"ano";"chave";"UF";"MUNICIPIO";"CAMINHAO";"MICRO_ONIBUS";"ONIBUS";"total"
2011;"ACRELANDIA (AC)";"AC";"ACRELANDIA";176;3;35;214
2011;"ASSIS BRASIL (AC)";"AC";"ASSIS BRASIL";14;1;2;17
2011;"BRASILEIA (AC)";"AC";"BRASILEIA";155;2;9;166
2011;"BUJARI (AC)";"AC";"BUJARI";76;3;5;84
2011;"CAPIXABA (AC)";"AC";"CAPIXABA";62;1;8;71
2011;"CRUZEIRO DO SUL (AC)";"AC";"CRUZEIRO DO SUL";501;44;43;588
2011;"EPITACIOLANDIA (AC)";"AC";"EPITACIOLANDIA";148;1;11;160
2011;"FEIJO (AC)";"AC";"FEIJO";84;1;1;86
2011;"JORDAO (AC)";"AC";"JORDAO";1;0;0;1
2011;"MANCIO LIMA (AC)";"AC";"MANCIO LIMA";60;1;8;69
2011;"MANOEL URBANO (AC)";"AC";"MANOEL URBANO";21;0;1;22
2011;"MARECHAL THAUMATURGO (AC)";"AC";"MARECHAL THAUMATURGO";4;0;2;6
2011;"PLACIDO DE CASTRO (AC)";"AC";"PLACIDO DE CASTRO";128;1;8;137
2011;"PORTO ACRE (AC)";"AC";"PORTO ACRE";113;2;26;141
2011;"PORTO WALTER (AC)";"AC";"PORTO WALTER";2;0;0;2
2011;"RIO BRANCO (AC)";"AC";"RIO BRANCO";3563;158;487;4208
2011;"RODRIGUES ALVES (AC)";"AC";"RODRIGUES ALVES";9;1;1;11
2011;"SANTA ROSA DO PURUS (AC)";"AC";"SANTA ROSA DO PURUS";2;0;1;3
2011;"SENA MADUREIRA (AC)";"AC";"SENA MADUREIRA";83;3;4;90
2011;"SENADOR GUIOMARD (AC)";"AC";"SENADOR GUIOMARD";291;3;16;310
2011;"TARAUACA (AC)";"AC";"TARAUACA";121;2;7;130
2011;"XAPURI (AC)";"AC";"XAPURI";55;2;1;58
2011;"AGUA BRANCA (AL)";"AL";"AGUA BRANCA";50;66;7;123
2011;"ANADIA (AL)";"AL";"ANADIA";42;54;31;127
2011;"ARAPIRACA (AL)";"AL";"ARAPIRACA";2639;431;273;3343
2011;"ATALAIA (AL)";"AL";"ATALAIA";192;46;101;339
2011;"BARRA DE SANTO ANTONIO (AL)";"AL";"BARRA DE SANTO ANTONIO";22;8;14;44
2011;"BARRA DE SAO MIGUEL (AL)";"AL";"BARRA DE SAO MIGUEL";17;2;5;24
2011;"BATALHA (AL)";"AL";"BATALHA";81;25;3;109
2011;"BELEM (AL)";"AL";"BELEM";10;17;1;28
2011;"BELO MONTE (AL)";"AL";"BELO MONTE";30;6;2;38
2011;"BOCA DA MATA (AL)";"AL";"BOCA DA MATA";233;64;84;381
2011;"BRANQUINHA (AL)";"AL";"BRANQUINHA";15;18;10;43
2011;"CACIMBINHAS (AL)";"AL";"CACIMBINHAS";37;31;8;76
2011;"CAJUEIRO (AL)";"AL";"CAJUEIRO";95;12;44;151
2011;"CAMPESTRE (AL)";"AL";"CAMPESTRE";14;47;8;69
2011;"CAMPO ALEGRE (AL)";"AL";"CAMPO ALEGRE";131;121;100;352
2011;"CAMPO GRANDE (AL)";"AL";"CAMPO GRANDE";42;22;9;73
2011;"CANAPI (AL)";"AL";"CANAPI";26;25;13;64
2011;"CAPELA (AL)";"AL";"CAPELA";62;5;33;100
2011;"CARNEIROS (AL)";"AL";"CARNEIROS";18;6;2;26
2011;"CHA PRETA (AL)";"AL";"CHA PRETA";21;6;4;31
2011;"COITE DO NOIA (AL)";"AL";"COITE DO NOIA";40;4;16;60
2011;"COLONIA LEOPOLDINA (AL)";"AL";"COLONIA LEOPOLDINA";53;21;23;97
2011;"COQUEIRO SECO (AL)";"AL";"COQUEIRO SECO";6;4;3;13
2011;"CORURIPE (AL)";"AL";"CORURIPE";318;61;163;542
2011;"CRAIBAS (AL)";"AL";"CRAIBAS";84;25;16;125
2011;"DELMIRO GOUVEIA (AL)";"AL";"DELMIRO GOUVEIA";406;345;29;780
2011;"DOIS RIACHOS (AL)";"AL";"DOIS RIACHOS";48;9;5;62
2011;"ESTRELA DE ALAGOAS (AL)";"AL";"ESTRELA DE ALAGOAS";38;42;12;92
2011;"FEIRA GRANDE (AL)";"AL";"FEIRA GRANDE";44;2;36;82
2011;"FELIZ DESERTO (AL)";"AL";"FELIZ DESERTO";3;5;6;14
2011;"FLEXEIRAS (AL)";"AL";"FLEXEIRAS";21;17;31;69
2011;"GIRAU DO PONCIANO (AL)";"AL";"GIRAU DO PONCIANO";114;37;36;187
2011;"IBATEGUARA (AL)";"AL";"IBATEGUARA";31;50;14;95
2011;"IGACI (AL)";"AL";"IGACI";60;46;24;130
2011;"IGREJA NOVA (AL)";"AL";"IGREJA NOVA";68;20;65;153
2011;"INHAPI (AL)";"AL";"INHAPI";42;12;4;58
2011;"JACARE DOS HOMENS (AL)";"AL";"JACARE DOS HOMENS";30;5;4;39
2011;"JACUIPE (AL)";"AL";"JACUIPE";11;7;10;28
2011;"JAPARATINGA (AL)";"AL";"JAPARATINGA";10;14;3;27
2011;"JARAMATAIA (AL)";"AL";"JARAMATAIA";14;8;3;25
2011;"JEQUIA DA PRAIA (AL)";"AL";"JEQUIA DA PRAIA";30;11;28;69
2011;"JOAQUIM GOMES (AL)";"AL";"JOAQUIM GOMES";79;27;63;169
2011;"JUNDIA (AL)";"AL";"JUNDIA";8;5;8;21
2011;"JUNQUEIRO (AL)";"AL";"JUNQUEIRO";191;27;92;310
2011;"LAGOA DA CANOA (AL)";"AL";"LAGOA DA CANOA";62;13;22;97
2011;"LIMOEIRO DE ANADIA (AL)";"AL";"LIMOEIRO DE ANADIA";68;14;36;118
2011;"MACEIO (AL)";"AL";"MACEIO";6156;939;1732;8827
2011;"MAJOR ISIDORO (AL)";"AL";"MAJOR ISIDORO";57;20;16;93
2011;"MAR VERMELHO (AL)";"AL";"MAR VERMELHO";10;2;5;17
2011;"MARAGOGI (AL)";"AL";"MARAGOGI";47;79;28;154
2011;"MARAVILHA (AL)";"AL";"MARAVILHA";28;31;5;64
2011;"MARECHAL DEODORO (AL)";"AL";"MARECHAL DEODORO";224;73;82;379
2011;"MARIBONDO (AL)";"AL";"MARIBONDO";43;18;12;73
2011;"MATA GRANDE (AL)";"AL";"MATA GRANDE";42;26;4;72
2011;"MATRIZ DE CAMARAGIBE (AL)";"AL";"MATRIZ DE CAMARAGIBE";116;25;102;243
2011;"MESSIAS (AL)";"AL";"MESSIAS";63;36;57;156
2011;"MINADOR DO NEGRAO (AL)";"AL";"MINADOR DO NEGRAO";24;10;5;39
2011;"MONTEIROPOLIS (AL)";"AL";"MONTEIROPOLIS";9;2;5;16
2011;"MURICI (AL)";"AL";"MURICI";98;24;81;203
2011;"NOVO LINO (AL)";"AL";"NOVO LINO";41;18;38;97
2011;"OLHO D AGUA DAS FLORES (AL)";"AL";"OLHO D AGUA DAS FLORES";90;48;16;154
2011;"OLHO D AGUA DO CASADO (AL)";"AL";"OLHO D AGUA DO CASADO";21;15;4;40
2011;"OLHO D AGUA GRANDE (AL)";"AL";"OLHO D AGUA GRANDE";9;1;9;19
2011;"OLIVENCA (AL)";"AL";"OLIVENCA";31;10;4;45
2011;"OURO BRANCO (AL)";"AL";"OURO BRANCO";37;30;15;82
2011;"PALESTINA (AL)";"AL";"PALESTINA";5;4;1;10
2011;"PALMEIRA DOS INDIOS (AL)";"AL";"PALMEIRA DOS INDIOS";534;133;41;708
2011;"PAO DE ACUCAR (AL)";"AL";"PAO DE ACUCAR";59;13;7;79
2011;"PARICONHA (AL)";"AL";"PARICONHA";25;15;5;45
2011;"PARIPUEIRA (AL)";"AL";"PARIPUEIRA";45;4;10;59
2011;"PASSO DE CAMARAGIBE (AL)";"AL";"PASSO DE CAMARAGIBE";28;8;22;58
2011;"PAULO JACINTO (AL)";"AL";"PAULO JACINTO";14;9;5;28
2011;"PENEDO (AL)";"AL";"PENEDO";230;75;157;462
2011;"PIACABUCU (AL)";"AL";"PIACABUCU";18;18;9;45
2011;"PILAR (AL)";"AL";"PILAR";152;56;56;264
2011;"PINDOBA (AL)";"AL";"PINDOBA";11;2;2;15
2011;"PIRANHAS (AL)";"AL";"PIRANHAS";45;63;6;114
2011;"POCO DAS TRINCHEIRAS (AL)";"AL";"POCO DAS TRINCHEIRAS";44;46;17;107
2011;"PORTO CALVO (AL)";"AL";"PORTO CALVO";178;107;46;331
2011;"PORTO DE PEDRAS (AL)";"AL";"PORTO DE PEDRAS";6;7;5;18
2011;"PORTO REAL DO COLEGIO (AL)";"AL";"PORTO REAL DO COLEGIO";17;25;17;59
2011;"QUEBRANGULO (AL)";"AL";"QUEBRANGULO";25;8;4;37
2011;"RIO LARGO (AL)";"AL";"RIO LARGO";403;168;161;732
2011;"ROTEIRO (AL)";"AL";"ROTEIRO";10;19;6;35
2011;"SANTA LUZIA DO NORTE (AL)";"AL";"SANTA LUZIA DO NORTE";9;2;59;70
2011;"SANTANA DO IPANEMA (AL)";"AL";"SANTANA DO IPANEMA";308;89;31;428
2011;"SANTANA DO MUNDAU (AL)";"AL";"SANTANA DO MUNDAU";57;26;2;85
2011;"SAO BRAS (AL)";"AL";"SAO BRAS";2;2;3;7
2011;"SAO JOSE DA LAJE (AL)";"AL";"SAO JOSE DA LAJE";94;76;40;210
2011;"SAO JOSE DA TAPERA (AL)";"AL";"SAO JOSE DA TAPERA";76;23;13;112
2011;"SAO LUIS DO QUITUNDE (AL)";"AL";"SAO LUIS DO QUITUNDE";199;20;101;320
2011;"SAO MIGUEL DOS CAMPOS (AL)";"AL";"SAO MIGUEL DOS CAMPOS";463;151;162;776
2011;"SAO MIGUEL DOS MILAGRES (AL)";"AL";"SAO MIGUEL DOS MILAGRES";18;1;4;23
2011;"SAO SEBASTIAO (AL)";"AL";"SAO SEBASTIAO";136;35;81;252
2011;"SATUBA (AL)";"AL";"SATUBA";62;15;21;98
2011;"SENADOR RUI PALMEIRA (AL)";"AL";"SENADOR RUI PALMEIRA";22;13;9;44
2011;"TANQUE D ARCA (AL)";"AL";"TANQUE D ARCA";11;13;5;29
2011;"TAQUARANA (AL)";"AL";"TAQUARANA";73;30;20;123
2011;"TEOTONIO VILELA (AL)";"AL";"TEOTONIO VILELA";187;88;155;430
2011;"TRAIPU (AL)";"AL";"TRAIPU";70;14;12;96
2011;"UNIAO DOS PALMARES (AL)";"AL";"UNIAO DOS PALMARES";426;194;156;776
2011;"VICOSA (AL)";"AL";"VICOSA";117;13;35;165
2011;"ALVARAES (AM)";"AM";"ALVARAES";3;0;3;6
2011;"AMATURA (AM)";"AM";"AMATURA";2;0;1;3
2011;"ANAMA (AM)";"AM";"ANAMA";0;0;3;3
2011;"ANORI (AM)";"AM";"ANORI";1;0;2;3
2011;"APUI (AM)";"AM";"APUI";69;1;11;81
2011;"ATALAIA DO NORTE (AM)";"AM";"ATALAIA DO NORTE";1;0;1;2
2011;"AUTAZES (AM)";"AM";"AUTAZES";21;2;12;35
2011;"BARCELOS (AM)";"AM";"BARCELOS";7;1;0;8
2011;"BARREIRINHA (AM)";"AM";"BARREIRINHA";2;0;0;2
2011;"BENJAMIN CONSTANT (AM)";"AM";"BENJAMIN CONSTANT";9;4;2;15
2011;"BERURI (AM)";"AM";"BERURI";0;0;0;0
2011;"BOA VISTA DO RAMOS (AM)";"AM";"BOA VISTA DO RAMOS";2;0;1;3
2011;"BOCA DO ACRE (AM)";"AM";"BOCA DO ACRE";30;2;5;37
2011;"BORBA (AM)";"AM";"BORBA";9;0;5;14
2011;"CAAPIRANGA (AM)";"AM";"CAAPIRANGA";8;1;3;12
2011;"CANUTAMA (AM)";"AM";"CANUTAMA";2;0;0;2
2011;"CARAUARI (AM)";"AM";"CARAUARI";24;1;1;26
2011;"CAREIRO (AM)";"AM";"CAREIRO";54;20;42;116
2011;"CAREIRO DA VARZEA (AM)";"AM";"CAREIRO DA VARZEA";10;23;34;67
2011;"COARI (AM)";"AM";"COARI";98;3;13;114
2011;"CODAJAS (AM)";"AM";"CODAJAS";7;0;4;11
2011;"EIRUNEPE (AM)";"AM";"EIRUNEPE";22;0;1;23
2011;"ENVIRA (AM)";"AM";"ENVIRA";13;0;2;15
2011;"FONTE BOA (AM)";"AM";"FONTE BOA";12;0;0;12
2011;"GUAJARA (AM)";"AM";"GUAJARA";0;0;1;1
2011;"HUMAITA (AM)";"AM";"HUMAITA";114;3;12;129
2011;"IPIXUNA (AM)";"AM";"IPIXUNA";2;0;0;2
2011;"IRANDUBA (AM)";"AM";"IRANDUBA";163;11;46;220
2011;"ITACOATIARA (AM)";"AM";"ITACOATIARA";301;21;103;425
2011;"ITAMARATI (AM)";"AM";"ITAMARATI";2;0;0;2
2011;"ITAPIRANGA (AM)";"AM";"ITAPIRANGA";6;1;2;9
2011;"JAPURA (AM)";"AM";"JAPURA";4;0;0;4
2011;"JURUA (AM)";"AM";"JURUA";6;0;1;7
2011;"JUTAI (AM)";"AM";"JUTAI";2;0;0;2
2011;"LABREA (AM)";"AM";"LABREA";18;1;2;21
2011;"MANACAPURU (AM)";"AM";"MANACAPURU";244;39;57;340
2011;"MANAQUIRI (AM)";"AM";"MANAQUIRI";7;3;5;15
2011;"MANAUS (AM)";"AM";"MANAUS";15668;2596;6783;25047
2011;"MANICORE (AM)";"AM";"MANICORE";18;1;7;26
2011;"MARAA (AM)";"AM";"MARAA";3;0;0;3
2011;"MAUES (AM)";"AM";"MAUES";33;1;9;43
2011;"NHAMUNDA (AM)";"AM";"NHAMUNDA";7;0;0;7
2011;"NOVA OLINDA DO NORTE (AM)";"AM";"NOVA OLINDA DO NORTE";13;6;6;25
2011;"NOVO AIRAO (AM)";"AM";"NOVO AIRAO";17;7;16;40
2011;"NOVO ARIPUANA (AM)";"AM";"NOVO ARIPUANA";12;2;5;19
2011;"PARINTINS (AM)";"AM";"PARINTINS";123;5;13;141
2011;"PAUINI (AM)";"AM";"PAUINI";2;1;1;4
2011;"PRESIDENTE FIGUEIREDO (AM)";"AM";"PRESIDENTE FIGUEIREDO";224;37;54;315
2011;"RIO PRETO DA EVA (AM)";"AM";"RIO PRETO DA EVA";96;11;60;167
2011;"SANTA ISABEL DO RIO NEGRO (AM)";"AM";"SANTA ISABEL DO RIO NEGRO";7;2;3;12
2011;"SANTO ANTONIO DO ICA (AM)";"AM";"SANTO ANTONIO DO ICA";6;0;0;6
2011;"SAO GABRIEL DA CACHOEIRA (AM)";"AM";"SAO GABRIEL DA CACHOEIRA";68;9;21;98
2011;"SAO PAULO DE OLIVENCA (AM)";"AM";"SAO PAULO DE OLIVENCA";4;0;5;9
2011;"SAO SEBASTIAO DO UATUMA (AM)";"AM";"SAO SEBASTIAO DO UATUMA";4;0;0;4
2011;"SILVES (AM)";"AM";"SILVES";8;3;3;14
2011;"TABATINGA (AM)";"AM";"TABATINGA";50;7;2;59
2011;"TAPAUA (AM)";"AM";"TAPAUA";3;0;2;5
2011;"TEFE (AM)";"AM";"TEFE";52;12;8;72
2011;"TONANTINS (AM)";"AM";"TONANTINS";3;0;1;4
2011;"UARINI (AM)";"AM";"UARINI";8;0;2;10
2011;"URUCARA (AM)";"AM";"URUCARA";11;2;2;15
2011;"URUCURITUBA (AM)";"AM";"URUCURITUBA";3;0;2;5
2011;"AMAPA (AP)";"AP";"AMAPA";6;1;2;9
2011;"CALCOENE (AP)";"AP";"CALCOENE";9;2;2;13
2011;"CUTIAS (AP)";"AP";"CUTIAS";3;1;0;4
2011;"FERREIRA GOMES (AP)";"AP";"FERREIRA GOMES";3;1;1;5
2011;"ITAUBAL (AP)";"AP";"ITAUBAL";3;0;2;5
2011;"LARANJAL DO JARI (AP)";"AP";"LARANJAL DO JARI";65;7;8;80
2011;"MACAPA (AP)";"AP";"MACAPA";2501;283;570;3354
2011;"MAZAGAO (AP)";"AP";"MAZAGAO";49;8;15;72
2011;"OIAPOQUE (AP)";"AP";"OIAPOQUE";46;4;5;55
2011;"PEDRA BRANCA DO AMAPARI (AP)";"AP";"PEDRA BRANCA DO AMAPARI";23;3;3;29
2011;"PORTO GRANDE (AP)";"AP";"PORTO GRANDE";25;1;7;33
2011;"PRACUUBA (AP)";"AP";"PRACUUBA";3;0;1;4
2011;"SANTANA (AP)";"AP";"SANTANA";498;40;123;661
2011;"SERRA DO NAVIO (AP)";"AP";"SERRA DO NAVIO";2;3;0;5
2011;"TARTARUGALZINHO (AP)";"AP";"TARTARUGALZINHO";9;1;1;11
2011;"VITORIA DO JARI (AP)";"AP";"VITORIA DO JARI";0;0;1;1
2011;"ABAIRA (BA)";"BA";"ABAIRA";53;20;13;86
2011;"ABARE (BA)";"BA";"ABARE";48;24;19;91
2011;"ACAJUTIBA (BA)";"BA";"ACAJUTIBA";61;7;11;79
2011;"ADUSTINA (BA)";"BA";"ADUSTINA";11;7;11;29
2011;"AGUA FRIA (BA)";"BA";"AGUA FRIA";16;15;34;65
2011;"AIQUARA (BA)";"BA";"AIQUARA";5;4;4;13
2011;"ALAGOINHAS (BA)";"BA";"ALAGOINHAS";1036;279;449;1764
2011;"ALCOBACA (BA)";"BA";"ALCOBACA";39;4;24;67
2011;"ALMADINA (BA)";"BA";"ALMADINA";14;0;4;18
2011;"AMARGOSA (BA)";"BA";"AMARGOSA";235;47;69;351
2011;"AMELIA RODRIGUES (BA)";"BA";"AMELIA RODRIGUES";169;80;30;279
2011;"AMERICA DOURADA (BA)";"BA";"AMERICA DOURADA";16;10;7;33
2011;"ANAGE (BA)";"BA";"ANAGE";66;55;33;154
2011;"ANDARAI (BA)";"BA";"ANDARAI";25;4;15;44
2011;"ANDORINHA (BA)";"BA";"ANDORINHA";60;10;33;103
2011;"ANGICAL (BA)";"BA";"ANGICAL";25;9;23;57
2011;"ANGUERA (BA)";"BA";"ANGUERA";15;7;12;34
2011;"ANTAS (BA)";"BA";"ANTAS";24;7;10;41
2011;"ANTONIO CARDOSO (BA)";"BA";"ANTONIO CARDOSO";2;23;12;37
2011;"ANTONIO GONCALVES (BA)";"BA";"ANTONIO GONCALVES";21;9;7;37
2011;"APORA (BA)";"BA";"APORA";30;20;27;77
2011;"APUAREMA (BA)";"BA";"APUAREMA";27;5;9;41
2011;"ARACAS (BA)";"BA";"ARACAS";55;12;26;93
2011;"ARACATU (BA)";"BA";"ARACATU";76;22;18;116
2011;"ARACI (BA)";"BA";"ARACI";222;17;51;290
2011;"ARAMARI (BA)";"BA";"ARAMARI";41;4;7;52
2011;"ARATACA (BA)";"BA";"ARATACA";23;0;3;26
2011;"ARATUIPE (BA)";"BA";"ARATUIPE";29;2;12;43
2011;"AURELINO LEAL (BA)";"BA";"AURELINO LEAL";47;3;11;61
2011;"BAIANOPOLIS (BA)";"BA";"BAIANOPOLIS";37;5;29;71
2011;"BAIXA GRANDE (BA)";"BA";"BAIXA GRANDE";79;40;41;160
2011;"BANZAE (BA)";"BA";"BANZAE";20;4;19;43
2011;"BARRA (BA)";"BA";"BARRA";45;22;27;94
2011;"BARRA DA ESTIVA (BA)";"BA";"BARRA DA ESTIVA";179;48;51;278
2011;"BARRA DO CHOCA (BA)";"BA";"BARRA DO CHOCA";105;155;26;286
2011;"BARRA DO MENDES (BA)";"BA";"BARRA DO MENDES";53;20;7;80
2011;"BARRA DO ROCHA (BA)";"BA";"BARRA DO ROCHA";7;4;2;13
2011;"BARREIRAS (BA)";"BA";"BARREIRAS";2345;113;378;2836
2011;"BARRO ALTO (BA)";"BA";"BARRO ALTO";43;11;16;70
2011;"BARRO PRETO (BA)";"BA";"BARRO PRETO";9;2;10;21
2011;"BARROCAS (BA)";"BA";"BARROCAS";81;2;16;99
2011;"BELMONTE (BA)";"BA";"BELMONTE";46;2;10;58
2011;"BELO CAMPO (BA)";"BA";"BELO CAMPO";80;14;24;118
2011;"BIRITINGA (BA)";"BA";"BIRITINGA";17;11;27;55
2011;"BOA NOVA (BA)";"BA";"BOA NOVA";21;31;22;74
2011;"BOA VISTA DO TUPIM (BA)";"BA";"BOA VISTA DO TUPIM";39;10;17;66
2011;"BOM JESUS DA LAPA (BA)";"BA";"BOM JESUS DA LAPA";415;50;97;562
2011;"BOM JESUS DA SERRA (BA)";"BA";"BOM JESUS DA SERRA";28;39;18;85
2011;"BONINAL (BA)";"BA";"BONINAL";62;18;28;108
2011;"BONITO (BA)";"BA";"BONITO";65;12;13;90
2011;"BOQUIRA (BA)";"BA";"BOQUIRA";116;8;53;177
2011;"BOTUPORA (BA)";"BA";"BOTUPORA";44;2;36;82
2011;"BREJOES (BA)";"BA";"BREJOES";76;8;34;118
2011;"BREJOLANDIA (BA)";"BA";"BREJOLANDIA";27;8;17;52
2011;"BROTAS DE MACAUBAS (BA)";"BA";"BROTAS DE MACAUBAS";24;34;14;72
2011;"BRUMADO (BA)";"BA";"BRUMADO";1119;203;252;1574
2011;"BUERAREMA (BA)";"BA";"BUERAREMA";132;8;35;175
2011;"BURITIRAMA (BA)";"BA";"BURITIRAMA";15;3;18;36
2011;"CAATIBA (BA)";"BA";"CAATIBA";17;5;2;24
2011;"CABACEIRAS DO PARAGUACU (BA)";"BA";"CABACEIRAS DO PARAGUACU";45;17;38;100
2011;"CACHOEIRA (BA)";"BA";"CACHOEIRA";94;104;67;265
2011;"CACULE (BA)";"BA";"CACULE";316;21;43;380
2011;"CAEM (BA)";"BA";"CAEM";17;9;12;38
2011;"CAETANOS (BA)";"BA";"CAETANOS";39;12;9;60
2011;"CAETITE (BA)";"BA";"CAETITE";471;70;90;631
2011;"CAFARNAUM (BA)";"BA";"CAFARNAUM";54;5;21;80
2011;"CAIRU (BA)";"BA";"CAIRU";8;6;4;18
2011;"CALDEIRAO GRANDE (BA)";"BA";"CALDEIRAO GRANDE";28;6;14;48
2011;"CAMACAN (BA)";"BA";"CAMACAN";187;25;33;245
2011;"CAMACARI (BA)";"BA";"CAMACARI";2043;415;1207;3665
2011;"CAMAMU (BA)";"BA";"CAMAMU";129;41;29;199
2011;"CAMPO ALEGRE DE LOURDES (BA)";"BA";"CAMPO ALEGRE DE LOURDES";58;4;10;72
2011;"CAMPO FORMOSO (BA)";"BA";"CAMPO FORMOSO";203;25;74;302
2011;"CANAPOLIS (BA)";"BA";"CANAPOLIS";15;17;12;44
2011;"CANARANA (BA)";"BA";"CANARANA";147;13;16;176
2011;"CANAVIEIRAS (BA)";"BA";"CANAVIEIRAS";89;9;14;112
2011;"CANDEAL (BA)";"BA";"CANDEAL";19;20;10;49
2011;"CANDEIAS (BA)";"BA";"CANDEIAS";868;334;313;1515
2011;"CANDIBA (BA)";"BA";"CANDIBA";50;1;25;76
2011;"CANDIDO SALES (BA)";"BA";"CANDIDO SALES";290;27;42;359
2011;"CANSANCAO (BA)";"BA";"CANSANCAO";133;48;49;230
2011;"CANUDOS (BA)";"BA";"CANUDOS";41;4;34;79
2011;"CAPELA DO ALTO ALEGRE (BA)";"BA";"CAPELA DO ALTO ALEGRE";63;23;18;104
2011;"CAPIM GROSSO (BA)";"BA";"CAPIM GROSSO";432;47;51;530
2011;"CARAIBAS (BA)";"BA";"CARAIBAS";39;20;17;76
2011;"CARAVELAS (BA)";"BA";"CARAVELAS";31;17;42;90
2011;"CARDEAL DA SILVA (BA)";"BA";"CARDEAL DA SILVA";22;6;6;34
2011;"CARINHANHA (BA)";"BA";"CARINHANHA";120;25;36;181
2011;"CASA NOVA (BA)";"BA";"CASA NOVA";366;180;168;714
2011;"CASTRO ALVES (BA)";"BA";"CASTRO ALVES";129;22;52;203
2011;"CATOLANDIA (BA)";"BA";"CATOLANDIA";6;3;7;16
2011;"CATU (BA)";"BA";"CATU";363;114;95;572
2011;"CATURAMA (BA)";"BA";"CATURAMA";28;5;9;42
2011;"CENTRAL (BA)";"BA";"CENTRAL";78;17;9;104
2011;"CHORROCHO (BA)";"BA";"CHORROCHO";20;6;7;33
2011;"CICERO DANTAS (BA)";"BA";"CICERO DANTAS";121;26;36;183
2011;"CIPO (BA)";"BA";"CIPO";39;6;10;55
2011;"COARACI (BA)";"BA";"COARACI";93;4;19;116
2011;"COCOS (BA)";"BA";"COCOS";71;5;38;114
2011;"CONCEICAO DA FEIRA (BA)";"BA";"CONCEICAO DA FEIRA";225;99;12;336
2011;"CONCEICAO DO ALMEIDA (BA)";"BA";"CONCEICAO DO ALMEIDA";110;30;24;164
2011;"CONCEICAO DO COITE (BA)";"BA";"CONCEICAO DO COITE";399;85;101;585
2011;"CONCEICAO DO JACUIPE (BA)";"BA";"CONCEICAO DO JACUIPE";260;128;22;410
2011;"CONDE (BA)";"BA";"CONDE";53;16;16;85
2011;"CONDEUBA (BA)";"BA";"CONDEUBA";117;37;63;217
2011;"CONTENDAS DO SINCORA (BA)";"BA";"CONTENDAS DO SINCORA";18;7;5;30
2011;"CORACAO DE MARIA (BA)";"BA";"CORACAO DE MARIA";98;41;47;186
2011;"CORDEIROS (BA)";"BA";"CORDEIROS";35;18;18;71
2011;"CORIBE (BA)";"BA";"CORIBE";46;16;19;81
2011;"CORONEL JOAO SA (BA)";"BA";"CORONEL JOAO SA";17;0;23;40
2011;"CORRENTINA (BA)";"BA";"CORRENTINA";133;26;68;227
2011;"COTEGIPE (BA)";"BA";"COTEGIPE";39;8;18;65
2011;"CRAVOLANDIA (BA)";"BA";"CRAVOLANDIA";17;1;6;24
2011;"CRISOPOLIS (BA)";"BA";"CRISOPOLIS";53;22;31;106
2011;"CRISTOPOLIS (BA)";"BA";"CRISTOPOLIS";49;10;27;86
2011;"CRUZ DAS ALMAS (BA)";"BA";"CRUZ DAS ALMAS";939;222;86;1247
2011;"CURACA (BA)";"BA";"CURACA";65;29;28;122
2011;"DARIO MEIRA (BA)";"BA";"DARIO MEIRA";16;11;5;32
2011;"DIAS D AVILA (BA)";"BA";"DIAS D AVILA";601;78;401;1080
2011;"DOM BASILIO (BA)";"BA";"DOM BASILIO";265;9;22;296
2011;"DOM MACEDO COSTA (BA)";"BA";"DOM MACEDO COSTA";13;26;7;46
2011;"ELISIO MEDRADO (BA)";"BA";"ELISIO MEDRADO";28;6;12;46
2011;"ENCRUZILHADA (BA)";"BA";"ENCRUZILHADA";78;34;13;125
2011;"ENTRE RIOS (BA)";"BA";"ENTRE RIOS";195;74;93;362
2011;"ERICO CARDOSO (BA)";"BA";"ERICO CARDOSO";29;6;16;51
2011;"ESPLANADA (BA)";"BA";"ESPLANADA";138;35;67;240
2011;"EUCLIDES DA CUNHA (BA)";"BA";"EUCLIDES DA CUNHA";246;34;124;404
2011;"EUNAPOLIS (BA)";"BA";"EUNAPOLIS";1193;102;321;1616
2011;"FATIMA (BA)";"BA";"FATIMA";20;7;21;48
2011;"FEIRA DA MATA (BA)";"BA";"FEIRA DA MATA";15;8;9;32
2011;"FEIRA DE SANTANA (BA)";"BA";"FEIRA DE SANTANA";7883;1027;1180;10090
2011;"FILADELFIA (BA)";"BA";"FILADELFIA";92;7;23;122
2011;"FIRMINO ALVES (BA)";"BA";"FIRMINO ALVES";12;2;2;16
2011;"FLORESTA AZUL (BA)";"BA";"FLORESTA AZUL";53;1;2;56
2011;"FORMOSA DO RIO PRETO (BA)";"BA";"FORMOSA DO RIO PRETO";123;3;17;143
2011;"GANDU (BA)";"BA";"GANDU";261;42;20;323
2011;"GAVIAO (BA)";"BA";"GAVIAO";14;11;6;31
2011;"GENTIO DO OURO (BA)";"BA";"GENTIO DO OURO";17;4;3;24
2011;"GLORIA (BA)";"BA";"GLORIA";43;19;39;101
2011;"GONGOGI (BA)";"BA";"GONGOGI";7;1;2;10
2011;"GOVERNADOR MANGABEIRA (BA)";"BA";"GOVERNADOR MANGABEIRA";152;36;34;222
2011;"GUAJERU (BA)";"BA";"GUAJERU";16;21;7;44
2011;"GUANAMBI (BA)";"BA";"GUANAMBI";1103;79;153;1335
2011;"GUARATINGA (BA)";"BA";"GUARATINGA";66;4;24;94
2011;"HELIOPOLIS (BA)";"BA";"HELIOPOLIS";26;10;11;47
2011;"IACU (BA)";"BA";"IACU";125;21;29;175
2011;"IBIASSUCE (BA)";"BA";"IBIASSUCE";76;12;14;102
2011;"IBICARAI (BA)";"BA";"IBICARAI";134;9;26;169
2011;"IBICOARA (BA)";"BA";"IBICOARA";183;31;52;266
2011;"IBICUI (BA)";"BA";"IBICUI";41;9;14;64
2011;"IBIPEBA (BA)";"BA";"IBIPEBA";33;16;9;58
2011;"IBIPITANGA (BA)";"BA";"IBIPITANGA";74;14;34;122
2011;"IBIQUERA (BA)";"BA";"IBIQUERA";6;7;2;15
2011;"IBIRAPITANGA (BA)";"BA";"IBIRAPITANGA";47;17;9;73
2011;"IBIRAPUA (BA)";"BA";"IBIRAPUA";51;5;15;71
2011;"IBIRATAIA (BA)";"BA";"IBIRATAIA";77;37;11;125
2011;"IBITIARA (BA)";"BA";"IBITIARA";88;35;33;156
2011;"IBITITA (BA)";"BA";"IBITITA";38;4;14;56
2011;"IBOTIRAMA (BA)";"BA";"IBOTIRAMA";209;58;25;292
2011;"ICHU (BA)";"BA";"ICHU";25;13;13;51
2011;"IGAPORA (BA)";"BA";"IGAPORA";91;25;25;141
2011;"IGRAPIUNA (BA)";"BA";"IGRAPIUNA";42;25;17;84
2011;"IGUAI (BA)";"BA";"IGUAI";58;24;31;113
2011;"ILHEUS (BA)";"BA";"ILHEUS";625;150;294;1069
2011;"INHAMBUPE (BA)";"BA";"INHAMBUPE";159;84;89;332
2011;"IPECAETA (BA)";"BA";"IPECAETA";13;5;44;62
2011;"IPIAU (BA)";"BA";"IPIAU";338;36;44;418
2011;"IPIRA (BA)";"BA";"IPIRA";350;46;86;482
2011;"IPUPIARA (BA)";"BA";"IPUPIARA";50;19;6;75
2011;"IRAJUBA (BA)";"BA";"IRAJUBA";25;1;21;47
2011;"IRAMAIA (BA)";"BA";"IRAMAIA";32;7;12;51
2011;"IRAQUARA (BA)";"BA";"IRAQUARA";115;23;29;167
2011;"IRARA (BA)";"BA";"IRARA";126;37;58;221
2011;"IRECE (BA)";"BA";"IRECE";800;63;116;979
2011;"ITABELA (BA)";"BA";"ITABELA";240;8;71;319
2011;"ITABERABA (BA)";"BA";"ITABERABA";456;71;58;585
2011;"ITABUNA (BA)";"BA";"ITABUNA";1771;63;692;2526
2011;"ITACARE (BA)";"BA";"ITACARE";19;28;5;52
2011;"ITAETE (BA)";"BA";"ITAETE";57;11;24;92
2011;"ITAGI (BA)";"BA";"ITAGI";35;4;4;43
2011;"ITAGIBA (BA)";"BA";"ITAGIBA";26;31;17;74
2011;"ITAGIMIRIM (BA)";"BA";"ITAGIMIRIM";47;2;4;53
2011;"ITAGUACU DA BAHIA (BA)";"BA";"ITAGUACU DA BAHIA";18;2;6;26
2011;"ITAJU DO COLONIA (BA)";"BA";"ITAJU DO COLONIA";12;0;5;17
2011;"ITAJUIPE (BA)";"BA";"ITAJUIPE";71;11;16;98
2011;"ITAMARAJU (BA)";"BA";"ITAMARAJU";418;30;140;588
2011;"ITAMARI (BA)";"BA";"ITAMARI";36;5;0;41
2011;"ITAMBE (BA)";"BA";"ITAMBE";65;49;6;120
2011;"ITANAGRA (BA)";"BA";"ITANAGRA";18;1;3;22
2011;"ITANHEM (BA)";"BA";"ITANHEM";59;8;21;88
2011;"ITAPARICA (BA)";"BA";"ITAPARICA";26;29;49;104
2011;"ITAPE (BA)";"BA";"ITAPE";22;0;1;23
2011;"ITAPEBI (BA)";"BA";"ITAPEBI";45;3;8;56
2011;"ITAPETINGA (BA)";"BA";"ITAPETINGA";500;49;159;708
2011;"ITAPICURU (BA)";"BA";"ITAPICURU";39;17;36;92
2011;"ITAPITANGA (BA)";"BA";"ITAPITANGA";11;4;3;18
2011;"ITAQUARA (BA)";"BA";"ITAQUARA";35;4;4;43
2011;"ITARANTIM (BA)";"BA";"ITARANTIM";85;9;3;97
2011;"ITATIM (BA)";"BA";"ITATIM";162;28;27;217
2011;"ITIRUCU (BA)";"BA";"ITIRUCU";110;10;15;135
2011;"ITIUBA (BA)";"BA";"ITIUBA";68;32;51;151
2011;"ITORORO (BA)";"BA";"ITORORO";93;18;20;131
2011;"ITUACU (BA)";"BA";"ITUACU";123;22;34;179
2011;"ITUBERA (BA)";"BA";"ITUBERA";135;20;18;173
2011;"IUIU (BA)";"BA";"IUIU";38;6;10;54
2011;"JABORANDI (BA)";"BA";"JABORANDI";49;2;26;77
2011;"JACARACI (BA)";"BA";"JACARACI";44;13;23;80
2011;"JACOBINA (BA)";"BA";"JACOBINA";666;100;156;922
2011;"JAGUAQUARA (BA)";"BA";"JAGUAQUARA";563;21;45;629
2011;"JAGUARARI (BA)";"BA";"JAGUARARI";188;57;66;311
2011;"JAGUARIPE (BA)";"BA";"JAGUARIPE";36;13;21;70
2011;"JANDAIRA (BA)";"BA";"JANDAIRA";15;4;11;30
2011;"JEQUIE (BA)";"BA";"JEQUIE";1445;87;356;1888
2011;"JEREMOABO (BA)";"BA";"JEREMOABO";85;29;50;164
2011;"JIQUIRICA (BA)";"BA";"JIQUIRICA";42;21;20;83
2011;"JITAUNA (BA)";"BA";"JITAUNA";30;8;9;47
2011;"JOAO DOURADO (BA)";"BA";"JOAO DOURADO";90;17;16;123
2011;"JUAZEIRO (BA)";"BA";"JUAZEIRO";2890;878;848;4616
2011;"JUCURUCU (BA)";"BA";"JUCURUCU";11;1;3;15
2011;"JUSSARA (BA)";"BA";"JUSSARA";49;19;19;87
2011;"JUSSARI (BA)";"BA";"JUSSARI";10;1;2;13
2011;"JUSSIAPE (BA)";"BA";"JUSSIAPE";55;13;20;88
2011;"LAFAIETE COUTINHO (BA)";"BA";"LAFAIETE COUTINHO";15;4;4;23
2011;"LAGEDO DO TABOCAL (BA)";"BA";"LAGEDO DO TABOCAL";33;1;8;42
2011;"LAGOA REAL (BA)";"BA";"LAGOA REAL";41;5;16;62
2011;"LAJE (BA)";"BA";"LAJE";141;57;43;241
2011;"LAJEDAO (BA)";"BA";"LAJEDAO";6;1;15;22
2011;"LAJEDINHO (BA)";"BA";"LAJEDINHO";8;4;7;19
2011;"LAMARAO (BA)";"BA";"LAMARAO";3;6;6;15
2011;"LAPAO (BA)";"BA";"LAPAO";120;9;27;156
2011;"LAURO DE FREITAS (BA)";"BA";"LAURO DE FREITAS";2226;448;632;3306
2011;"LENCOIS (BA)";"BA";"LENCOIS";12;11;3;26
2011;"LICINIO DE ALMEIDA (BA)";"BA";"LICINIO DE ALMEIDA";105;12;15;132
2011;"LIVRAMENTO DE NOSSA SENHORA (BA)";"BA";"LIVRAMENTO DE NOSSA SENHORA";407;41;96;544
2011;"LUIS EDUARDO MAGALHAES (BA)";"BA";"LUIS EDUARDO MAGALHAES";1320;55;106;1481
2011;"MACAJUBA (BA)";"BA";"MACAJUBA";23;18;28;69
2011;"MACARANI (BA)";"BA";"MACARANI";88;9;17;114
2011;"MACAUBAS (BA)";"BA";"MACAUBAS";192;20;222;434
2011;"MACURURE (BA)";"BA";"MACURURE";12;4;8;24
2011;"MADRE DE DEUS (BA)";"BA";"MADRE DE DEUS";74;44;29;147
2011;"MAETINGA (BA)";"BA";"MAETINGA";27;9;10;46
2011;"MAIQUINIQUE (BA)";"BA";"MAIQUINIQUE";50;5;10;65
2011;"MAIRI (BA)";"BA";"MAIRI";63;23;33;119
2011;"MALHADA (BA)";"BA";"MALHADA";32;8;15;55
2011;"MALHADA DE PEDRAS (BA)";"BA";"MALHADA DE PEDRAS";82;36;30;148
2011;"MANOEL VITORINO (BA)";"BA";"MANOEL VITORINO";53;13;10;76
2011;"MANSIDAO (BA)";"BA";"MANSIDAO";11;0;6;17
2011;"MARACAS (BA)";"BA";"MARACAS";190;13;43;246
2011;"MARAGOGIPE (BA)";"BA";"MARAGOGIPE";108;34;26;168
2011;"MARAU (BA)";"BA";"MARAU";12;3;2;17
2011;"MARCIONILIO SOUZA (BA)";"BA";"MARCIONILIO SOUZA";17;21;12;50
2011;"MASCOTE (BA)";"BA";"MASCOTE";45;5;8;58
2011;"MATA DE SAO JOAO (BA)";"BA";"MATA DE SAO JOAO";202;74;70;346
2011;"MATINA (BA)";"BA";"MATINA";16;13;21;50
2011;"MEDEIROS NETO (BA)";"BA";"MEDEIROS NETO";83;15;38;136
2011;"MIGUEL CALMON (BA)";"BA";"MIGUEL CALMON";84;12;32;128
2011;"MILAGRES (BA)";"BA";"MILAGRES";110;11;17;138
2011;"MIRANGABA (BA)";"BA";"MIRANGABA";42;13;31;86
2011;"MIRANTE (BA)";"BA";"MIRANTE";41;14;17;72
2011;"MONTE SANTO (BA)";"BA";"MONTE SANTO";147;37;119;303
2011;"MORPARA (BA)";"BA";"MORPARA";16;14;4;34
2011;"MORRO DO CHAPEU (BA)";"BA";"MORRO DO CHAPEU";127;34;15;176
2011;"MORTUGABA (BA)";"BA";"MORTUGABA";83;6;12;101
2011;"MUCUGE (BA)";"BA";"MUCUGE";105;11;47;163
2011;"MUCURI (BA)";"BA";"MUCURI";119;28;41;188
2011;"MULUNGU DO MORRO (BA)";"BA";"MULUNGU DO MORRO";55;7;9;71
2011;"MUNDO NOVO (BA)";"BA";"MUNDO NOVO";48;19;23;90
2011;"MUNIZ FERREIRA (BA)";"BA";"MUNIZ FERREIRA";38;51;5;94
2011;"MUQUEM DO SAO FRANCISCO (BA)";"BA";"MUQUEM DO SAO FRANCISCO";24;15;22;61
2011;"MURITIBA (BA)";"BA";"MURITIBA";127;31;31;189
2011;"MUTUIPE (BA)";"BA";"MUTUIPE";121;66;41;228
2011;"NAZARE (BA)";"BA";"NAZARE";233;52;32;317
2011;"NILO PECANHA (BA)";"BA";"NILO PECANHA";32;25;11;68
2011;"NORDESTINA (BA)";"BA";"NORDESTINA";37;8;16;61
2011;"NOVA CANAA (BA)";"BA";"NOVA CANAA";46;10;13;69
2011;"NOVA FATIMA (BA)";"BA";"NOVA FATIMA";56;5;8;69
2011;"NOVA IBIA (BA)";"BA";"NOVA IBIA";20;5;6;31
2011;"NOVA ITARANA (BA)";"BA";"NOVA ITARANA";30;7;5;42
2011;"NOVA REDENCAO (BA)";"BA";"NOVA REDENCAO";11;4;7;22
2011;"NOVA SOURE (BA)";"BA";"NOVA SOURE";53;15;22;90
2011;"NOVA VICOSA (BA)";"BA";"NOVA VICOSA";118;22;40;180
2011;"NOVO HORIZONTE (BA)";"BA";"NOVO HORIZONTE";38;7;13;58
2011;"NOVO TRIUNFO (BA)";"BA";"NOVO TRIUNFO";10;2;2;14
2011;"OLINDINA (BA)";"BA";"OLINDINA";82;27;49;158
2011;"OLIVEIRA DOS BREJINHOS (BA)";"BA";"OLIVEIRA DOS BREJINHOS";92;41;30;163
2011;"OURICANGAS (BA)";"BA";"OURICANGAS";28;10;23;61
2011;"OUROLANDIA (BA)";"BA";"OUROLANDIA";56;14;6;76
2011;"PALMAS DE MONTE ALTO (BA)";"BA";"PALMAS DE MONTE ALTO";51;1;32;84
2011;"PALMEIRAS (BA)";"BA";"PALMEIRAS";38;18;4;60
2011;"PARAMIRIM (BA)";"BA";"PARAMIRIM";149;13;57;219
2011;"PARATINGA (BA)";"BA";"PARATINGA";52;24;40;116
2011;"PARIPIRANGA (BA)";"BA";"PARIPIRANGA";70;4;52;126
2011;"PAU BRASIL (BA)";"BA";"PAU BRASIL";35;7;32;74
2011;"PAULO AFONSO (BA)";"BA";"PAULO AFONSO";842;296;320;1458
2011;"PE DE SERRA (BA)";"BA";"PE DE SERRA";52;10;18;80
2011;"PEDRAO (BA)";"BA";"PEDRAO";7;4;6;17
2011;"PEDRO ALEXANDRE (BA)";"BA";"PEDRO ALEXANDRE";2;3;8;13
2011;"PIATA (BA)";"BA";"PIATA";96;26;25;147
2011;"PILAO ARCADO (BA)";"BA";"PILAO ARCADO";33;32;8;73
2011;"PINDAI (BA)";"BA";"PINDAI";47;8;26;81
2011;"PINDOBACU (BA)";"BA";"PINDOBACU";50;22;25;97
2011;"PINTADAS (BA)";"BA";"PINTADAS";44;18;41;103
2011;"PIRAI DO NORTE (BA)";"BA";"PIRAI DO NORTE";22;3;2;27
2011;"PIRIPA (BA)";"BA";"PIRIPA";76;27;17;120
2011;"PIRITIBA (BA)";"BA";"PIRITIBA";51;22;18;91
2011;"PLANALTINO (BA)";"BA";"PLANALTINO";30;6;16;52
2011;"PLANALTO (BA)";"BA";"PLANALTO";119;25;47;191
2011;"POCOES (BA)";"BA";"POCOES";316;199;76;591
2011;"POJUCA (BA)";"BA";"POJUCA";334;78;58;470
2011;"PONTO NOVO (BA)";"BA";"PONTO NOVO";57;6;25;88
2011;"PORTO SEGURO (BA)";"BA";"PORTO SEGURO";567;225;429;1221
2011;"POTIRAGUA (BA)";"BA";"POTIRAGUA";41;6;5;52
2011;"PRADO (BA)";"BA";"PRADO";59;10;31;100
2011;"PRESIDENTE DUTRA (BA)";"BA";"PRESIDENTE DUTRA";53;4;5;62
2011;"PRESIDENTE JANIO QUADROS (BA)";"BA";"PRESIDENTE JANIO QUADROS";34;20;12;66
2011;"PRESIDENTE TANCREDO NEVES (BA)";"BA";"PRESIDENTE TANCREDO NEVES";162;79;31;272
2011;"QUEIMADAS (BA)";"BA";"QUEIMADAS";91;15;65;171
2011;"QUIJINGUE (BA)";"BA";"QUIJINGUE";39;16;50;105
2011;"QUIXABEIRA (BA)";"BA";"QUIXABEIRA";28;17;12;57
2011;"RAFAEL JAMBEIRO (BA)";"BA";"RAFAEL JAMBEIRO";61;17;45;123
2011;"REMANSO (BA)";"BA";"REMANSO";243;71;36;350
2011;"RETIROLANDIA (BA)";"BA";"RETIROLANDIA";65;6;10;81
2011;"RIACHAO DAS NEVES (BA)";"BA";"RIACHAO DAS NEVES";67;18;24;109
2011;"RIACHAO DO JACUIPE (BA)";"BA";"RIACHAO DO JACUIPE";255;33;36;324
2011;"RIACHO DE SANTANA (BA)";"BA";"RIACHO DE SANTANA";225;29;61;315
2011;"RIBEIRA DO AMPARO (BA)";"BA";"RIBEIRA DO AMPARO";10;14;35;59
2011;"RIBEIRA DO POMBAL (BA)";"BA";"RIBEIRA DO POMBAL";251;70;113;434
2011;"RIBEIRAO DO LARGO (BA)";"BA";"RIBEIRAO DO LARGO";31;15;6;52
2011;"RIO DE CONTAS (BA)";"BA";"RIO DE CONTAS";66;26;19;111
2011;"RIO DO ANTONIO (BA)";"BA";"RIO DO ANTONIO";122;30;18;170
2011;"RIO DO PIRES (BA)";"BA";"RIO DO PIRES";60;13;17;90
2011;"RIO REAL (BA)";"BA";"RIO REAL";171;17;49;237
2011;"RODELAS (BA)";"BA";"RODELAS";22;7;4;33
2011;"RUY BARBOSA (BA)";"BA";"RUY BARBOSA";104;49;17;170
2011;"SALINAS DA MARGARIDA (BA)";"BA";"SALINAS DA MARGARIDA";24;6;6;36
2011;"SALVADOR (BA)";"BA";"SALVADOR";16439;3590;7432;27461
2011;"SANTA BARBARA (BA)";"BA";"SANTA BARBARA";53;6;15;74
2011;"SANTA BRIGIDA (BA)";"BA";"SANTA BRIGIDA";26;17;18;61
2011;"SANTA CRUZ CABRALIA (BA)";"BA";"SANTA CRUZ CABRALIA";69;27;17;113
2011;"SANTA CRUZ DA VITORIA (BA)";"BA";"SANTA CRUZ DA VITORIA";13;5;2;20
2011;"SANTA INES (BA)";"BA";"SANTA INES";44;9;4;57
2011;"SANTA LUZIA (BA)";"BA";"SANTA LUZIA";36;2;6;44
2011;"SANTA MARIA DA VITORIA (BA)";"BA";"SANTA MARIA DA VITORIA";353;41;53;447
2011;"SANTA RITA DE CASSIA (BA)";"BA";"SANTA RITA DE CASSIA";62;8;11;81
2011;"SANTA TERESINHA (BA)";"BA";"SANTA TERESINHA";23;10;20;53
2011;"SANTALUZ (BA)";"BA";"SANTALUZ";203;24;36;263
2011;"SANTANA (BA)";"BA";"SANTANA";142;11;48;201
2011;"SANTANOPOLIS (BA)";"BA";"SANTANOPOLIS";19;11;10;40
2011;"SANTO AMARO (BA)";"BA";"SANTO AMARO";204;104;264;572
2011;"SANTO ANTONIO DE JESUS (BA)";"BA";"SANTO ANTONIO DE JESUS";1916;212;158;2286
2011;"SANTO ESTEVAO (BA)";"BA";"SANTO ESTEVAO";223;75;48;346
2011;"SAO DESIDERIO (BA)";"BA";"SAO DESIDERIO";233;19;63;315
2011;"SAO DOMINGOS (BA)";"BA";"SAO DOMINGOS";38;0;8;46
2011;"SAO FELIPE (BA)";"BA";"SAO FELIPE";191;47;33;271
2011;"SAO FELIX (BA)";"BA";"SAO FELIX";48;18;14;80
2011;"SAO FELIX DO CORIBE (BA)";"BA";"SAO FELIX DO CORIBE";116;16;16;148
2011;"SAO FRANCISCO DO CONDE (BA)";"BA";"SAO FRANCISCO DO CONDE";134;90;81;305
2011;"SAO GABRIEL (BA)";"BA";"SAO GABRIEL";30;9;11;50
2011;"SAO GONCALO DOS CAMPOS (BA)";"BA";"SAO GONCALO DOS CAMPOS";99;153;38;290
2011;"SAO JOSE DA VITORIA (BA)";"BA";"SAO JOSE DA VITORIA";11;0;4;15
2011;"SAO JOSE DO JACUIPE (BA)";"BA";"SAO JOSE DO JACUIPE";53;13;4;70
2011;"SAO MIGUEL DAS MATAS (BA)";"BA";"SAO MIGUEL DAS MATAS";48;6;12;66
2011;"SAO SEBASTIAO DO PASSE (BA)";"BA";"SAO SEBASTIAO DO PASSE";173;160;127;460
2011;"SAPEACU (BA)";"BA";"SAPEACU";85;66;35;186
2011;"SATIRO DIAS (BA)";"BA";"SATIRO DIAS";20;9;15;44
2011;"SAUBARA (BA)";"BA";"SAUBARA";17;20;3;40
2011;"SAUDE (BA)";"BA";"SAUDE";32;16;11;59
2011;"SEABRA (BA)";"BA";"SEABRA";367;98;138;603
2011;"SEBASTIAO LARANJEIRAS (BA)";"BA";"SEBASTIAO LARANJEIRAS";17;1;25;43
2011;"SENHOR DO BONFIM (BA)";"BA";"SENHOR DO BONFIM";526;124;170;820
2011;"SENTO SE (BA)";"BA";"SENTO SE";47;4;17;68
2011;"SERRA DO RAMALHO (BA)";"BA";"SERRA DO RAMALHO";72;22;22;116
2011;"SERRA DOURADA (BA)";"BA";"SERRA DOURADA";58;12;30;100
2011;"SERRA PRETA (BA)";"BA";"SERRA PRETA";33;14;51;98
2011;"SERRINHA (BA)";"BA";"SERRINHA";621;111;184;916
2011;"SERROLANDIA (BA)";"BA";"SERROLANDIA";49;38;15;102
2011;"SIMOES FILHO (BA)";"BA";"SIMOES FILHO";2240;457;763;3460
2011;"SITIO DO MATO (BA)";"BA";"SITIO DO MATO";21;10;19;50
2011;"SITIO DO QUINTO (BA)";"BA";"SITIO DO QUINTO";17;2;9;28
2011;"SOBRADINHO (BA)";"BA";"SOBRADINHO";88;42;32;162
2011;"SOUTO SOARES (BA)";"BA";"SOUTO SOARES";88;9;24;121
2011;"TABOCAS DO BREJO VELHO (BA)";"BA";"TABOCAS DO BREJO VELHO";26;2;10;38
2011;"TANHACU (BA)";"BA";"TANHACU";184;38;37;259
2011;"TANQUE NOVO (BA)";"BA";"TANQUE NOVO";265;7;35;307
2011;"TANQUINHO (BA)";"BA";"TANQUINHO";25;15;10;50
2011;"TAPEROA (BA)";"BA";"TAPEROA";111;23;9;143
2011;"TAPIRAMUTA (BA)";"BA";"TAPIRAMUTA";37;8;11;56
2011;"TEIXEIRA DE FREITAS (BA)";"BA";"TEIXEIRA DE FREITAS";1391;88;315;1794
2011;"TEODORO SAMPAIO (BA)";"BA";"TEODORO SAMPAIO";13;12;10;35
2011;"TEOFILANDIA (BA)";"BA";"TEOFILANDIA";78;26;32;136
2011;"TEOLANDIA (BA)";"BA";"TEOLANDIA";116;22;8;146
2011;"TERRA NOVA (BA)";"BA";"TERRA NOVA";18;7;19;44
2011;"TREMEDAL (BA)";"BA";"TREMEDAL";42;17;35;94
2011;"TUCANO (BA)";"BA";"TUCANO";250;39;83;372
2011;"UAUA (BA)";"BA";"UAUA";138;18;23;179
2011;"UBAIRA (BA)";"BA";"UBAIRA";92;17;38;147
2011;"UBAITABA (BA)";"BA";"UBAITABA";159;7;17;183
2011;"UBATA (BA)";"BA";"UBATA";201;17;11;229
2011;"UIBAI (BA)";"BA";"UIBAI";43;9;8;60
2011;"UMBURANAS (BA)";"BA";"UMBURANAS";32;18;12;62
2011;"UNA (BA)";"BA";"UNA";50;7;24;81
2011;"URANDI (BA)";"BA";"URANDI";93;19;21;133
2011;"URUCUCA (BA)";"BA";"URUCUCA";91;3;15;109
2011;"UTINGA (BA)";"BA";"UTINGA";64;14;8;86
2011;"VALENCA (BA)";"BA";"VALENCA";663;116;114;893
2011;"VALENTE (BA)";"BA";"VALENTE";124;11;24;159
2011;"VARZEA DA ROCA (BA)";"BA";"VARZEA DA ROCA";38;11;16;65
2011;"VARZEA DO POCO (BA)";"BA";"VARZEA DO POCO";52;12;12;76
2011;"VARZEA NOVA (BA)";"BA";"VARZEA NOVA";50;7;11;68
2011;"VARZEDO (BA)";"BA";"VARZEDO";56;8;19;83
2011;"VERA CRUZ (BA)";"BA";"VERA CRUZ";146;158;27;331
2011;"VEREDA (BA)";"BA";"VEREDA";9;3;2;14
2011;"VITORIA DA CONQUISTA (BA)";"BA";"VITORIA DA CONQUISTA";3763;623;1136;5522
2011;"WAGNER (BA)";"BA";"WAGNER";25;4;14;43
2011;"WANDERLEY (BA)";"BA";"WANDERLEY";54;7;17;78
2011;"WENCESLAU GUIMARAES (BA)";"BA";"WENCESLAU GUIMARAES";119;13;11;143
2011;"XIQUE XIQUE (BA)";"BA";"XIQUE XIQUE";119;16;13;148
2011;"ABAIARA (CE)";"CE";"ABAIARA";10;25;6;41
2011;"ACARAPE (CE)";"CE";"ACARAPE";86;19;135;240
2011;"ACARAU (CE)";"CE";"ACARAU";184;17;47;248
2011;"ACOPIARA (CE)";"CE";"ACOPIARA";300;22;31;353
2011;"AIUABA (CE)";"CE";"AIUABA";21;5;1;27
2011;"ALCANTARAS (CE)";"CE";"ALCANTARAS";40;11;15;66
2011;"ALTANEIRA (CE)";"CE";"ALTANEIRA";16;8;3;27
2011;"ALTO SANTO (CE)";"CE";"ALTO SANTO";147;11;15;173
2011;"AMONTADA (CE)";"CE";"AMONTADA";161;18;16;195
2011;"ANTONINA DO NORTE (CE)";"CE";"ANTONINA DO NORTE";32;4;3;39
2011;"APUIARES (CE)";"CE";"APUIARES";64;7;4;75
2011;"AQUIRAZ (CE)";"CE";"AQUIRAZ";484;111;71;666
2011;"ARACATI (CE)";"CE";"ARACATI";426;75;109;610
2011;"ARACOIABA (CE)";"CE";"ARACOIABA";97;9;15;121
2011;"ARARENDA (CE)";"CE";"ARARENDA";24;3;4;31
2011;"ARARIPE (CE)";"CE";"ARARIPE";53;87;26;166
2011;"ARATUBA (CE)";"CE";"ARATUBA";57;3;12;72
2011;"ARNEIROZ (CE)";"CE";"ARNEIROZ";24;6;2;32
2011;"ASSARE (CE)";"CE";"ASSARE";85;20;6;111
2011;"AURORA (CE)";"CE";"AURORA";72;32;8;112
2011;"BAIXIO (CE)";"CE";"BAIXIO";13;17;5;35
2011;"BANABUIU (CE)";"CE";"BANABUIU";100;10;16;126
2011;"BARBALHA (CE)";"CE";"BARBALHA";304;74;74;452
2011;"BARREIRA (CE)";"CE";"BARREIRA";97;10;10;117
2011;"BARRO (CE)";"CE";"BARRO";48;27;13;88
2011;"BARROQUINHA (CE)";"CE";"BARROQUINHA";32;9;4;45
2011;"BATURITE (CE)";"CE";"BATURITE";190;20;29;239
2011;"BEBERIBE (CE)";"CE";"BEBERIBE";205;53;52;310
2011;"BELA CRUZ (CE)";"CE";"BELA CRUZ";95;8;25;128
2011;"BOA VIAGEM (CE)";"CE";"BOA VIAGEM";373;16;40;429
2011;"BREJO SANTO (CE)";"CE";"BREJO SANTO";338;77;53;468
2011;"CAMOCIM (CE)";"CE";"CAMOCIM";173;36;29;238
2011;"CAMPOS SALES (CE)";"CE";"CAMPOS SALES";185;67;39;291
2011;"CANINDE (CE)";"CE";"CANINDE";504;19;55;578
2011;"CAPISTRANO (CE)";"CE";"CAPISTRANO";62;7;14;83
2011;"CARIDADE (CE)";"CE";"CARIDADE";65;6;10;81
2011;"CARIRE (CE)";"CE";"CARIRE";51;16;21;88
2011;"CARIRIACU (CE)";"CE";"CARIRIACU";53;32;11;96
2011;"CARIUS (CE)";"CE";"CARIUS";46;19;5;70
2011;"CARNAUBAL (CE)";"CE";"CARNAUBAL";73;22;8;103
2011;"CASCAVEL (CE)";"CE";"CASCAVEL";420;42;96;558
2011;"CATARINA (CE)";"CE";"CATARINA";37;3;1;41
2011;"CATUNDA (CE)";"CE";"CATUNDA";28;10;5;43
2011;"CAUCAIA (CE)";"CE";"CAUCAIA";1347;191;342;1880
2011;"CEDRO (CE)";"CE";"CEDRO";79;30;25;134
2011;"CHAVAL (CE)";"CE";"CHAVAL";27;11;7;45
2011;"CHORO (CE)";"CE";"CHORO";54;10;15;79
2011;"CHOROZINHO (CE)";"CE";"CHOROZINHO";108;14;35;157
2011;"COREAU (CE)";"CE";"COREAU";94;13;25;132
2011;"CRATEUS (CE)";"CE";"CRATEUS";302;59;76;437
2011;"CRATO (CE)";"CE";"CRATO";864;105;84;1053
2011;"CROATA (CE)";"CE";"CROATA";51;15;9;75
2011;"CRUZ (CE)";"CE";"CRUZ";112;24;48;184
2011;"DEPUTADO IRAPUAN PINHEIRO (CE)";"CE";"DEPUTADO IRAPUAN PINHEIRO";23;5;8;36
2011;"ERERE (CE)";"CE";"ERERE";2;1;2;5
2011;"EUSEBIO (CE)";"CE";"EUSEBIO";941;50;48;1039
2011;"FARIAS BRITO (CE)";"CE";"FARIAS BRITO";76;31;16;123
2011;"FORQUILHA (CE)";"CE";"FORQUILHA";103;32;30;165
2011;"FORTALEZA (CE)";"CE";"FORTALEZA";19938;2825;6045;28808
2011;"FORTIM (CE)";"CE";"FORTIM";26;27;14;67
2011;"FRECHEIRINHA (CE)";"CE";"FRECHEIRINHA";76;12;18;106
2011;"GENERAL SAMPAIO (CE)";"CE";"GENERAL SAMPAIO";31;1;3;35
2011;"GRACA (CE)";"CE";"GRACA";24;6;6;36
2011;"GRANJA (CE)";"CE";"GRANJA";163;30;20;213
2011;"GRANJEIRO (CE)";"CE";"GRANJEIRO";9;5;2;16
2011;"GROAIRAS (CE)";"CE";"GROAIRAS";53;24;16;93
2011;"GUAIUBA (CE)";"CE";"GUAIUBA";71;23;10;104
2011;"GUARACIABA DO NORTE (CE)";"CE";"GUARACIABA DO NORTE";356;13;18;387
2011;"GUARAMIRANGA (CE)";"CE";"GUARAMIRANGA";31;1;6;38
2011;"HIDROLANDIA (CE)";"CE";"HIDROLANDIA";114;17;13;144
2011;"HORIZONTE (CE)";"CE";"HORIZONTE";354;79;70;503
2011;"IBARETAMA (CE)";"CE";"IBARETAMA";53;9;18;80
2011;"IBIAPINA (CE)";"CE";"IBIAPINA";128;26;21;175
2011;"IBICUITINGA (CE)";"CE";"IBICUITINGA";66;4;8;78
2011;"ICAPUI (CE)";"CE";"ICAPUI";68;23;45;136
2011;"ICO (CE)";"CE";"ICO";287;60;53;400
2011;"IGUATU (CE)";"CE";"IGUATU";934;57;101;1092
2011;"INDEPENDENCIA (CE)";"CE";"INDEPENDENCIA";199;3;18;220
2011;"IPAPORANGA (CE)";"CE";"IPAPORANGA";24;4;4;32
2011;"IPAUMIRIM (CE)";"CE";"IPAUMIRIM";211;48;33;292
2011;"IPU (CE)";"CE";"IPU";247;29;26;302
2011;"IPUEIRAS (CE)";"CE";"IPUEIRAS";76;19;7;102
2011;"IRACEMA (CE)";"CE";"IRACEMA";58;9;10;77
2011;"IRAUCUBA (CE)";"CE";"IRAUCUBA";88;14;17;119
2011;"ITAICABA (CE)";"CE";"ITAICABA";27;4;11;42
2011;"ITAITINGA (CE)";"CE";"ITAITINGA";302;59;21;382
2011;"ITAPAJE (CE)";"CE";"ITAPAJE";241;28;23;292
2011;"ITAPIPOCA (CE)";"CE";"ITAPIPOCA";701;24;38;763
2011;"ITAPIUNA (CE)";"CE";"ITAPIUNA";70;5;13;88
2011;"ITAREMA (CE)";"CE";"ITAREMA";112;10;34;156
2011;"ITATIRA (CE)";"CE";"ITATIRA";105;5;10;120
2011;"JAGUARETAMA (CE)";"CE";"JAGUARETAMA";87;5;13;105
2011;"JAGUARIBARA (CE)";"CE";"JAGUARIBARA";66;9;9;84
2011;"JAGUARIBE (CE)";"CE";"JAGUARIBE";344;21;23;388
2011;"JAGUARUANA (CE)";"CE";"JAGUARUANA";219;11;10;240
2011;"JARDIM (CE)";"CE";"JARDIM";74;63;5;142
2011;"JATI (CE)";"CE";"JATI";22;23;5;50
2011;"JIJOCA DE JERICOACOARA (CE)";"CE";"JIJOCA DE JERICOACOARA";59;12;11;82
2011;"JUAZEIRO DO NORTE (CE)";"CE";"JUAZEIRO DO NORTE";1647;166;212;2025
2011;"JUCAS (CE)";"CE";"JUCAS";92;7;20;119
2011;"LAVRAS DA MANGABEIRA (CE)";"CE";"LAVRAS DA MANGABEIRA";86;19;18;123
2011;"LIMOEIRO DO NORTE (CE)";"CE";"LIMOEIRO DO NORTE";631;25;117;773
2011;"MADALENA (CE)";"CE";"MADALENA";85;4;13;102
2011;"MARACANAU (CE)";"CE";"MARACANAU";1376;205;301;1882
2011;"MARANGUAPE (CE)";"CE";"MARANGUAPE";510;97;187;794
2011;"MARCO (CE)";"CE";"MARCO";213;13;12;238
2011;"MARTINOPOLE (CE)";"CE";"MARTINOPOLE";24;11;2;37
2011;"MASSAPE (CE)";"CE";"MASSAPE";81;23;64;168
2011;"MAURITI (CE)";"CE";"MAURITI";113;56;36;205
2011;"MERUOCA (CE)";"CE";"MERUOCA";35;11;10;56
2011;"MILAGRES (CE)";"CE";"MILAGRES";89;38;13;140
2011;"MILHA (CE)";"CE";"MILHA";59;5;11;75
2011;"MIRAIMA (CE)";"CE";"MIRAIMA";27;1;4;32
2011;"MISSAO VELHA (CE)";"CE";"MISSAO VELHA";183;60;10;253
2011;"MOMBACA (CE)";"CE";"MOMBACA";215;13;11;239
2011;"MONSENHOR TABOSA (CE)";"CE";"MONSENHOR TABOSA";60;6;3;69
2011;"MORADA NOVA (CE)";"CE";"MORADA NOVA";407;42;69;518
2011;"MORAUJO (CE)";"CE";"MORAUJO";19;5;6;30
2011;"MORRINHOS (CE)";"CE";"MORRINHOS";75;13;14;102
2011;"MUCAMBO (CE)";"CE";"MUCAMBO";32;18;8;58
2011;"MULUNGU (CE)";"CE";"MULUNGU";60;6;5;71
2011;"NOVA OLINDA (CE)";"CE";"NOVA OLINDA";91;30;8;129
2011;"NOVA RUSSAS (CE)";"CE";"NOVA RUSSAS";182;14;7;203
2011;"NOVO ORIENTE (CE)";"CE";"NOVO ORIENTE";61;26;8;95
2011;"OCARA (CE)";"CE";"OCARA";112;14;39;165
2011;"OROS (CE)";"CE";"OROS";117;23;18;158
2011;"PACAJUS (CE)";"CE";"PACAJUS";590;84;157;831
2011;"PACATUBA (CE)";"CE";"PACATUBA";158;71;18;247
2011;"PACOTI (CE)";"CE";"PACOTI";98;3;11;112
2011;"PACUJA (CE)";"CE";"PACUJA";32;4;10;46
2011;"PALHANO (CE)";"CE";"PALHANO";52;11;12;75
2011;"PALMACIA (CE)";"CE";"PALMACIA";38;14;11;63
2011;"PARACURU (CE)";"CE";"PARACURU";181;19;24;224
2011;"PARAIPABA (CE)";"CE";"PARAIPABA";186;14;16;216
2011;"PARAMBU (CE)";"CE";"PARAMBU";186;3;10;199
2011;"PARAMOTI (CE)";"CE";"PARAMOTI";53;5;9;67
2011;"PEDRA BRANCA (CE)";"CE";"PEDRA BRANCA";239;16;21;276
2011;"PENAFORTE (CE)";"CE";"PENAFORTE";31;31;19;81
2011;"PENTECOSTE (CE)";"CE";"PENTECOSTE";214;12;12;238
2011;"PEREIRO (CE)";"CE";"PEREIRO";78;13;23;114
2011;"PINDORETAMA (CE)";"CE";"PINDORETAMA";137;23;11;171
2011;"PIQUET CARNEIRO (CE)";"CE";"PIQUET CARNEIRO";36;5;9;50
2011;"PIRES FERREIRA (CE)";"CE";"PIRES FERREIRA";16;5;3;24
2011;"PORANGA (CE)";"CE";"PORANGA";15;8;2;25
2011;"PORTEIRAS (CE)";"CE";"PORTEIRAS";21;115;18;154
2011;"POTENGI (CE)";"CE";"POTENGI";24;5;4;33
2011;"POTIRETAMA (CE)";"CE";"POTIRETAMA";27;3;6;36
2011;"QUITERIANOPOLIS (CE)";"CE";"QUITERIANOPOLIS";46;11;6;63
2011;"QUIXADA (CE)";"CE";"QUIXADA";651;44;80;775
2011;"QUIXELO (CE)";"CE";"QUIXELO";50;18;24;92
2011;"QUIXERAMOBIM (CE)";"CE";"QUIXERAMOBIM";412;32;85;529
2011;"QUIXERE (CE)";"CE";"QUIXERE";181;13;40;234
2011;"REDENCAO (CE)";"CE";"REDENCAO";198;28;32;258
2011;"RERIUTABA (CE)";"CE";"RERIUTABA";76;18;20;114
2011;"RUSSAS (CE)";"CE";"RUSSAS";734;40;95;869
2011;"SABOEIRO (CE)";"CE";"SABOEIRO";35;11;4;50
2011;"SALITRE (CE)";"CE";"SALITRE";58;6;22;86
2011;"SANTA QUITERIA (CE)";"CE";"SANTA QUITERIA";253;31;9;293
2011;"SANTANA DO ACARAU (CE)";"CE";"SANTANA DO ACARAU";130;27;22;179
2011;"SANTANA DO CARIRI (CE)";"CE";"SANTANA DO CARIRI";57;26;11;94
2011;"SAO BENEDITO (CE)";"CE";"SAO BENEDITO";387;77;45;509
2011;"SAO GONCALO DO AMARANTE (CE)";"CE";"SAO GONCALO DO AMARANTE";265;61;127;453
2011;"SAO JOAO DO JAGUARIBE (CE)";"CE";"SAO JOAO DO JAGUARIBE";47;3;13;63
2011;"SAO LUIS DO CURU (CE)";"CE";"SAO LUIS DO CURU";53;3;11;67
2011;"SENADOR POMPEU (CE)";"CE";"SENADOR POMPEU";151;13;30;194
2011;"SENADOR SA (CE)";"CE";"SENADOR SA";19;4;12;35
2011;"SOBRAL (CE)";"CE";"SOBRAL";1387;205;284;1876
2011;"SOLONOPOLE (CE)";"CE";"SOLONOPOLE";80;5;12;97
2011;"TABULEIRO DO NORTE (CE)";"CE";"TABULEIRO DO NORTE";331;33;45;409
2011;"TAMBORIL (CE)";"CE";"TAMBORIL";74;16;20;110
2011;"TARRAFAS (CE)";"CE";"TARRAFAS";15;4;4;23
2011;"TAUA (CE)";"CE";"TAUA";393;30;37;460
2011;"TEJUCUOCA (CE)";"CE";"TEJUCUOCA";70;3;7;80
2011;"TIANGUA (CE)";"CE";"TIANGUA";1270;167;126;1563
2011;"TRAIRI (CE)";"CE";"TRAIRI";175;19;33;227
2011;"TURURU (CE)";"CE";"TURURU";46;6;3;55
2011;"UBAJARA (CE)";"CE";"UBAJARA";255;20;42;317
2011;"UMARI (CE)";"CE";"UMARI";5;3;5;13
2011;"UMIRIM (CE)";"CE";"UMIRIM";50;34;14;98
2011;"URUBURETAMA (CE)";"CE";"URUBURETAMA";65;9;37;111
2011;"URUOCA (CE)";"CE";"URUOCA";54;9;14;77
2011;"VARJOTA (CE)";"CE";"VARJOTA";119;27;6;152
2011;"VARZEA ALEGRE (CE)";"CE";"VARZEA ALEGRE";215;43;40;298
2011;"VICOSA DO CEARA (CE)";"CE";"VICOSA DO CEARA";294;36;50;380
2011;"BRASILIA (DF)";"DF";"BRASILIA";20371;4666;8719;33756
2011;"AFONSO CLAUDIO (ES)";"ES";"AFONSO CLAUDIO";495;68;103;666
2011;"AGUA DOCE DO NORTE (ES)";"ES";"AGUA DOCE DO NORTE";94;15;24;133
2011;"AGUIA BRANCA (ES)";"ES";"AGUIA BRANCA";139;3;22;164
2011;"ALEGRE (ES)";"ES";"ALEGRE";201;33;25;259
2011;"ALFREDO CHAVES (ES)";"ES";"ALFREDO CHAVES";421;25;33;479
2011;"ALTO RIO NOVO (ES)";"ES";"ALTO RIO NOVO";89;21;21;131
2011;"ANCHIETA (ES)";"ES";"ANCHIETA";259;57;44;360
2011;"APIACA (ES)";"ES";"APIACA";72;17;3;92
2011;"ARACRUZ (ES)";"ES";"ARACRUZ";1188;176;534;1898
2011;"ATILIO VIVACQUA (ES)";"ES";"ATILIO VIVACQUA";175;9;17;201
2011;"BAIXO GUANDU (ES)";"ES";"BAIXO GUANDU";497;26;60;583
2011;"BARRA DE SAO FRANCISCO (ES)";"ES";"BARRA DE SAO FRANCISCO";489;30;106;625
2011;"BOA ESPERANCA (ES)";"ES";"BOA ESPERANCA";220;11;40;271
2011;"BOM JESUS DO NORTE (ES)";"ES";"BOM JESUS DO NORTE";181;31;21;233
2011;"BREJETUBA (ES)";"ES";"BREJETUBA";189;16;47;252
2011;"CACHOEIRO DE ITAPEMIRIM (ES)";"ES";"CACHOEIRO DE ITAPEMIRIM";4633;190;1938;6761
2011;"CARIACICA (ES)";"ES";"CARIACICA";5027;537;1528;7092
2011;"CASTELO (ES)";"ES";"CASTELO";1265;75;66;1406
2011;"COLATINA (ES)";"ES";"COLATINA";2303;141;477;2921
2011;"CONCEICAO DA BARRA (ES)";"ES";"CONCEICAO DA BARRA";235;13;112;360
2011;"CONCEICAO DO CASTELO (ES)";"ES";"CONCEICAO DO CASTELO";244;56;47;347
2011;"DIVINO DE SAO LOURENCO (ES)";"ES";"DIVINO DE SAO LOURENCO";43;8;8;59
2011;"DOMINGOS MARTINS (ES)";"ES";"DOMINGOS MARTINS";981;91;73;1145
2011;"DORES DO RIO PRETO (ES)";"ES";"DORES DO RIO PRETO";117;17;15;149
2011;"ECOPORANGA (ES)";"ES";"ECOPORANGA";142;35;76;253
2011;"FUNDAO (ES)";"ES";"FUNDAO";313;47;39;399
2011;"GOVERNADOR LINDENBERG (ES)";"ES";"GOVERNADOR LINDENBERG";231;6;4;241
2011;"GUACUI (ES)";"ES";"GUACUI";435;43;41;519
2011;"GUARAPARI (ES)";"ES";"GUARAPARI";1040;267;202;1509
2011;"IBATIBA (ES)";"ES";"IBATIBA";416;37;48;501
2011;"IBIRACU (ES)";"ES";"IBIRACU";357;29;33;419
2011;"IBITIRAMA (ES)";"ES";"IBITIRAMA";112;17;15;144
2011;"ICONHA (ES)";"ES";"ICONHA";654;18;59;731
2011;"IRUPI (ES)";"ES";"IRUPI";196;33;20;249
2011;"ITAGUACU (ES)";"ES";"ITAGUACU";247;12;55;314
2011;"ITAPEMIRIM (ES)";"ES";"ITAPEMIRIM";438;38;52;528
2011;"ITARANA (ES)";"ES";"ITARANA";311;28;35;374
2011;"IUNA (ES)";"ES";"IUNA";370;46;77;493
2011;"JAGUARE (ES)";"ES";"JAGUARE";376;13;71;460
2011;"JERONIMO MONTEIRO (ES)";"ES";"JERONIMO MONTEIRO";78;16;10;104
2011;"JOAO NEIVA (ES)";"ES";"JOAO NEIVA";316;18;25;359
2011;"LARANJA DA TERRA (ES)";"ES";"LARANJA DA TERRA";260;13;26;299
2011;"LINHARES (ES)";"ES";"LINHARES";2642;131;413;3186
2011;"MANTENOPOLIS (ES)";"ES";"MANTENOPOLIS";142;17;25;184
2011;"MARATAIZES (ES)";"ES";"MARATAIZES";814;36;53;903
2011;"MARECHAL FLORIANO (ES)";"ES";"MARECHAL FLORIANO";626;36;21;683
2011;"MARILANDIA (ES)";"ES";"MARILANDIA";362;17;19;398
2011;"MIMOSO DO SUL (ES)";"ES";"MIMOSO DO SUL";253;28;68;349
2011;"MONTANHA (ES)";"ES";"MONTANHA";195;11;30;236
2011;"MUCURICI (ES)";"ES";"MUCURICI";52;8;17;77
2011;"MUNIZ FREIRE (ES)";"ES";"MUNIZ FREIRE";173;35;37;245
2011;"MUQUI (ES)";"ES";"MUQUI";152;16;25;193
2011;"NOVA VENECIA (ES)";"ES";"NOVA VENECIA";814;41;163;1018
2011;"PANCAS (ES)";"ES";"PANCAS";260;27;14;301
2011;"PEDRO CANARIO (ES)";"ES";"PEDRO CANARIO";429;39;218;686
2011;"PINHEIROS (ES)";"ES";"PINHEIROS";305;22;121;448
2011;"PIUMA (ES)";"ES";"PIUMA";194;35;13;242
2011;"PONTO BELO (ES)";"ES";"PONTO BELO";49;5;16;70
2011;"PRESIDENTE KENNEDY (ES)";"ES";"PRESIDENTE KENNEDY";262;18;21;301
2011;"RIO BANANAL (ES)";"ES";"RIO BANANAL";522;15;48;585
2011;"RIO NOVO DO SUL (ES)";"ES";"RIO NOVO DO SUL";295;9;25;329
2011;"SANTA LEOPOLDINA (ES)";"ES";"SANTA LEOPOLDINA";371;32;30;433
2011;"SANTA MARIA DE JETIBA (ES)";"ES";"SANTA MARIA DE JETIBA";1856;87;56;1999
2011;"SANTA TERESA (ES)";"ES";"SANTA TERESA";651;40;91;782
2011;"SAO DOMINGOS DO NORTE (ES)";"ES";"SAO DOMINGOS DO NORTE";204;9;19;232
2011;"SAO GABRIEL DA PALHA (ES)";"ES";"SAO GABRIEL DA PALHA";598;16;99;713
2011;"SAO JOSE DO CALCADO (ES)";"ES";"SAO JOSE DO CALCADO";81;14;16;111
2011;"SAO MATEUS (ES)";"ES";"SAO MATEUS";1008;101;350;1459
2011;"SAO ROQUE DO CANAA (ES)";"ES";"SAO ROQUE DO CANAA";284;16;25;325
2011;"SERRA (ES)";"ES";"SERRA";8086;528;2221;10835
2011;"SOORETAMA (ES)";"ES";"SOORETAMA";277;16;50;343
2011;"VARGEM ALTA (ES)";"ES";"VARGEM ALTA";440;23;55;518
2011;"VENDA NOVA DO IMIGRANTE (ES)";"ES";"VENDA NOVA DO IMIGRANTE";779;21;111;911
2011;"VIANA (ES)";"ES";"VIANA";1111;78;324;1513
2011;"VILA PAVAO (ES)";"ES";"VILA PAVAO";121;4;21;146
2011;"VILA VALERIO (ES)";"ES";"VILA VALERIO";329;7;32;368
2011;"VILA VELHA (ES)";"ES";"VILA VELHA";4032;754;817;5603
2011;"VITORIA (ES)";"ES";"VITORIA";3565;1088;1016;5669
2011;"ABADIA DE GOIAS (GO)";"GO";"ABADIA DE GOIAS";80;7;4;91
2011;"ABADIANIA (GO)";"GO";"ABADIANIA";260;22;18;300
2011;"ACREUNA (GO)";"GO";"ACREUNA";376;7;79;462
2011;"ADELANDIA (GO)";"GO";"ADELANDIA";28;1;7;36
2011;"AGUA FRIA DE GOIAS (GO)";"GO";"AGUA FRIA DE GOIAS";30;8;13;51
2011;"AGUA LIMPA (GO)";"GO";"AGUA LIMPA";18;6;2;26
2011;"AGUAS LINDAS DE GOIAS (GO)";"GO";"AGUAS LINDAS DE GOIAS";705;118;377;1200
2011;"ALEXANIA (GO)";"GO";"ALEXANIA";332;28;23;383
2011;"ALOANDIA (GO)";"GO";"ALOANDIA";23;3;2;28
2011;"ALTO HORIZONTE (GO)";"GO";"ALTO HORIZONTE";37;5;13;55
2011;"ALTO PARAISO DE GOIAS (GO)";"GO";"ALTO PARAISO DE GOIAS";55;6;12;73
2011;"ALVORADA DO NORTE (GO)";"GO";"ALVORADA DO NORTE";127;4;9;140
2011;"AMARALINA (GO)";"GO";"AMARALINA";10;2;6;18
2011;"AMERICANO DO BRASIL (GO)";"GO";"AMERICANO DO BRASIL";54;7;14;75
2011;"AMORINOPOLIS (GO)";"GO";"AMORINOPOLIS";34;3;8;45
2011;"ANAPOLIS (GO)";"GO";"ANAPOLIS";9632;260;1552;11444
2011;"ANHANGUERA (GO)";"GO";"ANHANGUERA";5;2;1;8
2011;"ANICUNS (GO)";"GO";"ANICUNS";339;22;100;461
2011;"APARECIDA DE GOIANIA (GO)";"GO";"APARECIDA DE GOIANIA";5713;260;558;6531
2011;"APARECIDA DO RIO DOCE (GO)";"GO";"APARECIDA DO RIO DOCE";37;3;10;50
2011;"APORE (GO)";"GO";"APORE";63;13;19;95
2011;"ARACU (GO)";"GO";"ARACU";24;3;4;31
2011;"ARAGARCAS (GO)";"GO";"ARAGARCAS";431;8;28;467
2011;"ARAGOIANIA (GO)";"GO";"ARAGOIANIA";72;1;9;82
2011;"ARAGUAPAZ (GO)";"GO";"ARAGUAPAZ";82;5;10;97
2011;"ARENOPOLIS (GO)";"GO";"ARENOPOLIS";11;6;2;19
2011;"ARUANA (GO)";"GO";"ARUANA";29;2;10;41
2011;"AURILANDIA (GO)";"GO";"AURILANDIA";22;4;1;27
2011;"AVELINOPOLIS (GO)";"GO";"AVELINOPOLIS";46;3;0;49
2011;"BALIZA (GO)";"GO";"BALIZA";5;0;3;8
2011;"BARRO ALTO (GO)";"GO";"BARRO ALTO";138;17;89;244
2011;"BELA VISTA DE GOIAS (GO)";"GO";"BELA VISTA DE GOIAS";347;16;32;395
2011;"BOM JARDIM DE GOIAS (GO)";"GO";"BOM JARDIM DE GOIAS";110;6;16;132
2011;"BOM JESUS (GO)";"GO";"BOM JESUS";351;37;94;482
2011;"BONFINOPOLIS (GO)";"GO";"BONFINOPOLIS";49;3;8;60
2011;"BONOPOLIS (GO)";"GO";"BONOPOLIS";13;2;3;18
2011;"BRAZABRANTES (GO)";"GO";"BRAZABRANTES";59;1;2;62
2011;"BRITANIA (GO)";"GO";"BRITANIA";72;5;3;80
2011;"BURITI ALEGRE (GO)";"GO";"BURITI ALEGRE";180;36;12;228
2011;"BURITI DE GOIAS (GO)";"GO";"BURITI DE GOIAS";14;9;2;25
2011;"BURITINOPOLIS (GO)";"GO";"BURITINOPOLIS";17;2;5;24
2011;"CABECEIRAS (GO)";"GO";"CABECEIRAS";173;8;28;209
2011;"CACHOEIRA ALTA (GO)";"GO";"CACHOEIRA ALTA";140;21;30;191
2011;"CACHOEIRA DE GOIAS (GO)";"GO";"CACHOEIRA DE GOIAS";6;2;1;9
2011;"CACHOEIRA DOURADA (GO)";"GO";"CACHOEIRA DOURADA";82;11;31;124
2011;"CACU (GO)";"GO";"CACU";223;12;32;267
2011;"CAIAPONIA (GO)";"GO";"CAIAPONIA";153;3;6;162
2011;"CALDAS NOVAS (GO)";"GO";"CALDAS NOVAS";649;76;88;813
2011;"CALDAZINHA (GO)";"GO";"CALDAZINHA";30;3;2;35
2011;"CAMPESTRE DE GOIAS (GO)";"GO";"CAMPESTRE DE GOIAS";38;3;5;46
2011;"CAMPINACU (GO)";"GO";"CAMPINACU";14;2;5;21
2011;"CAMPINORTE (GO)";"GO";"CAMPINORTE";146;13;12;171
2011;"CAMPO ALEGRE DE GOIAS (GO)";"GO";"CAMPO ALEGRE DE GOIAS";126;9;17;152
2011;"CAMPO LIMPO DE GOIAS (GO)";"GO";"CAMPO LIMPO DE GOIAS";109;0;5;114
2011;"CAMPOS BELOS (GO)";"GO";"CAMPOS BELOS";200;9;41;250
2011;"CAMPOS VERDES (GO)";"GO";"CAMPOS VERDES";34;4;1;39
2011;"CARMO DO RIO VERDE (GO)";"GO";"CARMO DO RIO VERDE";78;10;52;140
2011;"CASTELANDIA (GO)";"GO";"CASTELANDIA";46;5;9;60
2011;"CATALAO (GO)";"GO";"CATALAO";1624;142;263;2029
2011;"CATURAI (GO)";"GO";"CATURAI";45;2;7;54
2011;"CAVALCANTE (GO)";"GO";"CAVALCANTE";30;3;4;37
2011;"CERES (GO)";"GO";"CERES";460;19;28;507
2011;"CEZARINA (GO)";"GO";"CEZARINA";106;6;19;131
2011;"CHAPADAO DO CEU (GO)";"GO";"CHAPADAO DO CEU";198;17;16;231
2011;"CIDADE OCIDENTAL (GO)";"GO";"CIDADE OCIDENTAL";113;46;59;218
2011;"COCALZINHO DE GOIAS (GO)";"GO";"COCALZINHO DE GOIAS";130;18;18;166
2011;"COLINAS DO SUL (GO)";"GO";"COLINAS DO SUL";9;3;2;14
2011;"CORREGO DO OURO (GO)";"GO";"CORREGO DO OURO";18;2;3;23
2011;"CORUMBA DE GOIAS (GO)";"GO";"CORUMBA DE GOIAS";70;10;18;98
2011;"CORUMBAIBA (GO)";"GO";"CORUMBAIBA";131;22;8;161
2011;"CRISTALINA (GO)";"GO";"CRISTALINA";1666;78;405;2149
2011;"CRISTIANOPOLIS (GO)";"GO";"CRISTIANOPOLIS";48;10;1;59
2011;"CRIXAS (GO)";"GO";"CRIXAS";126;14;14;154
2011;"CROMINIA (GO)";"GO";"CROMINIA";41;4;2;47
2011;"CUMARI (GO)";"GO";"CUMARI";31;7;0;38
2011;"DAMIANOPOLIS (GO)";"GO";"DAMIANOPOLIS";18;2;7;27
2011;"DAMOLANDIA (GO)";"GO";"DAMOLANDIA";39;5;3;47
2011;"DAVINOPOLIS (GO)";"GO";"DAVINOPOLIS";24;4;3;31
2011;"DIORAMA (GO)";"GO";"DIORAMA";7;5;4;16
2011;"DIVINOPOLIS DE GOIAS (GO)";"GO";"DIVINOPOLIS DE GOIAS";20;0;6;26
2011;"DOVERLANDIA (GO)";"GO";"DOVERLANDIA";101;4;31;136
2011;"EDEALINA (GO)";"GO";"EDEALINA";61;6;7;74
2011;"EDEIA (GO)";"GO";"EDEIA";160;8;11;179
2011;"ESTRELA DO NORTE (GO)";"GO";"ESTRELA DO NORTE";24;2;2;28
2011;"FAINA (GO)";"GO";"FAINA";40;14;5;59
2011;"FAZENDA NOVA (GO)";"GO";"FAZENDA NOVA";37;4;7;48
2011;"FIRMINOPOLIS (GO)";"GO";"FIRMINOPOLIS";81;1;5;87
2011;"FLORES DE GOIAS (GO)";"GO";"FLORES DE GOIAS";31;4;8;43
2011;"FORMOSA (GO)";"GO";"FORMOSA";2807;136;565;3508
2011;"FORMOSO (GO)";"GO";"FORMOSO";32;6;5;43
2011;"GAMELEIRA DE GOIAS (GO)";"GO";"GAMELEIRA DE GOIAS";15;7;11;33
2011;"GOIANAPOLIS (GO)";"GO";"GOIANAPOLIS";190;6;10;206
2011;"GOIANDIRA (GO)";"GO";"GOIANDIRA";49;6;4;59
2011;"GOIANESIA (GO)";"GO";"GOIANESIA";882;78;230;1190
2011;"GOIANIA (GO)";"GO";"GOIANIA";24513;1885;6243;32641
2011;"GOIANIRA (GO)";"GO";"GOIANIRA";242;8;59;309
2011;"GOIAS (GO)";"GO";"GOIAS";186;17;35;238
2011;"GOIATUBA (GO)";"GO";"GOIATUBA";679;34;71;784
2011;"GOUVELANDIA (GO)";"GO";"GOUVELANDIA";55;9;6;70
2011;"GUAPO (GO)";"GO";"GUAPO";165;23;23;211
2011;"GUARAITA (GO)";"GO";"GUARAITA";17;1;2;20
2011;"GUARANI DE GOIAS (GO)";"GO";"GUARANI DE GOIAS";11;3;8;22
2011;"GUARINOS (GO)";"GO";"GUARINOS";4;5;2;11
2011;"HEITORAI (GO)";"GO";"HEITORAI";26;2;5;33
2011;"HIDROLANDIA (GO)";"GO";"HIDROLANDIA";340;16;36;392
2011;"HIDROLINA (GO)";"GO";"HIDROLINA";17;0;2;19
2011;"IACIARA (GO)";"GO";"IACIARA";114;5;14;133
2011;"INACIOLANDIA (GO)";"GO";"INACIOLANDIA";41;7;6;54
2011;"INDIARA (GO)";"GO";"INDIARA";193;9;19;221
2011;"INHUMAS (GO)";"GO";"INHUMAS";979;38;150;1167
2011;"IPAMERI (GO)";"GO";"IPAMERI";272;53;70;395
2011;"IPIRANGA DE GOIAS (GO)";"GO";"IPIRANGA DE GOIAS";24;6;6;36
2011;"IPORA (GO)";"GO";"IPORA";410;21;45;476
2011;"ISRAELANDIA (GO)";"GO";"ISRAELANDIA";20;2;6;28
2011;"ITABERAI (GO)";"GO";"ITABERAI";609;23;63;695
2011;"ITAGUARI (GO)";"GO";"ITAGUARI";55;7;10;72
2011;"ITAGUARU (GO)";"GO";"ITAGUARU";62;6;9;77
2011;"ITAJA (GO)";"GO";"ITAJA";68;6;14;88
2011;"ITAPACI (GO)";"GO";"ITAPACI";143;19;54;216
2011;"ITAPIRAPUA (GO)";"GO";"ITAPIRAPUA";56;3;9;68
2011;"ITAPURANGA (GO)";"GO";"ITAPURANGA";304;20;64;388
2011;"ITARUMA (GO)";"GO";"ITARUMA";78;11;11;100
2011;"ITAUCU (GO)";"GO";"ITAUCU";84;8;10;102
2011;"ITUMBIARA (GO)";"GO";"ITUMBIARA";1975;186;347;2508
2011;"IVOLANDIA (GO)";"GO";"IVOLANDIA";6;3;2;11
2011;"JANDAIA (GO)";"GO";"JANDAIA";99;3;11;113
2011;"JARAGUA (GO)";"GO";"JARAGUA";336;24;38;398
2011;"JATAI (GO)";"GO";"JATAI";2009;96;202;2307
2011;"JAUPACI (GO)";"GO";"JAUPACI";24;4;5;33
2011;"JESUPOLIS (GO)";"GO";"JESUPOLIS";16;2;5;23
2011;"JOVIANIA (GO)";"GO";"JOVIANIA";116;11;21;148
2011;"JUSSARA (GO)";"GO";"JUSSARA";342;13;14;369
2011;"LAGOA SANTA (GO)";"GO";"LAGOA SANTA";10;2;6;18
2011;"LEOPOLDO DE BULHOES (GO)";"GO";"LEOPOLDO DE BULHOES";109;9;6;124
2011;"LUZIANIA (GO)";"GO";"LUZIANIA";2089;133;373;2595
2011;"MAIRIPOTABA (GO)";"GO";"MAIRIPOTABA";19;4;4;27
2011;"MAMBAI (GO)";"GO";"MAMBAI";63;3;13;79
2011;"MARA ROSA (GO)";"GO";"MARA ROSA";102;5;15;122
2011;"MARZAGAO (GO)";"GO";"MARZAGAO";25;5;0;30
2011;"MATRINCHA (GO)";"GO";"MATRINCHA";30;5;7;42
2011;"MAURILANDIA (GO)";"GO";"MAURILANDIA";333;16;99;448
2011;"MIMOSO DE GOIAS (GO)";"GO";"MIMOSO DE GOIAS";7;1;4;12
2011;"MINACU (GO)";"GO";"MINACU";405;40;34;479
2011;"MINEIROS (GO)";"GO";"MINEIROS";1135;71;144;1350
2011;"MOIPORA (GO)";"GO";"MOIPORA";7;4;1;12
2011;"MONTE ALEGRE DE GOIAS (GO)";"GO";"MONTE ALEGRE DE GOIAS";15;3;5;23
2011;"MONTES CLAROS DE GOIAS (GO)";"GO";"MONTES CLAROS DE GOIAS";67;12;23;102
2011;"MONTIVIDIU (GO)";"GO";"MONTIVIDIU";315;12;51;378
2011;"MONTIVIDIU DO NORTE (GO)";"GO";"MONTIVIDIU DO NORTE";18;2;19;39
2011;"MORRINHOS (GO)";"GO";"MORRINHOS";687;44;89;820
2011;"MORRO AGUDO DE GOIAS (GO)";"GO";"MORRO AGUDO DE GOIAS";18;5;2;25
2011;"MOSSAMEDES (GO)";"GO";"MOSSAMEDES";36;7;3;46
2011;"MOZARLANDIA (GO)";"GO";"MOZARLANDIA";109;5;26;140
2011;"MUNDO NOVO (GO)";"GO";"MUNDO NOVO";25;6;15;46
2011;"MUTUNOPOLIS (GO)";"GO";"MUTUNOPOLIS";26;3;12;41
2011;"NAZARIO (GO)";"GO";"NAZARIO";97;8;9;114
2011;"NEROPOLIS (GO)";"GO";"NEROPOLIS";428;12;18;458
2011;"NIQUELANDIA (GO)";"GO";"NIQUELANDIA";531;57;138;726
2011;"NOVA AMERICA (GO)";"GO";"NOVA AMERICA";18;1;2;21
2011;"NOVA AURORA (GO)";"GO";"NOVA AURORA";29;3;4;36
2011;"NOVA CRIXAS (GO)";"GO";"NOVA CRIXAS";63;8;28;99
2011;"NOVA GLORIA (GO)";"GO";"NOVA GLORIA";65;6;22;93
2011;"NOVA IGUACU DE GOIAS (GO)";"GO";"NOVA IGUACU DE GOIAS";15;4;3;22
2011;"NOVA ROMA (GO)";"GO";"NOVA ROMA";4;3;4;11
2011;"NOVA VENEZA (GO)";"GO";"NOVA VENEZA";175;9;13;197
2011;"NOVO BRASIL (GO)";"GO";"NOVO BRASIL";21;3;1;25
2011;"NOVO GAMA (GO)";"GO";"NOVO GAMA";313;66;112;491
2011;"NOVO PLANALTO (GO)";"GO";"NOVO PLANALTO";28;5;1;34
2011;"ORIZONA (GO)";"GO";"ORIZONA";174;29;40;243
2011;"OURO VERDE DE GOIAS (GO)";"GO";"OURO VERDE DE GOIAS";84;0;8;92
2011;"OUVIDOR (GO)";"GO";"OUVIDOR";87;5;11;103
2011;"PADRE BERNARDO (GO)";"GO";"PADRE BERNARDO";353;15;62;430
2011;"PALESTINA DE GOIAS (GO)";"GO";"PALESTINA DE GOIAS";19;12;6;37
2011;"PALMEIRAS DE GOIAS (GO)";"GO";"PALMEIRAS DE GOIAS";295;9;63;367
2011;"PALMELO (GO)";"GO";"PALMELO";20;1;3;24
2011;"PALMINOPOLIS (GO)";"GO";"PALMINOPOLIS";35;1;4;40
2011;"PANAMA (GO)";"GO";"PANAMA";33;7;6;46
2011;"PARANAIGUARA (GO)";"GO";"PARANAIGUARA";90;10;8;108
2011;"PARAUNA (GO)";"GO";"PARAUNA";129;18;32;179
2011;"PEROLANDIA (GO)";"GO";"PEROLANDIA";24;7;7;38
2011;"PETROLINA DE GOIAS (GO)";"GO";"PETROLINA DE GOIAS";133;3;16;152
2011;"PILAR DE GOIAS (GO)";"GO";"PILAR DE GOIAS";8;4;4;16
2011;"PIRACANJUBA (GO)";"GO";"PIRACANJUBA";357;21;27;405
2011;"PIRANHAS (GO)";"GO";"PIRANHAS";184;5;29;218
2011;"PIRENOPOLIS (GO)";"GO";"PIRENOPOLIS";256;32;30;318
2011;"PIRES DO RIO (GO)";"GO";"PIRES DO RIO";456;32;33;521
2011;"PLANALTINA (GO)";"GO";"PLANALTINA";409;32;304;745
2011;"PONTALINA (GO)";"GO";"PONTALINA";231;10;22;263
2011;"PORANGATU (GO)";"GO";"PORANGATU";590;38;76;704
2011;"PORTEIRAO (GO)";"GO";"PORTEIRAO";77;7;11;95
2011;"PORTELANDIA (GO)";"GO";"PORTELANDIA";38;18;4;60
2011;"POSSE (GO)";"GO";"POSSE";544;41;83;668
2011;"PROFESSOR JAMIL (GO)";"GO";"PROFESSOR JAMIL";26;3;5;34
2011;"QUIRINOPOLIS (GO)";"GO";"QUIRINOPOLIS";804;35;146;985
2011;"RIALMA (GO)";"GO";"RIALMA";266;21;22;309
2011;"RIANAPOLIS (GO)";"GO";"RIANAPOLIS";77;4;5;86
2011;"RIO QUENTE (GO)";"GO";"RIO QUENTE";39;19;55;113
2011;"RIO VERDE (GO)";"GO";"RIO VERDE";3164;246;503;3913
2011;"RUBIATABA (GO)";"GO";"RUBIATABA";285;20;48;353
2011;"SANCLERLANDIA (GO)";"GO";"SANCLERLANDIA";82;7;6;95
2011;"SANTA BARBARA DE GOIAS (GO)";"GO";"SANTA BARBARA DE GOIAS";82;2;6;90
2011;"SANTA CRUZ DE GOIAS (GO)";"GO";"SANTA CRUZ DE GOIAS";4;2;3;9
2011;"SANTA FE DE GOIAS (GO)";"GO";"SANTA FE DE GOIAS";33;2;4;39
2011;"SANTA HELENA DE GOIAS (GO)";"GO";"SANTA HELENA DE GOIAS";823;36;193;1052
2011;"SANTA ISABEL (GO)";"GO";"SANTA ISABEL";10;8;5;23
2011;"SANTA RITA DO ARAGUAIA (GO)";"GO";"SANTA RITA DO ARAGUAIA";126;13;4;143
2011;"SANTA RITA DO NOVO DESTINO (GO)";"GO";"SANTA RITA DO NOVO DESTINO";24;4;9;37
2011;"SANTA ROSA DE GOIAS (GO)";"GO";"SANTA ROSA DE GOIAS";24;3;3;30
2011;"SANTA TEREZA DE GOIAS (GO)";"GO";"SANTA TEREZA DE GOIAS";37;2;4;43
2011;"SANTA TEREZINHA DE GOIAS (GO)";"GO";"SANTA TEREZINHA DE GOIAS";79;10;17;106
2011;"SANTO ANTONIO DA BARRA (GO)";"GO";"SANTO ANTONIO DA BARRA";31;8;10;49
2011;"SANTO ANTONIO DE GOIAS (GO)";"GO";"SANTO ANTONIO DE GOIAS";49;10;10;69
2011;"SANTO ANTONIO DO DESCOBERTO (GO)";"GO";"SANTO ANTONIO DO DESCOBERTO";268;36;236;540
2011;"SAO DOMINGOS (GO)";"GO";"SAO DOMINGOS";38;5;19;62
2011;"SAO FRANCISCO DE GOIAS (GO)";"GO";"SAO FRANCISCO DE GOIAS";41;8;8;57
2011;"SAO JOAO D ALIANCA (GO)";"GO";"SAO JOAO D ALIANCA";112;7;13;132
2011;"SAO JOAO DA PARAUNA (GO)";"GO";"SAO JOAO DA PARAUNA";17;0;3;20
2011;"SAO LUIS DE MONTES BELOS (GO)";"GO";"SAO LUIS DE MONTES BELOS";348;19;62;429
2011;"SAO LUIZ DO NORTE (GO)";"GO";"SAO LUIZ DO NORTE";36;6;14;56
2011;"SAO MIGUEL DO ARAGUAIA (GO)";"GO";"SAO MIGUEL DO ARAGUAIA";296;8;49;353
2011;"SAO MIGUEL DO PASSA QUATRO (GO)";"GO";"SAO MIGUEL DO PASSA QUATRO";37;1;3;41
2011;"SAO PATRICIO (GO)";"GO";"SAO PATRICIO";8;0;5;13
2011;"SAO SIMAO (GO)";"GO";"SAO SIMAO";179;26;62;267
2011;"SENADOR CANEDO (GO)";"GO";"SENADOR CANEDO";580;46;44;670
2011;"SERRANOPOLIS (GO)";"GO";"SERRANOPOLIS";86;13;18;117
2011;"SILVANIA (GO)";"GO";"SILVANIA";337;24;32;393
2011;"SIMOLANDIA (GO)";"GO";"SIMOLANDIA";98;3;8;109
2011;"SITIO D ABADIA (GO)";"GO";"SITIO D ABADIA";7;0;6;13
2011;"TAQUARAL DE GOIAS (GO)";"GO";"TAQUARAL DE GOIAS";19;3;4;26
2011;"TERESINA DE GOIAS (GO)";"GO";"TERESINA DE GOIAS";7;1;2;10
2011;"TEREZOPOLIS DE GOIAS (GO)";"GO";"TEREZOPOLIS DE GOIAS";78;3;11;92
2011;"TRES RANCHOS (GO)";"GO";"TRES RANCHOS";31;11;3;45
2011;"TRINDADE (GO)";"GO";"TRINDADE";907;50;110;1067
2011;"TROMBAS (GO)";"GO";"TROMBAS";26;3;10;39
2011;"TURVANIA (GO)";"GO";"TURVANIA";65;3;5;73
2011;"TURVELANDIA (GO)";"GO";"TURVELANDIA";39;3;14;56
2011;"UIRAPURU (GO)";"GO";"UIRAPURU";17;10;3;30
2011;"URUACU (GO)";"GO";"URUACU";491;33;63;587
2011;"URUANA (GO)";"GO";"URUANA";235;4;11;250
2011;"URUTAI (GO)";"GO";"URUTAI";19;0;7;26
2011;"VALPARAISO DE GOIAS (GO)";"GO";"VALPARAISO DE GOIAS";547;188;173;908
2011;"VARJAO (GO)";"GO";"VARJAO";48;0;4;52
2011;"VIANOPOLIS (GO)";"GO";"VIANOPOLIS";411;17;22;450
2011;"VICENTINOPOLIS (GO)";"GO";"VICENTINOPOLIS";161;8;34;203
2011;"VILA BOA (GO)";"GO";"VILA BOA";17;2;9;28
2011;"VILA PROPICIO (GO)";"GO";"VILA PROPICIO";10;3;13;26
2011;"ACAILANDIA (MA)";"MA";"ACAILANDIA";1024;105;136;1265
2011;"AFONSO CUNHA (MA)";"MA";"AFONSO CUNHA";3;1;1;5
2011;"AGUA DOCE DO MARANHAO (MA)";"MA";"AGUA DOCE DO MARANHAO";3;1;3;7
2011;"ALCANTARA (MA)";"MA";"ALCANTARA";45;11;13;69
2011;"ALDEIAS ALTAS (MA)";"MA";"ALDEIAS ALTAS";38;3;21;62
2011;"ALTAMIRA DO MARANHAO (MA)";"MA";"ALTAMIRA DO MARANHAO";18;3;1;22
2011;"ALTO ALEGRE DO MARANHAO (MA)";"MA";"ALTO ALEGRE DO MARANHAO";33;20;1;54
2011;"ALTO ALEGRE DO PINDARE (MA)";"MA";"ALTO ALEGRE DO PINDARE";34;11;2;47
2011;"ALTO PARNAIBA (MA)";"MA";"ALTO PARNAIBA";45;2;6;53
2011;"AMAPA DO MARANHAO (MA)";"MA";"AMAPA DO MARANHAO";6;2;2;10
2011;"AMARANTE DO MARANHAO (MA)";"MA";"AMARANTE DO MARANHAO";78;4;6;88
2011;"ANAJATUBA (MA)";"MA";"ANAJATUBA";27;3;3;33
2011;"ANAPURUS (MA)";"MA";"ANAPURUS";40;1;11;52
2011;"APICUM ACU (MA)";"MA";"APICUM ACU";9;6;0;15
2011;"ARAGUANA (MA)";"MA";"ARAGUANA";7;0;3;10
2011;"ARAIOSES (MA)";"MA";"ARAIOSES";20;6;22;48
2011;"ARAME (MA)";"MA";"ARAME";92;11;1;104
2011;"ARARI (MA)";"MA";"ARARI";68;6;3;77
2011;"AXIXA (MA)";"MA";"AXIXA";16;6;5;27
2011;"BACABAL (MA)";"MA";"BACABAL";770;80;53;903
2011;"BACABEIRA (MA)";"MA";"BACABEIRA";135;3;9;147
2011;"BACURI (MA)";"MA";"BACURI";9;3;3;15
2011;"BACURITUBA (MA)";"MA";"BACURITUBA";3;0;2;5
2011;"BALSAS (MA)";"MA";"BALSAS";1155;39;70;1264
2011;"BARAO DE GRAJAU (MA)";"MA";"BARAO DE GRAJAU";42;1;5;48
2011;"BARRA DO CORDA (MA)";"MA";"BARRA DO CORDA";474;23;11;508
2011;"BARREIRINHAS (MA)";"MA";"BARREIRINHAS";65;6;11;82
2011;"BELA VISTA DO MARANHAO (MA)";"MA";"BELA VISTA DO MARANHAO";24;1;2;27
2011;"BELAGUA (MA)";"MA";"BELAGUA";1;4;3;8
2011;"BENEDITO LEITE (MA)";"MA";"BENEDITO LEITE";3;2;1;6
2011;"BEQUIMAO (MA)";"MA";"BEQUIMAO";68;8;11;87
2011;"BERNARDO DO MEARIM (MA)";"MA";"BERNARDO DO MEARIM";20;1;1;22
2011;"BOA VISTA DO GURUPI (MA)";"MA";"BOA VISTA DO GURUPI";4;2;2;8
2011;"BOM JARDIM (MA)";"MA";"BOM JARDIM";90;6;7;103
2011;"BOM JESUS DAS SELVAS (MA)";"MA";"BOM JESUS DAS SELVAS";87;4;2;93
2011;"BOM LUGAR (MA)";"MA";"BOM LUGAR";26;9;12;47
2011;"BREJO (MA)";"MA";"BREJO";55;14;12;81
2011;"BREJO DE AREIA (MA)";"MA";"BREJO DE AREIA";20;3;1;24
2011;"BURITI (MA)";"MA";"BURITI";16;8;13;37
2011;"BURITI BRAVO (MA)";"MA";"BURITI BRAVO";22;0;1;23
2011;"BURITICUPU (MA)";"MA";"BURITICUPU";335;40;10;385
2011;"BURITIRANA (MA)";"MA";"BURITIRANA";16;0;0;16
2011;"CACHOEIRA GRANDE (MA)";"MA";"CACHOEIRA GRANDE";4;2;2;8
2011;"CAJAPIO (MA)";"MA";"CAJAPIO";6;1;2;9
2011;"CAJARI (MA)";"MA";"CAJARI";4;2;0;6
2011;"CAMPESTRE DO MARANHAO (MA)";"MA";"CAMPESTRE DO MARANHAO";13;11;8;32
2011;"CANDIDO MENDES (MA)";"MA";"CANDIDO MENDES";15;5;2;22
2011;"CANTANHEDE (MA)";"MA";"CANTANHEDE";19;2;1;22
2011;"CAPINZAL DO NORTE (MA)";"MA";"CAPINZAL DO NORTE";24;13;2;39
2011;"CAROLINA (MA)";"MA";"CAROLINA";56;3;7;66
2011;"CARUTAPERA (MA)";"MA";"CARUTAPERA";20;12;6;38
2011;"CAXIAS (MA)";"MA";"CAXIAS";744;51;89;884
2011;"CEDRAL (MA)";"MA";"CEDRAL";7;0;4;11
2011;"CENTRAL DO MARANHAO (MA)";"MA";"CENTRAL DO MARANHAO";7;1;1;9
2011;"CENTRO DO GUILHERME (MA)";"MA";"CENTRO DO GUILHERME";11;0;2;13
2011;"CENTRO NOVO DO MARANHAO (MA)";"MA";"CENTRO NOVO DO MARANHAO";23;3;4;30
2011;"CHAPADINHA (MA)";"MA";"CHAPADINHA";285;36;12;333
2011;"CIDELANDIA (MA)";"MA";"CIDELANDIA";34;9;9;52
2011;"CODO (MA)";"MA";"CODO";535;24;26;585
2011;"COELHO NETO (MA)";"MA";"COELHO NETO";90;12;33;135
2011;"COLINAS (MA)";"MA";"COLINAS";113;8;12;133
2011;"CONCEICAO DO LAGO ACU (MA)";"MA";"CONCEICAO DO LAGO ACU";14;5;1;20
2011;"COROATA (MA)";"MA";"COROATA";173;32;9;214
2011;"CURURUPU (MA)";"MA";"CURURUPU";24;9;5;38
2011;"DAVINOPOLIS (MA)";"MA";"DAVINOPOLIS";45;3;2;50
2011;"DOM PEDRO (MA)";"MA";"DOM PEDRO";361;9;32;402
2011;"DUQUE BACELAR (MA)";"MA";"DUQUE BACELAR";0;2;4;6
2011;"ESPERANTINOPOLIS (MA)";"MA";"ESPERANTINOPOLIS";84;15;1;100
2011;"ESTREITO (MA)";"MA";"ESTREITO";101;20;13;134
2011;"FEIRA NOVA DO MARANHAO (MA)";"MA";"FEIRA NOVA DO MARANHAO";3;1;1;5
2011;"FERNANDO FALCAO (MA)";"MA";"FERNANDO FALCAO";10;0;4;14
2011;"FORMOSA DA SERRA NEGRA (MA)";"MA";"FORMOSA DA SERRA NEGRA";23;3;3;29
2011;"FORTALEZA DOS NOGUEIRAS (MA)";"MA";"FORTALEZA DOS NOGUEIRAS";50;3;6;59
2011;"FORTUNA (MA)";"MA";"FORTUNA";30;7;1;38
2011;"GODOFREDO VIANA (MA)";"MA";"GODOFREDO VIANA";8;8;3;19
2011;"GONCALVES DIAS (MA)";"MA";"GONCALVES DIAS";35;4;5;44
2011;"GOVERNADOR ARCHER (MA)";"MA";"GOVERNADOR ARCHER";17;6;4;27
2011;"GOVERNADOR EDISON LOBAO (MA)";"MA";"GOVERNADOR EDISON LOBAO";42;2;9;53
2011;"GOVERNADOR EUGENIO BARROS (MA)";"MA";"GOVERNADOR EUGENIO BARROS";41;8;11;60
2011;"GOVERNADOR LUIZ ROCHA (MA)";"MA";"GOVERNADOR LUIZ ROCHA";18;3;5;26
2011;"GOVERNADOR NEWTON BELLO (MA)";"MA";"GOVERNADOR NEWTON BELLO";20;1;2;23
2011;"GOVERNADOR NUNES FREIRE (MA)";"MA";"GOVERNADOR NUNES FREIRE";62;6;3;71
2011;"GRACA ARANHA (MA)";"MA";"GRACA ARANHA";10;4;3;17
2011;"GRAJAU (MA)";"MA";"GRAJAU";364;16;20;400
2011;"GUIMARAES (MA)";"MA";"GUIMARAES";12;1;8;21
2011;"HUMBERTO DE CAMPOS (MA)";"MA";"HUMBERTO DE CAMPOS";13;1;3;17
2011;"ICATU (MA)";"MA";"ICATU";15;1;6;22
2011;"IGARAPE DO MEIO (MA)";"MA";"IGARAPE DO MEIO";17;2;7;26
2011;"IGARAPE GRANDE (MA)";"MA";"IGARAPE GRANDE";65;9;4;78
2011;"IMPERATRIZ (MA)";"MA";"IMPERATRIZ";2830;215;273;3318
2011;"ITAIPAVA DO GRAJAU (MA)";"MA";"ITAIPAVA DO GRAJAU";18;3;1;22
2011;"ITAPECURU MIRIM (MA)";"MA";"ITAPECURU MIRIM";303;19;33;355
2011;"ITINGA DO MARANHAO (MA)";"MA";"ITINGA DO MARANHAO";102;5;3;110
2011;"JATOBA (MA)";"MA";"JATOBA";2;2;1;5
2011;"JENIPAPO DOS VIEIRAS (MA)";"MA";"JENIPAPO DOS VIEIRAS";33;1;2;36
2011;"JOAO LISBOA (MA)";"MA";"JOAO LISBOA";84;8;5;97
2011;"JOSELANDIA (MA)";"MA";"JOSELANDIA";49;5;3;57
2011;"JUNCO DO MARANHAO (MA)";"MA";"JUNCO DO MARANHAO";6;15;1;22
2011;"LAGO DA PEDRA (MA)";"MA";"LAGO DA PEDRA";245;35;6;286
2011;"LAGO DO JUNCO (MA)";"MA";"LAGO DO JUNCO";18;2;4;24
2011;"LAGO DOS RODRIGUES (MA)";"MA";"LAGO DOS RODRIGUES";37;11;4;52
2011;"LAGO VERDE (MA)";"MA";"LAGO VERDE";21;0;6;27
2011;"LAGOA DO MATO (MA)";"MA";"LAGOA DO MATO";10;0;2;12
2011;"LAGOA GRANDE DO MARANHAO (MA)";"MA";"LAGOA GRANDE DO MARANHAO";15;1;1;17
2011;"LAJEADO NOVO (MA)";"MA";"LAJEADO NOVO";14;6;2;22
2011;"LIMA CAMPOS (MA)";"MA";"LIMA CAMPOS";65;23;4;92
2011;"LORETO (MA)";"MA";"LORETO";10;4;3;17
2011;"LUIS DOMINGUES (MA)";"MA";"LUIS DOMINGUES";3;2;2;7
2011;"MAGALHAES DE ALMEIDA (MA)";"MA";"MAGALHAES DE ALMEIDA";11;2;4;17
2011;"MARACACUME (MA)";"MA";"MARACACUME";47;36;3;86
2011;"MARAJA DO SENA (MA)";"MA";"MARAJA DO SENA";8;0;1;9
2011;"MARANHAOZINHO (MA)";"MA";"MARANHAOZINHO";22;2;2;26
2011;"MATA ROMA (MA)";"MA";"MATA ROMA";35;7;7;49
2011;"MATINHA (MA)";"MA";"MATINHA";29;7;2;38
2011;"MATOES (MA)";"MA";"MATOES";26;4;12;42
2011;"MATOES DO NORTE (MA)";"MA";"MATOES DO NORTE";16;5;2;23
2011;"MILAGRES DO MARANHAO (MA)";"MA";"MILAGRES DO MARANHAO";3;2;3;8
2011;"MIRADOR (MA)";"MA";"MIRADOR";15;3;5;23
2011;"MIRANDA DO NORTE (MA)";"MA";"MIRANDA DO NORTE";110;3;5;118
2011;"MIRINZAL (MA)";"MA";"MIRINZAL";28;3;5;36
2011;"MONCAO (MA)";"MA";"MONCAO";17;5;6;28
2011;"MONTES ALTOS (MA)";"MA";"MONTES ALTOS";28;1;1;30
2011;"MORROS (MA)";"MA";"MORROS";11;3;3;17
2011;"NINA RODRIGUES (MA)";"MA";"NINA RODRIGUES";5;2;2;9
2011;"NOVA COLINAS (MA)";"MA";"NOVA COLINAS";11;3;8;22
2011;"NOVA IORQUE (MA)";"MA";"NOVA IORQUE";4;1;1;6
2011;"NOVA OLINDA DO MARANHAO (MA)";"MA";"NOVA OLINDA DO MARANHAO";47;16;2;65
2011;"OLHO D AGUA DAS CUNHAS (MA)";"MA";"OLHO D AGUA DAS CUNHAS";70;12;9;91
2011;"OLINDA NOVA DO MARANHAO (MA)";"MA";"OLINDA NOVA DO MARANHAO";19;1;1;21
2011;"PACO DO LUMIAR (MA)";"MA";"PACO DO LUMIAR";366;108;102;576
2011;"PALMEIRANDIA (MA)";"MA";"PALMEIRANDIA";13;1;8;22
2011;"PARAIBANO (MA)";"MA";"PARAIBANO";40;11;5;56
2011;"PARNARAMA (MA)";"MA";"PARNARAMA";30;2;3;35
2011;"PASSAGEM FRANCA (MA)";"MA";"PASSAGEM FRANCA";22;4;1;27
2011;"PASTOS BONS (MA)";"MA";"PASTOS BONS";81;8;2;91
2011;"PAULINO NEVES (MA)";"MA";"PAULINO NEVES";4;1;5;10
2011;"PAULO RAMOS (MA)";"MA";"PAULO RAMOS";59;8;3;70
2011;"PEDREIRAS (MA)";"MA";"PEDREIRAS";343;45;30;418
2011;"PEDRO DO ROSARIO (MA)";"MA";"PEDRO DO ROSARIO";14;1;2;17
2011;"PENALVA (MA)";"MA";"PENALVA";23;3;1;27
2011;"PERI MIRIM (MA)";"MA";"PERI MIRIM";18;5;7;30
2011;"PERITORO (MA)";"MA";"PERITORO";40;57;11;108
2011;"PINDARE MIRIM (MA)";"MA";"PINDARE MIRIM";93;12;16;121
2011;"PINHEIRO (MA)";"MA";"PINHEIRO";390;22;62;474
2011;"PIO XII (MA)";"MA";"PIO XII";93;3;3;99
2011;"PIRAPEMAS (MA)";"MA";"PIRAPEMAS";12;9;2;23
2011;"POCAO DE PEDRAS (MA)";"MA";"POCAO DE PEDRAS";40;16;4;60
2011;"PORTO FRANCO (MA)";"MA";"PORTO FRANCO";57;21;5;83
2011;"PORTO RICO DO MARANHAO (MA)";"MA";"PORTO RICO DO MARANHAO";3;1;2;6
2011;"PRESIDENTE DUTRA (MA)";"MA";"PRESIDENTE DUTRA";331;20;13;364
2011;"PRESIDENTE JUSCELINO (MA)";"MA";"PRESIDENTE JUSCELINO";5;2;3;10
2011;"PRESIDENTE MEDICI (MA)";"MA";"PRESIDENTE MEDICI";11;5;1;17
2011;"PRESIDENTE SARNEY (MA)";"MA";"PRESIDENTE SARNEY";8;5;2;15
2011;"PRESIDENTE VARGAS (MA)";"MA";"PRESIDENTE VARGAS";16;5;1;22
2011;"PRIMEIRA CRUZ (MA)";"MA";"PRIMEIRA CRUZ";1;1;0;2
2011;"RAPOSA (MA)";"MA";"RAPOSA";66;4;41;111
2011;"RIACHAO (MA)";"MA";"RIACHAO";35;5;5;45
2011;"RIBAMAR FIQUENE (MA)";"MA";"RIBAMAR FIQUENE";11;4;3;18
2011;"ROSARIO (MA)";"MA";"ROSARIO";186;21;45;252
2011;"SAMBAIBA (MA)";"MA";"SAMBAIBA";16;2;1;19
2011;"SANTA FILOMENA DO MARANHAO (MA)";"MA";"SANTA FILOMENA DO MARANHAO";4;6;1;11
2011;"SANTA HELENA (MA)";"MA";"SANTA HELENA";81;6;7;94
2011;"SANTA INES (MA)";"MA";"SANTA INES";658;140;84;882
2011;"SANTA LUZIA (MA)";"MA";"SANTA LUZIA";232;76;12;320
2011;"SANTA LUZIA DO PARUA (MA)";"MA";"SANTA LUZIA DO PARUA";109;9;6;124
2011;"SANTA QUITERIA DO MARANHAO (MA)";"MA";"SANTA QUITERIA DO MARANHAO";26;4;7;37
2011;"SANTA RITA (MA)";"MA";"SANTA RITA";128;5;8;141
2011;"SANTANA DO MARANHAO (MA)";"MA";"SANTANA DO MARANHAO";6;0;4;10
2011;"SANTO AMARO DO MARANHAO (MA)";"MA";"SANTO AMARO DO MARANHAO";2;4;2;8
2011;"SANTO ANTONIO DOS LOPES (MA)";"MA";"SANTO ANTONIO DOS LOPES";77;6;3;86
2011;"SAO BENEDITO DO RIO PRETO (MA)";"MA";"SAO BENEDITO DO RIO PRETO";14;8;2;24
2011;"SAO BENTO (MA)";"MA";"SAO BENTO";114;27;14;155
2011;"SAO BERNARDO (MA)";"MA";"SAO BERNARDO";71;3;9;83
2011;"SAO DOMINGOS DO AZEITAO (MA)";"MA";"SAO DOMINGOS DO AZEITAO";31;0;1;32
2011;"SAO DOMINGOS DO MARANHAO (MA)";"MA";"SAO DOMINGOS DO MARANHAO";144;3;2;149
2011;"SAO FELIX DE BALSAS (MA)";"MA";"SAO FELIX DE BALSAS";4;0;1;5
2011;"SAO FRANCISCO DO BREJAO (MA)";"MA";"SAO FRANCISCO DO BREJAO";42;2;2;46
2011;"SAO FRANCISCO DO MARANHAO (MA)";"MA";"SAO FRANCISCO DO MARANHAO";5;0;2;7
2011;"SAO JOAO BATISTA (MA)";"MA";"SAO JOAO BATISTA";30;5;9;44
2011;"SAO JOAO DO CARU (MA)";"MA";"SAO JOAO DO CARU";25;1;1;27
2011;"SAO JOAO DO PARAISO (MA)";"MA";"SAO JOAO DO PARAISO";12;4;1;17
2011;"SAO JOAO DO SOTER (MA)";"MA";"SAO JOAO DO SOTER";17;1;1;19
2011;"SAO JOAO DOS PATOS (MA)";"MA";"SAO JOAO DOS PATOS";144;6;5;155
2011;"SAO JOSE DE RIBAMAR (MA)";"MA";"SAO JOSE DE RIBAMAR";559;128;150;837
2011;"SAO JOSE DOS BASILIOS (MA)";"MA";"SAO JOSE DOS BASILIOS";11;3;2;16
2011;"SAO LUIS (MA)";"MA";"SAO LUIS";7821;1224;3365;12410
2011;"SAO LUIS GONZAGA DO MARANHAO (MA)";"MA";"SAO LUIS GONZAGA DO MARANHAO";28;6;4;38
2011;"SAO MATEUS DO MARANHAO (MA)";"MA";"SAO MATEUS DO MARANHAO";106;36;17;159
2011;"SAO PEDRO DA AGUA BRANCA (MA)";"MA";"SAO PEDRO DA AGUA BRANCA";14;6;2;22
2011;"SAO PEDRO DOS CRENTES (MA)";"MA";"SAO PEDRO DOS CRENTES";11;1;3;15
2011;"SAO RAIMUNDO DAS MANGABEIRAS (MA)";"MA";"SAO RAIMUNDO DAS MANGABEIRAS";104;6;39;149
2011;"SAO RAIMUNDO DO DOCA BEZERRA (MA)";"MA";"SAO RAIMUNDO DO DOCA BEZERRA";13;0;1;14
2011;"SAO ROBERTO (MA)";"MA";"SAO ROBERTO";14;4;1;19
2011;"SAO VICENTE FERRER (MA)";"MA";"SAO VICENTE FERRER";25;1;5;31
2011;"SATUBINHA (MA)";"MA";"SATUBINHA";15;3;1;19
2011;"SENADOR ALEXANDRE COSTA (MA)";"MA";"SENADOR ALEXANDRE COSTA";18;5;2;25
2011;"SENADOR LA ROCQUE (MA)";"MA";"SENADOR LA ROCQUE";46;0;1;47
2011;"SERRANO DO MARANHAO (MA)";"MA";"SERRANO DO MARANHAO";1;0;2;3
2011;"SITIO NOVO (MA)";"MA";"SITIO NOVO";39;5;6;50
2011;"SUCUPIRA DO NORTE (MA)";"MA";"SUCUPIRA DO NORTE";17;4;3;24
2011;"SUCUPIRA DO RIACHAO (MA)";"MA";"SUCUPIRA DO RIACHAO";5;4;2;11
2011;"TASSO FRAGOSO (MA)";"MA";"TASSO FRAGOSO";44;4;5;53
2011;"TIMBIRAS (MA)";"MA";"TIMBIRAS";31;5;1;37
2011;"TIMON (MA)";"MA";"TIMON";532;43;65;640
2011;"TRIZIDELA DO VALE (MA)";"MA";"TRIZIDELA DO VALE";112;19;6;137
2011;"TUFILANDIA (MA)";"MA";"TUFILANDIA";8;6;1;15
2011;"TUNTUM (MA)";"MA";"TUNTUM";93;6;7;106
2011;"TURIACU (MA)";"MA";"TURIACU";33;3;3;39
2011;"TURILANDIA (MA)";"MA";"TURILANDIA";11;4;2;17
2011;"TUTOIA (MA)";"MA";"TUTOIA";54;6;9;69
2011;"URBANO SANTOS (MA)";"MA";"URBANO SANTOS";49;7;9;65
2011;"VARGEM GRANDE (MA)";"MA";"VARGEM GRANDE";104;5;7;116
2011;"VIANA (MA)";"MA";"VIANA";171;8;5;184
2011;"VILA NOVA DOS MARTIRIOS (MA)";"MA";"VILA NOVA DOS MARTIRIOS";33;3;1;37
2011;"VITORIA DO MEARIM (MA)";"MA";"VITORIA DO MEARIM";69;11;7;87
2011;"VITORINO FREIRE (MA)";"MA";"VITORINO FREIRE";116;11;5;132
2011;"ZE DOCA (MA)";"MA";"ZE DOCA";198;24;19;241
2011;"ABADIA DOS DOURADOS (MG)";"MG";"ABADIA DOS DOURADOS";84;29;9;122
2011;"ABAETE (MG)";"MG";"ABAETE";439;25;160;624
2011;"ABRE CAMPO (MG)";"MG";"ABRE CAMPO";175;15;49;239
2011;"ACAIACA (MG)";"MG";"ACAIACA";22;7;4;33
2011;"ACUCENA (MG)";"MG";"ACUCENA";35;12;29;76
2011;"AGUA BOA (MG)";"MG";"AGUA BOA";60;7;25;92
2011;"AGUA COMPRIDA (MG)";"MG";"AGUA COMPRIDA";33;8;5;46
2011;"AGUANIL (MG)";"MG";"AGUANIL";43;11;11;65
2011;"AGUAS FORMOSAS (MG)";"MG";"AGUAS FORMOSAS";92;18;32;142
2011;"AGUAS VERMELHAS (MG)";"MG";"AGUAS VERMELHAS";78;12;17;107
2011;"AIMORES (MG)";"MG";"AIMORES";171;30;37;238
2011;"AIURUOCA (MG)";"MG";"AIURUOCA";91;16;10;117
2011;"ALAGOA (MG)";"MG";"ALAGOA";21;3;9;33
2011;"ALBERTINA (MG)";"MG";"ALBERTINA";38;13;4;55
2011;"ALEM PARAIBA (MG)";"MG";"ALEM PARAIBA";1267;76;96;1439
2011;"ALFENAS (MG)";"MG";"ALFENAS";1125;95;313;1533
2011;"ALFREDO VASCONCELOS (MG)";"MG";"ALFREDO VASCONCELOS";128;6;16;150
2011;"ALMENARA (MG)";"MG";"ALMENARA";240;48;83;371
2011;"ALPERCATA (MG)";"MG";"ALPERCATA";67;4;5;76
2011;"ALPINOPOLIS (MG)";"MG";"ALPINOPOLIS";392;26;41;459
2011;"ALTEROSA (MG)";"MG";"ALTEROSA";208;31;44;283
2011;"ALTO CAPARAO (MG)";"MG";"ALTO CAPARAO";55;8;8;71
2011;"ALTO JEQUITIBA (MG)";"MG";"ALTO JEQUITIBA";70;9;12;91
2011;"ALTO RIO DOCE (MG)";"MG";"ALTO RIO DOCE";100;20;22;142
2011;"ALVARENGA (MG)";"MG";"ALVARENGA";31;1;12;44
2011;"ALVINOPOLIS (MG)";"MG";"ALVINOPOLIS";175;14;17;206
2011;"ALVORADA DE MINAS (MG)";"MG";"ALVORADA DE MINAS";10;7;11;28
2011;"AMPARO DA SERRA (MG)";"MG";"AMPARO DA SERRA";29;4;22;55
2011;"ANDRADAS (MG)";"MG";"ANDRADAS";966;69;86;1121
2011;"ANDRELANDIA (MG)";"MG";"ANDRELANDIA";140;32;14;186
2011;"ANGELANDIA (MG)";"MG";"ANGELANDIA";54;6;25;85
2011;"ANTONIO CARLOS (MG)";"MG";"ANTONIO CARLOS";153;16;26;195
2011;"ANTONIO DIAS (MG)";"MG";"ANTONIO DIAS";107;9;42;158
2011;"ANTONIO PRADO DE MINAS (MG)";"MG";"ANTONIO PRADO DE MINAS";13;3;3;19
2011;"ARACAI (MG)";"MG";"ARACAI";11;6;6;23
2011;"ARACITABA (MG)";"MG";"ARACITABA";12;2;1;15
2011;"ARACUAI (MG)";"MG";"ARACUAI";210;13;75;298
2011;"ARAGUARI (MG)";"MG";"ARAGUARI";2626;316;172;3114
2011;"ARANTINA (MG)";"MG";"ARANTINA";32;1;3;36
2011;"ARAPONGA (MG)";"MG";"ARAPONGA";57;7;8;72
2011;"ARAPORA (MG)";"MG";"ARAPORA";171;13;51;235
2011;"ARAPUA (MG)";"MG";"ARAPUA";38;3;11;52
2011;"ARAUJOS (MG)";"MG";"ARAUJOS";143;12;5;160
2011;"ARAXA (MG)";"MG";"ARAXA";1545;182;279;2006
2011;"ARCEBURGO (MG)";"MG";"ARCEBURGO";98;22;43;163
2011;"ARCOS (MG)";"MG";"ARCOS";1192;86;258;1536
2011;"AREADO (MG)";"MG";"AREADO";199;17;75;291
2011;"ARGIRITA (MG)";"MG";"ARGIRITA";21;6;4;31
2011;"ARICANDUVA (MG)";"MG";"ARICANDUVA";9;3;9;21
2011;"ARINOS (MG)";"MG";"ARINOS";246;18;68;332
2011;"ASTOLFO DUTRA (MG)";"MG";"ASTOLFO DUTRA";218;8;29;255
2011;"ATALEIA (MG)";"MG";"ATALEIA";70;20;25;115
2011;"AUGUSTO DE LIMA (MG)";"MG";"AUGUSTO DE LIMA";30;3;14;47
2011;"BAEPENDI (MG)";"MG";"BAEPENDI";339;37;27;403
2011;"BALDIM (MG)";"MG";"BALDIM";154;11;15;180
2011;"BAMBUI (MG)";"MG";"BAMBUI";449;35;68;552
2011;"BANDEIRA (MG)";"MG";"BANDEIRA";5;3;4;12
2011;"BANDEIRA DO SUL (MG)";"MG";"BANDEIRA DO SUL";125;26;4;155
2011;"BARAO DE COCAIS (MG)";"MG";"BARAO DE COCAIS";459;65;73;597
2011;"BARAO D0 MONTE ALTO (MG)";"MG";"BARAO D0 MONTE ALTO";28;5;8;41
2011;"BARBACENA (MG)";"MG";"BARBACENA";1656;302;211;2169
2011;"BARRA LONGA (MG)";"MG";"BARRA LONGA";40;7;9;56
2011;"BARROSO (MG)";"MG";"BARROSO";375;24;27;426
2011;"BELA VISTA DE MINAS (MG)";"MG";"BELA VISTA DE MINAS";149;12;9;170
2011;"BELMIRO BRAGA (MG)";"MG";"BELMIRO BRAGA";59;9;4;72
2011;"BELO HORIZONTE (MG)";"MG";"BELO HORIZONTE";33457;5465;8465;47387
2011;"BELO ORIENTE (MG)";"MG";"BELO ORIENTE";252;34;83;369
2011;"BELO VALE (MG)";"MG";"BELO VALE";153;21;24;198
2011;"BERILO (MG)";"MG";"BERILO";65;4;22;91
2011;"BERIZAL (MG)";"MG";"BERIZAL";19;3;8;30
2011;"BERTOPOLIS (MG)";"MG";"BERTOPOLIS";12;2;3;17
2011;"BETIM (MG)";"MG";"BETIM";4546;524;1183;6253
2011;"BIAS FORTES (MG)";"MG";"BIAS FORTES";22;5;4;31
2011;"BICAS (MG)";"MG";"BICAS";213;29;30;272
2011;"BIQUINHAS (MG)";"MG";"BIQUINHAS";45;10;3;58
2011;"BOA ESPERANCA (MG)";"MG";"BOA ESPERANCA";586;72;164;822
2011;"BOCAINA DE MINAS (MG)";"MG";"BOCAINA DE MINAS";58;10;7;75
2011;"BOCAIUVA (MG)";"MG";"BOCAIUVA";434;41;130;605
2011;"BOM DESPACHO (MG)";"MG";"BOM DESPACHO";939;67;356;1362
2011;"BOM JARDIM DE MINAS (MG)";"MG";"BOM JARDIM DE MINAS";97;12;13;122
2011;"BOM JESUS DA PENHA (MG)";"MG";"BOM JESUS DA PENHA";108;14;18;140
2011;"BOM JESUS DO AMPARO (MG)";"MG";"BOM JESUS DO AMPARO";83;7;10;100
2011;"BOM JESUS DO GALHO (MG)";"MG";"BOM JESUS DO GALHO";84;6;17;107
2011;"BOM REPOUSO (MG)";"MG";"BOM REPOUSO";193;15;9;217
2011;"BOM SUCESSO (MG)";"MG";"BOM SUCESSO";229;28;54;311
2011;"BONFIM (MG)";"MG";"BONFIM";121;16;16;153
2011;"BONFINOPOLIS DE MINAS (MG)";"MG";"BONFINOPOLIS DE MINAS";69;3;23;95
2011;"BONITO DE MINAS (MG)";"MG";"BONITO DE MINAS";18;2;18;38
2011;"BORDA DA MATA (MG)";"MG";"BORDA DA MATA";262;29;61;352
2011;"BOTELHOS (MG)";"MG";"BOTELHOS";228;65;40;333
2011;"BOTUMIRIM (MG)";"MG";"BOTUMIRIM";25;2;11;38
2011;"BRAS PIRES (MG)";"MG";"BRAS PIRES";41;12;6;59
2011;"BRASILANDIA DE MINAS (MG)";"MG";"BRASILANDIA DE MINAS";202;12;92;306
2011;"BRASILIA DE MINAS (MG)";"MG";"BRASILIA DE MINAS";251;8;78;337
2011;"BRASOPOLIS (MG)";"MG";"BRASOPOLIS";187;33;26;246
2011;"BRAUNAS (MG)";"MG";"BRAUNAS";12;6;13;31
2011;"BRUMADINHO (MG)";"MG";"BRUMADINHO";818;121;285;1224
2011;"BUENO BRANDAO (MG)";"MG";"BUENO BRANDAO";179;42;18;239
2011;"BUENOPOLIS (MG)";"MG";"BUENOPOLIS";106;10;26;142
2011;"BUGRE (MG)";"MG";"BUGRE";22;4;5;31
2011;"BURITIS (MG)";"MG";"BURITIS";245;11;82;338
2011;"BURITIZEIRO (MG)";"MG";"BURITIZEIRO";230;20;92;342
2011;"CABECEIRA GRANDE (MG)";"MG";"CABECEIRA GRANDE";47;1;9;57
2011;"CABO VERDE (MG)";"MG";"CABO VERDE";168;35;39;242
2011;"CACHOEIRA DA PRATA (MG)";"MG";"CACHOEIRA DA PRATA";56;2;2;60
2011;"CACHOEIRA DE MINAS (MG)";"MG";"CACHOEIRA DE MINAS";115;21;13;149
2011;"CACHOEIRA DE PAJEU (MG)";"MG";"CACHOEIRA DE PAJEU";30;9;11;50
2011;"CACHOEIRA DOURADA (MG)";"MG";"CACHOEIRA DOURADA";18;11;2;31
2011;"CAETANOPOLIS (MG)";"MG";"CAETANOPOLIS";118;15;45;178
2011;"CAETE (MG)";"MG";"CAETE";482;68;57;607
2011;"CAIANA (MG)";"MG";"CAIANA";40;6;8;54
2011;"CAJURI (MG)";"MG";"CAJURI";39;4;9;52
2011;"CALDAS (MG)";"MG";"CALDAS";248;28;28;304
2011;"CAMACHO (MG)";"MG";"CAMACHO";54;8;10;72
2011;"CAMANDUCAIA (MG)";"MG";"CAMANDUCAIA";457;39;40;536
2011;"CAMBUI (MG)";"MG";"CAMBUI";527;53;106;686
2011;"CAMBUQUIRA (MG)";"MG";"CAMBUQUIRA";131;28;17;176
2011;"CAMPANARIO (MG)";"MG";"CAMPANARIO";12;5;3;20
2011;"CAMPANHA (MG)";"MG";"CAMPANHA";234;39;37;310
2011;"CAMPESTRE (MG)";"MG";"CAMPESTRE";481;47;57;585
2011;"CAMPINA VERDE (MG)";"MG";"CAMPINA VERDE";232;31;38;301
2011;"CAMPO AZUL (MG)";"MG";"CAMPO AZUL";10;4;4;18
2011;"CAMPO BELO (MG)";"MG";"CAMPO BELO";1140;79;112;1331
2011;"CAMPO DO MEIO (MG)";"MG";"CAMPO DO MEIO";111;21;67;199
2011;"CAMPO FLORIDO (MG)";"MG";"CAMPO FLORIDO";124;29;67;220
2011;"CAMPOS ALTOS (MG)";"MG";"CAMPOS ALTOS";292;29;75;396
2011;"CAMPOS GERAIS (MG)";"MG";"CAMPOS GERAIS";294;28;114;436
2011;"CANA VERDE (MG)";"MG";"CANA VERDE";59;8;7;74
2011;"CANAA (MG)";"MG";"CANAA";58;5;9;72
2011;"CANAPOLIS (MG)";"MG";"CANAPOLIS";207;12;101;320
2011;"CANDEIAS (MG)";"MG";"CANDEIAS";232;19;30;281
2011;"CANTAGALO (MG)";"MG";"CANTAGALO";10;1;7;18
2011;"CAPARAO (MG)";"MG";"CAPARAO";62;4;7;73
2011;"CAPELA NOVA (MG)";"MG";"CAPELA NOVA";18;12;4;34
2011;"CAPELINHA (MG)";"MG";"CAPELINHA";638;43;138;819
2011;"CAPETINGA (MG)";"MG";"CAPETINGA";153;15;31;199
2011;"CAPIM BRANCO (MG)";"MG";"CAPIM BRANCO";68;12;11;91
2011;"CAPINOPOLIS (MG)";"MG";"CAPINOPOLIS";252;28;75;355
2011;"CAPITAO ANDRADE (MG)";"MG";"CAPITAO ANDRADE";41;5;3;49
2011;"CAPITAO ENEAS (MG)";"MG";"CAPITAO ENEAS";55;3;21;79
2011;"CAPITOLIO (MG)";"MG";"CAPITOLIO";143;18;16;177
2011;"CAPUTIRA (MG)";"MG";"CAPUTIRA";117;6;37;160
2011;"CARAI (MG)";"MG";"CARAI";51;25;35;111
2011;"CARANAIBA (MG)";"MG";"CARANAIBA";22;8;11;41
2011;"CARANDAI (MG)";"MG";"CARANDAI";519;42;93;654
2011;"CARANGOLA (MG)";"MG";"CARANGOLA";361;36;54;451
2011;"CARATINGA (MG)";"MG";"CARATINGA";1144;68;785;1997
2011;"CARBONITA (MG)";"MG";"CARBONITA";147;16;39;202
2011;"CAREACU (MG)";"MG";"CAREACU";119;9;7;135
2011;"CARLOS CHAGAS (MG)";"MG";"CARLOS CHAGAS";136;32;48;216
2011;"CARMESIA (MG)";"MG";"CARMESIA";72;2;1293;1367
2011;"CARMO DA CACHOEIRA (MG)";"MG";"CARMO DA CACHOEIRA";140;31;51;222
2011;"CARMO DA MATA (MG)";"MG";"CARMO DA MATA";123;28;39;190
2011;"CARMO DE MINAS (MG)";"MG";"CARMO DE MINAS";129;36;20;185
2011;"CARMO DO CAJURU (MG)";"MG";"CARMO DO CAJURU";355;41;67;463
2011;"CARMO DO PARANAIBA (MG)";"MG";"CARMO DO PARANAIBA";548;55;95;698
2011;"CARMO DO RIO CLARO (MG)";"MG";"CARMO DO RIO CLARO";330;20;80;430
2011;"CARMOPOLIS DE MINAS (MG)";"MG";"CARMOPOLIS DE MINAS";469;38;46;553
2011;"CARNEIRINHO (MG)";"MG";"CARNEIRINHO";178;14;59;251
2011;"CARRANCAS (MG)";"MG";"CARRANCAS";41;9;10;60
2011;"CARVALHOPOLIS (MG)";"MG";"CARVALHOPOLIS";38;8;5;51
2011;"CARVALHOS (MG)";"MG";"CARVALHOS";60;3;8;71
2011;"CASA GRANDE (MG)";"MG";"CASA GRANDE";28;8;2;38
2011;"CASCALHO RICO (MG)";"MG";"CASCALHO RICO";46;20;3;69
2011;"CASSIA (MG)";"MG";"CASSIA";366;34;49;449
2011;"CATAGUASES (MG)";"MG";"CATAGUASES";645;78;163;886
2011;"CATAS ALTAS (MG)";"MG";"CATAS ALTAS";121;13;7;141
2011;"CATAS ALTAS DA NORUEGA (MG)";"MG";"CATAS ALTAS DA NORUEGA";39;5;6;50
2011;"CATUJI (MG)";"MG";"CATUJI";42;15;13;70
2011;"CATUTI (MG)";"MG";"CATUTI";17;6;17;40
2011;"CAXAMBU (MG)";"MG";"CAXAMBU";192;39;20;251
2011;"CEDRO DO ABAETE (MG)";"MG";"CEDRO DO ABAETE";10;1;1;12
2011;"CENTRAL DE MINAS (MG)";"MG";"CENTRAL DE MINAS";78;9;11;98
2011;"CENTRALINA (MG)";"MG";"CENTRALINA";97;5;14;116
2011;"CHACARA (MG)";"MG";"CHACARA";28;6;9;43
2011;"CHALE (MG)";"MG";"CHALE";51;13;10;74
2011;"CHAPADA DO NORTE (MG)";"MG";"CHAPADA DO NORTE";41;17;17;75
2011;"CHAPADA GAUCHA (MG)";"MG";"CHAPADA GAUCHA";82;7;18;107
2011;"CHIADOR (MG)";"MG";"CHIADOR";53;9;10;72
2011;"CIPOTANEA (MG)";"MG";"CIPOTANEA";39;5;13;57
2011;"CLARAVAL (MG)";"MG";"CLARAVAL";121;5;19;145
2011;"CLARO DOS POCOES (MG)";"MG";"CLARO DOS POCOES";37;5;20;62
2011;"CLAUDIO (MG)";"MG";"CLAUDIO";720;39;56;815
2011;"COIMBRA (MG)";"MG";"COIMBRA";109;3;9;121
2011;"COLUNA (MG)";"MG";"COLUNA";41;1;15;57
2011;"COMENDADOR GOMES (MG)";"MG";"COMENDADOR GOMES";37;6;8;51
2011;"COMERCINHO (MG)";"MG";"COMERCINHO";27;6;12;45
2011;"CONCEICAO DA APARECIDA (MG)";"MG";"CONCEICAO DA APARECIDA";139;13;17;169
2011;"CONCEICAO DA BARRA DE MINAS (MG)";"MG";"CONCEICAO DA BARRA DE MINAS";27;8;7;42
2011;"CONCEICAO DAS ALAGOAS (MG)";"MG";"CONCEICAO DAS ALAGOAS";445;29;102;576
2011;"CONCEICAO DAS PEDRAS (MG)";"MG";"CONCEICAO DAS PEDRAS";20;10;4;34
2011;"CONCEICAO DE IPANEMA (MG)";"MG";"CONCEICAO DE IPANEMA";39;8;2;49
2011;"CONCEICAO DO MATO DENTRO (MG)";"MG";"CONCEICAO DO MATO DENTRO";106;24;152;282
2011;"CONCEICAO DO PARA (MG)";"MG";"CONCEICAO DO PARA";64;12;16;92
2011;"CONCEICAO DO RIO VERDE (MG)";"MG";"CONCEICAO DO RIO VERDE";182;40;29;251
2011;"CONCEICAO DOS OUROS (MG)";"MG";"CONCEICAO DOS OUROS";290;31;14;335
2011;"CONEGO MARINHO (MG)";"MG";"CONEGO MARINHO";18;3;13;34
2011;"CONFINS (MG)";"MG";"CONFINS";110;14;15;139
2011;"CONGONHAL (MG)";"MG";"CONGONHAL";236;9;13;258
2011;"CONGONHAS (MG)";"MG";"CONGONHAS";903;158;122;1183
2011;"CONGONHAS DO NORTE (MG)";"MG";"CONGONHAS DO NORTE";33;4;6;43
2011;"CONQUISTA (MG)";"MG";"CONQUISTA";153;19;34;206
2011;"CONSELHEIRO LAFAIETE (MG)";"MG";"CONSELHEIRO LAFAIETE";1306;290;567;2163
2011;"CONSELHEIRO PENA (MG)";"MG";"CONSELHEIRO PENA";192;1;48;241
2011;"CONSOLACAO (MG)";"MG";"CONSOLACAO";12;8;1;21
2011;"CONTAGEM (MG)";"MG";"CONTAGEM";12831;1368;2750;16949
2011;"COQUEIRAL (MG)";"MG";"COQUEIRAL";87;14;18;119
2011;"CORACAO DE JESUS (MG)";"MG";"CORACAO DE JESUS";140;5;86;231
2011;"CORDISBURGO (MG)";"MG";"CORDISBURGO";80;9;9;98
2011;"CORDISLANDIA (MG)";"MG";"CORDISLANDIA";35;8;4;47
2011;"CORINTO (MG)";"MG";"CORINTO";302;22;64;388
2011;"COROACI (MG)";"MG";"COROACI";51;7;8;66
2011;"COROMANDEL (MG)";"MG";"COROMANDEL";525;58;80;663
2011;"CORONEL FABRICIANO (MG)";"MG";"CORONEL FABRICIANO";1154;162;630;1946
2011;"CORONEL MURTA (MG)";"MG";"CORONEL MURTA";23;3;11;37
2011;"CORONEL PACHECO (MG)";"MG";"CORONEL PACHECO";51;6;8;65
2011;"CORONEL XAVIER CHAVES (MG)";"MG";"CORONEL XAVIER CHAVES";78;6;3;87
2011;"CORREGO DANTA (MG)";"MG";"CORREGO DANTA";35;4;11;50
2011;"CORREGO DO BOM JESUS (MG)";"MG";"CORREGO DO BOM JESUS";36;9;9;54
2011;"CORREGO FUNDO (MG)";"MG";"CORREGO FUNDO";349;15;15;379
2011;"CORREGO NOVO (MG)";"MG";"CORREGO NOVO";11;4;5;20
2011;"COUTO DE MAGALHAES DE MINAS (MG)";"MG";"COUTO DE MAGALHAES DE MINAS";39;2;9;50
2011;"CRISOLITA (MG)";"MG";"CRISOLITA";12;15;12;39
2011;"CRISTAIS (MG)";"MG";"CRISTAIS";138;17;24;179
2011;"CRISTALIA (MG)";"MG";"CRISTALIA";25;4;15;44
2011;"CRISTIANO OTONI (MG)";"MG";"CRISTIANO OTONI";65;13;10;88
2011;"CRISTINA (MG)";"MG";"CRISTINA";108;24;10;142
2011;"CRUCILANDIA (MG)";"MG";"CRUCILANDIA";135;7;12;154
2011;"CRUZEIRO DA FORTALEZA (MG)";"MG";"CRUZEIRO DA FORTALEZA";59;5;13;77
2011;"CRUZILIA (MG)";"MG";"CRUZILIA";304;30;30;364
2011;"CUPARAQUE (MG)";"MG";"CUPARAQUE";35;8;2;45
2011;"CURRAL DE DENTRO (MG)";"MG";"CURRAL DE DENTRO";47;9;13;69
2011;"CURVELO (MG)";"MG";"CURVELO";1026;48;1880;2954
2011;"DATAS (MG)";"MG";"DATAS";27;3;12;42
2011;"DELFIM MOREIRA (MG)";"MG";"DELFIM MOREIRA";77;7;20;104
2011;"DELFINOPOLIS (MG)";"MG";"DELFINOPOLIS";81;15;9;105
2011;"DELTA (MG)";"MG";"DELTA";392;35;120;547
2011;"DESCOBERTO (MG)";"MG";"DESCOBERTO";29;8;1;38
2011;"DESTERRO DE ENTRE RIOS (MG)";"MG";"DESTERRO DE ENTRE RIOS";89;13;18;120
2011;"DESTERRO DO MELO (MG)";"MG";"DESTERRO DO MELO";31;6;11;48
2011;"DIAMANTINA (MG)";"MG";"DIAMANTINA";322;65;337;724
2011;"DIOGO DE VASCONCELOS (MG)";"MG";"DIOGO DE VASCONCELOS";15;4;6;25
2011;"DIONISIO (MG)";"MG";"DIONISIO";38;5;15;58
2011;"DIVINESIA (MG)";"MG";"DIVINESIA";71;5;6;82
2011;"DIVINO (MG)";"MG";"DIVINO";221;13;43;277
2011;"DIVINO DAS LARANJEIRAS (MG)";"MG";"DIVINO DAS LARANJEIRAS";35;2;5;42
2011;"DIVINOLANDIA DE MINAS (MG)";"MG";"DIVINOLANDIA DE MINAS";57;4;16;77
2011;"DIVINOPOLIS (MG)";"MG";"DIVINOPOLIS";3122;216;732;4070
2011;"DIVISA ALEGRE (MG)";"MG";"DIVISA ALEGRE";47;2;6;55
2011;"DIVISA NOVA (MG)";"MG";"DIVISA NOVA";69;22;26;117
2011;"DIVISOPOLIS (MG)";"MG";"DIVISOPOLIS";22;7;7;36
2011;"DOM BOSCO (MG)";"MG";"DOM BOSCO";21;2;10;33
2011;"DOM CAVATI (MG)";"MG";"DOM CAVATI";181;10;10;201
2011;"DOM JOAQUIM (MG)";"MG";"DOM JOAQUIM";18;4;8;30
2011;"DOM SILVERIO (MG)";"MG";"DOM SILVERIO";58;9;8;75
2011;"DOM VICOSO (MG)";"MG";"DOM VICOSO";29;9;9;47
2011;"DONA EUZEBIA (MG)";"MG";"DONA EUZEBIA";294;6;6;306
2011;"DORES DE CAMPOS (MG)";"MG";"DORES DE CAMPOS";79;10;36;125
2011;"DORES DE GUANHAES (MG)";"MG";"DORES DE GUANHAES";35;4;18;57
2011;"DORES DO INDAIA (MG)";"MG";"DORES DO INDAIA";217;29;17;263
2011;"DORES DO TURVO (MG)";"MG";"DORES DO TURVO";38;4;13;55
2011;"DORESOPOLIS (MG)";"MG";"DORESOPOLIS";13;7;1;21
2011;"DOURADOQUARA (MG)";"MG";"DOURADOQUARA";25;8;1;34
2011;"DURANDE (MG)";"MG";"DURANDE";82;6;12;100
2011;"ELOI MENDES (MG)";"MG";"ELOI MENDES";487;60;48;595
2011;"ENGENHEIRO CALDAS (MG)";"MG";"ENGENHEIRO CALDAS";130;7;10;147
2011;"ENGENHEIRO NAVARRO (MG)";"MG";"ENGENHEIRO NAVARRO";56;2;19;77
2011;"ENTRE FOLHAS (MG)";"MG";"ENTRE FOLHAS";54;2;8;64
2011;"ENTRE RIOS DE MINAS (MG)";"MG";"ENTRE RIOS DE MINAS";278;23;75;376
2011;"ERVALIA (MG)";"MG";"ERVALIA";290;16;37;343
2011;"ESMERALDAS (MG)";"MG";"ESMERALDAS";388;38;322;748
2011;"ESPERA FELIZ (MG)";"MG";"ESPERA FELIZ";299;30;38;367
2011;"ESPINOSA (MG)";"MG";"ESPINOSA";261;11;56;328
2011;"ESPIRITO SANTO DO DOURADO (MG)";"MG";"ESPIRITO SANTO DO DOURADO";68;4;5;77
2011;"ESTIVA (MG)";"MG";"ESTIVA";277;23;16;316
2011;"ESTRELA DALVA (MG)";"MG";"ESTRELA DALVA";27;5;1;33
2011;"ESTRELA DO INDAIA (MG)";"MG";"ESTRELA DO INDAIA";42;10;3;55
2011;"ESTRELA DO SUL (MG)";"MG";"ESTRELA DO SUL";110;15;19;144
2011;"EUGENOPOLIS (MG)";"MG";"EUGENOPOLIS";83;25;29;137
2011;"EWBANK DA CAMARA (MG)";"MG";"EWBANK DA CAMARA";39;6;2;47
2011;"EXTREMA (MG)";"MG";"EXTREMA";525;87;89;701
2011;"FAMA (MG)";"MG";"FAMA";14;8;2;24
2011;"FARIA LEMOS (MG)";"MG";"FARIA LEMOS";26;8;1;35
2011;"FELICIO DOS SANTOS (MG)";"MG";"FELICIO DOS SANTOS";27;10;17;54
2011;"FELISBURGO (MG)";"MG";"FELISBURGO";19;3;7;29
2011;"FELIXLANDIA (MG)";"MG";"FELIXLANDIA";188;17;44;249
2011;"FERNANDES TOURINHO (MG)";"MG";"FERNANDES TOURINHO";20;8;8;36
2011;"FERROS (MG)";"MG";"FERROS";96;10;44;150
2011;"FERVEDOURO (MG)";"MG";"FERVEDOURO";105;12;9;126
2011;"FLORESTAL (MG)";"MG";"FLORESTAL";54;10;16;80
2011;"FORMIGA (MG)";"MG";"FORMIGA";1570;149;221;1940
2011;"FORMOSO (MG)";"MG";"FORMOSO";36;2;22;60
2011;"FORTALEZA DE MINAS (MG)";"MG";"FORTALEZA DE MINAS";48;22;11;81
2011;"FORTUNA DE MINAS (MG)";"MG";"FORTUNA DE MINAS";29;3;6;38
2011;"FRANCISCO BADARO (MG)";"MG";"FRANCISCO BADARO";45;2;17;64
2011;"FRANCISCO DUMONT (MG)";"MG";"FRANCISCO DUMONT";53;4;29;86
2011;"FRANCISCO SA (MG)";"MG";"FRANCISCO SA";124;6;78;208
2011;"FRANCISCOPOLIS (MG)";"MG";"FRANCISCOPOLIS";15;8;13;36
2011;"FREI GASPAR (MG)";"MG";"FREI GASPAR";24;9;8;41
2011;"FREI INOCENCIO (MG)";"MG";"FREI INOCENCIO";86;7;23;116
2011;"FREI LAGONEGRO (MG)";"MG";"FREI LAGONEGRO";6;3;7;16
2011;"FRONTEIRA (MG)";"MG";"FRONTEIRA";198;34;65;297
2011;"FRONTEIRA DOS VALES (MG)";"MG";"FRONTEIRA DOS VALES";8;6;1;15
2011;"FRUTA DE LEITE (MG)";"MG";"FRUTA DE LEITE";20;3;25;48
2011;"FRUTAL (MG)";"MG";"FRUTAL";1400;116;191;1707
2011;"FUNILANDIA (MG)";"MG";"FUNILANDIA";34;5;13;52
2011;"GALILEIA (MG)";"MG";"GALILEIA";59;1;8;68
2011;"GAMELEIRAS (MG)";"MG";"GAMELEIRAS";26;4;13;43
2011;"GLAUCILANDIA (MG)";"MG";"GLAUCILANDIA";0;2;3;5
2011;"GOIABEIRA (MG)";"MG";"GOIABEIRA";26;9;4;39
2011;"GOIANA (MG)";"MG";"GOIANA";18;9;5;32
2011;"GONCALVES (MG)";"MG";"GONCALVES";103;16;4;123
2011;"GONZAGA (MG)";"MG";"GONZAGA";36;5;10;51
2011;"GOUVEA (MG)";"MG";"GOUVEA";130;13;30;173
2011;"GOVERNADOR VALADARES (MG)";"MG";"GOVERNADOR VALADARES";3220;247;343;3810
2011;"GRAO MOGOL (MG)";"MG";"GRAO MOGOL";60;10;65;135
2011;"GRUPIARA (MG)";"MG";"GRUPIARA";9;3;3;15
2011;"GUANHAES (MG)";"MG";"GUANHAES";459;41;90;590
2011;"GUAPE (MG)";"MG";"GUAPE";197;21;49;267
2011;"GUARACIABA (MG)";"MG";"GUARACIABA";66;13;33;112
2011;"GUARACIAMA (MG)";"MG";"GUARACIAMA";35;3;12;50
2011;"GUARANESIA (MG)";"MG";"GUARANESIA";318;44;81;443
2011;"GUARANI (MG)";"MG";"GUARANI";80;14;8;102
2011;"GUARARA (MG)";"MG";"GUARARA";48;11;3;62
2011;"GUARDA MOR (MG)";"MG";"GUARDA MOR";85;12;15;112
2011;"GUAXUPE (MG)";"MG";"GUAXUPE";806;76;165;1047
2011;"GUIDOVAL (MG)";"MG";"GUIDOVAL";133;2;5;140
2011;"GUIMARANIA (MG)";"MG";"GUIMARANIA";119;7;24;150
2011;"GUIRICEMA (MG)";"MG";"GUIRICEMA";234;12;23;269
2011;"GURINHATA (MG)";"MG";"GURINHATA";79;13;20;112
2011;"HELIODORA (MG)";"MG";"HELIODORA";79;7;11;97
2011;"IAPU (MG)";"MG";"IAPU";118;15;15;148
2011;"IBERTIOGA (MG)";"MG";"IBERTIOGA";38;11;3;52
2011;"IBIA (MG)";"MG";"IBIA";357;38;89;484
2011;"IBIAI (MG)";"MG";"IBIAI";43;7;7;57
2011;"IBIRACATU (MG)";"MG";"IBIRACATU";14;8;14;36
2011;"IBIRACI (MG)";"MG";"IBIRACI";329;30;36;395
2011;"IBIRITE (MG)";"MG";"IBIRITE";1143;185;282;1610
2011;"IBITIURA DE MINAS (MG)";"MG";"IBITIURA DE MINAS";93;7;4;104
2011;"IBITURUNA (MG)";"MG";"IBITURUNA";24;6;4;34
2011;"ICARAI DE MINAS (MG)";"MG";"ICARAI DE MINAS";23;1;6;30
2011;"IGARAPE (MG)";"MG";"IGARAPE";630;52;152;834
2011;"IGARATINGA (MG)";"MG";"IGARATINGA";479;11;13;503
2011;"IGUATAMA (MG)";"MG";"IGUATAMA";124;12;16;152
2011;"IJACI (MG)";"MG";"IJACI";128;10;12;150
2011;"ILICINEA (MG)";"MG";"ILICINEA";188;11;40;239
2011;"IMBE DE MINAS (MG)";"MG";"IMBE DE MINAS";40;2;9;51
2011;"INCONFIDENTES (MG)";"MG";"INCONFIDENTES";66;16;21;103
2011;"INDAIABIRA (MG)";"MG";"INDAIABIRA";51;5;22;78
2011;"INDIANOPOLIS (MG)";"MG";"INDIANOPOLIS";72;27;20;119
2011;"INGAI (MG)";"MG";"INGAI";16;14;8;38
2011;"INHAPIM (MG)";"MG";"INHAPIM";362;14;63;439
2011;"INHAUMA (MG)";"MG";"INHAUMA";91;6;19;116
2011;"INIMUTABA (MG)";"MG";"INIMUTABA";34;5;7;46
2011;"IPABA (MG)";"MG";"IPABA";86;14;13;113
2011;"IPANEMA (MG)";"MG";"IPANEMA";212;29;30;271
2011;"IPATINGA (MG)";"MG";"IPATINGA";3003;495;608;4106
2011;"IPIACU (MG)";"MG";"IPIACU";50;2;12;64
2011;"IPUIUNA (MG)";"MG";"IPUIUNA";354;29;21;404
2011;"IRAI DE MINAS (MG)";"MG";"IRAI DE MINAS";191;12;30;233
2011;"ITABIRA (MG)";"MG";"ITABIRA";1494;277;471;2242
2011;"ITABIRINHA (MG)";"MG";"ITABIRINHA";113;5;28;146
2011;"ITABIRITO (MG)";"MG";"ITABIRITO";897;190;311;1398
2011;"ITACAMBIRA (MG)";"MG";"ITACAMBIRA";11;0;8;19
2011;"ITACARAMBI (MG)";"MG";"ITACARAMBI";95;6;29;130
2011;"ITAGUARA (MG)";"MG";"ITAGUARA";413;23;47;483
2011;"ITAIPE (MG)";"MG";"ITAIPE";60;6;22;88
2011;"ITAJUBA (MG)";"MG";"ITAJUBA";813;96;126;1035
2011;"ITAMARANDIBA (MG)";"MG";"ITAMARANDIBA";586;38;98;722
2011;"ITAMARATI DE MINAS (MG)";"MG";"ITAMARATI DE MINAS";109;12;13;134
2011;"ITAMBACURI (MG)";"MG";"ITAMBACURI";178;20;35;233
2011;"ITAMBE DO MATO DENTRO (MG)";"MG";"ITAMBE DO MATO DENTRO";20;7;4;31
2011;"ITAMOGI (MG)";"MG";"ITAMOGI";224;19;25;268
2011;"ITAMONTE (MG)";"MG";"ITAMONTE";297;22;24;343
2011;"ITANHANDU (MG)";"MG";"ITANHANDU";346;28;23;397
2011;"ITANHOMI (MG)";"MG";"ITANHOMI";93;15;18;126
2011;"ITAOBIM (MG)";"MG";"ITAOBIM";200;24;36;260
2011;"ITAPAGIPE (MG)";"MG";"ITAPAGIPE";190;20;31;241
2011;"ITAPECERICA (MG)";"MG";"ITAPECERICA";315;40;65;420
2011;"ITAPEVA (MG)";"MG";"ITAPEVA";244;24;9;277
2011;"ITATIAIUCU (MG)";"MG";"ITATIAIUCU";339;11;35;385
2011;"ITAU DE MINAS (MG)";"MG";"ITAU DE MINAS";247;40;35;322
2011;"ITAUNA (MG)";"MG";"ITAUNA";1452;238;264;1954
2011;"ITAVERAVA (MG)";"MG";"ITAVERAVA";53;4;9;66
2011;"ITINGA (MG)";"MG";"ITINGA";55;15;28;98
2011;"ITUETA (MG)";"MG";"ITUETA";51;8;16;75
2011;"ITUIUTABA (MG)";"MG";"ITUIUTABA";1118;191;262;1571
2011;"ITUMIRIM (MG)";"MG";"ITUMIRIM";52;22;7;81
2011;"ITURAMA (MG)";"MG";"ITURAMA";749;76;307;1132
2011;"ITUTINGA (MG)";"MG";"ITUTINGA";63;23;1;87
2011;"JABOTICATUBAS (MG)";"MG";"JABOTICATUBAS";221;8;55;284
2011;"JACINTO (MG)";"MG";"JACINTO";24;6;34;64
2011;"JACUI (MG)";"MG";"JACUI";108;13;24;145
2011;"JACUTINGA (MG)";"MG";"JACUTINGA";338;56;56;450
2011;"JAGUARACU (MG)";"MG";"JAGUARACU";49;3;3;55
2011;"JAIBA (MG)";"MG";"JAIBA";297;13;90;400
2011;"JAMPRUCA (MG)";"MG";"JAMPRUCA";12;4;19;35
2011;"JANAUBA (MG)";"MG";"JANAUBA";758;25;125;908
2011;"JANUARIA (MG)";"MG";"JANUARIA";347;19;88;454
2011;"JAPARAIBA (MG)";"MG";"JAPARAIBA";59;4;17;80
2011;"JAPONVAR (MG)";"MG";"JAPONVAR";11;4;10;25
2011;"JECEABA (MG)";"MG";"JECEABA";105;33;14;152
2011;"JENIPAPO DE MINAS (MG)";"MG";"JENIPAPO DE MINAS";26;14;13;53
2011;"JEQUERI (MG)";"MG";"JEQUERI";85;7;22;114
2011;"JEQUITAI (MG)";"MG";"JEQUITAI";62;3;24;89
2011;"JEQUITIBA (MG)";"MG";"JEQUITIBA";69;9;25;103
2011;"JEQUITINHONHA (MG)";"MG";"JEQUITINHONHA";83;26;23;132
2011;"JESUANIA (MG)";"MG";"JESUANIA";56;20;9;85
2011;"JOAIMA (MG)";"MG";"JOAIMA";58;8;25;91
2011;"JOANESIA (MG)";"MG";"JOANESIA";13;4;14;31
2011;"JOAO MONLEVADE (MG)";"MG";"JOAO MONLEVADE";1112;117;243;1472
2011;"JOAO PINHEIRO (MG)";"MG";"JOAO PINHEIRO";865;40;199;1104
2011;"JOAQUIM FELICIO (MG)";"MG";"JOAQUIM FELICIO";36;2;9;47
2011;"JORDANIA (MG)";"MG";"JORDANIA";23;9;19;51
2011;"JOSE GONCALVES DE MINAS (MG)";"MG";"JOSE GONCALVES DE MINAS";25;7;10;42
2011;"JOSE RAYDAN (MG)";"MG";"JOSE RAYDAN";22;1;13;36
2011;"JOSENOPOLIS (MG)";"MG";"JOSENOPOLIS";18;4;8;30
2011;"JUATUBA (MG)";"MG";"JUATUBA";272;32;193;497
2011;"JUIZ DE FORA (MG)";"MG";"JUIZ DE FORA";5411;666;1498;7575
2011;"JURAMENTO (MG)";"MG";"JURAMENTO";16;2;12;30
2011;"JURUAIA (MG)";"MG";"JURUAIA";87;18;17;122
2011;"JUVENILIA (MG)";"MG";"JUVENILIA";16;5;6;27
2011;"LADAINHA (MG)";"MG";"LADAINHA";50;14;23;87
2011;"LAGAMAR (MG)";"MG";"LAGAMAR";78;19;21;118
2011;"LAGOA DA PRATA (MG)";"MG";"LAGOA DA PRATA";864;55;145;1064
2011;"LAGOA DOS PATOS (MG)";"MG";"LAGOA DOS PATOS";28;2;8;38
2011;"LAGOA DOURADA (MG)";"MG";"LAGOA DOURADA";382;16;66;464
2011;"LAGOA FORMOSA (MG)";"MG";"LAGOA FORMOSA";293;21;76;390
2011;"LAGOA GRANDE (MG)";"MG";"LAGOA GRANDE";95;8;48;151
2011;"LAGOA SANTA (MG)";"MG";"LAGOA SANTA";715;95;126;936
2011;"LAJINHA (MG)";"MG";"LAJINHA";235;23;45;303
2011;"LAMBARI (MG)";"MG";"LAMBARI";262;38;21;321
2011;"LAMIM (MG)";"MG";"LAMIM";38;4;6;48
2011;"LARANJAL (MG)";"MG";"LARANJAL";139;10;2;151
2011;"LASSANCE (MG)";"MG";"LASSANCE";37;9;6;52
2011;"LAVRAS (MG)";"MG";"LAVRAS";1225;175;239;1639
2011;"LEANDRO FERREIRA (MG)";"MG";"LEANDRO FERREIRA";35;8;5;48
2011;"LEME DO PRADO (MG)";"MG";"LEME DO PRADO";25;7;20;52
2011;"LEOPOLDINA (MG)";"MG";"LEOPOLDINA";640;59;86;785
2011;"LIBERDADE (MG)";"MG";"LIBERDADE";73;13;6;92
2011;"LIMA DUARTE (MG)";"MG";"LIMA DUARTE";171;30;35;236
2011;"LIMEIRA DO OESTE (MG)";"MG";"LIMEIRA DO OESTE";135;28;48;211
2011;"LONTRA (MG)";"MG";"LONTRA";20;5;9;34
2011;"LUISBURGO (MG)";"MG";"LUISBURGO";26;6;20;52
2011;"LUISLANDIA (MG)";"MG";"LUISLANDIA";13;5;10;28
2011;"LUMINARIAS (MG)";"MG";"LUMINARIAS";98;8;36;142
2011;"LUZ (MG)";"MG";"LUZ";299;57;30;386
2011;"MACHACALIS (MG)";"MG";"MACHACALIS";25;1;6;32
2011;"MACHADO (MG)";"MG";"MACHADO";696;106;106;908
2011;"MADRE DE DEUS DE MINAS (MG)";"MG";"MADRE DE DEUS DE MINAS";78;5;6;89
2011;"MALACACHETA (MG)";"MG";"MALACACHETA";103;9;40;152
2011;"MAMONAS (MG)";"MG";"MAMONAS";97;7;21;125
2011;"MANGA (MG)";"MG";"MANGA";120;10;45;175
2011;"MANHUACU (MG)";"MG";"MANHUACU";1365;100;139;1604
2011;"MANHUMIRIM (MG)";"MG";"MANHUMIRIM";276;26;39;341
2011;"MANTENA (MG)";"MG";"MANTENA";518;38;81;637
2011;"MAR DE ESPANHA (MG)";"MG";"MAR DE ESPANHA";141;22;12;175
2011;"MARAVILHAS (MG)";"MG";"MARAVILHAS";160;18;8;186
2011;"MARIA DA FE (MG)";"MG";"MARIA DA FE";234;10;30;274
2011;"MARIANA (MG)";"MG";"MARIANA";588;185;306;1079
2011;"MARILAC (MG)";"MG";"MARILAC";19;5;8;32
2011;"MARIO CAMPOS (MG)";"MG";"MARIO CAMPOS";179;18;13;210
2011;"MARIPA DE MINAS (MG)";"MG";"MARIPA DE MINAS";40;4;3;47
2011;"MARLIERIA (MG)";"MG";"MARLIERIA";35;3;7;45
2011;"MARMELOPOLIS (MG)";"MG";"MARMELOPOLIS";37;8;7;52
2011;"MARTINHO CAMPOS (MG)";"MG";"MARTINHO CAMPOS";344;31;68;443
2011;"MARTINS SOARES (MG)";"MG";"MARTINS SOARES";81;5;13;99
2011;"MATA VERDE (MG)";"MG";"MATA VERDE";16;18;3;37
2011;"MATERLANDIA (MG)";"MG";"MATERLANDIA";10;4;3;17
2011;"MATEUS LEME (MG)";"MG";"MATEUS LEME";602;76;111;789
2011;"MATHIAS LOBATO (MG)";"MG";"MATHIAS LOBATO";32;2;6;40
2011;"MATIAS BARBOSA (MG)";"MG";"MATIAS BARBOSA";591;32;39;662
2011;"MATIAS CARDOSO (MG)";"MG";"MATIAS CARDOSO";22;5;15;42
2011;"MATIPO (MG)";"MG";"MATIPO";259;25;42;326
2011;"MATO VERDE (MG)";"MG";"MATO VERDE";140;8;26;174
2011;"MATOZINHOS (MG)";"MG";"MATOZINHOS";342;79;150;571
2011;"MATUTINA (MG)";"MG";"MATUTINA";70;15;5;90
2011;"MEDEIROS (MG)";"MG";"MEDEIROS";48;19;3;70
2011;"MEDINA (MG)";"MG";"MEDINA";141;43;35;219
2011;"MENDES PIMENTEL (MG)";"MG";"MENDES PIMENTEL";42;6;11;59
2011;"MERCES (MG)";"MG";"MERCES";168;11;11;190
2011;"MESQUITA (MG)";"MG";"MESQUITA";21;11;6;38
2011;"MINAS NOVAS (MG)";"MG";"MINAS NOVAS";120;27;87;234
2011;"MINDURI (MG)";"MG";"MINDURI";73;10;3;86
2011;"MIRABELA (MG)";"MG";"MIRABELA";88;12;26;126
2011;"MIRADOURO (MG)";"MG";"MIRADOURO";113;16;29;158
2011;"MIRAI (MG)";"MG";"MIRAI";147;11;18;176
2011;"MIRAVANIA (MG)";"MG";"MIRAVANIA";8;3;7;18
2011;"MOEDA (MG)";"MG";"MOEDA";113;4;14;131
2011;"MOEMA (MG)";"MG";"MOEMA";150;11;121;282
2011;"MONJOLOS (MG)";"MG";"MONJOLOS";9;2;6;17
2011;"MONSENHOR PAULO (MG)";"MG";"MONSENHOR PAULO";159;19;11;189
2011;"MONTALVANIA (MG)";"MG";"MONTALVANIA";113;6;45;164
2011;"MONTE ALEGRE DE MINAS (MG)";"MG";"MONTE ALEGRE DE MINAS";488;42;40;570
2011;"MONTE AZUL (MG)";"MG";"MONTE AZUL";171;12;60;243
2011;"MONTE BELO (MG)";"MG";"MONTE BELO";242;31;48;321
2011;"MONTE CARMELO (MG)";"MG";"MONTE CARMELO";1315;99;136;1550
2011;"MONTE FORMOSO (MG)";"MG";"MONTE FORMOSO";13;6;26;45
2011;"MONTE SANTO DE MINAS (MG)";"MG";"MONTE SANTO DE MINAS";412;40;100;552
2011;"MONTE SIAO (MG)";"MG";"MONTE SIAO";237;40;34;311
2011;"MONTES CLAROS (MG)";"MG";"MONTES CLAROS";4149;258;988;5395
2011;"MONTEZUMA (MG)";"MG";"MONTEZUMA";24;8;19;51
2011;"MORADA NOVA DE MINAS (MG)";"MG";"MORADA NOVA DE MINAS";105;18;19;142
2011;"MORRO DA GARCA (MG)";"MG";"MORRO DA GARCA";41;7;16;64
2011;"MORRO DO PILAR (MG)";"MG";"MORRO DO PILAR";23;5;0;28
2011;"MUNHOZ (MG)";"MG";"MUNHOZ";141;13;10;164
2011;"MURIAE (MG)";"MG";"MURIAE";1352;113;183;1648
2011;"MUTUM (MG)";"MG";"MUTUM";181;24;60;265
2011;"MUZAMBINHO (MG)";"MG";"MUZAMBINHO";397;74;53;524
2011;"NACIP RAYDAN (MG)";"MG";"NACIP RAYDAN";7;0;4;11
2011;"NANUQUE (MG)";"MG";"NANUQUE";590;59;179;828
2011;"NAQUE (MG)";"MG";"NAQUE";37;3;19;59
2011;"NATALANDIA (MG)";"MG";"NATALANDIA";24;1;14;39
2011;"NATERCIA (MG)";"MG";"NATERCIA";84;12;16;112
2011;"NAZARENO (MG)";"MG";"NAZARENO";171;12;27;210
2011;"NEPOMUCENO (MG)";"MG";"NEPOMUCENO";400;27;79;506
2011;"NINHEIRA (MG)";"MG";"NINHEIRA";27;5;20;52
2011;"NOVA BELEM (MG)";"MG";"NOVA BELEM";35;4;13;52
2011;"NOVA ERA (MG)";"MG";"NOVA ERA";192;25;60;277
2011;"NOVA LIMA (MG)";"MG";"NOVA LIMA";1155;277;180;1612
2011;"NOVA MODICA (MG)";"MG";"NOVA MODICA";16;2;14;32
2011;"NOVA PONTE (MG)";"MG";"NOVA PONTE";221;57;69;347
2011;"NOVA PORTEIRINHA (MG)";"MG";"NOVA PORTEIRINHA";31;3;12;46
2011;"NOVA RESENDE (MG)";"MG";"NOVA RESENDE";326;26;53;405
2011;"NOVA SERRANA (MG)";"MG";"NOVA SERRANA";499;46;79;624
2011;"NOVA UNIAO (MG)";"MG";"NOVA UNIAO";128;10;18;156
2011;"NOVO CRUZEIRO (MG)";"MG";"NOVO CRUZEIRO";156;28;82;266
2011;"NOVO ORIENTE DE MINAS (MG)";"MG";"NOVO ORIENTE DE MINAS";36;17;15;68
2011;"NOVORIZONTE (MG)";"MG";"NOVORIZONTE";50;2;12;64
2011;"OLARIA (MG)";"MG";"OLARIA";13;3;4;20
2011;"OLHOS D AGUA (MG)";"MG";"OLHOS D AGUA";64;12;35;111
2011;"OLIMPIO NORONHA (MG)";"MG";"OLIMPIO NORONHA";21;12;7;40
2011;"OLIVEIRA (MG)";"MG";"OLIVEIRA";756;64;117;937
2011;"OLIVEIRA FORTES (MG)";"MG";"OLIVEIRA FORTES";23;4;2;29
2011;"ONCA DE PITANGUI (MG)";"MG";"ONCA DE PITANGUI";31;7;7;45
2011;"ORATORIOS (MG)";"MG";"ORATORIOS";73;6;18;97
2011;"ORIZANIA (MG)";"MG";"ORIZANIA";54;10;9;73
2011;"OURO BRANCO (MG)";"MG";"OURO BRANCO";518;121;204;843
2011;"OURO FINO (MG)";"MG";"OURO FINO";507;69;89;665
2011;"OURO PRETO (MG)";"MG";"OURO PRETO";933;208;256;1397
2011;"OURO VERDE DE MINAS (MG)";"MG";"OURO VERDE DE MINAS";22;6;6;34
2011;"PADRE CARVALHO (MG)";"MG";"PADRE CARVALHO";21;6;23;50
2011;"PADRE PARAISO (MG)";"MG";"PADRE PARAISO";128;60;56;244
2011;"PAI PEDRO (MG)";"MG";"PAI PEDRO";10;4;17;31
2011;"PAINEIRAS (MG)";"MG";"PAINEIRAS";83;13;10;106
2011;"PAINS (MG)";"MG";"PAINS";225;15;21;261
2011;"PAIVA (MG)";"MG";"PAIVA";10;1;1;12
2011;"PALMA (MG)";"MG";"PALMA";89;7;5;101
2011;"PALMOPOLIS (MG)";"MG";"PALMOPOLIS";12;7;8;27
2011;"PAPAGAIOS (MG)";"MG";"PAPAGAIOS";537;10;57;604
2011;"PARA DE MINAS (MG)";"MG";"PARA DE MINAS";2091;153;219;2463
2011;"PARACATU (MG)";"MG";"PARACATU";1391;101;352;1844
2011;"PARAGUACU (MG)";"MG";"PARAGUACU";292;48;31;371
2011;"PARAISOPOLIS (MG)";"MG";"PARAISOPOLIS";330;45;32;407
2011;"PARAOPEBA (MG)";"MG";"PARAOPEBA";425;25;50;500
2011;"PASSA QUATRO (MG)";"MG";"PASSA QUATRO";327;24;30;381
2011;"PASSA TEMPO (MG)";"MG";"PASSA TEMPO";175;31;15;221
2011;"PASSA VINTE (MG)";"MG";"PASSA VINTE";72;18;8;98
2011;"PASSABEM (MG)";"MG";"PASSABEM";13;4;2;19
2011;"PASSOS (MG)";"MG";"PASSOS";1933;162;396;2491
2011;"PATIS (MG)";"MG";"PATIS";11;3;8;22
2011;"PATOS DE MINAS (MG)";"MG";"PATOS DE MINAS";3006;152;393;3551
2011;"PATROCINIO (MG)";"MG";"PATROCINIO";1619;132;538;2289
2011;"PATROCINIO DO MURIAE (MG)";"MG";"PATROCINIO DO MURIAE";77;9;7;93
2011;"PAULA CANDIDO (MG)";"MG";"PAULA CANDIDO";69;11;14;94
2011;"PAULISTAS (MG)";"MG";"PAULISTAS";16;3;9;28
2011;"PAVAO (MG)";"MG";"PAVAO";44;17;9;70
2011;"PECANHA (MG)";"MG";"PECANHA";113;8;55;176
2011;"PEDRA AZUL (MG)";"MG";"PEDRA AZUL";133;17;47;197
2011;"PEDRA BONITA (MG)";"MG";"PEDRA BONITA";44;12;16;72
2011;"PEDRA DO ANTA (MG)";"MG";"PEDRA DO ANTA";31;3;14;48
2011;"PEDRA DO INDAIA (MG)";"MG";"PEDRA DO INDAIA";66;8;3;77
2011;"PEDRA DOURADA (MG)";"MG";"PEDRA DOURADA";15;5;10;30
2011;"PEDRALVA (MG)";"MG";"PEDRALVA";132;22;24;178
2011;"PEDRAS DE MARIA DA CRUZ (MG)";"MG";"PEDRAS DE MARIA DA CRUZ";23;3;30;56
2011;"PEDRINOPOLIS (MG)";"MG";"PEDRINOPOLIS";61;17;5;83
2011;"PEDRO LEOPOLDO (MG)";"MG";"PEDRO LEOPOLDO";1051;156;245;1452
2011;"PEDRO TEIXEIRA (MG)";"MG";"PEDRO TEIXEIRA";18;7;3;28
2011;"PEQUERI (MG)";"MG";"PEQUERI";72;7;3;82
2011;"PEQUI (MG)";"MG";"PEQUI";50;15;5;70
2011;"PERDIGAO (MG)";"MG";"PERDIGAO";147;15;7;169
2011;"PERDIZES (MG)";"MG";"PERDIZES";264;52;35;351
2011;"PERDOES (MG)";"MG";"PERDOES";502;34;62;598
2011;"PERIQUITO (MG)";"MG";"PERIQUITO";41;6;20;67
2011;"PESCADOR (MG)";"MG";"PESCADOR";14;7;7;28
2011;"PIAU (MG)";"MG";"PIAU";44;9;8;61
2011;"PIEDADE DE CARATINGA (MG)";"MG";"PIEDADE DE CARATINGA";129;12;13;154
2011;"PIEDADE DE PONTE NOVA (MG)";"MG";"PIEDADE DE PONTE NOVA";40;5;15;60
2011;"PIEDADE DO RIO GRANDE (MG)";"MG";"PIEDADE DO RIO GRANDE";52;7;6;65
2011;"PIEDADE DOS GERAIS (MG)";"MG";"PIEDADE DOS GERAIS";74;5;12;91
2011;"PIMENTA (MG)";"MG";"PIMENTA";210;9;24;243
2011;"PINGO D AGUA (MG)";"MG";"PINGO D AGUA";23;3;5;31
2011;"PINTOPOLIS (MG)";"MG";"PINTOPOLIS";13;2;2;17
2011;"PIRACEMA (MG)";"MG";"PIRACEMA";97;11;14;122
2011;"PIRAJUBA (MG)";"MG";"PIRAJUBA";135;24;6;165
2011;"PIRANGA (MG)";"MG";"PIRANGA";142;20;45;207
2011;"PIRANGUCU (MG)";"MG";"PIRANGUCU";41;23;30;94
2011;"PIRANGUINHO (MG)";"MG";"PIRANGUINHO";146;19;12;177
2011;"PIRAPETINGA (MG)";"MG";"PIRAPETINGA";367;18;32;417
2011;"PIRAPORA (MG)";"MG";"PIRAPORA";544;36;142;722
2011;"PIRAUBA (MG)";"MG";"PIRAUBA";116;21;13;150
2011;"PITANGUI (MG)";"MG";"PITANGUI";527;61;84;672
2011;"PIUMHI (MG)";"MG";"PIUMHI";712;61;82;855
2011;"PLANURA (MG)";"MG";"PLANURA";143;16;49;208
2011;"POCO FUNDO (MG)";"MG";"POCO FUNDO";259;49;17;325
2011;"POCOS DE CALDAS (MG)";"MG";"POCOS DE CALDAS";2760;516;411;3687
2011;"POCRANE (MG)";"MG";"POCRANE";65;8;9;82
2011;"POMPEU (MG)";"MG";"POMPEU";417;27;112;556
2011;"PONTE NOVA (MG)";"MG";"PONTE NOVA";973;64;163;1200
2011;"PONTO CHIQUE (MG)";"MG";"PONTO CHIQUE";12;1;10;23
2011;"PONTO DOS VOLANTES (MG)";"MG";"PONTO DOS VOLANTES";35;5;27;67
2011;"PORTEIRINHA (MG)";"MG";"PORTEIRINHA";292;22;161;475
2011;"PORTO FIRME (MG)";"MG";"PORTO FIRME";71;9;16;96
2011;"POTE (MG)";"MG";"POTE";63;12;32;107
2011;"POUSO ALEGRE (MG)";"MG";"POUSO ALEGRE";2453;256;481;3190
2011;"POUSO ALTO (MG)";"MG";"POUSO ALTO";113;12;6;131
2011;"PRADOS (MG)";"MG";"PRADOS";96;12;10;118
2011;"PRATA (MG)";"MG";"PRATA";406;92;81;579
2011;"PRATAPOLIS (MG)";"MG";"PRATAPOLIS";167;23;19;209
2011;"PRATINHA (MG)";"MG";"PRATINHA";47;8;3;58
2011;"PRESIDENTE BERNARDES (MG)";"MG";"PRESIDENTE BERNARDES";24;9;10;43
2011;"PRESIDENTE JUSCELINO (MG)";"MG";"PRESIDENTE JUSCELINO";46;3;14;63
2011;"PRESIDENTE KUBITSCHEK (MG)";"MG";"PRESIDENTE KUBITSCHEK";21;14;8;43
2011;"PRESIDENTE OLEGARIO (MG)";"MG";"PRESIDENTE OLEGARIO";211;15;84;310
2011;"PRUDENTE DE MORAIS (MG)";"MG";"PRUDENTE DE MORAIS";89;9;9;107
2011;"QUARTEL GERAL (MG)";"MG";"QUARTEL GERAL";45;6;3;54
2011;"QUELUZITA (MG)";"MG";"QUELUZITA";19;7;3;29
2011;"RAPOSOS (MG)";"MG";"RAPOSOS";69;39;27;135
2011;"RAUL SOARES (MG)";"MG";"RAUL SOARES";213;27;47;287
2011;"RECREIO (MG)";"MG";"RECREIO";170;19;23;212
2011;"REDUTO (MG)";"MG";"REDUTO";54;8;4;66
2011;"RESENDE COSTA (MG)";"MG";"RESENDE COSTA";188;16;17;221
2011;"RESPLENDOR (MG)";"MG";"RESPLENDOR";216;33;32;281
2011;"RESSAQUINHA (MG)";"MG";"RESSAQUINHA";143;8;13;164
2011;"RIACHINHO (MG)";"MG";"RIACHINHO";88;6;18;112
2011;"RIACHO DOS MACHADOS (MG)";"MG";"RIACHO DOS MACHADOS";47;4;33;84
2011;"RIBEIRAO DAS NEVES (MG)";"MG";"RIBEIRAO DAS NEVES";2397;373;712;3482
2011;"RIBEIRAO VERMELHO (MG)";"MG";"RIBEIRAO VERMELHO";39;10;4;53
2011;"RIO ACIMA (MG)";"MG";"RIO ACIMA";111;16;15;142
2011;"RIO CASCA (MG)";"MG";"RIO CASCA";203;13;47;263
2011;"RIO DO PRADO (MG)";"MG";"RIO DO PRADO";15;8;8;31
2011;"RIO DOCE (MG)";"MG";"RIO DOCE";15;6;7;28
2011;"RIO ESPERA (MG)";"MG";"RIO ESPERA";33;0;6;39
2011;"RIO MANSO (MG)";"MG";"RIO MANSO";135;4;11;150
2011;"RIO NOVO (MG)";"MG";"RIO NOVO";118;23;22;163
2011;"RIO PARANAIBA (MG)";"MG";"RIO PARANAIBA";192;11;58;261
2011;"RIO PARDO DE MINAS (MG)";"MG";"RIO PARDO DE MINAS";192;18;109;319
2011;"RIO PIRACICABA (MG)";"MG";"RIO PIRACICABA";188;21;35;244
2011;"RIO POMBA (MG)";"MG";"RIO POMBA";252;30;32;314
2011;"RIO PRETO (MG)";"MG";"RIO PRETO";875;83;88;1046
2011;"RIO VERMELHO (MG)";"MG";"RIO VERMELHO";67;23;39;129
2011;"RITAPOLIS (MG)";"MG";"RITAPOLIS";28;11;7;46
2011;"ROCHEDO DE MINAS (MG)";"MG";"ROCHEDO DE MINAS";19;5;2;26
2011;"RODEIRO (MG)";"MG";"RODEIRO";235;7;19;261
2011;"ROMARIA (MG)";"MG";"ROMARIA";43;21;8;72
2011;"ROSARIO DA LIMEIRA (MG)";"MG";"ROSARIO DA LIMEIRA";64;8;35;107
2011;"RUBELITA (MG)";"MG";"RUBELITA";15;5;7;27
2011;"RUBIM (MG)";"MG";"RUBIM";26;0;27;53
2011;"SABARA (MG)";"MG";"SABARA";665;187;332;1184
2011;"SABINOPOLIS (MG)";"MG";"SABINOPOLIS";124;23;38;185
2011;"SACRAMENTO (MG)";"MG";"SACRAMENTO";451;81;60;592
2011;"SALINAS (MG)";"MG";"SALINAS";369;45;119;533
2011;"SALTO DA DIVISA (MG)";"MG";"SALTO DA DIVISA";8;6;6;20
2011;"SANTA BARBARA (MG)";"MG";"SANTA BARBARA";398;67;97;562
2011;"SANTA BARBARA DO LESTE (MG)";"MG";"SANTA BARBARA DO LESTE";171;7;6;184
2011;"SANTA BARBARA DO MONTE VERDE (MG)";"MG";"SANTA BARBARA DO MONTE VERDE";1098;82;177;1357
2011;"SANTA BARBARA DO TUGURIO (MG)";"MG";"SANTA BARBARA DO TUGURIO";59;20;35;114
2011;"SANTA CRUZ DE MINAS (MG)";"MG";"SANTA CRUZ DE MINAS";65;5;2;72
2011;"SANTA CRUZ DE SALINAS (MG)";"MG";"SANTA CRUZ DE SALINAS";16;2;18;36
2011;"SANTA CRUZ DO ESCALVADO (MG)";"MG";"SANTA CRUZ DO ESCALVADO";33;5;9;47
2011;"SANTA EFIGENIA DE MINAS (MG)";"MG";"SANTA EFIGENIA DE MINAS";26;5;3;34
2011;"SANTA FE DE MINAS (MG)";"MG";"SANTA FE DE MINAS";7;2;1;10
2011;"SANTA HELENA DE MINAS (MG)";"MG";"SANTA HELENA DE MINAS";14;6;6;26
2011;"SANTA JULIANA (MG)";"MG";"SANTA JULIANA";339;40;43;422
2011;"SANTA LUZIA (MG)";"MG";"SANTA LUZIA";1756;209;668;2633
2011;"SANTA MARGARIDA (MG)";"MG";"SANTA MARGARIDA";201;27;26;254
2011;"SANTA MARIA DE ITABIRA (MG)";"MG";"SANTA MARIA DE ITABIRA";104;12;35;151
2011;"SANTA MARIA DO SALTO (MG)";"MG";"SANTA MARIA DO SALTO";7;5;5;17
2011;"SANTA MARIA DO SUACUI (MG)";"MG";"SANTA MARIA DO SUACUI";79;4;36;119
2011;"SANTA RITA DE CALDAS (MG)";"MG";"SANTA RITA DE CALDAS";280;24;12;316
2011;"SANTA RITA DE IBITIPOCA (MG)";"MG";"SANTA RITA DE IBITIPOCA";39;6;1;46
2011;"SANTA RITA DE JACUTINGA (MG)";"MG";"SANTA RITA DE JACUTINGA";87;10;6;103
2011;"SANTA RITA DE MINAS (MG)";"MG";"SANTA RITA DE MINAS";103;12;8;123
2011;"SANTA RITA DO ITUETO (MG)";"MG";"SANTA RITA DO ITUETO";69;7;18;94
2011;"SANTA RITA DO SAPUCAI (MG)";"MG";"SANTA RITA DO SAPUCAI";386;68;72;526
2011;"SANTA ROSA DA SERRA (MG)";"MG";"SANTA ROSA DA SERRA";43;7;8;58
2011;"SANTA VITORIA (MG)";"MG";"SANTA VITORIA";348;22;56;426
2011;"SANTANA DA VARGEM (MG)";"MG";"SANTANA DA VARGEM";73;14;24;111
2011;"SANTANA DE CATAGUASES (MG)";"MG";"SANTANA DE CATAGUASES";27;12;7;46
2011;"SANTANA DE PIRAPAMA (MG)";"MG";"SANTANA DE PIRAPAMA";68;1;27;96
2011;"SANTANA DO DESERTO (MG)";"MG";"SANTANA DO DESERTO";55;7;8;70
2011;"SANTANA DO GARAMBEU (MG)";"MG";"SANTANA DO GARAMBEU";11;5;5;21
2011;"SANTANA DO JACARE (MG)";"MG";"SANTANA DO JACARE";33;5;12;50
2011;"SANTANA DO MANHUACU (MG)";"MG";"SANTANA DO MANHUACU";160;7;17;184
2011;"SANTANA DO PARAISO (MG)";"MG";"SANTANA DO PARAISO";122;10;32;164
2011;"SANTANA DO RIACHO (MG)";"MG";"SANTANA DO RIACHO";25;8;9;42
2011;"SANTANA DOS MONTES (MG)";"MG";"SANTANA DOS MONTES";29;7;6;42
2011;"SANTO ANTONIO DO AMPARO (MG)";"MG";"SANTO ANTONIO DO AMPARO";222;39;77;338
2011;"SANTO ANTONIO DO AVENTUREIRO (MG)";"MG";"SANTO ANTONIO DO AVENTUREIRO";52;5;8;65
2011;"SANTO ANTONIO DO GRAMA (MG)";"MG";"SANTO ANTONIO DO GRAMA";47;3;11;61
2011;"SANTO ANTONIO DO ITAMBE (MG)";"MG";"SANTO ANTONIO DO ITAMBE";15;6;9;30
2011;"SANTO ANTONIO DO JACINTO (MG)";"MG";"SANTO ANTONIO DO JACINTO";32;2;27;61
2011;"SANTO ANTONIO DO MONTE (MG)";"MG";"SANTO ANTONIO DO MONTE";465;53;91;609
2011;"SANTO ANTONIO DO RETIRO (MG)";"MG";"SANTO ANTONIO DO RETIRO";30;3;21;54
2011;"SANTO ANTONIO DO RIO ABAIXO (MG)";"MG";"SANTO ANTONIO DO RIO ABAIXO";8;7;3;18
2011;"SANTO HIPOLITO (MG)";"MG";"SANTO HIPOLITO";22;4;2;28
2011;"SANTOS DUMONT (MG)";"MG";"SANTOS DUMONT";396;83;136;615
2011;"SAO BENTO ABADE (MG)";"MG";"SAO BENTO ABADE";45;13;13;71
2011;"SAO BRAS DO SUACUI (MG)";"MG";"SAO BRAS DO SUACUI";46;5;5;56
2011;"SAO DOMINGOS DAS DORES (MG)";"MG";"SAO DOMINGOS DAS DORES";87;4;6;97
2011;"SAO DOMINGOS DO PRATA (MG)";"MG";"SAO DOMINGOS DO PRATA";229;11;51;291
2011;"SAO FELIX DE MINAS (MG)";"MG";"SAO FELIX DE MINAS";16;3;8;27
2011;"SAO FRANCISCO (MG)";"MG";"SAO FRANCISCO";246;13;88;347
2011;"SAO FRANCISCO DE PAULA (MG)";"MG";"SAO FRANCISCO DE PAULA";73;17;21;111
2011;"SAO FRANCISCO DE SALES (MG)";"MG";"SAO FRANCISCO DE SALES";71;8;19;98
2011;"SAO FRANCISCO DO GLORIA (MG)";"MG";"SAO FRANCISCO DO GLORIA";60;10;7;77
2011;"SAO GERALDO (MG)";"MG";"SAO GERALDO";148;14;8;170
2011;"SAO GERALDO DA PIEDADE (MG)";"MG";"SAO GERALDO DA PIEDADE";12;3;6;21
2011;"SAO GERALDO DO BAIXIO (MG)";"MG";"SAO GERALDO DO BAIXIO";19;7;5;31
2011;"SAO GONCALO DO ABAETE (MG)";"MG";"SAO GONCALO DO ABAETE";71;11;17;99
2011;"SAO GONCALO DO PARA (MG)";"MG";"SAO GONCALO DO PARA";183;9;13;205
2011;"SAO GONCALO DO RIO ABAIXO (MG)";"MG";"SAO GONCALO DO RIO ABAIXO";168;29;26;223
2011;"SAO GONCALO DO RIO PRETO (MG)";"MG";"SAO GONCALO DO RIO PRETO";25;9;5;39
2011;"SAO GONCALO DO SAPUCAI (MG)";"MG";"SAO GONCALO DO SAPUCAI";411;42;69;522
2011;"SAO GOTARDO (MG)";"MG";"SAO GOTARDO";785;89;218;1092
2011;"SAO JOAO BATISTA DO GLORIA (MG)";"MG";"SAO JOAO BATISTA DO GLORIA";127;10;15;152
2011;"SAO JOAO DA LAGOA (MG)";"MG";"SAO JOAO DA LAGOA";25;8;11;44
2011;"SAO JOAO DA MATA (MG)";"MG";"SAO JOAO DA MATA";50;11;0;61
2011;"SAO JOAO DA PONTE (MG)";"MG";"SAO JOAO DA PONTE";56;9;47;112
2011;"SAO JOAO DAS MISSOES (MG)";"MG";"SAO JOAO DAS MISSOES";22;2;16;40
2011;"SAO JOAO DEL REI (MG)";"MG";"SAO JOAO DEL REI";1080;151;209;1440
2011;"SAO JOAO DO MANHUACU (MG)";"MG";"SAO JOAO DO MANHUACU";127;12;18;157
2011;"SAO JOAO DO MANTENINHA (MG)";"MG";"SAO JOAO DO MANTENINHA";81;12;4;97
2011;"SAO JOAO DO ORIENTE (MG)";"MG";"SAO JOAO DO ORIENTE";90;10;4;104
2011;"SAO JOAO DO PACUI (MG)";"MG";"SAO JOAO DO PACUI";7;1;5;13
2011;"SAO JOAO DO PARAISO (MG)";"MG";"SAO JOAO DO PARAISO";167;16;70;253
2011;"SAO JOAO EVANGELISTA (MG)";"MG";"SAO JOAO EVANGELISTA";97;9;35;141
2011;"SAO JOAO NEPOMUCENO (MG)";"MG";"SAO JOAO NEPOMUCENO";261;29;24;314
2011;"SAO JOAQUIM DE BICAS (MG)";"MG";"SAO JOAQUIM DE BICAS";684;82;54;820
2011;"SAO JOSE DA BARRA (MG)";"MG";"SAO JOSE DA BARRA";96;11;26;133
2011;"SAO JOSE DA LAPA (MG)";"MG";"SAO JOSE DA LAPA";264;35;35;334
2011;"SAO JOSE DA SAFIRA (MG)";"MG";"SAO JOSE DA SAFIRA";6;1;4;11
2011;"SAO JOSE DA VARGINHA (MG)";"MG";"SAO JOSE DA VARGINHA";59;4;19;82
2011;"SAO JOSE DO ALEGRE (MG)";"MG";"SAO JOSE DO ALEGRE";40;6;5;51
2011;"SAO JOSE DO DIVINO (MG)";"MG";"SAO JOSE DO DIVINO";15;4;9;28
2011;"SAO JOSE DO GOIABAL (MG)";"MG";"SAO JOSE DO GOIABAL";43;14;30;87
2011;"SAO JOSE DO JACURI (MG)";"MG";"SAO JOSE DO JACURI";18;3;6;27
2011;"SAO JOSE DO MANTIMENTO (MG)";"MG";"SAO JOSE DO MANTIMENTO";29;2;4;35
2011;"SAO LOURENCO (MG)";"MG";"SAO LOURENCO";495;67;50;612
2011;"SAO MIGUEL DO ANTA (MG)";"MG";"SAO MIGUEL DO ANTA";77;6;9;92
2011;"SAO PEDRO DA UNIAO (MG)";"MG";"SAO PEDRO DA UNIAO";98;15;8;121
2011;"SAO PEDRO DO SUACUI (MG)";"MG";"SAO PEDRO DO SUACUI";22;3;8;33
2011;"SAO PEDRO DOS FERROS (MG)";"MG";"SAO PEDRO DOS FERROS";112;10;31;153
2011;"SAO ROMAO (MG)";"MG";"SAO ROMAO";26;2;11;39
2011;"SAO ROQUE DE MINAS (MG)";"MG";"SAO ROQUE DE MINAS";149;18;10;177
2011;"SAO SEBASTIAO DA BELA VISTA (MG)";"MG";"SAO SEBASTIAO DA BELA VISTA";52;8;12;72
2011;"SAO SEBASTIAO DA VARGEM ALEGRE (MG)";"MG";"SAO SEBASTIAO DA VARGEM ALEGRE";15;2;9;26
2011;"SAO SEBASTIAO DO ANTA (MG)";"MG";"SAO SEBASTIAO DO ANTA";43;4;6;53
2011;"SAO SEBASTIAO DO MARANHAO (MG)";"MG";"SAO SEBASTIAO DO MARANHAO";22;7;11;40
2011;"SAO SEBASTIAO DO OESTE (MG)";"MG";"SAO SEBASTIAO DO OESTE";128;7;15;150
2011;"SAO SEBASTIAO DO PARAISO (MG)";"MG";"SAO SEBASTIAO DO PARAISO";1405;107;201;1713
2011;"SAO SEBASTIAO DO RIO PRETO (MG)";"MG";"SAO SEBASTIAO DO RIO PRETO";8;3;4;15
2011;"SAO SEBASTIAO DO RIO VERDE (MG)";"MG";"SAO SEBASTIAO DO RIO VERDE";15;2;5;22
2011;"SAO TIAGO (MG)";"MG";"SAO TIAGO";149;13;16;178
2011;"SAO TOMAS DE AQUINO (MG)";"MG";"SAO TOMAS DE AQUINO";81;23;13;117
2011;"SAO TOME DAS LETRAS (MG)";"MG";"SAO TOME DAS LETRAS";93;9;16;118
2011;"SAO VICENTE DE MINAS (MG)";"MG";"SAO VICENTE DE MINAS";84;19;2;105
2011;"SAPUCAI MIRIM (MG)";"MG";"SAPUCAI MIRIM";202;32;10;244
2011;"SARDOA (MG)";"MG";"SARDOA";40;7;8;55
2011;"SARZEDO (MG)";"MG";"SARZEDO";489;43;59;591
2011;"SEM PEIXE (MG)";"MG";"SEM PEIXE";11;4;8;23
2011;"SENADOR AMARAL (MG)";"MG";"SENADOR AMARAL";95;11;9;115
2011;"SENADOR CORTES (MG)";"MG";"SENADOR CORTES";14;4;2;20
2011;"SENADOR FIRMINO (MG)";"MG";"SENADOR FIRMINO";94;10;21;125
2011;"SENADOR JOSE BENTO (MG)";"MG";"SENADOR JOSE BENTO";15;1;7;23
2011;"SENADOR MODESTINO GONCALVES (MG)";"MG";"SENADOR MODESTINO GONCALVES";24;5;6;35
2011;"SENHORA DE OLIVEIRA (MG)";"MG";"SENHORA DE OLIVEIRA";66;4;11;81
2011;"SENHORA DO PORTO (MG)";"MG";"SENHORA DO PORTO";23;4;10;37
2011;"SENHORA DOS REMEDIOS (MG)";"MG";"SENHORA DOS REMEDIOS";90;27;14;131
2011;"SERICITA (MG)";"MG";"SERICITA";85;1;6;92
2011;"SERITINGA (MG)";"MG";"SERITINGA";23;1;3;27
2011;"SERRA AZUL DE MINAS (MG)";"MG";"SERRA AZUL DE MINAS";13;3;9;25
2011;"SERRA DA SAUDADE (MG)";"MG";"SERRA DA SAUDADE";5;6;0;11
2011;"SERRA DO SALITRE (MG)";"MG";"SERRA DO SALITRE";229;12;70;311
2011;"SERRA DOS AIMORES (MG)";"MG";"SERRA DOS AIMORES";65;4;23;92
2011;"SERRANIA (MG)";"MG";"SERRANIA";122;19;14;155
2011;"SERRANOPOLIS DE MINAS (MG)";"MG";"SERRANOPOLIS DE MINAS";11;0;13;24
2011;"SERRANOS (MG)";"MG";"SERRANOS";17;6;3;26
2011;"SERRO (MG)";"MG";"SERRO";157;21;50;228
2011;"SETE LAGOAS (MG)";"MG";"SETE LAGOAS";3181;414;572;4167
2011;"SETUBINHA (MG)";"MG";"SETUBINHA";19;3;20;42
2011;"SILVEIRANIA (MG)";"MG";"SILVEIRANIA";11;3;4;18
2011;"SILVIANOPOLIS (MG)";"MG";"SILVIANOPOLIS";81;11;11;103
2011;"SIMAO PEREIRA (MG)";"MG";"SIMAO PEREIRA";49;10;3;62
2011;"SIMONESIA (MG)";"MG";"SIMONESIA";191;14;35;240
2011;"SOBRALIA (MG)";"MG";"SOBRALIA";39;6;8;53
2011;"SOLEDADE DE MINAS (MG)";"MG";"SOLEDADE DE MINAS";41;8;0;49
2011;"TABULEIRO (MG)";"MG";"TABULEIRO";65;7;8;80
2011;"TAIOBEIRAS (MG)";"MG";"TAIOBEIRAS";632;25;136;793
2011;"TAPARUBA (MG)";"MG";"TAPARUBA";28;2;10;40
2011;"TAPIRA (MG)";"MG";"TAPIRA";40;8;15;63
2011;"TAPIRAI (MG)";"MG";"TAPIRAI";14;3;2;19
2011;"TAQUARACU DE MINAS (MG)";"MG";"TAQUARACU DE MINAS";69;7;9;85
2011;"TARUMIRIM (MG)";"MG";"TARUMIRIM";107;13;24;144
2011;"TEIXEIRAS (MG)";"MG";"TEIXEIRAS";162;13;16;191
2011;"TEOFILO OTONI (MG)";"MG";"TEOFILO OTONI";1458;156;153;1767
2011;"TIMOTEO (MG)";"MG";"TIMOTEO";1016;189;135;1340
2011;"TIRADENTES (MG)";"MG";"TIRADENTES";77;15;13;105
2011;"TIROS (MG)";"MG";"TIROS";143;22;11;176
2011;"TOCANTINS (MG)";"MG";"TOCANTINS";243;9;20;272
2011;"TOCOS DO MOJI (MG)";"MG";"TOCOS DO MOJI";51;11;10;72
2011;"TOLEDO (MG)";"MG";"TOLEDO";70;5;8;83
2011;"TOMBOS (MG)";"MG";"TOMBOS";101;24;23;148
2011;"TRES CORACOES (MG)";"MG";"TRES CORACOES";903;92;184;1179
2011;"TRES MARIAS (MG)";"MG";"TRES MARIAS";353;37;90;480
2011;"TRES PONTAS (MG)";"MG";"TRES PONTAS";822;90;180;1092
2011;"TUMIRITINGA (MG)";"MG";"TUMIRITINGA";30;7;7;44
2011;"TUPACIGUARA (MG)";"MG";"TUPACIGUARA";464;71;69;604
2011;"TURMALINA (MG)";"MG";"TURMALINA";301;33;49;383
2011;"TURVOLANDIA (MG)";"MG";"TURVOLANDIA";92;26;5;123
2011;"UBA (MG)";"MG";"UBA";1939;80;131;2150
2011;"UBAI (MG)";"MG";"UBAI";35;4;23;62
2011;"UBAPORANGA (MG)";"MG";"UBAPORANGA";139;6;21;166
2011;"UBERABA (MG)";"MG";"UBERABA";4441;896;930;6267
2011;"UBERLANDIA (MG)";"MG";"UBERLANDIA";10692;1029;1355;13076
2011;"UMBURATIBA (MG)";"MG";"UMBURATIBA";9;3;1;13
2011;"UNAI (MG)";"MG";"UNAI";1298;71;301;1670
2011;"UNIAO DE MINAS (MG)";"MG";"UNIAO DE MINAS";38;7;30;75
2011;"URUANA DE MINAS (MG)";"MG";"URUANA DE MINAS";16;4;9;29
2011;"URUCANIA (MG)";"MG";"URUCANIA";137;9;37;183
2011;"URUCUIA (MG)";"MG";"URUCUIA";70;4;21;95
2011;"VARGEM ALEGRE (MG)";"MG";"VARGEM ALEGRE";61;6;9;76
2011;"VARGEM BONITA (MG)";"MG";"VARGEM BONITA";27;5;3;35
2011;"VARGEM GRANDE DO RIO PARDO (MG)";"MG";"VARGEM GRANDE DO RIO PARDO";38;4;10;52
2011;"VARGINHA (MG)";"MG";"VARGINHA";1876;157;299;2332
2011;"VARJAO DE MINAS (MG)";"MG";"VARJAO DE MINAS";83;10;40;133
2011;"VARZEA DA PALMA (MG)";"MG";"VARZEA DA PALMA";419;20;79;518
2011;"VARZELANDIA (MG)";"MG";"VARZELANDIA";52;7;34;93
2011;"VAZANTE (MG)";"MG";"VAZANTE";291;33;83;407
2011;"VERDELANDIA (MG)";"MG";"VERDELANDIA";14;2;8;24
2011;"VEREDINHA (MG)";"MG";"VEREDINHA";40;6;17;63
2011;"VERISSIMO (MG)";"MG";"VERISSIMO";38;24;2;64
2011;"VERMELHO NOVO (MG)";"MG";"VERMELHO NOVO";79;8;22;109
2011;"VESPASIANO (MG)";"MG";"VESPASIANO";752;160;139;1051
2011;"VICOSA (MG)";"MG";"VICOSA";619;147;156;922
2011;"VIEIRAS (MG)";"MG";"VIEIRAS";42;9;6;57
2011;"VIRGEM DA LAPA (MG)";"MG";"VIRGEM DA LAPA";61;10;20;91
2011;"VIRGINIA (MG)";"MG";"VIRGINIA";126;12;4;142
2011;"VIRGINOPOLIS (MG)";"MG";"VIRGINOPOLIS";83;5;20;108
2011;"VIRGOLANDIA (MG)";"MG";"VIRGOLANDIA";19;5;7;31
2011;"VISCONDE DO RIO BRANCO (MG)";"MG";"VISCONDE DO RIO BRANCO";915;47;61;1023
2011;"VOLTA GRANDE (MG)";"MG";"VOLTA GRANDE";43;7;5;55
2011;"WENCESLAU BRAZ (MG)";"MG";"WENCESLAU BRAZ";41;5;6;52
2011;"AGUA CLARA (MS)";"MS";"AGUA CLARA";415;16;88;519
2011;"ALCINOPOLIS (MS)";"MS";"ALCINOPOLIS";78;16;14;108
2011;"AMAMBAI (MS)";"MS";"AMAMBAI";666;19;53;738
2011;"ANASTACIO (MS)";"MS";"ANASTACIO";359;17;23;399
2011;"ANAURILANDIA (MS)";"MS";"ANAURILANDIA";108;12;47;167
2011;"ANGELICA (MS)";"MS";"ANGELICA";248;24;44;316
2011;"ANTONIO JOAO (MS)";"MS";"ANTONIO JOAO";103;3;23;129
2011;"APARECIDA DO TABOADO (MS)";"MS";"APARECIDA DO TABOADO";382;29;47;458
2011;"AQUIDAUANA (MS)";"MS";"AQUIDAUANA";344;17;58;419
2011;"ARAL MOREIRA (MS)";"MS";"ARAL MOREIRA";179;12;23;214
2011;"BANDEIRANTES (MS)";"MS";"BANDEIRANTES";140;7;27;174
2011;"BATAGUASSU (MS)";"MS";"BATAGUASSU";461;26;157;644
2011;"BATAYPORA (MS)";"MS";"BATAYPORA";161;6;26;193
2011;"BELA VISTA (MS)";"MS";"BELA VISTA";223;28;44;295
2011;"BODOQUENA (MS)";"MS";"BODOQUENA";78;21;37;136
2011;"BONITO (MS)";"MS";"BONITO";244;57;49;350
2011;"BRASILANDIA (MS)";"MS";"BRASILANDIA";259;28;68;355
2011;"CAARAPO (MS)";"MS";"CAARAPO";509;11;123;643
2011;"CAMAPUA (MS)";"MS";"CAMAPUA";324;30;28;382
2011;"CAMPO GRANDE (MS)";"MS";"CAMPO GRANDE";12818;804;1820;15442
2011;"CARACOL (MS)";"MS";"CARACOL";55;15;9;79
2011;"CASSILANDIA (MS)";"MS";"CASSILANDIA";438;13;34;485
2011;"CHAPADAO DO SUL (MS)";"MS";"CHAPADAO DO SUL";722;18;96;836
2011;"CORGUINHO (MS)";"MS";"CORGUINHO";55;7;23;85
2011;"CORONEL SAPUCAIA (MS)";"MS";"CORONEL SAPUCAIA";274;7;28;309
2011;"CORUMBA (MS)";"MS";"CORUMBA";804;65;199;1068
2011;"COSTA RICA (MS)";"MS";"COSTA RICA";455;12;102;569
2011;"COXIM (MS)";"MS";"COXIM";557;13;66;636
2011;"DEODAPOLIS (MS)";"MS";"DEODAPOLIS";221;13;73;307
2011;"DOIS IRMAOS DO BURITI (MS)";"MS";"DOIS IRMAOS DO BURITI";116;19;27;162
2011;"DOURADINA (MS)";"MS";"DOURADINA";200;8;16;224
2011;"DOURADOS (MS)";"MS";"DOURADOS";3786;209;302;4297
2011;"ELDORADO (MS)";"MS";"ELDORADO";248;11;31;290
2011;"FATIMA DO SUL (MS)";"MS";"FATIMA DO SUL";403;5;28;436
2011;"FIGUEIRAO (MS)";"MS";"FIGUEIRAO";33;19;3;55
2011;"GLORIA DE DOURADOS (MS)";"MS";"GLORIA DE DOURADOS";186;7;39;232
2011;"GUIA LOPES DA LAGUNA (MS)";"MS";"GUIA LOPES DA LAGUNA";147;16;28;191
2011;"IGUATEMI (MS)";"MS";"IGUATEMI";226;8;54;288
2011;"INOCENCIA (MS)";"MS";"INOCENCIA";147;3;33;183
2011;"ITAPORA (MS)";"MS";"ITAPORA";369;24;40;433
2011;"ITAQUIRAI (MS)";"MS";"ITAQUIRAI";201;14;81;296
2011;"IVINHEMA (MS)";"MS";"IVINHEMA";495;17;194;706
2011;"JAPORA (MS)";"MS";"JAPORA";16;6;17;39
2011;"JARAGUARI (MS)";"MS";"JARAGUARI";70;5;17;92
2011;"JARDIM (MS)";"MS";"JARDIM";422;24;34;480
2011;"JATEI (MS)";"MS";"JATEI";44;6;62;112
2011;"JUTI (MS)";"MS";"JUTI";62;4;15;81
2011;"LADARIO (MS)";"MS";"LADARIO";139;16;55;210
2011;"LAGUNA CARAPA (MS)";"MS";"LAGUNA CARAPA";166;1;15;182
2011;"MARACAJU (MS)";"MS";"MARACAJU";871;18;119;1008
2011;"MIRANDA (MS)";"MS";"MIRANDA";292;22;67;381
2011;"MUNDO NOVO (MS)";"MS";"MUNDO NOVO";277;25;25;327
2011;"NAVIRAI (MS)";"MS";"NAVIRAI";817;43;162;1022
2011;"NIOAQUE (MS)";"MS";"NIOAQUE";135;20;48;203
2011;"NOVA ALVORADA DO SUL (MS)";"MS";"NOVA ALVORADA DO SUL";318;25;70;413
2011;"NOVA ANDRADINA (MS)";"MS";"NOVA ANDRADINA";934;20;214;1168
2011;"NOVO HORIZONTE DO SUL (MS)";"MS";"NOVO HORIZONTE DO SUL";67;6;13;86
2011;"PARANAIBA (MS)";"MS";"PARANAIBA";781;25;102;908
2011;"PARANHOS (MS)";"MS";"PARANHOS";114;5;22;141
2011;"PEDRO GOMES (MS)";"MS";"PEDRO GOMES";85;6;10;101
2011;"PONTA PORA (MS)";"MS";"PONTA PORA";1656;59;246;1961
2011;"PORTO MURTINHO (MS)";"MS";"PORTO MURTINHO";66;4;20;90
2011;"RIBAS DO RIO PARDO (MS)";"MS";"RIBAS DO RIO PARDO";556;27;55;638
2011;"RIO BRILHANTE (MS)";"MS";"RIO BRILHANTE";652;45;134;831
2011;"RIO NEGRO (MS)";"MS";"RIO NEGRO";53;10;10;73
2011;"RIO VERDE DE MATO GROSSO (MS)";"MS";"RIO VERDE DE MATO GROSSO";301;18;20;339
2011;"ROCHEDO (MS)";"MS";"ROCHEDO";52;2;11;65
2011;"SANTA RITA DO PARDO (MS)";"MS";"SANTA RITA DO PARDO";117;9;32;158
2011;"SAO GABRIEL DO OESTE (MS)";"MS";"SAO GABRIEL DO OESTE";811;19;48;878
2011;"SELVIRIA (MS)";"MS";"SELVIRIA";104;8;22;134
2011;"SETE QUEDAS (MS)";"MS";"SETE QUEDAS";206;7;21;234
2011;"SIDROLANDIA (MS)";"MS";"SIDROLANDIA";652;72;243;967
2011;"SONORA (MS)";"MS";"SONORA";192;18;86;296
2011;"TACURU (MS)";"MS";"TACURU";106;7;15;128
2011;"TAQUARUSSU (MS)";"MS";"TAQUARUSSU";35;4;13;52
2011;"TERENOS (MS)";"MS";"TERENOS";318;19;40;377
2011;"TRES LAGOAS (MS)";"MS";"TRES LAGOAS";1539;131;413;2083
2011;"VICENTINA (MS)";"MS";"VICENTINA";121;8;81;210
2011;"ACORIZAL (MT)";"MT";"ACORIZAL";16;3;3;22
2011;"AGUA BOA (MT)";"MT";"AGUA BOA";520;8;39;567
2011;"ALTA FLORESTA (MT)";"MT";"ALTA FLORESTA";1204;22;70;1296
2011;"ALTO ARAGUAIA (MT)";"MT";"ALTO ARAGUAIA";155;20;32;207
2011;"ALTO BOA VISTA (MT)";"MT";"ALTO BOA VISTA";26;1;4;31
2011;"ALTO GARCAS (MT)";"MT";"ALTO GARCAS";254;13;31;298
2011;"ALTO PARAGUAI (MT)";"MT";"ALTO PARAGUAI";30;6;4;40
2011;"ALTO TAQUARI (MT)";"MT";"ALTO TAQUARI";164;13;20;197
2011;"APIACAS (MT)";"MT";"APIACAS";97;10;4;111
2011;"ARAGUAIANA (MT)";"MT";"ARAGUAIANA";12;0;3;15
2011;"ARAGUAINHA (MT)";"MT";"ARAGUAINHA";7;1;1;9
2011;"ARAPUTANGA (MT)";"MT";"ARAPUTANGA";234;12;19;265
2011;"ARENAPOLIS (MT)";"MT";"ARENAPOLIS";179;8;61;248
2011;"ARIPUANA (MT)";"MT";"ARIPUANA";325;9;30;364
2011;"BARAO DE MELGACO (MT)";"MT";"BARAO DE MELGACO";8;2;2;12
2011;"BARRA DO BUGRES (MT)";"MT";"BARRA DO BUGRES";495;18;127;640
2011;"BARRA DO GARCAS (MT)";"MT";"BARRA DO GARCAS";801;29;176;1006
2011;"BOM JESUS DO ARAGUAIA (MT)";"MT";"BOM JESUS DO ARAGUAIA";23;1;9;33
2011;"BRASNORTE (MT)";"MT";"BRASNORTE";297;6;49;352
2011;"CACERES (MT)";"MT";"CACERES";745;48;272;1065
2011;"CAMPINAPOLIS (MT)";"MT";"CAMPINAPOLIS";73;3;13;89
2011;"CAMPO NOVO DO PARECIS (MT)";"MT";"CAMPO NOVO DO PARECIS";657;18;100;775
2011;"CAMPO VERDE (MT)";"MT";"CAMPO VERDE";819;42;102;963
2011;"CAMPOS DE JULIO (MT)";"MT";"CAMPOS DE JULIO";146;12;21;179
2011;"CANABRAVA DO NORTE (MT)";"MT";"CANABRAVA DO NORTE";30;0;8;38
2011;"CANARANA (MT)";"MT";"CANARANA";473;13;23;509
2011;"CARLINDA (MT)";"MT";"CARLINDA";118;0;21;139
2011;"CASTANHEIRA (MT)";"MT";"CASTANHEIRA";111;2;12;125
2011;"CHAPADA DOS GUIMARAES (MT)";"MT";"CHAPADA DOS GUIMARAES";190;20;40;250
2011;"CLAUDIA (MT)";"MT";"CLAUDIA";392;4;17;413
2011;"COCALINHO (MT)";"MT";"COCALINHO";17;1;7;25
2011;"COLIDER (MT)";"MT";"COLIDER";853;16;90;959
2011;"COLNIZA (MT)";"MT";"COLNIZA";259;0;9;268
2011;"COMODORO (MT)";"MT";"COMODORO";471;9;69;549
2011;"CONFRESA (MT)";"MT";"CONFRESA";148;3;38;189
2011;"CONQUISTA D OESTE (MT)";"MT";"CONQUISTA D OESTE";32;1;13;46
2011;"COTRIGUACU (MT)";"MT";"COTRIGUACU";122;1;34;157
2011;"CUIABA (MT)";"MT";"CUIABA";8556;701;2446;11703
2011;"CURVELANDIA (MT)";"MT";"CURVELANDIA";63;0;13;76
2011;"DENISE (MT)";"MT";"DENISE";70;4;27;101
2011;"DIAMANTINO (MT)";"MT";"DIAMANTINO";461;16;56;533
2011;"DOM AQUINO (MT)";"MT";"DOM AQUINO";98;8;18;124
2011;"FELIZ NATAL (MT)";"MT";"FELIZ NATAL";236;4;18;258
2011;"FIGUEIROPOLIS D OESTE (MT)";"MT";"FIGUEIROPOLIS D OESTE";66;3;9;78
2011;"GAUCHA DO NORTE (MT)";"MT";"GAUCHA DO NORTE";52;6;16;74
2011;"GENERAL CARNEIRO (MT)";"MT";"GENERAL CARNEIRO";21;5;4;30
2011;"GLORIA D OESTE (MT)";"MT";"GLORIA D OESTE";37;3;14;54
2011;"GUARANTA DO NORTE (MT)";"MT";"GUARANTA DO NORTE";830;11;59;900
2011;"GUIRATINGA (MT)";"MT";"GUIRATINGA";153;10;11;174
2011;"INDIAVAI (MT)";"MT";"INDIAVAI";15;1;7;23
2011;"IPIRANGA DO NORTE (MT)";"MT";"IPIRANGA DO NORTE";106;2;5;113
2011;"ITANHANGA (MT)";"MT";"ITANHANGA";128;1;15;144
2011;"ITAUBA (MT)";"MT";"ITAUBA";112;4;8;124
2011;"ITIQUIRA (MT)";"MT";"ITIQUIRA";94;18;35;147
2011;"JACIARA (MT)";"MT";"JACIARA";558;37;120;715
2011;"JANGADA (MT)";"MT";"JANGADA";47;11;16;74
2011;"JAURU (MT)";"MT";"JAURU";146;6;28;180
2011;"JUARA (MT)";"MT";"JUARA";732;20;50;802
2011;"JUINA (MT)";"MT";"JUINA";805;14;66;885
2011;"JURUENA (MT)";"MT";"JURUENA";166;1;11;178
2011;"JUSCIMEIRA (MT)";"MT";"JUSCIMEIRA";129;5;48;182
2011;"LAMBARI D OESTE (MT)";"MT";"LAMBARI D OESTE";62;2;22;86
2011;"LUCAS DO RIO VERDE (MT)";"MT";"LUCAS DO RIO VERDE";1400;36;112;1548
2011;"LUCIARA (MT)";"MT";"LUCIARA";8;0;2;10
2011;"MARCELANDIA (MT)";"MT";"MARCELANDIA";349;6;14;369
2011;"MATUPA (MT)";"MT";"MATUPA";348;7;30;385
2011;"MIRASSOL D OESTE (MT)";"MT";"MIRASSOL D OESTE";660;7;67;734
2011;"NOBRES (MT)";"MT";"NOBRES";269;14;54;337
2011;"NORTELANDIA (MT)";"MT";"NORTELANDIA";82;7;15;104
2011;"NOSSA SENHORA DO LIVRAMENTO (MT)";"MT";"NOSSA SENHORA DO LIVRAMENTO";73;1;24;98
2011;"NOVA BANDEIRANTES (MT)";"MT";"NOVA BANDEIRANTES";130;2;24;156
2011;"NOVA BRASILANDIA (MT)";"MT";"NOVA BRASILANDIA";44;1;9;54
2011;"NOVA CANAA DO NORTE (MT)";"MT";"NOVA CANAA DO NORTE";174;5;47;226
2011;"NOVA GUARITA (MT)";"MT";"NOVA GUARITA";83;0;13;96
2011;"NOVA LACERDA (MT)";"MT";"NOVA LACERDA";88;0;24;112
2011;"NOVA MARILANDIA (MT)";"MT";"NOVA MARILANDIA";27;4;4;35
2011;"NOVA MARINGA (MT)";"MT";"NOVA MARINGA";104;1;8;113
2011;"NOVA MONTE VERDE (MT)";"MT";"NOVA MONTE VERDE";110;7;5;122
2011;"NOVA MUTUM (MT)";"MT";"NOVA MUTUM";885;12;78;975
2011;"NOVA NAZARE (MT)";"MT";"NOVA NAZARE";7;4;4;15
2011;"NOVA OLIMPIA (MT)";"MT";"NOVA OLIMPIA";323;15;129;467
2011;"NOVA SANTA HELENA (MT)";"MT";"NOVA SANTA HELENA";57;1;10;68
2011;"NOVA UBIRATA (MT)";"MT";"NOVA UBIRATA";126;14;26;166
2011;"NOVA XAVANTINA (MT)";"MT";"NOVA XAVANTINA";350;16;36;402
2011;"NOVO HORIZONTE DO NORTE (MT)";"MT";"NOVO HORIZONTE DO NORTE";34;1;11;46
2011;"NOVO MUNDO (MT)";"MT";"NOVO MUNDO";87;2;11;100
2011;"NOVO SANTO ANTONIO (MT)";"MT";"NOVO SANTO ANTONIO";4;0;3;7
2011;"NOVO SAO JOAQUIM (MT)";"MT";"NOVO SAO JOAQUIM";60;1;11;72
2011;"PARANAITA (MT)";"MT";"PARANAITA";176;12;41;229
2011;"PARANATINGA (MT)";"MT";"PARANATINGA";364;12;57;433
2011;"PEDRA PRETA (MT)";"MT";"PEDRA PRETA";286;9;35;330
2011;"PEIXOTO DE AZEVEDO (MT)";"MT";"PEIXOTO DE AZEVEDO";313;9;58;380
2011;"PLANALTO DA SERRA (MT)";"MT";"PLANALTO DA SERRA";11;1;4;16
2011;"POCONE (MT)";"MT";"POCONE";359;17;30;406
2011;"PONTAL DO ARAGUAIA (MT)";"MT";"PONTAL DO ARAGUAIA";19;1;1;21
2011;"PONTE BRANCA (MT)";"MT";"PONTE BRANCA";5;1;0;6
2011;"PONTES E LACERDA (MT)";"MT";"PONTES E LACERDA";832;23;97;952
2011;"PORTO ALEGRE DO NORTE (MT)";"MT";"PORTO ALEGRE DO NORTE";49;5;28;82
2011;"PORTO DOS GAUCHOS (MT)";"MT";"PORTO DOS GAUCHOS";100;8;7;115
2011;"PORTO ESPERIDIAO (MT)";"MT";"PORTO ESPERIDIAO";131;4;37;172
2011;"PORTO ESTRELA (MT)";"MT";"PORTO ESTRELA";15;2;5;22
2011;"POXOREO (MT)";"MT";"POXOREO";96;15;35;146
2011;"PRIMAVERA DO LESTE (MT)";"MT";"PRIMAVERA DO LESTE";1712;56;133;1901
2011;"QUERENCIA (MT)";"MT";"QUERENCIA";258;3;18;279
2011;"RESERVA DO CABACAL (MT)";"MT";"RESERVA DO CABACAL";20;2;5;27
2011;"RIBEIRAO CASCALHEIRA (MT)";"MT";"RIBEIRAO CASCALHEIRA";99;10;12;121
2011;"RIBEIRAOZINHO (MT)";"MT";"RIBEIRAOZINHO";7;4;6;17
2011;"RIO BRANCO (MT)";"MT";"RIO BRANCO";76;6;17;99
2011;"RONDOLANDIA (MT)";"MT";"RONDOLANDIA";6;0;16;22
2011;"RONDONOPOLIS (MT)";"MT";"RONDONOPOLIS";3834;179;428;4441
2011;"ROSARIO OESTE (MT)";"MT";"ROSARIO OESTE";121;11;26;158
2011;"SALTO DO CEU (MT)";"MT";"SALTO DO CEU";43;3;16;62
2011;"SANTA CARMEM (MT)";"MT";"SANTA CARMEM";128;4;10;142
2011;"SANTA CRUZ DO XINGU (MT)";"MT";"SANTA CRUZ DO XINGU";6;1;3;10
2011;"SANTA RITA DO TRIVELATO (MT)";"MT";"SANTA RITA DO TRIVELATO";54;2;11;67
2011;"SANTA TEREZINHA (MT)";"MT";"SANTA TEREZINHA";8;1;9;18
2011;"SANTO AFONSO (MT)";"MT";"SANTO AFONSO";24;3;7;34
2011;"SANTO ANTONIO DO LESTE (MT)";"MT";"SANTO ANTONIO DO LESTE";54;2;14;70
2011;"SANTO ANTONIO DO LEVERGER (MT)";"MT";"SANTO ANTONIO DO LEVERGER";96;8;14;118
2011;"SAO FELIX DO ARAGUAIA (MT)";"MT";"SAO FELIX DO ARAGUAIA";38;4;19;61
2011;"SAO JOSE DO POVO (MT)";"MT";"SAO JOSE DO POVO";18;2;4;24
2011;"SAO JOSE DO RIO CLARO (MT)";"MT";"SAO JOSE DO RIO CLARO";300;12;46;358
2011;"SAO JOSE DO XINGU (MT)";"MT";"SAO JOSE DO XINGU";13;0;8;21
2011;"SAO JOSE DOS QUATRO MARCOS (MT)";"MT";"SAO JOSE DOS QUATRO MARCOS";437;10;55;502
2011;"SAO PEDRO DA CIPA (MT)";"MT";"SAO PEDRO DA CIPA";18;6;20;44
2011;"SAPEZAL (MT)";"MT";"SAPEZAL";503;19;58;580
2011;"SERRA NOVA DOURADA (MT)";"MT";"SERRA NOVA DOURADA";5;1;2;8
2011;"SINOP (MT)";"MT";"SINOP";3041;68;157;3266
2011;"SORRISO (MT)";"MT";"SORRISO";2034;46;134;2214
2011;"TABAPORA (MT)";"MT";"TABAPORA";127;4;19;150
2011;"TANGARA DA SERRA (MT)";"MT";"TANGARA DA SERRA";1769;68;178;2015
2011;"TAPURAH (MT)";"MT";"TAPURAH";299;6;32;337
2011;"TERRA NOVA DO NORTE (MT)";"MT";"TERRA NOVA DO NORTE";236;13;26;275
2011;"TESOURO (MT)";"MT";"TESOURO";11;2;3;16
2011;"TORIXOREU (MT)";"MT";"TORIXOREU";17;3;4;24
2011;"UNIAO DO SUL (MT)";"MT";"UNIAO DO SUL";79;0;8;87
2011;"VALE DE SAO DOMINGOS (MT)";"MT";"VALE DE SAO DOMINGOS";25;0;13;38
2011;"VARZEA GRANDE (MT)";"MT";"VARZEA GRANDE";4313;250;464;5027
2011;"VERA (MT)";"MT";"VERA";261;5;18;284
2011;"VILA BELA DA SANTISSIMA TRINDA (MT)";"MT";"VILA BELA DA SANTISSIMA TRINDA";93;2;26;121
2011;"VILA RICA (MT)";"MT";"VILA RICA";225;1;28;254
2011;"ABAETETUBA (PA)";"PA";"ABAETETUBA";267;20;207;494
2011;"ABEL FIGUEIREDO (PA)";"PA";"ABEL FIGUEIREDO";60;5;4;69
2011;"ACARA (PA)";"PA";"ACARA";70;5;45;120
2011;"AFUA (PA)";"PA";"AFUA";0;0;0;0
2011;"AGUA AZUL DO NORTE (PA)";"PA";"AGUA AZUL DO NORTE";60;7;15;82
2011;"ALENQUER (PA)";"PA";"ALENQUER";136;4;37;177
2011;"ALMEIRIM (PA)";"PA";"ALMEIRIM";210;17;103;330
2011;"ALTAMIRA (PA)";"PA";"ALTAMIRA";1181;126;75;1382
2011;"ANAJAS (PA)";"PA";"ANAJAS";0;0;1;1
2011;"ANANINDEUA (PA)";"PA";"ANANINDEUA";3781;375;1262;5418
2011;"ANAPU (PA)";"PA";"ANAPU";65;8;6;79
2011;"AUGUSTO CORREA (PA)";"PA";"AUGUSTO CORREA";33;4;52;89
2011;"AURORA DO PARA (PA)";"PA";"AURORA DO PARA";60;5;53;118
2011;"AVEIRO (PA)";"PA";"AVEIRO";2;0;1;3
2011;"BAGRE (PA)";"PA";"BAGRE";1;0;2;3
2011;"BAIAO (PA)";"PA";"BAIAO";33;1;12;46
2011;"BANNACH (PA)";"PA";"BANNACH";13;0;0;13
2011;"BARCARENA (PA)";"PA";"BARCARENA";771;175;576;1522
2011;"BELEM (PA)";"PA";"BELEM";7862;1554;3098;12514
2011;"BELTERRA (PA)";"PA";"BELTERRA";33;4;25;62
2011;"BENEVIDES (PA)";"PA";"BENEVIDES";471;45;92;608
2011;"BOM JESUS DO TOCANTINS (PA)";"PA";"BOM JESUS DO TOCANTINS";66;8;5;79
2011;"BONITO (PA)";"PA";"BONITO";47;3;41;91
2011;"BRAGANCA (PA)";"PA";"BRAGANCA";366;25;142;533
2011;"BRASIL NOVO (PA)";"PA";"BRASIL NOVO";165;24;7;196
2011;"BREJO GRANDE DO ARAGUAIA (PA)";"PA";"BREJO GRANDE DO ARAGUAIA";15;8;7;30
2011;"BREU BRANCO (PA)";"PA";"BREU BRANCO";244;6;70;320
2011;"BREVES (PA)";"PA";"BREVES";29;1;6;36
2011;"BUJARU (PA)";"PA";"BUJARU";34;7;14;55
2011;"CACHOEIRA DO ARARI (PA)";"PA";"CACHOEIRA DO ARARI";10;4;11;25
2011;"CACHOEIRA DO PIRIA (PA)";"PA";"CACHOEIRA DO PIRIA";29;2;19;50
2011;"CAMETA (PA)";"PA";"CAMETA";106;10;50;166
2011;"CANAA DOS CARAJAS (PA)";"PA";"CANAA DOS CARAJAS";192;62;82;336
2011;"CAPANEMA (PA)";"PA";"CAPANEMA";604;23;96;723
2011;"CAPITAO POCO (PA)";"PA";"CAPITAO POCO";302;21;68;391
2011;"CASTANHAL (PA)";"PA";"CASTANHAL";2374;141;332;2847
2011;"CHAVES (PA)";"PA";"CHAVES";0;0;0;0
2011;"COLARES (PA)";"PA";"COLARES";2;1;2;5
2011;"CONCEICAO DO ARAGUAIA (PA)";"PA";"CONCEICAO DO ARAGUAIA";323;33;53;409
2011;"CONCORDIA DO PARA (PA)";"PA";"CONCORDIA DO PARA";112;4;41;157
2011;"CUMARU DO NORTE (PA)";"PA";"CUMARU DO NORTE";19;0;6;25
2011;"CURIONOPOLIS (PA)";"PA";"CURIONOPOLIS";85;92;5;182
2011;"CURRALINHO (PA)";"PA";"CURRALINHO";1;0;1;2
2011;"CURUA (PA)";"PA";"CURUA";2;1;2;5
2011;"CURUCA (PA)";"PA";"CURUCA";43;11;14;68
2011;"DOM ELISEU (PA)";"PA";"DOM ELISEU";489;47;43;579
2011;"ELDORADO DOS CARAJAS (PA)";"PA";"ELDORADO DOS CARAJAS";135;31;9;175
2011;"FARO (PA)";"PA";"FARO";2;1;0;3
2011;"FLORESTA DO ARAGUAIA (PA)";"PA";"FLORESTA DO ARAGUAIA";81;2;5;88
2011;"GARRAFAO DO NORTE (PA)";"PA";"GARRAFAO DO NORTE";66;3;14;83
2011;"GOIANESIA DO PARA (PA)";"PA";"GOIANESIA DO PARA";279;16;30;325
2011;"GURUPA (PA)";"PA";"GURUPA";6;0;1;7
2011;"IGARAPE ACU (PA)";"PA";"IGARAPE ACU";140;60;66;266
2011;"IGARAPE MIRI (PA)";"PA";"IGARAPE MIRI";56;17;27;100
2011;"INHANGAPI (PA)";"PA";"INHANGAPI";25;1;30;56
2011;"IPIXUNA DO PARA (PA)";"PA";"IPIXUNA DO PARA";58;2;22;82
2011;"IRITUIA (PA)";"PA";"IRITUIA";61;2;40;103
2011;"ITAITUBA (PA)";"PA";"ITAITUBA";701;35;91;827
2011;"ITUPIRANGA (PA)";"PA";"ITUPIRANGA";153;88;23;264
2011;"JACAREACANGA (PA)";"PA";"JACAREACANGA";8;1;1;10
2011;"JACUNDA (PA)";"PA";"JACUNDA";585;19;37;641
2011;"JURUTI (PA)";"PA";"JURUTI";61;10;5;76
2011;"LIMOEIRO DO AJURU (PA)";"PA";"LIMOEIRO DO AJURU";0;0;3;3
2011;"MAE DO RIO (PA)";"PA";"MAE DO RIO";260;19;67;346
2011;"MAGALHAES BARATA (PA)";"PA";"MAGALHAES BARATA";4;24;7;35
2011;"MARABA (PA)";"PA";"MARABA";3266;290;475;4031
2011;"MARACANA (PA)";"PA";"MARACANA";25;14;21;60
2011;"MARAPANIM (PA)";"PA";"MARAPANIM";30;13;22;65
2011;"MARITUBA (PA)";"PA";"MARITUBA";730;108;311;1149
2011;"MEDICILANDIA (PA)";"PA";"MEDICILANDIA";160;8;21;189
2011;"MELGACO (PA)";"PA";"MELGACO";1;0;2;3
2011;"MOCAJUBA (PA)";"PA";"MOCAJUBA";10;2;9;21
2011;"MOJU (PA)";"PA";"MOJU";139;19;127;285
2011;"MONTE ALEGRE (PA)";"PA";"MONTE ALEGRE";222;7;121;350
2011;"MUANA (PA)";"PA";"MUANA";3;3;6;12
2011;"NOVA ESPERANCA DO PIRIA (PA)";"PA";"NOVA ESPERANCA DO PIRIA";56;4;16;76
2011;"NOVA IPIXUNA (PA)";"PA";"NOVA IPIXUNA";132;3;23;158
2011;"NOVA TIMBOTEUA (PA)";"PA";"NOVA TIMBOTEUA";52;6;17;75
2011;"NOVO PROGRESSO (PA)";"PA";"NOVO PROGRESSO";306;3;20;329
2011;"NOVO REPARTIMENTO (PA)";"PA";"NOVO REPARTIMENTO";346;26;34;406
2011;"OBIDOS (PA)";"PA";"OBIDOS";158;1;42;201
2011;"OEIRAS DO PARA (PA)";"PA";"OEIRAS DO PARA";7;1;3;11
2011;"ORIXIMINA (PA)";"PA";"ORIXIMINA";321;11;23;355
2011;"OUREM (PA)";"PA";"OUREM";150;4;13;167
2011;"OURILANDIA DO NORTE (PA)";"PA";"OURILANDIA DO NORTE";194;9;30;233
2011;"PACAJA (PA)";"PA";"PACAJA";108;15;10;133
2011;"PALESTINA DO PARA (PA)";"PA";"PALESTINA DO PARA";25;8;5;38
2011;"PARAGOMINAS (PA)";"PA";"PARAGOMINAS";1280;26;144;1450
2011;"PARAUAPEBAS (PA)";"PA";"PARAUAPEBAS";1465;569;776;2810
2011;"PAU D ARCO (PA)";"PA";"PAU D ARCO";15;8;5;28
2011;"PEIXE BOI (PA)";"PA";"PEIXE BOI";16;3;14;33
2011;"PICARRA (PA)";"PA";"PICARRA";17;1;6;24
2011;"PLACAS (PA)";"PA";"PLACAS";67;3;1;71
2011;"PONTA DE PEDRAS (PA)";"PA";"PONTA DE PEDRAS";4;1;4;9
2011;"PORTEL (PA)";"PA";"PORTEL";19;0;7;26
2011;"PORTO DE MOZ (PA)";"PA";"PORTO DE MOZ";11;0;5;16
2011;"PRAINHA (PA)";"PA";"PRAINHA";22;0;3;25
2011;"PRIMAVERA (PA)";"PA";"PRIMAVERA";11;2;15;28
2011;"QUATIPURU (PA)";"PA";"QUATIPURU";9;3;9;21
2011;"REDENCAO (PA)";"PA";"REDENCAO";1129;68;111;1308
2011;"RIO MARIA (PA)";"PA";"RIO MARIA";226;43;23;292
2011;"RONDON DO PARA (PA)";"PA";"RONDON DO PARA";458;46;17;521
2011;"RUROPOLIS (PA)";"PA";"RUROPOLIS";168;4;12;184
2011;"SALINOPOLIS (PA)";"PA";"SALINOPOLIS";135;25;54;214
2011;"SALVATERRA (PA)";"PA";"SALVATERRA";31;25;20;76
2011;"SANTA BARBARA DO PARA (PA)";"PA";"SANTA BARBARA DO PARA";52;18;51;121
2011;"SANTA CRUZ DO ARARI (PA)";"PA";"SANTA CRUZ DO ARARI";3;0;1;4
2011;"SANTA ISABEL DO PARA (PA)";"PA";"SANTA ISABEL DO PARA";551;45;140;736
2011;"SANTA LUZIA DO PARA (PA)";"PA";"SANTA LUZIA DO PARA";106;12;26;144
2011;"SANTA MARIA DAS BARREIRAS (PA)";"PA";"SANTA MARIA DAS BARREIRAS";63;2;16;81
2011;"SANTA MARIA DO PARA (PA)";"PA";"SANTA MARIA DO PARA";233;23;51;307
2011;"SANTANA DO ARAGUAIA (PA)";"PA";"SANTANA DO ARAGUAIA";160;12;19;191
2011;"SANTAREM (PA)";"PA";"SANTAREM";2270;98;579;2947
2011;"SANTAREM NOVO (PA)";"PA";"SANTAREM NOVO";8;5;12;25
2011;"SANTO ANTONIO DO TAUA (PA)";"PA";"SANTO ANTONIO DO TAUA";96;25;92;213
2011;"SAO CAETANO DE ODIVELAS (PA)";"PA";"SAO CAETANO DE ODIVELAS";23;0;4;27
2011;"SAO DOMINGOS DO ARAGUAIA (PA)";"PA";"SAO DOMINGOS DO ARAGUAIA";125;29;21;175
2011;"SAO DOMINGOS DO CAPIM (PA)";"PA";"SAO DOMINGOS DO CAPIM";38;0;19;57
2011;"SAO FELIX DO XINGU (PA)";"PA";"SAO FELIX DO XINGU";210;6;22;238
2011;"SAO FRANCISCO DO PARA (PA)";"PA";"SAO FRANCISCO DO PARA";34;33;29;96
2011;"SAO GERALDO DO ARAGUAIA (PA)";"PA";"SAO GERALDO DO ARAGUAIA";118;6;12;136
2011;"SAO JOAO DA PONTA (PA)";"PA";"SAO JOAO DA PONTA";2;4;7;13
2011;"SAO JOAO DE PIRABAS (PA)";"PA";"SAO JOAO DE PIRABAS";23;9;13;45
2011;"SAO JOAO DO ARAGUAIA (PA)";"PA";"SAO JOAO DO ARAGUAIA";19;16;6;41
2011;"SAO MIGUEL DO GUAMA (PA)";"PA";"SAO MIGUEL DO GUAMA";381;26;94;501
2011;"SAO SEBASTIAO DA BOA VISTA (PA)";"PA";"SAO SEBASTIAO DA BOA VISTA";2;0;1;3
2011;"SAPUCAIA (PA)";"PA";"SAPUCAIA";28;4;4;36
2011;"SENADOR JOSE PORFIRIO (PA)";"PA";"SENADOR JOSE PORFIRIO";18;5;2;25
2011;"SOURE (PA)";"PA";"SOURE";32;2;12;46
2011;"TAILANDIA (PA)";"PA";"TAILANDIA";581;34;96;711
2011;"TERRA ALTA (PA)";"PA";"TERRA ALTA";24;20;17;61
2011;"TERRA SANTA (PA)";"PA";"TERRA SANTA";11;0;3;14
2011;"TOME ACU (PA)";"PA";"TOME ACU";428;14;110;552
2011;"TRACUATEUA (PA)";"PA";"TRACUATEUA";24;6;27;57
2011;"TRAIRAO (PA)";"PA";"TRAIRAO";88;3;9;100
2011;"TUCUMA (PA)";"PA";"TUCUMA";454;18;80;552
2011;"TUCURUI (PA)";"PA";"TUCURUI";801;87;172;1060
2011;"ULIANOPOLIS (PA)";"PA";"ULIANOPOLIS";164;19;16;199
2011;"URUARA (PA)";"PA";"URUARA";431;13;17;461
2011;"VIGIA (PA)";"PA";"VIGIA";108;12;72;192
2011;"VISEU (PA)";"PA";"VISEU";54;2;33;89
2011;"VITORIA DO XINGU (PA)";"PA";"VITORIA DO XINGU";16;9;7;32
2011;"XINGUARA (PA)";"PA";"XINGUARA";719;25;76;820
2011;"AGUA BRANCA (PB)";"PB";"AGUA BRANCA";11;7;5;23
2011;"AGUIAR (PB)";"PB";"AGUIAR";6;5;1;12
2011;"ALAGOA GRANDE (PB)";"PB";"ALAGOA GRANDE";91;19;33;143
2011;"ALAGOA NOVA (PB)";"PB";"ALAGOA NOVA";111;74;11;196
2011;"ALAGOINHA (PB)";"PB";"ALAGOINHA";47;14;25;86
2011;"ALCANTIL (PB)";"PB";"ALCANTIL";38;21;11;70
2011;"ALGODAO DE JANDAIRA (PB)";"PB";"ALGODAO DE JANDAIRA";16;0;2;18
2011;"ALHANDRA (PB)";"PB";"ALHANDRA";114;19;16;149
2011;"AMPARO (PB)";"PB";"AMPARO";8;5;4;17
2011;"APARECIDA (PB)";"PB";"APARECIDA";32;4;11;47
2011;"ARACAGI (PB)";"PB";"ARACAGI";48;2;35;85
2011;"ARARA (PB)";"PB";"ARARA";51;5;15;71
2011;"ARARUNA (PB)";"PB";"ARARUNA";75;28;15;118
2011;"AREIA (PB)";"PB";"AREIA";103;24;15;142
2011;"AREIA DE BARAUNAS (PB)";"PB";"AREIA DE BARAUNAS";4;2;3;9
2011;"AREIAL (PB)";"PB";"AREIAL";26;4;7;37
2011;"AROEIRAS (PB)";"PB";"AROEIRAS";53;22;12;87
2011;"ASSUNCAO (PB)";"PB";"ASSUNCAO";22;9;4;35
2011;"BAIA DA TRAICAO (PB)";"PB";"BAIA DA TRAICAO";11;6;8;25
2011;"BANANEIRAS (PB)";"PB";"BANANEIRAS";67;15;22;104
2011;"BARAUNA (PB)";"PB";"BARAUNA";22;0;3;25
2011;"BARRA DE SANTA ROSA (PB)";"PB";"BARRA DE SANTA ROSA";67;6;13;86
2011;"BARRA DE SANTANA (PB)";"PB";"BARRA DE SANTANA";57;4;9;70
2011;"BARRA DE SAO MIGUEL (PB)";"PB";"BARRA DE SAO MIGUEL";6;1;3;10
2011;"BAYEUX (PB)";"PB";"BAYEUX";623;26;154;803
2011;"BELEM (PB)";"PB";"BELEM";108;10;12;130
2011;"BELEM DO BREJO DO CRUZ (PB)";"PB";"BELEM DO BREJO DO CRUZ";9;12;2;23
2011;"BERNARDINO BATISTA (PB)";"PB";"BERNARDINO BATISTA";3;0;3;6
2011;"BOA VENTURA (PB)";"PB";"BOA VENTURA";9;2;1;12
2011;"BOA VISTA (PB)";"PB";"BOA VISTA";97;8;16;121
2011;"BOM JESUS (PB)";"PB";"BOM JESUS";8;0;2;10
2011;"BOM SUCESSO (PB)";"PB";"BOM SUCESSO";2;1;6;9
2011;"BONITO DE SANTA FE (PB)";"PB";"BONITO DE SANTA FE";20;10;2;32
2011;"BOQUEIRAO (PB)";"PB";"BOQUEIRAO";178;10;19;207
2011;"BORBOREMA (PB)";"PB";"BORBOREMA";27;22;2;51
2011;"BREJO DO CRUZ (PB)";"PB";"BREJO DO CRUZ";74;12;3;89
2011;"BREJO DOS SANTOS (PB)";"PB";"BREJO DOS SANTOS";13;2;1;16
2011;"CAAPORA (PB)";"PB";"CAAPORA";32;3;7;42
2011;"CABACEIRAS (PB)";"PB";"CABACEIRAS";21;3;12;36
2011;"CABEDELO (PB)";"PB";"CABEDELO";410;27;26;463
2011;"CACHOEIRA DOS INDIOS (PB)";"PB";"CACHOEIRA DOS INDIOS";15;1;5;21
2011;"CACIMBA DE AREIA (PB)";"PB";"CACIMBA DE AREIA";4;0;5;9
2011;"CACIMBA DE DENTRO (PB)";"PB";"CACIMBA DE DENTRO";59;15;36;110
2011;"CACIMBAS (PB)";"PB";"CACIMBAS";1;4;2;7
2011;"CAICARA (PB)";"PB";"CAICARA";15;3;4;22
2011;"CAJAZEIRAS (PB)";"PB";"CAJAZEIRAS";420;39;43;502
2011;"CAJAZEIRINHAS (PB)";"PB";"CAJAZEIRINHAS";3;4;0;7
2011;"CALDAS BRANDAO (PB)";"PB";"CALDAS BRANDAO";27;4;3;34
2011;"CAMALAU (PB)";"PB";"CAMALAU";22;6;12;40
2011;"CAMPINA GRANDE (PB)";"PB";"CAMPINA GRANDE";4208;307;682;5197
2011;"CAMPO DE SANTANA (PB)";"PB";"CAMPO DE SANTANA";32;4;15;51
2011;"CAPIM (PB)";"PB";"CAPIM";20;2;11;33
2011;"CARAUBAS (PB)";"PB";"CARAUBAS";7;5;3;15
2011;"CARRAPATEIRA (PB)";"PB";"CARRAPATEIRA";2;1;2;5
2011;"CASSERENGUE (PB)";"PB";"CASSERENGUE";22;4;17;43
2011;"CATINGUEIRA (PB)";"PB";"CATINGUEIRA";11;2;2;15
2011;"CATOLE DO ROCHA (PB)";"PB";"CATOLE DO ROCHA";222;38;15;275
2011;"CATURITE (PB)";"PB";"CATURITE";88;12;10;110
2011;"CONCEICAO (PB)";"PB";"CONCEICAO";70;33;8;111
2011;"CONDADO (PB)";"PB";"CONDADO";26;9;7;42
2011;"CONDE (PB)";"PB";"CONDE";82;13;14;109
2011;"CONGO (PB)";"PB";"CONGO";19;4;2;25
2011;"COREMAS (PB)";"PB";"COREMAS";53;14;7;74
2011;"COXIXOLA (PB)";"PB";"COXIXOLA";2;6;0;8
2011;"CRUZ DO ESPIRITO SANTO (PB)";"PB";"CRUZ DO ESPIRITO SANTO";28;4;18;50
2011;"CUBATI (PB)";"PB";"CUBATI";23;4;1;28
2011;"CUITE (PB)";"PB";"CUITE";80;5;11;96
2011;"CUITE DE MAMANGUAPE (PB)";"PB";"CUITE DE MAMANGUAPE";12;9;23;44
2011;"CUITEGI (PB)";"PB";"CUITEGI";16;3;3;22
2011;"CURRAL DE CIMA (PB)";"PB";"CURRAL DE CIMA";13;3;11;27
2011;"CURRAL VELHO (PB)";"PB";"CURRAL VELHO";3;0;2;5
2011;"DAMIAO (PB)";"PB";"DAMIAO";14;4;6;24
2011;"DESTERRO (PB)";"PB";"DESTERRO";27;11;4;42
2011;"DIAMANTE (PB)";"PB";"DIAMANTE";11;2;2;15
2011;"DONA INES (PB)";"PB";"DONA INES";33;7;18;58
2011;"DUAS ESTRADAS (PB)";"PB";"DUAS ESTRADAS";10;5;4;19
2011;"EMAS (PB)";"PB";"EMAS";3;4;2;9
2011;"ESPERANCA (PB)";"PB";"ESPERANCA";473;22;91;586
2011;"FAGUNDES (PB)";"PB";"FAGUNDES";35;8;18;61
2011;"FREI MARTINHO (PB)";"PB";"FREI MARTINHO";6;0;4;10
2011;"GADO BRAVO (PB)";"PB";"GADO BRAVO";34;16;10;60
2011;"GUARABIRA (PB)";"PB";"GUARABIRA";477;57;134;668
2011;"GURINHEM (PB)";"PB";"GURINHEM";37;7;21;65
2011;"GURJAO (PB)";"PB";"GURJAO";8;4;2;14
2011;"IBIARA (PB)";"PB";"IBIARA";10;2;2;14
2011;"IGARACY (PB)";"PB";"IGARACY";11;9;3;23
2011;"IMACULADA (PB)";"PB";"IMACULADA";8;8;2;18
2011;"INGA (PB)";"PB";"INGA";91;8;25;124
2011;"ITABAIANA (PB)";"PB";"ITABAIANA";143;9;33;185
2011;"ITAPORANGA (PB)";"PB";"ITAPORANGA";104;36;14;154
2011;"ITAPOROROCA (PB)";"PB";"ITAPOROROCA";79;3;22;104
2011;"ITATUBA (PB)";"PB";"ITATUBA";31;1;8;40
2011;"JACARAU (PB)";"PB";"JACARAU";56;3;14;73
2011;"JERICO (PB)";"PB";"JERICO";20;3;1;24
2011;"JOAO PESSOA (PB)";"PB";"JOAO PESSOA";5031;872;1538;7441
2011;"JUAREZ TAVORA (PB)";"PB";"JUAREZ TAVORA";24;4;13;41
2011;"JUAZEIRINHO (PB)";"PB";"JUAZEIRINHO";55;18;8;81
2011;"JUNCO DO SERIDO (PB)";"PB";"JUNCO DO SERIDO";50;6;3;59
2011;"JURIPIRANGA (PB)";"PB";"JURIPIRANGA";37;2;17;56
2011;"JURU (PB)";"PB";"JURU";10;9;0;19
2011;"LAGOA (PB)";"PB";"LAGOA";9;3;4;16
2011;"LAGOA DE DENTRO (PB)";"PB";"LAGOA DE DENTRO";31;5;7;43
2011;"LAGOA SECA (PB)";"PB";"LAGOA SECA";171;41;19;231
2011;"LASTRO (PB)";"PB";"LASTRO";3;3;1;7
2011;"LIVRAMENTO (PB)";"PB";"LIVRAMENTO";32;5;2;39
2011;"LOGRADOURO (PB)";"PB";"LOGRADOURO";2;5;9;16
2011;"LUCENA (PB)";"PB";"LUCENA";19;2;8;29
2011;"MAE D AGUA (PB)";"PB";"MAE D AGUA";3;0;3;6
2011;"MALTA (PB)";"PB";"MALTA";10;8;1;19
2011;"MAMANGUAPE (PB)";"PB";"MAMANGUAPE";384;10;78;472
2011;"MANAIRA (PB)";"PB";"MANAIRA";11;6;2;19
2011;"MARCACAO (PB)";"PB";"MARCACAO";2;4;9;15
2011;"MARI (PB)";"PB";"MARI";89;7;42;138
2011;"MARIZOPOLIS (PB)";"PB";"MARIZOPOLIS";20;4;1;25
2011;"MASSARANDUBA (PB)";"PB";"MASSARANDUBA";27;9;10;46
2011;"MATARACA (PB)";"PB";"MATARACA";36;4;14;54
2011;"MATINHAS (PB)";"PB";"MATINHAS";9;2;1;12
2011;"MATO GROSSO (PB)";"PB";"MATO GROSSO";7;3;2;12
2011;"MATUREIA (PB)";"PB";"MATUREIA";14;10;3;27
2011;"MOGEIRO (PB)";"PB";"MOGEIRO";29;7;5;41
2011;"MONTADAS (PB)";"PB";"MONTADAS";20;2;6;28
2011;"MONTE HOREBE (PB)";"PB";"MONTE HOREBE";5;2;3;10
2011;"MONTEIRO (PB)";"PB";"MONTEIRO";224;59;37;320
2011;"MULUNGU (PB)";"PB";"MULUNGU";34;5;12;51
2011;"NATUBA (PB)";"PB";"NATUBA";15;1;2;18
2011;"NAZAREZINHO (PB)";"PB";"NAZAREZINHO";21;7;4;32
2011;"NOVA FLORESTA (PB)";"PB";"NOVA FLORESTA";42;8;7;57
2011;"NOVA OLINDA (PB)";"PB";"NOVA OLINDA";24;6;4;34
2011;"NOVA PALMEIRA (PB)";"PB";"NOVA PALMEIRA";17;1;3;21
2011;"OLHO D AGUA (PB)";"PB";"OLHO D AGUA";4;5;2;11
2011;"OLIVEDOS (PB)";"PB";"OLIVEDOS";26;6;8;40
2011;"OURO VELHO (PB)";"PB";"OURO VELHO";9;5;2;16
2011;"PARARI (PB)";"PB";"PARARI";4;0;1;5
2011;"PASSAGEM (PB)";"PB";"PASSAGEM";16;0;1;17
2011;"PATOS (PB)";"PB";"PATOS";744;128;48;920
2011;"PAULISTA (PB)";"PB";"PAULISTA";43;10;6;59
2011;"PEDRA BRANCA (PB)";"PB";"PEDRA BRANCA";5;4;4;13
2011;"PEDRA LAVRADA (PB)";"PB";"PEDRA LAVRADA";34;4;4;42
2011;"PEDRAS DE FOGO (PB)";"PB";"PEDRAS DE FOGO";254;20;64;338
2011;"PEDRO REGIS (PB)";"PB";"PEDRO REGIS";19;1;3;23
2011;"PIANCO (PB)";"PB";"PIANCO";83;18;3;104
2011;"PICUI (PB)";"PB";"PICUI";108;8;26;142
2011;"PILAR (PB)";"PB";"PILAR";24;2;13;39
2011;"PILOES (PB)";"PB";"PILOES";23;3;6;32
2011;"PILOEZINHOS (PB)";"PB";"PILOEZINHOS";10;3;4;17
2011;"PIRPIRITUBA (PB)";"PB";"PIRPIRITUBA";25;0;10;35
2011;"PITIMBU (PB)";"PB";"PITIMBU";18;16;7;41
2011;"POCINHOS (PB)";"PB";"POCINHOS";96;18;20;134
2011;"POCO DANTAS (PB)";"PB";"POCO DANTAS";3;1;3;7
2011;"POCO DE JOSE DE MOURA (PB)";"PB";"POCO DE JOSE DE MOURA";4;2;3;9
2011;"POMBAL (PB)";"PB";"POMBAL";277;33;14;324
2011;"PRATA (PB)";"PB";"PRATA";17;8;5;30
2011;"PRINCESA ISABEL (PB)";"PB";"PRINCESA ISABEL";81;77;7;165
2011;"PUXINANA (PB)";"PB";"PUXINANA";66;15;7;88
2011;"QUEIMADAS (PB)";"PB";"QUEIMADAS";403;102;86;591
2011;"QUIXABA (PB)";"PB";"QUIXABA";4;3;3;10
2011;"REMIGIO (PB)";"PB";"REMIGIO";206;6;16;228
2011;"RIACHAO (PB)";"PB";"RIACHAO";2;1;5;8
2011;"RIACHAO DO BACAMARTE (PB)";"PB";"RIACHAO DO BACAMARTE";14;0;3;17
2011;"RIACHAO DO POCO (PB)";"PB";"RIACHAO DO POCO";10;1;8;19
2011;"RIACHO DE SANTO ANTONIO (PB)";"PB";"RIACHO DE SANTO ANTONIO";11;4;4;19
2011;"RIACHO DOS CAVALOS (PB)";"PB";"RIACHO DOS CAVALOS";18;3;3;24
2011;"RIO TINTO (PB)";"PB";"RIO TINTO";74;6;29;109
2011;"SALGADINHO (PB)";"PB";"SALGADINHO";4;1;3;8
2011;"SALGADO DE SAO FELIX (PB)";"PB";"SALGADO DE SAO FELIX";15;3;2;20
2011;"SANTA CECILIA (PB)";"PB";"SANTA CECILIA";20;4;6;30
2011;"SANTA CRUZ (PB)";"PB";"SANTA CRUZ";12;3;8;23
2011;"SANTA HELENA (PB)";"PB";"SANTA HELENA";7;0;7;14
2011;"SANTA INES (PB)";"PB";"SANTA INES";9;2;1;12
2011;"SANTA LUZIA (PB)";"PB";"SANTA LUZIA";165;18;14;197
2011;"SANTA RITA (PB)";"PB";"SANTA RITA";691;59;221;971
2011;"SANTA TERESINHA (PB)";"PB";"SANTA TERESINHA";20;3;6;29
2011;"SANTANA DE MANGUEIRA (PB)";"PB";"SANTANA DE MANGUEIRA";2;0;2;4
2011;"SANTANA DOS GARROTES (PB)";"PB";"SANTANA DOS GARROTES";15;4;0;19
2011;"SANTAREM (PB)";"PB";"SANTAREM";2;0;2;4
2011;"SANTO ANDRE (PB)";"PB";"SANTO ANDRE";12;5;16;33
2011;"SAO BENTINHO (PB)";"PB";"SAO BENTINHO";13;4;2;19
2011;"SAO BENTO (PB)";"PB";"SAO BENTO";248;25;15;288
2011;"SAO DOMINGOS DE POMBAL (PB)";"PB";"SAO DOMINGOS DE POMBAL";4;2;2;8
2011;"SAO DOMINGOS DO CARIRI (PB)";"PB";"SAO DOMINGOS DO CARIRI";8;0;3;11
2011;"SAO FRANCISCO (PB)";"PB";"SAO FRANCISCO";8;1;3;12
2011;"SAO JOAO DO CARIRI (PB)";"PB";"SAO JOAO DO CARIRI";17;4;7;28
2011;"SAO JOAO DO RIO DO PEIXE (PB)";"PB";"SAO JOAO DO RIO DO PEIXE";40;4;18;62
2011;"SAO JOAO DO TIGRE (PB)";"PB";"SAO JOAO DO TIGRE";9;2;2;13
2011;"SAO JOSE DA LAGOA TAPADA (PB)";"PB";"SAO JOSE DA LAGOA TAPADA";13;5;5;23
2011;"SAO JOSE DE CAIANA (PB)";"PB";"SAO JOSE DE CAIANA";3;4;4;11
2011;"SAO JOSE DE ESPINHARAS (PB)";"PB";"SAO JOSE DE ESPINHARAS";13;5;2;20
2011;"SAO JOSE DE PIRANHAS (PB)";"PB";"SAO JOSE DE PIRANHAS";32;5;6;43
2011;"SAO JOSE DE PRINCESA (PB)";"PB";"SAO JOSE DE PRINCESA";3;2;3;8
2011;"SAO JOSE DO BONFIM (PB)";"PB";"SAO JOSE DO BONFIM";8;1;3;12
2011;"SAO JOSE DO BREJO DO CRUZ (PB)";"PB";"SAO JOSE DO BREJO DO CRUZ";1;1;1;3
2011;"SAO JOSE DO SABUGI (PB)";"PB";"SAO JOSE DO SABUGI";16;2;2;20
2011;"SAO JOSE DOS CORDEIROS (PB)";"PB";"SAO JOSE DOS CORDEIROS";7;3;4;14
2011;"SAO JOSE DOS RAMOS (PB)";"PB";"SAO JOSE DOS RAMOS";14;1;7;22
2011;"SAO MAMEDE (PB)";"PB";"SAO MAMEDE";20;1;3;24
2011;"SAO MIGUEL DE TAIPU (PB)";"PB";"SAO MIGUEL DE TAIPU";17;0;5;22
2011;"SAO SEBASTIAO DE LAGOA DE ROCA (PB)";"PB";"SAO SEBASTIAO DE LAGOA DE ROCA";54;12;9;75
2011;"SAO SEBASTIAO DO UMBUZEIRO (PB)";"PB";"SAO SEBASTIAO DO UMBUZEIRO";7;1;4;12
2011;"SAO VICENTE DO SERIDO (PB)";"PB";"SAO VICENTE DO SERIDO";11;6;4;21
2011;"SAPE (PB)";"PB";"SAPE";319;24;86;429
2011;"SERRA BRANCA (PB)";"PB";"SERRA BRANCA";72;16;7;95
2011;"SERRA DA RAIZ (PB)";"PB";"SERRA DA RAIZ";4;0;5;9
2011;"SERRA GRANDE (PB)";"PB";"SERRA GRANDE";3;0;3;6
2011;"SERRA REDONDA (PB)";"PB";"SERRA REDONDA";18;7;2;27
2011;"SERRARIA (PB)";"PB";"SERRARIA";14;6;5;25
2011;"SERTAOZINHO (PB)";"PB";"SERTAOZINHO";6;1;8;15
2011;"SOBRADO (PB)";"PB";"SOBRADO";47;3;5;55
2011;"SOLANEA (PB)";"PB";"SOLANEA";162;26;30;218
2011;"SOLEDADE (PB)";"PB";"SOLEDADE";135;14;17;166
2011;"SOSSEGO (PB)";"PB";"SOSSEGO";21;3;3;27
2011;"SOUSA (PB)";"PB";"SOUSA";656;37;59;752
2011;"SUME (PB)";"PB";"SUME";77;19;15;111
2011;"TAPEROA (PB)";"PB";"TAPEROA";68;10;4;82
2011;"TAVARES (PB)";"PB";"TAVARES";21;4;5;30
2011;"TEIXEIRA (PB)";"PB";"TEIXEIRA";80;11;17;108
2011;"TENORIO (PB)";"PB";"TENORIO";12;1;3;16
2011;"TRIUNFO (PB)";"PB";"TRIUNFO";10;3;3;16
2011;"UIRAUNA (PB)";"PB";"UIRAUNA";64;5;6;75
2011;"UMBUZEIRO (PB)";"PB";"UMBUZEIRO";61;26;23;110
2011;"VARZEA (PB)";"PB";"VARZEA";13;4;4;21
2011;"VIEIROPOLIS (PB)";"PB";"VIEIROPOLIS";14;1;8;23
2011;"VISTA SERRANA (PB)";"PB";"VISTA SERRANA";16;1;4;21
2011;"ZABELE (PB)";"PB";"ZABELE";8;2;2;12
2011;"ABREU E LIMA (PE)";"PE";"ABREU E LIMA";487;47;349;883
2011;"AFOGADOS DA INGAZEIRA (PE)";"PE";"AFOGADOS DA INGAZEIRA";320;31;49;400
2011;"AFRANIO (PE)";"PE";"AFRANIO";121;7;12;140
2011;"AGRESTINA (PE)";"PE";"AGRESTINA";153;35;23;211
2011;"AGUA PRETA (PE)";"PE";"AGUA PRETA";146;36;43;225
2011;"AGUAS BELAS (PE)";"PE";"AGUAS BELAS";255;59;33;347
2011;"ALAGOINHA (PE)";"PE";"ALAGOINHA";91;33;10;134
2011;"ALIANCA (PE)";"PE";"ALIANCA";144;15;103;262
2011;"ALTINHO (PE)";"PE";"ALTINHO";63;35;24;122
2011;"AMARAJI (PE)";"PE";"AMARAJI";79;27;30;136
2011;"ANGELIM (PE)";"PE";"ANGELIM";45;14;5;64
2011;"ARACOIABA (PE)";"PE";"ARACOIABA";66;7;77;150
2011;"ARARIPINA (PE)";"PE";"ARARIPINA";1183;34;57;1274
2011;"ARCOVERDE (PE)";"PE";"ARCOVERDE";939;102;101;1142
2011;"BARRA DE GUABIRABA (PE)";"PE";"BARRA DE GUABIRABA";59;17;9;85
2011;"BARREIROS (PE)";"PE";"BARREIROS";255;25;43;323
2011;"BELEM DE MARIA (PE)";"PE";"BELEM DE MARIA";69;27;14;110
2011;"BELEM DE SAO FRANCISCO (PE)";"PE";"BELEM DE SAO FRANCISCO";92;9;11;112
2011;"BELO JARDIM (PE)";"PE";"BELO JARDIM";599;161;66;826
2011;"BETANIA (PE)";"PE";"BETANIA";39;3;5;47
2011;"BEZERROS (PE)";"PE";"BEZERROS";660;92;49;801
2011;"BODOCO (PE)";"PE";"BODOCO";188;2;10;200
2011;"BOM CONSELHO (PE)";"PE";"BOM CONSELHO";253;38;35;326
2011;"BOM JARDIM (PE)";"PE";"BOM JARDIM";155;193;35;383
2011;"BONITO (PE)";"PE";"BONITO";314;70;27;411
2011;"BREJAO (PE)";"PE";"BREJAO";42;9;8;59
2011;"BREJINHO (PE)";"PE";"BREJINHO";30;3;3;36
2011;"BREJO DA MADRE DE DEUS (PE)";"PE";"BREJO DA MADRE DE DEUS";201;282;10;493
2011;"BUENOS AIRES (PE)";"PE";"BUENOS AIRES";51;4;13;68
2011;"BUIQUE (PE)";"PE";"BUIQUE";246;51;30;327
2011;"CABO DE SANTO AGOSTINHO (PE)";"PE";"CABO DE SANTO AGOSTINHO";1199;227;388;1814
2011;"CABROBO (PE)";"PE";"CABROBO";200;6;27;233
2011;"CACHOEIRINHA (PE)";"PE";"CACHOEIRINHA";126;44;10;180
2011;"CAETES (PE)";"PE";"CAETES";223;35;8;266
2011;"CALCADO (PE)";"PE";"CALCADO";49;8;20;77
2011;"CALUMBI (PE)";"PE";"CALUMBI";53;7;4;64
2011;"CAMARAGIBE (PE)";"PE";"CAMARAGIBE";696;236;138;1070
2011;"CAMOCIM DE SAO FELIX (PE)";"PE";"CAMOCIM DE SAO FELIX";120;24;7;151
2011;"CAMUTANGA (PE)";"PE";"CAMUTANGA";74;1;14;89
2011;"CANHOTINHO (PE)";"PE";"CANHOTINHO";193;62;6;261
2011;"CAPOEIRAS (PE)";"PE";"CAPOEIRAS";198;29;6;233
2011;"CARNAIBA (PE)";"PE";"CARNAIBA";77;21;7;105
2011;"CARNAUBEIRA DA PENHA (PE)";"PE";"CARNAUBEIRA DA PENHA";38;4;1;43
2011;"CARPINA (PE)";"PE";"CARPINA";838;104;127;1069
2011;"CARUARU (PE)";"PE";"CARUARU";3918;611;474;5003
2011;"CASINHAS (PE)";"PE";"CASINHAS";47;128;11;186
2011;"CATENDE (PE)";"PE";"CATENDE";172;53;57;282
2011;"CEDRO (PE)";"PE";"CEDRO";38;4;9;51
2011;"CHA DE ALEGRIA (PE)";"PE";"CHA DE ALEGRIA";48;16;24;88
2011;"CHA GRANDE (PE)";"PE";"CHA GRANDE";215;31;17;263
2011;"CONDADO (PE)";"PE";"CONDADO";123;8;62;193
2011;"CORRENTES (PE)";"PE";"CORRENTES";63;26;8;97
2011;"CORTES (PE)";"PE";"CORTES";154;38;28;220
2011;"CUMARU (PE)";"PE";"CUMARU";98;61;16;175
2011;"CUPIRA (PE)";"PE";"CUPIRA";220;58;14;292
2011;"CUSTODIA (PE)";"PE";"CUSTODIA";294;47;19;360
2011;"DORMENTES (PE)";"PE";"DORMENTES";140;5;10;155
2011;"ESCADA (PE)";"PE";"ESCADA";349;66;159;574
2011;"EXU (PE)";"PE";"EXU";297;6;26;329
2011;"FEIRA NOVA (PE)";"PE";"FEIRA NOVA";186;27;11;224
2011;"FERNANDO DE NORONHA (PE)";"PE";"FERNANDO DE NORONHA";16;18;8;42
2011;"FERREIROS (PE)";"PE";"FERREIROS";59;1;41;101
2011;"FLORES (PE)";"PE";"FLORES";61;15;5;81
2011;"FLORESTA (PE)";"PE";"FLORESTA";421;7;12;440
2011;"FREI MIGUELINHO (PE)";"PE";"FREI MIGUELINHO";132;128;17;277
2011;"GAMELEIRA (PE)";"PE";"GAMELEIRA";81;14;43;138
2011;"GARANHUNS (PE)";"PE";"GARANHUNS";1784;212;99;2095
2011;"GLORIA DO GOITA (PE)";"PE";"GLORIA DO GOITA";146;40;25;211
2011;"GOIANA (PE)";"PE";"GOIANA";665;68;125;858
2011;"GRANITO (PE)";"PE";"GRANITO";20;1;8;29
2011;"GRAVATA (PE)";"PE";"GRAVATA";833;85;51;969
2011;"IATI (PE)";"PE";"IATI";41;26;20;87
2011;"IBIMIRIM (PE)";"PE";"IBIMIRIM";175;27;4;206
2011;"IBIRAJUBA (PE)";"PE";"IBIRAJUBA";46;4;5;55
2011;"IGARASSU (PE)";"PE";"IGARASSU";795;66;624;1485
2011;"IGUARACI (PE)";"PE";"IGUARACI";86;13;22;121
2011;"ILHA DE ITAMARACA (PE)";"PE";"ILHA DE ITAMARACA";76;13;11;100
2011;"INAJA (PE)";"PE";"INAJA";48;5;6;59
2011;"INGAZEIRA (PE)";"PE";"INGAZEIRA";19;3;4;26
2011;"IPOJUCA (PE)";"PE";"IPOJUCA";540;229;176;945
2011;"IPUBI (PE)";"PE";"IPUBI";208;13;27;248
2011;"ITACURUBA (PE)";"PE";"ITACURUBA";16;2;5;23
2011;"ITAIBA (PE)";"PE";"ITAIBA";93;23;7;123
2011;"ITAMBE (PE)";"PE";"ITAMBE";337;16;100;453
2011;"ITAPETIM (PE)";"PE";"ITAPETIM";50;2;6;58
2011;"ITAPISSUMA (PE)";"PE";"ITAPISSUMA";66;32;22;120
2011;"ITAQUITINGA (PE)";"PE";"ITAQUITINGA";38;5;26;69
2011;"JABOATAO DOS GUARARAPES (PE)";"PE";"JABOATAO DOS GUARARAPES";5031;821;1811;7663
2011;"JAQUEIRA (PE)";"PE";"JAQUEIRA";60;6;18;84
2011;"JATAUBA (PE)";"PE";"JATAUBA";73;120;7;200
2011;"JATOBA (PE)";"PE";"JATOBA";31;7;8;46
2011;"JOAO ALFREDO (PE)";"PE";"JOAO ALFREDO";183;454;11;648
2011;"JOAQUIM NABUCO (PE)";"PE";"JOAQUIM NABUCO";87;15;42;144
2011;"JUCATI (PE)";"PE";"JUCATI";110;11;17;138
2011;"JUPI (PE)";"PE";"JUPI";137;23;21;181
2011;"JUREMA (PE)";"PE";"JUREMA";70;16;6;92
2011;"LAGOA DO CARRO (PE)";"PE";"LAGOA DO CARRO";86;10;13;109
2011;"LAGOA DO ITAENGA (PE)";"PE";"LAGOA DO ITAENGA";339;22;48;409
2011;"LAGOA DO OURO (PE)";"PE";"LAGOA DO OURO";41;24;6;71
2011;"LAGOA DOS GATOS (PE)";"PE";"LAGOA DOS GATOS";91;17;6;114
2011;"LAGOA GRANDE (PE)";"PE";"LAGOA GRANDE";93;8;10;111
2011;"LAJEDO (PE)";"PE";"LAJEDO";466;58;41;565
2011;"LIMOEIRO (PE)";"PE";"LIMOEIRO";435;105;41;581
2011;"MACAPARANA (PE)";"PE";"MACAPARANA";160;12;37;209
2011;"MACHADOS (PE)";"PE";"MACHADOS";96;24;9;129
2011;"MANARI (PE)";"PE";"MANARI";36;4;6;46
2011;"MARAIAL (PE)";"PE";"MARAIAL";133;7;17;157
2011;"MIRANDIBA (PE)";"PE";"MIRANDIBA";106;5;2;113
2011;"MOREILANDIA (PE)";"PE";"MOREILANDIA";39;4;6;49
2011;"MORENO (PE)";"PE";"MORENO";511;115;244;870
2011;"NAZARE DA MATA (PE)";"PE";"NAZARE DA MATA";206;17;36;259
2011;"OLINDA (PE)";"PE";"OLINDA";2730;331;1299;4360
2011;"OROBO (PE)";"PE";"OROBO";126;144;50;320
2011;"OROCO (PE)";"PE";"OROCO";55;2;7;64
2011;"OURICURI (PE)";"PE";"OURICURI";538;18;66;622
2011;"PALMARES (PE)";"PE";"PALMARES";516;62;158;736
2011;"PALMEIRINA (PE)";"PE";"PALMEIRINA";25;11;3;39
2011;"PANELAS (PE)";"PE";"PANELAS";85;43;15;143
2011;"PARANATAMA (PE)";"PE";"PARANATAMA";62;18;12;92
2011;"PARNAMIRIM (PE)";"PE";"PARNAMIRIM";140;5;14;159
2011;"PASSIRA (PE)";"PE";"PASSIRA";212;62;21;295
2011;"PAUDALHO (PE)";"PE";"PAUDALHO";503;27;51;581
2011;"PAULISTA (PE)";"PE";"PAULISTA";1290;247;290;1827
2011;"PEDRA (PE)";"PE";"PEDRA";107;26;13;146
2011;"PESQUEIRA (PE)";"PE";"PESQUEIRA";576;55;97;728
2011;"PETROLANDIA (PE)";"PE";"PETROLANDIA";226;5;37;268
2011;"PETROLINA (PE)";"PE";"PETROLINA";2850;224;308;3382
2011;"POCAO (PE)";"PE";"POCAO";40;21;7;68
2011;"POMBOS (PE)";"PE";"POMBOS";441;41;42;524
2011;"PRIMAVERA (PE)";"PE";"PRIMAVERA";69;9;37;115
2011;"QUIPAPA (PE)";"PE";"QUIPAPA";78;19;38;135
2011;"QUIXABA (PE)";"PE";"QUIXABA";26;2;4;32
2011;"RECIFE (PE)";"PE";"RECIFE";18351;2161;3836;24348
2011;"RIACHO DAS ALMAS (PE)";"PE";"RIACHO DAS ALMAS";228;73;21;322
2011;"RIBEIRAO (PE)";"PE";"RIBEIRAO";268;35;86;389
2011;"RIO FORMOSO (PE)";"PE";"RIO FORMOSO";102;19;58;179
2011;"SAIRE (PE)";"PE";"SAIRE";83;6;22;111
2011;"SALGADINHO (PE)";"PE";"SALGADINHO";16;24;4;44
2011;"SALGUEIRO (PE)";"PE";"SALGUEIRO";476;30;50;556
2011;"SALOA (PE)";"PE";"SALOA";56;21;3;80
2011;"SANHARO (PE)";"PE";"SANHARO";86;14;25;125
2011;"SANTA CRUZ (PE)";"PE";"SANTA CRUZ";116;4;14;134
2011;"SANTA CRUZ DA BAIXA VERDE (PE)";"PE";"SANTA CRUZ DA BAIXA VERDE";191;8;5;204
2011;"SANTA CRUZ DO CAPIBARIBE (PE)";"PE";"SANTA CRUZ DO CAPIBARIBE";679;349;52;1080
2011;"SANTA FILOMENA (PE)";"PE";"SANTA FILOMENA";68;0;17;85
2011;"SANTA MARIA DA BOA VISTA (PE)";"PE";"SANTA MARIA DA BOA VISTA";185;7;36;228
2011;"SANTA MARIA DO CAMBUCA (PE)";"PE";"SANTA MARIA DO CAMBUCA";139;99;18;256
2011;"SANTA TEREZINHA (PE)";"PE";"SANTA TEREZINHA";43;5;7;55
2011;"SAO BENEDITO DO SUL (PE)";"PE";"SAO BENEDITO DO SUL";29;6;11;46
2011;"SAO BENTO DO UNA (PE)";"PE";"SAO BENTO DO UNA";674;53;61;788
2011;"SAO CAITANO (PE)";"PE";"SAO CAITANO";260;125;36;421
2011;"SAO JOAO (PE)";"PE";"SAO JOAO";95;31;12;138
2011;"SAO JOAQUIM DO MONTE (PE)";"PE";"SAO JOAQUIM DO MONTE";63;18;15;96
2011;"SAO JOSE DA COROA GRANDE (PE)";"PE";"SAO JOSE DA COROA GRANDE";55;12;18;85
2011;"SAO JOSE DO BELMONTE (PE)";"PE";"SAO JOSE DO BELMONTE";251;16;24;291
2011;"SAO JOSE DO EGITO (PE)";"PE";"SAO JOSE DO EGITO";426;39;53;518
2011;"SAO LOURENCO DA MATA (PE)";"PE";"SAO LOURENCO DA MATA";345;47;367;759
2011;"SAO VICENTE FERRER (PE)";"PE";"SAO VICENTE FERRER";138;11;18;167
2011;"SERRA TALHADA (PE)";"PE";"SERRA TALHADA";1403;49;42;1494
2011;"SERRITA (PE)";"PE";"SERRITA";90;5;9;104
2011;"SERTANIA (PE)";"PE";"SERTANIA";350;30;38;418
2011;"SIRINHAEM (PE)";"PE";"SIRINHAEM";190;8;67;265
2011;"SOLIDAO (PE)";"PE";"SOLIDAO";21;3;2;26
2011;"SURUBIM (PE)";"PE";"SURUBIM";656;514;50;1220
2011;"TABIRA (PE)";"PE";"TABIRA";207;24;19;250
2011;"TACAIMBO (PE)";"PE";"TACAIMBO";71;17;16;104
2011;"TACARATU (PE)";"PE";"TACARATU";46;9;7;62
2011;"TAMANDARE (PE)";"PE";"TAMANDARE";60;15;16;91
2011;"TAQUARITINGA DO NORTE (PE)";"PE";"TAQUARITINGA DO NORTE";156;84;17;257
2011;"TEREZINHA (PE)";"PE";"TEREZINHA";20;5;4;29
2011;"TERRA NOVA (PE)";"PE";"TERRA NOVA";77;0;6;83
2011;"TIMBAUBA (PE)";"PE";"TIMBAUBA";663;34;101;798
2011;"TORITAMA (PE)";"PE";"TORITAMA";191;65;23;279
2011;"TRACUNHAEM (PE)";"PE";"TRACUNHAEM";47;18;20;85
2011;"TRINDADE (PE)";"PE";"TRINDADE";319;22;10;351
2011;"TRIUNFO (PE)";"PE";"TRIUNFO";183;13;9;205
2011;"TUPANATINGA (PE)";"PE";"TUPANATINGA";117;26;7;150
2011;"TUPARETAMA (PE)";"PE";"TUPARETAMA";94;16;18;128
2011;"VENTUROSA (PE)";"PE";"VENTUROSA";123;28;10;161
2011;"VERDEJANTE (PE)";"PE";"VERDEJANTE";53;4;13;70
2011;"VERTENTE DO LERIO (PE)";"PE";"VERTENTE DO LERIO";71;70;9;150
2011;"VERTENTES (PE)";"PE";"VERTENTES";133;73;20;226
2011;"VICENCIA (PE)";"PE";"VICENCIA";238;10;66;314
2011;"VITORIA DE SANTO ANTAO (PE)";"PE";"VITORIA DE SANTO ANTAO";2075;109;269;2453
2011;"XEXEU (PE)";"PE";"XEXEU";55;8;34;97
2011;"ACAUA (PI)";"PI";"ACAUA";19;3;3;25
2011;"AGRICOLANDIA (PI)";"PI";"AGRICOLANDIA";12;1;7;20
2011;"AGUA BRANCA (PI)";"PI";"AGUA BRANCA";109;10;7;126
2011;"ALAGOINHA DO PIAUI (PI)";"PI";"ALAGOINHA DO PIAUI";26;1;4;31
2011;"ALEGRETE DO PIAUI (PI)";"PI";"ALEGRETE DO PIAUI";5;1;2;8
2011;"ALTO LONGA (PI)";"PI";"ALTO LONGA";30;3;11;44
2011;"ALTOS (PI)";"PI";"ALTOS";197;5;24;226
2011;"ALVORADA DO GURGUEIA (PI)";"PI";"ALVORADA DO GURGUEIA";12;3;6;21
2011;"AMARANTE (PI)";"PI";"AMARANTE";57;8;10;75
2011;"ANGICAL DO PIAUI (PI)";"PI";"ANGICAL DO PIAUI";12;2;2;16
2011;"ANISIO DE ABREU (PI)";"PI";"ANISIO DE ABREU";15;7;6;28
2011;"ANTONIO ALMEIDA (PI)";"PI";"ANTONIO ALMEIDA";15;2;2;19
2011;"AROAZES (PI)";"PI";"AROAZES";12;3;7;22
2011;"AROEIRAS DO ITAIM (PI)";"PI";"AROEIRAS DO ITAIM";8;0;5;13
2011;"ARRAIAL (PI)";"PI";"ARRAIAL";4;2;3;9
2011;"ASSUNCAO DO PIAUI (PI)";"PI";"ASSUNCAO DO PIAUI";2;0;1;3
2011;"AVELINO LOPES (PI)";"PI";"AVELINO LOPES";13;3;2;18
2011;"BAIXA GRANDE DO RIBEIRO (PI)";"PI";"BAIXA GRANDE DO RIBEIRO";39;2;3;44
2011;"BARRA D ALCANTARA (PI)";"PI";"BARRA D ALCANTARA";16;0;1;17
2011;"BARRAS (PI)";"PI";"BARRAS";105;9;37;151
2011;"BARREIRAS DO PIAUI (PI)";"PI";"BARREIRAS DO PIAUI";5;0;0;5
2011;"BARRO DURO (PI)";"PI";"BARRO DURO";45;3;2;50
2011;"BATALHA (PI)";"PI";"BATALHA";63;2;11;76
2011;"BELA VISTA DO PIAUI (PI)";"PI";"BELA VISTA DO PIAUI";9;1;3;13
2011;"BELEM DO PIAUI (PI)";"PI";"BELEM DO PIAUI";2;0;0;2
2011;"BENEDITINOS (PI)";"PI";"BENEDITINOS";20;1;6;27
2011;"BERTOLINIA (PI)";"PI";"BERTOLINIA";14;5;3;22
2011;"BETANIA DO PIAUI (PI)";"PI";"BETANIA DO PIAUI";6;6;2;14
2011;"BOA HORA (PI)";"PI";"BOA HORA";11;0;4;15
2011;"BOCAINA (PI)";"PI";"BOCAINA";6;5;2;13
2011;"BOM JESUS (PI)";"PI";"BOM JESUS";167;2;12;181
2011;"BOM PRINCIPIO DO PIAUI (PI)";"PI";"BOM PRINCIPIO DO PIAUI";6;4;5;15
2011;"BONFIM DO PIAUI (PI)";"PI";"BONFIM DO PIAUI";8;2;3;13
2011;"BOQUEIRAO DO PIAUI (PI)";"PI";"BOQUEIRAO DO PIAUI";8;0;2;10
2011;"BRASILEIRA (PI)";"PI";"BRASILEIRA";11;2;5;18
2011;"BREJO DO PIAUI (PI)";"PI";"BREJO DO PIAUI";6;4;0;10
2011;"BURITI DOS LOPES (PI)";"PI";"BURITI DOS LOPES";25;4;13;42
2011;"BURITI DOS MONTES (PI)";"PI";"BURITI DOS MONTES";12;3;3;18
2011;"CABECEIRAS DO PIAUI (PI)";"PI";"CABECEIRAS DO PIAUI";9;1;14;24
2011;"CAJAZEIRAS DO PIAUI (PI)";"PI";"CAJAZEIRAS DO PIAUI";3;0;2;5
2011;"CAJUEIRO DA PRAIA (PI)";"PI";"CAJUEIRO DA PRAIA";8;1;7;16
2011;"CALDEIRAO GRANDE DO PIAUI (PI)";"PI";"CALDEIRAO GRANDE DO PIAUI";7;2;2;11
2011;"CAMPINAS DO PIAUI (PI)";"PI";"CAMPINAS DO PIAUI";1;0;3;4
2011;"CAMPO ALEGRE DO FIDALGO (PI)";"PI";"CAMPO ALEGRE DO FIDALGO";2;1;2;5
2011;"CAMPO GRANDE DO PIAUI (PI)";"PI";"CAMPO GRANDE DO PIAUI";22;6;2;30
2011;"CAMPO LARGO DO PIAUI (PI)";"PI";"CAMPO LARGO DO PIAUI";3;2;1;6
2011;"CAMPO MAIOR (PI)";"PI";"CAMPO MAIOR";361;22;62;445
2011;"CANAVIEIRA (PI)";"PI";"CANAVIEIRA";0;0;1;1
2011;"CANTO DO BURITI (PI)";"PI";"CANTO DO BURITI";81;12;5;98
2011;"CAPITAO DE CAMPOS (PI)";"PI";"CAPITAO DE CAMPOS";18;2;7;27
2011;"CAPITAO GERVASIO OLIVEIRA (PI)";"PI";"CAPITAO GERVASIO OLIVEIRA";1;0;3;4
2011;"CARACOL (PI)";"PI";"CARACOL";28;3;1;32
2011;"CARAUBAS DO PIAUI (PI)";"PI";"CARAUBAS DO PIAUI";10;1;3;14
2011;"CARIDADE DO PIAUI (PI)";"PI";"CARIDADE DO PIAUI";4;1;3;8
2011;"CASTELO DO PIAUI (PI)";"PI";"CASTELO DO PIAUI";57;4;7;68
2011;"CAXINGO (PI)";"PI";"CAXINGO";8;1;6;15
2011;"COCAL (PI)";"PI";"COCAL";44;7;9;60
2011;"COCAL DE TELHA (PI)";"PI";"COCAL DE TELHA";11;1;2;14
2011;"COCAL DOS ALVES (PI)";"PI";"COCAL DOS ALVES";2;4;1;7
2011;"COIVARAS (PI)";"PI";"COIVARAS";6;0;4;10
2011;"COLONIA DO GURGUEIA (PI)";"PI";"COLONIA DO GURGUEIA";3;6;1;10
2011;"COLONIA DO PIAUI (PI)";"PI";"COLONIA DO PIAUI";8;2;4;14
2011;"CONCEICAO DO CANINDE (PI)";"PI";"CONCEICAO DO CANINDE";9;2;0;11
2011;"CORONEL JOSE DIAS (PI)";"PI";"CORONEL JOSE DIAS";4;1;2;7
2011;"CORRENTE (PI)";"PI";"CORRENTE";73;6;5;84
2011;"CRISTALANDIA DO PIAUI (PI)";"PI";"CRISTALANDIA DO PIAUI";4;0;2;6
2011;"CRISTINO CASTRO (PI)";"PI";"CRISTINO CASTRO";28;3;8;39
2011;"CURIMATA (PI)";"PI";"CURIMATA";10;1;2;13
2011;"CURRAIS (PI)";"PI";"CURRAIS";0;1;1;2
2011;"CURRAL NOVO DO PIAUI (PI)";"PI";"CURRAL NOVO DO PIAUI";0;2;1;3
2011;"CURRALINHOS (PI)";"PI";"CURRALINHOS";4;0;2;6
2011;"DEMERVAL LOBAO (PI)";"PI";"DEMERVAL LOBAO";52;6;3;61
2011;"DIRCEU ARCOVERDE (PI)";"PI";"DIRCEU ARCOVERDE";7;1;2;10
2011;"DOM EXPEDITO LOPES (PI)";"PI";"DOM EXPEDITO LOPES";66;5;2;73
2011;"DOM INOCENCIO (PI)";"PI";"DOM INOCENCIO";15;2;3;20
2011;"DOMINGOS MOURAO (PI)";"PI";"DOMINGOS MOURAO";1;0;2;3
2011;"ELESBAO VELOSO (PI)";"PI";"ELESBAO VELOSO";58;1;7;66
2011;"ELISEU MARTINS (PI)";"PI";"ELISEU MARTINS";6;1;2;9
2011;"ESPERANTINA (PI)";"PI";"ESPERANTINA";147;14;29;190
2011;"FARTURA DO PIAUI (PI)";"PI";"FARTURA DO PIAUI";3;0;1;4
2011;"FLORES DO PIAUI (PI)";"PI";"FLORES DO PIAUI";3;3;2;8
2011;"FLORESTA DO PIAUI (PI)";"PI";"FLORESTA DO PIAUI";4;5;2;11
2011;"FLORIANO (PI)";"PI";"FLORIANO";1004;67;41;1112
2011;"FRANCINOPOLIS (PI)";"PI";"FRANCINOPOLIS";11;5;1;17
2011;"FRANCISCO AYRES (PI)";"PI";"FRANCISCO AYRES";7;9;4;20
2011;"FRANCISCO MACEDO (PI)";"PI";"FRANCISCO MACEDO";6;2;3;11
2011;"FRANCISCO SANTOS (PI)";"PI";"FRANCISCO SANTOS";57;7;8;72
2011;"FRONTEIRAS (PI)";"PI";"FRONTEIRAS";54;5;4;63
2011;"GEMINIANO (PI)";"PI";"GEMINIANO";20;7;10;37
2011;"GILBUES (PI)";"PI";"GILBUES";7;2;5;14
2011;"GUADALUPE (PI)";"PI";"GUADALUPE";63;9;6;78
2011;"GUARIBAS (PI)";"PI";"GUARIBAS";2;0;1;3
2011;"HUGO NAPOLEAO (PI)";"PI";"HUGO NAPOLEAO";6;1;1;8
2011;"ILHA GRANDE (PI)";"PI";"ILHA GRANDE";12;2;2;16
2011;"INHUMA (PI)";"PI";"INHUMA";66;4;12;82
2011;"IPIRANGA DO PIAUI (PI)";"PI";"IPIRANGA DO PIAUI";45;13;4;62
2011;"ISAIAS COELHO (PI)";"PI";"ISAIAS COELHO";7;0;3;10
2011;"ITAINOPOLIS (PI)";"PI";"ITAINOPOLIS";29;19;9;57
2011;"ITAUEIRA (PI)";"PI";"ITAUEIRA";33;5;1;39
2011;"JACOBINA DO PIAUI (PI)";"PI";"JACOBINA DO PIAUI";21;3;1;25
2011;"JAICOS (PI)";"PI";"JAICOS";80;7;6;93
2011;"JARDIM DO MULATO (PI)";"PI";"JARDIM DO MULATO";3;1;1;5
2011;"JATOBA DO PIAUI (PI)";"PI";"JATOBA DO PIAUI";30;0;7;37
2011;"JERUMENHA (PI)";"PI";"JERUMENHA";9;1;1;11
2011;"JOAO COSTA (PI)";"PI";"JOAO COSTA";2;0;0;2
2011;"JOAQUIM PIRES (PI)";"PI";"JOAQUIM PIRES";20;2;2;24
2011;"JOCA MARQUES (PI)";"PI";"JOCA MARQUES";4;0;3;7
2011;"JOSE DE FREITAS (PI)";"PI";"JOSE DE FREITAS";78;7;18;103
2011;"JUAZEIRO DO PIAUI (PI)";"PI";"JUAZEIRO DO PIAUI";10;1;0;11
2011;"JULIO BORGES (PI)";"PI";"JULIO BORGES";1;1;2;4
2011;"JUREMA (PI)";"PI";"JUREMA";4;3;3;10
2011;"LAGOA ALEGRE (PI)";"PI";"LAGOA ALEGRE";8;2;9;19
2011;"LAGOA DE SAO FRANCISCO (PI)";"PI";"LAGOA DE SAO FRANCISCO";5;0;1;6
2011;"LAGOA DO BARRO DO PIAUI (PI)";"PI";"LAGOA DO BARRO DO PIAUI";1;0;6;7
2011;"LAGOA DO PIAUI (PI)";"PI";"LAGOA DO PIAUI";8;0;0;8
2011;"LAGOA DO SITIO (PI)";"PI";"LAGOA DO SITIO";9;1;2;12
2011;"LAGOINHA DO PIAUI (PI)";"PI";"LAGOINHA DO PIAUI";6;2;4;12
2011;"LANDRI SALES (PI)";"PI";"LANDRI SALES";5;3;1;9
2011;"LUIS CORREIA (PI)";"PI";"LUIS CORREIA";38;10;22;70
2011;"LUZILANDIA (PI)";"PI";"LUZILANDIA";32;2;13;47
2011;"MADEIRO (PI)";"PI";"MADEIRO";7;2;2;11
2011;"MANOEL EMIDIO (PI)";"PI";"MANOEL EMIDIO";7;1;3;11
2011;"MARCOLANDIA (PI)";"PI";"MARCOLANDIA";63;18;5;86
2011;"MARCOS PARENTE (PI)";"PI";"MARCOS PARENTE";5;7;0;12
2011;"MASSAPE DO PIAUI (PI)";"PI";"MASSAPE DO PIAUI";4;1;2;7
2011;"MATIAS OLIMPIO (PI)";"PI";"MATIAS OLIMPIO";15;7;6;28
2011;"MIGUEL ALVES (PI)";"PI";"MIGUEL ALVES";33;2;14;49
2011;"MIGUEL LEAO (PI)";"PI";"MIGUEL LEAO";3;0;1;4
2011;"MILTON BRANDAO (PI)";"PI";"MILTON BRANDAO";5;0;2;7
2011;"MONSENHOR GIL (PI)";"PI";"MONSENHOR GIL";18;2;5;25
2011;"MONSENHOR HIPOLITO (PI)";"PI";"MONSENHOR HIPOLITO";15;9;3;27
2011;"MONTE ALEGRE DO PIAUI (PI)";"PI";"MONTE ALEGRE DO PIAUI";6;0;3;9
2011;"MORRO CABECA NO TEMPO (PI)";"PI";"MORRO CABECA NO TEMPO";0;0;2;2
2011;"MORRO DO CHAPEU DO PIAUI (PI)";"PI";"MORRO DO CHAPEU DO PIAUI";4;1;3;8
2011;"MURICI DOS PORTELAS (PI)";"PI";"MURICI DOS PORTELAS";5;1;3;9
2011;"NAZARE DO PIAUI (PI)";"PI";"NAZARE DO PIAUI";13;15;2;30
2011;"NAZARIA (PI)";"PI";"NAZARIA";4;0;2;6
2011;"NOSSA SENHORA DE NAZARE (PI)";"PI";"NOSSA SENHORA DE NAZARE";8;1;4;13
2011;"NOSSA SENHORA DOS REMEDIOS (PI)";"PI";"NOSSA SENHORA DOS REMEDIOS";3;5;1;9
2011;"NOVA SANTA RITA (PI)";"PI";"NOVA SANTA RITA";1;3;1;5
2011;"NOVO ORIENTE DO PIAUI (PI)";"PI";"NOVO ORIENTE DO PIAUI";13;3;6;22
2011;"NOVO SANTO ANTONIO (PI)";"PI";"NOVO SANTO ANTONIO";8;2;3;13
2011;"OEIRAS (PI)";"PI";"OEIRAS";290;31;36;357
2011;"OLHO D AGUA DO PIAUI (PI)";"PI";"OLHO D AGUA DO PIAUI";3;1;2;6
2011;"PADRE MARCOS (PI)";"PI";"PADRE MARCOS";9;4;3;16
2011;"PAES LANDIM (PI)";"PI";"PAES LANDIM";4;1;0;5
2011;"PAJEU DO PIAUI (PI)";"PI";"PAJEU DO PIAUI";6;2;1;9
2011;"PALMEIRA DO PIAUI (PI)";"PI";"PALMEIRA DO PIAUI";24;1;1;26
2011;"PALMEIRAIS (PI)";"PI";"PALMEIRAIS";14;3;7;24
2011;"PAQUETA (PI)";"PI";"PAQUETA";6;5;3;14
2011;"PARNAGUA (PI)";"PI";"PARNAGUA";6;1;1;8
2011;"PARNAIBA (PI)";"PI";"PARNAIBA";902;100;215;1217
2011;"PASSAGEM FRANCA DO PIAUI (PI)";"PI";"PASSAGEM FRANCA DO PIAUI";3;1;1;5
2011;"PATOS DO PIAUI (PI)";"PI";"PATOS DO PIAUI";14;3;6;23
2011;"PAU D ARCO DO PIAUI (PI)";"PI";"PAU D ARCO DO PIAUI";4;0;2;6
2011;"PAULISTANA (PI)";"PI";"PAULISTANA";109;10;14;133
2011;"PAVUSSU (PI)";"PI";"PAVUSSU";3;2;0;5
2011;"PEDRO II (PI)";"PI";"PEDRO II";84;10;6;100
2011;"PEDRO LAURENTINO (PI)";"PI";"PEDRO LAURENTINO";2;0;0;2
2011;"PICOS (PI)";"PI";"PICOS";1473;113;71;1657
2011;"PIMENTEIRAS (PI)";"PI";"PIMENTEIRAS";31;7;2;40
2011;"PIO IX (PI)";"PI";"PIO IX";37;8;6;51
2011;"PIRACURUCA (PI)";"PI";"PIRACURUCA";180;12;33;225
2011;"PIRIPIRI (PI)";"PI";"PIRIPIRI";303;31;88;422
2011;"PORTO (PI)";"PI";"PORTO";5;5;1;11
2011;"PORTO ALEGRE DO PIAUI (PI)";"PI";"PORTO ALEGRE DO PIAUI";5;3;1;9
2011;"PRATA DO PIAUI (PI)";"PI";"PRATA DO PIAUI";7;1;1;9
2011;"QUEIMADA NOVA (PI)";"PI";"QUEIMADA NOVA";5;3;5;13
2011;"REDENCAO DO GURGUEIA (PI)";"PI";"REDENCAO DO GURGUEIA";9;0;9;18
2011;"REGENERACAO (PI)";"PI";"REGENERACAO";74;8;6;88
2011;"RIACHO FRIO (PI)";"PI";"RIACHO FRIO";2;1;2;5
2011;"RIBEIRA DO PIAUI (PI)";"PI";"RIBEIRA DO PIAUI";4;2;2;8
2011;"RIBEIRO GONCALVES (PI)";"PI";"RIBEIRO GONCALVES";17;0;1;18
2011;"RIO GRANDE DO PIAUI (PI)";"PI";"RIO GRANDE DO PIAUI";21;7;3;31
2011;"SANTA CRUZ DO PIAUI (PI)";"PI";"SANTA CRUZ DO PIAUI";15;11;1;27
2011;"SANTA CRUZ DOS MILAGRES (PI)";"PI";"SANTA CRUZ DOS MILAGRES";3;0;2;5
2011;"SANTA FILOMENA (PI)";"PI";"SANTA FILOMENA";8;0;2;10
2011;"SANTA LUZ (PI)";"PI";"SANTA LUZ";7;1;2;10
2011;"SANTA ROSA DO PIAUI (PI)";"PI";"SANTA ROSA DO PIAUI";6;5;8;19
2011;"SANTANA DO PIAUI (PI)";"PI";"SANTANA DO PIAUI";19;10;10;39
2011;"SANTO ANTONIO DE LISBOA (PI)";"PI";"SANTO ANTONIO DE LISBOA";32;9;4;45
2011;"SANTO ANTONIO DOS MILAGRES (PI)";"PI";"SANTO ANTONIO DOS MILAGRES";2;3;1;6
2011;"SANTO INACIO DO PIAUI (PI)";"PI";"SANTO INACIO DO PIAUI";3;3;0;6
2011;"SAO BRAZ DO PIAUI (PI)";"PI";"SAO BRAZ DO PIAUI";3;1;3;7
2011;"SAO FELIX DO PIAUI (PI)";"PI";"SAO FELIX DO PIAUI";5;2;1;8
2011;"SAO FRANCISCO DE ASSIS DO PIAU (PI)";"PI";"SAO FRANCISCO DE ASSIS DO PIAU";0;0;1;1
2011;"SAO FRANCISCO DO PIAUI (PI)";"PI";"SAO FRANCISCO DO PIAUI";6;4;4;14
2011;"SAO GONCALO DO GURGUEIA (PI)";"PI";"SAO GONCALO DO GURGUEIA";1;1;0;2
2011;"SAO GONCALO DO PIAUI (PI)";"PI";"SAO GONCALO DO PIAUI";10;4;4;18
2011;"SAO JOAO DA CANABRAVA (PI)";"PI";"SAO JOAO DA CANABRAVA";13;8;3;24
2011;"SAO JOAO DA FRONTEIRA (PI)";"PI";"SAO JOAO DA FRONTEIRA";2;1;5;8
2011;"SAO JOAO DA SERRA (PI)";"PI";"SAO JOAO DA SERRA";6;0;1;7
2011;"SAO JOAO DA VARJOTA (PI)";"PI";"SAO JOAO DA VARJOTA";1;4;2;7
2011;"SAO JOAO DO ARRAIAL (PI)";"PI";"SAO JOAO DO ARRAIAL";7;1;1;9
2011;"SAO JOAO DO PIAUI (PI)";"PI";"SAO JOAO DO PIAUI";81;10;11;102
2011;"SAO JOSE DO DIVINO (PI)";"PI";"SAO JOSE DO DIVINO";8;1;2;11
2011;"SAO JOSE DO PEIXE (PI)";"PI";"SAO JOSE DO PEIXE";1;2;1;4
2011;"SAO JOSE DO PIAUI (PI)";"PI";"SAO JOSE DO PIAUI";26;7;5;38
2011;"SAO JULIAO (PI)";"PI";"SAO JULIAO";12;9;3;24
2011;"SAO LOURENCO DO PIAUI (PI)";"PI";"SAO LOURENCO DO PIAUI";0;0;1;1
2011;"SAO LUIS DO PIAUI (PI)";"PI";"SAO LUIS DO PIAUI";7;3;1;11
2011;"SAO MIGUEL DA BAIXA GRANDE (PI)";"PI";"SAO MIGUEL DA BAIXA GRANDE";8;2;2;12
2011;"SAO MIGUEL DO FIDALGO (PI)";"PI";"SAO MIGUEL DO FIDALGO";1;1;2;4
2011;"SAO MIGUEL DO TAPUIO (PI)";"PI";"SAO MIGUEL DO TAPUIO";18;0;8;26
2011;"SAO PEDRO DO PIAUI (PI)";"PI";"SAO PEDRO DO PIAUI";30;1;4;35
2011;"SAO RAIMUNDO NONATO (PI)";"PI";"SAO RAIMUNDO NONATO";184;10;25;219
2011;"SEBASTIAO BARROS (PI)";"PI";"SEBASTIAO BARROS";1;2;0;3
2011;"SEBASTIAO LEAL (PI)";"PI";"SEBASTIAO LEAL";16;1;2;19
2011;"SIGEFREDO PACHECO (PI)";"PI";"SIGEFREDO PACHECO";26;4;1;31
2011;"SIMOES (PI)";"PI";"SIMOES";39;5;4;48
2011;"SIMPLICIO MENDES (PI)";"PI";"SIMPLICIO MENDES";47;7;6;60
2011;"SOCORRO DO PIAUI (PI)";"PI";"SOCORRO DO PIAUI";2;1;1;4
2011;"SUSSUAPARA (PI)";"PI";"SUSSUAPARA";21;16;4;41
2011;"TAMBORIL DO PIAUI (PI)";"PI";"TAMBORIL DO PIAUI";2;0;1;3
2011;"TANQUE DO PIAUI (PI)";"PI";"TANQUE DO PIAUI";5;2;3;10
2011;"TERESINA (PI)";"PI";"TERESINA";9596;881;2367;12844
2011;"UNIAO (PI)";"PI";"UNIAO";93;29;36;158
2011;"URUCUI (PI)";"PI";"URUCUI";116;7;9;132
2011;"VALENCA DO PIAUI (PI)";"PI";"VALENCA DO PIAUI";117;24;12;153
2011;"VARZEA BRANCA (PI)";"PI";"VARZEA BRANCA";4;0;6;10
2011;"VARZEA GRANDE (PI)";"PI";"VARZEA GRANDE";9;4;0;13
2011;"VERA MENDES (PI)";"PI";"VERA MENDES";6;5;0;11
2011;"VILA NOVA DO PIAUI (PI)";"PI";"VILA NOVA DO PIAUI";10;5;3;18
2011;"WALL FERRAZ (PI)";"PI";"WALL FERRAZ";9;7;4;20
2011;"ABATIA (PR)";"PR";"ABATIA";105;2;37;144
2011;"ADRIANOPOLIS (PR)";"PR";"ADRIANOPOLIS";131;6;15;152
2011;"AGUDOS DO SUL (PR)";"PR";"AGUDOS DO SUL";325;8;19;352
2011;"ALMIRANTE TAMANDARE (PR)";"PR";"ALMIRANTE TAMANDARE";1309;77;223;1609
2011;"ALTAMIRA DO PARANA (PR)";"PR";"ALTAMIRA DO PARANA";42;3;8;53
2011;"ALTO PARAISO (PR)";"PR";"ALTO PARAISO";41;5;10;56
2011;"ALTO PARANA (PR)";"PR";"ALTO PARANA";237;11;73;321
2011;"ALTO PIQUIRI (PR)";"PR";"ALTO PIQUIRI";180;5;37;222
2011;"ALTONIA (PR)";"PR";"ALTONIA";401;18;38;457
2011;"ALVORADA DO SUL (PR)";"PR";"ALVORADA DO SUL";260;8;48;316
2011;"AMAPORA (PR)";"PR";"AMAPORA";74;4;48;126
2011;"AMPERE (PR)";"PR";"AMPERE";421;10;30;461
2011;"ANAHY (PR)";"PR";"ANAHY";73;2;5;80
2011;"ANDIRA (PR)";"PR";"ANDIRA";512;17;79;608
2011;"ANGULO (PR)";"PR";"ANGULO";64;1;6;71
2011;"ANTONINA (PR)";"PR";"ANTONINA";94;13;27;134
2011;"ANTONIO OLINTO (PR)";"PR";"ANTONIO OLINTO";128;4;29;161
2011;"APUCARANA (PR)";"PR";"APUCARANA";2309;303;275;2887
2011;"ARAPONGAS (PR)";"PR";"ARAPONGAS";3157;196;96;3449
2011;"ARAPOTI (PR)";"PR";"ARAPOTI";490;30;55;575
2011;"ARAPUA (PR)";"PR";"ARAPUA";74;5;20;99
2011;"ARARUNA (PR)";"PR";"ARARUNA";353;12;29;394
2011;"ARAUCARIA (PR)";"PR";"ARAUCARIA";2795;337;697;3829
2011;"ARIRANHA DO IVAI (PR)";"PR";"ARIRANHA DO IVAI";44;2;13;59
2011;"ASSAI (PR)";"PR";"ASSAI";449;22;36;507
2011;"ASSIS CHATEAUBRIAND (PR)";"PR";"ASSIS CHATEAUBRIAND";1087;36;62;1185
2011;"ASTORGA (PR)";"PR";"ASTORGA";612;39;86;737
2011;"ATALAIA (PR)";"PR";"ATALAIA";93;12;23;128
2011;"BALSA NOVA (PR)";"PR";"BALSA NOVA";333;11;46;390
2011;"BANDEIRANTES (PR)";"PR";"BANDEIRANTES";770;40;97;907
2011;"BARBOSA FERRAZ (PR)";"PR";"BARBOSA FERRAZ";172;5;23;200
2011;"BARRA DO JACARE (PR)";"PR";"BARRA DO JACARE";40;7;7;54
2011;"BARRACAO (PR)";"PR";"BARRACAO";200;20;45;265
2011;"BELA VISTA DO CAROBA (PR)";"PR";"BELA VISTA DO CAROBA";55;2;14;71
2011;"BELA VISTA DO PARAISO (PR)";"PR";"BELA VISTA DO PARAISO";389;19;51;459
2011;"BITURUNA (PR)";"PR";"BITURUNA";394;22;108;524
2011;"BOA ESPERANCA (PR)";"PR";"BOA ESPERANCA";171;8;12;191
2011;"BOA ESPERANCA DO IGUACU (PR)";"PR";"BOA ESPERANCA DO IGUACU";58;3;8;69
2011;"BOA VENTURA DE SAO ROQUE (PR)";"PR";"BOA VENTURA DE SAO ROQUE";167;10;28;205
2011;"BOA VISTA DA APARECIDA (PR)";"PR";"BOA VISTA DA APARECIDA";152;7;21;180
2011;"BOCAIUVA DO SUL (PR)";"PR";"BOCAIUVA DO SUL";271;11;20;302
2011;"BOM JESUS DO SUL (PR)";"PR";"BOM JESUS DO SUL";47;4;9;60
2011;"BOM SUCESSO (PR)";"PR";"BOM SUCESSO";99;3;41;143
2011;"BOM SUCESSO DO SUL (PR)";"PR";"BOM SUCESSO DO SUL";97;9;6;112
2011;"BORRAZOPOLIS (PR)";"PR";"BORRAZOPOLIS";243;7;7;257
2011;"BRAGANEY (PR)";"PR";"BRAGANEY";150;6;19;175
2011;"BRASILANDIA DO SUL (PR)";"PR";"BRASILANDIA DO SUL";64;4;7;75
2011;"CAFEARA (PR)";"PR";"CAFEARA";33;6;13;52
2011;"CAFELANDIA (PR)";"PR";"CAFELANDIA";524;10;46;580
2011;"CAFEZAL DO SUL (PR)";"PR";"CAFEZAL DO SUL";85;1;27;113
2011;"CALIFORNIA (PR)";"PR";"CALIFORNIA";244;10;16;270
2011;"CAMBARA (PR)";"PR";"CAMBARA";779;27;78;884
2011;"CAMBE (PR)";"PR";"CAMBE";1770;213;144;2127
2011;"CAMBIRA (PR)";"PR";"CAMBIRA";240;3;21;264
2011;"CAMPINA DA LAGOA (PR)";"PR";"CAMPINA DA LAGOA";363;16;35;414
2011;"CAMPINA DO SIMAO (PR)";"PR";"CAMPINA DO SIMAO";73;4;21;98
2011;"CAMPINA GRANDE DO SUL (PR)";"PR";"CAMPINA GRANDE DO SUL";788;80;61;929
2011;"CAMPO BONITO (PR)";"PR";"CAMPO BONITO";92;8;9;109
2011;"CAMPO DO TENENTE (PR)";"PR";"CAMPO DO TENENTE";152;8;36;196
2011;"CAMPO LARGO (PR)";"PR";"CAMPO LARGO";2177;261;453;2891
2011;"CAMPO MAGRO (PR)";"PR";"CAMPO MAGRO";416;54;19;489
2011;"CAMPO MOURAO (PR)";"PR";"CAMPO MOURAO";2001;96;513;2610
2011;"CANDIDO DE ABREU (PR)";"PR";"CANDIDO DE ABREU";208;9;41;258
2011;"CANDOI (PR)";"PR";"CANDOI";344;10;95;449
2011;"CANTAGALO (PR)";"PR";"CANTAGALO";238;8;38;284
2011;"CAPANEMA (PR)";"PR";"CAPANEMA";420;12;47;479
2011;"CAPITAO LEONIDAS MARQUES (PR)";"PR";"CAPITAO LEONIDAS MARQUES";540;17;31;588
2011;"CARAMBEI (PR)";"PR";"CARAMBEI";570;33;52;655
2011;"CARLOPOLIS (PR)";"PR";"CARLOPOLIS";263;17;44;324
2011;"CASCAVEL (PR)";"PR";"CASCAVEL";7426;347;855;8628
2011;"CASTRO (PR)";"PR";"CASTRO";1662;164;234;2060
2011;"CATANDUVAS (PR)";"PR";"CATANDUVAS";191;10;28;229
2011;"CENTENARIO DO SUL (PR)";"PR";"CENTENARIO DO SUL";113;27;57;197
2011;"CERRO AZUL (PR)";"PR";"CERRO AZUL";399;15;48;462
2011;"CEU AZUL (PR)";"PR";"CEU AZUL";319;13;47;379
2011;"CHOPINZINHO (PR)";"PR";"CHOPINZINHO";528;21;66;615
2011;"CIANORTE (PR)";"PR";"CIANORTE";1523;70;187;1780
2011;"CIDADE GAUCHA (PR)";"PR";"CIDADE GAUCHA";265;15;69;349
2011;"CLEVELANDIA (PR)";"PR";"CLEVELANDIA";517;33;42;592
2011;"COLOMBO (PR)";"PR";"COLOMBO";4089;272;489;4850
2011;"COLORADO (PR)";"PR";"COLORADO";568;36;98;702
2011;"CONGONHINHAS (PR)";"PR";"CONGONHINHAS";116;6;30;152
2011;"CONSELHEIRO MAIRINCK (PR)";"PR";"CONSELHEIRO MAIRINCK";44;3;7;54
2011;"CONTENDA (PR)";"PR";"CONTENDA";677;17;48;742
2011;"CORBELIA (PR)";"PR";"CORBELIA";711;24;40;775
2011;"CORNELIO PROCOPIO (PR)";"PR";"CORNELIO PROCOPIO";1022;105;111;1238
2011;"CORONEL DOMINGOS SOARES (PR)";"PR";"CORONEL DOMINGOS SOARES";120;7;24;151
2011;"CORONEL VIVIDA (PR)";"PR";"CORONEL VIVIDA";659;18;98;775
2011;"CORUMBATAI DO SUL (PR)";"PR";"CORUMBATAI DO SUL";56;2;21;79
2011;"CRUZ MACHADO (PR)";"PR";"CRUZ MACHADO";465;14;67;546
2011;"CRUZEIRO DO IGUACU (PR)";"PR";"CRUZEIRO DO IGUACU";67;2;13;82
2011;"CRUZEIRO DO OESTE (PR)";"PR";"CRUZEIRO DO OESTE";449;16;63;528
2011;"CRUZEIRO DO SUL (PR)";"PR";"CRUZEIRO DO SUL";69;7;17;93
2011;"CRUZMALTINA (PR)";"PR";"CRUZMALTINA";78;3;8;89
2011;"CURITIBA (PR)";"PR";"CURITIBA";39041;3672;7584;50297
2011;"CURIUVA (PR)";"PR";"CURIUVA";219;21;77;317
2011;"DIAMANTE D OESTE (PR)";"PR";"DIAMANTE D OESTE";71;5;19;95
2011;"DIAMANTE DO NORTE (PR)";"PR";"DIAMANTE DO NORTE";63;4;22;89
2011;"DIAMANTE DO SUL (PR)";"PR";"DIAMANTE DO SUL";37;2;6;45
2011;"DOIS VIZINHOS (PR)";"PR";"DOIS VIZINHOS";974;51;89;1114
2011;"DOURADINA (PR)";"PR";"DOURADINA";355;8;10;373
2011;"DOUTOR CAMARGO (PR)";"PR";"DOUTOR CAMARGO";159;3;46;208
2011;"DOUTOR ULYSSES (PR)";"PR";"DOUTOR ULYSSES";43;1;16;60
2011;"ENEAS MARQUES (PR)";"PR";"ENEAS MARQUES";154;9;19;182
2011;"ENGENHEIRO BELTRAO (PR)";"PR";"ENGENHEIRO BELTRAO";450;12;86;548
2011;"ENTRE RIOS DO OESTE (PR)";"PR";"ENTRE RIOS DO OESTE";122;4;5;131
2011;"ESPERANCA NOVA (PR)";"PR";"ESPERANCA NOVA";24;3;3;30
2011;"ESPIGAO ALTO DO IGUACU (PR)";"PR";"ESPIGAO ALTO DO IGUACU";64;6;8;78
2011;"FAROL (PR)";"PR";"FAROL";84;1;8;93
2011;"FAXINAL (PR)";"PR";"FAXINAL";377;14;38;429
2011;"FAZENDA RIO GRANDE (PR)";"PR";"FAZENDA RIO GRANDE";977;63;209;1249
2011;"FENIX (PR)";"PR";"FENIX";92;2;11;105
2011;"FERNANDES PINHEIRO (PR)";"PR";"FERNANDES PINHEIRO";101;3;22;126
2011;"FIGUEIRA (PR)";"PR";"FIGUEIRA";133;9;29;171
2011;"FLOR DA SERRA DO SUL (PR)";"PR";"FLOR DA SERRA DO SUL";91;3;21;115
2011;"FLORAI (PR)";"PR";"FLORAI";131;7;23;161
2011;"FLORESTA (PR)";"PR";"FLORESTA";233;10;22;265
2011;"FLORESTOPOLIS (PR)";"PR";"FLORESTOPOLIS";178;13;94;285
2011;"FLORIDA (PR)";"PR";"FLORIDA";56;9;15;80
2011;"FORMOSA DO OESTE (PR)";"PR";"FORMOSA DO OESTE";200;17;17;234
2011;"FOZ DO IGUACU (PR)";"PR";"FOZ DO IGUACU";3201;965;986;5152
2011;"FOZ DO JORDAO (PR)";"PR";"FOZ DO JORDAO";75;3;12;90
2011;"FRANCISCO ALVES (PR)";"PR";"FRANCISCO ALVES";153;3;21;177
2011;"FRANCISCO BELTRAO (PR)";"PR";"FRANCISCO BELTRAO";1901;115;200;2216
2011;"GENERAL CARNEIRO (PR)";"PR";"GENERAL CARNEIRO";382;15;57;454
2011;"GODOY MOREIRA (PR)";"PR";"GODOY MOREIRA";52;3;9;64
2011;"GOIOERE (PR)";"PR";"GOIOERE";667;32;56;755
2011;"GOIOXIM (PR)";"PR";"GOIOXIM";94;13;24;131
2011;"GRANDES RIOS (PR)";"PR";"GRANDES RIOS";88;10;9;107
2011;"GUAIRA (PR)";"PR";"GUAIRA";1080;37;87;1204
2011;"GUAIRACA (PR)";"PR";"GUAIRACA";129;3;29;161
2011;"GUAMIRANGA (PR)";"PR";"GUAMIRANGA";148;8;24;180
2011;"GUAPIRAMA (PR)";"PR";"GUAPIRAMA";108;3;19;130
2011;"GUAPOREMA (PR)";"PR";"GUAPOREMA";51;2;7;60
2011;"GUARACI (PR)";"PR";"GUARACI";96;3;28;127
2011;"GUARANIACU (PR)";"PR";"GUARANIACU";403;31;53;487
2011;"GUARAPUAVA (PR)";"PR";"GUARAPUAVA";4218;411;428;5057
2011;"GUARAQUECABA (PR)";"PR";"GUARAQUECABA";23;2;8;33
2011;"GUARATUBA (PR)";"PR";"GUARATUBA";315;24;47;386
2011;"HONORIO SERPA (PR)";"PR";"HONORIO SERPA";105;6;30;141
2011;"IBAITI (PR)";"PR";"IBAITI";528;33;161;722
2011;"IBEMA (PR)";"PR";"IBEMA";147;6;12;165
2011;"IBIPORA (PR)";"PR";"IBIPORA";955;42;129;1126
2011;"ICARAIMA (PR)";"PR";"ICARAIMA";115;5;24;144
2011;"IGUARACU (PR)";"PR";"IGUARACU";69;7;10;86
2011;"IGUATU (PR)";"PR";"IGUATU";35;1;6;42
2011;"IMBAU (PR)";"PR";"IMBAU";193;21;26;240
2011;"IMBITUVA (PR)";"PR";"IMBITUVA";687;25;51;763
2011;"INACIO MARTINS (PR)";"PR";"INACIO MARTINS";253;25;29;307
2011;"INAJA (PR)";"PR";"INAJA";31;3;20;54
2011;"INDIANOPOLIS (PR)";"PR";"INDIANOPOLIS";165;2;7;174
2011;"IPIRANGA (PR)";"PR";"IPIRANGA";314;28;42;384
2011;"IPORA (PR)";"PR";"IPORA";349;14;36;399
2011;"IRACEMA DO OESTE (PR)";"PR";"IRACEMA DO OESTE";68;5;4;77
2011;"IRATI (PR)";"PR";"IRATI";1416;81;126;1623
2011;"IRETAMA (PR)";"PR";"IRETAMA";169;2;29;200
2011;"ITAGUAJE (PR)";"PR";"ITAGUAJE";65;8;22;95
2011;"ITAIPULANDIA (PR)";"PR";"ITAIPULANDIA";193;20;28;241
2011;"ITAMBARACA (PR)";"PR";"ITAMBARACA";139;8;25;172
2011;"ITAMBE (PR)";"PR";"ITAMBE";174;5;25;204
2011;"ITAPEJARA D OESTE (PR)";"PR";"ITAPEJARA D OESTE";278;6;26;310
2011;"ITAPERUCU (PR)";"PR";"ITAPERUCU";582;51;54;687
2011;"ITAUNA DO SUL (PR)";"PR";"ITAUNA DO SUL";43;3;6;52
2011;"IVAI (PR)";"PR";"IVAI";320;7;33;360
2011;"IVAIPORA (PR)";"PR";"IVAIPORA";789;31;93;913
2011;"IVATE (PR)";"PR";"IVATE";191;11;55;257
2011;"IVATUBA (PR)";"PR";"IVATUBA";54;3;7;64
2011;"JABOTI (PR)";"PR";"JABOTI";77;4;10;91
2011;"JACAREZINHO (PR)";"PR";"JACAREZINHO";544;78;128;750
2011;"JAGUAPITA (PR)";"PR";"JAGUAPITA";321;17;50;388
2011;"JAGUARIAIVA (PR)";"PR";"JAGUARIAIVA";698;50;99;847
2011;"JANDAIA DO SUL (PR)";"PR";"JANDAIA DO SUL";575;29;97;701
2011;"JANIOPOLIS (PR)";"PR";"JANIOPOLIS";126;4;20;150
2011;"JAPIRA (PR)";"PR";"JAPIRA";44;1;10;55
2011;"JAPURA (PR)";"PR";"JAPURA";232;6;17;255
2011;"JARDIM ALEGRE (PR)";"PR";"JARDIM ALEGRE";193;9;23;225
2011;"JARDIM OLINDA (PR)";"PR";"JARDIM OLINDA";37;2;5;44
2011;"JATAIZINHO (PR)";"PR";"JATAIZINHO";317;25;23;365
2011;"JESUITAS (PR)";"PR";"JESUITAS";251;9;23;283
2011;"JOAQUIM TAVORA (PR)";"PR";"JOAQUIM TAVORA";219;11;21;251
2011;"JUNDIAI DO SUL (PR)";"PR";"JUNDIAI DO SUL";28;3;16;47
2011;"JURANDA (PR)";"PR";"JURANDA";291;3;12;306
2011;"JUSSARA (PR)";"PR";"JUSSARA";153;5;26;184
2011;"KALORE (PR)";"PR";"KALORE";136;10;18;164
2011;"LAPA (PR)";"PR";"LAPA";1173;99;155;1427
2011;"LARANJAL (PR)";"PR";"LARANJAL";49;4;16;69
2011;"LARANJEIRAS DO SUL (PR)";"PR";"LARANJEIRAS DO SUL";680;28;69;777
2011;"LEOPOLIS (PR)";"PR";"LEOPOLIS";74;5;5;84
2011;"LIDIANOPOLIS (PR)";"PR";"LIDIANOPOLIS";75;6;20;101
2011;"LINDOESTE (PR)";"PR";"LINDOESTE";87;7;19;113
2011;"LOANDA (PR)";"PR";"LOANDA";410;13;56;479
2011;"LOBATO (PR)";"PR";"LOBATO";170;4;30;204
2011;"LONDRINA (PR)";"PR";"LONDRINA";8720;770;2083;11573
2011;"LUIZIANA (PR)";"PR";"LUIZIANA";147;5;13;165
2011;"LUNARDELLI (PR)";"PR";"LUNARDELLI";83;8;7;98
2011;"LUPIONOPOLIS (PR)";"PR";"LUPIONOPOLIS";97;27;99;223
2011;"MALLET (PR)";"PR";"MALLET";323;12;33;368
2011;"MAMBORE (PR)";"PR";"MAMBORE";524;6;32;562
2011;"MANDAGUACU (PR)";"PR";"MANDAGUACU";402;12;47;461
2011;"MANDAGUARI (PR)";"PR";"MANDAGUARI";700;39;55;794
2011;"MANDIRITUBA (PR)";"PR";"MANDIRITUBA";970;23;60;1053
2011;"MANFRINOPOLIS (PR)";"PR";"MANFRINOPOLIS";33;5;17;55
2011;"MANGUEIRINHA (PR)";"PR";"MANGUEIRINHA";457;24;58;539
2011;"MANOEL RIBAS (PR)";"PR";"MANOEL RIBAS";300;11;28;339
2011;"MARECHAL CANDIDO RONDON (PR)";"PR";"MARECHAL CANDIDO RONDON";1369;60;142;1571
2011;"MARIA HELENA (PR)";"PR";"MARIA HELENA";104;4;25;133
2011;"MARIALVA (PR)";"PR";"MARIALVA";823;43;73;939
2011;"MARILANDIA DO SUL (PR)";"PR";"MARILANDIA DO SUL";230;11;25;266
2011;"MARILENA (PR)";"PR";"MARILENA";108;9;33;150
2011;"MARILUZ (PR)";"PR";"MARILUZ";173;11;64;248
2011;"MARINGA (PR)";"PR";"MARINGA";8667;490;904;10061
2011;"MARIOPOLIS (PR)";"PR";"MARIOPOLIS";206;13;32;251
2011;"MARIPA (PR)";"PR";"MARIPA";299;10;11;320
2011;"MARMELEIRO (PR)";"PR";"MARMELEIRO";323;12;46;381
2011;"MARQUINHO (PR)";"PR";"MARQUINHO";59;8;12;79
2011;"MARUMBI (PR)";"PR";"MARUMBI";88;3;13;104
2011;"MATELANDIA (PR)";"PR";"MATELANDIA";475;6;44;525
2011;"MATINHOS (PR)";"PR";"MATINHOS";276;27;23;326
2011;"MATO RICO (PR)";"PR";"MATO RICO";42;3;8;53
2011;"MAUA DA SERRA (PR)";"PR";"MAUA DA SERRA";189;7;23;219
2011;"MEDIANEIRA (PR)";"PR";"MEDIANEIRA";1143;47;87;1277
2011;"MERCEDES (PR)";"PR";"MERCEDES";215;9;26;250
2011;"MIRADOR (PR)";"PR";"MIRADOR";12;1;9;22
2011;"MIRASELVA (PR)";"PR";"MIRASELVA";37;4;22;63
2011;"MISSAL (PR)";"PR";"MISSAL";339;22;28;389
2011;"MOREIRA SALES (PR)";"PR";"MOREIRA SALES";165;9;62;236
2011;"MORRETES (PR)";"PR";"MORRETES";186;18;36;240
2011;"MUNHOZ DE MELLO (PR)";"PR";"MUNHOZ DE MELLO";61;6;7;74
2011;"NOSSA SENHORA DAS GRACAS (PR)";"PR";"NOSSA SENHORA DAS GRACAS";29;7;28;64
2011;"NOVA ALIANCA DO IVAI (PR)";"PR";"NOVA ALIANCA DO IVAI";17;8;4;29
2011;"NOVA AMERICA DA COLINA (PR)";"PR";"NOVA AMERICA DA COLINA";112;5;12;129
2011;"NOVA AURORA (PR)";"PR";"NOVA AURORA";396;10;35;441
2011;"NOVA CANTU (PR)";"PR";"NOVA CANTU";103;0;19;122
2011;"NOVA ESPERANCA (PR)";"PR";"NOVA ESPERANCA";770;30;65;865
2011;"NOVA ESPERANCA DO SUDOESTE (PR)";"PR";"NOVA ESPERANCA DO SUDOESTE";99;13;19;131
2011;"NOVA FATIMA (PR)";"PR";"NOVA FATIMA";233;2;34;269
2011;"NOVA LARANJEIRAS (PR)";"PR";"NOVA LARANJEIRAS";147;3;24;174
2011;"NOVA LONDRINA (PR)";"PR";"NOVA LONDRINA";387;15;39;441
2011;"NOVA OLIMPIA (PR)";"PR";"NOVA OLIMPIA";89;3;15;107
2011;"NOVA PRATA DO IGUACU (PR)";"PR";"NOVA PRATA DO IGUACU";209;5;24;238
2011;"NOVA SANTA BARBARA (PR)";"PR";"NOVA SANTA BARBARA";124;8;7;139
2011;"NOVA SANTA ROSA (PR)";"PR";"NOVA SANTA ROSA";320;10;17;347
2011;"NOVA TEBAS (PR)";"PR";"NOVA TEBAS";100;5;11;116
2011;"NOVO ITACOLOMI (PR)";"PR";"NOVO ITACOLOMI";80;1;6;87
2011;"ORTIGUEIRA (PR)";"PR";"ORTIGUEIRA";330;24;72;426
2011;"OURIZONA (PR)";"PR";"OURIZONA";80;4;16;100
2011;"OURO VERDE DO OESTE (PR)";"PR";"OURO VERDE DO OESTE";146;1;13;160
2011;"PAICANDU (PR)";"PR";"PAICANDU";432;26;59;517
2011;"PALMAS (PR)";"PR";"PALMAS";840;57;79;976
2011;"PALMEIRA (PR)";"PR";"PALMEIRA";859;38;70;967
2011;"PALMITAL (PR)";"PR";"PALMITAL";236;9;48;293
2011;"PALOTINA (PR)";"PR";"PALOTINA";1136;28;103;1267
2011;"PARAISO DO NORTE (PR)";"PR";"PARAISO DO NORTE";235;12;50;297
2011;"PARANACITY (PR)";"PR";"PARANACITY";220;15;45;280
2011;"PARANAGUA (PR)";"PR";"PARANAGUA";1602;154;144;1900
2011;"PARANAPOEMA (PR)";"PR";"PARANAPOEMA";66;5;16;87
2011;"PARANAVAI (PR)";"PR";"PARANAVAI";1872;101;198;2171
2011;"PATO BRAGADO (PR)";"PR";"PATO BRAGADO";131;4;12;147
2011;"PATO BRANCO (PR)";"PR";"PATO BRANCO";1982;132;369;2483
2011;"PAULA FREITAS (PR)";"PR";"PAULA FREITAS";132;2;17;151
2011;"PAULO FRONTIN (PR)";"PR";"PAULO FRONTIN";181;1;13;195
2011;"PEABIRU (PR)";"PR";"PEABIRU";276;14;25;315
2011;"PEROBAL (PR)";"PR";"PEROBAL";93;3;28;124
2011;"PEROLA (PR)";"PR";"PEROLA";203;11;12;226
2011;"PEROLA D OESTE (PR)";"PR";"PEROLA D OESTE";158;4;21;183
2011;"PIEN (PR)";"PR";"PIEN";384;19;17;420
2011;"PINHAIS (PR)";"PR";"PINHAIS";2151;190;429;2770
2011;"PINHAL DO SAO BENTO (PR)";"PR";"PINHAL DO SAO BENTO";37;3;9;49
2011;"PINHALAO (PR)";"PR";"PINHALAO";94;7;14;115
2011;"PINHAO (PR)";"PR";"PINHAO";461;29;91;581
2011;"PIRAI DO SUL (PR)";"PR";"PIRAI DO SUL";431;26;87;544
2011;"PIRAQUARA (PR)";"PR";"PIRAQUARA";550;64;186;800
2011;"PITANGA (PR)";"PR";"PITANGA";733;27;100;860
2011;"PITANGUEIRAS (PR)";"PR";"PITANGUEIRAS";55;5;26;86
2011;"PLANALTINA DO PARANA (PR)";"PR";"PLANALTINA DO PARANA";105;5;15;125
2011;"PLANALTO (PR)";"PR";"PLANALTO";282;15;28;325
2011;"PONTA GROSSA (PR)";"PR";"PONTA GROSSA";5853;567;1036;7456
2011;"PONTAL DO PARANA (PR)";"PR";"PONTAL DO PARANA";224;10;44;278
2011;"PORECATU (PR)";"PR";"PORECATU";289;30;127;446
2011;"PORTO AMAZONAS (PR)";"PR";"PORTO AMAZONAS";80;8;11;99
2011;"PORTO BARREIRO (PR)";"PR";"PORTO BARREIRO";55;4;17;76
2011;"PORTO RICO (PR)";"PR";"PORTO RICO";21;0;6;27
2011;"PORTO VITORIA (PR)";"PR";"PORTO VITORIA";154;3;10;167
2011;"PRADO FERREIRA (PR)";"PR";"PRADO FERREIRA";79;3;14;96
2011;"PRANCHITA (PR)";"PR";"PRANCHITA";225;5;12;242
2011;"PRESIDENTE CASTELO BRANCO (PR)";"PR";"PRESIDENTE CASTELO BRANCO";91;4;24;119
2011;"PRIMEIRO DE MAIO (PR)";"PR";"PRIMEIRO DE MAIO";296;11;23;330
2011;"PRUDENTOPOLIS (PR)";"PR";"PRUDENTOPOLIS";1152;36;102;1290
2011;"QUARTO CENTENARIO (PR)";"PR";"QUARTO CENTENARIO";130;7;6;143
2011;"QUATIGUA (PR)";"PR";"QUATIGUA";357;8;17;382
2011;"QUATRO BARRAS (PR)";"PR";"QUATRO BARRAS";563;44;135;742
2011;"QUATRO PONTES (PR)";"PR";"QUATRO PONTES";164;3;4;171
2011;"QUEDAS DO IGUACU (PR)";"PR";"QUEDAS DO IGUACU";645;26;124;795
2011;"QUERENCIA DO NORTE (PR)";"PR";"QUERENCIA DO NORTE";192;5;26;223
2011;"QUINTA DO SOL (PR)";"PR";"QUINTA DO SOL";107;2;18;127
2011;"QUITANDINHA (PR)";"PR";"QUITANDINHA";496;6;58;560
2011;"RAMILANDIA (PR)";"PR";"RAMILANDIA";51;2;13;66
2011;"RANCHO ALEGRE (PR)";"PR";"RANCHO ALEGRE";105;3;13;121
2011;"RANCHO ALEGRE D OESTE (PR)";"PR";"RANCHO ALEGRE D OESTE";81;2;9;92
2011;"REALEZA (PR)";"PR";"REALEZA";522;17;36;575
2011;"REBOUCAS (PR)";"PR";"REBOUCAS";251;11;39;301
2011;"RENASCENCA (PR)";"PR";"RENASCENCA";203;7;28;238
2011;"RESERVA (PR)";"PR";"RESERVA";551;20;62;633
2011;"RESERVA DO IGUACU (PR)";"PR";"RESERVA DO IGUACU";70;10;20;100
2011;"RIBEIRAO CLARO (PR)";"PR";"RIBEIRAO CLARO";190;27;26;243
2011;"RIBEIRAO DO PINHAL (PR)";"PR";"RIBEIRAO DO PINHAL";200;30;35;265
2011;"RIO AZUL (PR)";"PR";"RIO AZUL";239;8;49;296
2011;"RIO BOM (PR)";"PR";"RIO BOM";68;5;7;80
2011;"RIO BONITO DO IGUACU (PR)";"PR";"RIO BONITO DO IGUACU";224;8;62;294
2011;"RIO BRANCO DO IVAI (PR)";"PR";"RIO BRANCO DO IVAI";41;3;11;55
2011;"RIO BRANCO DO SUL (PR)";"PR";"RIO BRANCO DO SUL";671;79;100;850
2011;"RIO NEGRO (PR)";"PR";"RIO NEGRO";851;70;55;976
2011;"ROLANDIA (PR)";"PR";"ROLANDIA";1610;91;110;1811
2011;"RONCADOR (PR)";"PR";"RONCADOR";287;4;30;321
2011;"RONDON (PR)";"PR";"RONDON";271;9;49;329
2011;"ROSARIO DO IVAI (PR)";"PR";"ROSARIO DO IVAI";72;6;19;97
2011;"SABAUDIA (PR)";"PR";"SABAUDIA";166;9;16;191
2011;"SALGADO FILHO (PR)";"PR";"SALGADO FILHO";74;6;22;102
2011;"SALTO DO ITARARE (PR)";"PR";"SALTO DO ITARARE";95;5;14;114
2011;"SALTO DO LONTRA (PR)";"PR";"SALTO DO LONTRA";243;9;25;277
2011;"SANTA AMELIA (PR)";"PR";"SANTA AMELIA";86;4;16;106
2011;"SANTA CECILIA DO PAVAO (PR)";"PR";"SANTA CECILIA DO PAVAO";74;7;9;90
2011;"SANTA CRUZ DO MONTE CASTELO (PR)";"PR";"SANTA CRUZ DO MONTE CASTELO";194;7;34;235
2011;"SANTA FE (PR)";"PR";"SANTA FE";225;6;27;258
2011;"SANTA HELENA (PR)";"PR";"SANTA HELENA";583;41;102;726
2011;"SANTA INES (PR)";"PR";"SANTA INES";14;3;7;24
2011;"SANTA ISABEL DO IVAI (PR)";"PR";"SANTA ISABEL DO IVAI";168;10;33;211
2011;"SANTA IZABEL DO OESTE (PR)";"PR";"SANTA IZABEL DO OESTE";197;15;29;241
2011;"SANTA LUCIA (PR)";"PR";"SANTA LUCIA";93;1;9;103
2011;"SANTA MARIA DO OESTE (PR)";"PR";"SANTA MARIA DO OESTE";191;8;22;221
2011;"SANTA MARIANA (PR)";"PR";"SANTA MARIANA";262;17;44;323
2011;"SANTA MONICA (PR)";"PR";"SANTA MONICA";45;3;10;58
2011;"SANTA TEREZA DO OESTE (PR)";"PR";"SANTA TEREZA DO OESTE";200;12;34;246
2011;"SANTA TEREZINHA DE ITAIPU (PR)";"PR";"SANTA TEREZINHA DE ITAIPU";435;38;47;520
2011;"SANTANA DO ITARARE (PR)";"PR";"SANTANA DO ITARARE";87;3;15;105
2011;"SANTO ANTONIO DA PLATINA (PR)";"PR";"SANTO ANTONIO DA PLATINA";637;55;215;907
2011;"SANTO ANTONIO DO CAIUA (PR)";"PR";"SANTO ANTONIO DO CAIUA";19;2;11;32
2011;"SANTO ANTONIO DO PARAISO (PR)";"PR";"SANTO ANTONIO DO PARAISO";74;3;8;85
2011;"SANTO ANTONIO DO SUDOESTE (PR)";"PR";"SANTO ANTONIO DO SUDOESTE";344;14;40;398
2011;"SANTO INACIO (PR)";"PR";"SANTO INACIO";81;6;17;104
2011;"SAO CARLOS DO IVAI (PR)";"PR";"SAO CARLOS DO IVAI";221;8;25;254
2011;"SAO JERONIMO DA SERRA (PR)";"PR";"SAO JERONIMO DA SERRA";145;4;20;169
2011;"SAO JOAO (PR)";"PR";"SAO JOAO";320;13;36;369
2011;"SAO JOAO DO CAIUA (PR)";"PR";"SAO JOAO DO CAIUA";64;1;29;94
2011;"SAO JOAO DO IVAI (PR)";"PR";"SAO JOAO DO IVAI";301;10;28;339
2011;"SAO JOAO DO TRIUNFO (PR)";"PR";"SAO JOAO DO TRIUNFO";213;10;32;255
2011;"SAO JORGE D OESTE (PR)";"PR";"SAO JORGE D OESTE";192;11;31;234
2011;"SAO JORGE DO IVAI (PR)";"PR";"SAO JORGE DO IVAI";252;4;16;272
2011;"SAO JORGE DO PATROCINIO (PR)";"PR";"SAO JORGE DO PATROCINIO";123;5;12;140
2011;"SAO JOSE DA BOA VISTA (PR)";"PR";"SAO JOSE DA BOA VISTA";87;5;16;108
2011;"SAO JOSE DAS PALMEIRAS (PR)";"PR";"SAO JOSE DAS PALMEIRAS";67;9;26;102
2011;"SAO JOSE DOS PINHAIS (PR)";"PR";"SAO JOSE DOS PINHAIS";6790;690;769;8249
2011;"SAO MANOEL DO PARANA (PR)";"PR";"SAO MANOEL DO PARANA";38;3;10;51
2011;"SAO MATEUS DO SUL (PR)";"PR";"SAO MATEUS DO SUL";886;76;141;1103
2011;"SAO MIGUEL DO IGUACU (PR)";"PR";"SAO MIGUEL DO IGUACU";794;28;74;896
2011;"SAO PEDRO DO IGUACU (PR)";"PR";"SAO PEDRO DO IGUACU";160;11;26;197
2011;"SAO PEDRO DO IVAI (PR)";"PR";"SAO PEDRO DO IVAI";308;7;45;360
2011;"SAO PEDRO DO PARANA (PR)";"PR";"SAO PEDRO DO PARANA";27;3;4;34
2011;"SAO SEBASTIAO DA AMOREIRA (PR)";"PR";"SAO SEBASTIAO DA AMOREIRA";168;7;32;207
2011;"SAO TOME (PR)";"PR";"SAO TOME";125;10;27;162
2011;"SAPOPEMA (PR)";"PR";"SAPOPEMA";101;4;12;117
2011;"SARANDI (PR)";"PR";"SARANDI";920;60;119;1099
2011;"SAUDADE DO IGUACU (PR)";"PR";"SAUDADE DO IGUACU";72;12;18;102
2011;"SENGES (PR)";"PR";"SENGES";457;29;62;548
2011;"SERRANOPOLIS DO IGUACU (PR)";"PR";"SERRANOPOLIS DO IGUACU";140;12;9;161
2011;"SERTANEJA (PR)";"PR";"SERTANEJA";199;10;23;232
2011;"SERTANOPOLIS (PR)";"PR";"SERTANOPOLIS";550;10;49;609
2011;"SIQUEIRA CAMPOS (PR)";"PR";"SIQUEIRA CAMPOS";340;14;42;396
2011;"SULINA (PR)";"PR";"SULINA";81;4;8;93
2011;"TAMARANA (PR)";"PR";"TAMARANA";258;9;30;297
2011;"TAMBOARA (PR)";"PR";"TAMBOARA";74;7;12;93
2011;"TAPEJARA (PR)";"PR";"TAPEJARA";355;11;94;460
2011;"TAPIRA (PR)";"PR";"TAPIRA";144;5;25;174
2011;"TEIXEIRA SOARES (PR)";"PR";"TEIXEIRA SOARES";204;10;70;284
2011;"TELEMACO BORBA (PR)";"PR";"TELEMACO BORBA";991;198;217;1406
2011;"TERRA BOA (PR)";"PR";"TERRA BOA";295;14;70;379
2011;"TERRA RICA (PR)";"PR";"TERRA RICA";338;11;67;416
2011;"TERRA ROXA (PR)";"PR";"TERRA ROXA";472;13;40;525
2011;"TIBAGI (PR)";"PR";"TIBAGI";309;27;47;383
2011;"TIJUCAS DO SUL (PR)";"PR";"TIJUCAS DO SUL";423;10;34;467
2011;"TOLEDO (PR)";"PR";"TOLEDO";2759;195;251;3205
2011;"TOMAZINA (PR)";"PR";"TOMAZINA";96;8;17;121
2011;"TRES BARRAS DO PARANA (PR)";"PR";"TRES BARRAS DO PARANA";288;5;22;315
2011;"TUNAS DO PARANA (PR)";"PR";"TUNAS DO PARANA";83;11;29;123
2011;"TUNEIRAS DO OESTE (PR)";"PR";"TUNEIRAS DO OESTE";120;7;30;157
2011;"TUPASSI (PR)";"PR";"TUPASSI";321;12;35;368
2011;"TURVO (PR)";"PR";"TURVO";412;14;50;476
2011;"UBIRATA (PR)";"PR";"UBIRATA";668;25;45;738
2011;"UMUARAMA (PR)";"PR";"UMUARAMA";2433;69;264;2766
2011;"UNIAO DA VITORIA (PR)";"PR";"UNIAO DA VITORIA";1364;51;69;1484
2011;"UNIFLOR (PR)";"PR";"UNIFLOR";34;7;10;51
2011;"URAI (PR)";"PR";"URAI";275;20;21;316
2011;"VENTANIA (PR)";"PR";"VENTANIA";167;20;31;218
2011;"VERA CRUZ DO OESTE (PR)";"PR";"VERA CRUZ DO OESTE";236;6;10;252
2011;"VERE (PR)";"PR";"VERE";195;12;22;229
2011;"VIRMOND (PR)";"PR";"VIRMOND";105;1;12;118
2011;"VITORINO (PR)";"PR";"VITORINO";200;5;20;225
2011;"WENCESLAU BRAZ (PR)";"PR";"WENCESLAU BRAZ";383;23;76;482
2011;"XAMBRE (PR)";"PR";"XAMBRE";138;7;11;156
2011;"ANGRA DOS REIS (RJ)";"RJ";"ANGRA DOS REIS";995;180;289;1464
2011;"APERIBE (RJ)";"RJ";"APERIBE";103;14;8;125
2011;"ARARUAMA (RJ)";"RJ";"ARARUAMA";1692;282;97;2071
2011;"AREAL (RJ)";"RJ";"AREAL";139;32;33;204
2011;"ARMACAO DE BUZIOS (RJ)";"RJ";"ARMACAO DE BUZIOS";271;296;38;605
2011;"ARRAIAL DO CABO (RJ)";"RJ";"ARRAIAL DO CABO";110;43;12;165
2011;"BARRA DO PIRAI (RJ)";"RJ";"BARRA DO PIRAI";1441;165;235;1841
2011;"BARRA MANSA (RJ)";"RJ";"BARRA MANSA";1939;160;572;2671
2011;"BELFORD ROXO (RJ)";"RJ";"BELFORD ROXO";1442;297;788;2527
2011;"BOM JARDIM (RJ)";"RJ";"BOM JARDIM";534;31;33;598
2011;"BOM JESUS DO ITABAPOANA (RJ)";"RJ";"BOM JESUS DO ITABAPOANA";336;56;50;442
2011;"CABO FRIO (RJ)";"RJ";"CABO FRIO";3381;319;429;4129
2011;"CACHOEIRAS DE MACACU (RJ)";"RJ";"CACHOEIRAS DE MACACU";821;140;42;1003
2011;"CAMBUCI (RJ)";"RJ";"CAMBUCI";88;18;15;121
2011;"CAMPOS DOS GOYTACAZES (RJ)";"RJ";"CAMPOS DOS GOYTACAZES";6185;857;1181;8223
2011;"CANTAGALO (RJ)";"RJ";"CANTAGALO";171;27;37;235
2011;"CARAPEBUS (RJ)";"RJ";"CARAPEBUS";79;22;5;106
2011;"CARDOSO MOREIRA (RJ)";"RJ";"CARDOSO MOREIRA";155;19;29;203
2011;"CARMO (RJ)";"RJ";"CARMO";110;19;31;160
2011;"CASIMIRO DE ABREU (RJ)";"RJ";"CASIMIRO DE ABREU";482;91;42;615
2011;"COMENDADOR LEVY GASPARIAN (RJ)";"RJ";"COMENDADOR LEVY GASPARIAN";123;30;17;170
2011;"CONCEICAO DE MACABU (RJ)";"RJ";"CONCEICAO DE MACABU";159;37;52;248
2011;"CORDEIRO (RJ)";"RJ";"CORDEIRO";271;35;44;350
2011;"DUAS BARRAS (RJ)";"RJ";"DUAS BARRAS";100;22;6;128
2011;"DUQUE DE CAXIAS (RJ)";"RJ";"DUQUE DE CAXIAS";8124;807;3475;12406
2011;"ENGENHEIRO PAULO DE FRONTIN (RJ)";"RJ";"ENGENHEIRO PAULO DE FRONTIN";133;28;17;178
2011;"GUAPIMIRIM (RJ)";"RJ";"GUAPIMIRIM";306;56;40;402
2011;"IGUABA GRANDE (RJ)";"RJ";"IGUABA GRANDE";159;62;23;244
2011;"ITABORAI (RJ)";"RJ";"ITABORAI";2848;811;429;4088
2011;"ITAGUAI (RJ)";"RJ";"ITAGUAI";1424;263;279;1966
2011;"ITALVA (RJ)";"RJ";"ITALVA";192;22;22;236
2011;"ITAOCARA (RJ)";"RJ";"ITAOCARA";298;41;26;365
2011;"ITAPERUNA (RJ)";"RJ";"ITAPERUNA";1203;112;100;1415
2011;"ITATIAIA (RJ)";"RJ";"ITATIAIA";149;73;45;267
2011;"JAPERI (RJ)";"RJ";"JAPERI";449;54;59;562
2011;"LAJE DO MURIAE (RJ)";"RJ";"LAJE DO MURIAE";40;6;12;58
2011;"MACAE (RJ)";"RJ";"MACAE";2711;745;868;4324
2011;"MACUCO (RJ)";"RJ";"MACUCO";148;12;11;171
2011;"MAGE (RJ)";"RJ";"MAGE";1365;387;204;1956
2011;"MANGARATIBA (RJ)";"RJ";"MANGARATIBA";122;88;126;336
2011;"MARICA (RJ)";"RJ";"MARICA";872;279;315;1466
2011;"MENDES (RJ)";"RJ";"MENDES";210;42;28;280
2011;"MESQUITA (RJ)";"RJ";"MESQUITA";573;96;603;1272
2011;"MIGUEL PEREIRA (RJ)";"RJ";"MIGUEL PEREIRA";330;75;25;430
2011;"MIRACEMA (RJ)";"RJ";"MIRACEMA";221;21;26;268
2011;"NATIVIDADE (RJ)";"RJ";"NATIVIDADE";88;14;31;133
2011;"NILOPOLIS (RJ)";"RJ";"NILOPOLIS";596;126;330;1052
2011;"NITEROI (RJ)";"RJ";"NITEROI";2227;1230;2391;5848
2011;"NOVA FRIBURGO (RJ)";"RJ";"NOVA FRIBURGO";3331;230;310;3871
2011;"NOVA IGUACU (RJ)";"RJ";"NOVA IGUACU";5288;1269;1460;8017
2011;"PARACAMBI (RJ)";"RJ";"PARACAMBI";744;89;64;897
2011;"PARAIBA DO SUL (RJ)";"RJ";"PARAIBA DO SUL";530;82;98;710
2011;"PARATI (RJ)";"RJ";"PARATI";172;56;27;255
2011;"PATY DO ALFERES (RJ)";"RJ";"PATY DO ALFERES";433;66;46;545
2011;"PETROPOLIS (RJ)";"RJ";"PETROPOLIS";2919;581;697;4197
2011;"PINHEIRAL (RJ)";"RJ";"PINHEIRAL";168;38;77;283
2011;"PIRAI (RJ)";"RJ";"PIRAI";412;55;46;513
2011;"PORCIUNCULA (RJ)";"RJ";"PORCIUNCULA";70;10;16;96
2011;"PORTO REAL (RJ)";"RJ";"PORTO REAL";341;49;20;410
2011;"QUATIS (RJ)";"RJ";"QUATIS";168;67;31;266
2011;"QUEIMADOS (RJ)";"RJ";"QUEIMADOS";423;209;116;748
2011;"QUISSAMA (RJ)";"RJ";"QUISSAMA";183;25;98;306
2011;"RESENDE (RJ)";"RJ";"RESENDE";1166;226;408;1800
2011;"RIO BONITO (RJ)";"RJ";"RIO BONITO";3591;362;146;4099
2011;"RIO CLARO (RJ)";"RJ";"RIO CLARO";82;12;12;106
2011;"RIO DAS FLORES (RJ)";"RJ";"RIO DAS FLORES";48;20;8;76
2011;"RIO DAS OSTRAS (RJ)";"RJ";"RIO DAS OSTRAS";860;684;79;1623
2011;"RIO DE JANEIRO (RJ)";"RJ";"RIO DE JANEIRO";34182;15931;15797;65910
2011;"SANTA MARIA MADALENA (RJ)";"RJ";"SANTA MARIA MADALENA";52;19;2;73
2011;"SANTO ANTONIO DE PADUA (RJ)";"RJ";"SANTO ANTONIO DE PADUA";578;93;23;694
2011;"SAO FIDELIS (RJ)";"RJ";"SAO FIDELIS";411;28;42;481
2011;"SAO FRANCISCO DE ITABAPOANA (RJ)";"RJ";"SAO FRANCISCO DE ITABAPOANA";332;73;42;447
2011;"SAO GONCALO (RJ)";"RJ";"SAO GONCALO";3309;1696;2954;7959
2011;"SAO JOAO DA BARRA (RJ)";"RJ";"SAO JOAO DA BARRA";406;80;44;530
2011;"SAO JOAO DE MERITI (RJ)";"RJ";"SAO JOAO DE MERITI";3000;491;1305;4796
2011;"SAO JOSE DE UBA (RJ)";"RJ";"SAO JOSE DE UBA";31;9;4;44
2011;"SAO JOSE DO VALE DO RIO PRETO (RJ)";"RJ";"SAO JOSE DO VALE DO RIO PRETO";558;36;18;612
2011;"SAO PEDRO DA ALDEIA (RJ)";"RJ";"SAO PEDRO DA ALDEIA";650;76;68;794
2011;"SAO SEBASTIAO DO ALTO (RJ)";"RJ";"SAO SEBASTIAO DO ALTO";96;17;5;118
2011;"SAPUCAIA (RJ)";"RJ";"SAPUCAIA";106;16;10;132
2011;"SAQUAREMA (RJ)";"RJ";"SAQUAREMA";639;118;90;847
2011;"SEROPEDICA (RJ)";"RJ";"SEROPEDICA";855;51;226;1132
2011;"SILVA JARDIM (RJ)";"RJ";"SILVA JARDIM";251;47;30;328
2011;"SUMIDOURO (RJ)";"RJ";"SUMIDOURO";222;9;10;241
2011;"TANGUA (RJ)";"RJ";"TANGUA";233;42;76;351
2011;"TERESOPOLIS (RJ)";"RJ";"TERESOPOLIS";1914;231;293;2438
2011;"TRAJANO DE MORAIS (RJ)";"RJ";"TRAJANO DE MORAIS";53;11;10;74
2011;"TRES RIOS (RJ)";"RJ";"TRES RIOS";851;98;210;1159
2011;"VALENCA (RJ)";"RJ";"VALENCA";319;85;76;480
2011;"VARRE SAI (RJ)";"RJ";"VARRE SAI";58;8;2;68
2011;"VASSOURAS (RJ)";"RJ";"VASSOURAS";485;73;90;648
2011;"VOLTA REDONDA (RJ)";"RJ";"VOLTA REDONDA";2209;304;599;3112
2011;"ACARI (RN)";"RN";"ACARI";89;10;7;106
2011;"AFONSO BEZERRA (RN)";"RN";"AFONSO BEZERRA";18;3;5;26
2011;"AGUA NOVA (RN)";"RN";"AGUA NOVA";4;11;2;17
2011;"ALEXANDRIA (RN)";"RN";"ALEXANDRIA";50;30;12;92
2011;"ALMINO AFONSO (RN)";"RN";"ALMINO AFONSO";14;8;1;23
2011;"ALTO DO RODRIGUES (RN)";"RN";"ALTO DO RODRIGUES";138;15;19;172
2011;"ANGICOS (RN)";"RN";"ANGICOS";99;9;10;118
2011;"ANTONIO MARTINS (RN)";"RN";"ANTONIO MARTINS";15;10;1;26
2011;"APODI (RN)";"RN";"APODI";246;16;20;282
2011;"AREIA BRANCA (RN)";"RN";"AREIA BRANCA";111;35;51;197
2011;"ARES (RN)";"RN";"ARES";60;10;18;88
2011;"ASSU (RN)";"RN";"ASSU";502;51;69;622
2011;"BAIA FORMOSA (RN)";"RN";"BAIA FORMOSA";47;4;15;66
2011;"BARAUNA (RN)";"RN";"BARAUNA";142;17;14;173
2011;"BARCELONA (RN)";"RN";"BARCELONA";21;2;2;25
2011;"BENTO FERNANDES (RN)";"RN";"BENTO FERNANDES";15;6;6;27
2011;"BOA SAUDE (RN)";"RN";"BOA SAUDE";45;5;6;56
2011;"BODO (RN)";"RN";"BODO";6;3;1;10
2011;"BOM JESUS (RN)";"RN";"BOM JESUS";48;3;6;57
2011;"BREJINHO (RN)";"RN";"BREJINHO";61;12;12;85
2011;"CAICARA DO NORTE (RN)";"RN";"CAICARA DO NORTE";13;2;4;19
2011;"CAICARA DO RIO DO VENTO (RN)";"RN";"CAICARA DO RIO DO VENTO";19;4;2;25
2011;"CAICO (RN)";"RN";"CAICO";1463;79;43;1585
2011;"CAMPO GRANDE (RN)";"RN";"CAMPO GRANDE";36;10;2;48
2011;"CAMPO REDONDO (RN)";"RN";"CAMPO REDONDO";39;13;9;61
2011;"CANGUARETAMA (RN)";"RN";"CANGUARETAMA";130;21;63;214
2011;"CARAUBAS (RN)";"RN";"CARAUBAS";131;18;8;157
2011;"CARNAUBA DOS DANTAS (RN)";"RN";"CARNAUBA DOS DANTAS";186;8;9;203
2011;"CARNAUBAIS (RN)";"RN";"CARNAUBAIS";43;18;13;74
2011;"CEARA MIRIM (RN)";"RN";"CEARA MIRIM";293;32;108;433
2011;"CERRO CORA (RN)";"RN";"CERRO CORA";74;8;7;89
2011;"CORONEL EZEQUIEL (RN)";"RN";"CORONEL EZEQUIEL";22;7;5;34
2011;"CORONEL JOAO PESSOA (RN)";"RN";"CORONEL JOAO PESSOA";9;2;1;12
2011;"CRUZETA (RN)";"RN";"CRUZETA";74;12;4;90
2011;"CURRAIS NOVOS (RN)";"RN";"CURRAIS NOVOS";594;52;52;698
2011;"DOUTOR SEVERIANO (RN)";"RN";"DOUTOR SEVERIANO";15;7;5;27
2011;"ENCANTO (RN)";"RN";"ENCANTO";11;11;8;30
2011;"EQUADOR (RN)";"RN";"EQUADOR";88;3;1;92
2011;"ESPIRITO SANTO (RN)";"RN";"ESPIRITO SANTO";19;3;13;35
2011;"EXTREMOZ (RN)";"RN";"EXTREMOZ";45;19;35;99
2011;"FELIPE GUERRA (RN)";"RN";"FELIPE GUERRA";12;6;4;22
2011;"FERNANDO PEDROZA (RN)";"RN";"FERNANDO PEDROZA";20;2;2;24
2011;"FLORANIA (RN)";"RN";"FLORANIA";46;8;2;56
2011;"FRANCISCO DANTAS (RN)";"RN";"FRANCISCO DANTAS";8;4;2;14
2011;"FRUTUOSO GOMES (RN)";"RN";"FRUTUOSO GOMES";16;13;1;30
2011;"GALINHOS (RN)";"RN";"GALINHOS";8;3;3;14
2011;"GOIANINHA (RN)";"RN";"GOIANINHA";138;27;53;218
2011;"GOVERNADOR DIX SEPT ROSADO (RN)";"RN";"GOVERNADOR DIX SEPT ROSADO";119;22;15;156
2011;"GROSSOS (RN)";"RN";"GROSSOS";48;4;11;63
2011;"GUAMARE (RN)";"RN";"GUAMARE";75;18;24;117
2011;"IELMO MARINHO (RN)";"RN";"IELMO MARINHO";47;4;25;76
2011;"IPANGUACU (RN)";"RN";"IPANGUACU";69;20;53;142
2011;"IPUEIRA (RN)";"RN";"IPUEIRA";12;6;6;24
2011;"ITAJA (RN)";"RN";"ITAJA";96;3;4;103
2011;"ITAU (RN)";"RN";"ITAU";24;6;2;32
2011;"JACANA (RN)";"RN";"JACANA";93;31;15;139
2011;"JANDAIRA (RN)";"RN";"JANDAIRA";41;0;10;51
2011;"JANDUIS (RN)";"RN";"JANDUIS";14;3;3;20
2011;"JAPI (RN)";"RN";"JAPI";35;6;8;49
2011;"JARDIM DE ANGICOS (RN)";"RN";"JARDIM DE ANGICOS";6;0;1;7
2011;"JARDIM DE PIRANHAS (RN)";"RN";"JARDIM DE PIRANHAS";89;19;7;115
2011;"JARDIM DO SERIDO (RN)";"RN";"JARDIM DO SERIDO";130;18;49;197
2011;"JOAO CAMARA (RN)";"RN";"JOAO CAMARA";273;16;26;315
2011;"JOAO DIAS (RN)";"RN";"JOAO DIAS";3;0;1;4
2011;"JOSE DA PENHA (RN)";"RN";"JOSE DA PENHA";19;10;3;32
2011;"JUCURUTU (RN)";"RN";"JUCURUTU";115;29;9;153
2011;"JUNDIA (RN)";"RN";"JUNDIA";8;5;9;22
2011;"LAGOA DANTA (RN)";"RN";"LAGOA DANTA";33;4;11;48
2011;"LAGOA DE PEDRAS (RN)";"RN";"LAGOA DE PEDRAS";23;5;9;37
2011;"LAGOA DE VELHOS (RN)";"RN";"LAGOA DE VELHOS";17;1;0;18
2011;"LAGOA NOVA (RN)";"RN";"LAGOA NOVA";72;4;8;84
2011;"LAGOA SALGADA (RN)";"RN";"LAGOA SALGADA";57;6;4;67
2011;"LAJES (RN)";"RN";"LAJES";51;3;9;63
2011;"LAJES PINTADAS (RN)";"RN";"LAJES PINTADAS";17;9;3;29
2011;"LUCRECIA (RN)";"RN";"LUCRECIA";16;7;2;25
2011;"LUIS GOMES (RN)";"RN";"LUIS GOMES";28;35;6;69
2011;"MACAIBA (RN)";"RN";"MACAIBA";687;73;62;822
2011;"MACAU (RN)";"RN";"MACAU";192;29;45;266
2011;"MAJOR SALES (RN)";"RN";"MAJOR SALES";14;16;2;32
2011;"MARCELINO VIEIRA (RN)";"RN";"MARCELINO VIEIRA";15;13;2;30
2011;"MARTINS (RN)";"RN";"MARTINS";31;10;4;45
2011;"MAXARANGUAPE (RN)";"RN";"MAXARANGUAPE";20;5;6;31
2011;"MESSIAS TARGINO (RN)";"RN";"MESSIAS TARGINO";31;8;2;41
2011;"MONTANHAS (RN)";"RN";"MONTANHAS";43;5;15;63
2011;"MONTE ALEGRE (RN)";"RN";"MONTE ALEGRE";89;12;11;112
2011;"MONTE DAS GAMELEIRAS (RN)";"RN";"MONTE DAS GAMELEIRAS";9;3;7;19
2011;"MOSSORO (RN)";"RN";"MOSSORO";3406;266;233;3905
2011;"NATAL (RN)";"RN";"NATAL";6138;1167;2160;9465
2011;"NISIA FLORESTA (RN)";"RN";"NISIA FLORESTA";71;37;55;163
2011;"NOVA CRUZ (RN)";"RN";"NOVA CRUZ";319;26;56;401
2011;"OLHO D AGUA DO BORGES (RN)";"RN";"OLHO D AGUA DO BORGES";15;3;1;19
2011;"OURO BRANCO (RN)";"RN";"OURO BRANCO";42;4;5;51
2011;"PARANA (RN)";"RN";"PARANA";13;10;3;26
2011;"PARAU (RN)";"RN";"PARAU";14;8;2;24
2011;"PARAZINHO (RN)";"RN";"PARAZINHO";19;3;9;31
2011;"PARELHAS (RN)";"RN";"PARELHAS";349;23;30;402
2011;"PARNAMIRIM (RN)";"RN";"PARNAMIRIM";1762;319;311;2392
2011;"PASSA E FICA (RN)";"RN";"PASSA E FICA";98;32;20;150
2011;"PASSAGEM (RN)";"RN";"PASSAGEM";16;5;3;24
2011;"PATU (RN)";"RN";"PATU";69;22;2;93
2011;"PAU DOS FERROS (RN)";"RN";"PAU DOS FERROS";365;39;32;436
2011;"PEDRA GRANDE (RN)";"RN";"PEDRA GRANDE";8;1;6;15
2011;"PEDRA PRETA (RN)";"RN";"PEDRA PRETA";23;2;9;34
2011;"PEDRO AVELINO (RN)";"RN";"PEDRO AVELINO";31;3;3;37
2011;"PEDRO VELHO (RN)";"RN";"PEDRO VELHO";41;5;12;58
2011;"PENDENCIAS (RN)";"RN";"PENDENCIAS";48;13;14;75
2011;"PILOES (RN)";"RN";"PILOES";7;6;2;15
2011;"POCO BRANCO (RN)";"RN";"POCO BRANCO";29;2;7;38
2011;"PORTALEGRE (RN)";"RN";"PORTALEGRE";35;7;4;46
2011;"PORTO DO MANGUE (RN)";"RN";"PORTO DO MANGUE";40;12;8;60
2011;"PUREZA (RN)";"RN";"PUREZA";63;3;13;79
2011;"RAFAEL FERNANDES (RN)";"RN";"RAFAEL FERNANDES";11;5;2;18
2011;"RAFAEL GODEIRO (RN)";"RN";"RAFAEL GODEIRO";8;1;1;10
2011;"RIACHO DA CRUZ (RN)";"RN";"RIACHO DA CRUZ";5;2;1;8
2011;"RIACHO DE SANTANA (RN)";"RN";"RIACHO DE SANTANA";4;9;3;16
2011;"RIACHUELO (RN)";"RN";"RIACHUELO";23;2;4;29
2011;"RIO DO FOGO (RN)";"RN";"RIO DO FOGO";33;4;6;43
2011;"RODOLFO FERNANDES (RN)";"RN";"RODOLFO FERNANDES";15;6;1;22
2011;"RUY BARBOSA (RN)";"RN";"RUY BARBOSA";14;1;3;18
2011;"SANTA CRUZ (RN)";"RN";"SANTA CRUZ";362;20;27;409
2011;"SANTA MARIA (RN)";"RN";"SANTA MARIA";45;4;5;54
2011;"SANTANA DO MATOS (RN)";"RN";"SANTANA DO MATOS";70;13;5;88
2011;"SANTANA DO SERIDO (RN)";"RN";"SANTANA DO SERIDO";16;4;1;21
2011;"SANTO ANTONIO (RN)";"RN";"SANTO ANTONIO";97;35;19;151
2011;"SAO BENTO DO NORTE (RN)";"RN";"SAO BENTO DO NORTE";7;0;6;13
2011;"SAO BENTO DO TRAIRI (RN)";"RN";"SAO BENTO DO TRAIRI";15;1;2;18
2011;"SAO FERNANDO (RN)";"RN";"SAO FERNANDO";12;8;2;22
2011;"SAO FRANCISCO DO OESTE (RN)";"RN";"SAO FRANCISCO DO OESTE";14;3;2;19
2011;"SAO GONCALO DO AMARANTE (RN)";"RN";"SAO GONCALO DO AMARANTE";327;96;185;608
2011;"SAO JOAO DO SABUGI (RN)";"RN";"SAO JOAO DO SABUGI";38;18;2;58
2011;"SAO JOSE DE MIPIBU (RN)";"RN";"SAO JOSE DE MIPIBU";227;33;57;317
2011;"SAO JOSE DO CAMPESTRE (RN)";"RN";"SAO JOSE DO CAMPESTRE";67;4;12;83
2011;"SAO JOSE DO SERIDO (RN)";"RN";"SAO JOSE DO SERIDO";24;9;3;36
2011;"SAO MIGUEL (RN)";"RN";"SAO MIGUEL";159;20;23;202
2011;"SAO MIGUEL DO GOSTOSO (RN)";"RN";"SAO MIGUEL DO GOSTOSO";19;7;9;35
2011;"SAO PAULO DO POTENGI (RN)";"RN";"SAO PAULO DO POTENGI";116;11;11;138
2011;"SAO PEDRO (RN)";"RN";"SAO PEDRO";28;2;5;35
2011;"SAO RAFAEL (RN)";"RN";"SAO RAFAEL";28;11;3;42
2011;"SAO TOME (RN)";"RN";"SAO TOME";52;5;20;77
2011;"SAO VICENTE (RN)";"RN";"SAO VICENTE";42;3;4;49
2011;"SENADOR ELOI DE SOUZA (RN)";"RN";"SENADOR ELOI DE SOUZA";10;4;7;21
2011;"SENADOR GEORGINO AVELINO (RN)";"RN";"SENADOR GEORGINO AVELINO";10;2;2;14
2011;"SERRA CAIADA (RN)";"RN";"SERRA CAIADA";26;3;9;38
2011;"SERRA DE SAO BENTO (RN)";"RN";"SERRA DE SAO BENTO";27;6;2;35
2011;"SERRA DO MEL (RN)";"RN";"SERRA DO MEL";71;9;11;91
2011;"SERRA NEGRA DO NORTE (RN)";"RN";"SERRA NEGRA DO NORTE";86;13;4;103
2011;"SERRINHA (RN)";"RN";"SERRINHA";21;16;8;45
2011;"SERRINHA DOS PINTOS (RN)";"RN";"SERRINHA DOS PINTOS";24;8;2;34
2011;"SEVERIANO MELO (RN)";"RN";"SEVERIANO MELO";26;4;7;37
2011;"SITIO NOVO (RN)";"RN";"SITIO NOVO";17;4;2;23
2011;"TABOLEIRO GRANDE (RN)";"RN";"TABOLEIRO GRANDE";7;8;2;17
2011;"TAIPU (RN)";"RN";"TAIPU";52;3;12;67
2011;"TANGARA (RN)";"RN";"TANGARA";100;6;24;130
2011;"TENENTE ANANIAS (RN)";"RN";"TENENTE ANANIAS";34;14;3;51
2011;"TENENTE LAURENTINO CRUZ (RN)";"RN";"TENENTE LAURENTINO CRUZ";36;6;5;47
2011;"TIBAU (RN)";"RN";"TIBAU";24;9;7;40
2011;"TIBAU DO SUL (RN)";"RN";"TIBAU DO SUL";43;36;12;91
2011;"TIMBAUBA DOS BATISTAS (RN)";"RN";"TIMBAUBA DOS BATISTAS";17;6;2;25
2011;"TOUROS (RN)";"RN";"TOUROS";150;26;36;212
2011;"TRIUNFO POTIGUAR (RN)";"RN";"TRIUNFO POTIGUAR";9;7;1;17
2011;"UMARIZAL (RN)";"RN";"UMARIZAL";53;25;2;80
2011;"UPANEMA (RN)";"RN";"UPANEMA";51;11;10;72
2011;"VARZEA (RN)";"RN";"VARZEA";10;4;7;21
2011;"VENHA VER (RN)";"RN";"VENHA VER";14;5;2;21
2011;"VERA CRUZ (RN)";"RN";"VERA CRUZ";134;7;20;161
2011;"VICOSA (RN)";"RN";"VICOSA";3;1;1;5
2011;"VILA FLOR (RN)";"RN";"VILA FLOR";11;1;3;15
2011;"ALTA FLORESTA D OESTE (RO)";"RO";"ALTA FLORESTA D OESTE";510;13;41;564
2011;"ALTO ALEGRE DOS PARECIS (RO)";"RO";"ALTO ALEGRE DOS PARECIS";113;9;19;141
2011;"ALTO PARAISO (RO)";"RO";"ALTO PARAISO";219;7;36;262
2011;"ALVORADA D OESTE (RO)";"RO";"ALVORADA D OESTE";256;8;62;326
2011;"ARIQUEMES (RO)";"RO";"ARIQUEMES";2050;27;165;2242
2011;"BURITIS (RO)";"RO";"BURITIS";398;6;27;431
2011;"CABIXI (RO)";"RO";"CABIXI";64;2;16;82
2011;"CACAULANDIA (RO)";"RO";"CACAULANDIA";59;2;15;76
2011;"CACOAL (RO)";"RO";"CACOAL";1443;50;259;1752
2011;"CAMPO NOVO DE RONDONIA (RO)";"RO";"CAMPO NOVO DE RONDONIA";53;2;16;71
2011;"CANDEIAS DO JAMARI (RO)";"RO";"CANDEIAS DO JAMARI";143;3;18;164
2011;"CASTANHEIRAS (RO)";"RO";"CASTANHEIRAS";28;1;6;35
2011;"CEREJEIRAS (RO)";"RO";"CEREJEIRAS";316;7;42;365
2011;"CHUPINGUAIA (RO)";"RO";"CHUPINGUAIA";95;5;20;120
2011;"COLORADO DO OESTE (RO)";"RO";"COLORADO DO OESTE";369;8;40;417
2011;"CORUMBIARA (RO)";"RO";"CORUMBIARA";63;5;11;79
2011;"COSTA MARQUES (RO)";"RO";"COSTA MARQUES";68;4;13;85
2011;"CUJUBIM (RO)";"RO";"CUJUBIM";149;4;14;167
2011;"ESPIGAO D OESTE (RO)";"RO";"ESPIGAO D OESTE";499;5;82;586
2011;"GOVERNADOR JORGE TEIXEIRA (RO)";"RO";"GOVERNADOR JORGE TEIXEIRA";47;1;12;60
2011;"GUAJARA MIRIM (RO)";"RO";"GUAJARA MIRIM";817;12;43;872
2011;"ITAPUA DO OESTE (RO)";"RO";"ITAPUA DO OESTE";101;1;41;143
2011;"JARU (RO)";"RO";"JARU";1000;21;189;1210
2011;"JI PARANA (RO)";"RO";"JI PARANA";2575;70;560;3205
2011;"MACHADINHO D OESTE (RO)";"RO";"MACHADINHO D OESTE";291;6;48;345
2011;"MINISTRO ANDREAZZA (RO)";"RO";"MINISTRO ANDREAZZA";154;3;13;170
2011;"MIRANTE DA SERRA (RO)";"RO";"MIRANTE DA SERRA";168;3;24;195
2011;"MONTE NEGRO (RO)";"RO";"MONTE NEGRO";237;9;54;300
2011;"NOVA BRASILANDIA D OESTE (RO)";"RO";"NOVA BRASILANDIA D OESTE";228;6;40;274
2011;"NOVA DO MAMORE (RO)";"RO";"NOVA DO MAMORE";190;2;25;217
2011;"NOVA UNIAO (RO)";"RO";"NOVA UNIAO";50;1;10;61
2011;"NOVO HORIZONTE DO OESTE (RO)";"RO";"NOVO HORIZONTE DO OESTE";80;2;15;97
2011;"OURO PRETO DO OESTE (RO)";"RO";"OURO PRETO DO OESTE";690;26;99;815
2011;"PARECIS (RO)";"RO";"PARECIS";29;2;15;46
2011;"PIMENTA BUENO (RO)";"RO";"PIMENTA BUENO";903;30;68;1001
2011;"PIMENTEIRAS DO OESTE (RO)";"RO";"PIMENTEIRAS DO OESTE";10;1;11;22
2011;"PORTO VELHO (RO)";"RO";"PORTO VELHO";5778;377;1446;7601
2011;"PRESIDENTE MEDICI (RO)";"RO";"PRESIDENTE MEDICI";288;5;38;331
2011;"PRIMAVERA DE RONDONIA (RO)";"RO";"PRIMAVERA DE RONDONIA";28;2;10;40
2011;"RIO CRESPO (RO)";"RO";"RIO CRESPO";47;1;18;66
2011;"ROLIM DE MOURA (RO)";"RO";"ROLIM DE MOURA";1019;31;103;1153
2011;"SANTA LUZIA D OESTE (RO)";"RO";"SANTA LUZIA D OESTE";132;3;38;173
2011;"SAO FELIPE D OESTE (RO)";"RO";"SAO FELIPE D OESTE";63;2;21;86
2011;"SAO FRANCISCO DO GUAPORE (RO)";"RO";"SAO FRANCISCO DO GUAPORE";213;3;44;260
2011;"SAO MIGUEL DO GUAPORE (RO)";"RO";"SAO MIGUEL DO GUAPORE";239;9;59;307
2011;"SERINGUEIRAS (RO)";"RO";"SERINGUEIRAS";168;5;24;197
2011;"TEIXEIROPOLIS (RO)";"RO";"TEIXEIROPOLIS";29;0;11;40
2011;"THEOBROMA (RO)";"RO";"THEOBROMA";62;1;15;78
2011;"URUPA (RO)";"RO";"URUPA";97;2;35;134
2011;"VALE DO ANARI (RO)";"RO";"VALE DO ANARI";71;3;12;86
2011;"VALE DO PARAISO (RO)";"RO";"VALE DO PARAISO";55;1;11;67
2011;"VILHENA (RO)";"RO";"VILHENA";1453;53;159;1665
2011;"ALTO ALEGRE (RR)";"RR";"ALTO ALEGRE";47;4;8;59
2011;"AMAJARI (RR)";"RR";"AMAJARI";17;5;0;22
2011;"BOA VISTA (RR)";"RR";"BOA VISTA";2909;360;622;3891
2011;"BONFIM (RR)";"RR";"BONFIM";12;1;0;13
2011;"CANTA (RR)";"RR";"CANTA";26;6;7;39
2011;"CARACARAI (RR)";"RR";"CARACARAI";80;6;5;91
2011;"CAROEBE (RR)";"RR";"CAROEBE";26;5;20;51
2011;"IRACEMA (RR)";"RR";"IRACEMA";21;16;1;38
2011;"MUCAJAI (RR)";"RR";"MUCAJAI";87;32;30;149
2011;"NORMANDIA (RR)";"RR";"NORMANDIA";10;0;1;11
2011;"PACARAIMA (RR)";"RR";"PACARAIMA";42;2;3;47
2011;"RORAINOPOLIS (RR)";"RR";"RORAINOPOLIS";84;12;11;107
2011;"SAO JOAO DA BALIZA (RR)";"RR";"SAO JOAO DA BALIZA";40;8;4;52
2011;"SAO LUIZ (RR)";"RR";"SAO LUIZ";30;3;2;35
2011;"UIRAMUTA (RR)";"RR";"UIRAMUTA";1;0;0;1
2011;"ACEGUA (RS)";"RS";"ACEGUA";60;16;13;89
2011;"AGUA SANTA (RS)";"RS";"AGUA SANTA";153;8;15;176
2011;"AGUDO (RS)";"RS";"AGUDO";289;10;52;351
2011;"AJURICABA (RS)";"RS";"AJURICABA";361;19;32;412
2011;"ALECRIM (RS)";"RS";"ALECRIM";77;5;23;105
2011;"ALEGRETE (RS)";"RS";"ALEGRETE";919;49;202;1170
2011;"ALEGRIA (RS)";"RS";"ALEGRIA";79;5;20;104
2011;"ALMIRANTE TAMANDARE DO SUL (RS)";"RS";"ALMIRANTE TAMANDARE DO SUL";78;8;3;89
2011;"ALPESTRE (RS)";"RS";"ALPESTRE";128;17;49;194
2011;"ALTO ALEGRE (RS)";"RS";"ALTO ALEGRE";81;6;6;93
2011;"ALTO FELIZ (RS)";"RS";"ALTO FELIZ";85;12;10;107
2011;"ALVORADA (RS)";"RS";"ALVORADA";1635;170;604;2409
2011;"AMARAL FERRADOR (RS)";"RS";"AMARAL FERRADOR";132;9;20;161
2011;"AMETISTA DO SUL (RS)";"RS";"AMETISTA DO SUL";62;6;49;117
2011;"ANDRE DA ROCHA (RS)";"RS";"ANDRE DA ROCHA";49;4;4;57
2011;"ANTA GORDA (RS)";"RS";"ANTA GORDA";229;18;20;267
2011;"ANTONIO PRADO (RS)";"RS";"ANTONIO PRADO";635;17;40;692
2011;"ARAMBARE (RS)";"RS";"ARAMBARE";51;6;8;65
2011;"ARARICA (RS)";"RS";"ARARICA";101;5;10;116
2011;"ARATIBA (RS)";"RS";"ARATIBA";168;29;26;223
2011;"ARROIO DO MEIO (RS)";"RS";"ARROIO DO MEIO";494;36;46;576
2011;"ARROIO DO PADRE (RS)";"RS";"ARROIO DO PADRE";86;7;12;105
2011;"ARROIO DO SAL (RS)";"RS";"ARROIO DO SAL";111;11;11;133
2011;"ARROIO DO TIGRE (RS)";"RS";"ARROIO DO TIGRE";269;25;36;330
2011;"ARROIO DOS RATOS (RS)";"RS";"ARROIO DOS RATOS";204;11;58;273
2011;"ARROIO GRANDE (RS)";"RS";"ARROIO GRANDE";244;15;57;316
2011;"ARVOREZINHA (RS)";"RS";"ARVOREZINHA";445;40;36;521
2011;"AUGUSTO PESTANA (RS)";"RS";"AUGUSTO PESTANA";391;12;28;431
2011;"AUREA (RS)";"RS";"AUREA";125;5;9;139
2011;"BAGE (RS)";"RS";"BAGE";1114;171;317;1602
2011;"BALNEARIO PINHAL (RS)";"RS";"BALNEARIO PINHAL";94;6;18;118
2011;"BARAO (RS)";"RS";"BARAO";190;29;35;254
2011;"BARAO DE COTEGIPE (RS)";"RS";"BARAO DE COTEGIPE";206;15;15;236
2011;"BARAO DO TRIUNFO (RS)";"RS";"BARAO DO TRIUNFO";125;22;31;178
2011;"BARRA DO GUARITA (RS)";"RS";"BARRA DO GUARITA";22;4;5;31
2011;"BARRA DO QUARAI (RS)";"RS";"BARRA DO QUARAI";28;4;13;45
2011;"BARRA DO RIBEIRO (RS)";"RS";"BARRA DO RIBEIRO";149;11;46;206
2011;"BARRA DO RIO AZUL (RS)";"RS";"BARRA DO RIO AZUL";41;10;9;60
2011;"BARRA FUNDA (RS)";"RS";"BARRA FUNDA";176;5;10;191
2011;"BARRACAO (RS)";"RS";"BARRACAO";135;7;18;160
2011;"BARROS CASSAL (RS)";"RS";"BARROS CASSAL";148;13;45;206
2011;"BENJAMIN CONSTANT DO SUL (RS)";"RS";"BENJAMIN CONSTANT DO SUL";25;4;7;36
2011;"BENTO GONCALVES (RS)";"RS";"BENTO GONCALVES";3227;241;308;3776
2011;"BOA VISTA DAS MISSOES (RS)";"RS";"BOA VISTA DAS MISSOES";87;5;14;106
2011;"BOA VISTA DO BURICA (RS)";"RS";"BOA VISTA DO BURICA";204;11;20;235
2011;"BOA VISTA DO CADEADO (RS)";"RS";"BOA VISTA DO CADEADO";88;2;19;109
2011;"BOA VISTA DO INCRA (RS)";"RS";"BOA VISTA DO INCRA";62;2;7;71
2011;"BOA VISTA DO SUL (RS)";"RS";"BOA VISTA DO SUL";324;7;11;342
2011;"BOM JESUS (RS)";"RS";"BOM JESUS";247;28;46;321
2011;"BOM PRINCIPIO (RS)";"RS";"BOM PRINCIPIO";416;27;29;472
2011;"BOM PROGRESSO (RS)";"RS";"BOM PROGRESSO";40;7;4;51
2011;"BOM RETIRO DO SUL (RS)";"RS";"BOM RETIRO DO SUL";171;14;30;215
2011;"BOQUEIRAO DO LEAO (RS)";"RS";"BOQUEIRAO DO LEAO";153;9;17;179
2011;"BOSSOROCA (RS)";"RS";"BOSSOROCA";175;3;21;199
2011;"BOZANO (RS)";"RS";"BOZANO";132;4;6;142
2011;"BRAGA (RS)";"RS";"BRAGA";67;2;13;82
2011;"BROCHIER (RS)";"RS";"BROCHIER";259;13;22;294
2011;"BUTIA (RS)";"RS";"BUTIA";419;19;99;537
2011;"CACAPAVA DO SUL (RS)";"RS";"CACAPAVA DO SUL";571;51;104;726
2011;"CACEQUI (RS)";"RS";"CACEQUI";131;17;21;169
2011;"CACHOEIRA DO SUL (RS)";"RS";"CACHOEIRA DO SUL";1149;82;209;1440
2011;"CACHOEIRINHA (RS)";"RS";"CACHOEIRINHA";2133;227;508;2868
2011;"CACIQUE DOBLE (RS)";"RS";"CACIQUE DOBLE";104;4;11;119
2011;"CAIBATE (RS)";"RS";"CAIBATE";125;7;4;136
2011;"CAICARA (RS)";"RS";"CAICARA";67;9;19;95
2011;"CAMAQUA (RS)";"RS";"CAMAQUA";1256;65;218;1539
2011;"CAMARGO (RS)";"RS";"CAMARGO";142;8;17;167
2011;"CAMBARA DO SUL (RS)";"RS";"CAMBARA DO SUL";268;13;32;313
2011;"CAMPESTRE DA SERRA (RS)";"RS";"CAMPESTRE DA SERRA";157;4;12;173
2011;"CAMPINA DAS MISSOES (RS)";"RS";"CAMPINA DAS MISSOES";136;12;29;177
2011;"CAMPINAS DO SUL (RS)";"RS";"CAMPINAS DO SUL";190;13;23;226
2011;"CAMPO BOM (RS)";"RS";"CAMPO BOM";717;77;99;893
2011;"CAMPO NOVO (RS)";"RS";"CAMPO NOVO";148;15;24;187
2011;"CAMPOS BORGES (RS)";"RS";"CAMPOS BORGES";130;11;14;155
2011;"CANDELARIA (RS)";"RS";"CANDELARIA";398;24;76;498
2011;"CANDIDO GODOI (RS)";"RS";"CANDIDO GODOI";207;11;21;239
2011;"CANDIOTA (RS)";"RS";"CANDIOTA";137;32;39;208
2011;"CANELA (RS)";"RS";"CANELA";531;79;118;728
2011;"CANGUCU (RS)";"RS";"CANGUCU";1038;83;157;1278
2011;"CANOAS (RS)";"RS";"CANOAS";4269;430;909;5608
2011;"CANUDOS DO VALE (RS)";"RS";"CANUDOS DO VALE";25;12;2;39
2011;"CAPAO BONITO DO SUL (RS)";"RS";"CAPAO BONITO DO SUL";41;4;7;52
2011;"CAPAO DA CANOA (RS)";"RS";"CAPAO DA CANOA";415;63;91;569
2011;"CAPAO DO CIPO (RS)";"RS";"CAPAO DO CIPO";87;7;6;100
2011;"CAPAO DO LEAO (RS)";"RS";"CAPAO DO LEAO";461;21;26;508
2011;"CAPELA DE SANTANA (RS)";"RS";"CAPELA DE SANTANA";194;12;11;217
2011;"CAPITAO (RS)";"RS";"CAPITAO";68;9;8;85
2011;"CAPIVARI DO SUL (RS)";"RS";"CAPIVARI DO SUL";134;11;5;150
2011;"CARAA (RS)";"RS";"CARAA";103;2;17;122
2011;"CARAZINHO (RS)";"RS";"CARAZINHO";1324;72;182;1578
2011;"CARLOS BARBOSA (RS)";"RS";"CARLOS BARBOSA";773;46;106;925
2011;"CARLOS GOMES (RS)";"RS";"CARLOS GOMES";28;4;5;37
2011;"CASCA (RS)";"RS";"CASCA";376;21;25;422
2011;"CASEIROS (RS)";"RS";"CASEIROS";136;6;13;155
2011;"CATUIPE (RS)";"RS";"CATUIPE";338;9;26;373
2011;"CAXIAS DO SUL (RS)";"RS";"CAXIAS DO SUL";8438;1341;1629;11408
2011;"CENTENARIO (RS)";"RS";"CENTENARIO";77;9;10;96
2011;"CERRITO (RS)";"RS";"CERRITO";188;9;8;205
2011;"CERRO BRANCO (RS)";"RS";"CERRO BRANCO";65;7;14;86
2011;"CERRO GRANDE (RS)";"RS";"CERRO GRANDE";38;2;12;52
2011;"CERRO GRANDE DO SUL (RS)";"RS";"CERRO GRANDE DO SUL";224;17;17;258
2011;"CERRO LARGO (RS)";"RS";"CERRO LARGO";344;10;36;390
2011;"CHAPADA (RS)";"RS";"CHAPADA";305;39;26;370
2011;"CHARQUEADAS (RS)";"RS";"CHARQUEADAS";341;64;86;491
2011;"CHARRUA (RS)";"RS";"CHARRUA";96;3;9;108
2011;"CHIAPETTA (RS)";"RS";"CHIAPETTA";136;9;12;157
2011;"CHUI (RS)";"RS";"CHUI";115;13;10;138
2011;"CHUVISCA (RS)";"RS";"CHUVISCA";104;7;29;140
2011;"CIDREIRA (RS)";"RS";"CIDREIRA";115;13;24;152
2011;"CIRIACO (RS)";"RS";"CIRIACO";142;13;16;171
2011;"COLINAS (RS)";"RS";"COLINAS";67;7;9;83
2011;"COLORADO (RS)";"RS";"COLORADO";200;14;11;225
2011;"CONDOR (RS)";"RS";"CONDOR";229;14;25;268
2011;"CONSTANTINA (RS)";"RS";"CONSTANTINA";277;18;70;365
2011;"COQUEIRO BAIXO (RS)";"RS";"COQUEIRO BAIXO";19;6;2;27
2011;"COQUEIROS DO SUL (RS)";"RS";"COQUEIROS DO SUL";113;4;10;127
2011;"CORONEL BARROS (RS)";"RS";"CORONEL BARROS";94;0;10;104
2011;"CORONEL BICACO (RS)";"RS";"CORONEL BICACO";203;19;17;239
2011;"CORONEL PILAR (RS)";"RS";"CORONEL PILAR";190;6;9;205
2011;"COTIPORA (RS)";"RS";"COTIPORA";206;9;12;227
2011;"COXILHA (RS)";"RS";"COXILHA";103;5;13;121
2011;"CRISSIUMAL (RS)";"RS";"CRISSIUMAL";308;24;48;380
2011;"CRISTAL (RS)";"RS";"CRISTAL";173;10;27;210
2011;"CRISTAL DO SUL (RS)";"RS";"CRISTAL DO SUL";29;4;16;49
2011;"CRUZ ALTA (RS)";"RS";"CRUZ ALTA";1166;81;107;1354
2011;"CRUZALTENSE (RS)";"RS";"CRUZALTENSE";56;6;7;69
2011;"CRUZEIRO DO SUL (RS)";"RS";"CRUZEIRO DO SUL";361;13;13;387
2011;"DAVID CANABARRO (RS)";"RS";"DAVID CANABARRO";168;7;24;199
2011;"DERRUBADAS (RS)";"RS";"DERRUBADAS";80;13;6;99
2011;"DEZESSEIS DE NOVEMBRO (RS)";"RS";"DEZESSEIS DE NOVEMBRO";53;3;6;62
2011;"DILERMANDO DE AGUIAR (RS)";"RS";"DILERMANDO DE AGUIAR";44;1;25;70
2011;"DOIS IRMAOS (RS)";"RS";"DOIS IRMAOS";434;25;110;569
2011;"DOIS IRMAOS DAS MISSOES (RS)";"RS";"DOIS IRMAOS DAS MISSOES";64;8;4;76
2011;"DOIS LAJEADOS (RS)";"RS";"DOIS LAJEADOS";119;2;17;138
2011;"DOM FELICIANO (RS)";"RS";"DOM FELICIANO";232;14;71;317
2011;"DOM PEDRITO (RS)";"RS";"DOM PEDRITO";560;33;44;637
2011;"DOM PEDRO DE ALCANTARA (RS)";"RS";"DOM PEDRO DE ALCANTARA";94;2;4;100
2011;"DONA FRANCISCA (RS)";"RS";"DONA FRANCISCA";48;1;8;57
2011;"DOUTOR MAURICIO CARDOSO (RS)";"RS";"DOUTOR MAURICIO CARDOSO";172;16;15;203
2011;"DOUTOR RICARDO (RS)";"RS";"DOUTOR RICARDO";62;8;10;80
2011;"ELDORADO DO SUL (RS)";"RS";"ELDORADO DO SUL";475;35;45;555
2011;"ENCANTADO (RS)";"RS";"ENCANTADO";670;48;146;864
2011;"ENCRUZILHADA DO SUL (RS)";"RS";"ENCRUZILHADA DO SUL";370;16;164;550
2011;"ENGENHO VELHO (RS)";"RS";"ENGENHO VELHO";33;1;12;46
2011;"ENTRE IJUIS (RS)";"RS";"ENTRE IJUIS";295;10;24;329
2011;"ENTRE RIOS DO SUL (RS)";"RS";"ENTRE RIOS DO SUL";53;11;16;80
2011;"EREBANGO (RS)";"RS";"EREBANGO";106;2;7;115
2011;"ERECHIM (RS)";"RS";"ERECHIM";1863;267;485;2615
2011;"ERNESTINA (RS)";"RS";"ERNESTINA";151;19;12;182
2011;"ERVAL GRANDE (RS)";"RS";"ERVAL GRANDE";108;23;16;147
2011;"ERVAL SECO (RS)";"RS";"ERVAL SECO";145;9;33;187
2011;"ESMERALDA (RS)";"RS";"ESMERALDA";75;3;12;90
2011;"ESPERANCA DO SUL (RS)";"RS";"ESPERANCA DO SUL";40;2;10;52
2011;"ESPUMOSO (RS)";"RS";"ESPUMOSO";614;28;69;711
2011;"ESTACAO (RS)";"RS";"ESTACAO";190;13;12;215
2011;"ESTANCIA VELHA (RS)";"RS";"ESTANCIA VELHA";761;69;100;930
2011;"ESTEIO (RS)";"RS";"ESTEIO";1114;138;275;1527
2011;"ESTRELA (RS)";"RS";"ESTRELA";964;38;71;1073
2011;"ESTRELA VELHA (RS)";"RS";"ESTRELA VELHA";109;6;14;129
2011;"EUGENIO DE CASTRO (RS)";"RS";"EUGENIO DE CASTRO";91;9;7;107
2011;"FAGUNDES VARELA (RS)";"RS";"FAGUNDES VARELA";107;3;17;127
2011;"FARROUPILHA (RS)";"RS";"FARROUPILHA";1985;237;172;2394
2011;"FAXINAL DO SOTURNO (RS)";"RS";"FAXINAL DO SOTURNO";138;6;9;153
2011;"FAXINALZINHO (RS)";"RS";"FAXINALZINHO";55;9;11;75
2011;"FAZENDA VILANOVA (RS)";"RS";"FAZENDA VILANOVA";144;10;14;168
2011;"FELIZ (RS)";"RS";"FELIZ";404;32;73;509
2011;"FLORES DA CUNHA (RS)";"RS";"FLORES DA CUNHA";1400;64;105;1569
2011;"FLORIANO PEIXOTO (RS)";"RS";"FLORIANO PEIXOTO";59;14;14;87
2011;"FONTOURA XAVIER (RS)";"RS";"FONTOURA XAVIER";198;18;32;248
2011;"FORMIGUEIRO (RS)";"RS";"FORMIGUEIRO";147;5;21;173
2011;"FORQUETINHA (RS)";"RS";"FORQUETINHA";65;3;3;71
2011;"FORTALEZA DOS VALOS (RS)";"RS";"FORTALEZA DOS VALOS";217;4;20;241
2011;"FREDERICO WESTPHALEN (RS)";"RS";"FREDERICO WESTPHALEN";690;39;92;821
2011;"GARIBALDI (RS)";"RS";"GARIBALDI";1354;69;118;1541
2011;"GARRUCHOS (RS)";"RS";"GARRUCHOS";43;7;14;64
2011;"GAURAMA (RS)";"RS";"GAURAMA";183;17;20;220
2011;"GENERAL CAMARA (RS)";"RS";"GENERAL CAMARA";77;10;20;107
2011;"GENTIL (RS)";"RS";"GENTIL";85;9;19;113
2011;"GETULIO VARGAS (RS)";"RS";"GETULIO VARGAS";467;23;29;519
2011;"GIRUA (RS)";"RS";"GIRUA";521;32;46;599
2011;"GLORINHA (RS)";"RS";"GLORINHA";205;29;12;246
2011;"GRAMADO (RS)";"RS";"GRAMADO";630;133;123;886
2011;"GRAMADO DOS LOUREIROS (RS)";"RS";"GRAMADO DOS LOUREIROS";29;2;11;42
2011;"GRAMADO XAVIER (RS)";"RS";"GRAMADO XAVIER";55;5;5;65
2011;"GRAVATAI (RS)";"RS";"GRAVATAI";3093;502;598;4193
2011;"GUABIJU (RS)";"RS";"GUABIJU";48;5;9;62
2011;"GUAIBA (RS)";"RS";"GUAIBA";966;174;409;1549
2011;"GUAPORE (RS)";"RS";"GUAPORE";458;38;70;566
2011;"GUARANI DAS MISSOES (RS)";"RS";"GUARANI DAS MISSOES";229;8;19;256
2011;"HARMONIA (RS)";"RS";"HARMONIA";210;6;9;225
2011;"HERVAL (RS)";"RS";"HERVAL";114;11;9;134
2011;"HERVEIRAS (RS)";"RS";"HERVEIRAS";52;1;2;55
2011;"HORIZONTINA (RS)";"RS";"HORIZONTINA";332;26;50;408
2011;"HULHA NEGRA (RS)";"RS";"HULHA NEGRA";50;9;37;96
2011;"HUMAITA (RS)";"RS";"HUMAITA";114;5;7;126
2011;"IBARAMA (RS)";"RS";"IBARAMA";86;4;17;107
2011;"IBIACA (RS)";"RS";"IBIACA";257;10;20;287
2011;"IBIRAIARAS (RS)";"RS";"IBIRAIARAS";431;9;22;462
2011;"IBIRAPUITA (RS)";"RS";"IBIRAPUITA";124;8;35;167
2011;"IBIRUBA (RS)";"RS";"IBIRUBA";840;52;77;969
2011;"IGREJINHA (RS)";"RS";"IGREJINHA";402;39;87;528
2011;"IJUI (RS)";"RS";"IJUI";1821;108;122;2051
2011;"ILOPOLIS (RS)";"RS";"ILOPOLIS";191;5;5;201
2011;"IMBE (RS)";"RS";"IMBE";255;16;46;317
2011;"IMIGRANTE (RS)";"RS";"IMIGRANTE";93;19;17;129
2011;"INDEPENDENCIA (RS)";"RS";"INDEPENDENCIA";195;20;37;252
2011;"INHACORA (RS)";"RS";"INHACORA";61;5;7;73
2011;"IPE (RS)";"RS";"IPE";269;26;23;318
2011;"IPIRANGA DO SUL (RS)";"RS";"IPIRANGA DO SUL";115;9;12;136
2011;"IRAI (RS)";"RS";"IRAI";119;8;16;143
2011;"ITAARA (RS)";"RS";"ITAARA";107;6;15;128
2011;"ITACURUBI (RS)";"RS";"ITACURUBI";38;6;8;52
2011;"ITAPUCA (RS)";"RS";"ITAPUCA";52;3;8;63
2011;"ITAQUI (RS)";"RS";"ITAQUI";623;22;68;713
2011;"ITATI (RS)";"RS";"ITATI";74;4;11;89
2011;"ITATIBA DO SUL (RS)";"RS";"ITATIBA DO SUL";76;15;8;99
2011;"IVORA (RS)";"RS";"IVORA";64;4;4;72
2011;"IVOTI (RS)";"RS";"IVOTI";514;37;100;651
2011;"JABOTICABA (RS)";"RS";"JABOTICABA";61;4;16;81
2011;"JACUIZINHO (RS)";"RS";"JACUIZINHO";51;4;15;70
2011;"JACUTINGA (RS)";"RS";"JACUTINGA";105;8;7;120
2011;"JAGUARAO (RS)";"RS";"JAGUARAO";296;17;41;354
2011;"JAGUARI (RS)";"RS";"JAGUARI";232;19;49;300
2011;"JAQUIRANA (RS)";"RS";"JAQUIRANA";137;9;10;156
2011;"JARI (RS)";"RS";"JARI";59;6;10;75
2011;"JOIA (RS)";"RS";"JOIA";283;14;37;334
2011;"JULIO DE CASTILHOS (RS)";"RS";"JULIO DE CASTILHOS";578;22;56;656
2011;"LAGOA BONITA DO SUL (RS)";"RS";"LAGOA BONITA DO SUL";46;5;12;63
2011;"LAGOA DOS TRES CANTOS (RS)";"RS";"LAGOA DOS TRES CANTOS";85;6;4;95
2011;"LAGOA VERMELHA (RS)";"RS";"LAGOA VERMELHA";647;51;83;781
2011;"LAGOAO (RS)";"RS";"LAGOAO";70;4;30;104
2011;"LAJEADO (RS)";"RS";"LAJEADO";1986;170;242;2398
2011;"LAJEADO DO BUGRE (RS)";"RS";"LAJEADO DO BUGRE";23;2;8;33
2011;"LAVRAS DO SUL (RS)";"RS";"LAVRAS DO SUL";75;11;19;105
2011;"LIBERATO SALZANO (RS)";"RS";"LIBERATO SALZANO";113;9;23;145
2011;"LINDOLFO COLLOR (RS)";"RS";"LINDOLFO COLLOR";119;6;13;138
2011;"LINHA NOVA (RS)";"RS";"LINHA NOVA";71;6;3;80
2011;"MACAMBARA (RS)";"RS";"MACAMBARA";41;3;32;76
2011;"MACHADINHO (RS)";"RS";"MACHADINHO";102;8;24;134
2011;"MAMPITUBA (RS)";"RS";"MAMPITUBA";30;1;12;43
2011;"MANOEL VIANA (RS)";"RS";"MANOEL VIANA";152;6;15;173
2011;"MAQUINE (RS)";"RS";"MAQUINE";246;12;13;271
2011;"MARATA (RS)";"RS";"MARATA";112;12;24;148
2011;"MARAU (RS)";"RS";"MARAU";1023;79;140;1242
2011;"MARCELINO RAMOS (RS)";"RS";"MARCELINO RAMOS";128;18;25;171
2011;"MARIANA PIMENTEL (RS)";"RS";"MARIANA PIMENTEL";117;7;25;149
2011;"MARIANO MORO (RS)";"RS";"MARIANO MORO";59;12;9;80
2011;"MARQUES DE SOUZA (RS)";"RS";"MARQUES DE SOUZA";134;14;34;182
2011;"MATA (RS)";"RS";"MATA";92;4;21;117
2011;"MATO CASTELHANO (RS)";"RS";"MATO CASTELHANO";116;11;19;146
2011;"MATO LEITAO (RS)";"RS";"MATO LEITAO";108;8;9;125
2011;"MATO QUEIMADO (RS)";"RS";"MATO QUEIMADO";60;6;6;72
2011;"MAXIMILIANO DE ALMEIDA (RS)";"RS";"MAXIMILIANO DE ALMEIDA";131;9;90;230
2011;"MINAS DO LEAO (RS)";"RS";"MINAS DO LEAO";105;10;25;140
2011;"MIRAGUAI (RS)";"RS";"MIRAGUAI";87;4;24;115
2011;"MONTAURI (RS)";"RS";"MONTAURI";59;3;8;70
2011;"MONTE ALEGRE DOS CAMPOS (RS)";"RS";"MONTE ALEGRE DOS CAMPOS";71;3;29;103
2011;"MONTE BELO DO SUL (RS)";"RS";"MONTE BELO DO SUL";195;8;17;220
2011;"MONTENEGRO (RS)";"RS";"MONTENEGRO";1249;148;191;1588
2011;"MORMACO (RS)";"RS";"MORMACO";75;5;8;88
2011;"MORRINHOS DO SUL (RS)";"RS";"MORRINHOS DO SUL";140;1;7;148
2011;"MORRO REDONDO (RS)";"RS";"MORRO REDONDO";210;3;16;229
2011;"MORRO REUTER (RS)";"RS";"MORRO REUTER";151;10;21;182
2011;"MOSTARDAS (RS)";"RS";"MOSTARDAS";294;11;58;363
2011;"MUCUM (RS)";"RS";"MUCUM";83;8;16;107
2011;"MUITOS CAPOES (RS)";"RS";"MUITOS CAPOES";72;4;6;82
2011;"MULITERNO (RS)";"RS";"MULITERNO";99;4;9;112
2011;"NAO ME TOQUE (RS)";"RS";"NAO ME TOQUE";527;37;57;621
2011;"NICOLAU VERGUEIRO (RS)";"RS";"NICOLAU VERGUEIRO";89;6;14;109
2011;"NONOAI (RS)";"RS";"NONOAI";217;17;51;285
2011;"NOVA ALVORADA (RS)";"RS";"NOVA ALVORADA";139;4;15;158
2011;"NOVA ARACA (RS)";"RS";"NOVA ARACA";159;18;28;205
2011;"NOVA BASSANO (RS)";"RS";"NOVA BASSANO";473;35;55;563
2011;"NOVA BOA VISTA (RS)";"RS";"NOVA BOA VISTA";65;9;11;85
2011;"NOVA BRESCIA (RS)";"RS";"NOVA BRESCIA";111;13;10;134
2011;"NOVA CANDELARIA (RS)";"RS";"NOVA CANDELARIA";71;8;6;85
2011;"NOVA ESPERANCA DO SUL (RS)";"RS";"NOVA ESPERANCA DO SUL";72;7;25;104
2011;"NOVA HARTZ (RS)";"RS";"NOVA HARTZ";138;15;66;219
2011;"NOVA PADUA (RS)";"RS";"NOVA PADUA";305;3;6;314
2011;"NOVA PALMA (RS)";"RS";"NOVA PALMA";236;13;30;279
2011;"NOVA PETROPOLIS (RS)";"RS";"NOVA PETROPOLIS";522;37;67;626
2011;"NOVA PRATA (RS)";"RS";"NOVA PRATA";600;20;56;676
2011;"NOVA RAMADA (RS)";"RS";"NOVA RAMADA";101;7;9;117
2011;"NOVA ROMA DO SUL (RS)";"RS";"NOVA ROMA DO SUL";287;8;22;317
2011;"NOVA SANTA RITA (RS)";"RS";"NOVA SANTA RITA";774;46;49;869
2011;"NOVO BARREIRO (RS)";"RS";"NOVO BARREIRO";125;11;16;152
2011;"NOVO CABRAIS (RS)";"RS";"NOVO CABRAIS";80;2;8;90
2011;"NOVO HAMBURGO (RS)";"RS";"NOVO HAMBURGO";2967;274;373;3614
2011;"NOVO MACHADO (RS)";"RS";"NOVO MACHADO";137;19;11;167
2011;"NOVO TIRADENTES (RS)";"RS";"NOVO TIRADENTES";35;4;6;45
2011;"NOVO XINGU (RS)";"RS";"NOVO XINGU";35;11;10;56
2011;"OSORIO (RS)";"RS";"OSORIO";938;54;92;1084
2011;"PAIM FILHO (RS)";"RS";"PAIM FILHO";111;4;22;137
2011;"PALMARES DO SUL (RS)";"RS";"PALMARES DO SUL";171;18;30;219
2011;"PALMEIRA DAS MISSOES (RS)";"RS";"PALMEIRA DAS MISSOES";892;22;85;999
2011;"PALMITINHO (RS)";"RS";"PALMITINHO";169;11;34;214
2011;"PANAMBI (RS)";"RS";"PANAMBI";952;59;112;1123
2011;"PANTANO GRANDE (RS)";"RS";"PANTANO GRANDE";293;6;23;322
2011;"PARAI (RS)";"RS";"PARAI";479;7;15;501
2011;"PARAISO DO SUL (RS)";"RS";"PARAISO DO SUL";87;7;11;105
2011;"PARECI NOVO (RS)";"RS";"PARECI NOVO";416;8;19;443
2011;"PAROBE (RS)";"RS";"PAROBE";502;61;148;711
2011;"PASSA SETE (RS)";"RS";"PASSA SETE";83;2;24;109
2011;"PASSO DO SOBRADO (RS)";"RS";"PASSO DO SOBRADO";127;5;42;174
2011;"PASSO FUNDO (RS)";"RS";"PASSO FUNDO";3227;213;353;3793
2011;"PAULO BENTO (RS)";"RS";"PAULO BENTO";76;13;9;98
2011;"PAVERAMA (RS)";"RS";"PAVERAMA";203;28;40;271
2011;"PEDRAS ALTAS (RS)";"RS";"PEDRAS ALTAS";14;17;1;32
2011;"PEDRO OSORIO (RS)";"RS";"PEDRO OSORIO";98;7;29;134
2011;"PEJUCARA (RS)";"RS";"PEJUCARA";221;3;19;243
2011;"PELOTAS (RS)";"RS";"PELOTAS";5099;300;1049;6448
2011;"PICADA CAFE (RS)";"RS";"PICADA CAFE";116;24;59;199
2011;"PINHAL (RS)";"RS";"PINHAL";76;2;9;87
2011;"PINHAL DA SERRA (RS)";"RS";"PINHAL DA SERRA";42;9;12;63
2011;"PINHAL GRANDE (RS)";"RS";"PINHAL GRANDE";110;13;20;143
2011;"PINHEIRINHO DO VALE (RS)";"RS";"PINHEIRINHO DO VALE";60;5;21;86
2011;"PINHEIRO MACHADO (RS)";"RS";"PINHEIRO MACHADO";134;8;55;197
2011;"PINTO BANDEIRA (RS)";"RS";"PINTO BANDEIRA";4;0;0;4
2011;"PIRAPO (RS)";"RS";"PIRAPO";41;8;7;56
2011;"PIRATINI (RS)";"RS";"PIRATINI";238;31;93;362
2011;"PLANALTO (RS)";"RS";"PLANALTO";189;5;30;224
2011;"POCO DAS ANTAS (RS)";"RS";"POCO DAS ANTAS";84;12;17;113
2011;"PONTAO (RS)";"RS";"PONTAO";102;4;18;124
2011;"PONTE PRETA (RS)";"RS";"PONTE PRETA";58;8;6;72
2011;"PORTAO (RS)";"RS";"PORTAO";1944;91;106;2141
2011;"PORTO ALEGRE (RS)";"RS";"PORTO ALEGRE";15284;2162;4690;22136
2011;"PORTO LUCENA (RS)";"RS";"PORTO LUCENA";88;12;16;116
2011;"PORTO MAUA (RS)";"RS";"PORTO MAUA";53;5;6;64
2011;"PORTO VERA CRUZ (RS)";"RS";"PORTO VERA CRUZ";10;1;8;19
2011;"PORTO XAVIER (RS)";"RS";"PORTO XAVIER";196;11;31;238
2011;"POUSO NOVO (RS)";"RS";"POUSO NOVO";38;6;5;49
2011;"PRESIDENTE LUCENA (RS)";"RS";"PRESIDENTE LUCENA";144;4;16;164
2011;"PROGRESSO (RS)";"RS";"PROGRESSO";97;14;22;133
2011;"PROTASIO ALVES (RS)";"RS";"PROTASIO ALVES";53;6;4;63
2011;"PUTINGA (RS)";"RS";"PUTINGA";103;13;13;129
2011;"QUARAI (RS)";"RS";"QUARAI";166;13;47;226
2011;"QUATRO IRMAOS (RS)";"RS";"QUATRO IRMAOS";50;10;5;65
2011;"QUEVEDOS (RS)";"RS";"QUEVEDOS";31;4;6;41
2011;"QUINZE DE NOVEMBRO (RS)";"RS";"QUINZE DE NOVEMBRO";172;17;23;212
2011;"REDENTORA (RS)";"RS";"REDENTORA";97;15;17;129
2011;"RELVADO (RS)";"RS";"RELVADO";44;12;4;60
2011;"RESTINGA SECA (RS)";"RS";"RESTINGA SECA";301;8;49;358
2011;"RIO DOS INDIOS (RS)";"RS";"RIO DOS INDIOS";68;4;30;102
2011;"RIO GRANDE (RS)";"RS";"RIO GRANDE";2147;172;586;2905
2011;"RIO PARDO (RS)";"RS";"RIO PARDO";427;36;70;533
2011;"RIOZINHO (RS)";"RS";"RIOZINHO";47;3;29;79
2011;"ROCA SALES (RS)";"RS";"ROCA SALES";156;22;41;219
2011;"RODEIO BONITO (RS)";"RS";"RODEIO BONITO";117;8;26;151
2011;"ROLADOR (RS)";"RS";"ROLADOR";59;4;6;69
2011;"ROLANTE (RS)";"RS";"ROLANTE";239;26;67;332
2011;"RONDA ALTA (RS)";"RS";"RONDA ALTA";266;13;26;305
2011;"RONDINHA (RS)";"RS";"RONDINHA";181;10;18;209
2011;"ROQUE GONZALES (RS)";"RS";"ROQUE GONZALES";132;4;19;155
2011;"ROSARIO DO SUL (RS)";"RS";"ROSARIO DO SUL";472;33;74;579
2011;"SAGRADA FAMILIA (RS)";"RS";"SAGRADA FAMILIA";31;5;5;41
2011;"SALDANHA MARINHO (RS)";"RS";"SALDANHA MARINHO";156;11;5;172
2011;"SALTO DO JACUI (RS)";"RS";"SALTO DO JACUI";186;17;30;233
2011;"SALVADOR DAS MISSOES (RS)";"RS";"SALVADOR DAS MISSOES";108;2;3;113
2011;"SALVADOR DO SUL (RS)";"RS";"SALVADOR DO SUL";270;29;26;325
2011;"SANANDUVA (RS)";"RS";"SANANDUVA";603;24;50;677
2011;"SANTA BARBARA DO SUL (RS)";"RS";"SANTA BARBARA DO SUL";339;18;35;392
2011;"SANTA CECILIA DO SUL (RS)";"RS";"SANTA CECILIA DO SUL";53;5;14;72
2011;"SANTA CLARA DO SUL (RS)";"RS";"SANTA CLARA DO SUL";129;24;12;165
2011;"SANTA CRUZ DO SUL (RS)";"RS";"SANTA CRUZ DO SUL";2113;154;581;2848
2011;"SANTA MARGARIDA DO SUL (RS)";"RS";"SANTA MARGARIDA DO SUL";42;3;2;47
2011;"SANTA MARIA (RS)";"RS";"SANTA MARIA";3206;361;963;4530
2011;"SANTA MARIA DO HERVAL (RS)";"RS";"SANTA MARIA DO HERVAL";216;13;50;279
2011;"SANTA ROSA (RS)";"RS";"SANTA ROSA";1470;84;161;1715
2011;"SANTA TEREZA (RS)";"RS";"SANTA TEREZA";82;4;5;91
2011;"SANTA VITORIA DO PALMAR (RS)";"RS";"SANTA VITORIA DO PALMAR";511;10;57;578
2011;"SANTANA DA BOA VISTA (RS)";"RS";"SANTANA DA BOA VISTA";73;8;33;114
2011;"SANTANA DO LIVRAMENTO (RS)";"RS";"SANTANA DO LIVRAMENTO";686;66;188;940
2011;"SANTIAGO (RS)";"RS";"SANTIAGO";796;67;93;956
2011;"SANTO ANGELO (RS)";"RS";"SANTO ANGELO";1174;85;101;1360
2011;"SANTO ANTONIO DA PATRULHA (RS)";"RS";"SANTO ANTONIO DA PATRULHA";896;39;166;1101
2011;"SANTO ANTONIO DAS MISSOES (RS)";"RS";"SANTO ANTONIO DAS MISSOES";157;30;28;215
2011;"SANTO ANTONIO DO PALMA (RS)";"RS";"SANTO ANTONIO DO PALMA";50;3;7;60
2011;"SANTO ANTONIO DO PLANALTO (RS)";"RS";"SANTO ANTONIO DO PLANALTO";91;3;8;102
2011;"SANTO AUGUSTO (RS)";"RS";"SANTO AUGUSTO";494;40;30;564
2011;"SANTO CRISTO (RS)";"RS";"SANTO CRISTO";453;21;45;519
2011;"SANTO EXPEDITO DO SUL (RS)";"RS";"SANTO EXPEDITO DO SUL";86;2;10;98
2011;"SAO BORJA (RS)";"RS";"SAO BORJA";1067;61;97;1225
2011;"SAO DOMINGOS DO SUL (RS)";"RS";"SAO DOMINGOS DO SUL";91;8;3;102
2011;"SAO FRANCISCO DE ASSIS (RS)";"RS";"SAO FRANCISCO DE ASSIS";279;18;88;385
2011;"SAO FRANCISCO DE PAULA (RS)";"RS";"SAO FRANCISCO DE PAULA";505;33;64;602
2011;"SAO GABRIEL (RS)";"RS";"SAO GABRIEL";839;26;105;970
2011;"SAO JERONIMO (RS)";"RS";"SAO JERONIMO";259;23;113;395
2011;"SAO JOAO DA URTIGA (RS)";"RS";"SAO JOAO DA URTIGA";145;4;20;169
2011;"SAO JOAO DO POLESINE (RS)";"RS";"SAO JOAO DO POLESINE";66;1;6;73
2011;"SAO JORGE (RS)";"RS";"SAO JORGE";132;4;20;156
2011;"SAO JOSE DAS MISSOES (RS)";"RS";"SAO JOSE DAS MISSOES";47;2;9;58
2011;"SAO JOSE DO HERVAL (RS)";"RS";"SAO JOSE DO HERVAL";71;4;13;88
2011;"SAO JOSE DO HORTENCIO (RS)";"RS";"SAO JOSE DO HORTENCIO";180;11;30;221
2011;"SAO JOSE DO INHACORA (RS)";"RS";"SAO JOSE DO INHACORA";40;5;5;50
2011;"SAO JOSE DO NORTE (RS)";"RS";"SAO JOSE DO NORTE";307;10;64;381
2011;"SAO JOSE DO OURO (RS)";"RS";"SAO JOSE DO OURO";300;5;37;342
2011;"SAO JOSE DO SUL (RS)";"RS";"SAO JOSE DO SUL";132;11;8;151
2011;"SAO JOSE DOS AUSENTES (RS)";"RS";"SAO JOSE DOS AUSENTES";101;7;12;120
2011;"SAO LEOPOLDO (RS)";"RS";"SAO LEOPOLDO";1980;233;547;2760
2011;"SAO LOURENCO DO SUL (RS)";"RS";"SAO LOURENCO DO SUL";885;44;133;1062
2011;"SAO LUIZ GONZAGA (RS)";"RS";"SAO LUIZ GONZAGA";590;47;80;717
2011;"SAO MARCOS (RS)";"RS";"SAO MARCOS";679;13;107;799
2011;"SAO MARTINHO (RS)";"RS";"SAO MARTINHO";181;13;17;211
2011;"SAO MARTINHO DA SERRA (RS)";"RS";"SAO MARTINHO DA SERRA";43;2;3;48
2011;"SAO MIGUEL DAS MISSOES (RS)";"RS";"SAO MIGUEL DAS MISSOES";211;22;31;264
2011;"SAO NICOLAU (RS)";"RS";"SAO NICOLAU";67;11;12;90
2011;"SAO PAULO DAS MISSOES (RS)";"RS";"SAO PAULO DAS MISSOES";104;9;27;140
2011;"SAO PEDRO DA SERRA (RS)";"RS";"SAO PEDRO DA SERRA";105;9;10;124
2011;"SAO PEDRO DAS MISSOES (RS)";"RS";"SAO PEDRO DAS MISSOES";34;6;5;45
2011;"SAO PEDRO DO BUTIA (RS)";"RS";"SAO PEDRO DO BUTIA";102;1;10;113
2011;"SAO PEDRO DO SUL (RS)";"RS";"SAO PEDRO DO SUL";287;44;34;365
2011;"SAO SEBASTIAO DO CAI (RS)";"RS";"SAO SEBASTIAO DO CAI";715;26;65;806
2011;"SAO SEPE (RS)";"RS";"SAO SEPE";417;39;95;551
2011;"SAO VALENTIM (RS)";"RS";"SAO VALENTIM";63;12;12;87
2011;"SAO VALENTIM DO SUL (RS)";"RS";"SAO VALENTIM DO SUL";82;4;7;93
2011;"SAO VALERIO DO SUL (RS)";"RS";"SAO VALERIO DO SUL";41;4;5;50
2011;"SAO VENDELINO (RS)";"RS";"SAO VENDELINO";80;13;7;100
2011;"SAO VICENTE DO SUL (RS)";"RS";"SAO VICENTE DO SUL";128;4;42;174
2011;"SAPIRANGA (RS)";"RS";"SAPIRANGA";836;106;148;1090
2011;"SAPUCAIA DO SUL (RS)";"RS";"SAPUCAIA DO SUL";1578;118;122;1818
2011;"SARANDI (RS)";"RS";"SARANDI";575;37;69;681
2011;"SEBERI (RS)";"RS";"SEBERI";255;8;38;301
2011;"SEDE NOVA (RS)";"RS";"SEDE NOVA";74;9;11;94
2011;"SEGREDO (RS)";"RS";"SEGREDO";147;3;39;189
2011;"SELBACH (RS)";"RS";"SELBACH";290;11;18;319
2011;"SENADOR SALGADO FILHO (RS)";"RS";"SENADOR SALGADO FILHO";119;8;9;136
2011;"SENTINELA DO SUL (RS)";"RS";"SENTINELA DO SUL";132;3;14;149
2011;"SERAFINA CORREA (RS)";"RS";"SERAFINA CORREA";313;45;50;408
2011;"SERIO (RS)";"RS";"SERIO";51;8;4;63
2011;"SERTAO (RS)";"RS";"SERTAO";230;11;27;268
2011;"SERTAO SANTANA (RS)";"RS";"SERTAO SANTANA";165;8;27;200
2011;"SETE DE SETEMBRO (RS)";"RS";"SETE DE SETEMBRO";63;2;10;75
2011;"SEVERIANO DE ALMEIDA (RS)";"RS";"SEVERIANO DE ALMEIDA";101;17;9;127
2011;"SILVEIRA MARTINS (RS)";"RS";"SILVEIRA MARTINS";129;1;5;135
2011;"SINIMBU (RS)";"RS";"SINIMBU";136;2;5;143
2011;"SOBRADINHO (RS)";"RS";"SOBRADINHO";303;16;58;377
2011;"SOLEDADE (RS)";"RS";"SOLEDADE";541;20;106;667
2011;"TABAI (RS)";"RS";"TABAI";198;22;9;229
2011;"TAPEJARA (RS)";"RS";"TAPEJARA";729;25;79;833
2011;"TAPERA (RS)";"RS";"TAPERA";344;21;26;391
2011;"TAPES (RS)";"RS";"TAPES";279;16;33;328
2011;"TAQUARA (RS)";"RS";"TAQUARA";752;60;242;1054
2011;"TAQUARI (RS)";"RS";"TAQUARI";446;32;131;609
2011;"TAQUARUCU DO SUL (RS)";"RS";"TAQUARUCU DO SUL";72;1;13;86
2011;"TAVARES (RS)";"RS";"TAVARES";124;4;17;145
2011;"TENENTE PORTELA (RS)";"RS";"TENENTE PORTELA";263;10;43;316
2011;"TERRA DE AREIA (RS)";"RS";"TERRA DE AREIA";307;8;26;341
2011;"TEUTONIA (RS)";"RS";"TEUTONIA";652;36;85;773
2011;"TIO HUGO (RS)";"RS";"TIO HUGO";106;5;12;123
2011;"TIRADENTES DO SUL (RS)";"RS";"TIRADENTES DO SUL";84;8;12;104
2011;"TOROPI (RS)";"RS";"TOROPI";52;2;19;73
2011;"TORRES (RS)";"RS";"TORRES";411;29;60;500
2011;"TRAMANDAI (RS)";"RS";"TRAMANDAI";602;60;134;796
2011;"TRAVESSEIRO (RS)";"RS";"TRAVESSEIRO";49;8;9;66
2011;"TRES ARROIOS (RS)";"RS";"TRES ARROIOS";99;12;3;114
2011;"TRES CACHOEIRAS (RS)";"RS";"TRES CACHOEIRAS";610;11;19;640
2011;"TRES COROAS (RS)";"RS";"TRES COROAS";257;32;61;350
2011;"TRES DE MAIO (RS)";"RS";"TRES DE MAIO";677;44;74;795
2011;"TRES FORQUILHAS (RS)";"RS";"TRES FORQUILHAS";89;3;2;94
2011;"TRES PALMEIRAS (RS)";"RS";"TRES PALMEIRAS";71;5;19;95
2011;"TRES PASSOS (RS)";"RS";"TRES PASSOS";392;22;119;533
2011;"TRINDADE DO SUL (RS)";"RS";"TRINDADE DO SUL";118;11;25;154
2011;"TRIUNFO (RS)";"RS";"TRIUNFO";504;130;173;807
2011;"TUCUNDUVA (RS)";"RS";"TUCUNDUVA";220;13;12;245
2011;"TUNAS (RS)";"RS";"TUNAS";47;3;17;67
2011;"TUPANCI DO SUL (RS)";"RS";"TUPANCI DO SUL";50;3;14;67
2011;"TUPANCIRETA (RS)";"RS";"TUPANCIRETA";513;48;47;608
2011;"TUPANDI (RS)";"RS";"TUPANDI";115;24;28;167
2011;"TUPARENDI (RS)";"RS";"TUPARENDI";240;12;25;277
2011;"TURUCU (RS)";"RS";"TURUCU";91;6;11;108
2011;"UBIRETAMA (RS)";"RS";"UBIRETAMA";85;10;3;98
2011;"UNIAO DA SERRA (RS)";"RS";"UNIAO DA SERRA";59;3;9;71
2011;"UNISTALDA (RS)";"RS";"UNISTALDA";31;10;17;58
2011;"URUGUAIANA (RS)";"RS";"URUGUAIANA";1748;80;163;1991
2011;"VACARIA (RS)";"RS";"VACARIA";1650;130;448;2228
2011;"VALE DO SOL (RS)";"RS";"VALE DO SOL";186;8;37;231
2011;"VALE REAL (RS)";"RS";"VALE REAL";218;12;9;239
2011;"VALE VERDE (RS)";"RS";"VALE VERDE";53;5;5;63
2011;"VANINI (RS)";"RS";"VANINI";89;11;11;111
2011;"VENANCIO AIRES (RS)";"RS";"VENANCIO AIRES";1137;74;176;1387
2011;"VERA CRUZ (RS)";"RS";"VERA CRUZ";383;23;100;506
2011;"VERANOPOLIS (RS)";"RS";"VERANOPOLIS";902;42;54;998
2011;"VESPASIANO CORREA (RS)";"RS";"VESPASIANO CORREA";93;5;10;108
2011;"VIADUTOS (RS)";"RS";"VIADUTOS";130;13;23;166
2011;"VIAMAO (RS)";"RS";"VIAMAO";1973;294;634;2901
2011;"VICENTE DUTRA (RS)";"RS";"VICENTE DUTRA";49;2;17;68
2011;"VICTOR GRAEFF (RS)";"RS";"VICTOR GRAEFF";156;14;5;175
2011;"VILA FLORES (RS)";"RS";"VILA FLORES";170;13;12;195
2011;"VILA LANGARO (RS)";"RS";"VILA LANGARO";98;5;10;113
2011;"VILA MARIA (RS)";"RS";"VILA MARIA";243;8;41;292
2011;"VILA NOVA DO SUL (RS)";"RS";"VILA NOVA DO SUL";93;6;12;111
2011;"VISTA ALEGRE (RS)";"RS";"VISTA ALEGRE";57;4;9;70
2011;"VISTA ALEGRE DO PRATA (RS)";"RS";"VISTA ALEGRE DO PRATA";41;8;3;52
2011;"VISTA GAUCHA (RS)";"RS";"VISTA GAUCHA";66;1;10;77
2011;"VITORIA DAS MISSOES (RS)";"RS";"VITORIA DAS MISSOES";96;0;12;108
2011;"WESTFALIA (RS)";"RS";"WESTFALIA";123;18;13;154
2011;"XANGRI LA (RS)";"RS";"XANGRI LA";163;15;12;190
2011;"ABDON BATISTA (SC)";"SC";"ABDON BATISTA";53;5;8;66
2011;"ABELARDO LUZ (SC)";"SC";"ABELARDO LUZ";358;12;77;447
2011;"AGROLANDIA (SC)";"SC";"AGROLANDIA";226;16;13;255
2011;"AGRONOMICA (SC)";"SC";"AGRONOMICA";149;4;12;165
2011;"AGUA DOCE (SC)";"SC";"AGUA DOCE";183;22;21;226
2011;"AGUAS DE CHAPECO (SC)";"SC";"AGUAS DE CHAPECO";74;8;20;102
2011;"AGUAS FRIAS (SC)";"SC";"AGUAS FRIAS";45;5;5;55
2011;"AGUAS MORNAS (SC)";"SC";"AGUAS MORNAS";264;6;16;286
2011;"ALFREDO WAGNER (SC)";"SC";"ALFREDO WAGNER";242;22;13;277
2011;"ALTO BELA VISTA (SC)";"SC";"ALTO BELA VISTA";56;8;8;72
2011;"ANCHIETA (SC)";"SC";"ANCHIETA";205;14;17;236
2011;"ANGELINA (SC)";"SC";"ANGELINA";214;20;13;247
2011;"ANITA GARIBALDI (SC)";"SC";"ANITA GARIBALDI";137;10;25;172
2011;"ANITAPOLIS (SC)";"SC";"ANITAPOLIS";90;8;11;109
2011;"ANTONIO CARLOS (SC)";"SC";"ANTONIO CARLOS";558;10;13;581
2011;"APIUNA (SC)";"SC";"APIUNA";156;23;20;199
2011;"ARABUTA (SC)";"SC";"ARABUTA";108;9;31;148
2011;"ARAQUARI (SC)";"SC";"ARAQUARI";484;41;45;570
2011;"ARARANGUA (SC)";"SC";"ARARANGUA";1305;61;163;1529
2011;"ARMAZEM (SC)";"SC";"ARMAZEM";256;15;14;285
2011;"ARROIO TRINTA (SC)";"SC";"ARROIO TRINTA";169;13;12;194
2011;"ARVOREDO (SC)";"SC";"ARVOREDO";36;14;6;56
2011;"ASCURRA (SC)";"SC";"ASCURRA";212;16;24;252
2011;"ATALANTA (SC)";"SC";"ATALANTA";92;3;5;100
2011;"AURORA (SC)";"SC";"AURORA";183;5;9;197
2011;"BALNEARIO ARROIO DO SILVA (SC)";"SC";"BALNEARIO ARROIO DO SILVA";111;8;6;125
2011;"BALNEARIO BARRA DO SUL (SC)";"SC";"BALNEARIO BARRA DO SUL";123;11;6;140
2011;"BALNEARIO CAMBORIU (SC)";"SC";"BALNEARIO CAMBORIU";944;243;286;1473
2011;"BALNEARIO DE PICARRAS (SC)";"SC";"BALNEARIO DE PICARRAS";313;30;32;375
2011;"BALNEARIO GAIVOTA (SC)";"SC";"BALNEARIO GAIVOTA";147;7;16;170
2011;"BANDEIRANTE (SC)";"SC";"BANDEIRANTE";34;4;13;51
2011;"BARRA BONITA (SC)";"SC";"BARRA BONITA";33;4;10;47
2011;"BARRA VELHA (SC)";"SC";"BARRA VELHA";414;30;29;473
2011;"BELA VISTA DO TOLDO (SC)";"SC";"BELA VISTA DO TOLDO";91;9;32;132
2011;"BELMONTE (SC)";"SC";"BELMONTE";51;7;9;67
2011;"BENEDITO NOVO (SC)";"SC";"BENEDITO NOVO";283;35;21;339
2011;"BIGUACU (SC)";"SC";"BIGUACU";991;54;129;1174
2011;"BLUMENAU (SC)";"SC";"BLUMENAU";5082;396;771;6249
2011;"BOCAINA DO SUL (SC)";"SC";"BOCAINA DO SUL";49;3;15;67
2011;"BOM JARDIM DA SERRA (SC)";"SC";"BOM JARDIM DA SERRA";92;10;20;122
2011;"BOM JESUS (SC)";"SC";"BOM JESUS";51;3;8;62
2011;"BOM JESUS DO OESTE (SC)";"SC";"BOM JESUS DO OESTE";52;2;8;62
2011;"BOM RETIRO (SC)";"SC";"BOM RETIRO";172;19;29;220
2011;"BOMBINHAS (SC)";"SC";"BOMBINHAS";128;42;24;194
2011;"BOTUVERA (SC)";"SC";"BOTUVERA";227;8;14;249
2011;"BRACO DO NORTE (SC)";"SC";"BRACO DO NORTE";1007;49;62;1118
2011;"BRACO DO TROMBUDO (SC)";"SC";"BRACO DO TROMBUDO";122;6;1;129
2011;"BRUNOPOLIS (SC)";"SC";"BRUNOPOLIS";73;5;9;87
2011;"BRUSQUE (SC)";"SC";"BRUSQUE";2263;140;178;2581
2011;"CACADOR (SC)";"SC";"CACADOR";1925;97;762;2784
2011;"CAIBI (SC)";"SC";"CAIBI";170;7;25;202
2011;"CALMON (SC)";"SC";"CALMON";29;5;19;53
2011;"CAMBORIU (SC)";"SC";"CAMBORIU";1005;50;27;1082
2011;"CAMPO ALEGRE (SC)";"SC";"CAMPO ALEGRE";380;15;10;405
2011;"CAMPO BELO DO SUL (SC)";"SC";"CAMPO BELO DO SUL";180;10;27;217
2011;"CAMPO ERE (SC)";"SC";"CAMPO ERE";225;9;25;259
2011;"CAMPOS NOVOS (SC)";"SC";"CAMPOS NOVOS";931;63;97;1091
2011;"CANELINHA (SC)";"SC";"CANELINHA";499;20;8;527
2011;"CANOINHAS (SC)";"SC";"CANOINHAS";1202;49;117;1368
2011;"CAPAO ALTO (SC)";"SC";"CAPAO ALTO";57;6;14;77
2011;"CAPINZAL (SC)";"SC";"CAPINZAL";399;31;40;470
2011;"CAPIVARI DE BAIXO (SC)";"SC";"CAPIVARI DE BAIXO";348;16;27;391
2011;"CATANDUVAS (SC)";"SC";"CATANDUVAS";305;29;45;379
2011;"CAXAMBU DO SUL (SC)";"SC";"CAXAMBU DO SUL";97;3;17;117
2011;"CELSO RAMOS (SC)";"SC";"CELSO RAMOS";53;3;4;60
2011;"CERRO NEGRO (SC)";"SC";"CERRO NEGRO";43;6;15;64
2011;"CHAPADAO DO LAGEADO (SC)";"SC";"CHAPADAO DO LAGEADO";44;5;8;57
2011;"CHAPECO (SC)";"SC";"CHAPECO";4022;263;340;4625
2011;"COCAL DO SUL (SC)";"SC";"COCAL DO SUL";280;21;19;320
2011;"CONCORDIA (SC)";"SC";"CONCORDIA";2216;130;169;2515
2011;"CORDILHEIRA ALTA (SC)";"SC";"CORDILHEIRA ALTA";266;11;4;281
2011;"CORONEL FREITAS (SC)";"SC";"CORONEL FREITAS";237;11;22;270
2011;"CORONEL MARTINS (SC)";"SC";"CORONEL MARTINS";44;8;12;64
2011;"CORREIA PINTO (SC)";"SC";"CORREIA PINTO";344;33;56;433
2011;"CORUPA (SC)";"SC";"CORUPA";354;7;34;395
2011;"CRICIUMA (SC)";"SC";"CRICIUMA";3476;286;391;4153
2011;"CUNHA PORA (SC)";"SC";"CUNHA PORA";349;12;46;407
2011;"CUNHATAI (SC)";"SC";"CUNHATAI";31;3;8;42
2011;"CURITIBANOS (SC)";"SC";"CURITIBANOS";913;55;99;1067
2011;"DESCANSO (SC)";"SC";"DESCANSO";205;15;24;244
2011;"DIONISIO CERQUEIRA (SC)";"SC";"DIONISIO CERQUEIRA";145;18;19;182
2011;"DONA EMMA (SC)";"SC";"DONA EMMA";115;13;9;137
2011;"DOUTOR PEDRINHO (SC)";"SC";"DOUTOR PEDRINHO";123;7;6;136
2011;"ENTRE RIOS (SC)";"SC";"ENTRE RIOS";28;4;14;46
2011;"ERMO (SC)";"SC";"ERMO";71;3;7;81
2011;"ERVAL VELHO (SC)";"SC";"ERVAL VELHO";94;5;21;120
2011;"FAXINAL DOS GUEDES (SC)";"SC";"FAXINAL DOS GUEDES";380;19;31;430
2011;"FLOR DO SERTAO (SC)";"SC";"FLOR DO SERTAO";18;8;17;43
2011;"FLORIANOPOLIS (SC)";"SC";"FLORIANOPOLIS";3371;841;1736;5948
2011;"FORMOSA DO SUL (SC)";"SC";"FORMOSA DO SUL";61;6;13;80
2011;"FORQUILHINHA (SC)";"SC";"FORQUILHINHA";490;16;35;541
2011;"FRAIBURGO (SC)";"SC";"FRAIBURGO";806;40;201;1047
2011;"FREI ROGERIO (SC)";"SC";"FREI ROGERIO";66;12;13;91
2011;"GALVAO (SC)";"SC";"GALVAO";80;4;18;102
2011;"GAROPABA (SC)";"SC";"GAROPABA";227;21;36;284
2011;"GARUVA (SC)";"SC";"GARUVA";396;24;19;439
2011;"GASPAR (SC)";"SC";"GASPAR";1265;56;76;1397
2011;"GOVERNADOR CELSO RAMOS (SC)";"SC";"GOVERNADOR CELSO RAMOS";149;18;14;181
2011;"GRAO PARA (SC)";"SC";"GRAO PARA";247;7;8;262
2011;"GRAVATAL (SC)";"SC";"GRAVATAL";267;14;16;297
2011;"GUABIRUBA (SC)";"SC";"GUABIRUBA";313;14;17;344
2011;"GUARACIABA (SC)";"SC";"GUARACIABA";212;12;35;259
2011;"GUARAMIRIM (SC)";"SC";"GUARAMIRIM";1022;31;26;1079
2011;"GUARUJA DO SUL (SC)";"SC";"GUARUJA DO SUL";156;8;15;179
2011;"GUATAMBU (SC)";"SC";"GUATAMBU";83;9;20;112
2011;"HERVAL D OESTE (SC)";"SC";"HERVAL D OESTE";294;32;56;382
2011;"IBIAM (SC)";"SC";"IBIAM";63;3;13;79
2011;"IBICARE (SC)";"SC";"IBICARE";135;8;8;151
2011;"IBIRAMA (SC)";"SC";"IBIRAMA";425;44;66;535
2011;"ICARA (SC)";"SC";"ICARA";1650;83;119;1852
2011;"ILHOTA (SC)";"SC";"ILHOTA";320;23;17;360
2011;"IMARUI (SC)";"SC";"IMARUI";110;24;27;161
2011;"IMBITUBA (SC)";"SC";"IMBITUBA";607;70;75;752
2011;"IMBUIA (SC)";"SC";"IMBUIA";174;9;19;202
2011;"INDAIAL (SC)";"SC";"INDAIAL";1285;82;101;1468
2011;"IOMERE (SC)";"SC";"IOMERE";148;7;8;163
2011;"IPIRA (SC)";"SC";"IPIRA";107;9;13;129
2011;"IPORA DO OESTE (SC)";"SC";"IPORA DO OESTE";245;17;51;313
2011;"IPUACU (SC)";"SC";"IPUACU";93;11;15;119
2011;"IPUMIRIM (SC)";"SC";"IPUMIRIM";227;37;26;290
2011;"IRACEMINHA (SC)";"SC";"IRACEMINHA";98;4;20;122
2011;"IRANI (SC)";"SC";"IRANI";312;25;52;389
2011;"IRATI (SC)";"SC";"IRATI";24;7;9;40
2011;"IRINEOPOLIS (SC)";"SC";"IRINEOPOLIS";236;6;9;251
2011;"ITA (SC)";"SC";"ITA";91;16;31;138
2011;"ITAIOPOLIS (SC)";"SC";"ITAIOPOLIS";553;27;75;655
2011;"ITAJAI (SC)";"SC";"ITAJAI";4090;267;337;4694
2011;"ITAPEMA (SC)";"SC";"ITAPEMA";511;50;40;601
2011;"ITAPIRANGA (SC)";"SC";"ITAPIRANGA";292;21;56;369
2011;"ITAPOA (SC)";"SC";"ITAPOA";173;7;12;192
2011;"ITUPORANGA (SC)";"SC";"ITUPORANGA";654;27;46;727
2011;"JABORA (SC)";"SC";"JABORA";124;14;23;161
2011;"JACINTO MACHADO (SC)";"SC";"JACINTO MACHADO";379;13;33;425
2011;"JAGUARUNA (SC)";"SC";"JAGUARUNA";433;19;45;497
2011;"JARAGUA DO SUL (SC)";"SC";"JARAGUA DO SUL";2382;200;346;2928
2011;"JARDINOPOLIS (SC)";"SC";"JARDINOPOLIS";18;4;3;25
2011;"JOACABA (SC)";"SC";"JOACABA";863;75;38;976
2011;"JOINVILLE (SC)";"SC";"JOINVILLE";7915;642;833;9390
2011;"JOSE BOITEUX (SC)";"SC";"JOSE BOITEUX";116;22;6;144
2011;"JUPIA (SC)";"SC";"JUPIA";39;5;6;50
2011;"LACERDOPOLIS (SC)";"SC";"LACERDOPOLIS";105;5;5;115
2011;"LAGEADO GRANDE (SC)";"SC";"LAGEADO GRANDE";36;2;4;42
2011;"LAGES (SC)";"SC";"LAGES";3278;224;357;3859
2011;"LAGUNA (SC)";"SC";"LAGUNA";556;80;96;732
2011;"LAURENTINO (SC)";"SC";"LAURENTINO";301;6;5;312
2011;"LAURO MULLER (SC)";"SC";"LAURO MULLER";461;23;47;531
2011;"LEBON REGIS (SC)";"SC";"LEBON REGIS";203;18;37;258
2011;"LEOBERTO LEAL (SC)";"SC";"LEOBERTO LEAL";119;11;6;136
2011;"LINDOIA DO SUL (SC)";"SC";"LINDOIA DO SUL";144;11;40;195
2011;"LONTRAS (SC)";"SC";"LONTRAS";299;21;28;348
2011;"LUIZ ALVES (SC)";"SC";"LUIZ ALVES";445;6;18;469
2011;"LUZERNA (SC)";"SC";"LUZERNA";132;8;17;157
2011;"MACIEIRA (SC)";"SC";"MACIEIRA";69;6;11;86
2011;"MAFRA (SC)";"SC";"MAFRA";1261;88;141;1490
2011;"MAJOR GERCINO (SC)";"SC";"MAJOR GERCINO";120;8;10;138
2011;"MAJOR VIEIRA (SC)";"SC";"MAJOR VIEIRA";182;4;10;196
2011;"MARACAJA (SC)";"SC";"MARACAJA";215;1;13;229
2011;"MARAVILHA (SC)";"SC";"MARAVILHA";668;56;61;785
2011;"MAREMA (SC)";"SC";"MAREMA";57;8;7;72
2011;"MASSARANDUBA (SC)";"SC";"MASSARANDUBA";516;18;36;570
2011;"MATOS COSTA (SC)";"SC";"MATOS COSTA";38;5;10;53
2011;"MELEIRO (SC)";"SC";"MELEIRO";268;3;21;292
2011;"MIRIM DOCE (SC)";"SC";"MIRIM DOCE";52;2;10;64
2011;"MODELO (SC)";"SC";"MODELO";118;7;7;132
2011;"MONDAI (SC)";"SC";"MONDAI";191;9;49;249
2011;"MONTE CARLO (SC)";"SC";"MONTE CARLO";165;13;95;273
2011;"MONTE CASTELO (SC)";"SC";"MONTE CASTELO";162;10;17;189
2011;"MORRO DA FUMACA (SC)";"SC";"MORRO DA FUMACA";835;23;25;883
2011;"MORRO GRANDE (SC)";"SC";"MORRO GRANDE";107;2;7;116
2011;"NAVEGANTES (SC)";"SC";"NAVEGANTES";642;67;52;761
2011;"NOVA ERECHIM (SC)";"SC";"NOVA ERECHIM";100;7;8;115
2011;"NOVA ITABERABA (SC)";"SC";"NOVA ITABERABA";89;3;19;111
2011;"NOVA TRENTO (SC)";"SC";"NOVA TRENTO";252;31;32;315
2011;"NOVA VENEZA (SC)";"SC";"NOVA VENEZA";402;30;33;465
2011;"NOVO HORIZONTE (SC)";"SC";"NOVO HORIZONTE";62;9;12;83
2011;"ORLEANS (SC)";"SC";"ORLEANS";844;21;44;909
2011;"OTACILIO COSTA (SC)";"SC";"OTACILIO COSTA";401;44;41;486
2011;"OURO (SC)";"SC";"OURO";243;30;26;299
2011;"OURO VERDE (SC)";"SC";"OURO VERDE";80;2;9;91
2011;"PAIAL (SC)";"SC";"PAIAL";12;4;22;38
2011;"PAINEL (SC)";"SC";"PAINEL";32;3;9;44
2011;"PALHOCA (SC)";"SC";"PALHOCA";2026;124;387;2537
2011;"PALMA SOLA (SC)";"SC";"PALMA SOLA";178;7;24;209
2011;"PALMEIRA (SC)";"SC";"PALMEIRA";87;4;4;95
2011;"PALMITOS (SC)";"SC";"PALMITOS";348;33;52;433
2011;"PAPANDUVA (SC)";"SC";"PAPANDUVA";514;18;72;604
2011;"PARAISO (SC)";"SC";"PARAISO";68;5;8;81
2011;"PASSO DE TORRES (SC)";"SC";"PASSO DE TORRES";119;5;13;137
2011;"PASSOS MAIA (SC)";"SC";"PASSOS MAIA";101;1;23;125
2011;"PAULO LOPES (SC)";"SC";"PAULO LOPES";230;15;11;256
2011;"PEDRAS GRANDES (SC)";"SC";"PEDRAS GRANDES";234;15;14;263
2011;"PENHA (SC)";"SC";"PENHA";323;24;40;387
2011;"PERITIBA (SC)";"SC";"PERITIBA";78;4;15;97
2011;"PETROLANDIA (SC)";"SC";"PETROLANDIA";152;13;23;188
2011;"PINHALZINHO (SC)";"SC";"PINHALZINHO";425;17;53;495
2011;"PINHEIRO PRETO (SC)";"SC";"PINHEIRO PRETO";272;9;15;296
2011;"PIRATUBA (SC)";"SC";"PIRATUBA";92;13;30;135
2011;"PLANALTO ALEGRE (SC)";"SC";"PLANALTO ALEGRE";54;5;4;63
2011;"POMERODE (SC)";"SC";"POMERODE";630;26;95;751
2011;"PONTE ALTA (SC)";"SC";"PONTE ALTA";117;6;12;135
2011;"PONTE ALTA DO NORTE (SC)";"SC";"PONTE ALTA DO NORTE";82;4;13;99
2011;"PONTE SERRADA (SC)";"SC";"PONTE SERRADA";316;35;78;429
2011;"PORTO BELO (SC)";"SC";"PORTO BELO";214;20;28;262
2011;"PORTO UNIAO (SC)";"SC";"PORTO UNIAO";562;22;33;617
2011;"POUSO REDONDO (SC)";"SC";"POUSO REDONDO";456;23;32;511
2011;"PRAIA GRANDE (SC)";"SC";"PRAIA GRANDE";204;12;21;237
2011;"PRESIDENTE CASTELO BRANCO (SC)";"SC";"PRESIDENTE CASTELO BRANCO";54;5;7;66
2011;"PRESIDENTE GETULIO (SC)";"SC";"PRESIDENTE GETULIO";326;30;62;418
2011;"PRESIDENTE NEREU (SC)";"SC";"PRESIDENTE NEREU";29;9;5;43
2011;"PRINCESA (SC)";"SC";"PRINCESA";52;3;10;65
2011;"QUILOMBO (SC)";"SC";"QUILOMBO";197;27;37;261
2011;"RANCHO QUEIMADO (SC)";"SC";"RANCHO QUEIMADO";127;3;5;135
2011;"RIO DAS ANTAS (SC)";"SC";"RIO DAS ANTAS";172;6;25;203
2011;"RIO DO CAMPO (SC)";"SC";"RIO DO CAMPO";164;12;16;192
2011;"RIO DO OESTE (SC)";"SC";"RIO DO OESTE";202;15;23;240
2011;"RIO DO SUL (SC)";"SC";"RIO DO SUL";1434;87;119;1640
2011;"RIO DOS CEDROS (SC)";"SC";"RIO DOS CEDROS";240;21;26;287
2011;"RIO FORTUNA (SC)";"SC";"RIO FORTUNA";255;7;15;277
2011;"RIO NEGRINHO (SC)";"SC";"RIO NEGRINHO";918;71;64;1053
2011;"RIO RUFINO (SC)";"SC";"RIO RUFINO";51;5;17;73
2011;"RIQUEZA (SC)";"SC";"RIQUEZA";117;5;22;144
2011;"RODEIO (SC)";"SC";"RODEIO";237;13;14;264
2011;"ROMELANDIA (SC)";"SC";"ROMELANDIA";92;7;23;122
2011;"SALETE (SC)";"SC";"SALETE";161;11;16;188
2011;"SALTINHO (SC)";"SC";"SALTINHO";44;6;14;64
2011;"SALTO VELOSO (SC)";"SC";"SALTO VELOSO";146;4;5;155
2011;"SANGAO (SC)";"SC";"SANGAO";451;12;17;480
2011;"SANTA CECILIA (SC)";"SC";"SANTA CECILIA";355;35;46;436
2011;"SANTA HELENA (SC)";"SC";"SANTA HELENA";56;11;11;78
2011;"SANTA ROSA DE LIMA (SC)";"SC";"SANTA ROSA DE LIMA";107;7;9;123
2011;"SANTA ROSA DO SUL (SC)";"SC";"SANTA ROSA DO SUL";259;13;16;288
2011;"SANTA TEREZINHA (SC)";"SC";"SANTA TEREZINHA";162;17;25;204
2011;"SANTA TEREZINHA DO PROGRESSO (SC)";"SC";"SANTA TEREZINHA DO PROGRESSO";41;6;10;57
2011;"SANTIAGO DO SUL (SC)";"SC";"SANTIAGO DO SUL";39;6;4;49
2011;"SANTO AMARO DA IMPERATRIZ (SC)";"SC";"SANTO AMARO DA IMPERATRIZ";597;30;69;696
2011;"SAO BENTO DO SUL (SC)";"SC";"SAO BENTO DO SUL";1482;118;155;1755
2011;"SAO BERNARDINO (SC)";"SC";"SAO BERNARDINO";36;3;19;58
2011;"SAO BONIFACIO (SC)";"SC";"SAO BONIFACIO";114;6;9;129
2011;"SAO CARLOS (SC)";"SC";"SAO CARLOS";186;17;41;244
2011;"SAO CRISTOVAO DO SUL (SC)";"SC";"SAO CRISTOVAO DO SUL";191;5;14;210
2011;"SAO DOMINGOS (SC)";"SC";"SAO DOMINGOS";291;20;37;348
2011;"SAO FRANCISCO DO SUL (SC)";"SC";"SAO FRANCISCO DO SUL";568;67;86;721
2011;"SAO JOAO BATISTA (SC)";"SC";"SAO JOAO BATISTA";573;14;43;630
2011;"SAO JOAO DO ITAPERIU (SC)";"SC";"SAO JOAO DO ITAPERIU";198;4;5;207
2011;"SAO JOAO DO OESTE (SC)";"SC";"SAO JOAO DO OESTE";146;10;15;171
2011;"SAO JOAO DO SUL (SC)";"SC";"SAO JOAO DO SUL";206;3;14;223
2011;"SAO JOAQUIM (SC)";"SC";"SAO JOAQUIM";824;69;160;1053
2011;"SAO JOSE (SC)";"SC";"SAO JOSE";3518;257;200;3975
2011;"SAO JOSE DO CEDRO (SC)";"SC";"SAO JOSE DO CEDRO";398;18;72;488
2011;"SAO JOSE DO CERRITO (SC)";"SC";"SAO JOSE DO CERRITO";174;6;36;216
2011;"SAO LOURENCO D OESTE (SC)";"SC";"SAO LOURENCO D OESTE";762;46;60;868
2011;"SAO LUDGERO (SC)";"SC";"SAO LUDGERO";530;10;25;565
2011;"SAO MARTINHO (SC)";"SC";"SAO MARTINHO";134;6;7;147
2011;"SAO MIGUEL D OESTE (SC)";"SC";"SAO MIGUEL D OESTE";969;57;101;1127
2011;"SAO MIGUEL DA BOA VISTA (SC)";"SC";"SAO MIGUEL DA BOA VISTA";16;2;11;29
2011;"SAO PEDRO DE ALCANTARA (SC)";"SC";"SAO PEDRO DE ALCANTARA";116;6;4;126
2011;"SAUDADES (SC)";"SC";"SAUDADES";190;7;29;226
2011;"SCHROEDER (SC)";"SC";"SCHROEDER";194;6;19;219
2011;"SEARA (SC)";"SC";"SEARA";382;52;67;501
2011;"SERRA ALTA (SC)";"SC";"SERRA ALTA";64;9;14;87
2011;"SIDEROPOLIS (SC)";"SC";"SIDEROPOLIS";405;26;70;501
2011;"SOMBRIO (SC)";"SC";"SOMBRIO";684;53;41;778
2011;"SUL BRASIL (SC)";"SC";"SUL BRASIL";41;3;12;56
2011;"TAIO (SC)";"SC";"TAIO";525;22;50;597
2011;"TANGARA (SC)";"SC";"TANGARA";385;13;40;438
2011;"TIGRINHOS (SC)";"SC";"TIGRINHOS";25;1;16;42
2011;"TIJUCAS (SC)";"SC";"TIJUCAS";843;47;46;936
2011;"TIMBE DO SUL (SC)";"SC";"TIMBE DO SUL";158;10;12;180
2011;"TIMBO (SC)";"SC";"TIMBO";642;46;47;735
2011;"TIMBO GRANDE (SC)";"SC";"TIMBO GRANDE";151;7;15;173
2011;"TRES BARRAS (SC)";"SC";"TRES BARRAS";254;29;51;334
2011;"TREVISO (SC)";"SC";"TREVISO";109;10;6;125
2011;"TREZE DE MAIO (SC)";"SC";"TREZE DE MAIO";388;7;16;411
2011;"TREZE TILIAS (SC)";"SC";"TREZE TILIAS";255;12;23;290
2011;"TROMBUDO CENTRAL (SC)";"SC";"TROMBUDO CENTRAL";201;18;20;239
2011;"TUBARAO (SC)";"SC";"TUBARAO";2317;87;385;2789
2011;"TUNAPOLIS (SC)";"SC";"TUNAPOLIS";94;9;18;121
2011;"TURVO (SC)";"SC";"TURVO";435;18;49;502
2011;"UNIAO DO OESTE (SC)";"SC";"UNIAO DO OESTE";45;4;15;64
2011;"URUBICI (SC)";"SC";"URUBICI";242;15;44;301
2011;"URUPEMA (SC)";"SC";"URUPEMA";56;10;10;76
2011;"URUSSANGA (SC)";"SC";"URUSSANGA";423;37;78;538
2011;"VARGEAO (SC)";"SC";"VARGEAO";125;2;10;137
2011;"VARGEM (SC)";"SC";"VARGEM";43;4;12;59
2011;"VARGEM BONITA (SC)";"SC";"VARGEM BONITA";138;10;22;170
2011;"VIDAL RAMOS (SC)";"SC";"VIDAL RAMOS";153;14;14;181
2011;"VIDEIRA (SC)";"SC";"VIDEIRA";1570;104;134;1808
2011;"VITOR MEIRELES (SC)";"SC";"VITOR MEIRELES";90;12;18;120
2011;"WITMARSUM (SC)";"SC";"WITMARSUM";102;11;12;125
2011;"XANXERE (SC)";"SC";"XANXERE";1217;111;118;1446
2011;"XAVANTINA (SC)";"SC";"XAVANTINA";145;14;5;164
2011;"XAXIM (SC)";"SC";"XAXIM";654;42;127;823
2011;"ZORTEA (SC)";"SC";"ZORTEA";38;8;3;49
2011;"AMPARO DE SAO FRANCISCO (SE)";"SE";"AMPARO DE SAO FRANCISCO";6;8;4;18
2011;"AQUIDABA (SE)";"SE";"AQUIDABA";120;13;51;184
2011;"ARACAJU (SE)";"SE";"ARACAJU";5416;916;1935;8267
2011;"ARAUA (SE)";"SE";"ARAUA";45;17;20;82
2011;"AREIA BRANCA (SE)";"SE";"AREIA BRANCA";128;12;16;156
2011;"BARRA DOS COQUEIROS (SE)";"SE";"BARRA DOS COQUEIROS";59;15;21;95
2011;"BOQUIM (SE)";"SE";"BOQUIM";191;16;22;229
2011;"BREJO GRANDE (SE)";"SE";"BREJO GRANDE";6;4;7;17
2011;"CAMPO DO BRITO (SE)";"SE";"CAMPO DO BRITO";298;19;66;383
2011;"CANHOBA (SE)";"SE";"CANHOBA";5;3;4;12
2011;"CANINDE DE SAO FRANCISCO (SE)";"SE";"CANINDE DE SAO FRANCISCO";134;66;27;227
2011;"CAPELA (SE)";"SE";"CAPELA";105;27;53;185
2011;"CARIRA (SE)";"SE";"CARIRA";200;36;94;330
2011;"CARMOPOLIS (SE)";"SE";"CARMOPOLIS";87;37;77;201
2011;"CEDRO DE SAO JOAO (SE)";"SE";"CEDRO DE SAO JOAO";16;6;5;27
2011;"CRISTINAPOLIS (SE)";"SE";"CRISTINAPOLIS";58;20;26;104
2011;"CUMBE (SE)";"SE";"CUMBE";25;8;16;49
2011;"DIVINA PASTORA (SE)";"SE";"DIVINA PASTORA";8;4;8;20
2011;"ESTANCIA (SE)";"SE";"ESTANCIA";426;152;193;771
2011;"FEIRA NOVA (SE)";"SE";"FEIRA NOVA";12;10;4;26
2011;"FREI PAULO (SE)";"SE";"FREI PAULO";102;22;27;151
2011;"GARARU (SE)";"SE";"GARARU";32;9;21;62
2011;"GENERAL MAYNARD (SE)";"SE";"GENERAL MAYNARD";10;12;19;41
2011;"GRACCHO CARDOSO (SE)";"SE";"GRACCHO CARDOSO";20;7;5;32
2011;"ILHA DAS FLORES (SE)";"SE";"ILHA DAS FLORES";10;8;8;26
2011;"INDIAROBA (SE)";"SE";"INDIAROBA";35;20;20;75
2011;"ITABAIANA (SE)";"SE";"ITABAIANA";2822;108;120;3050
2011;"ITABAIANINHA (SE)";"SE";"ITABAIANINHA";548;59;43;650
2011;"ITABI (SE)";"SE";"ITABI";14;4;6;24
2011;"ITAPORANGA D AJUDA (SE)";"SE";"ITAPORANGA D AJUDA";190;29;55;274
2011;"JAPARATUBA (SE)";"SE";"JAPARATUBA";44;17;42;103
2011;"JAPOATA (SE)";"SE";"JAPOATA";43;8;25;76
2011;"LAGARTO (SE)";"SE";"LAGARTO";856;129;174;1159
2011;"LARANJEIRAS (SE)";"SE";"LARANJEIRAS";110;38;39;187
2011;"MACAMBIRA (SE)";"SE";"MACAMBIRA";43;13;9;65
2011;"MALHADA DOS BOIS (SE)";"SE";"MALHADA DOS BOIS";10;7;5;22
2011;"MALHADOR (SE)";"SE";"MALHADOR";197;21;44;262
2011;"MARUIM (SE)";"SE";"MARUIM";45;20;26;91
2011;"MOITA BONITA (SE)";"SE";"MOITA BONITA";391;18;14;423
2011;"MONTE ALEGRE DE SERGIPE (SE)";"SE";"MONTE ALEGRE DE SERGIPE";108;21;21;150
2011;"MURIBECA (SE)";"SE";"MURIBECA";47;9;24;80
2011;"NEOPOLIS (SE)";"SE";"NEOPOLIS";42;15;19;76
2011;"NOSSA SENHORA APARECIDA (SE)";"SE";"NOSSA SENHORA APARECIDA";122;19;14;155
2011;"NOSSA SENHORA DA GLORIA (SE)";"SE";"NOSSA SENHORA DA GLORIA";400;41;92;533
2011;"NOSSA SENHORA DAS DORES (SE)";"SE";"NOSSA SENHORA DAS DORES";187;12;54;253
2011;"NOSSA SENHORA DE LOURDES (SE)";"SE";"NOSSA SENHORA DE LOURDES";24;1;6;31
2011;"NOSSA SENHORA DO SOCORRO (SE)";"SE";"NOSSA SENHORA DO SOCORRO";726;88;140;954
2011;"PACATUBA (SE)";"SE";"PACATUBA";115;6;32;153
2011;"PEDRA MOLE (SE)";"SE";"PEDRA MOLE";5;2;8;15
2011;"PEDRINHAS (SE)";"SE";"PEDRINHAS";55;4;9;68
2011;"PINHAO (SE)";"SE";"PINHAO";22;13;4;39
2011;"PIRAMBU (SE)";"SE";"PIRAMBU";21;4;14;39
2011;"POCO REDONDO (SE)";"SE";"POCO REDONDO";103;35;49;187
2011;"POCO VERDE (SE)";"SE";"POCO VERDE";83;26;130;239
2011;"PORTO DA FOLHA (SE)";"SE";"PORTO DA FOLHA";96;27;29;152
2011;"PROPRIA (SE)";"SE";"PROPRIA";209;34;50;293
2011;"RIACHAO DO DANTAS (SE)";"SE";"RIACHAO DO DANTAS";28;7;13;48
2011;"RIACHUELO (SE)";"SE";"RIACHUELO";32;9;10;51
2011;"RIBEIROPOLIS (SE)";"SE";"RIBEIROPOLIS";264;48;52;364
2011;"ROSARIO DO CATETE (SE)";"SE";"ROSARIO DO CATETE";32;20;12;64
2011;"SALGADO (SE)";"SE";"SALGADO";88;17;95;200
2011;"SANTA LUZIA DO ITANHY (SE)";"SE";"SANTA LUZIA DO ITANHY";18;11;10;39
2011;"SANTA ROSA DE LIMA (SE)";"SE";"SANTA ROSA DE LIMA";19;5;7;31
2011;"SANTANA DO SAO FRANCISCO (SE)";"SE";"SANTANA DO SAO FRANCISCO";8;3;8;19
2011;"SANTO AMARO DAS BROTAS (SE)";"SE";"SANTO AMARO DAS BROTAS";19;4;15;38
2011;"SAO CRISTOVAO (SE)";"SE";"SAO CRISTOVAO";330;70;149;549
2011;"SAO DOMINGOS (SE)";"SE";"SAO DOMINGOS";117;9;23;149
2011;"SAO FRANCISCO (SE)";"SE";"SAO FRANCISCO";14;4;25;43
2011;"SAO MIGUEL DO ALEIXO (SE)";"SE";"SAO MIGUEL DO ALEIXO";30;6;9;45
2011;"SIMAO DIAS (SE)";"SE";"SIMAO DIAS";228;48;176;452
2011;"SIRIRI (SE)";"SE";"SIRIRI";35;11;35;81
2011;"TELHA (SE)";"SE";"TELHA";9;4;2;15
2011;"TOBIAS BARRETO (SE)";"SE";"TOBIAS BARRETO";230;49;133;412
2011;"TOMAR DO GERU (SE)";"SE";"TOMAR DO GERU";40;6;14;60
2011;"UMBAUBA (SE)";"SE";"UMBAUBA";271;34;35;340
2011;"ADAMANTINA (SP)";"SP";"ADAMANTINA";663;56;81;800
2011;"ADOLFO (SP)";"SP";"ADOLFO";73;3;25;101
2011;"AGUAI (SP)";"SP";"AGUAI";784;76;121;981
2011;"AGUAS DA PRATA (SP)";"SP";"AGUAS DA PRATA";114;16;10;140
2011;"AGUAS DE LINDOIA (SP)";"SP";"AGUAS DE LINDOIA";176;63;52;291
2011;"AGUAS DE SANTA BARBARA (SP)";"SP";"AGUAS DE SANTA BARBARA";86;14;14;114
2011;"AGUAS DE SAO PEDRO (SP)";"SP";"AGUAS DE SAO PEDRO";28;5;3;36
2011;"AGUDOS (SP)";"SP";"AGUDOS";556;78;88;722
2011;"ALAMBARI (SP)";"SP";"ALAMBARI";93;16;7;116
2011;"ALFREDO MARCONDES (SP)";"SP";"ALFREDO MARCONDES";60;7;9;76
2011;"ALTAIR (SP)";"SP";"ALTAIR";62;7;31;100
2011;"ALTINOPOLIS (SP)";"SP";"ALTINOPOLIS";320;43;99;462
2011;"ALTO ALEGRE (SP)";"SP";"ALTO ALEGRE";89;4;37;130
2011;"ALUMINIO (SP)";"SP";"ALUMINIO";218;29;38;285
2011;"ALVARES FLORENCE (SP)";"SP";"ALVARES FLORENCE";49;4;15;68
2011;"ALVARES MACHADO (SP)";"SP";"ALVARES MACHADO";402;27;34;463
2011;"ALVARO DE CARVALHO (SP)";"SP";"ALVARO DE CARVALHO";14;3;23;40
2011;"ALVINLANDIA (SP)";"SP";"ALVINLANDIA";39;4;19;62
2011;"AMERICANA (SP)";"SP";"AMERICANA";3333;493;731;4557
2011;"AMERICO BRASILIENSE (SP)";"SP";"AMERICO BRASILIENSE";655;52;221;928
2011;"AMERICO DE CAMPOS (SP)";"SP";"AMERICO DE CAMPOS";140;7;24;171
2011;"AMPARO (SP)";"SP";"AMPARO";1312;195;132;1639
2011;"ANALANDIA (SP)";"SP";"ANALANDIA";75;12;13;100
2011;"ANDRADINA (SP)";"SP";"ANDRADINA";1260;68;126;1454
2011;"ANGATUBA (SP)";"SP";"ANGATUBA";366;43;83;492
2011;"ANHEMBI (SP)";"SP";"ANHEMBI";79;21;14;114
2011;"ANHUMAS (SP)";"SP";"ANHUMAS";70;7;7;84
2011;"APARECIDA (SP)";"SP";"APARECIDA";840;60;520;1420
2011;"APARECIDA D OESTE (SP)";"SP";"APARECIDA D OESTE";106;8;22;136
2011;"APIAI (SP)";"SP";"APIAI";320;42;54;416
2011;"ARACARIGUAMA (SP)";"SP";"ARACARIGUAMA";557;68;45;670
2011;"ARACATUBA (SP)";"SP";"ARACATUBA";3402;237;684;4323
2011;"ARACOIABA DA SERRA (SP)";"SP";"ARACOIABA DA SERRA";458;70;23;551
2011;"ARAMINA (SP)";"SP";"ARAMINA";55;10;23;88
2011;"ARANDU (SP)";"SP";"ARANDU";48;7;20;75
2011;"ARAPEI (SP)";"SP";"ARAPEI";37;9;12;58
2011;"ARARAQUARA (SP)";"SP";"ARARAQUARA";3376;385;990;4751
2011;"ARARAS (SP)";"SP";"ARARAS";2167;224;283;2674
2011;"ARCO IRIS (SP)";"SP";"ARCO IRIS";58;3;8;69
2011;"AREALVA (SP)";"SP";"AREALVA";148;6;21;175
2011;"AREIAS (SP)";"SP";"AREIAS";38;6;6;50
2011;"AREIOPOLIS (SP)";"SP";"AREIOPOLIS";119;26;78;223
2011;"ARIRANHA (SP)";"SP";"ARIRANHA";258;24;136;418
2011;"ARTUR NOGUEIRA (SP)";"SP";"ARTUR NOGUEIRA";940;89;141;1170
2011;"ARUJA (SP)";"SP";"ARUJA";2617;264;315;3196
2011;"ASPASIA (SP)";"SP";"ASPASIA";30;5;5;40
2011;"ASSIS (SP)";"SP";"ASSIS";1626;143;351;2120
2011;"ATIBAIA (SP)";"SP";"ATIBAIA";2292;325;315;2932
2011;"AURIFLAMA (SP)";"SP";"AURIFLAMA";319;22;40;381
2011;"AVAI (SP)";"SP";"AVAI";65;11;18;94
2011;"AVANHANDAVA (SP)";"SP";"AVANHANDAVA";125;8;40;173
2011;"AVARE (SP)";"SP";"AVARE";1233;133;247;1613
2011;"BADY BASSITT (SP)";"SP";"BADY BASSITT";367;41;65;473
2011;"BALBINOS (SP)";"SP";"BALBINOS";18;2;8;28
2011;"BALSAMO (SP)";"SP";"BALSAMO";166;5;19;190
2011;"BANANAL (SP)";"SP";"BANANAL";112;14;29;155
2011;"BARAO DE ANTONINA (SP)";"SP";"BARAO DE ANTONINA";20;2;13;35
2011;"BARBOSA (SP)";"SP";"BARBOSA";110;4;32;146
2011;"BARIRI (SP)";"SP";"BARIRI";753;71;98;922
2011;"BARRA BONITA (SP)";"SP";"BARRA BONITA";1160;82;188;1430
2011;"BARRA DO CHAPEU (SP)";"SP";"BARRA DO CHAPEU";32;2;9;43
2011;"BARRA DO TURVO (SP)";"SP";"BARRA DO TURVO";57;13;42;112
2011;"BARRETOS (SP)";"SP";"BARRETOS";1784;184;543;2511
2011;"BARRINHA (SP)";"SP";"BARRINHA";433;30;151;614
2011;"BARUERI (SP)";"SP";"BARUERI";6282;686;1114;8082
2011;"BASTOS (SP)";"SP";"BASTOS";709;22;72;803
2011;"BATATAIS (SP)";"SP";"BATATAIS";1090;112;152;1354
2011;"BAURU (SP)";"SP";"BAURU";5106;444;1142;6692
2011;"BEBEDOURO (SP)";"SP";"BEBEDOURO";1517;129;236;1882
2011;"BENTO DE ABREU (SP)";"SP";"BENTO DE ABREU";73;10;11;94
2011;"BERNARDINO DE CAMPOS (SP)";"SP";"BERNARDINO DE CAMPOS";317;23;35;375
2011;"BERTIOGA (SP)";"SP";"BERTIOGA";462;51;102;615
2011;"BILAC (SP)";"SP";"BILAC";136;9;23;168
2011;"BIRIGUI (SP)";"SP";"BIRIGUI";1627;87;182;1896
2011;"BIRITIBA MIRIM (SP)";"SP";"BIRITIBA MIRIM";339;22;22;383
2011;"BOA ESPERANCA DO SUL (SP)";"SP";"BOA ESPERANCA DO SUL";338;34;98;470
2011;"BOCAINA (SP)";"SP";"BOCAINA";224;35;34;293
2011;"BOFETE (SP)";"SP";"BOFETE";165;33;51;249
2011;"BOITUVA (SP)";"SP";"BOITUVA";1093;107;130;1330
2011;"BOM JESUS DOS PERDOES (SP)";"SP";"BOM JESUS DOS PERDOES";452;64;55;571
2011;"BOM SUCESSO DE ITARARE (SP)";"SP";"BOM SUCESSO DE ITARARE";79;10;12;101
2011;"BORA (SP)";"SP";"BORA";37;1;6;44
2011;"BORACEIA (SP)";"SP";"BORACEIA";205;9;21;235
2011;"BORBOREMA (SP)";"SP";"BORBOREMA";309;16;75;400
2011;"BOREBI (SP)";"SP";"BOREBI";45;9;7;61
2011;"BOTUCATU (SP)";"SP";"BOTUCATU";1580;244;406;2230
2011;"BRAGANCA PAULISTA (SP)";"SP";"BRAGANCA PAULISTA";2540;325;343;3208
2011;"BRAUNA (SP)";"SP";"BRAUNA";73;3;76;152
2011;"BREJO ALEGRE (SP)";"SP";"BREJO ALEGRE";172;1;19;192
2011;"BRODOWSKI (SP)";"SP";"BRODOWSKI";520;26;37;583
2011;"BROTAS (SP)";"SP";"BROTAS";490;51;138;679
2011;"BURI (SP)";"SP";"BURI";384;30;54;468
2011;"BURITAMA (SP)";"SP";"BURITAMA";323;22;52;397
2011;"BURITIZAL (SP)";"SP";"BURITIZAL";108;13;36;157
2011;"CABRALIA PAULISTA (SP)";"SP";"CABRALIA PAULISTA";130;5;10;145
2011;"CABREUVA (SP)";"SP";"CABREUVA";912;111;75;1098
2011;"CACAPAVA (SP)";"SP";"CACAPAVA";919;243;134;1296
2011;"CACHOEIRA PAULISTA (SP)";"SP";"CACHOEIRA PAULISTA";316;77;25;418
2011;"CACONDE (SP)";"SP";"CACONDE";207;37;78;322
2011;"CAFELANDIA (SP)";"SP";"CAFELANDIA";279;11;67;357
2011;"CAIABU (SP)";"SP";"CAIABU";42;6;40;88
2011;"CAIEIRAS (SP)";"SP";"CAIEIRAS";1131;200;381;1712
2011;"CAIUA (SP)";"SP";"CAIUA";55;11;23;89
2011;"CAJAMAR (SP)";"SP";"CAJAMAR";1397;165;248;1810
2011;"CAJATI (SP)";"SP";"CAJATI";470;68;75;613
2011;"CAJOBI (SP)";"SP";"CAJOBI";276;10;78;364
2011;"CAJURU (SP)";"SP";"CAJURU";451;21;94;566
2011;"CAMPINA DO MONTE ALEGRE (SP)";"SP";"CAMPINA DO MONTE ALEGRE";68;16;24;108
2011;"CAMPINAS (SP)";"SP";"CAMPINAS";19089;3416;4680;27185
2011;"CAMPO LIMPO PAULISTA (SP)";"SP";"CAMPO LIMPO PAULISTA";563;93;32;688
2011;"CAMPOS DO JORDAO (SP)";"SP";"CAMPOS DO JORDAO";569;155;61;785
2011;"CAMPOS NOVOS PAULISTA (SP)";"SP";"CAMPOS NOVOS PAULISTA";80;4;27;111
2011;"CANANEIA (SP)";"SP";"CANANEIA";76;6;9;91
2011;"CANAS (SP)";"SP";"CANAS";72;6;8;86
2011;"CANDIDO MOTA (SP)";"SP";"CANDIDO MOTA";776;35;64;875
2011;"CANDIDO RODRIGUES (SP)";"SP";"CANDIDO RODRIGUES";101;7;9;117
2011;"CANITAR (SP)";"SP";"CANITAR";45;16;19;80
2011;"CAPAO BONITO (SP)";"SP";"CAPAO BONITO";851;101;162;1114
2011;"CAPELA DO ALTO (SP)";"SP";"CAPELA DO ALTO";406;42;27;475
2011;"CAPIVARI (SP)";"SP";"CAPIVARI";1165;96;190;1451
2011;"CARAGUATATUBA (SP)";"SP";"CARAGUATATUBA";1467;159;121;1747
2011;"CARAPICUIBA (SP)";"SP";"CARAPICUIBA";3493;734;885;5112
2011;"CARDOSO (SP)";"SP";"CARDOSO";159;11;41;211
2011;"CASA BRANCA (SP)";"SP";"CASA BRANCA";534;58;83;675
2011;"CASSIA DOS COQUEIROS (SP)";"SP";"CASSIA DOS COQUEIROS";22;4;11;37
2011;"CASTILHO (SP)";"SP";"CASTILHO";217;29;94;340
2011;"CATANDUVA (SP)";"SP";"CATANDUVA";2919;240;526;3685
2011;"CATIGUA (SP)";"SP";"CATIGUA";93;12;32;137
2011;"CEDRAL (SP)";"SP";"CEDRAL";199;13;17;229
2011;"CERQUEIRA CESAR (SP)";"SP";"CERQUEIRA CESAR";277;46;108;431
2011;"CERQUILHO (SP)";"SP";"CERQUILHO";866;94;85;1045
2011;"CESARIO LANGE (SP)";"SP";"CESARIO LANGE";355;48;46;449
2011;"CHARQUEADA (SP)";"SP";"CHARQUEADA";423;27;82;532
2011;"CHAVANTES (SP)";"SP";"CHAVANTES";144;19;50;213
2011;"CLEMENTINA (SP)";"SP";"CLEMENTINA";232;12;57;301
2011;"COLINA (SP)";"SP";"COLINA";383;25;77;485
2011;"COLOMBIA (SP)";"SP";"COLOMBIA";121;32;69;222
2011;"CONCHAL (SP)";"SP";"CONCHAL";708;45;228;981
2011;"CONCHAS (SP)";"SP";"CONCHAS";324;35;31;390
2011;"CORDEIROPOLIS (SP)";"SP";"CORDEIROPOLIS";624;65;32;721
2011;"COROADOS (SP)";"SP";"COROADOS";73;5;17;95
2011;"CORONEL MACEDO (SP)";"SP";"CORONEL MACEDO";54;10;26;90
2011;"CORUMBATAI (SP)";"SP";"CORUMBATAI";145;12;10;167
2011;"COSMOPOLIS (SP)";"SP";"COSMOPOLIS";790;254;244;1288
2011;"COSMORAMA (SP)";"SP";"COSMORAMA";164;6;40;210
2011;"COTIA (SP)";"SP";"COTIA";2866;774;709;4349
2011;"CRAVINHOS (SP)";"SP";"CRAVINHOS";934;35;165;1134
2011;"CRISTAIS PAULISTA (SP)";"SP";"CRISTAIS PAULISTA";120;4;27;151
2011;"CRUZALIA (SP)";"SP";"CRUZALIA";66;9;4;79
2011;"CRUZEIRO (SP)";"SP";"CRUZEIRO";664;120;46;830
2011;"CUBATAO (SP)";"SP";"CUBATAO";2992;369;403;3764
2011;"CUNHA (SP)";"SP";"CUNHA";239;31;29;299
2011;"DESCALVADO (SP)";"SP";"DESCALVADO";890;76;184;1150
2011;"DIADEMA (SP)";"SP";"DIADEMA";4153;737;590;5480
2011;"DIRCE REIS (SP)";"SP";"DIRCE REIS";56;5;7;68
2011;"DIVINOLANDIA (SP)";"SP";"DIVINOLANDIA";411;21;37;469
2011;"DOBRADA (SP)";"SP";"DOBRADA";60;8;76;144
2011;"DOIS CORREGOS (SP)";"SP";"DOIS CORREGOS";665;53;128;846
2011;"DOLCINOPOLIS (SP)";"SP";"DOLCINOPOLIS";27;3;7;37
2011;"DOURADO (SP)";"SP";"DOURADO";182;28;51;261
2011;"DRACENA (SP)";"SP";"DRACENA";957;48;138;1143
2011;"DUARTINA (SP)";"SP";"DUARTINA";254;28;58;340
2011;"DUMONT (SP)";"SP";"DUMONT";271;9;54;334
2011;"ECHAPORA (SP)";"SP";"ECHAPORA";122;1;17;140
2011;"ELDORADO (SP)";"SP";"ELDORADO";223;13;41;277
2011;"ELIAS FAUSTO (SP)";"SP";"ELIAS FAUSTO";329;14;68;411
2011;"ELISIARIO (SP)";"SP";"ELISIARIO";50;4;6;60
2011;"EMBAUBA (SP)";"SP";"EMBAUBA";74;5;24;103
2011;"EMBU (SP)";"SP";"EMBU";2300;572;679;3551
2011;"EMBU GUACU (SP)";"SP";"EMBU GUACU";1841;163;254;2258
2011;"EMILIANOPOLIS (SP)";"SP";"EMILIANOPOLIS";55;3;18;76
2011;"ENGENHEIRO COELHO (SP)";"SP";"ENGENHEIRO COELHO";328;36;142;506
2011;"ESPIRITO SANTO DO PINHAL (SP)";"SP";"ESPIRITO SANTO DO PINHAL";598;102;89;789
2011;"ESPIRITO SANTO DO TURVO (SP)";"SP";"ESPIRITO SANTO DO TURVO";148;22;35;205
2011;"ESTIVA GERBI (SP)";"SP";"ESTIVA GERBI";258;11;26;295
2011;"ESTRELA D OESTE (SP)";"SP";"ESTRELA D OESTE";257;7;21;285
2011;"ESTRELA DO NORTE (SP)";"SP";"ESTRELA DO NORTE";24;2;9;35
2011;"EUCLIDES DA CUNHA PAULISTA (SP)";"SP";"EUCLIDES DA CUNHA PAULISTA";84;6;42;132
2011;"FARTURA (SP)";"SP";"FARTURA";240;21;31;292
2011;"FERNANDO PRESTES (SP)";"SP";"FERNANDO PRESTES";202;7;16;225
2011;"FERNANDOPOLIS (SP)";"SP";"FERNANDOPOLIS";1359;73;179;1611
2011;"FERNAO (SP)";"SP";"FERNAO";26;4;7;37
2011;"FERRAZ DE VASCONCELOS (SP)";"SP";"FERRAZ DE VASCONCELOS";1580;228;266;2074
2011;"FLORA RICA (SP)";"SP";"FLORA RICA";17;1;10;28
2011;"FLOREAL (SP)";"SP";"FLOREAL";56;10;7;73
2011;"FLORIDA PAULISTA (SP)";"SP";"FLORIDA PAULISTA";289;14;110;413
2011;"FLORINEA (SP)";"SP";"FLORINEA";42;5;7;54
2011;"FRANCA (SP)";"SP";"FRANCA";3032;336;561;3929
2011;"FRANCISCO MORATO (SP)";"SP";"FRANCISCO MORATO";551;170;197;918
2011;"FRANCO DA ROCHA (SP)";"SP";"FRANCO DA ROCHA";775;171;191;1137
2011;"GABRIEL MONTEIRO (SP)";"SP";"GABRIEL MONTEIRO";48;2;13;63
2011;"GALIA (SP)";"SP";"GALIA";135;14;36;185
2011;"GARCA (SP)";"SP";"GARCA";717;55;108;880
2011;"GASTAO VIDIGAL (SP)";"SP";"GASTAO VIDIGAL";64;9;51;124
2011;"GAVIAO PEIXOTO (SP)";"SP";"GAVIAO PEIXOTO";47;7;21;75
2011;"GENERAL SALGADO (SP)";"SP";"GENERAL SALGADO";294;15;85;394
2011;"GETULINA (SP)";"SP";"GETULINA";144;5;61;210
2011;"GLICERIO (SP)";"SP";"GLICERIO";106;4;21;131
2011;"GUAICARA (SP)";"SP";"GUAICARA";88;10;28;126
2011;"GUAIMBE (SP)";"SP";"GUAIMBE";121;1;27;149
2011;"GUAIRA (SP)";"SP";"GUAIRA";1122;67;164;1353
2011;"GUAPIACU (SP)";"SP";"GUAPIACU";413;21;62;496
2011;"GUAPIARA (SP)";"SP";"GUAPIARA";288;35;44;367
2011;"GUARA (SP)";"SP";"GUARA";197;27;149;373
2011;"GUARACAI (SP)";"SP";"GUARACAI";297;21;30;348
2011;"GUARACI (SP)";"SP";"GUARACI";167;12;66;245
2011;"GUARANI D OESTE (SP)";"SP";"GUARANI D OESTE";23;4;5;32
2011;"GUARANTA (SP)";"SP";"GUARANTA";81;3;39;123
2011;"GUARARAPES (SP)";"SP";"GUARARAPES";697;43;134;874
2011;"GUARAREMA (SP)";"SP";"GUARAREMA";452;74;56;582
2011;"GUARATINGUETA (SP)";"SP";"GUARATINGUETA";1050;297;171;1518
2011;"GUAREI (SP)";"SP";"GUAREI";242;24;50;316
2011;"GUARIBA (SP)";"SP";"GUARIBA";855;62;252;1169
2011;"GUARUJA (SP)";"SP";"GUARUJA";2000;392;408;2800
2011;"GUARULHOS (SP)";"SP";"GUARULHOS";19812;3756;3524;27092
2011;"GUATAPARA (SP)";"SP";"GUATAPARA";154;12;42;208
2011;"GUZOLANDIA (SP)";"SP";"GUZOLANDIA";58;4;37;99
2011;"HERCULANDIA (SP)";"SP";"HERCULANDIA";403;5;21;429
2011;"HOLAMBRA (SP)";"SP";"HOLAMBRA";353;30;70;453
2011;"HORTOLANDIA (SP)";"SP";"HORTOLANDIA";1612;330;336;2278
2011;"IACANGA (SP)";"SP";"IACANGA";178;14;28;220
2011;"IACRI (SP)";"SP";"IACRI";129;3;16;148
2011;"IARAS (SP)";"SP";"IARAS";45;14;34;93
2011;"IBATE (SP)";"SP";"IBATE";552;101;202;855
2011;"IBIRA (SP)";"SP";"IBIRA";160;15;57;232
2011;"IBIRAREMA (SP)";"SP";"IBIRAREMA";138;12;26;176
2011;"IBITINGA (SP)";"SP";"IBITINGA";810;66;142;1018
2011;"IBIUNA (SP)";"SP";"IBIUNA";1838;144;116;2098
2011;"ICEM (SP)";"SP";"ICEM";176;8;61;245
2011;"IEPE (SP)";"SP";"IEPE";147;10;26;183
2011;"IGARACU DO TIETE (SP)";"SP";"IGARACU DO TIETE";349;30;83;462
2011;"IGARAPAVA (SP)";"SP";"IGARAPAVA";362;39;100;501
2011;"IGARATA (SP)";"SP";"IGARATA";148;27;12;187
2011;"IGUAPE (SP)";"SP";"IGUAPE";208;42;23;273
2011;"ILHA COMPRIDA (SP)";"SP";"ILHA COMPRIDA";131;18;58;207
2011;"ILHA SOLTEIRA (SP)";"SP";"ILHA SOLTEIRA";235;31;80;346
2011;"ILHABELA (SP)";"SP";"ILHABELA";293;64;50;407
2011;"INDAIATUBA (SP)";"SP";"INDAIATUBA";2796;491;210;3497
2011;"INDIANA (SP)";"SP";"INDIANA";111;7;14;132
2011;"INDIAPORA (SP)";"SP";"INDIAPORA";52;3;17;72
2011;"INUBIA PAULISTA (SP)";"SP";"INUBIA PAULISTA";56;7;14;77
2011;"IPAUSSU (SP)";"SP";"IPAUSSU";177;30;50;257
2011;"IPERO (SP)";"SP";"IPERO";211;17;30;258
2011;"IPEUNA (SP)";"SP";"IPEUNA";159;29;32;220
2011;"IPIGUA (SP)";"SP";"IPIGUA";22;2;9;33
2011;"IPORANGA (SP)";"SP";"IPORANGA";23;4;9;36
2011;"IPUA (SP)";"SP";"IPUA";256;17;76;349
2011;"IRACEMAPOLIS (SP)";"SP";"IRACEMAPOLIS";532;51;100;683
2011;"IRAPUA (SP)";"SP";"IRAPUA";137;6;80;223
2011;"IRAPURU (SP)";"SP";"IRAPURU";105;14;25;144
2011;"ITABERA (SP)";"SP";"ITABERA";230;28;29;287
2011;"ITAI (SP)";"SP";"ITAI";469;57;138;664
2011;"ITAJOBI (SP)";"SP";"ITAJOBI";479;14;43;536
2011;"ITAJU (SP)";"SP";"ITAJU";73;3;18;94
2011;"ITANHAEM (SP)";"SP";"ITANHAEM";719;188;96;1003
2011;"ITAOCA (SP)";"SP";"ITAOCA";26;7;7;40
2011;"ITAPECERICA DA SERRA (SP)";"SP";"ITAPECERICA DA SERRA";2531;609;586;3726
2011;"ITAPETININGA (SP)";"SP";"ITAPETININGA";2467;357;352;3176
2011;"ITAPEVA (SP)";"SP";"ITAPEVA";1751;260;338;2349
2011;"ITAPEVI (SP)";"SP";"ITAPEVI";1583;237;152;1972
2011;"ITAPIRA (SP)";"SP";"ITAPIRA";1625;129;219;1973
2011;"ITAPIRAPUA PAULISTA (SP)";"SP";"ITAPIRAPUA PAULISTA";39;16;10;65
2011;"ITAPOLIS (SP)";"SP";"ITAPOLIS";1216;72;181;1469
2011;"ITAPORANGA (SP)";"SP";"ITAPORANGA";206;18;69;293
2011;"ITAPUI (SP)";"SP";"ITAPUI";372;32;68;472
2011;"ITAPURA (SP)";"SP";"ITAPURA";28;3;11;42
2011;"ITAQUAQUECETUBA (SP)";"SP";"ITAQUAQUECETUBA";2991;345;341;3677
2011;"ITARARE (SP)";"SP";"ITARARE";900;79;256;1235
2011;"ITARIRI (SP)";"SP";"ITARIRI";299;25;20;344
2011;"ITATIBA (SP)";"SP";"ITATIBA";2482;219;349;3050
2011;"ITATINGA (SP)";"SP";"ITATINGA";192;37;109;338
2011;"ITIRAPINA (SP)";"SP";"ITIRAPINA";244;36;52;332
2011;"ITIRAPUA (SP)";"SP";"ITIRAPUA";66;4;19;89
2011;"ITOBI (SP)";"SP";"ITOBI";136;13;70;219
2011;"ITU (SP)";"SP";"ITU";2709;378;572;3659
2011;"ITUPEVA (SP)";"SP";"ITUPEVA";969;101;97;1167
2011;"ITUVERAVA (SP)";"SP";"ITUVERAVA";629;42;121;792
2011;"JABORANDI (SP)";"SP";"JABORANDI";163;7;43;213
2011;"JABOTICABAL (SP)";"SP";"JABOTICABAL";1767;110;220;2097
2011;"JACAREI (SP)";"SP";"JACAREI";2551;549;354;3454
2011;"JACI (SP)";"SP";"JACI";183;8;28;219
2011;"JACUPIRANGA (SP)";"SP";"JACUPIRANGA";381;33;327;741
2011;"JAGUARIUNA (SP)";"SP";"JAGUARIUNA";1036;89;173;1298
2011;"JALES (SP)";"SP";"JALES";1145;32;69;1246
2011;"JAMBEIRO (SP)";"SP";"JAMBEIRO";54;28;10;92
2011;"JANDIRA (SP)";"SP";"JANDIRA";1191;237;167;1595
2011;"JARDINOPOLIS (SP)";"SP";"JARDINOPOLIS";873;90;119;1082
2011;"JARINU (SP)";"SP";"JARINU";574;43;49;666
2011;"JAU (SP)";"SP";"JAU";2321;278;337;2936
2011;"JERIQUARA (SP)";"SP";"JERIQUARA";48;6;10;64
2011;"JOANOPOLIS (SP)";"SP";"JOANOPOLIS";334;23;16;373
2011;"JOAO RAMALHO (SP)";"SP";"JOAO RAMALHO";29;7;18;54
2011;"JOSE BONIFACIO (SP)";"SP";"JOSE BONIFACIO";821;52;98;971
2011;"JULIO MESQUITA (SP)";"SP";"JULIO MESQUITA";42;6;26;74
2011;"JUMIRIM (SP)";"SP";"JUMIRIM";94;10;7;111
2011;"JUNDIAI (SP)";"SP";"JUNDIAI";7617;826;1056;9499
2011;"JUNQUEIROPOLIS (SP)";"SP";"JUNQUEIROPOLIS";424;31;164;619
2011;"JUQUIA (SP)";"SP";"JUQUIA";377;23;18;418
2011;"JUQUITIBA (SP)";"SP";"JUQUITIBA";611;71;95;777
2011;"LAGOINHA (SP)";"SP";"LAGOINHA";110;12;20;142
2011;"LARANJAL PAULISTA (SP)";"SP";"LARANJAL PAULISTA";616;44;174;834
2011;"LAVINIA (SP)";"SP";"LAVINIA";76;6;11;93
2011;"LAVRINHAS (SP)";"SP";"LAVRINHAS";86;22;14;122
2011;"LEME (SP)";"SP";"LEME";2339;137;477;2953
2011;"LENCOIS PAULISTA (SP)";"SP";"LENCOIS PAULISTA";1323;162;242;1727
2011;"LIMEIRA (SP)";"SP";"LIMEIRA";4710;756;574;6040
2011;"LINDOIA (SP)";"SP";"LINDOIA";137;23;16;176
2011;"LINS (SP)";"SP";"LINS";1478;105;164;1747
2011;"LORENA (SP)";"SP";"LORENA";851;166;38;1055
2011;"LOURDES (SP)";"SP";"LOURDES";27;5;13;45
2011;"LOUVEIRA (SP)";"SP";"LOUVEIRA";903;113;53;1069
2011;"LUCELIA (SP)";"SP";"LUCELIA";377;29;175;581
2011;"LUCIANOPOLIS (SP)";"SP";"LUCIANOPOLIS";47;8;14;69
2011;"LUIS ANTONIO (SP)";"SP";"LUIS ANTONIO";275;24;142;441
2011;"LUIZIANIA (SP)";"SP";"LUIZIANIA";59;2;27;88
2011;"LUPERCIO (SP)";"SP";"LUPERCIO";56;3;31;90
2011;"LUTECIA (SP)";"SP";"LUTECIA";40;8;12;60
2011;"MACATUBA (SP)";"SP";"MACATUBA";479;28;74;581
2011;"MACAUBAL (SP)";"SP";"MACAUBAL";137;16;20;173
2011;"MACEDONIA (SP)";"SP";"MACEDONIA";42;3;13;58
2011;"MAGDA (SP)";"SP";"MAGDA";93;10;10;113
2011;"MAIRINQUE (SP)";"SP";"MAIRINQUE";559;78;127;764
2011;"MAIRIPORA (SP)";"SP";"MAIRIPORA";1698;276;145;2119
2011;"MANDURI (SP)";"SP";"MANDURI";186;29;68;283
2011;"MARABA PAULISTA (SP)";"SP";"MARABA PAULISTA";28;3;14;45
2011;"MARACAI (SP)";"SP";"MARACAI";312;53;53;418
2011;"MARAPOAMA (SP)";"SP";"MARAPOAMA";120;11;11;142
2011;"MARIAPOLIS (SP)";"SP";"MARIAPOLIS";37;0;23;60
2011;"MARILIA (SP)";"SP";"MARILIA";3005;257;438;3700
2011;"MARINOPOLIS (SP)";"SP";"MARINOPOLIS";73;5;5;83
2011;"MARTINOPOLIS (SP)";"SP";"MARTINOPOLIS";391;43;88;522
2011;"MATAO (SP)";"SP";"MATAO";1511;79;297;1887
2011;"MAUA (SP)";"SP";"MAUA";3557;1004;1076;5637
2011;"MENDONCA (SP)";"SP";"MENDONCA";94;4;21;119
2011;"MERIDIANO (SP)";"SP";"MERIDIANO";136;10;16;162
2011;"MESOPOLIS (SP)";"SP";"MESOPOLIS";15;4;12;31
2011;"MIGUELOPOLIS (SP)";"SP";"MIGUELOPOLIS";304;13;104;421
2011;"MINEIROS DO TIETE (SP)";"SP";"MINEIROS DO TIETE";236;11;36;283
2011;"MIRA ESTRELA (SP)";"SP";"MIRA ESTRELA";36;4;26;66
2011;"MIRACATU (SP)";"SP";"MIRACATU";595;75;23;693
2011;"MIRANDOPOLIS (SP)";"SP";"MIRANDOPOLIS";528;39;150;717
2011;"MIRANTE DO PARANAPANEMA (SP)";"SP";"MIRANTE DO PARANAPANEMA";198;46;68;312
2011;"MIRASSOL (SP)";"SP";"MIRASSOL";1141;47;64;1252
2011;"MIRASSOLANDIA (SP)";"SP";"MIRASSOLANDIA";38;11;12;61
2011;"MOCOCA (SP)";"SP";"MOCOCA";1071;109;299;1479
2011;"MOGI DAS CRUZES (SP)";"SP";"MOGI DAS CRUZES";5853;761;1178;7792
2011;"MOGI GUACU (SP)";"SP";"MOGI GUACU";2233;368;413;3014
2011;"MOGI MIRIM (SP)";"SP";"MOGI MIRIM";1867;199;576;2642
2011;"MOMBUCA (SP)";"SP";"MOMBUCA";85;4;19;108
2011;"MONCOES (SP)";"SP";"MONCOES";76;10;12;98
2011;"MONGAGUA (SP)";"SP";"MONGAGUA";496;79;48;623
2011;"MONTE ALEGRE DO SUL (SP)";"SP";"MONTE ALEGRE DO SUL";225;36;30;291
2011;"MONTE ALTO (SP)";"SP";"MONTE ALTO";1463;69;101;1633
2011;"MONTE APRAZIVEL (SP)";"SP";"MONTE APRAZIVEL";584;37;155;776
2011;"MONTE AZUL PAULISTA (SP)";"SP";"MONTE AZUL PAULISTA";485;27;132;644
2011;"MONTE CASTELO (SP)";"SP";"MONTE CASTELO";75;5;14;94
2011;"MONTE MOR (SP)";"SP";"MONTE MOR";666;82;113;861
2011;"MONTEIRO LOBATO (SP)";"SP";"MONTEIRO LOBATO";211;41;23;275
2011;"MORRO AGUDO (SP)";"SP";"MORRO AGUDO";650;38;162;850
2011;"MORUNGABA (SP)";"SP";"MORUNGABA";352;51;26;429
2011;"MOTUCA (SP)";"SP";"MOTUCA";126;6;30;162
2011;"MUNICIPIO NAO INFORMADO (SP)";"SP";"MUNICIPIO NAO INFORMADO";0;0;0;0
2011;"MURUTINGA DO SUL (SP)";"SP";"MURUTINGA DO SUL";85;9;12;106
2011;"NANTES (SP)";"SP";"NANTES";17;5;17;39
2011;"NARANDIBA (SP)";"SP";"NARANDIBA";87;5;19;111
2011;"NATIVIDADE DA SERRA (SP)";"SP";"NATIVIDADE DA SERRA";79;30;9;118
2011;"NAZARE PAULISTA (SP)";"SP";"NAZARE PAULISTA";581;17;24;622
2011;"NEVES PAULISTA (SP)";"SP";"NEVES PAULISTA";185;13;30;228
2011;"NHANDEARA (SP)";"SP";"NHANDEARA";190;12;38;240
2011;"NIPOA (SP)";"SP";"NIPOA";111;5;25;141
2011;"NOVA ALIANCA (SP)";"SP";"NOVA ALIANCA";120;15;18;153
2011;"NOVA CAMPINA (SP)";"SP";"NOVA CAMPINA";62;14;15;91
2011;"NOVA CANAA PAULISTA (SP)";"SP";"NOVA CANAA PAULISTA";28;6;6;40
2011;"NOVA CASTILHO (SP)";"SP";"NOVA CASTILHO";14;3;9;26
2011;"NOVA EUROPA (SP)";"SP";"NOVA EUROPA";165;7;118;290
2011;"NOVA GRANADA (SP)";"SP";"NOVA GRANADA";316;39;93;448
2011;"NOVA GUATAPORANGA (SP)";"SP";"NOVA GUATAPORANGA";32;4;14;50
2011;"NOVA INDEPENDENCIA (SP)";"SP";"NOVA INDEPENDENCIA";37;10;10;57
2011;"NOVA LUZITANIA (SP)";"SP";"NOVA LUZITANIA";40;2;26;68
2011;"NOVA ODESSA (SP)";"SP";"NOVA ODESSA";821;114;115;1050
2011;"NOVAIS (SP)";"SP";"NOVAIS";96;9;35;140
2011;"NOVO HORIZONTE (SP)";"SP";"NOVO HORIZONTE";1015;26;200;1241
2011;"NUPORANGA (SP)";"SP";"NUPORANGA";191;19;53;263
2011;"OCAUCU (SP)";"SP";"OCAUCU";99;8;16;123
2011;"OLEO (SP)";"SP";"OLEO";23;10;7;40
2011;"OLIMPIA (SP)";"SP";"OLIMPIA";933;98;184;1215
2011;"ONDA VERDE (SP)";"SP";"ONDA VERDE";86;5;23;114
2011;"ORIENTE (SP)";"SP";"ORIENTE";73;9;17;99
2011;"ORINDIUVA (SP)";"SP";"ORINDIUVA";189;11;100;300
2011;"ORLANDIA (SP)";"SP";"ORLANDIA";899;52;262;1213
2011;"OSASCO (SP)";"SP";"OSASCO";9904;1801;2447;14152
2011;"OSCAR BRESSANE (SP)";"SP";"OSCAR BRESSANE";53;5;5;63
2011;"OSVALDO CRUZ (SP)";"SP";"OSVALDO CRUZ";555;26;106;687
2011;"OURINHOS (SP)";"SP";"OURINHOS";2091;134;492;2717
2011;"OURO VERDE (SP)";"SP";"OURO VERDE";120;4;54;178
2011;"OUROESTE (SP)";"SP";"OUROESTE";127;9;36;172
2011;"PACAEMBU (SP)";"SP";"PACAEMBU";166;19;42;227
2011;"PALESTINA (SP)";"SP";"PALESTINA";152;15;42;209
2011;"PALMARES PAULISTA (SP)";"SP";"PALMARES PAULISTA";70;10;105;185
2011;"PALMEIRA D OESTE (SP)";"SP";"PALMEIRA D OESTE";241;7;35;283
2011;"PALMITAL (SP)";"SP";"PALMITAL";591;39;58;688
2011;"PANORAMA (SP)";"SP";"PANORAMA";324;11;16;351
2011;"PARAGUACU PAULISTA (SP)";"SP";"PARAGUACU PAULISTA";742;124;86;952
2011;"PARAIBUNA (SP)";"SP";"PARAIBUNA";225;70;52;347
2011;"PARAISO (SP)";"SP";"PARAISO";192;12;64;268
2011;"PARANAPANEMA (SP)";"SP";"PARANAPANEMA";520;29;63;612
2011;"PARANAPUA (SP)";"SP";"PARANAPUA";75;6;12;93
2011;"PARAPUA (SP)";"SP";"PARAPUA";290;8;49;347
2011;"PARDINHO (SP)";"SP";"PARDINHO";135;14;22;171
2011;"PARIQUERA ACU (SP)";"SP";"PARIQUERA ACU";374;22;19;415
2011;"PARISI (SP)";"SP";"PARISI";22;6;8;36
2011;"PATROCINIO PAULISTA (SP)";"SP";"PATROCINIO PAULISTA";232;14;45;291
2011;"PAULICEIA (SP)";"SP";"PAULICEIA";265;11;23;299
2011;"PAULINIA (SP)";"SP";"PAULINIA";1884;213;429;2526
2011;"PAULISTANIA (SP)";"SP";"PAULISTANIA";20;6;8;34
2011;"PAULO DE FARIA (SP)";"SP";"PAULO DE FARIA";92;14;41;147
2011;"PEDERNEIRAS (SP)";"SP";"PEDERNEIRAS";1002;93;199;1294
2011;"PEDRA BELA (SP)";"SP";"PEDRA BELA";184;9;15;208
2011;"PEDRANOPOLIS (SP)";"SP";"PEDRANOPOLIS";50;1;13;64
2011;"PEDREGULHO (SP)";"SP";"PEDREGULHO";247;24;94;365
2011;"PEDREIRA (SP)";"SP";"PEDREIRA";704;108;68;880
2011;"PEDRINHAS PAULISTA (SP)";"SP";"PEDRINHAS PAULISTA";140;6;14;160
2011;"PEDRO DE TOLEDO (SP)";"SP";"PEDRO DE TOLEDO";138;20;7;165
2011;"PENAPOLIS (SP)";"SP";"PENAPOLIS";1293;60;238;1591
2011;"PEREIRA BARRETO (SP)";"SP";"PEREIRA BARRETO";340;38;90;468
2011;"PEREIRAS (SP)";"SP";"PEREIRAS";228;11;27;266
2011;"PERUIBE (SP)";"SP";"PERUIBE";575;181;90;846
2011;"PIACATU (SP)";"SP";"PIACATU";82;2;18;102
2011;"PIEDADE (SP)";"SP";"PIEDADE";1320;122;84;1526
2011;"PILAR DO SUL (SP)";"SP";"PILAR DO SUL";922;57;69;1048
2011;"PINDAMONHANGABA (SP)";"SP";"PINDAMONHANGABA";1817;334;180;2331
2011;"PINDORAMA (SP)";"SP";"PINDORAMA";269;21;56;346
2011;"PINHALZINHO (SP)";"SP";"PINHALZINHO";370;33;9;412
2011;"PIQUEROBI (SP)";"SP";"PIQUEROBI";37;4;7;48
2011;"PIQUETE (SP)";"SP";"PIQUETE";167;43;18;228
2011;"PIRACAIA (SP)";"SP";"PIRACAIA";459;76;32;567
2011;"PIRACICABA (SP)";"SP";"PIRACICABA";7243;784;1312;9339
2011;"PIRAJU (SP)";"SP";"PIRAJU";434;60;73;567
2011;"PIRAJUI (SP)";"SP";"PIRAJUI";312;23;79;414
2011;"PIRANGI (SP)";"SP";"PIRANGI";380;17;62;459
2011;"PIRAPORA DO BOM JESUS (SP)";"SP";"PIRAPORA DO BOM JESUS";233;27;13;273
2011;"PIRAPOZINHO (SP)";"SP";"PIRAPOZINHO";413;28;90;531
2011;"PIRASSUNUNGA (SP)";"SP";"PIRASSUNUNGA";1025;142;235;1402
2011;"PIRATININGA (SP)";"SP";"PIRATININGA";232;29;38;299
2011;"PITANGUEIRAS (SP)";"SP";"PITANGUEIRAS";878;49;246;1173
2011;"PLANALTO (SP)";"SP";"PLANALTO";79;8;26;113
2011;"PLATINA (SP)";"SP";"PLATINA";45;15;13;73
2011;"POA (SP)";"SP";"POA";942;165;196;1303
2011;"POLONI (SP)";"SP";"POLONI";167;5;46;218
2011;"POMPEIA (SP)";"SP";"POMPEIA";253;16;45;314
2011;"PONGAI (SP)";"SP";"PONGAI";57;4;13;74
2011;"PONTAL (SP)";"SP";"PONTAL";912;29;451;1392
2011;"PONTALINDA (SP)";"SP";"PONTALINDA";31;3;19;53
2011;"PONTES GESTAL (SP)";"SP";"PONTES GESTAL";92;1;23;116
2011;"POPULINA (SP)";"SP";"POPULINA";55;5;18;78
2011;"PORANGABA (SP)";"SP";"PORANGABA";125;12;13;150
2011;"PORTO FELIZ (SP)";"SP";"PORTO FELIZ";1291;89;186;1566
2011;"PORTO FERREIRA (SP)";"SP";"PORTO FERREIRA";1072;87;154;1313
2011;"POTIM (SP)";"SP";"POTIM";74;46;20;140
2011;"POTIRENDABA (SP)";"SP";"POTIRENDABA";445;16;66;527
2011;"PRACINHA (SP)";"SP";"PRACINHA";10;0;15;25
2011;"PRADOPOLIS (SP)";"SP";"PRADOPOLIS";371;19;222;612
2011;"PRAIA GRANDE (SP)";"SP";"PRAIA GRANDE";1949;296;217;2462
2011;"PRATANIA (SP)";"SP";"PRATANIA";97;15;38;150
2011;"PRESIDENTE ALVES (SP)";"SP";"PRESIDENTE ALVES";65;4;40;109
2011;"PRESIDENTE BERNARDES (SP)";"SP";"PRESIDENTE BERNARDES";228;29;31;288
2011;"PRESIDENTE EPITACIO (SP)";"SP";"PRESIDENTE EPITACIO";471;62;123;656
2011;"PRESIDENTE PRUDENTE (SP)";"SP";"PRESIDENTE PRUDENTE";3649;315;814;4778
2011;"PRESIDENTE VENCESLAU (SP)";"SP";"PRESIDENTE VENCESLAU";652;47;60;759
2011;"PROMISSAO (SP)";"SP";"PROMISSAO";677;69;169;915
2011;"QUADRA (SP)";"SP";"QUADRA";58;7;12;77
2011;"QUATA (SP)";"SP";"QUATA";211;16;59;286
2011;"QUEIROZ (SP)";"SP";"QUEIROZ";23;4;8;35
2011;"QUELUZ (SP)";"SP";"QUELUZ";105;29;6;140
2011;"QUINTANA (SP)";"SP";"QUINTANA";109;9;19;137
2011;"RAFARD (SP)";"SP";"RAFARD";259;20;28;307
2011;"RANCHARIA (SP)";"SP";"RANCHARIA";554;69;72;695
2011;"REDENCAO DA SERRA (SP)";"SP";"REDENCAO DA SERRA";66;17;23;106
2011;"REGENTE FEIJO (SP)";"SP";"REGENTE FEIJO";367;35;28;430
2011;"REGINOPOLIS (SP)";"SP";"REGINOPOLIS";76;8;22;106
2011;"REGISTRO (SP)";"SP";"REGISTRO";1135;82;287;1504
2011;"RESTINGA (SP)";"SP";"RESTINGA";63;9;19;91
2011;"RIBEIRA (SP)";"SP";"RIBEIRA";22;7;4;33
2011;"RIBEIRAO BONITO (SP)";"SP";"RIBEIRAO BONITO";288;34;86;408
2011;"RIBEIRAO BRANCO (SP)";"SP";"RIBEIRAO BRANCO";153;25;35;213
2011;"RIBEIRAO CORRENTE (SP)";"SP";"RIBEIRAO CORRENTE";69;6;32;107
2011;"RIBEIRAO DO SUL (SP)";"SP";"RIBEIRAO DO SUL";115;11;12;138
2011;"RIBEIRAO DOS INDIOS (SP)";"SP";"RIBEIRAO DOS INDIOS";19;3;13;35
2011;"RIBEIRAO GRANDE (SP)";"SP";"RIBEIRAO GRANDE";66;20;12;98
2011;"RIBEIRAO PIRES (SP)";"SP";"RIBEIRAO PIRES";4274;548;492;5314
2011;"RIBEIRAO PRETO (SP)";"SP";"RIBEIRAO PRETO";10036;904;1645;12585
2011;"RIFAINA (SP)";"SP";"RIFAINA";32;5;10;47
2011;"RINCAO (SP)";"SP";"RINCAO";254;13;49;316
2011;"RINOPOLIS (SP)";"SP";"RINOPOLIS";171;6;53;230
2011;"RIO CLARO (SP)";"SP";"RIO CLARO";3152;326;396;3874
2011;"RIO DAS PEDRAS (SP)";"SP";"RIO DAS PEDRAS";646;76;166;888
2011;"RIO GRANDE DA SERRA (SP)";"SP";"RIO GRANDE DA SERRA";361;122;68;551
2011;"RIOLANDIA (SP)";"SP";"RIOLANDIA";87;11;44;142
2011;"RIVERSUL (SP)";"SP";"RIVERSUL";59;16;27;102
2011;"ROSANA (SP)";"SP";"ROSANA";167;15;55;237
2011;"ROSEIRA (SP)";"SP";"ROSEIRA";130;51;13;194
2011;"RUBIACEA (SP)";"SP";"RUBIACEA";30;2;10;42
2011;"RUBINEIA (SP)";"SP";"RUBINEIA";21;9;8;38
2011;"SABINO (SP)";"SP";"SABINO";61;6;13;80
2011;"SAGRES (SP)";"SP";"SAGRES";20;1;6;27
2011;"SALES (SP)";"SP";"SALES";81;2;30;113
2011;"SALES OLIVEIRA (SP)";"SP";"SALES OLIVEIRA";249;13;40;302
2011;"SALESOPOLIS (SP)";"SP";"SALESOPOLIS";700;81;37;818
2011;"SALMOURAO (SP)";"SP";"SALMOURAO";32;1;34;67
2011;"SALTINHO (SP)";"SP";"SALTINHO";320;13;5;338
2011;"SALTO (SP)";"SP";"SALTO";2095;235;208;2538
2011;"SALTO DE PIRAPORA (SP)";"SP";"SALTO DE PIRAPORA";625;54;48;727
2011;"SALTO GRANDE (SP)";"SP";"SALTO GRANDE";141;12;28;181
2011;"SANDOVALINA (SP)";"SP";"SANDOVALINA";26;4;14;44
2011;"SANTA ADELIA (SP)";"SP";"SANTA ADELIA";578;32;76;686
2011;"SANTA ALBERTINA (SP)";"SP";"SANTA ALBERTINA";123;7;19;149
2011;"SANTA BARBARA D OESTE (SP)";"SP";"SANTA BARBARA D OESTE";2396;389;300;3085
2011;"SANTA BRANCA (SP)";"SP";"SANTA BRANCA";135;41;34;210
2011;"SANTA CLARA D OESTE (SP)";"SP";"SANTA CLARA D OESTE";27;3;4;34
2011;"SANTA CRUZ DA CONCEICAO (SP)";"SP";"SANTA CRUZ DA CONCEICAO";132;15;14;161
2011;"SANTA CRUZ DA ESPERANCA (SP)";"SP";"SANTA CRUZ DA ESPERANCA";25;2;4;31
2011;"SANTA CRUZ DAS PALMEIRAS (SP)";"SP";"SANTA CRUZ DAS PALMEIRAS";591;39;191;821
2011;"SANTA CRUZ DO RIO PARDO (SP)";"SP";"SANTA CRUZ DO RIO PARDO";1211;93;93;1397
2011;"SANTA ERNESTINA (SP)";"SP";"SANTA ERNESTINA";84;16;52;152
2011;"SANTA FE DO SUL (SP)";"SP";"SANTA FE DO SUL";611;24;38;673
2011;"SANTA GERTRUDES (SP)";"SP";"SANTA GERTRUDES";616;54;24;694
2011;"SANTA ISABEL (SP)";"SP";"SANTA ISABEL";1187;82;95;1364
2011;"SANTA LUCIA (SP)";"SP";"SANTA LUCIA";118;21;45;184
2011;"SANTA MARIA DA SERRA (SP)";"SP";"SANTA MARIA DA SERRA";238;23;25;286
2011;"SANTA MERCEDES (SP)";"SP";"SANTA MERCEDES";46;8;10;64
2011;"SANTA RITA D OESTE (SP)";"SP";"SANTA RITA D OESTE";27;1;7;35
2011;"SANTA RITA DO PASSA QUATRO (SP)";"SP";"SANTA RITA DO PASSA QUATRO";574;57;43;674
2011;"SANTA ROSA DE VITERBO (SP)";"SP";"SANTA ROSA DE VITERBO";394;37;94;525
2011;"SANTA SALETE (SP)";"SP";"SANTA SALETE";41;6;6;53
2011;"SANTANA DA PONTE PENSA (SP)";"SP";"SANTANA DA PONTE PENSA";26;3;3;32
2011;"SANTANA DE PARNAIBA (SP)";"SP";"SANTANA DE PARNAIBA";1738;439;173;2350
2011;"SANTO ANASTACIO (SP)";"SP";"SANTO ANASTACIO";463;23;62;548
2011;"SANTO ANDRE (SP)";"SP";"SANTO ANDRE";10012;1767;1673;13452
2011;"SANTO ANTONIO DA ALEGRIA (SP)";"SP";"SANTO ANTONIO DA ALEGRIA";90;7;24;121
2011;"SANTO ANTONIO DE POSSE (SP)";"SP";"SANTO ANTONIO DE POSSE";728;53;129;910
2011;"SANTO ANTONIO DO ARACANGUA (SP)";"SP";"SANTO ANTONIO DO ARACANGUA";193;23;92;308
2011;"SANTO ANTONIO DO JARDIM (SP)";"SP";"SANTO ANTONIO DO JARDIM";197;12;12;221
2011;"SANTO ANTONIO DO PINHAL (SP)";"SP";"SANTO ANTONIO DO PINHAL";131;21;7;159
2011;"SANTO EXPEDITO (SP)";"SP";"SANTO EXPEDITO";26;3;10;39
2011;"SANTOPOLIS DO AGUAPEI (SP)";"SP";"SANTOPOLIS DO AGUAPEI";69;4;26;99
2011;"SANTOS (SP)";"SP";"SANTOS";5627;850;673;7150
2011;"SAO BENTO DO SAPUCAI (SP)";"SP";"SAO BENTO DO SAPUCAI";128;38;12;178
2011;"SAO BERNARDO DO CAMPO (SP)";"SP";"SAO BERNARDO DO CAMPO";11728;2251;3415;17394
2011;"SAO CAETANO DO SUL (SP)";"SP";"SAO CAETANO DO SUL";2804;564;585;3953
2011;"SAO CARLOS (SP)";"SP";"SAO CARLOS";3520;407;417;4344
2011;"SAO FRANCISCO (SP)";"SP";"SAO FRANCISCO";31;5;21;57
2011;"SAO JOAO DA BOA VISTA (SP)";"SP";"SAO JOAO DA BOA VISTA";1828;232;90;2150
2011;"SAO JOAO DAS DUAS PONTES (SP)";"SP";"SAO JOAO DAS DUAS PONTES";15;8;5;28
2011;"SAO JOAO DE IRACEMA (SP)";"SP";"SAO JOAO DE IRACEMA";30;7;10;47
2011;"SAO JOAO DO PAU D ALHO (SP)";"SP";"SAO JOAO DO PAU D ALHO";37;6;5;48
2011;"SAO JOAQUIM DA BARRA (SP)";"SP";"SAO JOAQUIM DA BARRA";778;56;174;1008
2011;"SAO JOSE DA BELA VISTA (SP)";"SP";"SAO JOSE DA BELA VISTA";77;10;46;133
2011;"SAO JOSE DO BARREIRO (SP)";"SP";"SAO JOSE DO BARREIRO";38;12;8;58
2011;"SAO JOSE DO RIO PARDO (SP)";"SP";"SAO JOSE DO RIO PARDO";1157;77;116;1350
2011;"SAO JOSE DO RIO PRETO (SP)";"SP";"SAO JOSE DO RIO PRETO";7665;604;1464;9733
2011;"SAO JOSE DOS CAMPOS (SP)";"SP";"SAO JOSE DOS CAMPOS";6597;1759;1561;9917
2011;"SAO LOURENCO DA SERRA (SP)";"SP";"SAO LOURENCO DA SERRA";296;22;22;340
2011;"SAO LUIZ DO PARAITINGA (SP)";"SP";"SAO LUIZ DO PARAITINGA";150;31;27;208
2011;"SAO MANUEL (SP)";"SP";"SAO MANUEL";755;110;195;1060
2011;"SAO MIGUEL ARCANJO (SP)";"SP";"SAO MIGUEL ARCANJO";661;84;68;813
2011;"SAO PAULO (SP)";"SP";"SAO PAULO";123859;32018;40828;196705
2011;"SAO PEDRO (SP)";"SP";"SAO PEDRO";557;73;77;707
2011;"SAO PEDRO DO TURVO (SP)";"SP";"SAO PEDRO DO TURVO";158;17;30;205
2011;"SAO ROQUE (SP)";"SP";"SAO ROQUE";1047;200;207;1454
2011;"SAO SEBASTIAO (SP)";"SP";"SAO SEBASTIAO";581;119;192;892
2011;"SAO SEBASTIAO DA GRAMA (SP)";"SP";"SAO SEBASTIAO DA GRAMA";236;23;29;288
2011;"SAO SIMAO (SP)";"SP";"SAO SIMAO";342;18;37;397
2011;"SAO VICENTE (SP)";"SP";"SAO VICENTE";1815;661;895;3371
2011;"SARAPUI (SP)";"SP";"SARAPUI";147;18;10;175
2011;"SARUTAIA (SP)";"SP";"SARUTAIA";39;10;24;73
2011;"SEBASTIANOPOLIS DO SUL (SP)";"SP";"SEBASTIANOPOLIS DO SUL";194;6;15;215
2011;"SERRA AZUL (SP)";"SP";"SERRA AZUL";135;12;86;233
2011;"SERRA NEGRA (SP)";"SP";"SERRA NEGRA";415;53;22;490
2011;"SERRANA (SP)";"SP";"SERRANA";605;98;217;920
2011;"SERTAOZINHO (SP)";"SP";"SERTAOZINHO";2620;143;451;3214
2011;"SETE BARRAS (SP)";"SP";"SETE BARRAS";193;11;32;236
2011;"SEVERINIA (SP)";"SP";"SEVERINIA";319;21;193;533
2011;"SILVEIRAS (SP)";"SP";"SILVEIRAS";78;20;7;105
2011;"SOCORRO (SP)";"SP";"SOCORRO";814;125;42;981
2011;"SOROCABA (SP)";"SP";"SOROCABA";7502;1202;1608;10312
2011;"SUD MENNUCCI (SP)";"SP";"SUD MENNUCCI";135;13;51;199
2011;"SUMARE (SP)";"SP";"SUMARE";2348;534;438;3320
2011;"SUZANAPOLIS (SP)";"SP";"SUZANAPOLIS";56;4;15;75
2011;"SUZANO (SP)";"SP";"SUZANO";2649;659;465;3773
2011;"TABAPUA (SP)";"SP";"TABAPUA";150;13;56;219
2011;"TABATINGA (SP)";"SP";"TABATINGA";330;21;152;503
2011;"TABOAO DA SERRA (SP)";"SP";"TABOAO DA SERRA";2622;778;564;3964
2011;"TACIBA (SP)";"SP";"TACIBA";81;8;25;114
2011;"TAGUAI (SP)";"SP";"TAGUAI";170;6;24;200
2011;"TAIACU (SP)";"SP";"TAIACU";136;6;19;161
2011;"TAIUVA (SP)";"SP";"TAIUVA";150;7;22;179
2011;"TAMBAU (SP)";"SP";"TAMBAU";511;42;53;606
2011;"TANABI (SP)";"SP";"TANABI";476;45;103;624
2011;"TAPIRAI (SP)";"SP";"TAPIRAI";170;12;12;194
2011;"TAPIRATIBA (SP)";"SP";"TAPIRATIBA";375;16;64;455
2011;"TAQUARAL (SP)";"SP";"TAQUARAL";55;8;19;82
2011;"TAQUARITINGA (SP)";"SP";"TAQUARITINGA";1444;81;320;1845
2011;"TAQUARITUBA (SP)";"SP";"TAQUARITUBA";607;58;77;742
2011;"TAQUARIVAI (SP)";"SP";"TAQUARIVAI";52;9;12;73
2011;"TARABAI (SP)";"SP";"TARABAI";91;9;24;124
2011;"TARUMA (SP)";"SP";"TARUMA";355;21;209;585
2011;"TATUI (SP)";"SP";"TATUI";2023;146;774;2943
2011;"TAUBATE (SP)";"SP";"TAUBATE";3100;788;792;4680
2011;"TEJUPA (SP)";"SP";"TEJUPA";47;16;8;71
2011;"TEODORO SAMPAIO (SP)";"SP";"TEODORO SAMPAIO";266;24;301;591
2011;"TERRA ROXA (SP)";"SP";"TERRA ROXA";158;15;59;232
2011;"TIETE (SP)";"SP";"TIETE";1181;47;162;1390
2011;"TIMBURI (SP)";"SP";"TIMBURI";27;4;6;37
2011;"TORRE DE PEDRA (SP)";"SP";"TORRE DE PEDRA";40;6;7;53
2011;"TORRINHA (SP)";"SP";"TORRINHA";396;18;44;458
2011;"TRABIJU (SP)";"SP";"TRABIJU";44;15;8;67
2011;"TREMEMBE (SP)";"SP";"TREMEMBE";381;58;13;452
2011;"TRES FRONTEIRAS (SP)";"SP";"TRES FRONTEIRAS";63;5;10;78
2011;"TUIUTI (SP)";"SP";"TUIUTI";97;22;14;133
2011;"TUPA (SP)";"SP";"TUPA";1384;53;217;1654
2011;"TUPI PAULISTA (SP)";"SP";"TUPI PAULISTA";298;23;25;346
2011;"TURIUBA (SP)";"SP";"TURIUBA";20;0;9;29
2011;"TURMALINA (SP)";"SP";"TURMALINA";22;2;10;34
2011;"UBARANA (SP)";"SP";"UBARANA";122;6;33;161
2011;"UBATUBA (SP)";"SP";"UBATUBA";636;87;51;774
2011;"UBIRAJARA (SP)";"SP";"UBIRAJARA";90;5;25;120
2011;"UCHOA (SP)";"SP";"UCHOA";148;11;43;202
2011;"UNIAO PAULISTA (SP)";"SP";"UNIAO PAULISTA";49;5;7;61
2011;"URANIA (SP)";"SP";"URANIA";161;15;31;207
2011;"URU (SP)";"SP";"URU";9;9;8;26
2011;"URUPES (SP)";"SP";"URUPES";349;20;48;417
2011;"VALENTIM GENTIL (SP)";"SP";"VALENTIM GENTIL";247;20;28;295
2011;"VALINHOS (SP)";"SP";"VALINHOS";2050;474;1836;4360
2011;"VALPARAISO (SP)";"SP";"VALPARAISO";424;31;143;598
2011;"VARGEM (SP)";"SP";"VARGEM";288;20;17;325
2011;"VARGEM GRANDE DO SUL (SP)";"SP";"VARGEM GRANDE DO SUL";1079;78;207;1364
2011;"VARGEM GRANDE PAULISTA (SP)";"SP";"VARGEM GRANDE PAULISTA";909;99;74;1082
2011;"VARZEA PAULISTA (SP)";"SP";"VARZEA PAULISTA";1050;347;220;1617
2011;"VERA CRUZ (SP)";"SP";"VERA CRUZ";136;19;28;183
2011;"VINHEDO (SP)";"SP";"VINHEDO";1471;156;112;1739
2011;"VIRADOURO (SP)";"SP";"VIRADOURO";347;22;64;433
2011;"VISTA ALEGRE DO ALTO (SP)";"SP";"VISTA ALEGRE DO ALTO";322;30;124;476
2011;"VITORIA BRASIL (SP)";"SP";"VITORIA BRASIL";20;2;8;30
2011;"VOTORANTIM (SP)";"SP";"VOTORANTIM";1223;275;254;1752
2011;"VOTUPORANGA (SP)";"SP";"VOTUPORANGA";1920;124;223;2267
2011;"ZACARIAS (SP)";"SP";"ZACARIAS";46;5;17;68
2011;"ABREULANDIA (TO)";"TO";"ABREULANDIA";11;0;1;12
2011;"AGUIARNOPOLIS (TO)";"TO";"AGUIARNOPOLIS";78;11;13;102
2011;"ALIANCA DO TOCANTINS (TO)";"TO";"ALIANCA DO TOCANTINS";64;7;9;80
2011;"ALMAS (TO)";"TO";"ALMAS";51;0;3;54
2011;"ALVORADA (TO)";"TO";"ALVORADA";142;1;4;147
2011;"ANANAS (TO)";"TO";"ANANAS";62;3;23;88
2011;"ANGICO (TO)";"TO";"ANGICO";12;3;3;18
2011;"APARECIDA DO RIO NEGRO (TO)";"TO";"APARECIDA DO RIO NEGRO";51;12;2;65
2011;"ARAGOMINAS (TO)";"TO";"ARAGOMINAS";74;2;16;92
2011;"ARAGUACEMA (TO)";"TO";"ARAGUACEMA";24;1;6;31
2011;"ARAGUACU (TO)";"TO";"ARAGUACU";81;8;8;97
2011;"ARAGUAINA (TO)";"TO";"ARAGUAINA";3619;126;501;4246
2011;"ARAGUANA (TO)";"TO";"ARAGUANA";173;10;38;221
2011;"ARAGUATINS (TO)";"TO";"ARAGUATINS";339;39;60;438
2011;"ARAPOEMA (TO)";"TO";"ARAPOEMA";43;5;10;58
2011;"ARRAIAS (TO)";"TO";"ARRAIAS";41;1;5;47
2011;"AUGUSTINOPOLIS (TO)";"TO";"AUGUSTINOPOLIS";168;33;27;228
2011;"AURORA DO TOCANTINS (TO)";"TO";"AURORA DO TOCANTINS";6;0;2;8
2011;"AXIXA DO TOCANTINS (TO)";"TO";"AXIXA DO TOCANTINS";37;16;8;61
2011;"BABACULANDIA (TO)";"TO";"BABACULANDIA";535;11;32;578
2011;"BANDEIRANTES DO TOCANTINS (TO)";"TO";"BANDEIRANTES DO TOCANTINS";23;3;2;28
2011;"BARRA DO OURO (TO)";"TO";"BARRA DO OURO";7;0;0;7
2011;"BARROLANDIA (TO)";"TO";"BARROLANDIA";45;4;3;52
2011;"BERNARDO SAYAO (TO)";"TO";"BERNARDO SAYAO";34;1;7;42
2011;"BOM JESUS DO TOCANTINS (TO)";"TO";"BOM JESUS DO TOCANTINS";5;1;1;7
2011;"BRASILANDIA DO TOCANTINS (TO)";"TO";"BRASILANDIA DO TOCANTINS";15;1;1;17
2011;"BREJINHO DE NAZARE (TO)";"TO";"BREJINHO DE NAZARE";40;1;8;49
2011;"BURITI DO TOCANTINS (TO)";"TO";"BURITI DO TOCANTINS";50;11;5;66
2011;"CACHOEIRINHA (TO)";"TO";"CACHOEIRINHA";4;0;1;5
2011;"CAMPOS LINDOS (TO)";"TO";"CAMPOS LINDOS";54;0;4;58
2011;"CARIRI DO TOCANTINS (TO)";"TO";"CARIRI DO TOCANTINS";34;4;7;45
2011;"CARMOLANDIA (TO)";"TO";"CARMOLANDIA";393;24;141;558
2011;"CARRASCO BONITO (TO)";"TO";"CARRASCO BONITO";4;4;1;9
2011;"CASEARA (TO)";"TO";"CASEARA";23;3;2;28
2011;"CENTENARIO (TO)";"TO";"CENTENARIO";4;0;1;5
2011;"CHAPADA DA NATIVIDADE (TO)";"TO";"CHAPADA DA NATIVIDADE";13;2;6;21
2011;"CHAPADA DE AREIA (TO)";"TO";"CHAPADA DE AREIA";2;1;1;4
2011;"COLINAS DO TOCANTINS (TO)";"TO";"COLINAS DO TOCANTINS";482;12;56;550
2011;"COLMEIA (TO)";"TO";"COLMEIA";109;7;16;132
2011;"COMBINADO (TO)";"TO";"COMBINADO";15;1;5;21
2011;"CONCEICAO DO TOCANTINS (TO)";"TO";"CONCEICAO DO TOCANTINS";12;0;0;12
2011;"COUTO DE MAGALHAES (TO)";"TO";"COUTO DE MAGALHAES";7;4;6;17
2011;"CRISTALANDIA (TO)";"TO";"CRISTALANDIA";90;0;2;92
2011;"CRIXAS DO TOCANTINS (TO)";"TO";"CRIXAS DO TOCANTINS";7;1;1;9
2011;"DARCINOPOLIS (TO)";"TO";"DARCINOPOLIS";87;8;5;100
2011;"DIANOPOLIS (TO)";"TO";"DIANOPOLIS";144;8;32;184
2011;"DIVINOPOLIS DO TOCANTINS (TO)";"TO";"DIVINOPOLIS DO TOCANTINS";58;3;4;65
2011;"DOIS IRMAOS DO TOCANTINS (TO)";"TO";"DOIS IRMAOS DO TOCANTINS";36;5;8;49
2011;"DUERE (TO)";"TO";"DUERE";34;2;4;40
2011;"ESPERANTINA (TO)";"TO";"ESPERANTINA";17;14;8;39
2011;"FATIMA (TO)";"TO";"FATIMA";34;2;3;39
2011;"FIGUEIROPOLIS (TO)";"TO";"FIGUEIROPOLIS";56;4;4;64
2011;"FILADELFIA (TO)";"TO";"FILADELFIA";51;9;8;68
2011;"FORMOSO DO ARAGUAIA (TO)";"TO";"FORMOSO DO ARAGUAIA";201;7;20;228
2011;"FORTALEZA DO TABOCAO (TO)";"TO";"FORTALEZA DO TABOCAO";24;8;4;36
2011;"GOIANORTE (TO)";"TO";"GOIANORTE";32;5;7;44
2011;"GOIATINS (TO)";"TO";"GOIATINS";71;6;11;88
2011;"GUARAI (TO)";"TO";"GUARAI";342;9;32;383
2011;"GURUPI (TO)";"TO";"GURUPI";1464;37;203;1704
2011;"IPUEIRAS (TO)";"TO";"IPUEIRAS";3;0;3;6
2011;"ITACAJA (TO)";"TO";"ITACAJA";33;2;1;36
2011;"ITAGUATINS (TO)";"TO";"ITAGUATINS";46;4;22;72
2011;"ITAPIRATINS (TO)";"TO";"ITAPIRATINS";18;2;7;27
2011;"ITAPORA DO TOCANTINS (TO)";"TO";"ITAPORA DO TOCANTINS";16;3;5;24
2011;"JAU DO TOCANTINS (TO)";"TO";"JAU DO TOCANTINS";15;1;6;22
2011;"JUARINA (TO)";"TO";"JUARINA";13;1;4;18
2011;"LAGOA DA CONFUSAO (TO)";"TO";"LAGOA DA CONFUSAO";101;4;8;113
2011;"LAGOA DO TOCANTINS (TO)";"TO";"LAGOA DO TOCANTINS";7;1;5;13
2011;"LAJEADO (TO)";"TO";"LAJEADO";25;1;8;34
2011;"LAVANDEIRA (TO)";"TO";"LAVANDEIRA";2;0;0;2
2011;"LIZARDA (TO)";"TO";"LIZARDA";12;1;1;14
2011;"LUZINOPOLIS (TO)";"TO";"LUZINOPOLIS";9;2;0;11
2011;"MARIANOPOLIS DO TOCANTINS (TO)";"TO";"MARIANOPOLIS DO TOCANTINS";30;0;4;34
2011;"MATEIROS (TO)";"TO";"MATEIROS";21;0;2;23
2011;"MAURILANDIA DO TOCANTINS (TO)";"TO";"MAURILANDIA DO TOCANTINS";11;8;2;21
2011;"MIRACEMA DO TOCANTINS (TO)";"TO";"MIRACEMA DO TOCANTINS";191;18;34;243
2011;"MIRANORTE (TO)";"TO";"MIRANORTE";212;11;12;235
2011;"MONTE DO CARMO (TO)";"TO";"MONTE DO CARMO";20;3;4;27
2011;"MONTE SANTO DO TOCANTINS (TO)";"TO";"MONTE SANTO DO TOCANTINS";21;3;2;26
2011;"MURICILANDIA (TO)";"TO";"MURICILANDIA";11;1;1;13
2011;"NATIVIDADE (TO)";"TO";"NATIVIDADE";65;2;4;71
2011;"NAZARE (TO)";"TO";"NAZARE";20;3;3;26
2011;"NOVA OLINDA (TO)";"TO";"NOVA OLINDA";87;3;20;110
2011;"NOVA ROSALANDIA (TO)";"TO";"NOVA ROSALANDIA";17;1;2;20
2011;"NOVO ACORDO (TO)";"TO";"NOVO ACORDO";19;0;4;23
2011;"NOVO ALEGRE (TO)";"TO";"NOVO ALEGRE";8;2;4;14
2011;"NOVO JARDIM (TO)";"TO";"NOVO JARDIM";16;0;2;18
2011;"OLIVEIRA DE FATIMA (TO)";"TO";"OLIVEIRA DE FATIMA";7;0;3;10
2011;"PALMAS (TO)";"TO";"PALMAS";4246;314;1012;5572
2011;"PALMEIRANTE (TO)";"TO";"PALMEIRANTE";11;4;2;17
2011;"PALMEIRAS DO TOCANTINS (TO)";"TO";"PALMEIRAS DO TOCANTINS";36;7;6;49
2011;"PALMEIROPOLIS (TO)";"TO";"PALMEIROPOLIS";101;2;11;114
2011;"PARAISO DO TOCANTINS (TO)";"TO";"PARAISO DO TOCANTINS";1110;28;110;1248
2011;"PARANA (TO)";"TO";"PARANA";18;4;1;23
2011;"PAU D ARCO (TO)";"TO";"PAU D ARCO";14;0;4;18
2011;"PEDRO AFONSO (TO)";"TO";"PEDRO AFONSO";167;5;38;210
2011;"PEIXE (TO)";"TO";"PEIXE";60;9;41;110
2011;"PEQUIZEIRO (TO)";"TO";"PEQUIZEIRO";27;0;5;32
2011;"PINDORAMA DO TOCANTINS (TO)";"TO";"PINDORAMA DO TOCANTINS";24;0;5;29
2011;"PIRAQUE (TO)";"TO";"PIRAQUE";3;0;5;8
2011;"PIUM (TO)";"TO";"PIUM";35;3;9;47
2011;"PONTE ALTA DO BOM JESUS (TO)";"TO";"PONTE ALTA DO BOM JESUS";10;1;0;11
2011;"PONTE ALTA DO TOCANTINS (TO)";"TO";"PONTE ALTA DO TOCANTINS";27;2;4;33
2011;"PORTO ALEGRE DO TOCANTINS (TO)";"TO";"PORTO ALEGRE DO TOCANTINS";7;0;4;11
2011;"PORTO NACIONAL (TO)";"TO";"PORTO NACIONAL";599;40;96;735
2011;"PRAIA NORTE (TO)";"TO";"PRAIA NORTE";6;7;2;15
2011;"PRESIDENTE KENNEDY (TO)";"TO";"PRESIDENTE KENNEDY";37;2;1;40
2011;"PUGMIL (TO)";"TO";"PUGMIL";14;1;1;16
2011;"RECURSOLANDIA (TO)";"TO";"RECURSOLANDIA";11;0;1;12
2011;"RIACHINHO (TO)";"TO";"RIACHINHO";182;24;119;325
2011;"RIO DA CONCEICAO (TO)";"TO";"RIO DA CONCEICAO";5;1;1;7
2011;"RIO DOS BOIS (TO)";"TO";"RIO DOS BOIS";8;0;2;10
2011;"RIO SONO (TO)";"TO";"RIO SONO";14;1;6;21
2011;"SAMPAIO (TO)";"TO";"SAMPAIO";78;3;4;85
2011;"SANDOLANDIA (TO)";"TO";"SANDOLANDIA";12;6;1;19
2011;"SANTA FE DO ARAGUAIA (TO)";"TO";"SANTA FE DO ARAGUAIA";63;10;8;81
2011;"SANTA MARIA DO TOCANTINS (TO)";"TO";"SANTA MARIA DO TOCANTINS";10;4;2;16
2011;"SANTA RITA DO TOCANTINS (TO)";"TO";"SANTA RITA DO TOCANTINS";13;2;3;18
2011;"SANTA ROSA DO TOCANTINS (TO)";"TO";"SANTA ROSA DO TOCANTINS";26;0;3;29
2011;"SANTA TEREZA DO TOCANTINS (TO)";"TO";"SANTA TEREZA DO TOCANTINS";14;1;1;16
2011;"SANTA TEREZINHA DO TOCANTINS (TO)";"TO";"SANTA TEREZINHA DO TOCANTINS";9;4;1;14
2011;"SAO BENTO DO TOCANTINS (TO)";"TO";"SAO BENTO DO TOCANTINS";17;4;10;31
2011;"SAO FELIX DO TOCANTINS (TO)";"TO";"SAO FELIX DO TOCANTINS";5;1;0;6
2011;"SAO MIGUEL DO TOCANTINS (TO)";"TO";"SAO MIGUEL DO TOCANTINS";124;20;48;192
2011;"SAO SALVADOR DO TOCANTINS (TO)";"TO";"SAO SALVADOR DO TOCANTINS";20;3;2;25
2011;"SAO SEBASTIAO DO TOCANTINS (TO)";"TO";"SAO SEBASTIAO DO TOCANTINS";12;2;3;17
2011;"SAO VALERIO DA NATIVIDADE (TO)";"TO";"SAO VALERIO DA NATIVIDADE";43;1;5;49
2011;"SILVANOPOLIS (TO)";"TO";"SILVANOPOLIS";30;1;3;34
2011;"SITIO NOVO DO TOCANTINS (TO)";"TO";"SITIO NOVO DO TOCANTINS";53;6;15;74
2011;"SUCUPIRA (TO)";"TO";"SUCUPIRA";9;0;6;15
2011;"TAGUATINGA (TO)";"TO";"TAGUATINGA";77;6;16;99
2011;"TAIPAS DO TOCANTINS (TO)";"TO";"TAIPAS DO TOCANTINS";7;1;0;8
2011;"TALISMA (TO)";"TO";"TALISMA";12;6;1;19
2011;"TOCANTINIA (TO)";"TO";"TOCANTINIA";20;0;3;23
2011;"TOCANTINOPOLIS (TO)";"TO";"TOCANTINOPOLIS";1368;181;273;1822
2011;"TUPIRAMA (TO)";"TO";"TUPIRAMA";15;2;2;19
2011;"TUPIRATINS (TO)";"TO";"TUPIRATINS";10;0;6;16
2011;"WANDERLANDIA (TO)";"TO";"WANDERLANDIA";78;4;5;87
2011;"XAMBIOA (TO)";"TO";"XAMBIOA";117;4;16;137
