"ano";"chave";"UF";"MUNICIPIO";"CAMINHAO";"MICRO_ONIBUS";"ONIBUS";"total"
2010;"ACRELANDIA (AC)";"AC";"ACRELANDIA";139;1;25;165
2010;"ASSIS BRASIL (AC)";"AC";"ASSIS BRASIL";14;0;2;16
2010;"BRASILEIA (AC)";"AC";"BRASILEIA";135;3;8;146
2010;"BUJARI (AC)";"AC";"BUJARI";72;3;3;78
2010;"CAPIXABA (AC)";"AC";"CAPIXABA";53;1;7;61
2010;"CRUZEIRO DO SUL (AC)";"AC";"CRUZEIRO DO SUL";436;31;37;504
2010;"EPITACIOLANDIA (AC)";"AC";"EPITACIOLANDIA";120;0;10;130
2010;"FEIJO (AC)";"AC";"FEIJO";74;1;1;76
2010;"JORDAO (AC)";"AC";"JORDAO";0;0;0;0
2010;"MANCIO LIMA (AC)";"AC";"MANCIO LIMA";51;1;6;58
2010;"MANOEL URBANO (AC)";"AC";"MANOEL URBANO";15;0;1;16
2010;"MARECHAL THAUMATURGO (AC)";"AC";"MARECHAL THAUMATURGO";3;0;0;3
2010;"PLACIDO DE CASTRO (AC)";"AC";"PLACIDO DE CASTRO";106;1;5;112
2010;"PORTO ACRE (AC)";"AC";"PORTO ACRE";101;3;22;126
2010;"PORTO WALTER (AC)";"AC";"PORTO WALTER";0;0;0;0
2010;"RIO BRANCO (AC)";"AC";"RIO BRANCO";3343;123;433;3899
2010;"RODRIGUES ALVES (AC)";"AC";"RODRIGUES ALVES";6;1;1;8
2010;"SANTA ROSA DO PURUS (AC)";"AC";"SANTA ROSA DO PURUS";1;0;1;2
2010;"SENA MADUREIRA (AC)";"AC";"SENA MADUREIRA";79;3;3;85
2010;"SENADOR GUIOMARD (AC)";"AC";"SENADOR GUIOMARD";245;3;13;261
2010;"TARAUACA (AC)";"AC";"TARAUACA";108;0;4;112
2010;"XAPURI (AC)";"AC";"XAPURI";47;0;1;48
2010;"AGUA BRANCA (AL)";"AL";"AGUA BRANCA";45;77;6;128
2010;"ANADIA (AL)";"AL";"ANADIA";34;50;31;115
2010;"ARAPIRACA (AL)";"AL";"ARAPIRACA";2437;414;256;3107
2010;"ATALAIA (AL)";"AL";"ATALAIA";176;50;89;315
2010;"BARRA DE SANTO ANTONIO (AL)";"AL";"BARRA DE SANTO ANTONIO";21;7;12;40
2010;"BARRA DE SAO MIGUEL (AL)";"AL";"BARRA DE SAO MIGUEL";16;2;5;23
2010;"BATALHA (AL)";"AL";"BATALHA";70;18;2;90
2010;"BELEM (AL)";"AL";"BELEM";8;14;1;23
2010;"BELO MONTE (AL)";"AL";"BELO MONTE";25;4;1;30
2010;"BOCA DA MATA (AL)";"AL";"BOCA DA MATA";225;65;83;373
2010;"BRANQUINHA (AL)";"AL";"BRANQUINHA";13;21;7;41
2010;"CACIMBINHAS (AL)";"AL";"CACIMBINHAS";36;23;7;66
2010;"CAJUEIRO (AL)";"AL";"CAJUEIRO";94;12;38;144
2010;"CAMPESTRE (AL)";"AL";"CAMPESTRE";11;43;8;62
2010;"CAMPO ALEGRE (AL)";"AL";"CAMPO ALEGRE";136;115;94;345
2010;"CAMPO GRANDE (AL)";"AL";"CAMPO GRANDE";42;14;6;62
2010;"CANAPI (AL)";"AL";"CANAPI";23;20;10;53
2010;"CAPELA (AL)";"AL";"CAPELA";57;4;30;91
2010;"CARNEIROS (AL)";"AL";"CARNEIROS";18;5;0;23
2010;"CHA PRETA (AL)";"AL";"CHA PRETA";20;7;5;32
2010;"COITE DO NOIA (AL)";"AL";"COITE DO NOIA";33;4;11;48
2010;"COLONIA LEOPOLDINA (AL)";"AL";"COLONIA LEOPOLDINA";45;15;20;80
2010;"COQUEIRO SECO (AL)";"AL";"COQUEIRO SECO";8;5;3;16
2010;"CORURIPE (AL)";"AL";"CORURIPE";302;49;146;497
2010;"CRAIBAS (AL)";"AL";"CRAIBAS";69;23;13;105
2010;"DELMIRO GOUVEIA (AL)";"AL";"DELMIRO GOUVEIA";383;287;28;698
2010;"DOIS RIACHOS (AL)";"AL";"DOIS RIACHOS";46;9;4;59
2010;"ESTRELA DE ALAGOAS (AL)";"AL";"ESTRELA DE ALAGOAS";31;33;12;76
2010;"FEIRA GRANDE (AL)";"AL";"FEIRA GRANDE";34;0;27;61
2010;"FELIZ DESERTO (AL)";"AL";"FELIZ DESERTO";3;6;5;14
2010;"FLEXEIRAS (AL)";"AL";"FLEXEIRAS";22;14;28;64
2010;"GIRAU DO PONCIANO (AL)";"AL";"GIRAU DO PONCIANO";86;28;32;146
2010;"IBATEGUARA (AL)";"AL";"IBATEGUARA";30;45;10;85
2010;"IGACI (AL)";"AL";"IGACI";55;45;22;122
2010;"IGREJA NOVA (AL)";"AL";"IGREJA NOVA";60;17;51;128
2010;"INHAPI (AL)";"AL";"INHAPI";33;9;2;44
2010;"JACARE DOS HOMENS (AL)";"AL";"JACARE DOS HOMENS";29;3;4;36
2010;"JACUIPE (AL)";"AL";"JACUIPE";9;7;10;26
2010;"JAPARATINGA (AL)";"AL";"JAPARATINGA";8;12;3;23
2010;"JARAMATAIA (AL)";"AL";"JARAMATAIA";11;8;3;22
2010;"JEQUIA DA PRAIA (AL)";"AL";"JEQUIA DA PRAIA";27;11;23;61
2010;"JOAQUIM GOMES (AL)";"AL";"JOAQUIM GOMES";78;24;49;151
2010;"JUNDIA (AL)";"AL";"JUNDIA";8;2;9;19
2010;"JUNQUEIRO (AL)";"AL";"JUNQUEIRO";155;26;81;262
2010;"LAGOA DA CANOA (AL)";"AL";"LAGOA DA CANOA";54;11;20;85
2010;"LIMOEIRO DE ANADIA (AL)";"AL";"LIMOEIRO DE ANADIA";53;15;32;100
2010;"MACEIO (AL)";"AL";"MACEIO";5456;881;1502;7839
2010;"MAJOR ISIDORO (AL)";"AL";"MAJOR ISIDORO";51;19;13;83
2010;"MAR VERMELHO (AL)";"AL";"MAR VERMELHO";9;1;4;14
2010;"MARAGOGI (AL)";"AL";"MARAGOGI";36;70;24;130
2010;"MARAVILHA (AL)";"AL";"MARAVILHA";25;24;5;54
2010;"MARECHAL DEODORO (AL)";"AL";"MARECHAL DEODORO";201;69;65;335
2010;"MARIBONDO (AL)";"AL";"MARIBONDO";38;20;11;69
2010;"MATA GRANDE (AL)";"AL";"MATA GRANDE";48;22;4;74
2010;"MATRIZ DE CAMARAGIBE (AL)";"AL";"MATRIZ DE CAMARAGIBE";110;24;82;216
2010;"MESSIAS (AL)";"AL";"MESSIAS";56;35;52;143
2010;"MINADOR DO NEGRAO (AL)";"AL";"MINADOR DO NEGRAO";23;11;4;38
2010;"MONTEIROPOLIS (AL)";"AL";"MONTEIROPOLIS";9;2;4;15
2010;"MURICI (AL)";"AL";"MURICI";88;22;71;181
2010;"NOVO LINO (AL)";"AL";"NOVO LINO";43;18;29;90
2010;"OLHO D AGUA DAS FLORES (AL)";"AL";"OLHO D AGUA DAS FLORES";84;40;11;135
2010;"OLHO D AGUA DO CASADO (AL)";"AL";"OLHO D AGUA DO CASADO";19;12;4;35
2010;"OLHO D AGUA GRANDE (AL)";"AL";"OLHO D AGUA GRANDE";9;2;11;22
2010;"OLIVENCA (AL)";"AL";"OLIVENCA";24;6;4;34
2010;"OURO BRANCO (AL)";"AL";"OURO BRANCO";34;28;13;75
2010;"PALESTINA (AL)";"AL";"PALESTINA";5;4;1;10
2010;"PALMEIRA DOS INDIOS (AL)";"AL";"PALMEIRA DOS INDIOS";489;115;37;641
2010;"PAO DE ACUCAR (AL)";"AL";"PAO DE ACUCAR";49;13;5;67
2010;"PARICONHA (AL)";"AL";"PARICONHA";17;15;5;37
2010;"PARIPUEIRA (AL)";"AL";"PARIPUEIRA";44;3;8;55
2010;"PASSO DE CAMARAGIBE (AL)";"AL";"PASSO DE CAMARAGIBE";26;5;18;49
2010;"PAULO JACINTO (AL)";"AL";"PAULO JACINTO";10;7;5;22
2010;"PENEDO (AL)";"AL";"PENEDO";216;71;138;425
2010;"PIACABUCU (AL)";"AL";"PIACABUCU";17;17;7;41
2010;"PILAR (AL)";"AL";"PILAR";137;55;56;248
2010;"PINDOBA (AL)";"AL";"PINDOBA";10;2;2;14
2010;"PIRANHAS (AL)";"AL";"PIRANHAS";39;53;4;96
2010;"POCO DAS TRINCHEIRAS (AL)";"AL";"POCO DAS TRINCHEIRAS";40;34;14;88
2010;"PORTO CALVO (AL)";"AL";"PORTO CALVO";172;101;36;309
2010;"PORTO DE PEDRAS (AL)";"AL";"PORTO DE PEDRAS";6;7;4;17
2010;"PORTO REAL DO COLEGIO (AL)";"AL";"PORTO REAL DO COLEGIO";15;20;17;52
2010;"QUEBRANGULO (AL)";"AL";"QUEBRANGULO";19;7;3;29
2010;"RIO LARGO (AL)";"AL";"RIO LARGO";357;149;135;641
2010;"ROTEIRO (AL)";"AL";"ROTEIRO";9;17;6;32
2010;"SANTA LUZIA DO NORTE (AL)";"AL";"SANTA LUZIA DO NORTE";8;3;56;67
2010;"SANTANA DO IPANEMA (AL)";"AL";"SANTANA DO IPANEMA";292;74;25;391
2010;"SANTANA DO MUNDAU (AL)";"AL";"SANTANA DO MUNDAU";51;23;1;75
2010;"SAO BRAS (AL)";"AL";"SAO BRAS";1;1;3;5
2010;"SAO JOSE DA LAJE (AL)";"AL";"SAO JOSE DA LAJE";83;75;37;195
2010;"SAO JOSE DA TAPERA (AL)";"AL";"SAO JOSE DA TAPERA";65;13;10;88
2010;"SAO LUIS DO QUITUNDE (AL)";"AL";"SAO LUIS DO QUITUNDE";198;21;89;308
2010;"SAO MIGUEL DOS CAMPOS (AL)";"AL";"SAO MIGUEL DOS CAMPOS";412;144;161;717
2010;"SAO MIGUEL DOS MILAGRES (AL)";"AL";"SAO MIGUEL DOS MILAGRES";17;1;4;22
2010;"SAO SEBASTIAO (AL)";"AL";"SAO SEBASTIAO";125;31;75;231
2010;"SATUBA (AL)";"AL";"SATUBA";52;12;16;80
2010;"SENADOR RUI PALMEIRA (AL)";"AL";"SENADOR RUI PALMEIRA";23;8;6;37
2010;"TANQUE D ARCA (AL)";"AL";"TANQUE D ARCA";8;8;4;20
2010;"TAQUARANA (AL)";"AL";"TAQUARANA";62;30;22;114
2010;"TEOTONIO VILELA (AL)";"AL";"TEOTONIO VILELA";179;80;137;396
2010;"TRAIPU (AL)";"AL";"TRAIPU";63;11;6;80
2010;"UNIAO DOS PALMARES (AL)";"AL";"UNIAO DOS PALMARES";395;187;126;708
2010;"VICOSA (AL)";"AL";"VICOSA";120;12;31;163
2010;"ALVARAES (AM)";"AM";"ALVARAES";2;0;2;4
2010;"AMATURA (AM)";"AM";"AMATURA";1;0;1;2
2010;"ANAMA (AM)";"AM";"ANAMA";0;0;2;2
2010;"ANORI (AM)";"AM";"ANORI";1;0;1;2
2010;"APUI (AM)";"AM";"APUI";54;2;9;65
2010;"ATALAIA DO NORTE (AM)";"AM";"ATALAIA DO NORTE";1;0;1;2
2010;"AUTAZES (AM)";"AM";"AUTAZES";16;2;10;28
2010;"BARCELOS (AM)";"AM";"BARCELOS";6;1;0;7
2010;"BARREIRINHA (AM)";"AM";"BARREIRINHA";1;0;0;1
2010;"BENJAMIN CONSTANT (AM)";"AM";"BENJAMIN CONSTANT";10;4;2;16
2010;"BERURI (AM)";"AM";"BERURI";0;0;0;0
2010;"BOA VISTA DO RAMOS (AM)";"AM";"BOA VISTA DO RAMOS";1;0;1;2
2010;"BOCA DO ACRE (AM)";"AM";"BOCA DO ACRE";25;2;0;27
2010;"BORBA (AM)";"AM";"BORBA";6;0;2;8
2010;"CAAPIRANGA (AM)";"AM";"CAAPIRANGA";5;1;2;8
2010;"CANUTAMA (AM)";"AM";"CANUTAMA";0;0;0;0
2010;"CARAUARI (AM)";"AM";"CARAUARI";18;1;0;19
2010;"CAREIRO (AM)";"AM";"CAREIRO";44;15;38;97
2010;"CAREIRO DA VARZEA (AM)";"AM";"CAREIRO DA VARZEA";10;22;27;59
2010;"COARI (AM)";"AM";"COARI";91;3;6;100
2010;"CODAJAS (AM)";"AM";"CODAJAS";6;0;2;8
2010;"EIRUNEPE (AM)";"AM";"EIRUNEPE";21;0;0;21
2010;"ENVIRA (AM)";"AM";"ENVIRA";13;0;2;15
2010;"FONTE BOA (AM)";"AM";"FONTE BOA";12;0;0;12
2010;"GUAJARA (AM)";"AM";"GUAJARA";0;0;1;1
2010;"HUMAITA (AM)";"AM";"HUMAITA";98;1;10;109
2010;"IPIXUNA (AM)";"AM";"IPIXUNA";1;0;0;1
2010;"IRANDUBA (AM)";"AM";"IRANDUBA";147;8;47;202
2010;"ITACOATIARA (AM)";"AM";"ITACOATIARA";269;21;90;380
2010;"ITAMARATI (AM)";"AM";"ITAMARATI";2;0;0;2
2010;"ITAPIRANGA (AM)";"AM";"ITAPIRANGA";6;1;2;9
2010;"JAPURA (AM)";"AM";"JAPURA";4;0;0;4
2010;"JURUA (AM)";"AM";"JURUA";5;0;0;5
2010;"JUTAI (AM)";"AM";"JUTAI";2;0;0;2
2010;"LABREA (AM)";"AM";"LABREA";12;1;2;15
2010;"MANACAPURU (AM)";"AM";"MANACAPURU";229;29;52;310
2010;"MANAQUIRI (AM)";"AM";"MANAQUIRI";7;1;2;10
2010;"MANAUS (AM)";"AM";"MANAUS";14631;2334;5807;22772
2010;"MANICORE (AM)";"AM";"MANICORE";13;1;3;17
2010;"MARAA (AM)";"AM";"MARAA";2;0;0;2
2010;"MAUES (AM)";"AM";"MAUES";29;1;6;36
2010;"NHAMUNDA (AM)";"AM";"NHAMUNDA";6;0;0;6
2010;"NOVA OLINDA DO NORTE (AM)";"AM";"NOVA OLINDA DO NORTE";11;6;6;23
2010;"NOVO AIRAO (AM)";"AM";"NOVO AIRAO";17;5;14;36
2010;"NOVO ARIPUANA (AM)";"AM";"NOVO ARIPUANA";14;2;5;21
2010;"PARINTINS (AM)";"AM";"PARINTINS";118;5;12;135
2010;"PAUINI (AM)";"AM";"PAUINI";2;1;1;4
2010;"PRESIDENTE FIGUEIREDO (AM)";"AM";"PRESIDENTE FIGUEIREDO";200;31;48;279
2010;"RIO PRETO DA EVA (AM)";"AM";"RIO PRETO DA EVA";75;11;48;134
2010;"SANTA ISABEL DO RIO NEGRO (AM)";"AM";"SANTA ISABEL DO RIO NEGRO";7;2;3;12
2010;"SANTO ANTONIO DO ICA (AM)";"AM";"SANTO ANTONIO DO ICA";6;0;0;6
2010;"SAO GABRIEL DA CACHOEIRA (AM)";"AM";"SAO GABRIEL DA CACHOEIRA";61;8;21;90
2010;"SAO PAULO DE OLIVENCA (AM)";"AM";"SAO PAULO DE OLIVENCA";4;0;0;4
2010;"SAO SEBASTIAO DO UATUMA (AM)";"AM";"SAO SEBASTIAO DO UATUMA";4;0;0;4
2010;"SILVES (AM)";"AM";"SILVES";7;2;2;11
2010;"TABATINGA (AM)";"AM";"TABATINGA";44;4;0;48
2010;"TAPAUA (AM)";"AM";"TAPAUA";3;0;1;4
2010;"TEFE (AM)";"AM";"TEFE";39;9;5;53
2010;"TONANTINS (AM)";"AM";"TONANTINS";2;1;1;4
2010;"UARINI (AM)";"AM";"UARINI";7;0;0;7
2010;"URUCARA (AM)";"AM";"URUCARA";10;2;2;14
2010;"URUCURITUBA (AM)";"AM";"URUCURITUBA";2;0;1;3
2010;"AMAPA (AP)";"AP";"AMAPA";5;2;1;8
2010;"CALCOENE (AP)";"AP";"CALCOENE";9;0;1;10
2010;"CUTIAS (AP)";"AP";"CUTIAS";3;1;0;4
2010;"FERREIRA GOMES (AP)";"AP";"FERREIRA GOMES";2;0;0;2
2010;"ITAUBAL (AP)";"AP";"ITAUBAL";3;0;2;5
2010;"LARANJAL DO JARI (AP)";"AP";"LARANJAL DO JARI";48;7;6;61
2010;"MACAPA (AP)";"AP";"MACAPA";2433;249;495;3177
2010;"MAZAGAO (AP)";"AP";"MAZAGAO";49;5;10;64
2010;"OIAPOQUE (AP)";"AP";"OIAPOQUE";35;5;3;43
2010;"PEDRA BRANCA DO AMAPARI (AP)";"AP";"PEDRA BRANCA DO AMAPARI";12;2;3;17
2010;"PORTO GRANDE (AP)";"AP";"PORTO GRANDE";23;1;6;30
2010;"PRACUUBA (AP)";"AP";"PRACUUBA";3;0;1;4
2010;"SANTANA (AP)";"AP";"SANTANA";469;37;109;615
2010;"SERRA DO NAVIO (AP)";"AP";"SERRA DO NAVIO";2;3;0;5
2010;"TARTARUGALZINHO (AP)";"AP";"TARTARUGALZINHO";6;0;1;7
2010;"VITORIA DO JARI (AP)";"AP";"VITORIA DO JARI";0;0;1;1
2010;"ABAIRA (BA)";"BA";"ABAIRA";47;16;14;77
2010;"ABARE (BA)";"BA";"ABARE";45;14;18;77
2010;"ACAJUTIBA (BA)";"BA";"ACAJUTIBA";47;6;10;63
2010;"ADUSTINA (BA)";"BA";"ADUSTINA";7;7;5;19
2010;"AGUA FRIA (BA)";"BA";"AGUA FRIA";11;13;29;53
2010;"AIQUARA (BA)";"BA";"AIQUARA";4;2;2;8
2010;"ALAGOINHAS (BA)";"BA";"ALAGOINHAS";1009;244;414;1667
2010;"ALCOBACA (BA)";"BA";"ALCOBACA";25;4;19;48
2010;"ALMADINA (BA)";"BA";"ALMADINA";13;1;4;18
2010;"AMARGOSA (BA)";"BA";"AMARGOSA";222;39;61;322
2010;"AMELIA RODRIGUES (BA)";"BA";"AMELIA RODRIGUES";161;71;27;259
2010;"AMERICA DOURADA (BA)";"BA";"AMERICA DOURADA";13;8;5;26
2010;"ANAGE (BA)";"BA";"ANAGE";58;39;31;128
2010;"ANDARAI (BA)";"BA";"ANDARAI";23;2;13;38
2010;"ANDORINHA (BA)";"BA";"ANDORINHA";55;7;30;92
2010;"ANGICAL (BA)";"BA";"ANGICAL";26;10;15;51
2010;"ANGUERA (BA)";"BA";"ANGUERA";14;5;11;30
2010;"ANTAS (BA)";"BA";"ANTAS";21;6;8;35
2010;"ANTONIO CARDOSO (BA)";"BA";"ANTONIO CARDOSO";1;23;10;34
2010;"ANTONIO GONCALVES (BA)";"BA";"ANTONIO GONCALVES";19;5;4;28
2010;"APORA (BA)";"BA";"APORA";24;15;17;56
2010;"APUAREMA (BA)";"BA";"APUAREMA";24;5;8;37
2010;"ARACAS (BA)";"BA";"ARACAS";50;9;21;80
2010;"ARACATU (BA)";"BA";"ARACATU";62;16;14;92
2010;"ARACI (BA)";"BA";"ARACI";210;17;47;274
2010;"ARAMARI (BA)";"BA";"ARAMARI";38;4;7;49
2010;"ARATACA (BA)";"BA";"ARATACA";20;0;3;23
2010;"ARATUIPE (BA)";"BA";"ARATUIPE";25;3;10;38
2010;"AURELINO LEAL (BA)";"BA";"AURELINO LEAL";41;3;12;56
2010;"BAIANOPOLIS (BA)";"BA";"BAIANOPOLIS";37;5;24;66
2010;"BAIXA GRANDE (BA)";"BA";"BAIXA GRANDE";68;32;36;136
2010;"BANZAE (BA)";"BA";"BANZAE";18;4;16;38
2010;"BARRA (BA)";"BA";"BARRA";39;16;22;77
2010;"BARRA DA ESTIVA (BA)";"BA";"BARRA DA ESTIVA";152;34;46;232
2010;"BARRA DO CHOCA (BA)";"BA";"BARRA DO CHOCA";93;138;23;254
2010;"BARRA DO MENDES (BA)";"BA";"BARRA DO MENDES";45;15;5;65
2010;"BARRA DO ROCHA (BA)";"BA";"BARRA DO ROCHA";6;3;1;10
2010;"BARREIRAS (BA)";"BA";"BARREIRAS";2162;97;331;2590
2010;"BARRO ALTO (BA)";"BA";"BARRO ALTO";34;9;13;56
2010;"BARRO PRETO (BA)";"BA";"BARRO PRETO";9;1;9;19
2010;"BARROCAS (BA)";"BA";"BARROCAS";71;1;15;87
2010;"BELMONTE (BA)";"BA";"BELMONTE";40;2;10;52
2010;"BELO CAMPO (BA)";"BA";"BELO CAMPO";76;8;18;102
2010;"BIRITINGA (BA)";"BA";"BIRITINGA";16;8;26;50
2010;"BOA NOVA (BA)";"BA";"BOA NOVA";19;21;17;57
2010;"BOA VISTA DO TUPIM (BA)";"BA";"BOA VISTA DO TUPIM";40;8;14;62
2010;"BOM JESUS DA LAPA (BA)";"BA";"BOM JESUS DA LAPA";371;43;86;500
2010;"BOM JESUS DA SERRA (BA)";"BA";"BOM JESUS DA SERRA";20;31;15;66
2010;"BONINAL (BA)";"BA";"BONINAL";60;18;24;102
2010;"BONITO (BA)";"BA";"BONITO";56;7;9;72
2010;"BOQUIRA (BA)";"BA";"BOQUIRA";100;7;49;156
2010;"BOTUPORA (BA)";"BA";"BOTUPORA";39;3;32;74
2010;"BREJOES (BA)";"BA";"BREJOES";71;6;27;104
2010;"BREJOLANDIA (BA)";"BA";"BREJOLANDIA";27;8;17;52
2010;"BROTAS DE MACAUBAS (BA)";"BA";"BROTAS DE MACAUBAS";24;23;12;59
2010;"BRUMADO (BA)";"BA";"BRUMADO";1004;177;223;1404
2010;"BUERAREMA (BA)";"BA";"BUERAREMA";117;6;27;150
2010;"BURITIRAMA (BA)";"BA";"BURITIRAMA";12;3;12;27
2010;"CAATIBA (BA)";"BA";"CAATIBA";14;4;0;18
2010;"CABACEIRAS DO PARAGUACU (BA)";"BA";"CABACEIRAS DO PARAGUACU";44;18;35;97
2010;"CACHOEIRA (BA)";"BA";"CACHOEIRA";90;92;62;244
2010;"CACULE (BA)";"BA";"CACULE";292;22;40;354
2010;"CAEM (BA)";"BA";"CAEM";14;7;9;30
2010;"CAETANOS (BA)";"BA";"CAETANOS";32;7;8;47
2010;"CAETITE (BA)";"BA";"CAETITE";410;62;77;549
2010;"CAFARNAUM (BA)";"BA";"CAFARNAUM";41;4;19;64
2010;"CAIRU (BA)";"BA";"CAIRU";9;6;3;18
2010;"CALDEIRAO GRANDE (BA)";"BA";"CALDEIRAO GRANDE";27;3;12;42
2010;"CAMACAN (BA)";"BA";"CAMACAN";177;22;35;234
2010;"CAMACARI (BA)";"BA";"CAMACARI";1806;353;1094;3253
2010;"CAMAMU (BA)";"BA";"CAMAMU";107;37;26;170
2010;"CAMPO ALEGRE DE LOURDES (BA)";"BA";"CAMPO ALEGRE DE LOURDES";47;4;5;56
2010;"CAMPO FORMOSO (BA)";"BA";"CAMPO FORMOSO";173;23;65;261
2010;"CANAPOLIS (BA)";"BA";"CANAPOLIS";10;15;11;36
2010;"CANARANA (BA)";"BA";"CANARANA";129;7;11;147
2010;"CANAVIEIRAS (BA)";"BA";"CANAVIEIRAS";68;8;13;89
2010;"CANDEAL (BA)";"BA";"CANDEAL";18;17;6;41
2010;"CANDEIAS (BA)";"BA";"CANDEIAS";822;258;283;1363
2010;"CANDIBA (BA)";"BA";"CANDIBA";49;1;21;71
2010;"CANDIDO SALES (BA)";"BA";"CANDIDO SALES";276;23;37;336
2010;"CANSANCAO (BA)";"BA";"CANSANCAO";107;27;35;169
2010;"CANUDOS (BA)";"BA";"CANUDOS";39;1;27;67
2010;"CAPELA DO ALTO ALEGRE (BA)";"BA";"CAPELA DO ALTO ALEGRE";54;16;19;89
2010;"CAPIM GROSSO (BA)";"BA";"CAPIM GROSSO";407;32;43;482
2010;"CARAIBAS (BA)";"BA";"CARAIBAS";34;17;15;66
2010;"CARAVELAS (BA)";"BA";"CARAVELAS";32;15;35;82
2010;"CARDEAL DA SILVA (BA)";"BA";"CARDEAL DA SILVA";18;7;4;29
2010;"CARINHANHA (BA)";"BA";"CARINHANHA";115;20;30;165
2010;"CASA NOVA (BA)";"BA";"CASA NOVA";330;163;149;642
2010;"CASTRO ALVES (BA)";"BA";"CASTRO ALVES";123;18;48;189
2010;"CATOLANDIA (BA)";"BA";"CATOLANDIA";5;4;4;13
2010;"CATU (BA)";"BA";"CATU";353;103;78;534
2010;"CATURAMA (BA)";"BA";"CATURAMA";22;4;7;33
2010;"CENTRAL (BA)";"BA";"CENTRAL";76;12;7;95
2010;"CHORROCHO (BA)";"BA";"CHORROCHO";16;3;5;24
2010;"CICERO DANTAS (BA)";"BA";"CICERO DANTAS";98;19;35;152
2010;"CIPO (BA)";"BA";"CIPO";37;4;7;48
2010;"COARACI (BA)";"BA";"COARACI";80;4;20;104
2010;"COCOS (BA)";"BA";"COCOS";59;5;33;97
2010;"CONCEICAO DA FEIRA (BA)";"BA";"CONCEICAO DA FEIRA";213;99;9;321
2010;"CONCEICAO DO ALMEIDA (BA)";"BA";"CONCEICAO DO ALMEIDA";102;29;21;152
2010;"CONCEICAO DO COITE (BA)";"BA";"CONCEICAO DO COITE";368;63;100;531
2010;"CONCEICAO DO JACUIPE (BA)";"BA";"CONCEICAO DO JACUIPE";237;119;17;373
2010;"CONDE (BA)";"BA";"CONDE";44;11;12;67
2010;"CONDEUBA (BA)";"BA";"CONDEUBA";101;30;54;185
2010;"CONTENDAS DO SINCORA (BA)";"BA";"CONTENDAS DO SINCORA";16;8;5;29
2010;"CORACAO DE MARIA (BA)";"BA";"CORACAO DE MARIA";94;29;40;163
2010;"CORDEIROS (BA)";"BA";"CORDEIROS";32;17;17;66
2010;"CORIBE (BA)";"BA";"CORIBE";41;13;18;72
2010;"CORONEL JOAO SA (BA)";"BA";"CORONEL JOAO SA";18;0;24;42
2010;"CORRENTINA (BA)";"BA";"CORRENTINA";122;22;62;206
2010;"COTEGIPE (BA)";"BA";"COTEGIPE";38;9;16;63
2010;"CRAVOLANDIA (BA)";"BA";"CRAVOLANDIA";16;1;6;23
2010;"CRISOPOLIS (BA)";"BA";"CRISOPOLIS";49;19;23;91
2010;"CRISTOPOLIS (BA)";"BA";"CRISTOPOLIS";45;9;25;79
2010;"CRUZ DAS ALMAS (BA)";"BA";"CRUZ DAS ALMAS";879;195;73;1147
2010;"CURACA (BA)";"BA";"CURACA";57;27;22;106
2010;"DARIO MEIRA (BA)";"BA";"DARIO MEIRA";15;11;4;30
2010;"DIAS D AVILA (BA)";"BA";"DIAS D AVILA";573;67;369;1009
2010;"DOM BASILIO (BA)";"BA";"DOM BASILIO";251;8;17;276
2010;"DOM MACEDO COSTA (BA)";"BA";"DOM MACEDO COSTA";13;18;5;36
2010;"ELISIO MEDRADO (BA)";"BA";"ELISIO MEDRADO";19;6;12;37
2010;"ENCRUZILHADA (BA)";"BA";"ENCRUZILHADA";64;31;11;106
2010;"ENTRE RIOS (BA)";"BA";"ENTRE RIOS";179;69;82;330
2010;"ERICO CARDOSO (BA)";"BA";"ERICO CARDOSO";25;3;16;44
2010;"ESPLANADA (BA)";"BA";"ESPLANADA";126;33;60;219
2010;"EUCLIDES DA CUNHA (BA)";"BA";"EUCLIDES DA CUNHA";222;29;108;359
2010;"EUNAPOLIS (BA)";"BA";"EUNAPOLIS";1107;82;269;1458
2010;"FATIMA (BA)";"BA";"FATIMA";15;5;16;36
2010;"FEIRA DA MATA (BA)";"BA";"FEIRA DA MATA";16;8;6;30
2010;"FEIRA DE SANTANA (BA)";"BA";"FEIRA DE SANTANA";7506;885;1122;9513
2010;"FILADELFIA (BA)";"BA";"FILADELFIA";80;8;22;110
2010;"FIRMINO ALVES (BA)";"BA";"FIRMINO ALVES";11;2;2;15
2010;"FLORESTA AZUL (BA)";"BA";"FLORESTA AZUL";50;1;2;53
2010;"FORMOSA DO RIO PRETO (BA)";"BA";"FORMOSA DO RIO PRETO";104;2;14;120
2010;"GANDU (BA)";"BA";"GANDU";241;27;16;284
2010;"GAVIAO (BA)";"BA";"GAVIAO";12;10;5;27
2010;"GENTIO DO OURO (BA)";"BA";"GENTIO DO OURO";12;1;1;14
2010;"GLORIA (BA)";"BA";"GLORIA";45;16;35;96
2010;"GONGOGI (BA)";"BA";"GONGOGI";7;1;2;10
2010;"GOVERNADOR MANGABEIRA (BA)";"BA";"GOVERNADOR MANGABEIRA";144;23;27;194
2010;"GUAJERU (BA)";"BA";"GUAJERU";13;18;7;38
2010;"GUANAMBI (BA)";"BA";"GUANAMBI";1000;70;127;1197
2010;"GUARATINGA (BA)";"BA";"GUARATINGA";58;5;24;87
2010;"HELIOPOLIS (BA)";"BA";"HELIOPOLIS";16;9;8;33
2010;"IACU (BA)";"BA";"IACU";113;20;25;158
2010;"IBIASSUCE (BA)";"BA";"IBIASSUCE";64;12;10;86
2010;"IBICARAI (BA)";"BA";"IBICARAI";124;9;23;156
2010;"IBICOARA (BA)";"BA";"IBICOARA";162;26;45;233
2010;"IBICUI (BA)";"BA";"IBICUI";34;9;13;56
2010;"IBIPEBA (BA)";"BA";"IBIPEBA";30;9;6;45
2010;"IBIPITANGA (BA)";"BA";"IBIPITANGA";69;11;29;109
2010;"IBIQUERA (BA)";"BA";"IBIQUERA";6;5;1;12
2010;"IBIRAPITANGA (BA)";"BA";"IBIRAPITANGA";38;6;9;53
2010;"IBIRAPUA (BA)";"BA";"IBIRAPUA";42;5;9;56
2010;"IBIRATAIA (BA)";"BA";"IBIRATAIA";81;28;9;118
2010;"IBITIARA (BA)";"BA";"IBITIARA";81;32;29;142
2010;"IBITITA (BA)";"BA";"IBITITA";34;3;11;48
2010;"IBOTIRAMA (BA)";"BA";"IBOTIRAMA";190;50;25;265
2010;"ICHU (BA)";"BA";"ICHU";19;9;12;40
2010;"IGAPORA (BA)";"BA";"IGAPORA";85;21;16;122
2010;"IGRAPIUNA (BA)";"BA";"IGRAPIUNA";40;22;15;77
2010;"IGUAI (BA)";"BA";"IGUAI";46;25;26;97
2010;"ILHEUS (BA)";"BA";"ILHEUS";558;128;286;972
2010;"INHAMBUPE (BA)";"BA";"INHAMBUPE";149;72;92;313
2010;"IPECAETA (BA)";"BA";"IPECAETA";7;6;35;48
2010;"IPIAU (BA)";"BA";"IPIAU";326;28;29;383
2010;"IPIRA (BA)";"BA";"IPIRA";323;37;80;440
2010;"IPUPIARA (BA)";"BA";"IPUPIARA";40;17;3;60
2010;"IRAJUBA (BA)";"BA";"IRAJUBA";20;1;20;41
2010;"IRAMAIA (BA)";"BA";"IRAMAIA";28;4;8;40
2010;"IRAQUARA (BA)";"BA";"IRAQUARA";101;25;22;148
2010;"IRARA (BA)";"BA";"IRARA";117;37;55;209
2010;"IRECE (BA)";"BA";"IRECE";724;48;104;876
2010;"ITABELA (BA)";"BA";"ITABELA";227;11;67;305
2010;"ITABERABA (BA)";"BA";"ITABERABA";427;62;47;536
2010;"ITABUNA (BA)";"BA";"ITABUNA";1643;59;724;2426
2010;"ITACARE (BA)";"BA";"ITACARE";18;24;4;46
2010;"ITAETE (BA)";"BA";"ITAETE";55;10;19;84
2010;"ITAGI (BA)";"BA";"ITAGI";30;2;2;34
2010;"ITAGIBA (BA)";"BA";"ITAGIBA";24;26;17;67
2010;"ITAGIMIRIM (BA)";"BA";"ITAGIMIRIM";41;2;4;47
2010;"ITAGUACU DA BAHIA (BA)";"BA";"ITAGUACU DA BAHIA";18;1;6;25
2010;"ITAJU DO COLONIA (BA)";"BA";"ITAJU DO COLONIA";10;0;3;13
2010;"ITAJUIPE (BA)";"BA";"ITAJUIPE";67;8;15;90
2010;"ITAMARAJU (BA)";"BA";"ITAMARAJU";392;23;116;531
2010;"ITAMARI (BA)";"BA";"ITAMARI";35;4;1;40
2010;"ITAMBE (BA)";"BA";"ITAMBE";61;38;6;105
2010;"ITANAGRA (BA)";"BA";"ITANAGRA";16;1;2;19
2010;"ITANHEM (BA)";"BA";"ITANHEM";54;7;17;78
2010;"ITAPARICA (BA)";"BA";"ITAPARICA";22;29;45;96
2010;"ITAPE (BA)";"BA";"ITAPE";19;0;1;20
2010;"ITAPEBI (BA)";"BA";"ITAPEBI";47;2;8;57
2010;"ITAPETINGA (BA)";"BA";"ITAPETINGA";481;53;145;679
2010;"ITAPICURU (BA)";"BA";"ITAPICURU";28;16;34;78
2010;"ITAPITANGA (BA)";"BA";"ITAPITANGA";9;3;3;15
2010;"ITAQUARA (BA)";"BA";"ITAQUARA";25;2;2;29
2010;"ITARANTIM (BA)";"BA";"ITARANTIM";79;6;4;89
2010;"ITATIM (BA)";"BA";"ITATIM";132;26;22;180
2010;"ITIRUCU (BA)";"BA";"ITIRUCU";108;9;15;132
2010;"ITIUBA (BA)";"BA";"ITIUBA";59;33;45;137
2010;"ITORORO (BA)";"BA";"ITORORO";86;14;20;120
2010;"ITUACU (BA)";"BA";"ITUACU";111;17;18;146
2010;"ITUBERA (BA)";"BA";"ITUBERA";125;18;14;157
2010;"IUIU (BA)";"BA";"IUIU";33;5;6;44
2010;"JABORANDI (BA)";"BA";"JABORANDI";47;2;24;73
2010;"JACARACI (BA)";"BA";"JACARACI";38;11;24;73
2010;"JACOBINA (BA)";"BA";"JACOBINA";635;96;146;877
2010;"JAGUAQUARA (BA)";"BA";"JAGUAQUARA";520;13;45;578
2010;"JAGUARARI (BA)";"BA";"JAGUARARI";167;51;61;279
2010;"JAGUARIPE (BA)";"BA";"JAGUARIPE";35;9;20;64
2010;"JANDAIRA (BA)";"BA";"JANDAIRA";16;3;9;28
2010;"JEQUIE (BA)";"BA";"JEQUIE";1352;71;323;1746
2010;"JEREMOABO (BA)";"BA";"JEREMOABO";79;24;44;147
2010;"JIQUIRICA (BA)";"BA";"JIQUIRICA";35;19;19;73
2010;"JITAUNA (BA)";"BA";"JITAUNA";30;11;6;47
2010;"JOAO DOURADO (BA)";"BA";"JOAO DOURADO";72;12;10;94
2010;"JUAZEIRO (BA)";"BA";"JUAZEIRO";2716;793;782;4291
2010;"JUCURUCU (BA)";"BA";"JUCURUCU";12;0;3;15
2010;"JUSSARA (BA)";"BA";"JUSSARA";44;15;17;76
2010;"JUSSARI (BA)";"BA";"JUSSARI";10;1;3;14
2010;"JUSSIAPE (BA)";"BA";"JUSSIAPE";55;10;17;82
2010;"LAFAIETE COUTINHO (BA)";"BA";"LAFAIETE COUTINHO";12;5;4;21
2010;"LAGEDO DO TABOCAL (BA)";"BA";"LAGEDO DO TABOCAL";28;1;6;35
2010;"LAGOA REAL (BA)";"BA";"LAGOA REAL";31;5;13;49
2010;"LAJE (BA)";"BA";"LAJE";119;44;33;196
2010;"LAJEDAO (BA)";"BA";"LAJEDAO";7;1;9;17
2010;"LAJEDINHO (BA)";"BA";"LAJEDINHO";7;4;5;16
2010;"LAMARAO (BA)";"BA";"LAMARAO";3;1;6;10
2010;"LAPAO (BA)";"BA";"LAPAO";101;7;22;130
2010;"LAURO DE FREITAS (BA)";"BA";"LAURO DE FREITAS";2006;411;519;2936
2010;"LENCOIS (BA)";"BA";"LENCOIS";13;11;2;26
2010;"LICINIO DE ALMEIDA (BA)";"BA";"LICINIO DE ALMEIDA";93;11;13;117
2010;"LIVRAMENTO DE NOSSA SENHORA (BA)";"BA";"LIVRAMENTO DE NOSSA SENHORA";356;37;85;478
2010;"LUIS EDUARDO MAGALHAES (BA)";"BA";"LUIS EDUARDO MAGALHAES";1147;48;90;1285
2010;"MACAJUBA (BA)";"BA";"MACAJUBA";18;17;24;59
2010;"MACARANI (BA)";"BA";"MACARANI";79;6;16;101
2010;"MACAUBAS (BA)";"BA";"MACAUBAS";174;16;216;406
2010;"MACURURE (BA)";"BA";"MACURURE";8;4;6;18
2010;"MADRE DE DEUS (BA)";"BA";"MADRE DE DEUS";62;44;29;135
2010;"MAETINGA (BA)";"BA";"MAETINGA";21;7;9;37
2010;"MAIQUINIQUE (BA)";"BA";"MAIQUINIQUE";39;2;10;51
2010;"MAIRI (BA)";"BA";"MAIRI";65;19;29;113
2010;"MALHADA (BA)";"BA";"MALHADA";30;5;13;48
2010;"MALHADA DE PEDRAS (BA)";"BA";"MALHADA DE PEDRAS";65;36;30;131
2010;"MANOEL VITORINO (BA)";"BA";"MANOEL VITORINO";48;12;7;67
2010;"MANSIDAO (BA)";"BA";"MANSIDAO";7;0;6;13
2010;"MARACAS (BA)";"BA";"MARACAS";172;10;39;221
2010;"MARAGOGIPE (BA)";"BA";"MARAGOGIPE";91;26;19;136
2010;"MARAU (BA)";"BA";"MARAU";10;3;0;13
2010;"MARCIONILIO SOUZA (BA)";"BA";"MARCIONILIO SOUZA";16;16;11;43
2010;"MASCOTE (BA)";"BA";"MASCOTE";40;5;9;54
2010;"MATA DE SAO JOAO (BA)";"BA";"MATA DE SAO JOAO";197;72;56;325
2010;"MATINA (BA)";"BA";"MATINA";14;8;20;42
2010;"MEDEIROS NETO (BA)";"BA";"MEDEIROS NETO";77;11;31;119
2010;"MIGUEL CALMON (BA)";"BA";"MIGUEL CALMON";85;11;27;123
2010;"MILAGRES (BA)";"BA";"MILAGRES";110;8;15;133
2010;"MIRANGABA (BA)";"BA";"MIRANGABA";39;10;30;79
2010;"MIRANTE (BA)";"BA";"MIRANTE";29;12;15;56
2010;"MONTE SANTO (BA)";"BA";"MONTE SANTO";129;22;93;244
2010;"MORPARA (BA)";"BA";"MORPARA";15;15;4;34
2010;"MORRO DO CHAPEU (BA)";"BA";"MORRO DO CHAPEU";118;32;10;160
2010;"MORTUGABA (BA)";"BA";"MORTUGABA";72;6;8;86
2010;"MUCUGE (BA)";"BA";"MUCUGE";97;10;37;144
2010;"MUCURI (BA)";"BA";"MUCURI";93;27;36;156
2010;"MULUNGU DO MORRO (BA)";"BA";"MULUNGU DO MORRO";40;7;7;54
2010;"MUNDO NOVO (BA)";"BA";"MUNDO NOVO";44;15;21;80
2010;"MUNIZ FERREIRA (BA)";"BA";"MUNIZ FERREIRA";33;55;4;92
2010;"MUQUEM DO SAO FRANCISCO (BA)";"BA";"MUQUEM DO SAO FRANCISCO";9;14;20;43
2010;"MURITIBA (BA)";"BA";"MURITIBA";117;27;32;176
2010;"MUTUIPE (BA)";"BA";"MUTUIPE";113;61;35;209
2010;"NAZARE (BA)";"BA";"NAZARE";219;44;29;292
2010;"NILO PECANHA (BA)";"BA";"NILO PECANHA";30;21;11;62
2010;"NORDESTINA (BA)";"BA";"NORDESTINA";25;7;14;46
2010;"NOVA CANAA (BA)";"BA";"NOVA CANAA";42;11;12;65
2010;"NOVA FATIMA (BA)";"BA";"NOVA FATIMA";53;5;6;64
2010;"NOVA IBIA (BA)";"BA";"NOVA IBIA";17;4;4;25
2010;"NOVA ITARANA (BA)";"BA";"NOVA ITARANA";24;6;4;34
2010;"NOVA REDENCAO (BA)";"BA";"NOVA REDENCAO";13;4;5;22
2010;"NOVA SOURE (BA)";"BA";"NOVA SOURE";41;11;18;70
2010;"NOVA VICOSA (BA)";"BA";"NOVA VICOSA";102;21;29;152
2010;"NOVO HORIZONTE (BA)";"BA";"NOVO HORIZONTE";32;6;11;49
2010;"NOVO TRIUNFO (BA)";"BA";"NOVO TRIUNFO";9;1;1;11
2010;"OLINDINA (BA)";"BA";"OLINDINA";72;24;41;137
2010;"OLIVEIRA DOS BREJINHOS (BA)";"BA";"OLIVEIRA DOS BREJINHOS";85;32;30;147
2010;"OURICANGAS (BA)";"BA";"OURICANGAS";26;10;18;54
2010;"OUROLANDIA (BA)";"BA";"OUROLANDIA";46;13;5;64
2010;"PALMAS DE MONTE ALTO (BA)";"BA";"PALMAS DE MONTE ALTO";48;2;26;76
2010;"PALMEIRAS (BA)";"BA";"PALMEIRAS";34;12;4;50
2010;"PARAMIRIM (BA)";"BA";"PARAMIRIM";130;12;53;195
2010;"PARATINGA (BA)";"BA";"PARATINGA";44;18;36;98
2010;"PARIPIRANGA (BA)";"BA";"PARIPIRANGA";69;2;38;109
2010;"PAU BRASIL (BA)";"BA";"PAU BRASIL";28;6;29;63
2010;"PAULO AFONSO (BA)";"BA";"PAULO AFONSO";802;286;289;1377
2010;"PE DE SERRA (BA)";"BA";"PE DE SERRA";42;9;14;65
2010;"PEDRAO (BA)";"BA";"PEDRAO";6;5;4;15
2010;"PEDRO ALEXANDRE (BA)";"BA";"PEDRO ALEXANDRE";2;4;5;11
2010;"PIATA (BA)";"BA";"PIATA";84;21;22;127
2010;"PILAO ARCADO (BA)";"BA";"PILAO ARCADO";29;21;5;55
2010;"PINDAI (BA)";"BA";"PINDAI";44;8;22;74
2010;"PINDOBACU (BA)";"BA";"PINDOBACU";39;18;22;79
2010;"PINTADAS (BA)";"BA";"PINTADAS";40;17;35;92
2010;"PIRAI DO NORTE (BA)";"BA";"PIRAI DO NORTE";21;3;1;25
2010;"PIRIPA (BA)";"BA";"PIRIPA";66;23;14;103
2010;"PIRITIBA (BA)";"BA";"PIRITIBA";53;23;16;92
2010;"PLANALTINO (BA)";"BA";"PLANALTINO";19;4;15;38
2010;"PLANALTO (BA)";"BA";"PLANALTO";111;22;41;174
2010;"POCOES (BA)";"BA";"POCOES";294;168;73;535
2010;"POJUCA (BA)";"BA";"POJUCA";311;69;62;442
2010;"PONTO NOVO (BA)";"BA";"PONTO NOVO";55;6;23;84
2010;"PORTO SEGURO (BA)";"BA";"PORTO SEGURO";534;183;412;1129
2010;"POTIRAGUA (BA)";"BA";"POTIRAGUA";32;3;5;40
2010;"PRADO (BA)";"BA";"PRADO";60;8;24;92
2010;"PRESIDENTE DUTRA (BA)";"BA";"PRESIDENTE DUTRA";45;5;4;54
2010;"PRESIDENTE JANIO QUADROS (BA)";"BA";"PRESIDENTE JANIO QUADROS";24;16;10;50
2010;"PRESIDENTE TANCREDO NEVES (BA)";"BA";"PRESIDENTE TANCREDO NEVES";130;59;24;213
2010;"QUEIMADAS (BA)";"BA";"QUEIMADAS";74;11;59;144
2010;"QUIJINGUE (BA)";"BA";"QUIJINGUE";38;15;37;90
2010;"QUIXABEIRA (BA)";"BA";"QUIXABEIRA";28;12;11;51
2010;"RAFAEL JAMBEIRO (BA)";"BA";"RAFAEL JAMBEIRO";56;15;40;111
2010;"REMANSO (BA)";"BA";"REMANSO";226;55;32;313
2010;"RETIROLANDIA (BA)";"BA";"RETIROLANDIA";48;5;9;62
2010;"RIACHAO DAS NEVES (BA)";"BA";"RIACHAO DAS NEVES";46;16;20;82
2010;"RIACHAO DO JACUIPE (BA)";"BA";"RIACHAO DO JACUIPE";232;29;30;291
2010;"RIACHO DE SANTANA (BA)";"BA";"RIACHO DE SANTANA";212;26;56;294
2010;"RIBEIRA DO AMPARO (BA)";"BA";"RIBEIRA DO AMPARO";14;10;31;55
2010;"RIBEIRA DO POMBAL (BA)";"BA";"RIBEIRA DO POMBAL";222;61;101;384
2010;"RIBEIRAO DO LARGO (BA)";"BA";"RIBEIRAO DO LARGO";22;14;6;42
2010;"RIO DE CONTAS (BA)";"BA";"RIO DE CONTAS";61;25;18;104
2010;"RIO DO ANTONIO (BA)";"BA";"RIO DO ANTONIO";109;31;14;154
2010;"RIO DO PIRES (BA)";"BA";"RIO DO PIRES";52;11;16;79
2010;"RIO REAL (BA)";"BA";"RIO REAL";159;17;40;216
2010;"RODELAS (BA)";"BA";"RODELAS";23;6;2;31
2010;"RUY BARBOSA (BA)";"BA";"RUY BARBOSA";100;42;16;158
2010;"SALINAS DA MARGARIDA (BA)";"BA";"SALINAS DA MARGARIDA";19;4;5;28
2010;"SALVADOR (BA)";"BA";"SALVADOR";15367;3294;7173;25834
2010;"SANTA BARBARA (BA)";"BA";"SANTA BARBARA";46;5;15;66
2010;"SANTA BRIGIDA (BA)";"BA";"SANTA BRIGIDA";21;19;18;58
2010;"SANTA CRUZ CABRALIA (BA)";"BA";"SANTA CRUZ CABRALIA";60;21;16;97
2010;"SANTA CRUZ DA VITORIA (BA)";"BA";"SANTA CRUZ DA VITORIA";12;5;2;19
2010;"SANTA INES (BA)";"BA";"SANTA INES";43;7;4;54
2010;"SANTA LUZIA (BA)";"BA";"SANTA LUZIA";32;1;5;38
2010;"SANTA MARIA DA VITORIA (BA)";"BA";"SANTA MARIA DA VITORIA";335;29;47;411
2010;"SANTA RITA DE CASSIA (BA)";"BA";"SANTA RITA DE CASSIA";52;8;8;68
2010;"SANTA TERESINHA (BA)";"BA";"SANTA TERESINHA";19;7;18;44
2010;"SANTALUZ (BA)";"BA";"SANTALUZ";186;13;35;234
2010;"SANTANA (BA)";"BA";"SANTANA";134;10;46;190
2010;"SANTANOPOLIS (BA)";"BA";"SANTANOPOLIS";18;11;9;38
2010;"SANTO AMARO (BA)";"BA";"SANTO AMARO";185;88;283;556
2010;"SANTO ANTONIO DE JESUS (BA)";"BA";"SANTO ANTONIO DE JESUS";1816;186;125;2127
2010;"SANTO ESTEVAO (BA)";"BA";"SANTO ESTEVAO";208;65;39;312
2010;"SAO DESIDERIO (BA)";"BA";"SAO DESIDERIO";198;16;45;259
2010;"SAO DOMINGOS (BA)";"BA";"SAO DOMINGOS";35;0;6;41
2010;"SAO FELIPE (BA)";"BA";"SAO FELIPE";170;39;35;244
2010;"SAO FELIX (BA)";"BA";"SAO FELIX";46;20;13;79
2010;"SAO FELIX DO CORIBE (BA)";"BA";"SAO FELIX DO CORIBE";104;13;14;131
2010;"SAO FRANCISCO DO CONDE (BA)";"BA";"SAO FRANCISCO DO CONDE";113;78;77;268
2010;"SAO GABRIEL (BA)";"BA";"SAO GABRIEL";25;5;9;39
2010;"SAO GONCALO DOS CAMPOS (BA)";"BA";"SAO GONCALO DOS CAMPOS";87;141;32;260
2010;"SAO JOSE DA VITORIA (BA)";"BA";"SAO JOSE DA VITORIA";8;0;4;12
2010;"SAO JOSE DO JACUIPE (BA)";"BA";"SAO JOSE DO JACUIPE";44;11;3;58
2010;"SAO MIGUEL DAS MATAS (BA)";"BA";"SAO MIGUEL DAS MATAS";46;6;12;64
2010;"SAO SEBASTIAO DO PASSE (BA)";"BA";"SAO SEBASTIAO DO PASSE";152;136;124;412
2010;"SAPEACU (BA)";"BA";"SAPEACU";82;55;31;168
2010;"SATIRO DIAS (BA)";"BA";"SATIRO DIAS";17;10;11;38
2010;"SAUBARA (BA)";"BA";"SAUBARA";14;14;1;29
2010;"SAUDE (BA)";"BA";"SAUDE";30;12;8;50
2010;"SEABRA (BA)";"BA";"SEABRA";335;90;125;550
2010;"SEBASTIAO LARANJEIRAS (BA)";"BA";"SEBASTIAO LARANJEIRAS";16;1;24;41
2010;"SENHOR DO BONFIM (BA)";"BA";"SENHOR DO BONFIM";509;111;162;782
2010;"SENTO SE (BA)";"BA";"SENTO SE";43;3;18;64
2010;"SERRA DO RAMALHO (BA)";"BA";"SERRA DO RAMALHO";60;18;18;96
2010;"SERRA DOURADA (BA)";"BA";"SERRA DOURADA";53;10;25;88
2010;"SERRA PRETA (BA)";"BA";"SERRA PRETA";29;16;44;89
2010;"SERRINHA (BA)";"BA";"SERRINHA";559;95;165;819
2010;"SERROLANDIA (BA)";"BA";"SERROLANDIA";44;30;12;86
2010;"SIMOES FILHO (BA)";"BA";"SIMOES FILHO";2066;388;688;3142
2010;"SITIO DO MATO (BA)";"BA";"SITIO DO MATO";20;10;18;48
2010;"SITIO DO QUINTO (BA)";"BA";"SITIO DO QUINTO";13;2;7;22
2010;"SOBRADINHO (BA)";"BA";"SOBRADINHO";79;25;31;135
2010;"SOUTO SOARES (BA)";"BA";"SOUTO SOARES";85;7;18;110
2010;"TABOCAS DO BREJO VELHO (BA)";"BA";"TABOCAS DO BREJO VELHO";19;2;8;29
2010;"TANHACU (BA)";"BA";"TANHACU";149;30;30;209
2010;"TANQUE NOVO (BA)";"BA";"TANQUE NOVO";249;6;33;288
2010;"TANQUINHO (BA)";"BA";"TANQUINHO";24;14;6;44
2010;"TAPEROA (BA)";"BA";"TAPEROA";107;23;10;140
2010;"TAPIRAMUTA (BA)";"BA";"TAPIRAMUTA";31;7;8;46
2010;"TEIXEIRA DE FREITAS (BA)";"BA";"TEIXEIRA DE FREITAS";1243;76;297;1616
2010;"TEODORO SAMPAIO (BA)";"BA";"TEODORO SAMPAIO";7;9;10;26
2010;"TEOFILANDIA (BA)";"BA";"TEOFILANDIA";72;17;27;116
2010;"TEOLANDIA (BA)";"BA";"TEOLANDIA";105;21;5;131
2010;"TERRA NOVA (BA)";"BA";"TERRA NOVA";16;5;18;39
2010;"TREMEDAL (BA)";"BA";"TREMEDAL";40;10;30;80
2010;"TUCANO (BA)";"BA";"TUCANO";230;35;83;348
2010;"UAUA (BA)";"BA";"UAUA";92;15;17;124
2010;"UBAIRA (BA)";"BA";"UBAIRA";85;13;34;132
2010;"UBAITABA (BA)";"BA";"UBAITABA";159;6;16;181
2010;"UBATA (BA)";"BA";"UBATA";188;16;11;215
2010;"UIBAI (BA)";"BA";"UIBAI";37;7;6;50
2010;"UMBURANAS (BA)";"BA";"UMBURANAS";26;13;14;53
2010;"UNA (BA)";"BA";"UNA";42;6;17;65
2010;"URANDI (BA)";"BA";"URANDI";90;17;21;128
2010;"URUCUCA (BA)";"BA";"URUCUCA";84;3;12;99
2010;"UTINGA (BA)";"BA";"UTINGA";49;11;7;67
2010;"VALENCA (BA)";"BA";"VALENCA";616;104;102;822
2010;"VALENTE (BA)";"BA";"VALENTE";104;9;23;136
2010;"VARZEA DA ROCA (BA)";"BA";"VARZEA DA ROCA";36;13;13;62
2010;"VARZEA DO POCO (BA)";"BA";"VARZEA DO POCO";51;9;10;70
2010;"VARZEA NOVA (BA)";"BA";"VARZEA NOVA";46;7;10;63
2010;"VARZEDO (BA)";"BA";"VARZEDO";52;6;14;72
2010;"VERA CRUZ (BA)";"BA";"VERA CRUZ";136;130;26;292
2010;"VEREDA (BA)";"BA";"VEREDA";7;3;2;12
2010;"VITORIA DA CONQUISTA (BA)";"BA";"VITORIA DA CONQUISTA";3480;512;1104;5096
2010;"WAGNER (BA)";"BA";"WAGNER";21;4;12;37
2010;"WANDERLEY (BA)";"BA";"WANDERLEY";43;7;16;66
2010;"WENCESLAU GUIMARAES (BA)";"BA";"WENCESLAU GUIMARAES";108;11;9;128
2010;"XIQUE XIQUE (BA)";"BA";"XIQUE XIQUE";105;12;11;128
2010;"ABAIARA (CE)";"CE";"ABAIARA";11;23;4;38
2010;"ACARAPE (CE)";"CE";"ACARAPE";85;20;108;213
2010;"ACARAU (CE)";"CE";"ACARAU";164;20;37;221
2010;"ACOPIARA (CE)";"CE";"ACOPIARA";267;23;28;318
2010;"AIUABA (CE)";"CE";"AIUABA";19;3;1;23
2010;"ALCANTARAS (CE)";"CE";"ALCANTARAS";39;2;8;49
2010;"ALTANEIRA (CE)";"CE";"ALTANEIRA";14;7;1;22
2010;"ALTO SANTO (CE)";"CE";"ALTO SANTO";120;5;11;136
2010;"AMONTADA (CE)";"CE";"AMONTADA";143;13;13;169
2010;"ANTONINA DO NORTE (CE)";"CE";"ANTONINA DO NORTE";27;4;1;32
2010;"APUIARES (CE)";"CE";"APUIARES";60;8;1;69
2010;"AQUIRAZ (CE)";"CE";"AQUIRAZ";447;95;50;592
2010;"ARACATI (CE)";"CE";"ARACATI";393;66;80;539
2010;"ARACOIABA (CE)";"CE";"ARACOIABA";92;7;12;111
2010;"ARARENDA (CE)";"CE";"ARARENDA";20;3;1;24
2010;"ARARIPE (CE)";"CE";"ARARIPE";53;73;24;150
2010;"ARATUBA (CE)";"CE";"ARATUBA";52;3;7;62
2010;"ARNEIROZ (CE)";"CE";"ARNEIROZ";23;6;0;29
2010;"ASSARE (CE)";"CE";"ASSARE";83;18;6;107
2010;"AURORA (CE)";"CE";"AURORA";65;36;6;107
2010;"BAIXIO (CE)";"CE";"BAIXIO";16;16;5;37
2010;"BANABUIU (CE)";"CE";"BANABUIU";95;9;14;118
2010;"BARBALHA (CE)";"CE";"BARBALHA";305;72;65;442
2010;"BARREIRA (CE)";"CE";"BARREIRA";84;8;8;100
2010;"BARRO (CE)";"CE";"BARRO";42;24;11;77
2010;"BARROQUINHA (CE)";"CE";"BARROQUINHA";30;10;2;42
2010;"BATURITE (CE)";"CE";"BATURITE";183;19;30;232
2010;"BEBERIBE (CE)";"CE";"BEBERIBE";177;55;47;279
2010;"BELA CRUZ (CE)";"CE";"BELA CRUZ";81;4;19;104
2010;"BOA VIAGEM (CE)";"CE";"BOA VIAGEM";347;14;35;396
2010;"BREJO SANTO (CE)";"CE";"BREJO SANTO";303;70;34;407
2010;"CAMOCIM (CE)";"CE";"CAMOCIM";160;30;19;209
2010;"CAMPOS SALES (CE)";"CE";"CAMPOS SALES";174;57;31;262
2010;"CANINDE (CE)";"CE";"CANINDE";481;17;49;547
2010;"CAPISTRANO (CE)";"CE";"CAPISTRANO";56;5;9;70
2010;"CARIDADE (CE)";"CE";"CARIDADE";64;8;10;82
2010;"CARIRE (CE)";"CE";"CARIRE";41;19;18;78
2010;"CARIRIACU (CE)";"CE";"CARIRIACU";45;33;6;84
2010;"CARIUS (CE)";"CE";"CARIUS";45;16;6;67
2010;"CARNAUBAL (CE)";"CE";"CARNAUBAL";68;22;7;97
2010;"CASCAVEL (CE)";"CE";"CASCAVEL";391;39;85;515
2010;"CATARINA (CE)";"CE";"CATARINA";36;4;1;41
2010;"CATUNDA (CE)";"CE";"CATUNDA";28;11;2;41
2010;"CAUCAIA (CE)";"CE";"CAUCAIA";1173;158;325;1656
2010;"CEDRO (CE)";"CE";"CEDRO";75;24;23;122
2010;"CHAVAL (CE)";"CE";"CHAVAL";25;6;6;37
2010;"CHORO (CE)";"CE";"CHORO";49;7;16;72
2010;"CHOROZINHO (CE)";"CE";"CHOROZINHO";93;11;30;134
2010;"COREAU (CE)";"CE";"COREAU";81;12;19;112
2010;"CRATEUS (CE)";"CE";"CRATEUS";262;38;62;362
2010;"CRATO (CE)";"CE";"CRATO";778;88;70;936
2010;"CROATA (CE)";"CE";"CROATA";42;11;5;58
2010;"CRUZ (CE)";"CE";"CRUZ";103;24;39;166
2010;"DEPUTADO IRAPUAN PINHEIRO (CE)";"CE";"DEPUTADO IRAPUAN PINHEIRO";24;4;2;30
2010;"ERERE (CE)";"CE";"ERERE";1;1;0;2
2010;"EUSEBIO (CE)";"CE";"EUSEBIO";862;43;47;952
2010;"FARIAS BRITO (CE)";"CE";"FARIAS BRITO";69;29;11;109
2010;"FORQUILHA (CE)";"CE";"FORQUILHA";87;26;22;135
2010;"FORTALEZA (CE)";"CE";"FORTALEZA";18836;2644;5687;27167
2010;"FORTIM (CE)";"CE";"FORTIM";25;26;9;60
2010;"FRECHEIRINHA (CE)";"CE";"FRECHEIRINHA";71;14;16;101
2010;"GENERAL SAMPAIO (CE)";"CE";"GENERAL SAMPAIO";30;1;3;34
2010;"GRACA (CE)";"CE";"GRACA";23;6;6;35
2010;"GRANJA (CE)";"CE";"GRANJA";156;28;11;195
2010;"GRANJEIRO (CE)";"CE";"GRANJEIRO";9;2;0;11
2010;"GROAIRAS (CE)";"CE";"GROAIRAS";46;23;13;82
2010;"GUAIUBA (CE)";"CE";"GUAIUBA";57;22;7;86
2010;"GUARACIABA DO NORTE (CE)";"CE";"GUARACIABA DO NORTE";330;11;14;355
2010;"GUARAMIRANGA (CE)";"CE";"GUARAMIRANGA";30;1;4;35
2010;"HIDROLANDIA (CE)";"CE";"HIDROLANDIA";107;15;11;133
2010;"HORIZONTE (CE)";"CE";"HORIZONTE";316;71;57;444
2010;"IBARETAMA (CE)";"CE";"IBARETAMA";51;8;16;75
2010;"IBIAPINA (CE)";"CE";"IBIAPINA";108;23;17;148
2010;"IBICUITINGA (CE)";"CE";"IBICUITINGA";59;3;8;70
2010;"ICAPUI (CE)";"CE";"ICAPUI";62;21;36;119
2010;"ICO (CE)";"CE";"ICO";272;56;47;375
2010;"IGUATU (CE)";"CE";"IGUATU";848;54;86;988
2010;"INDEPENDENCIA (CE)";"CE";"INDEPENDENCIA";174;4;14;192
2010;"IPAPORANGA (CE)";"CE";"IPAPORANGA";20;4;1;25
2010;"IPAUMIRIM (CE)";"CE";"IPAUMIRIM";186;47;28;261
2010;"IPU (CE)";"CE";"IPU";249;27;25;301
2010;"IPUEIRAS (CE)";"CE";"IPUEIRAS";63;17;6;86
2010;"IRACEMA (CE)";"CE";"IRACEMA";57;7;9;73
2010;"IRAUCUBA (CE)";"CE";"IRAUCUBA";82;12;12;106
2010;"ITAICABA (CE)";"CE";"ITAICABA";26;4;6;36
2010;"ITAITINGA (CE)";"CE";"ITAITINGA";271;54;13;338
2010;"ITAPAJE (CE)";"CE";"ITAPAJE";233;28;18;279
2010;"ITAPIPOCA (CE)";"CE";"ITAPIPOCA";620;21;38;679
2010;"ITAPIUNA (CE)";"CE";"ITAPIUNA";59;6;11;76
2010;"ITAREMA (CE)";"CE";"ITAREMA";107;10;24;141
2010;"ITATIRA (CE)";"CE";"ITATIRA";98;5;6;109
2010;"JAGUARETAMA (CE)";"CE";"JAGUARETAMA";78;3;10;91
2010;"JAGUARIBARA (CE)";"CE";"JAGUARIBARA";66;9;7;82
2010;"JAGUARIBE (CE)";"CE";"JAGUARIBE";307;20;19;346
2010;"JAGUARUANA (CE)";"CE";"JAGUARUANA";201;10;6;217
2010;"JARDIM (CE)";"CE";"JARDIM";64;59;5;128
2010;"JATI (CE)";"CE";"JATI";22;17;2;41
2010;"JIJOCA DE JERICOACOARA (CE)";"CE";"JIJOCA DE JERICOACOARA";50;12;5;67
2010;"JUAZEIRO DO NORTE (CE)";"CE";"JUAZEIRO DO NORTE";1492;159;198;1849
2010;"JUCAS (CE)";"CE";"JUCAS";70;8;17;95
2010;"LAVRAS DA MANGABEIRA (CE)";"CE";"LAVRAS DA MANGABEIRA";83;17;18;118
2010;"LIMOEIRO DO NORTE (CE)";"CE";"LIMOEIRO DO NORTE";580;23;103;706
2010;"MADALENA (CE)";"CE";"MADALENA";79;5;12;96
2010;"MARACANAU (CE)";"CE";"MARACANAU";1220;183;268;1671
2010;"MARANGUAPE (CE)";"CE";"MARANGUAPE";482;74;143;699
2010;"MARCO (CE)";"CE";"MARCO";187;7;14;208
2010;"MARTINOPOLE (CE)";"CE";"MARTINOPOLE";22;7;1;30
2010;"MASSAPE (CE)";"CE";"MASSAPE";73;23;48;144
2010;"MAURITI (CE)";"CE";"MAURITI";85;51;31;167
2010;"MERUOCA (CE)";"CE";"MERUOCA";32;9;7;48
2010;"MILAGRES (CE)";"CE";"MILAGRES";83;36;12;131
2010;"MILHA (CE)";"CE";"MILHA";56;3;14;73
2010;"MIRAIMA (CE)";"CE";"MIRAIMA";25;2;2;29
2010;"MISSAO VELHA (CE)";"CE";"MISSAO VELHA";156;58;9;223
2010;"MOMBACA (CE)";"CE";"MOMBACA";201;10;4;215
2010;"MONSENHOR TABOSA (CE)";"CE";"MONSENHOR TABOSA";58;5;1;64
2010;"MORADA NOVA (CE)";"CE";"MORADA NOVA";396;38;61;495
2010;"MORAUJO (CE)";"CE";"MORAUJO";17;5;6;28
2010;"MORRINHOS (CE)";"CE";"MORRINHOS";69;10;11;90
2010;"MUCAMBO (CE)";"CE";"MUCAMBO";27;17;8;52
2010;"MULUNGU (CE)";"CE";"MULUNGU";57;5;3;65
2010;"NOVA OLINDA (CE)";"CE";"NOVA OLINDA";77;29;5;111
2010;"NOVA RUSSAS (CE)";"CE";"NOVA RUSSAS";175;14;6;195
2010;"NOVO ORIENTE (CE)";"CE";"NOVO ORIENTE";53;23;8;84
2010;"OCARA (CE)";"CE";"OCARA";111;17;34;162
2010;"OROS (CE)";"CE";"OROS";107;20;16;143
2010;"PACAJUS (CE)";"CE";"PACAJUS";540;66;145;751
2010;"PACATUBA (CE)";"CE";"PACATUBA";136;69;16;221
2010;"PACOTI (CE)";"CE";"PACOTI";94;3;8;105
2010;"PACUJA (CE)";"CE";"PACUJA";31;4;9;44
2010;"PALHANO (CE)";"CE";"PALHANO";44;7;10;61
2010;"PALMACIA (CE)";"CE";"PALMACIA";37;14;10;61
2010;"PARACURU (CE)";"CE";"PARACURU";162;17;21;200
2010;"PARAIPABA (CE)";"CE";"PARAIPABA";171;14;16;201
2010;"PARAMBU (CE)";"CE";"PARAMBU";177;3;5;185
2010;"PARAMOTI (CE)";"CE";"PARAMOTI";48;3;8;59
2010;"PEDRA BRANCA (CE)";"CE";"PEDRA BRANCA";228;13;20;261
2010;"PENAFORTE (CE)";"CE";"PENAFORTE";29;25;15;69
2010;"PENTECOSTE (CE)";"CE";"PENTECOSTE";197;9;5;211
2010;"PEREIRO (CE)";"CE";"PEREIRO";69;12;18;99
2010;"PINDORETAMA (CE)";"CE";"PINDORETAMA";123;18;10;151
2010;"PIQUET CARNEIRO (CE)";"CE";"PIQUET CARNEIRO";35;5;7;47
2010;"PIRES FERREIRA (CE)";"CE";"PIRES FERREIRA";17;3;1;21
2010;"PORANGA (CE)";"CE";"PORANGA";14;6;2;22
2010;"PORTEIRAS (CE)";"CE";"PORTEIRAS";21;86;12;119
2010;"POTENGI (CE)";"CE";"POTENGI";22;3;1;26
2010;"POTIRETAMA (CE)";"CE";"POTIRETAMA";25;2;6;33
2010;"QUITERIANOPOLIS (CE)";"CE";"QUITERIANOPOLIS";36;11;2;49
2010;"QUIXADA (CE)";"CE";"QUIXADA";592;38;72;702
2010;"QUIXELO (CE)";"CE";"QUIXELO";40;15;22;77
2010;"QUIXERAMOBIM (CE)";"CE";"QUIXERAMOBIM";372;31;74;477
2010;"QUIXERE (CE)";"CE";"QUIXERE";163;11;40;214
2010;"REDENCAO (CE)";"CE";"REDENCAO";194;29;28;251
2010;"RERIUTABA (CE)";"CE";"RERIUTABA";72;14;17;103
2010;"RUSSAS (CE)";"CE";"RUSSAS";666;35;79;780
2010;"SABOEIRO (CE)";"CE";"SABOEIRO";32;13;3;48
2010;"SALITRE (CE)";"CE";"SALITRE";47;8;21;76
2010;"SANTA QUITERIA (CE)";"CE";"SANTA QUITERIA";234;29;7;270
2010;"SANTANA DO ACARAU (CE)";"CE";"SANTANA DO ACARAU";120;22;19;161
2010;"SANTANA DO CARIRI (CE)";"CE";"SANTANA DO CARIRI";57;21;7;85
2010;"SAO BENEDITO (CE)";"CE";"SAO BENEDITO";366;59;38;463
2010;"SAO GONCALO DO AMARANTE (CE)";"CE";"SAO GONCALO DO AMARANTE";236;56;73;365
2010;"SAO JOAO DO JAGUARIBE (CE)";"CE";"SAO JOAO DO JAGUARIBE";48;5;11;64
2010;"SAO LUIS DO CURU (CE)";"CE";"SAO LUIS DO CURU";49;2;10;61
2010;"SENADOR POMPEU (CE)";"CE";"SENADOR POMPEU";140;6;28;174
2010;"SENADOR SA (CE)";"CE";"SENADOR SA";18;3;10;31
2010;"SOBRAL (CE)";"CE";"SOBRAL";1296;191;235;1722
2010;"SOLONOPOLE (CE)";"CE";"SOLONOPOLE";75;3;10;88
2010;"TABULEIRO DO NORTE (CE)";"CE";"TABULEIRO DO NORTE";311;31;40;382
2010;"TAMBORIL (CE)";"CE";"TAMBORIL";66;13;16;95
2010;"TARRAFAS (CE)";"CE";"TARRAFAS";16;3;2;21
2010;"TAUA (CE)";"CE";"TAUA";361;24;31;416
2010;"TEJUCUOCA (CE)";"CE";"TEJUCUOCA";63;3;4;70
2010;"TIANGUA (CE)";"CE";"TIANGUA";1163;143;105;1411
2010;"TRAIRI (CE)";"CE";"TRAIRI";163;16;27;206
2010;"TURURU (CE)";"CE";"TURURU";42;3;3;48
2010;"UBAJARA (CE)";"CE";"UBAJARA";226;15;41;282
2010;"UMARI (CE)";"CE";"UMARI";5;3;3;11
2010;"UMIRIM (CE)";"CE";"UMIRIM";49;38;11;98
2010;"URUBURETAMA (CE)";"CE";"URUBURETAMA";63;9;37;109
2010;"URUOCA (CE)";"CE";"URUOCA";45;7;13;65
2010;"VARJOTA (CE)";"CE";"VARJOTA";109;24;4;137
2010;"VARZEA ALEGRE (CE)";"CE";"VARZEA ALEGRE";196;34;32;262
2010;"VICOSA DO CEARA (CE)";"CE";"VICOSA DO CEARA";300;26;30;356
2010;"BRASILIA (DF)";"DF";"BRASILIA";19362;4591;8663;32616
2010;"AFONSO CLAUDIO (ES)";"ES";"AFONSO CLAUDIO";466;49;101;616
2010;"AGUA DOCE DO NORTE (ES)";"ES";"AGUA DOCE DO NORTE";86;12;21;119
2010;"AGUIA BRANCA (ES)";"ES";"AGUIA BRANCA";126;2;20;148
2010;"ALEGRE (ES)";"ES";"ALEGRE";180;31;17;228
2010;"ALFREDO CHAVES (ES)";"ES";"ALFREDO CHAVES";412;22;32;466
2010;"ALTO RIO NOVO (ES)";"ES";"ALTO RIO NOVO";91;19;19;129
2010;"ANCHIETA (ES)";"ES";"ANCHIETA";249;43;38;330
2010;"APIACA (ES)";"ES";"APIACA";69;14;1;84
2010;"ARACRUZ (ES)";"ES";"ARACRUZ";1077;156;492;1725
2010;"ATILIO VIVACQUA (ES)";"ES";"ATILIO VIVACQUA";169;14;16;199
2010;"BAIXO GUANDU (ES)";"ES";"BAIXO GUANDU";494;24;60;578
2010;"BARRA DE SAO FRANCISCO (ES)";"ES";"BARRA DE SAO FRANCISCO";465;19;93;577
2010;"BOA ESPERANCA (ES)";"ES";"BOA ESPERANCA";204;13;42;259
2010;"BOM JESUS DO NORTE (ES)";"ES";"BOM JESUS DO NORTE";172;39;21;232
2010;"BREJETUBA (ES)";"ES";"BREJETUBA";161;11;33;205
2010;"CACHOEIRO DE ITAPEMIRIM (ES)";"ES";"CACHOEIRO DE ITAPEMIRIM";4474;196;1950;6620
2010;"CARIACICA (ES)";"ES";"CARIACICA";4732;513;1464;6709
2010;"CASTELO (ES)";"ES";"CASTELO";1197;63;61;1321
2010;"COLATINA (ES)";"ES";"COLATINA";2231;124;460;2815
2010;"CONCEICAO DA BARRA (ES)";"ES";"CONCEICAO DA BARRA";216;10;100;326
2010;"CONCEICAO DO CASTELO (ES)";"ES";"CONCEICAO DO CASTELO";216;39;43;298
2010;"DIVINO DE SAO LOURENCO (ES)";"ES";"DIVINO DE SAO LOURENCO";34;5;6;45
2010;"DOMINGOS MARTINS (ES)";"ES";"DOMINGOS MARTINS";905;77;68;1050
2010;"DORES DO RIO PRETO (ES)";"ES";"DORES DO RIO PRETO";111;11;15;137
2010;"ECOPORANGA (ES)";"ES";"ECOPORANGA";129;31;68;228
2010;"FUNDAO (ES)";"ES";"FUNDAO";290;41;48;379
2010;"GOVERNADOR LINDENBERG (ES)";"ES";"GOVERNADOR LINDENBERG";217;6;1;224
2010;"GUACUI (ES)";"ES";"GUACUI";418;42;34;494
2010;"GUARAPARI (ES)";"ES";"GUARAPARI";1010;227;194;1431
2010;"IBATIBA (ES)";"ES";"IBATIBA";364;35;39;438
2010;"IBIRACU (ES)";"ES";"IBIRACU";340;30;37;407
2010;"IBITIRAMA (ES)";"ES";"IBITIRAMA";92;11;10;113
2010;"ICONHA (ES)";"ES";"ICONHA";634;20;47;701
2010;"IRUPI (ES)";"ES";"IRUPI";146;36;20;202
2010;"ITAGUACU (ES)";"ES";"ITAGUACU";231;11;52;294
2010;"ITAPEMIRIM (ES)";"ES";"ITAPEMIRIM";396;38;48;482
2010;"ITARANA (ES)";"ES";"ITARANA";289;24;29;342
2010;"IUNA (ES)";"ES";"IUNA";329;34;74;437
2010;"JAGUARE (ES)";"ES";"JAGUARE";355;13;72;440
2010;"JERONIMO MONTEIRO (ES)";"ES";"JERONIMO MONTEIRO";68;12;10;90
2010;"JOAO NEIVA (ES)";"ES";"JOAO NEIVA";295;16;23;334
2010;"LARANJA DA TERRA (ES)";"ES";"LARANJA DA TERRA";246;14;23;283
2010;"LINHARES (ES)";"ES";"LINHARES";2580;118;389;3087
2010;"MANTENOPOLIS (ES)";"ES";"MANTENOPOLIS";120;13;24;157
2010;"MARATAIZES (ES)";"ES";"MARATAIZES";704;37;42;783
2010;"MARECHAL FLORIANO (ES)";"ES";"MARECHAL FLORIANO";602;31;17;650
2010;"MARILANDIA (ES)";"ES";"MARILANDIA";318;18;20;356
2010;"MIMOSO DO SUL (ES)";"ES";"MIMOSO DO SUL";232;29;59;320
2010;"MONTANHA (ES)";"ES";"MONTANHA";178;13;28;219
2010;"MUCURICI (ES)";"ES";"MUCURICI";55;4;18;77
2010;"MUNIZ FREIRE (ES)";"ES";"MUNIZ FREIRE";158;34;28;220
2010;"MUQUI (ES)";"ES";"MUQUI";138;16;23;177
2010;"NOVA VENECIA (ES)";"ES";"NOVA VENECIA";747;32;152;931
2010;"PANCAS (ES)";"ES";"PANCAS";230;25;9;264
2010;"PEDRO CANARIO (ES)";"ES";"PEDRO CANARIO";397;32;215;644
2010;"PINHEIROS (ES)";"ES";"PINHEIROS";279;17;111;407
2010;"PIUMA (ES)";"ES";"PIUMA";188;40;12;240
2010;"PONTO BELO (ES)";"ES";"PONTO BELO";50;6;17;73
2010;"PRESIDENTE KENNEDY (ES)";"ES";"PRESIDENTE KENNEDY";252;21;19;292
2010;"RIO BANANAL (ES)";"ES";"RIO BANANAL";484;16;47;547
2010;"RIO NOVO DO SUL (ES)";"ES";"RIO NOVO DO SUL";262;7;23;292
2010;"SANTA LEOPOLDINA (ES)";"ES";"SANTA LEOPOLDINA";340;28;29;397
2010;"SANTA MARIA DE JETIBA (ES)";"ES";"SANTA MARIA DE JETIBA";1738;84;52;1874
2010;"SANTA TERESA (ES)";"ES";"SANTA TERESA";609;36;78;723
2010;"SAO DOMINGOS DO NORTE (ES)";"ES";"SAO DOMINGOS DO NORTE";181;5;16;202
2010;"SAO GABRIEL DA PALHA (ES)";"ES";"SAO GABRIEL DA PALHA";553;16;89;658
2010;"SAO JOSE DO CALCADO (ES)";"ES";"SAO JOSE DO CALCADO";81;9;14;104
2010;"SAO MATEUS (ES)";"ES";"SAO MATEUS";944;94;323;1361
2010;"SAO ROQUE DO CANAA (ES)";"ES";"SAO ROQUE DO CANAA";267;13;17;297
2010;"SERRA (ES)";"ES";"SERRA";7612;471;2073;10156
2010;"SOORETAMA (ES)";"ES";"SOORETAMA";269;15;48;332
2010;"VARGEM ALTA (ES)";"ES";"VARGEM ALTA";396;24;48;468
2010;"VENDA NOVA DO IMIGRANTE (ES)";"ES";"VENDA NOVA DO IMIGRANTE";752;19;102;873
2010;"VIANA (ES)";"ES";"VIANA";1015;69;232;1316
2010;"VILA PAVAO (ES)";"ES";"VILA PAVAO";119;4;19;142
2010;"VILA VALERIO (ES)";"ES";"VILA VALERIO";309;3;29;341
2010;"VILA VELHA (ES)";"ES";"VILA VELHA";3853;701;786;5340
2010;"VITORIA (ES)";"ES";"VITORIA";3379;994;919;5292
2010;"ABADIA DE GOIAS (GO)";"GO";"ABADIA DE GOIAS";70;7;5;82
2010;"ABADIANIA (GO)";"GO";"ABADIANIA";220;18;17;255
2010;"ACREUNA (GO)";"GO";"ACREUNA";348;7;73;428
2010;"ADELANDIA (GO)";"GO";"ADELANDIA";22;1;4;27
2010;"AGUA FRIA DE GOIAS (GO)";"GO";"AGUA FRIA DE GOIAS";29;7;7;43
2010;"AGUA LIMPA (GO)";"GO";"AGUA LIMPA";17;6;2;25
2010;"AGUAS LINDAS DE GOIAS (GO)";"GO";"AGUAS LINDAS DE GOIAS";591;118;335;1044
2010;"ALEXANIA (GO)";"GO";"ALEXANIA";331;24;21;376
2010;"ALOANDIA (GO)";"GO";"ALOANDIA";20;3;2;25
2010;"ALTO HORIZONTE (GO)";"GO";"ALTO HORIZONTE";30;4;9;43
2010;"ALTO PARAISO DE GOIAS (GO)";"GO";"ALTO PARAISO DE GOIAS";47;6;11;64
2010;"ALVORADA DO NORTE (GO)";"GO";"ALVORADA DO NORTE";120;4;8;132
2010;"AMARALINA (GO)";"GO";"AMARALINA";8;2;5;15
2010;"AMERICANO DO BRASIL (GO)";"GO";"AMERICANO DO BRASIL";51;5;14;70
2010;"AMORINOPOLIS (GO)";"GO";"AMORINOPOLIS";27;3;8;38
2010;"ANAPOLIS (GO)";"GO";"ANAPOLIS";8896;229;1289;10414
2010;"ANHANGUERA (GO)";"GO";"ANHANGUERA";6;2;1;9
2010;"ANICUNS (GO)";"GO";"ANICUNS";303;18;87;408
2010;"APARECIDA DE GOIANIA (GO)";"GO";"APARECIDA DE GOIANIA";4755;211;501;5467
2010;"APARECIDA DO RIO DOCE (GO)";"GO";"APARECIDA DO RIO DOCE";37;2;10;49
2010;"APORE (GO)";"GO";"APORE";58;9;14;81
2010;"ARACU (GO)";"GO";"ARACU";23;3;4;30
2010;"ARAGARCAS (GO)";"GO";"ARAGARCAS";434;7;26;467
2010;"ARAGOIANIA (GO)";"GO";"ARAGOIANIA";59;0;7;66
2010;"ARAGUAPAZ (GO)";"GO";"ARAGUAPAZ";77;5;10;92
2010;"ARENOPOLIS (GO)";"GO";"ARENOPOLIS";11;6;2;19
2010;"ARUANA (GO)";"GO";"ARUANA";24;2;6;32
2010;"AURILANDIA (GO)";"GO";"AURILANDIA";19;4;1;24
2010;"AVELINOPOLIS (GO)";"GO";"AVELINOPOLIS";39;3;0;42
2010;"BALIZA (GO)";"GO";"BALIZA";6;0;2;8
2010;"BARRO ALTO (GO)";"GO";"BARRO ALTO";116;15;99;230
2010;"BELA VISTA DE GOIAS (GO)";"GO";"BELA VISTA DE GOIAS";312;12;29;353
2010;"BOM JARDIM DE GOIAS (GO)";"GO";"BOM JARDIM DE GOIAS";102;7;15;124
2010;"BOM JESUS (GO)";"GO";"BOM JESUS";358;28;94;480
2010;"BONFINOPOLIS (GO)";"GO";"BONFINOPOLIS";41;3;8;52
2010;"BONOPOLIS (GO)";"GO";"BONOPOLIS";10;1;3;14
2010;"BRAZABRANTES (GO)";"GO";"BRAZABRANTES";54;1;2;57
2010;"BRITANIA (GO)";"GO";"BRITANIA";67;4;2;73
2010;"BURITI ALEGRE (GO)";"GO";"BURITI ALEGRE";161;24;9;194
2010;"BURITI DE GOIAS (GO)";"GO";"BURITI DE GOIAS";15;10;2;27
2010;"BURITINOPOLIS (GO)";"GO";"BURITINOPOLIS";16;2;3;21
2010;"CABECEIRAS (GO)";"GO";"CABECEIRAS";162;8;26;196
2010;"CACHOEIRA ALTA (GO)";"GO";"CACHOEIRA ALTA";134;18;26;178
2010;"CACHOEIRA DE GOIAS (GO)";"GO";"CACHOEIRA DE GOIAS";5;1;1;7
2010;"CACHOEIRA DOURADA (GO)";"GO";"CACHOEIRA DOURADA";82;11;31;124
2010;"CACU (GO)";"GO";"CACU";226;9;31;266
2010;"CAIAPONIA (GO)";"GO";"CAIAPONIA";146;2;6;154
2010;"CALDAS NOVAS (GO)";"GO";"CALDAS NOVAS";594;65;65;724
2010;"CALDAZINHA (GO)";"GO";"CALDAZINHA";24;3;3;30
2010;"CAMPESTRE DE GOIAS (GO)";"GO";"CAMPESTRE DE GOIAS";33;2;5;40
2010;"CAMPINACU (GO)";"GO";"CAMPINACU";12;2;5;19
2010;"CAMPINORTE (GO)";"GO";"CAMPINORTE";117;12;11;140
2010;"CAMPO ALEGRE DE GOIAS (GO)";"GO";"CAMPO ALEGRE DE GOIAS";112;6;13;131
2010;"CAMPO LIMPO DE GOIAS (GO)";"GO";"CAMPO LIMPO DE GOIAS";89;0;6;95
2010;"CAMPOS BELOS (GO)";"GO";"CAMPOS BELOS";184;10;35;229
2010;"CAMPOS VERDES (GO)";"GO";"CAMPOS VERDES";35;6;1;42
2010;"CARMO DO RIO VERDE (GO)";"GO";"CARMO DO RIO VERDE";71;9;47;127
2010;"CASTELANDIA (GO)";"GO";"CASTELANDIA";38;5;9;52
2010;"CATALAO (GO)";"GO";"CATALAO";1559;108;249;1916
2010;"CATURAI (GO)";"GO";"CATURAI";36;2;7;45
2010;"CAVALCANTE (GO)";"GO";"CAVALCANTE";29;3;4;36
2010;"CERES (GO)";"GO";"CERES";470;18;22;510
2010;"CEZARINA (GO)";"GO";"CEZARINA";95;4;15;114
2010;"CHAPADAO DO CEU (GO)";"GO";"CHAPADAO DO CEU";180;13;15;208
2010;"CIDADE OCIDENTAL (GO)";"GO";"CIDADE OCIDENTAL";101;42;56;199
2010;"COCALZINHO DE GOIAS (GO)";"GO";"COCALZINHO DE GOIAS";119;15;18;152
2010;"COLINAS DO SUL (GO)";"GO";"COLINAS DO SUL";7;3;3;13
2010;"CORREGO DO OURO (GO)";"GO";"CORREGO DO OURO";18;1;1;20
2010;"CORUMBA DE GOIAS (GO)";"GO";"CORUMBA DE GOIAS";71;7;16;94
2010;"CORUMBAIBA (GO)";"GO";"CORUMBAIBA";117;21;7;145
2010;"CRISTALINA (GO)";"GO";"CRISTALINA";1364;58;316;1738
2010;"CRISTIANOPOLIS (GO)";"GO";"CRISTIANOPOLIS";46;10;1;57
2010;"CRIXAS (GO)";"GO";"CRIXAS";103;15;14;132
2010;"CROMINIA (GO)";"GO";"CROMINIA";36;3;2;41
2010;"CUMARI (GO)";"GO";"CUMARI";31;6;0;37
2010;"DAMIANOPOLIS (GO)";"GO";"DAMIANOPOLIS";12;2;7;21
2010;"DAMOLANDIA (GO)";"GO";"DAMOLANDIA";35;5;3;43
2010;"DAVINOPOLIS (GO)";"GO";"DAVINOPOLIS";27;4;3;34
2010;"DIORAMA (GO)";"GO";"DIORAMA";8;4;4;16
2010;"DIVINOPOLIS DE GOIAS (GO)";"GO";"DIVINOPOLIS DE GOIAS";21;0;5;26
2010;"DOVERLANDIA (GO)";"GO";"DOVERLANDIA";98;4;32;134
2010;"EDEALINA (GO)";"GO";"EDEALINA";62;4;7;73
2010;"EDEIA (GO)";"GO";"EDEIA";145;4;10;159
2010;"ESTRELA DO NORTE (GO)";"GO";"ESTRELA DO NORTE";28;2;2;32
2010;"FAINA (GO)";"GO";"FAINA";39;14;5;58
2010;"FAZENDA NOVA (GO)";"GO";"FAZENDA NOVA";35;4;6;45
2010;"FIRMINOPOLIS (GO)";"GO";"FIRMINOPOLIS";74;1;6;81
2010;"FLORES DE GOIAS (GO)";"GO";"FLORES DE GOIAS";30;4;6;40
2010;"FORMOSA (GO)";"GO";"FORMOSA";2584;120;523;3227
2010;"FORMOSO (GO)";"GO";"FORMOSO";32;4;5;41
2010;"GAMELEIRA DE GOIAS (GO)";"GO";"GAMELEIRA DE GOIAS";20;9;10;39
2010;"GOIANAPOLIS (GO)";"GO";"GOIANAPOLIS";180;4;10;194
2010;"GOIANDIRA (GO)";"GO";"GOIANDIRA";47;6;3;56
2010;"GOIANESIA (GO)";"GO";"GOIANESIA";811;58;187;1056
2010;"GOIANIA (GO)";"GO";"GOIANIA";23385;1785;6363;31533
2010;"GOIANIRA (GO)";"GO";"GOIANIRA";211;7;59;277
2010;"GOIAS (GO)";"GO";"GOIAS";190;15;36;241
2010;"GOIATUBA (GO)";"GO";"GOIATUBA";615;27;57;699
2010;"GOUVELANDIA (GO)";"GO";"GOUVELANDIA";53;6;6;65
2010;"GUAPO (GO)";"GO";"GUAPO";148;15;23;186
2010;"GUARAITA (GO)";"GO";"GUARAITA";15;2;1;18
2010;"GUARANI DE GOIAS (GO)";"GO";"GUARANI DE GOIAS";13;3;7;23
2010;"GUARINOS (GO)";"GO";"GUARINOS";4;5;2;11
2010;"HEITORAI (GO)";"GO";"HEITORAI";20;2;3;25
2010;"HIDROLANDIA (GO)";"GO";"HIDROLANDIA";250;15;26;291
2010;"HIDROLINA (GO)";"GO";"HIDROLINA";16;0;2;18
2010;"IACIARA (GO)";"GO";"IACIARA";112;6;13;131
2010;"INACIOLANDIA (GO)";"GO";"INACIOLANDIA";39;8;5;52
2010;"INDIARA (GO)";"GO";"INDIARA";152;12;17;181
2010;"INHUMAS (GO)";"GO";"INHUMAS";984;38;148;1170
2010;"IPAMERI (GO)";"GO";"IPAMERI";264;53;70;387
2010;"IPIRANGA DE GOIAS (GO)";"GO";"IPIRANGA DE GOIAS";19;5;7;31
2010;"IPORA (GO)";"GO";"IPORA";370;20;40;430
2010;"ISRAELANDIA (GO)";"GO";"ISRAELANDIA";18;2;5;25
2010;"ITABERAI (GO)";"GO";"ITABERAI";556;21;53;630
2010;"ITAGUARI (GO)";"GO";"ITAGUARI";49;5;11;65
2010;"ITAGUARU (GO)";"GO";"ITAGUARU";53;5;8;66
2010;"ITAJA (GO)";"GO";"ITAJA";61;4;12;77
2010;"ITAPACI (GO)";"GO";"ITAPACI";136;22;51;209
2010;"ITAPIRAPUA (GO)";"GO";"ITAPIRAPUA";51;2;9;62
2010;"ITAPURANGA (GO)";"GO";"ITAPURANGA";288;16;60;364
2010;"ITARUMA (GO)";"GO";"ITARUMA";71;13;10;94
2010;"ITAUCU (GO)";"GO";"ITAUCU";80;8;9;97
2010;"ITUMBIARA (GO)";"GO";"ITUMBIARA";1996;188;311;2495
2010;"IVOLANDIA (GO)";"GO";"IVOLANDIA";5;3;3;11
2010;"JANDAIA (GO)";"GO";"JANDAIA";94;4;10;108
2010;"JARAGUA (GO)";"GO";"JARAGUA";303;21;38;362
2010;"JATAI (GO)";"GO";"JATAI";1845;78;182;2105
2010;"JAUPACI (GO)";"GO";"JAUPACI";21;4;5;30
2010;"JESUPOLIS (GO)";"GO";"JESUPOLIS";12;2;5;19
2010;"JOVIANIA (GO)";"GO";"JOVIANIA";120;9;15;144
2010;"JUSSARA (GO)";"GO";"JUSSARA";330;13;14;357
2010;"LAGOA SANTA (GO)";"GO";"LAGOA SANTA";9;2;7;18
2010;"LEOPOLDO DE BULHOES (GO)";"GO";"LEOPOLDO DE BULHOES";107;6;5;118
2010;"LUZIANIA (GO)";"GO";"LUZIANIA";2047;115;356;2518
2010;"MAIRIPOTABA (GO)";"GO";"MAIRIPOTABA";17;4;3;24
2010;"MAMBAI (GO)";"GO";"MAMBAI";59;4;14;77
2010;"MARA ROSA (GO)";"GO";"MARA ROSA";99;5;15;119
2010;"MARZAGAO (GO)";"GO";"MARZAGAO";24;5;0;29
2010;"MATRINCHA (GO)";"GO";"MATRINCHA";30;6;7;43
2010;"MAURILANDIA (GO)";"GO";"MAURILANDIA";340;17;81;438
2010;"MIMOSO DE GOIAS (GO)";"GO";"MIMOSO DE GOIAS";8;1;2;11
2010;"MINACU (GO)";"GO";"MINACU";363;34;27;424
2010;"MINEIROS (GO)";"GO";"MINEIROS";1088;66;118;1272
2010;"MOIPORA (GO)";"GO";"MOIPORA";8;3;1;12
2010;"MONTE ALEGRE DE GOIAS (GO)";"GO";"MONTE ALEGRE DE GOIAS";13;1;5;19
2010;"MONTES CLAROS DE GOIAS (GO)";"GO";"MONTES CLAROS DE GOIAS";62;10;14;86
2010;"MONTIVIDIU (GO)";"GO";"MONTIVIDIU";283;9;49;341
2010;"MONTIVIDIU DO NORTE (GO)";"GO";"MONTIVIDIU DO NORTE";20;2;19;41
2010;"MORRINHOS (GO)";"GO";"MORRINHOS";647;41;77;765
2010;"MORRO AGUDO DE GOIAS (GO)";"GO";"MORRO AGUDO DE GOIAS";15;4;1;20
2010;"MOSSAMEDES (GO)";"GO";"MOSSAMEDES";31;7;2;40
2010;"MOZARLANDIA (GO)";"GO";"MOZARLANDIA";104;4;24;132
2010;"MUNDO NOVO (GO)";"GO";"MUNDO NOVO";22;5;13;40
2010;"MUTUNOPOLIS (GO)";"GO";"MUTUNOPOLIS";24;3;8;35
2010;"NAZARIO (GO)";"GO";"NAZARIO";100;6;7;113
2010;"NEROPOLIS (GO)";"GO";"NEROPOLIS";388;13;21;422
2010;"NIQUELANDIA (GO)";"GO";"NIQUELANDIA";515;52;129;696
2010;"NOVA AMERICA (GO)";"GO";"NOVA AMERICA";18;1;2;21
2010;"NOVA AURORA (GO)";"GO";"NOVA AURORA";26;3;4;33
2010;"NOVA CRIXAS (GO)";"GO";"NOVA CRIXAS";54;3;27;84
2010;"NOVA GLORIA (GO)";"GO";"NOVA GLORIA";58;8;21;87
2010;"NOVA IGUACU DE GOIAS (GO)";"GO";"NOVA IGUACU DE GOIAS";16;3;4;23
2010;"NOVA ROMA (GO)";"GO";"NOVA ROMA";4;3;4;11
2010;"NOVA VENEZA (GO)";"GO";"NOVA VENEZA";173;9;13;195
2010;"NOVO BRASIL (GO)";"GO";"NOVO BRASIL";21;2;1;24
2010;"NOVO GAMA (GO)";"GO";"NOVO GAMA";306;71;109;486
2010;"NOVO PLANALTO (GO)";"GO";"NOVO PLANALTO";27;4;0;31
2010;"ORIZONA (GO)";"GO";"ORIZONA";161;25;37;223
2010;"OURO VERDE DE GOIAS (GO)";"GO";"OURO VERDE DE GOIAS";87;0;7;94
2010;"OUVIDOR (GO)";"GO";"OUVIDOR";83;7;10;100
2010;"PADRE BERNARDO (GO)";"GO";"PADRE BERNARDO";294;10;53;357
2010;"PALESTINA DE GOIAS (GO)";"GO";"PALESTINA DE GOIAS";18;12;5;35
2010;"PALMEIRAS DE GOIAS (GO)";"GO";"PALMEIRAS DE GOIAS";268;6;54;328
2010;"PALMELO (GO)";"GO";"PALMELO";17;1;2;20
2010;"PALMINOPOLIS (GO)";"GO";"PALMINOPOLIS";32;1;3;36
2010;"PANAMA (GO)";"GO";"PANAMA";30;7;5;42
2010;"PARANAIGUARA (GO)";"GO";"PARANAIGUARA";88;9;8;105
2010;"PARAUNA (GO)";"GO";"PARAUNA";127;13;29;169
2010;"PEROLANDIA (GO)";"GO";"PEROLANDIA";25;5;8;38
2010;"PETROLINA DE GOIAS (GO)";"GO";"PETROLINA DE GOIAS";117;2;12;131
2010;"PILAR DE GOIAS (GO)";"GO";"PILAR DE GOIAS";8;4;3;15
2010;"PIRACANJUBA (GO)";"GO";"PIRACANJUBA";329;15;27;371
2010;"PIRANHAS (GO)";"GO";"PIRANHAS";176;3;28;207
2010;"PIRENOPOLIS (GO)";"GO";"PIRENOPOLIS";242;29;29;300
2010;"PIRES DO RIO (GO)";"GO";"PIRES DO RIO";441;28;29;498
2010;"PLANALTINA (GO)";"GO";"PLANALTINA";427;31;303;761
2010;"PONTALINA (GO)";"GO";"PONTALINA";218;10;20;248
2010;"PORANGATU (GO)";"GO";"PORANGATU";544;37;73;654
2010;"PORTEIRAO (GO)";"GO";"PORTEIRAO";72;5;8;85
2010;"PORTELANDIA (GO)";"GO";"PORTELANDIA";37;16;4;57
2010;"POSSE (GO)";"GO";"POSSE";505;41;71;617
2010;"PROFESSOR JAMIL (GO)";"GO";"PROFESSOR JAMIL";28;2;5;35
2010;"QUIRINOPOLIS (GO)";"GO";"QUIRINOPOLIS";773;29;90;892
2010;"RIALMA (GO)";"GO";"RIALMA";264;19;21;304
2010;"RIANAPOLIS (GO)";"GO";"RIANAPOLIS";77;5;4;86
2010;"RIO QUENTE (GO)";"GO";"RIO QUENTE";37;15;71;123
2010;"RIO VERDE (GO)";"GO";"RIO VERDE";2933;204;432;3569
2010;"RUBIATABA (GO)";"GO";"RUBIATABA";261;14;46;321
2010;"SANCLERLANDIA (GO)";"GO";"SANCLERLANDIA";73;6;5;84
2010;"SANTA BARBARA DE GOIAS (GO)";"GO";"SANTA BARBARA DE GOIAS";73;2;6;81
2010;"SANTA CRUZ DE GOIAS (GO)";"GO";"SANTA CRUZ DE GOIAS";3;1;2;6
2010;"SANTA FE DE GOIAS (GO)";"GO";"SANTA FE DE GOIAS";35;2;3;40
2010;"SANTA HELENA DE GOIAS (GO)";"GO";"SANTA HELENA DE GOIAS";774;33;178;985
2010;"SANTA ISABEL (GO)";"GO";"SANTA ISABEL";8;7;2;17
2010;"SANTA RITA DO ARAGUAIA (GO)";"GO";"SANTA RITA DO ARAGUAIA";131;11;3;145
2010;"SANTA RITA DO NOVO DESTINO (GO)";"GO";"SANTA RITA DO NOVO DESTINO";22;5;8;35
2010;"SANTA ROSA DE GOIAS (GO)";"GO";"SANTA ROSA DE GOIAS";21;3;3;27
2010;"SANTA TEREZA DE GOIAS (GO)";"GO";"SANTA TEREZA DE GOIAS";33;1;4;38
2010;"SANTA TEREZINHA DE GOIAS (GO)";"GO";"SANTA TEREZINHA DE GOIAS";73;7;17;97
2010;"SANTO ANTONIO DA BARRA (GO)";"GO";"SANTO ANTONIO DA BARRA";34;10;10;54
2010;"SANTO ANTONIO DE GOIAS (GO)";"GO";"SANTO ANTONIO DE GOIAS";41;9;10;60
2010;"SANTO ANTONIO DO DESCOBERTO (GO)";"GO";"SANTO ANTONIO DO DESCOBERTO";243;31;236;510
2010;"SAO DOMINGOS (GO)";"GO";"SAO DOMINGOS";38;3;18;59
2010;"SAO FRANCISCO DE GOIAS (GO)";"GO";"SAO FRANCISCO DE GOIAS";46;6;7;59
2010;"SAO JOAO D ALIANCA (GO)";"GO";"SAO JOAO D ALIANCA";104;8;11;123
2010;"SAO JOAO DA PARAUNA (GO)";"GO";"SAO JOAO DA PARAUNA";16;0;3;19
2010;"SAO LUIS DE MONTES BELOS (GO)";"GO";"SAO LUIS DE MONTES BELOS";314;15;58;387
2010;"SAO LUIZ DO NORTE (GO)";"GO";"SAO LUIZ DO NORTE";30;2;13;45
2010;"SAO MIGUEL DO ARAGUAIA (GO)";"GO";"SAO MIGUEL DO ARAGUAIA";277;8;43;328
2010;"SAO MIGUEL DO PASSA QUATRO (GO)";"GO";"SAO MIGUEL DO PASSA QUATRO";29;1;3;33
2010;"SAO PATRICIO (GO)";"GO";"SAO PATRICIO";10;0;5;15
2010;"SAO SIMAO (GO)";"GO";"SAO SIMAO";149;22;54;225
2010;"SENADOR CANEDO (GO)";"GO";"SENADOR CANEDO";519;35;41;595
2010;"SERRANOPOLIS (GO)";"GO";"SERRANOPOLIS";84;8;18;110
2010;"SILVANIA (GO)";"GO";"SILVANIA";295;15;31;341
2010;"SIMOLANDIA (GO)";"GO";"SIMOLANDIA";93;2;6;101
2010;"SITIO D ABADIA (GO)";"GO";"SITIO D ABADIA";7;0;6;13
2010;"TAQUARAL DE GOIAS (GO)";"GO";"TAQUARAL DE GOIAS";19;3;3;25
2010;"TERESINA DE GOIAS (GO)";"GO";"TERESINA DE GOIAS";8;1;1;10
2010;"TEREZOPOLIS DE GOIAS (GO)";"GO";"TEREZOPOLIS DE GOIAS";64;3;11;78
2010;"TRES RANCHOS (GO)";"GO";"TRES RANCHOS";29;11;3;43
2010;"TRINDADE (GO)";"GO";"TRINDADE";817;44;103;964
2010;"TROMBAS (GO)";"GO";"TROMBAS";23;3;8;34
2010;"TURVANIA (GO)";"GO";"TURVANIA";67;3;4;74
2010;"TURVELANDIA (GO)";"GO";"TURVELANDIA";47;3;15;65
2010;"UIRAPURU (GO)";"GO";"UIRAPURU";17;10;4;31
2010;"URUACU (GO)";"GO";"URUACU";444;27;60;531
2010;"URUANA (GO)";"GO";"URUANA";220;4;9;233
2010;"URUTAI (GO)";"GO";"URUTAI";16;0;7;23
2010;"VALPARAISO DE GOIAS (GO)";"GO";"VALPARAISO DE GOIAS";442;171;154;767
2010;"VARJAO (GO)";"GO";"VARJAO";46;0;4;50
2010;"VIANOPOLIS (GO)";"GO";"VIANOPOLIS";402;17;18;437
2010;"VICENTINOPOLIS (GO)";"GO";"VICENTINOPOLIS";155;8;29;192
2010;"VILA BOA (GO)";"GO";"VILA BOA";15;2;8;25
2010;"VILA PROPICIO (GO)";"GO";"VILA PROPICIO";9;3;13;25
2010;"ACAILANDIA (MA)";"MA";"ACAILANDIA";915;89;123;1127
2010;"AFONSO CUNHA (MA)";"MA";"AFONSO CUNHA";4;1;1;6
2010;"AGUA DOCE DO MARANHAO (MA)";"MA";"AGUA DOCE DO MARANHAO";2;1;0;3
2010;"ALCANTARA (MA)";"MA";"ALCANTARA";37;7;10;54
2010;"ALDEIAS ALTAS (MA)";"MA";"ALDEIAS ALTAS";37;4;8;49
2010;"ALTAMIRA DO MARANHAO (MA)";"MA";"ALTAMIRA DO MARANHAO";18;3;1;22
2010;"ALTO ALEGRE DO MARANHAO (MA)";"MA";"ALTO ALEGRE DO MARANHAO";28;16;1;45
2010;"ALTO ALEGRE DO PINDARE (MA)";"MA";"ALTO ALEGRE DO PINDARE";29;10;2;41
2010;"ALTO PARNAIBA (MA)";"MA";"ALTO PARNAIBA";35;2;5;42
2010;"AMAPA DO MARANHAO (MA)";"MA";"AMAPA DO MARANHAO";6;2;2;10
2010;"AMARANTE DO MARANHAO (MA)";"MA";"AMARANTE DO MARANHAO";74;4;4;82
2010;"ANAJATUBA (MA)";"MA";"ANAJATUBA";28;2;2;32
2010;"ANAPURUS (MA)";"MA";"ANAPURUS";37;1;9;47
2010;"APICUM ACU (MA)";"MA";"APICUM ACU";7;5;0;12
2010;"ARAGUANA (MA)";"MA";"ARAGUANA";7;0;2;9
2010;"ARAIOSES (MA)";"MA";"ARAIOSES";15;5;12;32
2010;"ARAME (MA)";"MA";"ARAME";84;10;0;94
2010;"ARARI (MA)";"MA";"ARARI";63;6;3;72
2010;"AXIXA (MA)";"MA";"AXIXA";13;5;4;22
2010;"BACABAL (MA)";"MA";"BACABAL";707;73;51;831
2010;"BACABEIRA (MA)";"MA";"BACABEIRA";66;1;4;71
2010;"BACURI (MA)";"MA";"BACURI";7;3;3;13
2010;"BACURITUBA (MA)";"MA";"BACURITUBA";3;0;0;3
2010;"BALSAS (MA)";"MA";"BALSAS";1046;35;57;1138
2010;"BARAO DE GRAJAU (MA)";"MA";"BARAO DE GRAJAU";42;1;4;47
2010;"BARRA DO CORDA (MA)";"MA";"BARRA DO CORDA";433;24;7;464
2010;"BARREIRINHAS (MA)";"MA";"BARREIRINHAS";52;7;11;70
2010;"BELA VISTA DO MARANHAO (MA)";"MA";"BELA VISTA DO MARANHAO";22;2;2;26
2010;"BELAGUA (MA)";"MA";"BELAGUA";1;4;3;8
2010;"BENEDITO LEITE (MA)";"MA";"BENEDITO LEITE";2;1;1;4
2010;"BEQUIMAO (MA)";"MA";"BEQUIMAO";63;7;9;79
2010;"BERNARDO DO MEARIM (MA)";"MA";"BERNARDO DO MEARIM";17;1;1;19
2010;"BOA VISTA DO GURUPI (MA)";"MA";"BOA VISTA DO GURUPI";4;1;2;7
2010;"BOM JARDIM (MA)";"MA";"BOM JARDIM";78;4;7;89
2010;"BOM JESUS DAS SELVAS (MA)";"MA";"BOM JESUS DAS SELVAS";71;4;1;76
2010;"BOM LUGAR (MA)";"MA";"BOM LUGAR";35;8;12;55
2010;"BREJO (MA)";"MA";"BREJO";45;13;12;70
2010;"BREJO DE AREIA (MA)";"MA";"BREJO DE AREIA";17;4;1;22
2010;"BURITI (MA)";"MA";"BURITI";13;7;14;34
2010;"BURITI BRAVO (MA)";"MA";"BURITI BRAVO";19;0;1;20
2010;"BURITICUPU (MA)";"MA";"BURITICUPU";287;41;8;336
2010;"BURITIRANA (MA)";"MA";"BURITIRANA";13;0;0;13
2010;"CACHOEIRA GRANDE (MA)";"MA";"CACHOEIRA GRANDE";4;2;2;8
2010;"CAJAPIO (MA)";"MA";"CAJAPIO";6;0;2;8
2010;"CAJARI (MA)";"MA";"CAJARI";4;1;0;5
2010;"CAMPESTRE DO MARANHAO (MA)";"MA";"CAMPESTRE DO MARANHAO";12;12;3;27
2010;"CANDIDO MENDES (MA)";"MA";"CANDIDO MENDES";12;5;2;19
2010;"CANTANHEDE (MA)";"MA";"CANTANHEDE";21;3;1;25
2010;"CAPINZAL DO NORTE (MA)";"MA";"CAPINZAL DO NORTE";20;12;2;34
2010;"CAROLINA (MA)";"MA";"CAROLINA";50;4;3;57
2010;"CARUTAPERA (MA)";"MA";"CARUTAPERA";18;7;5;30
2010;"CAXIAS (MA)";"MA";"CAXIAS";670;48;71;789
2010;"CEDRAL (MA)";"MA";"CEDRAL";5;0;4;9
2010;"CENTRAL DO MARANHAO (MA)";"MA";"CENTRAL DO MARANHAO";6;1;0;7
2010;"CENTRO DO GUILHERME (MA)";"MA";"CENTRO DO GUILHERME";6;0;2;8
2010;"CENTRO NOVO DO MARANHAO (MA)";"MA";"CENTRO NOVO DO MARANHAO";20;1;3;24
2010;"CHAPADINHA (MA)";"MA";"CHAPADINHA";249;38;9;296
2010;"CIDELANDIA (MA)";"MA";"CIDELANDIA";30;9;9;48
2010;"CODO (MA)";"MA";"CODO";487;24;22;533
2010;"COELHO NETO (MA)";"MA";"COELHO NETO";82;10;33;125
2010;"COLINAS (MA)";"MA";"COLINAS";103;7;9;119
2010;"CONCEICAO DO LAGO ACU (MA)";"MA";"CONCEICAO DO LAGO ACU";12;4;1;17
2010;"COROATA (MA)";"MA";"COROATA";157;31;7;195
2010;"CURURUPU (MA)";"MA";"CURURUPU";22;6;6;34
2010;"DAVINOPOLIS (MA)";"MA";"DAVINOPOLIS";40;3;2;45
2010;"DOM PEDRO (MA)";"MA";"DOM PEDRO";305;6;23;334
2010;"DUQUE BACELAR (MA)";"MA";"DUQUE BACELAR";0;2;4;6
2010;"ESPERANTINOPOLIS (MA)";"MA";"ESPERANTINOPOLIS";68;16;0;84
2010;"ESTREITO (MA)";"MA";"ESTREITO";64;18;3;85
2010;"FEIRA NOVA DO MARANHAO (MA)";"MA";"FEIRA NOVA DO MARANHAO";1;1;1;3
2010;"FERNANDO FALCAO (MA)";"MA";"FERNANDO FALCAO";9;0;2;11
2010;"FORMOSA DA SERRA NEGRA (MA)";"MA";"FORMOSA DA SERRA NEGRA";19;3;1;23
2010;"FORTALEZA DOS NOGUEIRAS (MA)";"MA";"FORTALEZA DOS NOGUEIRAS";41;3;5;49
2010;"FORTUNA (MA)";"MA";"FORTUNA";23;4;1;28
2010;"GODOFREDO VIANA (MA)";"MA";"GODOFREDO VIANA";4;4;3;11
2010;"GONCALVES DIAS (MA)";"MA";"GONCALVES DIAS";35;3;3;41
2010;"GOVERNADOR ARCHER (MA)";"MA";"GOVERNADOR ARCHER";18;7;3;28
2010;"GOVERNADOR EDISON LOBAO (MA)";"MA";"GOVERNADOR EDISON LOBAO";35;2;5;42
2010;"GOVERNADOR EUGENIO BARROS (MA)";"MA";"GOVERNADOR EUGENIO BARROS";34;7;8;49
2010;"GOVERNADOR LUIZ ROCHA (MA)";"MA";"GOVERNADOR LUIZ ROCHA";14;3;5;22
2010;"GOVERNADOR NEWTON BELLO (MA)";"MA";"GOVERNADOR NEWTON BELLO";18;1;3;22
2010;"GOVERNADOR NUNES FREIRE (MA)";"MA";"GOVERNADOR NUNES FREIRE";51;5;3;59
2010;"GRACA ARANHA (MA)";"MA";"GRACA ARANHA";10;4;3;17
2010;"GRAJAU (MA)";"MA";"GRAJAU";326;15;16;357
2010;"GUIMARAES (MA)";"MA";"GUIMARAES";9;1;6;16
2010;"HUMBERTO DE CAMPOS (MA)";"MA";"HUMBERTO DE CAMPOS";13;1;2;16
2010;"ICATU (MA)";"MA";"ICATU";12;1;5;18
2010;"IGARAPE DO MEIO (MA)";"MA";"IGARAPE DO MEIO";18;2;7;27
2010;"IGARAPE GRANDE (MA)";"MA";"IGARAPE GRANDE";60;10;4;74
2010;"IMPERATRIZ (MA)";"MA";"IMPERATRIZ";2485;193;245;2923
2010;"ITAIPAVA DO GRAJAU (MA)";"MA";"ITAIPAVA DO GRAJAU";15;2;1;18
2010;"ITAPECURU MIRIM (MA)";"MA";"ITAPECURU MIRIM";260;16;26;302
2010;"ITINGA DO MARANHAO (MA)";"MA";"ITINGA DO MARANHAO";79;5;4;88
2010;"JATOBA (MA)";"MA";"JATOBA";2;2;1;5
2010;"JENIPAPO DOS VIEIRAS (MA)";"MA";"JENIPAPO DOS VIEIRAS";34;1;2;37
2010;"JOAO LISBOA (MA)";"MA";"JOAO LISBOA";70;7;5;82
2010;"JOSELANDIA (MA)";"MA";"JOSELANDIA";43;5;2;50
2010;"JUNCO DO MARANHAO (MA)";"MA";"JUNCO DO MARANHAO";6;13;1;20
2010;"LAGO DA PEDRA (MA)";"MA";"LAGO DA PEDRA";225;31;4;260
2010;"LAGO DO JUNCO (MA)";"MA";"LAGO DO JUNCO";17;2;3;22
2010;"LAGO DOS RODRIGUES (MA)";"MA";"LAGO DOS RODRIGUES";35;12;2;49
2010;"LAGO VERDE (MA)";"MA";"LAGO VERDE";17;1;4;22
2010;"LAGOA DO MATO (MA)";"MA";"LAGOA DO MATO";9;0;2;11
2010;"LAGOA GRANDE DO MARANHAO (MA)";"MA";"LAGOA GRANDE DO MARANHAO";15;1;0;16
2010;"LAJEADO NOVO (MA)";"MA";"LAJEADO NOVO";13;7;1;21
2010;"LIMA CAMPOS (MA)";"MA";"LIMA CAMPOS";63;18;2;83
2010;"LORETO (MA)";"MA";"LORETO";7;4;2;13
2010;"LUIS DOMINGUES (MA)";"MA";"LUIS DOMINGUES";2;2;2;6
2010;"MAGALHAES DE ALMEIDA (MA)";"MA";"MAGALHAES DE ALMEIDA";9;2;1;12
2010;"MARACACUME (MA)";"MA";"MARACACUME";40;28;2;70
2010;"MARAJA DO SENA (MA)";"MA";"MARAJA DO SENA";9;0;1;10
2010;"MARANHAOZINHO (MA)";"MA";"MARANHAOZINHO";19;0;1;20
2010;"MATA ROMA (MA)";"MA";"MATA ROMA";31;7;7;45
2010;"MATINHA (MA)";"MA";"MATINHA";26;8;0;34
2010;"MATOES (MA)";"MA";"MATOES";24;4;9;37
2010;"MATOES DO NORTE (MA)";"MA";"MATOES DO NORTE";13;4;2;19
2010;"MILAGRES DO MARANHAO (MA)";"MA";"MILAGRES DO MARANHAO";4;2;2;8
2010;"MIRADOR (MA)";"MA";"MIRADOR";15;1;2;18
2010;"MIRANDA DO NORTE (MA)";"MA";"MIRANDA DO NORTE";87;4;5;96
2010;"MIRINZAL (MA)";"MA";"MIRINZAL";27;2;5;34
2010;"MONCAO (MA)";"MA";"MONCAO";11;5;5;21
2010;"MONTES ALTOS (MA)";"MA";"MONTES ALTOS";31;0;1;32
2010;"MORROS (MA)";"MA";"MORROS";11;3;3;17
2010;"NINA RODRIGUES (MA)";"MA";"NINA RODRIGUES";5;3;2;10
2010;"NOVA COLINAS (MA)";"MA";"NOVA COLINAS";9;2;5;16
2010;"NOVA IORQUE (MA)";"MA";"NOVA IORQUE";3;1;1;5
2010;"NOVA OLINDA DO MARANHAO (MA)";"MA";"NOVA OLINDA DO MARANHAO";38;16;1;55
2010;"OLHO D AGUA DAS CUNHAS (MA)";"MA";"OLHO D AGUA DAS CUNHAS";62;12;6;80
2010;"OLINDA NOVA DO MARANHAO (MA)";"MA";"OLINDA NOVA DO MARANHAO";16;1;1;18
2010;"PACO DO LUMIAR (MA)";"MA";"PACO DO LUMIAR";309;103;85;497
2010;"PALMEIRANDIA (MA)";"MA";"PALMEIRANDIA";9;2;8;19
2010;"PARAIBANO (MA)";"MA";"PARAIBANO";38;10;4;52
2010;"PARNARAMA (MA)";"MA";"PARNARAMA";24;2;1;27
2010;"PASSAGEM FRANCA (MA)";"MA";"PASSAGEM FRANCA";17;2;1;20
2010;"PASTOS BONS (MA)";"MA";"PASTOS BONS";67;9;2;78
2010;"PAULINO NEVES (MA)";"MA";"PAULINO NEVES";2;1;0;3
2010;"PAULO RAMOS (MA)";"MA";"PAULO RAMOS";55;5;0;60
2010;"PEDREIRAS (MA)";"MA";"PEDREIRAS";304;45;26;375
2010;"PEDRO DO ROSARIO (MA)";"MA";"PEDRO DO ROSARIO";11;1;2;14
2010;"PENALVA (MA)";"MA";"PENALVA";17;3;1;21
2010;"PERI MIRIM (MA)";"MA";"PERI MIRIM";17;4;6;27
2010;"PERITORO (MA)";"MA";"PERITORO";34;51;10;95
2010;"PINDARE MIRIM (MA)";"MA";"PINDARE MIRIM";85;11;15;111
2010;"PINHEIRO (MA)";"MA";"PINHEIRO";364;21;49;434
2010;"PIO XII (MA)";"MA";"PIO XII";84;3;1;88
2010;"PIRAPEMAS (MA)";"MA";"PIRAPEMAS";11;9;3;23
2010;"POCAO DE PEDRAS (MA)";"MA";"POCAO DE PEDRAS";37;16;3;56
2010;"PORTO FRANCO (MA)";"MA";"PORTO FRANCO";46;20;5;71
2010;"PORTO RICO DO MARANHAO (MA)";"MA";"PORTO RICO DO MARANHAO";3;1;1;5
2010;"PRESIDENTE DUTRA (MA)";"MA";"PRESIDENTE DUTRA";294;20;13;327
2010;"PRESIDENTE JUSCELINO (MA)";"MA";"PRESIDENTE JUSCELINO";5;2;3;10
2010;"PRESIDENTE MEDICI (MA)";"MA";"PRESIDENTE MEDICI";8;4;0;12
2010;"PRESIDENTE SARNEY (MA)";"MA";"PRESIDENTE SARNEY";1;3;1;5
2010;"PRESIDENTE VARGAS (MA)";"MA";"PRESIDENTE VARGAS";17;4;1;22
2010;"PRIMEIRA CRUZ (MA)";"MA";"PRIMEIRA CRUZ";0;1;0;1
2010;"RAPOSA (MA)";"MA";"RAPOSA";46;2;35;83
2010;"RIACHAO (MA)";"MA";"RIACHAO";33;4;3;40
2010;"RIBAMAR FIQUENE (MA)";"MA";"RIBAMAR FIQUENE";9;3;1;13
2010;"ROSARIO (MA)";"MA";"ROSARIO";175;18;37;230
2010;"SAMBAIBA (MA)";"MA";"SAMBAIBA";10;2;1;13
2010;"SANTA FILOMENA DO MARANHAO (MA)";"MA";"SANTA FILOMENA DO MARANHAO";4;5;1;10
2010;"SANTA HELENA (MA)";"MA";"SANTA HELENA";71;5;4;80
2010;"SANTA INES (MA)";"MA";"SANTA INES";583;122;81;786
2010;"SANTA LUZIA (MA)";"MA";"SANTA LUZIA";216;72;10;298
2010;"SANTA LUZIA DO PARUA (MA)";"MA";"SANTA LUZIA DO PARUA";98;8;5;111
2010;"SANTA QUITERIA DO MARANHAO (MA)";"MA";"SANTA QUITERIA DO MARANHAO";21;4;6;31
2010;"SANTA RITA (MA)";"MA";"SANTA RITA";121;6;7;134
2010;"SANTANA DO MARANHAO (MA)";"MA";"SANTANA DO MARANHAO";6;0;3;9
2010;"SANTO AMARO DO MARANHAO (MA)";"MA";"SANTO AMARO DO MARANHAO";3;4;2;9
2010;"SANTO ANTONIO DOS LOPES (MA)";"MA";"SANTO ANTONIO DOS LOPES";72;6;2;80
2010;"SAO BENEDITO DO RIO PRETO (MA)";"MA";"SAO BENEDITO DO RIO PRETO";13;9;2;24
2010;"SAO BENTO (MA)";"MA";"SAO BENTO";96;25;13;134
2010;"SAO BERNARDO (MA)";"MA";"SAO BERNARDO";67;0;6;73
2010;"SAO DOMINGOS DO AZEITAO (MA)";"MA";"SAO DOMINGOS DO AZEITAO";24;2;1;27
2010;"SAO DOMINGOS DO MARANHAO (MA)";"MA";"SAO DOMINGOS DO MARANHAO";129;3;2;134
2010;"SAO FELIX DE BALSAS (MA)";"MA";"SAO FELIX DE BALSAS";5;0;1;6
2010;"SAO FRANCISCO DO BREJAO (MA)";"MA";"SAO FRANCISCO DO BREJAO";40;2;1;43
2010;"SAO FRANCISCO DO MARANHAO (MA)";"MA";"SAO FRANCISCO DO MARANHAO";4;0;2;6
2010;"SAO JOAO BATISTA (MA)";"MA";"SAO JOAO BATISTA";31;4;6;41
2010;"SAO JOAO DO CARU (MA)";"MA";"SAO JOAO DO CARU";21;1;0;22
2010;"SAO JOAO DO PARAISO (MA)";"MA";"SAO JOAO DO PARAISO";8;3;2;13
2010;"SAO JOAO DO SOTER (MA)";"MA";"SAO JOAO DO SOTER";11;1;1;13
2010;"SAO JOAO DOS PATOS (MA)";"MA";"SAO JOAO DOS PATOS";131;6;5;142
2010;"SAO JOSE DE RIBAMAR (MA)";"MA";"SAO JOSE DE RIBAMAR";479;115;105;699
2010;"SAO JOSE DOS BASILIOS (MA)";"MA";"SAO JOSE DOS BASILIOS";9;3;1;13
2010;"SAO LUIS (MA)";"MA";"SAO LUIS";7064;1127;2966;11157
2010;"SAO LUIS GONZAGA DO MARANHAO (MA)";"MA";"SAO LUIS GONZAGA DO MARANHAO";26;6;3;35
2010;"SAO MATEUS DO MARANHAO (MA)";"MA";"SAO MATEUS DO MARANHAO";92;37;13;142
2010;"SAO PEDRO DA AGUA BRANCA (MA)";"MA";"SAO PEDRO DA AGUA BRANCA";14;6;2;22
2010;"SAO PEDRO DOS CRENTES (MA)";"MA";"SAO PEDRO DOS CRENTES";7;1;2;10
2010;"SAO RAIMUNDO DAS MANGABEIRAS (MA)";"MA";"SAO RAIMUNDO DAS MANGABEIRAS";81;5;33;119
2010;"SAO RAIMUNDO DO DOCA BEZERRA (MA)";"MA";"SAO RAIMUNDO DO DOCA BEZERRA";11;0;1;12
2010;"SAO ROBERTO (MA)";"MA";"SAO ROBERTO";13;3;1;17
2010;"SAO VICENTE FERRER (MA)";"MA";"SAO VICENTE FERRER";20;2;5;27
2010;"SATUBINHA (MA)";"MA";"SATUBINHA";15;3;0;18
2010;"SENADOR ALEXANDRE COSTA (MA)";"MA";"SENADOR ALEXANDRE COSTA";16;4;2;22
2010;"SENADOR LA ROCQUE (MA)";"MA";"SENADOR LA ROCQUE";36;1;1;38
2010;"SERRANO DO MARANHAO (MA)";"MA";"SERRANO DO MARANHAO";1;0;1;2
2010;"SITIO NOVO (MA)";"MA";"SITIO NOVO";33;4;3;40
2010;"SUCUPIRA DO NORTE (MA)";"MA";"SUCUPIRA DO NORTE";15;3;2;20
2010;"SUCUPIRA DO RIACHAO (MA)";"MA";"SUCUPIRA DO RIACHAO";4;4;2;10
2010;"TASSO FRAGOSO (MA)";"MA";"TASSO FRAGOSO";31;3;3;37
2010;"TIMBIRAS (MA)";"MA";"TIMBIRAS";26;7;1;34
2010;"TIMON (MA)";"MA";"TIMON";489;36;41;566
2010;"TRIZIDELA DO VALE (MA)";"MA";"TRIZIDELA DO VALE";95;17;5;117
2010;"TUFILANDIA (MA)";"MA";"TUFILANDIA";7;6;1;14
2010;"TUNTUM (MA)";"MA";"TUNTUM";83;4;4;91
2010;"TURIACU (MA)";"MA";"TURIACU";30;2;4;36
2010;"TURILANDIA (MA)";"MA";"TURILANDIA";11;4;2;17
2010;"TUTOIA (MA)";"MA";"TUTOIA";43;5;3;51
2010;"URBANO SANTOS (MA)";"MA";"URBANO SANTOS";45;7;4;56
2010;"VARGEM GRANDE (MA)";"MA";"VARGEM GRANDE";88;3;6;97
2010;"VIANA (MA)";"MA";"VIANA";141;4;4;149
2010;"VILA NOVA DOS MARTIRIOS (MA)";"MA";"VILA NOVA DOS MARTIRIOS";23;3;1;27
2010;"VITORIA DO MEARIM (MA)";"MA";"VITORIA DO MEARIM";58;8;4;70
2010;"VITORINO FREIRE (MA)";"MA";"VITORINO FREIRE";106;8;4;118
2010;"ZE DOCA (MA)";"MA";"ZE DOCA";170;20;17;207
2010;"ABADIA DOS DOURADOS (MG)";"MG";"ABADIA DOS DOURADOS";82;29;8;119
2010;"ABAETE (MG)";"MG";"ABAETE";428;18;151;597
2010;"ABRE CAMPO (MG)";"MG";"ABRE CAMPO";170;13;49;232
2010;"ACAIACA (MG)";"MG";"ACAIACA";14;6;7;27
2010;"ACUCENA (MG)";"MG";"ACUCENA";30;13;26;69
2010;"AGUA BOA (MG)";"MG";"AGUA BOA";50;6;22;78
2010;"AGUA COMPRIDA (MG)";"MG";"AGUA COMPRIDA";31;7;5;43
2010;"AGUANIL (MG)";"MG";"AGUANIL";37;6;11;54
2010;"AGUAS FORMOSAS (MG)";"MG";"AGUAS FORMOSAS";81;18;30;129
2010;"AGUAS VERMELHAS (MG)";"MG";"AGUAS VERMELHAS";69;13;15;97
2010;"AIMORES (MG)";"MG";"AIMORES";165;26;36;227
2010;"AIURUOCA (MG)";"MG";"AIURUOCA";81;14;10;105
2010;"ALAGOA (MG)";"MG";"ALAGOA";19;3;9;31
2010;"ALBERTINA (MG)";"MG";"ALBERTINA";34;12;4;50
2010;"ALEM PARAIBA (MG)";"MG";"ALEM PARAIBA";1268;74;109;1451
2010;"ALFENAS (MG)";"MG";"ALFENAS";1063;82;255;1400
2010;"ALFREDO VASCONCELOS (MG)";"MG";"ALFREDO VASCONCELOS";120;8;14;142
2010;"ALMENARA (MG)";"MG";"ALMENARA";214;40;79;333
2010;"ALPERCATA (MG)";"MG";"ALPERCATA";62;4;5;71
2010;"ALPINOPOLIS (MG)";"MG";"ALPINOPOLIS";379;24;37;440
2010;"ALTEROSA (MG)";"MG";"ALTEROSA";205;30;39;274
2010;"ALTO CAPARAO (MG)";"MG";"ALTO CAPARAO";52;6;5;63
2010;"ALTO JEQUITIBA (MG)";"MG";"ALTO JEQUITIBA";59;9;11;79
2010;"ALTO RIO DOCE (MG)";"MG";"ALTO RIO DOCE";93;17;23;133
2010;"ALVARENGA (MG)";"MG";"ALVARENGA";26;0;10;36
2010;"ALVINOPOLIS (MG)";"MG";"ALVINOPOLIS";159;17;18;194
2010;"ALVORADA DE MINAS (MG)";"MG";"ALVORADA DE MINAS";8;6;7;21
2010;"AMPARO DA SERRA (MG)";"MG";"AMPARO DA SERRA";27;5;19;51
2010;"ANDRADAS (MG)";"MG";"ANDRADAS";920;68;76;1064
2010;"ANDRELANDIA (MG)";"MG";"ANDRELANDIA";125;31;12;168
2010;"ANGELANDIA (MG)";"MG";"ANGELANDIA";50;5;20;75
2010;"ANTONIO CARLOS (MG)";"MG";"ANTONIO CARLOS";141;14;15;170
2010;"ANTONIO DIAS (MG)";"MG";"ANTONIO DIAS";98;9;36;143
2010;"ANTONIO PRADO DE MINAS (MG)";"MG";"ANTONIO PRADO DE MINAS";13;2;3;18
2010;"ARACAI (MG)";"MG";"ARACAI";12;6;5;23
2010;"ARACITABA (MG)";"MG";"ARACITABA";12;2;1;15
2010;"ARACUAI (MG)";"MG";"ARACUAI";203;11;67;281
2010;"ARAGUARI (MG)";"MG";"ARAGUARI";2253;314;166;2733
2010;"ARANTINA (MG)";"MG";"ARANTINA";26;1;2;29
2010;"ARAPONGA (MG)";"MG";"ARAPONGA";52;7;7;66
2010;"ARAPORA (MG)";"MG";"ARAPORA";169;11;57;237
2010;"ARAPUA (MG)";"MG";"ARAPUA";37;2;16;55
2010;"ARAUJOS (MG)";"MG";"ARAUJOS";108;8;5;121
2010;"ARAXA (MG)";"MG";"ARAXA";1459;150;267;1876
2010;"ARCEBURGO (MG)";"MG";"ARCEBURGO";87;18;38;143
2010;"ARCOS (MG)";"MG";"ARCOS";1076;73;259;1408
2010;"AREADO (MG)";"MG";"AREADO";182;13;74;269
2010;"ARGIRITA (MG)";"MG";"ARGIRITA";22;4;4;30
2010;"ARICANDUVA (MG)";"MG";"ARICANDUVA";7;3;9;19
2010;"ARINOS (MG)";"MG";"ARINOS";180;15;54;249
2010;"ASTOLFO DUTRA (MG)";"MG";"ASTOLFO DUTRA";205;9;24;238
2010;"ATALEIA (MG)";"MG";"ATALEIA";64;20;21;105
2010;"AUGUSTO DE LIMA (MG)";"MG";"AUGUSTO DE LIMA";29;2;12;43
2010;"BAEPENDI (MG)";"MG";"BAEPENDI";331;34;28;393
2010;"BALDIM (MG)";"MG";"BALDIM";133;10;12;155
2010;"BAMBUI (MG)";"MG";"BAMBUI";413;29;68;510
2010;"BANDEIRA (MG)";"MG";"BANDEIRA";2;2;4;8
2010;"BANDEIRA DO SUL (MG)";"MG";"BANDEIRA DO SUL";123;24;4;151
2010;"BARAO DE COCAIS (MG)";"MG";"BARAO DE COCAIS";439;55;62;556
2010;"BARAO D0 MONTE ALTO (MG)";"MG";"BARAO D0 MONTE ALTO";17;3;6;26
2010;"BARBACENA (MG)";"MG";"BARBACENA";1567;289;228;2084
2010;"BARRA LONGA (MG)";"MG";"BARRA LONGA";42;7;8;57
2010;"BARROSO (MG)";"MG";"BARROSO";365;20;25;410
2010;"BELA VISTA DE MINAS (MG)";"MG";"BELA VISTA DE MINAS";136;12;10;158
2010;"BELMIRO BRAGA (MG)";"MG";"BELMIRO BRAGA";46;8;3;57
2010;"BELO HORIZONTE (MG)";"MG";"BELO HORIZONTE";31526;4783;7992;44301
2010;"BELO ORIENTE (MG)";"MG";"BELO ORIENTE";230;61;78;369
2010;"BELO VALE (MG)";"MG";"BELO VALE";129;17;21;167
2010;"BERILO (MG)";"MG";"BERILO";55;5;21;81
2010;"BERIZAL (MG)";"MG";"BERIZAL";18;3;6;27
2010;"BERTOPOLIS (MG)";"MG";"BERTOPOLIS";10;3;3;16
2010;"BETIM (MG)";"MG";"BETIM";4087;481;1076;5644
2010;"BIAS FORTES (MG)";"MG";"BIAS FORTES";20;4;4;28
2010;"BICAS (MG)";"MG";"BICAS";201;30;29;260
2010;"BIQUINHAS (MG)";"MG";"BIQUINHAS";41;8;3;52
2010;"BOA ESPERANCA (MG)";"MG";"BOA ESPERANCA";536;51;156;743
2010;"BOCAINA DE MINAS (MG)";"MG";"BOCAINA DE MINAS";52;11;7;70
2010;"BOCAIUVA (MG)";"MG";"BOCAIUVA";404;39;118;561
2010;"BOM DESPACHO (MG)";"MG";"BOM DESPACHO";904;62;345;1311
2010;"BOM JARDIM DE MINAS (MG)";"MG";"BOM JARDIM DE MINAS";86;11;11;108
2010;"BOM JESUS DA PENHA (MG)";"MG";"BOM JESUS DA PENHA";104;13;12;129
2010;"BOM JESUS DO AMPARO (MG)";"MG";"BOM JESUS DO AMPARO";84;7;10;101
2010;"BOM JESUS DO GALHO (MG)";"MG";"BOM JESUS DO GALHO";84;7;17;108
2010;"BOM REPOUSO (MG)";"MG";"BOM REPOUSO";186;15;8;209
2010;"BOM SUCESSO (MG)";"MG";"BOM SUCESSO";222;18;48;288
2010;"BONFIM (MG)";"MG";"BONFIM";114;15;16;145
2010;"BONFINOPOLIS DE MINAS (MG)";"MG";"BONFINOPOLIS DE MINAS";68;2;22;92
2010;"BONITO DE MINAS (MG)";"MG";"BONITO DE MINAS";18;2;16;36
2010;"BORDA DA MATA (MG)";"MG";"BORDA DA MATA";251;23;60;334
2010;"BOTELHOS (MG)";"MG";"BOTELHOS";221;51;35;307
2010;"BOTUMIRIM (MG)";"MG";"BOTUMIRIM";18;1;8;27
2010;"BRAS PIRES (MG)";"MG";"BRAS PIRES";35;9;6;50
2010;"BRASILANDIA DE MINAS (MG)";"MG";"BRASILANDIA DE MINAS";202;8;86;296
2010;"BRASILIA DE MINAS (MG)";"MG";"BRASILIA DE MINAS";221;9;76;306
2010;"BRASOPOLIS (MG)";"MG";"BRASOPOLIS";181;27;23;231
2010;"BRAUNAS (MG)";"MG";"BRAUNAS";10;6;12;28
2010;"BRUMADINHO (MG)";"MG";"BRUMADINHO";750;112;215;1077
2010;"BUENO BRANDAO (MG)";"MG";"BUENO BRANDAO";170;40;21;231
2010;"BUENOPOLIS (MG)";"MG";"BUENOPOLIS";96;7;24;127
2010;"BUGRE (MG)";"MG";"BUGRE";18;3;5;26
2010;"BURITIS (MG)";"MG";"BURITIS";241;10;81;332
2010;"BURITIZEIRO (MG)";"MG";"BURITIZEIRO";202;12;89;303
2010;"CABECEIRA GRANDE (MG)";"MG";"CABECEIRA GRANDE";34;0;9;43
2010;"CABO VERDE (MG)";"MG";"CABO VERDE";169;27;35;231
2010;"CACHOEIRA DA PRATA (MG)";"MG";"CACHOEIRA DA PRATA";56;1;2;59
2010;"CACHOEIRA DE MINAS (MG)";"MG";"CACHOEIRA DE MINAS";114;20;11;145
2010;"CACHOEIRA DE PAJEU (MG)";"MG";"CACHOEIRA DE PAJEU";32;9;11;52
2010;"CACHOEIRA DOURADA (MG)";"MG";"CACHOEIRA DOURADA";19;12;2;33
2010;"CAETANOPOLIS (MG)";"MG";"CAETANOPOLIS";105;16;44;165
2010;"CAETE (MG)";"MG";"CAETE";457;60;50;567
2010;"CAIANA (MG)";"MG";"CAIANA";31;5;7;43
2010;"CAJURI (MG)";"MG";"CAJURI";37;4;8;49
2010;"CALDAS (MG)";"MG";"CALDAS";234;22;23;279
2010;"CAMACHO (MG)";"MG";"CAMACHO";56;6;9;71
2010;"CAMANDUCAIA (MG)";"MG";"CAMANDUCAIA";443;34;39;516
2010;"CAMBUI (MG)";"MG";"CAMBUI";486;46;96;628
2010;"CAMBUQUIRA (MG)";"MG";"CAMBUQUIRA";118;22;12;152
2010;"CAMPANARIO (MG)";"MG";"CAMPANARIO";9;6;3;18
2010;"CAMPANHA (MG)";"MG";"CAMPANHA";213;33;31;277
2010;"CAMPESTRE (MG)";"MG";"CAMPESTRE";454;43;49;546
2010;"CAMPINA VERDE (MG)";"MG";"CAMPINA VERDE";225;22;38;285
2010;"CAMPO AZUL (MG)";"MG";"CAMPO AZUL";7;3;4;14
2010;"CAMPO BELO (MG)";"MG";"CAMPO BELO";1087;70;110;1267
2010;"CAMPO DO MEIO (MG)";"MG";"CAMPO DO MEIO";101;20;63;184
2010;"CAMPO FLORIDO (MG)";"MG";"CAMPO FLORIDO";112;25;59;196
2010;"CAMPOS ALTOS (MG)";"MG";"CAMPOS ALTOS";271;18;71;360
2010;"CAMPOS GERAIS (MG)";"MG";"CAMPOS GERAIS";290;22;94;406
2010;"CANA VERDE (MG)";"MG";"CANA VERDE";56;8;5;69
2010;"CANAA (MG)";"MG";"CANAA";59;5;9;73
2010;"CANAPOLIS (MG)";"MG";"CANAPOLIS";200;12;94;306
2010;"CANDEIAS (MG)";"MG";"CANDEIAS";223;16;29;268
2010;"CANTAGALO (MG)";"MG";"CANTAGALO";12;2;8;22
2010;"CAPARAO (MG)";"MG";"CAPARAO";49;3;7;59
2010;"CAPELA NOVA (MG)";"MG";"CAPELA NOVA";20;13;3;36
2010;"CAPELINHA (MG)";"MG";"CAPELINHA";598;37;138;773
2010;"CAPETINGA (MG)";"MG";"CAPETINGA";152;13;27;192
2010;"CAPIM BRANCO (MG)";"MG";"CAPIM BRANCO";58;12;12;82
2010;"CAPINOPOLIS (MG)";"MG";"CAPINOPOLIS";251;30;76;357
2010;"CAPITAO ANDRADE (MG)";"MG";"CAPITAO ANDRADE";32;6;3;41
2010;"CAPITAO ENEAS (MG)";"MG";"CAPITAO ENEAS";57;2;20;79
2010;"CAPITOLIO (MG)";"MG";"CAPITOLIO";134;19;15;168
2010;"CAPUTIRA (MG)";"MG";"CAPUTIRA";117;6;32;155
2010;"CARAI (MG)";"MG";"CARAI";60;27;33;120
2010;"CARANAIBA (MG)";"MG";"CARANAIBA";17;7;11;35
2010;"CARANDAI (MG)";"MG";"CARANDAI";474;37;88;599
2010;"CARANGOLA (MG)";"MG";"CARANGOLA";338;32;45;415
2010;"CARATINGA (MG)";"MG";"CARATINGA";1099;61;794;1954
2010;"CARBONITA (MG)";"MG";"CARBONITA";144;12;35;191
2010;"CAREACU (MG)";"MG";"CAREACU";108;8;6;122
2010;"CARLOS CHAGAS (MG)";"MG";"CARLOS CHAGAS";130;30;45;205
2010;"CARMESIA (MG)";"MG";"CARMESIA";61;3;1230;1294
2010;"CARMO DA CACHOEIRA (MG)";"MG";"CARMO DA CACHOEIRA";138;29;51;218
2010;"CARMO DA MATA (MG)";"MG";"CARMO DA MATA";119;23;38;180
2010;"CARMO DE MINAS (MG)";"MG";"CARMO DE MINAS";124;29;16;169
2010;"CARMO DO CAJURU (MG)";"MG";"CARMO DO CAJURU";328;38;71;437
2010;"CARMO DO PARANAIBA (MG)";"MG";"CARMO DO PARANAIBA";520;47;90;657
2010;"CARMO DO RIO CLARO (MG)";"MG";"CARMO DO RIO CLARO";304;19;68;391
2010;"CARMOPOLIS DE MINAS (MG)";"MG";"CARMOPOLIS DE MINAS";474;32;38;544
2010;"CARNEIRINHO (MG)";"MG";"CARNEIRINHO";173;13;54;240
2010;"CARRANCAS (MG)";"MG";"CARRANCAS";42;9;11;62
2010;"CARVALHOPOLIS (MG)";"MG";"CARVALHOPOLIS";32;9;5;46
2010;"CARVALHOS (MG)";"MG";"CARVALHOS";56;4;7;67
2010;"CASA GRANDE (MG)";"MG";"CASA GRANDE";24;6;2;32
2010;"CASCALHO RICO (MG)";"MG";"CASCALHO RICO";44;20;2;66
2010;"CASSIA (MG)";"MG";"CASSIA";359;33;37;429
2010;"CATAGUASES (MG)";"MG";"CATAGUASES";596;72;155;823
2010;"CATAS ALTAS (MG)";"MG";"CATAS ALTAS";110;11;5;126
2010;"CATAS ALTAS DA NORUEGA (MG)";"MG";"CATAS ALTAS DA NORUEGA";38;4;5;47
2010;"CATUJI (MG)";"MG";"CATUJI";32;13;11;56
2010;"CATUTI (MG)";"MG";"CATUTI";17;7;13;37
2010;"CAXAMBU (MG)";"MG";"CAXAMBU";196;36;20;252
2010;"CEDRO DO ABAETE (MG)";"MG";"CEDRO DO ABAETE";10;1;1;12
2010;"CENTRAL DE MINAS (MG)";"MG";"CENTRAL DE MINAS";76;7;10;93
2010;"CENTRALINA (MG)";"MG";"CENTRALINA";94;5;13;112
2010;"CHACARA (MG)";"MG";"CHACARA";32;6;6;44
2010;"CHALE (MG)";"MG";"CHALE";49;12;10;71
2010;"CHAPADA DO NORTE (MG)";"MG";"CHAPADA DO NORTE";39;12;18;69
2010;"CHAPADA GAUCHA (MG)";"MG";"CHAPADA GAUCHA";68;9;14;91
2010;"CHIADOR (MG)";"MG";"CHIADOR";51;8;7;66
2010;"CIPOTANEA (MG)";"MG";"CIPOTANEA";34;3;11;48
2010;"CLARAVAL (MG)";"MG";"CLARAVAL";129;4;26;159
2010;"CLARO DOS POCOES (MG)";"MG";"CLARO DOS POCOES";29;4;20;53
2010;"CLAUDIO (MG)";"MG";"CLAUDIO";679;31;51;761
2010;"COIMBRA (MG)";"MG";"COIMBRA";92;4;9;105
2010;"COLUNA (MG)";"MG";"COLUNA";38;1;13;52
2010;"COMENDADOR GOMES (MG)";"MG";"COMENDADOR GOMES";35;6;5;46
2010;"COMERCINHO (MG)";"MG";"COMERCINHO";26;7;10;43
2010;"CONCEICAO DA APARECIDA (MG)";"MG";"CONCEICAO DA APARECIDA";128;9;14;151
2010;"CONCEICAO DA BARRA DE MINAS (MG)";"MG";"CONCEICAO DA BARRA DE MINAS";28;7;8;43
2010;"CONCEICAO DAS ALAGOAS (MG)";"MG";"CONCEICAO DAS ALAGOAS";421;21;97;539
2010;"CONCEICAO DAS PEDRAS (MG)";"MG";"CONCEICAO DAS PEDRAS";18;8;4;30
2010;"CONCEICAO DE IPANEMA (MG)";"MG";"CONCEICAO DE IPANEMA";30;8;2;40
2010;"CONCEICAO DO MATO DENTRO (MG)";"MG";"CONCEICAO DO MATO DENTRO";100;20;128;248
2010;"CONCEICAO DO PARA (MG)";"MG";"CONCEICAO DO PARA";59;11;15;85
2010;"CONCEICAO DO RIO VERDE (MG)";"MG";"CONCEICAO DO RIO VERDE";187;38;25;250
2010;"CONCEICAO DOS OUROS (MG)";"MG";"CONCEICAO DOS OUROS";285;34;12;331
2010;"CONEGO MARINHO (MG)";"MG";"CONEGO MARINHO";14;3;12;29
2010;"CONFINS (MG)";"MG";"CONFINS";101;12;13;126
2010;"CONGONHAL (MG)";"MG";"CONGONHAL";230;9;13;252
2010;"CONGONHAS (MG)";"MG";"CONGONHAS";727;136;116;979
2010;"CONGONHAS DO NORTE (MG)";"MG";"CONGONHAS DO NORTE";29;4;6;39
2010;"CONQUISTA (MG)";"MG";"CONQUISTA";151;20;30;201
2010;"CONSELHEIRO LAFAIETE (MG)";"MG";"CONSELHEIRO LAFAIETE";1215;241;504;1960
2010;"CONSELHEIRO PENA (MG)";"MG";"CONSELHEIRO PENA";182;1;47;230
2010;"CONSOLACAO (MG)";"MG";"CONSOLACAO";11;7;1;19
2010;"CONTAGEM (MG)";"MG";"CONTAGEM";11831;1270;2421;15522
2010;"COQUEIRAL (MG)";"MG";"COQUEIRAL";85;13;15;113
2010;"CORACAO DE JESUS (MG)";"MG";"CORACAO DE JESUS";135;6;78;219
2010;"CORDISBURGO (MG)";"MG";"CORDISBURGO";76;8;8;92
2010;"CORDISLANDIA (MG)";"MG";"CORDISLANDIA";39;8;2;49
2010;"CORINTO (MG)";"MG";"CORINTO";278;21;53;352
2010;"COROACI (MG)";"MG";"COROACI";47;7;9;63
2010;"COROMANDEL (MG)";"MG";"COROMANDEL";493;50;80;623
2010;"CORONEL FABRICIANO (MG)";"MG";"CORONEL FABRICIANO";1063;143;521;1727
2010;"CORONEL MURTA (MG)";"MG";"CORONEL MURTA";17;3;9;29
2010;"CORONEL PACHECO (MG)";"MG";"CORONEL PACHECO";47;6;8;61
2010;"CORONEL XAVIER CHAVES (MG)";"MG";"CORONEL XAVIER CHAVES";77;5;2;84
2010;"CORREGO DANTA (MG)";"MG";"CORREGO DANTA";31;5;8;44
2010;"CORREGO DO BOM JESUS (MG)";"MG";"CORREGO DO BOM JESUS";36;8;7;51
2010;"CORREGO FUNDO (MG)";"MG";"CORREGO FUNDO";322;14;16;352
2010;"CORREGO NOVO (MG)";"MG";"CORREGO NOVO";13;6;6;25
2010;"COUTO DE MAGALHAES DE MINAS (MG)";"MG";"COUTO DE MAGALHAES DE MINAS";36;1;8;45
2010;"CRISOLITA (MG)";"MG";"CRISOLITA";10;13;10;33
2010;"CRISTAIS (MG)";"MG";"CRISTAIS";140;11;16;167
2010;"CRISTALIA (MG)";"MG";"CRISTALIA";19;4;14;37
2010;"CRISTIANO OTONI (MG)";"MG";"CRISTIANO OTONI";66;12;8;86
2010;"CRISTINA (MG)";"MG";"CRISTINA";110;23;10;143
2010;"CRUCILANDIA (MG)";"MG";"CRUCILANDIA";133;6;12;151
2010;"CRUZEIRO DA FORTALEZA (MG)";"MG";"CRUZEIRO DA FORTALEZA";51;4;13;68
2010;"CRUZILIA (MG)";"MG";"CRUZILIA";287;23;26;336
2010;"CUPARAQUE (MG)";"MG";"CUPARAQUE";36;6;2;44
2010;"CURRAL DE DENTRO (MG)";"MG";"CURRAL DE DENTRO";40;7;8;55
2010;"CURVELO (MG)";"MG";"CURVELO";989;39;1727;2755
2010;"DATAS (MG)";"MG";"DATAS";23;3;10;36
2010;"DELFIM MOREIRA (MG)";"MG";"DELFIM MOREIRA";74;5;19;98
2010;"DELFINOPOLIS (MG)";"MG";"DELFINOPOLIS";76;13;9;98
2010;"DELTA (MG)";"MG";"DELTA";391;26;119;536
2010;"DESCOBERTO (MG)";"MG";"DESCOBERTO";28;5;1;34
2010;"DESTERRO DE ENTRE RIOS (MG)";"MG";"DESTERRO DE ENTRE RIOS";82;12;17;111
2010;"DESTERRO DO MELO (MG)";"MG";"DESTERRO DO MELO";26;7;11;44
2010;"DIAMANTINA (MG)";"MG";"DIAMANTINA";291;56;318;665
2010;"DIOGO DE VASCONCELOS (MG)";"MG";"DIOGO DE VASCONCELOS";14;4;6;24
2010;"DIONISIO (MG)";"MG";"DIONISIO";34;5;14;53
2010;"DIVINESIA (MG)";"MG";"DIVINESIA";57;6;5;68
2010;"DIVINO (MG)";"MG";"DIVINO";213;14;38;265
2010;"DIVINO DAS LARANJEIRAS (MG)";"MG";"DIVINO DAS LARANJEIRAS";31;1;4;36
2010;"DIVINOLANDIA DE MINAS (MG)";"MG";"DIVINOLANDIA DE MINAS";57;3;17;77
2010;"DIVINOPOLIS (MG)";"MG";"DIVINOPOLIS";2926;207;697;3830
2010;"DIVISA ALEGRE (MG)";"MG";"DIVISA ALEGRE";40;2;5;47
2010;"DIVISA NOVA (MG)";"MG";"DIVISA NOVA";64;20;20;104
2010;"DIVISOPOLIS (MG)";"MG";"DIVISOPOLIS";15;7;7;29
2010;"DOM BOSCO (MG)";"MG";"DOM BOSCO";22;2;8;32
2010;"DOM CAVATI (MG)";"MG";"DOM CAVATI";168;7;10;185
2010;"DOM JOAQUIM (MG)";"MG";"DOM JOAQUIM";14;4;5;23
2010;"DOM SILVERIO (MG)";"MG";"DOM SILVERIO";46;9;6;61
2010;"DOM VICOSO (MG)";"MG";"DOM VICOSO";27;11;7;45
2010;"DONA EUZEBIA (MG)";"MG";"DONA EUZEBIA";262;5;2;269
2010;"DORES DE CAMPOS (MG)";"MG";"DORES DE CAMPOS";70;10;33;113
2010;"DORES DE GUANHAES (MG)";"MG";"DORES DE GUANHAES";26;3;17;46
2010;"DORES DO INDAIA (MG)";"MG";"DORES DO INDAIA";214;27;20;261
2010;"DORES DO TURVO (MG)";"MG";"DORES DO TURVO";32;4;12;48
2010;"DORESOPOLIS (MG)";"MG";"DORESOPOLIS";14;8;1;23
2010;"DOURADOQUARA (MG)";"MG";"DOURADOQUARA";26;8;1;35
2010;"DURANDE (MG)";"MG";"DURANDE";85;4;11;100
2010;"ELOI MENDES (MG)";"MG";"ELOI MENDES";466;56;38;560
2010;"ENGENHEIRO CALDAS (MG)";"MG";"ENGENHEIRO CALDAS";119;8;8;135
2010;"ENGENHEIRO NAVARRO (MG)";"MG";"ENGENHEIRO NAVARRO";51;1;19;71
2010;"ENTRE FOLHAS (MG)";"MG";"ENTRE FOLHAS";54;2;8;64
2010;"ENTRE RIOS DE MINAS (MG)";"MG";"ENTRE RIOS DE MINAS";258;20;74;352
2010;"ERVALIA (MG)";"MG";"ERVALIA";268;11;35;314
2010;"ESMERALDAS (MG)";"MG";"ESMERALDAS";382;35;260;677
2010;"ESPERA FELIZ (MG)";"MG";"ESPERA FELIZ";281;26;37;344
2010;"ESPINOSA (MG)";"MG";"ESPINOSA";251;9;51;311
2010;"ESPIRITO SANTO DO DOURADO (MG)";"MG";"ESPIRITO SANTO DO DOURADO";68;3;5;76
2010;"ESTIVA (MG)";"MG";"ESTIVA";265;19;18;302
2010;"ESTRELA DALVA (MG)";"MG";"ESTRELA DALVA";26;4;1;31
2010;"ESTRELA DO INDAIA (MG)";"MG";"ESTRELA DO INDAIA";41;6;2;49
2010;"ESTRELA DO SUL (MG)";"MG";"ESTRELA DO SUL";86;15;16;117
2010;"EUGENOPOLIS (MG)";"MG";"EUGENOPOLIS";78;19;23;120
2010;"EWBANK DA CAMARA (MG)";"MG";"EWBANK DA CAMARA";38;4;3;45
2010;"EXTREMA (MG)";"MG";"EXTREMA";504;65;54;623
2010;"FAMA (MG)";"MG";"FAMA";13;7;1;21
2010;"FARIA LEMOS (MG)";"MG";"FARIA LEMOS";22;7;1;30
2010;"FELICIO DOS SANTOS (MG)";"MG";"FELICIO DOS SANTOS";22;7;15;44
2010;"FELISBURGO (MG)";"MG";"FELISBURGO";16;3;7;26
2010;"FELIXLANDIA (MG)";"MG";"FELIXLANDIA";181;15;40;236
2010;"FERNANDES TOURINHO (MG)";"MG";"FERNANDES TOURINHO";17;10;8;35
2010;"FERROS (MG)";"MG";"FERROS";87;7;42;136
2010;"FERVEDOURO (MG)";"MG";"FERVEDOURO";93;14;6;113
2010;"FLORESTAL (MG)";"MG";"FLORESTAL";55;10;15;80
2010;"FORMIGA (MG)";"MG";"FORMIGA";1471;131;197;1799
2010;"FORMOSO (MG)";"MG";"FORMOSO";27;2;21;50
2010;"FORTALEZA DE MINAS (MG)";"MG";"FORTALEZA DE MINAS";47;20;9;76
2010;"FORTUNA DE MINAS (MG)";"MG";"FORTUNA DE MINAS";26;4;6;36
2010;"FRANCISCO BADARO (MG)";"MG";"FRANCISCO BADARO";39;2;16;57
2010;"FRANCISCO DUMONT (MG)";"MG";"FRANCISCO DUMONT";50;4;25;79
2010;"FRANCISCO SA (MG)";"MG";"FRANCISCO SA";111;6;76;193
2010;"FRANCISCOPOLIS (MG)";"MG";"FRANCISCOPOLIS";14;7;10;31
2010;"FREI GASPAR (MG)";"MG";"FREI GASPAR";23;9;6;38
2010;"FREI INOCENCIO (MG)";"MG";"FREI INOCENCIO";83;8;22;113
2010;"FREI LAGONEGRO (MG)";"MG";"FREI LAGONEGRO";3;3;7;13
2010;"FRONTEIRA (MG)";"MG";"FRONTEIRA";208;36;61;305
2010;"FRONTEIRA DOS VALES (MG)";"MG";"FRONTEIRA DOS VALES";7;5;1;13
2010;"FRUTA DE LEITE (MG)";"MG";"FRUTA DE LEITE";17;2;18;37
2010;"FRUTAL (MG)";"MG";"FRUTAL";1332;114;174;1620
2010;"FUNILANDIA (MG)";"MG";"FUNILANDIA";32;4;11;47
2010;"GALILEIA (MG)";"MG";"GALILEIA";60;1;8;69
2010;"GAMELEIRAS (MG)";"MG";"GAMELEIRAS";25;3;11;39
2010;"GLAUCILANDIA (MG)";"MG";"GLAUCILANDIA";0;2;3;5
2010;"GOIABEIRA (MG)";"MG";"GOIABEIRA";23;6;4;33
2010;"GOIANA (MG)";"MG";"GOIANA";18;4;5;27
2010;"GONCALVES (MG)";"MG";"GONCALVES";110;16;4;130
2010;"GONZAGA (MG)";"MG";"GONZAGA";32;4;10;46
2010;"GOUVEA (MG)";"MG";"GOUVEA";129;10;27;166
2010;"GOVERNADOR VALADARES (MG)";"MG";"GOVERNADOR VALADARES";3100;224;338;3662
2010;"GRAO MOGOL (MG)";"MG";"GRAO MOGOL";48;7;61;116
2010;"GRUPIARA (MG)";"MG";"GRUPIARA";7;3;3;13
2010;"GUANHAES (MG)";"MG";"GUANHAES";425;33;81;539
2010;"GUAPE (MG)";"MG";"GUAPE";177;19;44;240
2010;"GUARACIABA (MG)";"MG";"GUARACIABA";59;13;28;100
2010;"GUARACIAMA (MG)";"MG";"GUARACIAMA";30;3;14;47
2010;"GUARANESIA (MG)";"MG";"GUARANESIA";305;38;81;424
2010;"GUARANI (MG)";"MG";"GUARANI";84;13;9;106
2010;"GUARARA (MG)";"MG";"GUARARA";49;9;2;60
2010;"GUARDA MOR (MG)";"MG";"GUARDA MOR";74;12;13;99
2010;"GUAXUPE (MG)";"MG";"GUAXUPE";799;73;151;1023
2010;"GUIDOVAL (MG)";"MG";"GUIDOVAL";121;2;4;127
2010;"GUIMARANIA (MG)";"MG";"GUIMARANIA";123;5;23;151
2010;"GUIRICEMA (MG)";"MG";"GUIRICEMA";219;11;17;247
2010;"GURINHATA (MG)";"MG";"GURINHATA";81;12;19;112
2010;"HELIODORA (MG)";"MG";"HELIODORA";71;7;10;88
2010;"IAPU (MG)";"MG";"IAPU";112;14;18;144
2010;"IBERTIOGA (MG)";"MG";"IBERTIOGA";30;10;3;43
2010;"IBIA (MG)";"MG";"IBIA";348;33;84;465
2010;"IBIAI (MG)";"MG";"IBIAI";41;4;6;51
2010;"IBIRACATU (MG)";"MG";"IBIRACATU";9;8;12;29
2010;"IBIRACI (MG)";"MG";"IBIRACI";321;25;29;375
2010;"IBIRITE (MG)";"MG";"IBIRITE";1101;168;267;1536
2010;"IBITIURA DE MINAS (MG)";"MG";"IBITIURA DE MINAS";89;6;3;98
2010;"IBITURUNA (MG)";"MG";"IBITURUNA";27;6;3;36
2010;"ICARAI DE MINAS (MG)";"MG";"ICARAI DE MINAS";20;4;5;29
2010;"IGARAPE (MG)";"MG";"IGARAPE";591;47;141;779
2010;"IGARATINGA (MG)";"MG";"IGARATINGA";422;9;13;444
2010;"IGUATAMA (MG)";"MG";"IGUATAMA";119;9;15;143
2010;"IJACI (MG)";"MG";"IJACI";124;10;11;145
2010;"ILICINEA (MG)";"MG";"ILICINEA";166;10;37;213
2010;"IMBE DE MINAS (MG)";"MG";"IMBE DE MINAS";40;3;10;53
2010;"INCONFIDENTES (MG)";"MG";"INCONFIDENTES";65;17;19;101
2010;"INDAIABIRA (MG)";"MG";"INDAIABIRA";38;5;23;66
2010;"INDIANOPOLIS (MG)";"MG";"INDIANOPOLIS";67;28;19;114
2010;"INGAI (MG)";"MG";"INGAI";16;13;7;36
2010;"INHAPIM (MG)";"MG";"INHAPIM";348;13;59;420
2010;"INHAUMA (MG)";"MG";"INHAUMA";88;5;14;107
2010;"INIMUTABA (MG)";"MG";"INIMUTABA";31;4;4;39
2010;"IPABA (MG)";"MG";"IPABA";80;14;16;110
2010;"IPANEMA (MG)";"MG";"IPANEMA";186;27;28;241
2010;"IPATINGA (MG)";"MG";"IPATINGA";2861;446;556;3863
2010;"IPIACU (MG)";"MG";"IPIACU";48;2;11;61
2010;"IPUIUNA (MG)";"MG";"IPUIUNA";360;29;20;409
2010;"IRAI DE MINAS (MG)";"MG";"IRAI DE MINAS";181;15;30;226
2010;"ITABIRA (MG)";"MG";"ITABIRA";1326;214;367;1907
2010;"ITABIRINHA (MG)";"MG";"ITABIRINHA";114;5;28;147
2010;"ITABIRITO (MG)";"MG";"ITABIRITO";839;161;273;1273
2010;"ITACAMBIRA (MG)";"MG";"ITACAMBIRA";9;0;6;15
2010;"ITACARAMBI (MG)";"MG";"ITACARAMBI";90;7;28;125
2010;"ITAGUARA (MG)";"MG";"ITAGUARA";370;20;39;429
2010;"ITAIPE (MG)";"MG";"ITAIPE";54;4;23;81
2010;"ITAJUBA (MG)";"MG";"ITAJUBA";782;88;114;984
2010;"ITAMARANDIBA (MG)";"MG";"ITAMARANDIBA";522;31;92;645
2010;"ITAMARATI DE MINAS (MG)";"MG";"ITAMARATI DE MINAS";87;8;13;108
2010;"ITAMBACURI (MG)";"MG";"ITAMBACURI";173;16;34;223
2010;"ITAMBE DO MATO DENTRO (MG)";"MG";"ITAMBE DO MATO DENTRO";17;7;4;28
2010;"ITAMOGI (MG)";"MG";"ITAMOGI";204;20;21;245
2010;"ITAMONTE (MG)";"MG";"ITAMONTE";300;23;25;348
2010;"ITANHANDU (MG)";"MG";"ITANHANDU";317;24;19;360
2010;"ITANHOMI (MG)";"MG";"ITANHOMI";95;15;18;128
2010;"ITAOBIM (MG)";"MG";"ITAOBIM";196;22;33;251
2010;"ITAPAGIPE (MG)";"MG";"ITAPAGIPE";172;17;26;215
2010;"ITAPECERICA (MG)";"MG";"ITAPECERICA";312;35;65;412
2010;"ITAPEVA (MG)";"MG";"ITAPEVA";219;21;6;246
2010;"ITATIAIUCU (MG)";"MG";"ITATIAIUCU";304;7;35;346
2010;"ITAU DE MINAS (MG)";"MG";"ITAU DE MINAS";233;35;34;302
2010;"ITAUNA (MG)";"MG";"ITAUNA";1373;206;242;1821
2010;"ITAVERAVA (MG)";"MG";"ITAVERAVA";44;4;9;57
2010;"ITINGA (MG)";"MG";"ITINGA";50;12;22;84
2010;"ITUETA (MG)";"MG";"ITUETA";45;7;16;68
2010;"ITUIUTABA (MG)";"MG";"ITUIUTABA";1081;170;274;1525
2010;"ITUMIRIM (MG)";"MG";"ITUMIRIM";53;17;4;74
2010;"ITURAMA (MG)";"MG";"ITURAMA";696;71;293;1060
2010;"ITUTINGA (MG)";"MG";"ITUTINGA";52;19;1;72
2010;"JABOTICATUBAS (MG)";"MG";"JABOTICATUBAS";200;8;53;261
2010;"JACINTO (MG)";"MG";"JACINTO";19;4;15;38
2010;"JACUI (MG)";"MG";"JACUI";108;12;22;142
2010;"JACUTINGA (MG)";"MG";"JACUTINGA";325;53;54;432
2010;"JAGUARACU (MG)";"MG";"JAGUARACU";46;2;3;51
2010;"JAIBA (MG)";"MG";"JAIBA";285;11;75;371
2010;"JAMPRUCA (MG)";"MG";"JAMPRUCA";13;5;15;33
2010;"JANAUBA (MG)";"MG";"JANAUBA";714;18;115;847
2010;"JANUARIA (MG)";"MG";"JANUARIA";312;15;77;404
2010;"JAPARAIBA (MG)";"MG";"JAPARAIBA";65;3;19;87
2010;"JAPONVAR (MG)";"MG";"JAPONVAR";8;4;11;23
2010;"JECEABA (MG)";"MG";"JECEABA";82;30;10;122
2010;"JENIPAPO DE MINAS (MG)";"MG";"JENIPAPO DE MINAS";25;12;10;47
2010;"JEQUERI (MG)";"MG";"JEQUERI";80;7;23;110
2010;"JEQUITAI (MG)";"MG";"JEQUITAI";54;3;16;73
2010;"JEQUITIBA (MG)";"MG";"JEQUITIBA";58;5;23;86
2010;"JEQUITINHONHA (MG)";"MG";"JEQUITINHONHA";77;25;22;124
2010;"JESUANIA (MG)";"MG";"JESUANIA";61;17;10;88
2010;"JOAIMA (MG)";"MG";"JOAIMA";54;7;24;85
2010;"JOANESIA (MG)";"MG";"JOANESIA";14;3;11;28
2010;"JOAO MONLEVADE (MG)";"MG";"JOAO MONLEVADE";1038;93;216;1347
2010;"JOAO PINHEIRO (MG)";"MG";"JOAO PINHEIRO";829;30;194;1053
2010;"JOAQUIM FELICIO (MG)";"MG";"JOAQUIM FELICIO";29;1;10;40
2010;"JORDANIA (MG)";"MG";"JORDANIA";19;9;17;45
2010;"JOSE GONCALVES DE MINAS (MG)";"MG";"JOSE GONCALVES DE MINAS";25;9;10;44
2010;"JOSE RAYDAN (MG)";"MG";"JOSE RAYDAN";18;2;12;32
2010;"JOSENOPOLIS (MG)";"MG";"JOSENOPOLIS";19;4;7;30
2010;"JUATUBA (MG)";"MG";"JUATUBA";302;39;167;508
2010;"JUIZ DE FORA (MG)";"MG";"JUIZ DE FORA";4968;617;1437;7022
2010;"JURAMENTO (MG)";"MG";"JURAMENTO";14;2;12;28
2010;"JURUAIA (MG)";"MG";"JURUAIA";71;16;17;104
2010;"JUVENILIA (MG)";"MG";"JUVENILIA";10;6;5;21
2010;"LADAINHA (MG)";"MG";"LADAINHA";45;12;23;80
2010;"LAGAMAR (MG)";"MG";"LAGAMAR";78;19;22;119
2010;"LAGOA DA PRATA (MG)";"MG";"LAGOA DA PRATA";795;55;138;988
2010;"LAGOA DOS PATOS (MG)";"MG";"LAGOA DOS PATOS";28;2;7;37
2010;"LAGOA DOURADA (MG)";"MG";"LAGOA DOURADA";347;11;47;405
2010;"LAGOA FORMOSA (MG)";"MG";"LAGOA FORMOSA";262;18;76;356
2010;"LAGOA GRANDE (MG)";"MG";"LAGOA GRANDE";95;6;46;147
2010;"LAGOA SANTA (MG)";"MG";"LAGOA SANTA";637;93;112;842
2010;"LAJINHA (MG)";"MG";"LAJINHA";214;22;40;276
2010;"LAMBARI (MG)";"MG";"LAMBARI";255;37;21;313
2010;"LAMIM (MG)";"MG";"LAMIM";41;4;5;50
2010;"LARANJAL (MG)";"MG";"LARANJAL";147;10;1;158
2010;"LASSANCE (MG)";"MG";"LASSANCE";34;5;4;43
2010;"LAVRAS (MG)";"MG";"LAVRAS";1110;156;229;1495
2010;"LEANDRO FERREIRA (MG)";"MG";"LEANDRO FERREIRA";30;9;3;42
2010;"LEME DO PRADO (MG)";"MG";"LEME DO PRADO";22;6;18;46
2010;"LEOPOLDINA (MG)";"MG";"LEOPOLDINA";630;52;80;762
2010;"LIBERDADE (MG)";"MG";"LIBERDADE";68;10;7;85
2010;"LIMA DUARTE (MG)";"MG";"LIMA DUARTE";158;29;36;223
2010;"LIMEIRA DO OESTE (MG)";"MG";"LIMEIRA DO OESTE";135;17;47;199
2010;"LONTRA (MG)";"MG";"LONTRA";10;3;7;20
2010;"LUISBURGO (MG)";"MG";"LUISBURGO";22;6;20;48
2010;"LUISLANDIA (MG)";"MG";"LUISLANDIA";8;4;6;18
2010;"LUMINARIAS (MG)";"MG";"LUMINARIAS";86;6;36;128
2010;"LUZ (MG)";"MG";"LUZ";291;53;29;373
2010;"MACHACALIS (MG)";"MG";"MACHACALIS";26;1;6;33
2010;"MACHADO (MG)";"MG";"MACHADO";643;90;100;833
2010;"MADRE DE DEUS DE MINAS (MG)";"MG";"MADRE DE DEUS DE MINAS";72;5;4;81
2010;"MALACACHETA (MG)";"MG";"MALACACHETA";93;10;37;140
2010;"MAMONAS (MG)";"MG";"MAMONAS";100;5;21;126
2010;"MANGA (MG)";"MG";"MANGA";108;8;43;159
2010;"MANHUACU (MG)";"MG";"MANHUACU";1305;85;143;1533
2010;"MANHUMIRIM (MG)";"MG";"MANHUMIRIM";257;26;38;321
2010;"MANTENA (MG)";"MG";"MANTENA";529;36;91;656
2010;"MAR DE ESPANHA (MG)";"MG";"MAR DE ESPANHA";131;20;11;162
2010;"MARAVILHAS (MG)";"MG";"MARAVILHAS";149;18;7;174
2010;"MARIA DA FE (MG)";"MG";"MARIA DA FE";237;10;29;276
2010;"MARIANA (MG)";"MG";"MARIANA";541;152;252;945
2010;"MARILAC (MG)";"MG";"MARILAC";17;5;8;30
2010;"MARIO CAMPOS (MG)";"MG";"MARIO CAMPOS";175;18;12;205
2010;"MARIPA DE MINAS (MG)";"MG";"MARIPA DE MINAS";38;5;3;46
2010;"MARLIERIA (MG)";"MG";"MARLIERIA";36;4;10;50
2010;"MARMELOPOLIS (MG)";"MG";"MARMELOPOLIS";39;8;5;52
2010;"MARTINHO CAMPOS (MG)";"MG";"MARTINHO CAMPOS";326;32;63;421
2010;"MARTINS SOARES (MG)";"MG";"MARTINS SOARES";67;4;13;84
2010;"MATA VERDE (MG)";"MG";"MATA VERDE";12;13;3;28
2010;"MATERLANDIA (MG)";"MG";"MATERLANDIA";9;4;4;17
2010;"MATEUS LEME (MG)";"MG";"MATEUS LEME";565;66;85;716
2010;"MATHIAS LOBATO (MG)";"MG";"MATHIAS LOBATO";31;2;4;37
2010;"MATIAS BARBOSA (MG)";"MG";"MATIAS BARBOSA";512;31;40;583
2010;"MATIAS CARDOSO (MG)";"MG";"MATIAS CARDOSO";17;5;13;35
2010;"MATIPO (MG)";"MG";"MATIPO";244;22;39;305
2010;"MATO VERDE (MG)";"MG";"MATO VERDE";125;7;24;156
2010;"MATOZINHOS (MG)";"MG";"MATOZINHOS";317;69;138;524
2010;"MATUTINA (MG)";"MG";"MATUTINA";64;8;5;77
2010;"MEDEIROS (MG)";"MG";"MEDEIROS";42;16;2;60
2010;"MEDINA (MG)";"MG";"MEDINA";125;35;35;195
2010;"MENDES PIMENTEL (MG)";"MG";"MENDES PIMENTEL";40;6;11;57
2010;"MERCES (MG)";"MG";"MERCES";152;11;10;173
2010;"MESQUITA (MG)";"MG";"MESQUITA";21;9;5;35
2010;"MINAS NOVAS (MG)";"MG";"MINAS NOVAS";107;21;77;205
2010;"MINDURI (MG)";"MG";"MINDURI";61;9;3;73
2010;"MIRABELA (MG)";"MG";"MIRABELA";81;8;26;115
2010;"MIRADOURO (MG)";"MG";"MIRADOURO";99;10;27;136
2010;"MIRAI (MG)";"MG";"MIRAI";131;10;19;160
2010;"MIRAVANIA (MG)";"MG";"MIRAVANIA";8;3;6;17
2010;"MOEDA (MG)";"MG";"MOEDA";105;2;14;121
2010;"MOEMA (MG)";"MG";"MOEMA";148;11;115;274
2010;"MONJOLOS (MG)";"MG";"MONJOLOS";6;2;6;14
2010;"MONSENHOR PAULO (MG)";"MG";"MONSENHOR PAULO";146;15;9;170
2010;"MONTALVANIA (MG)";"MG";"MONTALVANIA";103;6;39;148
2010;"MONTE ALEGRE DE MINAS (MG)";"MG";"MONTE ALEGRE DE MINAS";456;35;38;529
2010;"MONTE AZUL (MG)";"MG";"MONTE AZUL";162;12;50;224
2010;"MONTE BELO (MG)";"MG";"MONTE BELO";228;25;44;297
2010;"MONTE CARMELO (MG)";"MG";"MONTE CARMELO";1231;79;129;1439
2010;"MONTE FORMOSO (MG)";"MG";"MONTE FORMOSO";12;6;23;41
2010;"MONTE SANTO DE MINAS (MG)";"MG";"MONTE SANTO DE MINAS";392;31;86;509
2010;"MONTE SIAO (MG)";"MG";"MONTE SIAO";219;34;32;285
2010;"MONTES CLAROS (MG)";"MG";"MONTES CLAROS";3951;231;951;5133
2010;"MONTEZUMA (MG)";"MG";"MONTEZUMA";23;8;13;44
2010;"MORADA NOVA DE MINAS (MG)";"MG";"MORADA NOVA DE MINAS";94;19;19;132
2010;"MORRO DA GARCA (MG)";"MG";"MORRO DA GARCA";39;5;16;60
2010;"MORRO DO PILAR (MG)";"MG";"MORRO DO PILAR";18;7;0;25
2010;"MUNHOZ (MG)";"MG";"MUNHOZ";121;15;12;148
2010;"MURIAE (MG)";"MG";"MURIAE";1284;88;167;1539
2010;"MUTUM (MG)";"MG";"MUTUM";158;20;55;233
2010;"MUZAMBINHO (MG)";"MG";"MUZAMBINHO";361;64;44;469
2010;"NACIP RAYDAN (MG)";"MG";"NACIP RAYDAN";9;0;4;13
2010;"NANUQUE (MG)";"MG";"NANUQUE";572;54;173;799
2010;"NAQUE (MG)";"MG";"NAQUE";34;3;17;54
2010;"NATALANDIA (MG)";"MG";"NATALANDIA";19;3;14;36
2010;"NATERCIA (MG)";"MG";"NATERCIA";70;12;16;98
2010;"NAZARENO (MG)";"MG";"NAZARENO";162;14;26;202
2010;"NEPOMUCENO (MG)";"MG";"NEPOMUCENO";382;21;63;466
2010;"NINHEIRA (MG)";"MG";"NINHEIRA";25;3;18;46
2010;"NOVA BELEM (MG)";"MG";"NOVA BELEM";36;3;9;48
2010;"NOVA ERA (MG)";"MG";"NOVA ERA";170;18;62;250
2010;"NOVA LIMA (MG)";"MG";"NOVA LIMA";1024;261;162;1447
2010;"NOVA MODICA (MG)";"MG";"NOVA MODICA";17;2;14;33
2010;"NOVA PONTE (MG)";"MG";"NOVA PONTE";206;51;62;319
2010;"NOVA PORTEIRINHA (MG)";"MG";"NOVA PORTEIRINHA";18;3;11;32
2010;"NOVA RESENDE (MG)";"MG";"NOVA RESENDE";298;23;46;367
2010;"NOVA SERRANA (MG)";"MG";"NOVA SERRANA";417;40;72;529
2010;"NOVA UNIAO (MG)";"MG";"NOVA UNIAO";123;10;17;150
2010;"NOVO CRUZEIRO (MG)";"MG";"NOVO CRUZEIRO";138;24;77;239
2010;"NOVO ORIENTE DE MINAS (MG)";"MG";"NOVO ORIENTE DE MINAS";29;15;13;57
2010;"NOVORIZONTE (MG)";"MG";"NOVORIZONTE";47;2;11;60
2010;"OLARIA (MG)";"MG";"OLARIA";11;6;4;21
2010;"OLHOS D AGUA (MG)";"MG";"OLHOS D AGUA";50;11;30;91
2010;"OLIMPIO NORONHA (MG)";"MG";"OLIMPIO NORONHA";21;10;6;37
2010;"OLIVEIRA (MG)";"MG";"OLIVEIRA";733;60;110;903
2010;"OLIVEIRA FORTES (MG)";"MG";"OLIVEIRA FORTES";20;5;2;27
2010;"ONCA DE PITANGUI (MG)";"MG";"ONCA DE PITANGUI";25;6;8;39
2010;"ORATORIOS (MG)";"MG";"ORATORIOS";66;4;16;86
2010;"ORIZANIA (MG)";"MG";"ORIZANIA";52;5;9;66
2010;"OURO BRANCO (MG)";"MG";"OURO BRANCO";459;105;192;756
2010;"OURO FINO (MG)";"MG";"OURO FINO";475;54;81;610
2010;"OURO PRETO (MG)";"MG";"OURO PRETO";901;192;256;1349
2010;"OURO VERDE DE MINAS (MG)";"MG";"OURO VERDE DE MINAS";19;5;4;28
2010;"PADRE CARVALHO (MG)";"MG";"PADRE CARVALHO";18;6;17;41
2010;"PADRE PARAISO (MG)";"MG";"PADRE PARAISO";118;62;49;229
2010;"PAI PEDRO (MG)";"MG";"PAI PEDRO";14;5;16;35
2010;"PAINEIRAS (MG)";"MG";"PAINEIRAS";79;13;8;100
2010;"PAINS (MG)";"MG";"PAINS";211;16;20;247
2010;"PAIVA (MG)";"MG";"PAIVA";8;3;1;12
2010;"PALMA (MG)";"MG";"PALMA";75;8;5;88
2010;"PALMOPOLIS (MG)";"MG";"PALMOPOLIS";15;5;7;27
2010;"PAPAGAIOS (MG)";"MG";"PAPAGAIOS";517;10;51;578
2010;"PARA DE MINAS (MG)";"MG";"PARA DE MINAS";1980;140;194;2314
2010;"PARACATU (MG)";"MG";"PARACATU";1286;83;316;1685
2010;"PARAGUACU (MG)";"MG";"PARAGUACU";280;43;30;353
2010;"PARAISOPOLIS (MG)";"MG";"PARAISOPOLIS";372;40;27;439
2010;"PARAOPEBA (MG)";"MG";"PARAOPEBA";403;22;45;470
2010;"PASSA QUATRO (MG)";"MG";"PASSA QUATRO";324;22;29;375
2010;"PASSA TEMPO (MG)";"MG";"PASSA TEMPO";162;25;15;202
2010;"PASSA VINTE (MG)";"MG";"PASSA VINTE";56;17;6;79
2010;"PASSABEM (MG)";"MG";"PASSABEM";12;4;2;18
2010;"PASSOS (MG)";"MG";"PASSOS";1828;124;391;2343
2010;"PATIS (MG)";"MG";"PATIS";9;3;7;19
2010;"PATOS DE MINAS (MG)";"MG";"PATOS DE MINAS";2788;127;379;3294
2010;"PATROCINIO (MG)";"MG";"PATROCINIO";1485;117;557;2159
2010;"PATROCINIO DO MURIAE (MG)";"MG";"PATROCINIO DO MURIAE";75;9;7;91
2010;"PAULA CANDIDO (MG)";"MG";"PAULA CANDIDO";63;9;12;84
2010;"PAULISTAS (MG)";"MG";"PAULISTAS";13;2;7;22
2010;"PAVAO (MG)";"MG";"PAVAO";45;18;9;72
2010;"PECANHA (MG)";"MG";"PECANHA";112;8;52;172
2010;"PEDRA AZUL (MG)";"MG";"PEDRA AZUL";131;17;49;197
2010;"PEDRA BONITA (MG)";"MG";"PEDRA BONITA";37;11;14;62
2010;"PEDRA DO ANTA (MG)";"MG";"PEDRA DO ANTA";30;3;12;45
2010;"PEDRA DO INDAIA (MG)";"MG";"PEDRA DO INDAIA";57;7;2;66
2010;"PEDRA DOURADA (MG)";"MG";"PEDRA DOURADA";13;4;9;26
2010;"PEDRALVA (MG)";"MG";"PEDRALVA";129;19;20;168
2010;"PEDRAS DE MARIA DA CRUZ (MG)";"MG";"PEDRAS DE MARIA DA CRUZ";19;4;27;50
2010;"PEDRINOPOLIS (MG)";"MG";"PEDRINOPOLIS";58;16;6;80
2010;"PEDRO LEOPOLDO (MG)";"MG";"PEDRO LEOPOLDO";977;140;216;1333
2010;"PEDRO TEIXEIRA (MG)";"MG";"PEDRO TEIXEIRA";17;6;1;24
2010;"PEQUERI (MG)";"MG";"PEQUERI";71;9;3;83
2010;"PEQUI (MG)";"MG";"PEQUI";47;13;4;64
2010;"PERDIGAO (MG)";"MG";"PERDIGAO";145;11;8;164
2010;"PERDIZES (MG)";"MG";"PERDIZES";254;52;31;337
2010;"PERDOES (MG)";"MG";"PERDOES";482;29;59;570
2010;"PERIQUITO (MG)";"MG";"PERIQUITO";33;5;19;57
2010;"PESCADOR (MG)";"MG";"PESCADOR";17;8;4;29
2010;"PIAU (MG)";"MG";"PIAU";40;9;7;56
2010;"PIEDADE DE CARATINGA (MG)";"MG";"PIEDADE DE CARATINGA";115;11;9;135
2010;"PIEDADE DE PONTE NOVA (MG)";"MG";"PIEDADE DE PONTE NOVA";35;4;14;53
2010;"PIEDADE DO RIO GRANDE (MG)";"MG";"PIEDADE DO RIO GRANDE";43;6;5;54
2010;"PIEDADE DOS GERAIS (MG)";"MG";"PIEDADE DOS GERAIS";67;3;12;82
2010;"PIMENTA (MG)";"MG";"PIMENTA";189;7;26;222
2010;"PINGO D AGUA (MG)";"MG";"PINGO D AGUA";18;3;5;26
2010;"PINTOPOLIS (MG)";"MG";"PINTOPOLIS";11;2;1;14
2010;"PIRACEMA (MG)";"MG";"PIRACEMA";95;12;13;120
2010;"PIRAJUBA (MG)";"MG";"PIRAJUBA";124;22;8;154
2010;"PIRANGA (MG)";"MG";"PIRANGA";126;19;43;188
2010;"PIRANGUCU (MG)";"MG";"PIRANGUCU";31;25;30;86
2010;"PIRANGUINHO (MG)";"MG";"PIRANGUINHO";132;14;8;154
2010;"PIRAPETINGA (MG)";"MG";"PIRAPETINGA";338;18;28;384
2010;"PIRAPORA (MG)";"MG";"PIRAPORA";497;30;131;658
2010;"PIRAUBA (MG)";"MG";"PIRAUBA";119;22;12;153
2010;"PITANGUI (MG)";"MG";"PITANGUI";523;48;73;644
2010;"PIUMHI (MG)";"MG";"PIUMHI";653;56;71;780
2010;"PLANURA (MG)";"MG";"PLANURA";142;13;45;200
2010;"POCO FUNDO (MG)";"MG";"POCO FUNDO";227;44;16;287
2010;"POCOS DE CALDAS (MG)";"MG";"POCOS DE CALDAS";2631;496;403;3530
2010;"POCRANE (MG)";"MG";"POCRANE";67;10;6;83
2010;"POMPEU (MG)";"MG";"POMPEU";412;31;110;553
2010;"PONTE NOVA (MG)";"MG";"PONTE NOVA";911;53;143;1107
2010;"PONTO CHIQUE (MG)";"MG";"PONTO CHIQUE";10;1;10;21
2010;"PONTO DOS VOLANTES (MG)";"MG";"PONTO DOS VOLANTES";31;3;27;61
2010;"PORTEIRINHA (MG)";"MG";"PORTEIRINHA";284;20;152;456
2010;"PORTO FIRME (MG)";"MG";"PORTO FIRME";60;9;11;80
2010;"POTE (MG)";"MG";"POTE";61;12;24;97
2010;"POUSO ALEGRE (MG)";"MG";"POUSO ALEGRE";2229;227;496;2952
2010;"POUSO ALTO (MG)";"MG";"POUSO ALTO";110;12;6;128
2010;"PRADOS (MG)";"MG";"PRADOS";92;9;8;109
2010;"PRATA (MG)";"MG";"PRATA";397;94;78;569
2010;"PRATAPOLIS (MG)";"MG";"PRATAPOLIS";163;25;18;206
2010;"PRATINHA (MG)";"MG";"PRATINHA";44;8;3;55
2010;"PRESIDENTE BERNARDES (MG)";"MG";"PRESIDENTE BERNARDES";20;8;8;36
2010;"PRESIDENTE JUSCELINO (MG)";"MG";"PRESIDENTE JUSCELINO";43;3;13;59
2010;"PRESIDENTE KUBITSCHEK (MG)";"MG";"PRESIDENTE KUBITSCHEK";18;11;7;36
2010;"PRESIDENTE OLEGARIO (MG)";"MG";"PRESIDENTE OLEGARIO";196;17;79;292
2010;"PRUDENTE DE MORAIS (MG)";"MG";"PRUDENTE DE MORAIS";83;10;9;102
2010;"QUARTEL GERAL (MG)";"MG";"QUARTEL GERAL";39;7;2;48
2010;"QUELUZITA (MG)";"MG";"QUELUZITA";17;7;3;27
2010;"RAPOSOS (MG)";"MG";"RAPOSOS";64;35;24;123
2010;"RAUL SOARES (MG)";"MG";"RAUL SOARES";194;27;44;265
2010;"RECREIO (MG)";"MG";"RECREIO";148;20;22;190
2010;"REDUTO (MG)";"MG";"REDUTO";40;5;6;51
2010;"RESENDE COSTA (MG)";"MG";"RESENDE COSTA";160;12;17;189
2010;"RESPLENDOR (MG)";"MG";"RESPLENDOR";194;30;34;258
2010;"RESSAQUINHA (MG)";"MG";"RESSAQUINHA";129;5;12;146
2010;"RIACHINHO (MG)";"MG";"RIACHINHO";83;5;20;108
2010;"RIACHO DOS MACHADOS (MG)";"MG";"RIACHO DOS MACHADOS";44;3;33;80
2010;"RIBEIRAO DAS NEVES (MG)";"MG";"RIBEIRAO DAS NEVES";2228;342;677;3247
2010;"RIBEIRAO VERMELHO (MG)";"MG";"RIBEIRAO VERMELHO";36;9;4;49
2010;"RIO ACIMA (MG)";"MG";"RIO ACIMA";108;14;14;136
2010;"RIO CASCA (MG)";"MG";"RIO CASCA";200;11;42;253
2010;"RIO DO PRADO (MG)";"MG";"RIO DO PRADO";11;9;6;26
2010;"RIO DOCE (MG)";"MG";"RIO DOCE";17;6;8;31
2010;"RIO ESPERA (MG)";"MG";"RIO ESPERA";29;0;6;35
2010;"RIO MANSO (MG)";"MG";"RIO MANSO";115;3;11;129
2010;"RIO NOVO (MG)";"MG";"RIO NOVO";107;16;20;143
2010;"RIO PARANAIBA (MG)";"MG";"RIO PARANAIBA";167;8;52;227
2010;"RIO PARDO DE MINAS (MG)";"MG";"RIO PARDO DE MINAS";173;13;101;287
2010;"RIO PIRACICABA (MG)";"MG";"RIO PIRACICABA";178;21;28;227
2010;"RIO POMBA (MG)";"MG";"RIO POMBA";217;23;27;267
2010;"RIO PRETO (MG)";"MG";"RIO PRETO";1059;116;111;1286
2010;"RIO VERMELHO (MG)";"MG";"RIO VERMELHO";59;19;39;117
2010;"RITAPOLIS (MG)";"MG";"RITAPOLIS";28;9;6;43
2010;"ROCHEDO DE MINAS (MG)";"MG";"ROCHEDO DE MINAS";19;4;2;25
2010;"RODEIRO (MG)";"MG";"RODEIRO";216;7;16;239
2010;"ROMARIA (MG)";"MG";"ROMARIA";45;18;8;71
2010;"ROSARIO DA LIMEIRA (MG)";"MG";"ROSARIO DA LIMEIRA";62;10;32;104
2010;"RUBELITA (MG)";"MG";"RUBELITA";14;5;8;27
2010;"RUBIM (MG)";"MG";"RUBIM";23;1;28;52
2010;"SABARA (MG)";"MG";"SABARA";580;176;301;1057
2010;"SABINOPOLIS (MG)";"MG";"SABINOPOLIS";116;21;35;172
2010;"SACRAMENTO (MG)";"MG";"SACRAMENTO";434;73;56;563
2010;"SALINAS (MG)";"MG";"SALINAS";352;41;117;510
2010;"SALTO DA DIVISA (MG)";"MG";"SALTO DA DIVISA";4;4;6;14
2010;"SANTA BARBARA (MG)";"MG";"SANTA BARBARA";363;51;99;513
2010;"SANTA BARBARA DO LESTE (MG)";"MG";"SANTA BARBARA DO LESTE";156;7;5;168
2010;"SANTA BARBARA DO MONTE VERDE (MG)";"MG";"SANTA BARBARA DO MONTE VERDE";1390;101;198;1689
2010;"SANTA BARBARA DO TUGURIO (MG)";"MG";"SANTA BARBARA DO TUGURIO";60;14;23;97
2010;"SANTA CRUZ DE MINAS (MG)";"MG";"SANTA CRUZ DE MINAS";61;6;3;70
2010;"SANTA CRUZ DE SALINAS (MG)";"MG";"SANTA CRUZ DE SALINAS";11;2;16;29
2010;"SANTA CRUZ DO ESCALVADO (MG)";"MG";"SANTA CRUZ DO ESCALVADO";30;5;9;44
2010;"SANTA EFIGENIA DE MINAS (MG)";"MG";"SANTA EFIGENIA DE MINAS";25;6;3;34
2010;"SANTA FE DE MINAS (MG)";"MG";"SANTA FE DE MINAS";7;2;1;10
2010;"SANTA HELENA DE MINAS (MG)";"MG";"SANTA HELENA DE MINAS";13;5;5;23
2010;"SANTA JULIANA (MG)";"MG";"SANTA JULIANA";278;40;43;361
2010;"SANTA LUZIA (MG)";"MG";"SANTA LUZIA";1576;182;612;2370
2010;"SANTA MARGARIDA (MG)";"MG";"SANTA MARGARIDA";191;22;23;236
2010;"SANTA MARIA DE ITABIRA (MG)";"MG";"SANTA MARIA DE ITABIRA";92;13;32;137
2010;"SANTA MARIA DO SALTO (MG)";"MG";"SANTA MARIA DO SALTO";5;4;6;15
2010;"SANTA MARIA DO SUACUI (MG)";"MG";"SANTA MARIA DO SUACUI";73;4;32;109
2010;"SANTA RITA DE CALDAS (MG)";"MG";"SANTA RITA DE CALDAS";258;21;13;292
2010;"SANTA RITA DE IBITIPOCA (MG)";"MG";"SANTA RITA DE IBITIPOCA";37;5;1;43
2010;"SANTA RITA DE JACUTINGA (MG)";"MG";"SANTA RITA DE JACUTINGA";80;8;7;95
2010;"SANTA RITA DE MINAS (MG)";"MG";"SANTA RITA DE MINAS";100;11;9;120
2010;"SANTA RITA DO ITUETO (MG)";"MG";"SANTA RITA DO ITUETO";65;7;16;88
2010;"SANTA RITA DO SAPUCAI (MG)";"MG";"SANTA RITA DO SAPUCAI";362;56;64;482
2010;"SANTA ROSA DA SERRA (MG)";"MG";"SANTA ROSA DA SERRA";40;6;8;54
2010;"SANTA VITORIA (MG)";"MG";"SANTA VITORIA";321;20;54;395
2010;"SANTANA DA VARGEM (MG)";"MG";"SANTANA DA VARGEM";71;12;19;102
2010;"SANTANA DE CATAGUASES (MG)";"MG";"SANTANA DE CATAGUASES";28;11;6;45
2010;"SANTANA DE PIRAPAMA (MG)";"MG";"SANTANA DE PIRAPAMA";64;2;25;91
2010;"SANTANA DO DESERTO (MG)";"MG";"SANTANA DO DESERTO";49;6;7;62
2010;"SANTANA DO GARAMBEU (MG)";"MG";"SANTANA DO GARAMBEU";12;4;4;20
2010;"SANTANA DO JACARE (MG)";"MG";"SANTANA DO JACARE";34;6;10;50
2010;"SANTANA DO MANHUACU (MG)";"MG";"SANTANA DO MANHUACU";138;5;15;158
2010;"SANTANA DO PARAISO (MG)";"MG";"SANTANA DO PARAISO";124;11;30;165
2010;"SANTANA DO RIACHO (MG)";"MG";"SANTANA DO RIACHO";21;7;9;37
2010;"SANTANA DOS MONTES (MG)";"MG";"SANTANA DOS MONTES";28;7;5;40
2010;"SANTO ANTONIO DO AMPARO (MG)";"MG";"SANTO ANTONIO DO AMPARO";213;33;61;307
2010;"SANTO ANTONIO DO AVENTUREIRO (MG)";"MG";"SANTO ANTONIO DO AVENTUREIRO";50;4;9;63
2010;"SANTO ANTONIO DO GRAMA (MG)";"MG";"SANTO ANTONIO DO GRAMA";42;2;9;53
2010;"SANTO ANTONIO DO ITAMBE (MG)";"MG";"SANTO ANTONIO DO ITAMBE";12;5;7;24
2010;"SANTO ANTONIO DO JACINTO (MG)";"MG";"SANTO ANTONIO DO JACINTO";30;3;27;60
2010;"SANTO ANTONIO DO MONTE (MG)";"MG";"SANTO ANTONIO DO MONTE";443;44;88;575
2010;"SANTO ANTONIO DO RETIRO (MG)";"MG";"SANTO ANTONIO DO RETIRO";26;3;20;49
2010;"SANTO ANTONIO DO RIO ABAIXO (MG)";"MG";"SANTO ANTONIO DO RIO ABAIXO";7;7;3;17
2010;"SANTO HIPOLITO (MG)";"MG";"SANTO HIPOLITO";21;3;3;27
2010;"SANTOS DUMONT (MG)";"MG";"SANTOS DUMONT";369;66;111;546
2010;"SAO BENTO ABADE (MG)";"MG";"SAO BENTO ABADE";37;12;11;60
2010;"SAO BRAS DO SUACUI (MG)";"MG";"SAO BRAS DO SUACUI";38;2;6;46
2010;"SAO DOMINGOS DAS DORES (MG)";"MG";"SAO DOMINGOS DAS DORES";82;3;4;89
2010;"SAO DOMINGOS DO PRATA (MG)";"MG";"SAO DOMINGOS DO PRATA";204;9;49;262
2010;"SAO FELIX DE MINAS (MG)";"MG";"SAO FELIX DE MINAS";12;3;7;22
2010;"SAO FRANCISCO (MG)";"MG";"SAO FRANCISCO";235;11;80;326
2010;"SAO FRANCISCO DE PAULA (MG)";"MG";"SAO FRANCISCO DE PAULA";68;13;20;101
2010;"SAO FRANCISCO DE SALES (MG)";"MG";"SAO FRANCISCO DE SALES";62;5;20;87
2010;"SAO FRANCISCO DO GLORIA (MG)";"MG";"SAO FRANCISCO DO GLORIA";51;10;3;64
2010;"SAO GERALDO (MG)";"MG";"SAO GERALDO";132;13;7;152
2010;"SAO GERALDO DA PIEDADE (MG)";"MG";"SAO GERALDO DA PIEDADE";12;3;6;21
2010;"SAO GERALDO DO BAIXIO (MG)";"MG";"SAO GERALDO DO BAIXIO";18;7;5;30
2010;"SAO GONCALO DO ABAETE (MG)";"MG";"SAO GONCALO DO ABAETE";71;11;13;95
2010;"SAO GONCALO DO PARA (MG)";"MG";"SAO GONCALO DO PARA";164;9;12;185
2010;"SAO GONCALO DO RIO ABAIXO (MG)";"MG";"SAO GONCALO DO RIO ABAIXO";152;26;23;201
2010;"SAO GONCALO DO RIO PRETO (MG)";"MG";"SAO GONCALO DO RIO PRETO";25;8;5;38
2010;"SAO GONCALO DO SAPUCAI (MG)";"MG";"SAO GONCALO DO SAPUCAI";396;41;65;502
2010;"SAO GOTARDO (MG)";"MG";"SAO GOTARDO";737;81;190;1008
2010;"SAO JOAO BATISTA DO GLORIA (MG)";"MG";"SAO JOAO BATISTA DO GLORIA";110;9;13;132
2010;"SAO JOAO DA LAGOA (MG)";"MG";"SAO JOAO DA LAGOA";26;7;11;44
2010;"SAO JOAO DA MATA (MG)";"MG";"SAO JOAO DA MATA";39;10;0;49
2010;"SAO JOAO DA PONTE (MG)";"MG";"SAO JOAO DA PONTE";50;8;43;101
2010;"SAO JOAO DAS MISSOES (MG)";"MG";"SAO JOAO DAS MISSOES";17;3;12;32
2010;"SAO JOAO DEL REI (MG)";"MG";"SAO JOAO DEL REI";1028;133;198;1359
2010;"SAO JOAO DO MANHUACU (MG)";"MG";"SAO JOAO DO MANHUACU";116;11;17;144
2010;"SAO JOAO DO MANTENINHA (MG)";"MG";"SAO JOAO DO MANTENINHA";77;11;4;92
2010;"SAO JOAO DO ORIENTE (MG)";"MG";"SAO JOAO DO ORIENTE";91;6;4;101
2010;"SAO JOAO DO PACUI (MG)";"MG";"SAO JOAO DO PACUI";7;0;2;9
2010;"SAO JOAO DO PARAISO (MG)";"MG";"SAO JOAO DO PARAISO";141;13;70;224
2010;"SAO JOAO EVANGELISTA (MG)";"MG";"SAO JOAO EVANGELISTA";99;6;36;141
2010;"SAO JOAO NEPOMUCENO (MG)";"MG";"SAO JOAO NEPOMUCENO";242;25;24;291
2010;"SAO JOAQUIM DE BICAS (MG)";"MG";"SAO JOAQUIM DE BICAS";728;92;68;888
2010;"SAO JOSE DA BARRA (MG)";"MG";"SAO JOSE DA BARRA";85;11;23;119
2010;"SAO JOSE DA LAPA (MG)";"MG";"SAO JOSE DA LAPA";244;37;24;305
2010;"SAO JOSE DA SAFIRA (MG)";"MG";"SAO JOSE DA SAFIRA";6;1;1;8
2010;"SAO JOSE DA VARGINHA (MG)";"MG";"SAO JOSE DA VARGINHA";45;5;17;67
2010;"SAO JOSE DO ALEGRE (MG)";"MG";"SAO JOSE DO ALEGRE";41;7;4;52
2010;"SAO JOSE DO DIVINO (MG)";"MG";"SAO JOSE DO DIVINO";14;3;6;23
2010;"SAO JOSE DO GOIABAL (MG)";"MG";"SAO JOSE DO GOIABAL";47;13;35;95
2010;"SAO JOSE DO JACURI (MG)";"MG";"SAO JOSE DO JACURI";14;3;7;24
2010;"SAO JOSE DO MANTIMENTO (MG)";"MG";"SAO JOSE DO MANTIMENTO";27;2;4;33
2010;"SAO LOURENCO (MG)";"MG";"SAO LOURENCO";476;65;44;585
2010;"SAO MIGUEL DO ANTA (MG)";"MG";"SAO MIGUEL DO ANTA";82;6;7;95
2010;"SAO PEDRO DA UNIAO (MG)";"MG";"SAO PEDRO DA UNIAO";94;15;8;117
2010;"SAO PEDRO DO SUACUI (MG)";"MG";"SAO PEDRO DO SUACUI";22;3;7;32
2010;"SAO PEDRO DOS FERROS (MG)";"MG";"SAO PEDRO DOS FERROS";120;8;28;156
2010;"SAO ROMAO (MG)";"MG";"SAO ROMAO";19;2;12;33
2010;"SAO ROQUE DE MINAS (MG)";"MG";"SAO ROQUE DE MINAS";122;16;8;146
2010;"SAO SEBASTIAO DA BELA VISTA (MG)";"MG";"SAO SEBASTIAO DA BELA VISTA";50;6;12;68
2010;"SAO SEBASTIAO DA VARGEM ALEGRE (MG)";"MG";"SAO SEBASTIAO DA VARGEM ALEGRE";11;3;7;21
2010;"SAO SEBASTIAO DO ANTA (MG)";"MG";"SAO SEBASTIAO DO ANTA";43;2;5;50
2010;"SAO SEBASTIAO DO MARANHAO (MG)";"MG";"SAO SEBASTIAO DO MARANHAO";24;5;11;40
2010;"SAO SEBASTIAO DO OESTE (MG)";"MG";"SAO SEBASTIAO DO OESTE";117;6;14;137
2010;"SAO SEBASTIAO DO PARAISO (MG)";"MG";"SAO SEBASTIAO DO PARAISO";1377;102;184;1663
2010;"SAO SEBASTIAO DO RIO PRETO (MG)";"MG";"SAO SEBASTIAO DO RIO PRETO";7;2;4;13
2010;"SAO SEBASTIAO DO RIO VERDE (MG)";"MG";"SAO SEBASTIAO DO RIO VERDE";11;2;5;18
2010;"SAO TIAGO (MG)";"MG";"SAO TIAGO";127;10;16;153
2010;"SAO TOMAS DE AQUINO (MG)";"MG";"SAO TOMAS DE AQUINO";74;22;11;107
2010;"SAO TOME DAS LETRAS (MG)";"MG";"SAO TOME DAS LETRAS";89;8;15;112
2010;"SAO VICENTE DE MINAS (MG)";"MG";"SAO VICENTE DE MINAS";83;14;2;99
2010;"SAPUCAI MIRIM (MG)";"MG";"SAPUCAI MIRIM";180;35;11;226
2010;"SARDOA (MG)";"MG";"SARDOA";35;7;8;50
2010;"SARZEDO (MG)";"MG";"SARZEDO";402;30;39;471
2010;"SEM PEIXE (MG)";"MG";"SEM PEIXE";10;4;8;22
2010;"SENADOR AMARAL (MG)";"MG";"SENADOR AMARAL";83;13;9;105
2010;"SENADOR CORTES (MG)";"MG";"SENADOR CORTES";15;2;1;18
2010;"SENADOR FIRMINO (MG)";"MG";"SENADOR FIRMINO";83;10;18;111
2010;"SENADOR JOSE BENTO (MG)";"MG";"SENADOR JOSE BENTO";14;1;7;22
2010;"SENADOR MODESTINO GONCALVES (MG)";"MG";"SENADOR MODESTINO GONCALVES";25;5;5;35
2010;"SENHORA DE OLIVEIRA (MG)";"MG";"SENHORA DE OLIVEIRA";63;4;12;79
2010;"SENHORA DO PORTO (MG)";"MG";"SENHORA DO PORTO";25;3;10;38
2010;"SENHORA DOS REMEDIOS (MG)";"MG";"SENHORA DOS REMEDIOS";86;22;12;120
2010;"SERICITA (MG)";"MG";"SERICITA";77;2;4;83
2010;"SERITINGA (MG)";"MG";"SERITINGA";23;1;2;26
2010;"SERRA AZUL DE MINAS (MG)";"MG";"SERRA AZUL DE MINAS";12;3;8;23
2010;"SERRA DA SAUDADE (MG)";"MG";"SERRA DA SAUDADE";5;7;0;12
2010;"SERRA DO SALITRE (MG)";"MG";"SERRA DO SALITRE";210;13;67;290
2010;"SERRA DOS AIMORES (MG)";"MG";"SERRA DOS AIMORES";55;5;21;81
2010;"SERRANIA (MG)";"MG";"SERRANIA";117;15;12;144
2010;"SERRANOPOLIS DE MINAS (MG)";"MG";"SERRANOPOLIS DE MINAS";5;0;11;16
2010;"SERRANOS (MG)";"MG";"SERRANOS";17;6;2;25
2010;"SERRO (MG)";"MG";"SERRO";150;21;45;216
2010;"SETE LAGOAS (MG)";"MG";"SETE LAGOAS";2968;380;504;3852
2010;"SETUBINHA (MG)";"MG";"SETUBINHA";18;2;18;38
2010;"SILVEIRANIA (MG)";"MG";"SILVEIRANIA";11;4;4;19
2010;"SILVIANOPOLIS (MG)";"MG";"SILVIANOPOLIS";73;11;10;94
2010;"SIMAO PEREIRA (MG)";"MG";"SIMAO PEREIRA";49;6;3;58
2010;"SIMONESIA (MG)";"MG";"SIMONESIA";166;15;30;211
2010;"SOBRALIA (MG)";"MG";"SOBRALIA";31;5;6;42
2010;"SOLEDADE DE MINAS (MG)";"MG";"SOLEDADE DE MINAS";40;7;0;47
2010;"TABULEIRO (MG)";"MG";"TABULEIRO";62;6;8;76
2010;"TAIOBEIRAS (MG)";"MG";"TAIOBEIRAS";595;22;130;747
2010;"TAPARUBA (MG)";"MG";"TAPARUBA";25;2;10;37
2010;"TAPIRA (MG)";"MG";"TAPIRA";38;7;15;60
2010;"TAPIRAI (MG)";"MG";"TAPIRAI";12;3;2;17
2010;"TAQUARACU DE MINAS (MG)";"MG";"TAQUARACU DE MINAS";60;5;11;76
2010;"TARUMIRIM (MG)";"MG";"TARUMIRIM";109;12;21;142
2010;"TEIXEIRAS (MG)";"MG";"TEIXEIRAS";131;10;15;156
2010;"TEOFILO OTONI (MG)";"MG";"TEOFILO OTONI";1427;153;135;1715
2010;"TIMOTEO (MG)";"MG";"TIMOTEO";1019;174;129;1322
2010;"TIRADENTES (MG)";"MG";"TIRADENTES";75;15;12;102
2010;"TIROS (MG)";"MG";"TIROS";139;17;8;164
2010;"TOCANTINS (MG)";"MG";"TOCANTINS";218;7;16;241
2010;"TOCOS DO MOJI (MG)";"MG";"TOCOS DO MOJI";48;10;9;67
2010;"TOLEDO (MG)";"MG";"TOLEDO";63;4;7;74
2010;"TOMBOS (MG)";"MG";"TOMBOS";93;16;20;129
2010;"TRES CORACOES (MG)";"MG";"TRES CORACOES";896;77;154;1127
2010;"TRES MARIAS (MG)";"MG";"TRES MARIAS";335;33;82;450
2010;"TRES PONTAS (MG)";"MG";"TRES PONTAS";763;75;157;995
2010;"TUMIRITINGA (MG)";"MG";"TUMIRITINGA";31;6;6;43
2010;"TUPACIGUARA (MG)";"MG";"TUPACIGUARA";432;65;60;557
2010;"TURMALINA (MG)";"MG";"TURMALINA";286;28;45;359
2010;"TURVOLANDIA (MG)";"MG";"TURVOLANDIA";83;21;5;109
2010;"UBA (MG)";"MG";"UBA";1802;74;113;1989
2010;"UBAI (MG)";"MG";"UBAI";30;4;14;48
2010;"UBAPORANGA (MG)";"MG";"UBAPORANGA";129;6;17;152
2010;"UBERABA (MG)";"MG";"UBERABA";4103;805;895;5803
2010;"UBERLANDIA (MG)";"MG";"UBERLANDIA";10561;923;1378;12862
2010;"UMBURATIBA (MG)";"MG";"UMBURATIBA";9;3;1;13
2010;"UNAI (MG)";"MG";"UNAI";1261;62;292;1615
2010;"UNIAO DE MINAS (MG)";"MG";"UNIAO DE MINAS";36;6;29;71
2010;"URUANA DE MINAS (MG)";"MG";"URUANA DE MINAS";17;4;9;30
2010;"URUCANIA (MG)";"MG";"URUCANIA";138;7;35;180
2010;"URUCUIA (MG)";"MG";"URUCUIA";57;3;20;80
2010;"VARGEM ALEGRE (MG)";"MG";"VARGEM ALEGRE";54;6;11;71
2010;"VARGEM BONITA (MG)";"MG";"VARGEM BONITA";25;7;3;35
2010;"VARGEM GRANDE DO RIO PARDO (MG)";"MG";"VARGEM GRANDE DO RIO PARDO";32;5;7;44
2010;"VARGINHA (MG)";"MG";"VARGINHA";1812;144;273;2229
2010;"VARJAO DE MINAS (MG)";"MG";"VARJAO DE MINAS";84;10;37;131
2010;"VARZEA DA PALMA (MG)";"MG";"VARZEA DA PALMA";406;15;76;497
2010;"VARZELANDIA (MG)";"MG";"VARZELANDIA";45;7;29;81
2010;"VAZANTE (MG)";"MG";"VAZANTE";283;29;77;389
2010;"VERDELANDIA (MG)";"MG";"VERDELANDIA";13;2;8;23
2010;"VEREDINHA (MG)";"MG";"VEREDINHA";38;6;17;61
2010;"VERISSIMO (MG)";"MG";"VERISSIMO";40;22;2;64
2010;"VERMELHO NOVO (MG)";"MG";"VERMELHO NOVO";73;7;18;98
2010;"VESPASIANO (MG)";"MG";"VESPASIANO";674;128;127;929
2010;"VICOSA (MG)";"MG";"VICOSA";596;133;147;876
2010;"VIEIRAS (MG)";"MG";"VIEIRAS";31;7;5;43
2010;"VIRGEM DA LAPA (MG)";"MG";"VIRGEM DA LAPA";52;7;20;79
2010;"VIRGINIA (MG)";"MG";"VIRGINIA";124;12;4;140
2010;"VIRGINOPOLIS (MG)";"MG";"VIRGINOPOLIS";88;5;19;112
2010;"VIRGOLANDIA (MG)";"MG";"VIRGOLANDIA";18;5;6;29
2010;"VISCONDE DO RIO BRANCO (MG)";"MG";"VISCONDE DO RIO BRANCO";865;39;67;971
2010;"VOLTA GRANDE (MG)";"MG";"VOLTA GRANDE";38;6;5;49
2010;"WENCESLAU BRAZ (MG)";"MG";"WENCESLAU BRAZ";44;5;5;54
2010;"AGUA CLARA (MS)";"MS";"AGUA CLARA";392;11;70;473
2010;"ALCINOPOLIS (MS)";"MS";"ALCINOPOLIS";81;14;14;109
2010;"AMAMBAI (MS)";"MS";"AMAMBAI";629;15;48;692
2010;"ANASTACIO (MS)";"MS";"ANASTACIO";341;12;21;374
2010;"ANAURILANDIA (MS)";"MS";"ANAURILANDIA";110;11;43;164
2010;"ANGELICA (MS)";"MS";"ANGELICA";228;13;42;283
2010;"ANTONIO JOAO (MS)";"MS";"ANTONIO JOAO";105;1;20;126
2010;"APARECIDA DO TABOADO (MS)";"MS";"APARECIDA DO TABOADO";354;30;44;428
2010;"AQUIDAUANA (MS)";"MS";"AQUIDAUANA";328;18;53;399
2010;"ARAL MOREIRA (MS)";"MS";"ARAL MOREIRA";164;12;16;192
2010;"BANDEIRANTES (MS)";"MS";"BANDEIRANTES";136;6;25;167
2010;"BATAGUASSU (MS)";"MS";"BATAGUASSU";471;22;149;642
2010;"BATAYPORA (MS)";"MS";"BATAYPORA";144;6;27;177
2010;"BELA VISTA (MS)";"MS";"BELA VISTA";207;23;41;271
2010;"BODOQUENA (MS)";"MS";"BODOQUENA";81;14;36;131
2010;"BONITO (MS)";"MS";"BONITO";240;56;50;346
2010;"BRASILANDIA (MS)";"MS";"BRASILANDIA";239;23;63;325
2010;"CAARAPO (MS)";"MS";"CAARAPO";473;9;110;592
2010;"CAMAPUA (MS)";"MS";"CAMAPUA";301;29;26;356
2010;"CAMPO GRANDE (MS)";"MS";"CAMPO GRANDE";12056;745;1706;14507
2010;"CARACOL (MS)";"MS";"CARACOL";42;13;9;64
2010;"CASSILANDIA (MS)";"MS";"CASSILANDIA";424;12;29;465
2010;"CHAPADAO DO SUL (MS)";"MS";"CHAPADAO DO SUL";675;15;85;775
2010;"CORGUINHO (MS)";"MS";"CORGUINHO";49;6;21;76
2010;"CORONEL SAPUCAIA (MS)";"MS";"CORONEL SAPUCAIA";266;6;24;296
2010;"CORUMBA (MS)";"MS";"CORUMBA";763;57;179;999
2010;"COSTA RICA (MS)";"MS";"COSTA RICA";440;11;77;528
2010;"COXIM (MS)";"MS";"COXIM";534;12;60;606
2010;"DEODAPOLIS (MS)";"MS";"DEODAPOLIS";209;14;77;300
2010;"DOIS IRMAOS DO BURITI (MS)";"MS";"DOIS IRMAOS DO BURITI";115;17;26;158
2010;"DOURADINA (MS)";"MS";"DOURADINA";206;4;16;226
2010;"DOURADOS (MS)";"MS";"DOURADOS";3612;197;295;4104
2010;"ELDORADO (MS)";"MS";"ELDORADO";245;8;29;282
2010;"FATIMA DO SUL (MS)";"MS";"FATIMA DO SUL";390;7;27;424
2010;"FIGUEIRAO (MS)";"MS";"FIGUEIRAO";30;16;3;49
2010;"GLORIA DE DOURADOS (MS)";"MS";"GLORIA DE DOURADOS";173;5;32;210
2010;"GUIA LOPES DA LAGUNA (MS)";"MS";"GUIA LOPES DA LAGUNA";145;14;27;186
2010;"IGUATEMI (MS)";"MS";"IGUATEMI";213;7;51;271
2010;"INOCENCIA (MS)";"MS";"INOCENCIA";144;2;25;171
2010;"ITAPORA (MS)";"MS";"ITAPORA";348;19;41;408
2010;"ITAQUIRAI (MS)";"MS";"ITAQUIRAI";185;10;73;268
2010;"IVINHEMA (MS)";"MS";"IVINHEMA";483;14;191;688
2010;"JAPORA (MS)";"MS";"JAPORA";13;5;13;31
2010;"JARAGUARI (MS)";"MS";"JARAGUARI";68;4;16;88
2010;"JARDIM (MS)";"MS";"JARDIM";397;20;36;453
2010;"JATEI (MS)";"MS";"JATEI";40;6;41;87
2010;"JUTI (MS)";"MS";"JUTI";57;3;16;76
2010;"LADARIO (MS)";"MS";"LADARIO";141;18;58;217
2010;"LAGUNA CARAPA (MS)";"MS";"LAGUNA CARAPA";153;1;15;169
2010;"MARACAJU (MS)";"MS";"MARACAJU";841;16;124;981
2010;"MIRANDA (MS)";"MS";"MIRANDA";282;22;61;365
2010;"MUNDO NOVO (MS)";"MS";"MUNDO NOVO";268;23;25;316
2010;"NAVIRAI (MS)";"MS";"NAVIRAI";783;29;148;960
2010;"NIOAQUE (MS)";"MS";"NIOAQUE";123;19;53;195
2010;"NOVA ALVORADA DO SUL (MS)";"MS";"NOVA ALVORADA DO SUL";312;19;77;408
2010;"NOVA ANDRADINA (MS)";"MS";"NOVA ANDRADINA";869;18;203;1090
2010;"NOVO HORIZONTE DO SUL (MS)";"MS";"NOVO HORIZONTE DO SUL";61;5;14;80
2010;"PARANAIBA (MS)";"MS";"PARANAIBA";761;18;87;866
2010;"PARANHOS (MS)";"MS";"PARANHOS";96;5;21;122
2010;"PEDRO GOMES (MS)";"MS";"PEDRO GOMES";78;6;9;93
2010;"PONTA PORA (MS)";"MS";"PONTA PORA";1552;50;215;1817
2010;"PORTO MURTINHO (MS)";"MS";"PORTO MURTINHO";59;6;20;85
2010;"RIBAS DO RIO PARDO (MS)";"MS";"RIBAS DO RIO PARDO";527;22;54;603
2010;"RIO BRILHANTE (MS)";"MS";"RIO BRILHANTE";621;38;119;778
2010;"RIO NEGRO (MS)";"MS";"RIO NEGRO";49;7;9;65
2010;"RIO VERDE DE MATO GROSSO (MS)";"MS";"RIO VERDE DE MATO GROSSO";297;14;18;329
2010;"ROCHEDO (MS)";"MS";"ROCHEDO";45;2;10;57
2010;"SANTA RITA DO PARDO (MS)";"MS";"SANTA RITA DO PARDO";118;10;31;159
2010;"SAO GABRIEL DO OESTE (MS)";"MS";"SAO GABRIEL DO OESTE";769;19;40;828
2010;"SELVIRIA (MS)";"MS";"SELVIRIA";93;8;20;121
2010;"SETE QUEDAS (MS)";"MS";"SETE QUEDAS";200;6;21;227
2010;"SIDROLANDIA (MS)";"MS";"SIDROLANDIA";599;64;225;888
2010;"SONORA (MS)";"MS";"SONORA";181;16;86;283
2010;"TACURU (MS)";"MS";"TACURU";99;6;14;119
2010;"TAQUARUSSU (MS)";"MS";"TAQUARUSSU";34;5;10;49
2010;"TERENOS (MS)";"MS";"TERENOS";288;17;38;343
2010;"TRES LAGOAS (MS)";"MS";"TRES LAGOAS";1438;109;366;1913
2010;"VICENTINA (MS)";"MS";"VICENTINA";104;8;63;175
2010;"ACORIZAL (MT)";"MT";"ACORIZAL";13;3;3;19
2010;"AGUA BOA (MT)";"MT";"AGUA BOA";454;6;33;493
2010;"ALTA FLORESTA (MT)";"MT";"ALTA FLORESTA";1121;15;69;1205
2010;"ALTO ARAGUAIA (MT)";"MT";"ALTO ARAGUAIA";138;16;28;182
2010;"ALTO BOA VISTA (MT)";"MT";"ALTO BOA VISTA";19;1;2;22
2010;"ALTO GARCAS (MT)";"MT";"ALTO GARCAS";243;7;28;278
2010;"ALTO PARAGUAI (MT)";"MT";"ALTO PARAGUAI";27;7;4;38
2010;"ALTO TAQUARI (MT)";"MT";"ALTO TAQUARI";156;7;19;182
2010;"APIACAS (MT)";"MT";"APIACAS";90;10;3;103
2010;"ARAGUAIANA (MT)";"MT";"ARAGUAIANA";11;0;3;14
2010;"ARAGUAINHA (MT)";"MT";"ARAGUAINHA";7;1;0;8
2010;"ARAPUTANGA (MT)";"MT";"ARAPUTANGA";231;12;21;264
2010;"ARENAPOLIS (MT)";"MT";"ARENAPOLIS";165;7;60;232
2010;"ARIPUANA (MT)";"MT";"ARIPUANA";296;10;24;330
2010;"BARAO DE MELGACO (MT)";"MT";"BARAO DE MELGACO";8;1;2;11
2010;"BARRA DO BUGRES (MT)";"MT";"BARRA DO BUGRES";476;17;124;617
2010;"BARRA DO GARCAS (MT)";"MT";"BARRA DO GARCAS";775;28;166;969
2010;"BOM JESUS DO ARAGUAIA (MT)";"MT";"BOM JESUS DO ARAGUAIA";13;1;6;20
2010;"BRASNORTE (MT)";"MT";"BRASNORTE";281;4;43;328
2010;"CACERES (MT)";"MT";"CACERES";738;49;270;1057
2010;"CAMPINAPOLIS (MT)";"MT";"CAMPINAPOLIS";63;4;13;80
2010;"CAMPO NOVO DO PARECIS (MT)";"MT";"CAMPO NOVO DO PARECIS";639;16;89;744
2010;"CAMPO VERDE (MT)";"MT";"CAMPO VERDE";774;39;105;918
2010;"CAMPOS DE JULIO (MT)";"MT";"CAMPOS DE JULIO";149;10;22;181
2010;"CANABRAVA DO NORTE (MT)";"MT";"CANABRAVA DO NORTE";23;0;8;31
2010;"CANARANA (MT)";"MT";"CANARANA";453;11;24;488
2010;"CARLINDA (MT)";"MT";"CARLINDA";111;0;22;133
2010;"CASTANHEIRA (MT)";"MT";"CASTANHEIRA";97;2;12;111
2010;"CHAPADA DOS GUIMARAES (MT)";"MT";"CHAPADA DOS GUIMARAES";184;20;43;247
2010;"CLAUDIA (MT)";"MT";"CLAUDIA";379;4;17;400
2010;"COCALINHO (MT)";"MT";"COCALINHO";17;1;7;25
2010;"COLIDER (MT)";"MT";"COLIDER";810;16;78;904
2010;"COLNIZA (MT)";"MT";"COLNIZA";230;0;4;234
2010;"COMODORO (MT)";"MT";"COMODORO";433;8;69;510
2010;"CONFRESA (MT)";"MT";"CONFRESA";129;4;34;167
2010;"CONQUISTA D OESTE (MT)";"MT";"CONQUISTA D OESTE";35;1;12;48
2010;"COTRIGUACU (MT)";"MT";"COTRIGUACU";113;2;31;146
2010;"CUIABA (MT)";"MT";"CUIABA";7993;656;2013;10662
2010;"CURVELANDIA (MT)";"MT";"CURVELANDIA";59;0;15;74
2010;"DENISE (MT)";"MT";"DENISE";66;4;26;96
2010;"DIAMANTINO (MT)";"MT";"DIAMANTINO";440;14;48;502
2010;"DOM AQUINO (MT)";"MT";"DOM AQUINO";91;8;18;117
2010;"FELIZ NATAL (MT)";"MT";"FELIZ NATAL";228;3;16;247
2010;"FIGUEIROPOLIS D OESTE (MT)";"MT";"FIGUEIROPOLIS D OESTE";65;3;9;77
2010;"GAUCHA DO NORTE (MT)";"MT";"GAUCHA DO NORTE";50;6;15;71
2010;"GENERAL CARNEIRO (MT)";"MT";"GENERAL CARNEIRO";18;4;3;25
2010;"GLORIA D OESTE (MT)";"MT";"GLORIA D OESTE";37;3;13;53
2010;"GUARANTA DO NORTE (MT)";"MT";"GUARANTA DO NORTE";806;7;56;869
2010;"GUIRATINGA (MT)";"MT";"GUIRATINGA";139;7;9;155
2010;"INDIAVAI (MT)";"MT";"INDIAVAI";17;1;7;25
2010;"IPIRANGA DO NORTE (MT)";"MT";"IPIRANGA DO NORTE";89;2;7;98
2010;"ITANHANGA (MT)";"MT";"ITANHANGA";100;2;14;116
2010;"ITAUBA (MT)";"MT";"ITAUBA";105;4;9;118
2010;"ITIQUIRA (MT)";"MT";"ITIQUIRA";90;15;30;135
2010;"JACIARA (MT)";"MT";"JACIARA";524;36;107;667
2010;"JANGADA (MT)";"MT";"JANGADA";45;11;16;72
2010;"JAURU (MT)";"MT";"JAURU";151;5;27;183
2010;"JUARA (MT)";"MT";"JUARA";678;17;46;741
2010;"JUINA (MT)";"MT";"JUINA";778;9;54;841
2010;"JURUENA (MT)";"MT";"JURUENA";145;2;11;158
2010;"JUSCIMEIRA (MT)";"MT";"JUSCIMEIRA";115;6;48;169
2010;"LAMBARI D OESTE (MT)";"MT";"LAMBARI D OESTE";55;2;21;78
2010;"LUCAS DO RIO VERDE (MT)";"MT";"LUCAS DO RIO VERDE";1328;30;111;1469
2010;"LUCIARA (MT)";"MT";"LUCIARA";7;0;2;9
2010;"MARCELANDIA (MT)";"MT";"MARCELANDIA";334;6;14;354
2010;"MATUPA (MT)";"MT";"MATUPA";332;7;29;368
2010;"MIRASSOL D OESTE (MT)";"MT";"MIRASSOL D OESTE";650;6;66;722
2010;"NOBRES (MT)";"MT";"NOBRES";253;11;54;318
2010;"NORTELANDIA (MT)";"MT";"NORTELANDIA";81;5;12;98
2010;"NOSSA SENHORA DO LIVRAMENTO (MT)";"MT";"NOSSA SENHORA DO LIVRAMENTO";60;1;25;86
2010;"NOVA BANDEIRANTES (MT)";"MT";"NOVA BANDEIRANTES";122;1;22;145
2010;"NOVA BRASILANDIA (MT)";"MT";"NOVA BRASILANDIA";36;1;9;46
2010;"NOVA CANAA DO NORTE (MT)";"MT";"NOVA CANAA DO NORTE";169;2;31;202
2010;"NOVA GUARITA (MT)";"MT";"NOVA GUARITA";86;0;13;99
2010;"NOVA LACERDA (MT)";"MT";"NOVA LACERDA";67;0;20;87
2010;"NOVA MARILANDIA (MT)";"MT";"NOVA MARILANDIA";25;4;3;32
2010;"NOVA MARINGA (MT)";"MT";"NOVA MARINGA";96;0;8;104
2010;"NOVA MONTE VERDE (MT)";"MT";"NOVA MONTE VERDE";103;6;4;113
2010;"NOVA MUTUM (MT)";"MT";"NOVA MUTUM";814;12;63;889
2010;"NOVA NAZARE (MT)";"MT";"NOVA NAZARE";6;4;4;14
2010;"NOVA OLIMPIA (MT)";"MT";"NOVA OLIMPIA";313;16;88;417
2010;"NOVA SANTA HELENA (MT)";"MT";"NOVA SANTA HELENA";48;1;10;59
2010;"NOVA UBIRATA (MT)";"MT";"NOVA UBIRATA";113;11;22;146
2010;"NOVA XAVANTINA (MT)";"MT";"NOVA XAVANTINA";324;13;31;368
2010;"NOVO HORIZONTE DO NORTE (MT)";"MT";"NOVO HORIZONTE DO NORTE";34;0;11;45
2010;"NOVO MUNDO (MT)";"MT";"NOVO MUNDO";82;2;7;91
2010;"NOVO SANTO ANTONIO (MT)";"MT";"NOVO SANTO ANTONIO";3;0;3;6
2010;"NOVO SAO JOAQUIM (MT)";"MT";"NOVO SAO JOAQUIM";55;2;11;68
2010;"PARANAITA (MT)";"MT";"PARANAITA";168;7;32;207
2010;"PARANATINGA (MT)";"MT";"PARANATINGA";341;9;53;403
2010;"PEDRA PRETA (MT)";"MT";"PEDRA PRETA";270;8;33;311
2010;"PEIXOTO DE AZEVEDO (MT)";"MT";"PEIXOTO DE AZEVEDO";276;11;54;341
2010;"PLANALTO DA SERRA (MT)";"MT";"PLANALTO DA SERRA";8;1;4;13
2010;"POCONE (MT)";"MT";"POCONE";323;13;29;365
2010;"PONTAL DO ARAGUAIA (MT)";"MT";"PONTAL DO ARAGUAIA";18;1;1;20
2010;"PONTE BRANCA (MT)";"MT";"PONTE BRANCA";5;1;0;6
2010;"PONTES E LACERDA (MT)";"MT";"PONTES E LACERDA";769;22;90;881
2010;"PORTO ALEGRE DO NORTE (MT)";"MT";"PORTO ALEGRE DO NORTE";39;5;25;69
2010;"PORTO DOS GAUCHOS (MT)";"MT";"PORTO DOS GAUCHOS";94;7;6;107
2010;"PORTO ESPERIDIAO (MT)";"MT";"PORTO ESPERIDIAO";123;4;37;164
2010;"PORTO ESTRELA (MT)";"MT";"PORTO ESTRELA";14;2;5;21
2010;"POXOREO (MT)";"MT";"POXOREO";95;12;33;140
2010;"PRIMAVERA DO LESTE (MT)";"MT";"PRIMAVERA DO LESTE";1612;53;117;1782
2010;"QUERENCIA (MT)";"MT";"QUERENCIA";222;1;15;238
2010;"RESERVA DO CABACAL (MT)";"MT";"RESERVA DO CABACAL";20;2;5;27
2010;"RIBEIRAO CASCALHEIRA (MT)";"MT";"RIBEIRAO CASCALHEIRA";84;7;9;100
2010;"RIBEIRAOZINHO (MT)";"MT";"RIBEIRAOZINHO";7;4;6;17
2010;"RIO BRANCO (MT)";"MT";"RIO BRANCO";77;6;14;97
2010;"RONDOLANDIA (MT)";"MT";"RONDOLANDIA";5;0;10;15
2010;"RONDONOPOLIS (MT)";"MT";"RONDONOPOLIS";3624;172;381;4177
2010;"ROSARIO OESTE (MT)";"MT";"ROSARIO OESTE";114;9;25;148
2010;"SALTO DO CEU (MT)";"MT";"SALTO DO CEU";39;4;12;55
2010;"SANTA CARMEM (MT)";"MT";"SANTA CARMEM";126;2;10;138
2010;"SANTA CRUZ DO XINGU (MT)";"MT";"SANTA CRUZ DO XINGU";6;1;3;10
2010;"SANTA RITA DO TRIVELATO (MT)";"MT";"SANTA RITA DO TRIVELATO";43;2;10;55
2010;"SANTA TEREZINHA (MT)";"MT";"SANTA TEREZINHA";6;1;9;16
2010;"SANTO AFONSO (MT)";"MT";"SANTO AFONSO";19;2;6;27
2010;"SANTO ANTONIO DO LESTE (MT)";"MT";"SANTO ANTONIO DO LESTE";54;1;12;67
2010;"SANTO ANTONIO DO LEVERGER (MT)";"MT";"SANTO ANTONIO DO LEVERGER";78;10;13;101
2010;"SAO FELIX DO ARAGUAIA (MT)";"MT";"SAO FELIX DO ARAGUAIA";36;4;17;57
2010;"SAO JOSE DO POVO (MT)";"MT";"SAO JOSE DO POVO";14;1;4;19
2010;"SAO JOSE DO RIO CLARO (MT)";"MT";"SAO JOSE DO RIO CLARO";296;11;42;349
2010;"SAO JOSE DO XINGU (MT)";"MT";"SAO JOSE DO XINGU";10;0;8;18
2010;"SAO JOSE DOS QUATRO MARCOS (MT)";"MT";"SAO JOSE DOS QUATRO MARCOS";403;10;52;465
2010;"SAO PEDRO DA CIPA (MT)";"MT";"SAO PEDRO DA CIPA";18;4;21;43
2010;"SAPEZAL (MT)";"MT";"SAPEZAL";451;12;49;512
2010;"SERRA NOVA DOURADA (MT)";"MT";"SERRA NOVA DOURADA";5;1;1;7
2010;"SINOP (MT)";"MT";"SINOP";2877;61;147;3085
2010;"SORRISO (MT)";"MT";"SORRISO";1915;42;128;2085
2010;"TABAPORA (MT)";"MT";"TABAPORA";111;4;18;133
2010;"TANGARA DA SERRA (MT)";"MT";"TANGARA DA SERRA";1694;68;191;1953
2010;"TAPURAH (MT)";"MT";"TAPURAH";295;8;24;327
2010;"TERRA NOVA DO NORTE (MT)";"MT";"TERRA NOVA DO NORTE";237;11;22;270
2010;"TESOURO (MT)";"MT";"TESOURO";10;2;3;15
2010;"TORIXOREU (MT)";"MT";"TORIXOREU";21;3;4;28
2010;"UNIAO DO SUL (MT)";"MT";"UNIAO DO SUL";75;0;9;84
2010;"VALE DE SAO DOMINGOS (MT)";"MT";"VALE DE SAO DOMINGOS";21;0;13;34
2010;"VARZEA GRANDE (MT)";"MT";"VARZEA GRANDE";4001;234;458;4693
2010;"VERA (MT)";"MT";"VERA";252;5;19;276
2010;"VILA BELA DA SANTISSIMA TRINDA (MT)";"MT";"VILA BELA DA SANTISSIMA TRINDA";90;2;23;115
2010;"VILA RICA (MT)";"MT";"VILA RICA";209;2;26;237
2010;"ABAETETUBA (PA)";"PA";"ABAETETUBA";242;19;181;442
2010;"ABEL FIGUEIREDO (PA)";"PA";"ABEL FIGUEIREDO";57;6;4;67
2010;"ACARA (PA)";"PA";"ACARA";63;4;39;106
2010;"AFUA (PA)";"PA";"AFUA";0;0;0;0
2010;"AGUA AZUL DO NORTE (PA)";"PA";"AGUA AZUL DO NORTE";53;5;14;72
2010;"ALENQUER (PA)";"PA";"ALENQUER";123;4;37;164
2010;"ALMEIRIM (PA)";"PA";"ALMEIRIM";192;15;88;295
2010;"ALTAMIRA (PA)";"PA";"ALTAMIRA";841;125;61;1027
2010;"ANAJAS (PA)";"PA";"ANAJAS";0;0;1;1
2010;"ANANINDEUA (PA)";"PA";"ANANINDEUA";3529;376;1165;5070
2010;"ANAPU (PA)";"PA";"ANAPU";49;7;3;59
2010;"AUGUSTO CORREA (PA)";"PA";"AUGUSTO CORREA";26;2;49;77
2010;"AURORA DO PARA (PA)";"PA";"AURORA DO PARA";56;4;49;109
2010;"AVEIRO (PA)";"PA";"AVEIRO";4;0;1;5
2010;"BAGRE (PA)";"PA";"BAGRE";1;0;0;1
2010;"BAIAO (PA)";"PA";"BAIAO";30;1;12;43
2010;"BANNACH (PA)";"PA";"BANNACH";11;0;0;11
2010;"BARCARENA (PA)";"PA";"BARCARENA";704;150;519;1373
2010;"BELEM (PA)";"PA";"BELEM";7635;1417;2877;11929
2010;"BELTERRA (PA)";"PA";"BELTERRA";31;3;19;53
2010;"BENEVIDES (PA)";"PA";"BENEVIDES";445;33;80;558
2010;"BOM JESUS DO TOCANTINS (PA)";"PA";"BOM JESUS DO TOCANTINS";62;9;5;76
2010;"BONITO (PA)";"PA";"BONITO";45;2;42;89
2010;"BRAGANCA (PA)";"PA";"BRAGANCA";349;23;139;511
2010;"BRASIL NOVO (PA)";"PA";"BRASIL NOVO";150;26;5;181
2010;"BREJO GRANDE DO ARAGUAIA (PA)";"PA";"BREJO GRANDE DO ARAGUAIA";12;8;8;28
2010;"BREU BRANCO (PA)";"PA";"BREU BRANCO";229;6;61;296
2010;"BREVES (PA)";"PA";"BREVES";20;1;4;25
2010;"BUJARU (PA)";"PA";"BUJARU";32;7;14;53
2010;"CACHOEIRA DO ARARI (PA)";"PA";"CACHOEIRA DO ARARI";9;4;9;22
2010;"CACHOEIRA DO PIRIA (PA)";"PA";"CACHOEIRA DO PIRIA";23;2;16;41
2010;"CAMETA (PA)";"PA";"CAMETA";92;7;43;142
2010;"CANAA DOS CARAJAS (PA)";"PA";"CANAA DOS CARAJAS";176;61;67;304
2010;"CAPANEMA (PA)";"PA";"CAPANEMA";563;24;93;680
2010;"CAPITAO POCO (PA)";"PA";"CAPITAO POCO";280;22;63;365
2010;"CASTANHAL (PA)";"PA";"CASTANHAL";2337;137;283;2757
2010;"CHAVES (PA)";"PA";"CHAVES";0;0;0;0
2010;"COLARES (PA)";"PA";"COLARES";4;1;1;6
2010;"CONCEICAO DO ARAGUAIA (PA)";"PA";"CONCEICAO DO ARAGUAIA";324;28;54;406
2010;"CONCORDIA DO PARA (PA)";"PA";"CONCORDIA DO PARA";104;2;35;141
2010;"CUMARU DO NORTE (PA)";"PA";"CUMARU DO NORTE";18;0;5;23
2010;"CURIONOPOLIS (PA)";"PA";"CURIONOPOLIS";66;96;3;165
2010;"CURRALINHO (PA)";"PA";"CURRALINHO";1;0;1;2
2010;"CURUA (PA)";"PA";"CURUA";3;1;0;4
2010;"CURUCA (PA)";"PA";"CURUCA";41;7;12;60
2010;"DOM ELISEU (PA)";"PA";"DOM ELISEU";475;40;29;544
2010;"ELDORADO DOS CARAJAS (PA)";"PA";"ELDORADO DOS CARAJAS";124;29;7;160
2010;"FARO (PA)";"PA";"FARO";2;1;0;3
2010;"FLORESTA DO ARAGUAIA (PA)";"PA";"FLORESTA DO ARAGUAIA";80;2;5;87
2010;"GARRAFAO DO NORTE (PA)";"PA";"GARRAFAO DO NORTE";63;3;11;77
2010;"GOIANESIA DO PARA (PA)";"PA";"GOIANESIA DO PARA";263;14;25;302
2010;"GURUPA (PA)";"PA";"GURUPA";4;0;1;5
2010;"IGARAPE ACU (PA)";"PA";"IGARAPE ACU";132;64;64;260
2010;"IGARAPE MIRI (PA)";"PA";"IGARAPE MIRI";55;11;21;87
2010;"INHANGAPI (PA)";"PA";"INHANGAPI";24;0;26;50
2010;"IPIXUNA DO PARA (PA)";"PA";"IPIXUNA DO PARA";50;4;19;73
2010;"IRITUIA (PA)";"PA";"IRITUIA";51;2;37;90
2010;"ITAITUBA (PA)";"PA";"ITAITUBA";613;35;74;722
2010;"ITUPIRANGA (PA)";"PA";"ITUPIRANGA";138;83;21;242
2010;"JACAREACANGA (PA)";"PA";"JACAREACANGA";7;0;1;8
2010;"JACUNDA (PA)";"PA";"JACUNDA";557;21;34;612
2010;"JURUTI (PA)";"PA";"JURUTI";63;8;3;74
2010;"LIMOEIRO DO AJURU (PA)";"PA";"LIMOEIRO DO AJURU";0;0;0;0
2010;"MAE DO RIO (PA)";"PA";"MAE DO RIO";248;15;59;322
2010;"MAGALHAES BARATA (PA)";"PA";"MAGALHAES BARATA";8;21;5;34
2010;"MARABA (PA)";"PA";"MARABA";3110;237;392;3739
2010;"MARACANA (PA)";"PA";"MARACANA";23;12;17;52
2010;"MARAPANIM (PA)";"PA";"MARAPANIM";30;15;19;64
2010;"MARITUBA (PA)";"PA";"MARITUBA";647;103;239;989
2010;"MEDICILANDIA (PA)";"PA";"MEDICILANDIA";146;7;20;173
2010;"MELGACO (PA)";"PA";"MELGACO";1;0;0;1
2010;"MOCAJUBA (PA)";"PA";"MOCAJUBA";10;2;7;19
2010;"MOJU (PA)";"PA";"MOJU";118;16;115;249
2010;"MONTE ALEGRE (PA)";"PA";"MONTE ALEGRE";213;5;112;330
2010;"MUANA (PA)";"PA";"MUANA";3;2;3;8
2010;"NOVA ESPERANCA DO PIRIA (PA)";"PA";"NOVA ESPERANCA DO PIRIA";50;2;15;67
2010;"NOVA IPIXUNA (PA)";"PA";"NOVA IPIXUNA";130;2;21;153
2010;"NOVA TIMBOTEUA (PA)";"PA";"NOVA TIMBOTEUA";52;5;14;71
2010;"NOVO PROGRESSO (PA)";"PA";"NOVO PROGRESSO";226;1;16;243
2010;"NOVO REPARTIMENTO (PA)";"PA";"NOVO REPARTIMENTO";327;30;29;386
2010;"OBIDOS (PA)";"PA";"OBIDOS";147;0;31;178
2010;"OEIRAS DO PARA (PA)";"PA";"OEIRAS DO PARA";5;1;1;7
2010;"ORIXIMINA (PA)";"PA";"ORIXIMINA";260;8;16;284
2010;"OUREM (PA)";"PA";"OUREM";103;4;12;119
2010;"OURILANDIA DO NORTE (PA)";"PA";"OURILANDIA DO NORTE";167;7;19;193
2010;"PACAJA (PA)";"PA";"PACAJA";99;10;8;117
2010;"PALESTINA DO PARA (PA)";"PA";"PALESTINA DO PARA";22;12;4;38
2010;"PARAGOMINAS (PA)";"PA";"PARAGOMINAS";1198;23;135;1356
2010;"PARAUAPEBAS (PA)";"PA";"PARAUAPEBAS";1259;496;441;2196
2010;"PAU D ARCO (PA)";"PA";"PAU D ARCO";14;7;4;25
2010;"PEIXE BOI (PA)";"PA";"PEIXE BOI";16;4;13;33
2010;"PICARRA (PA)";"PA";"PICARRA";16;1;3;20
2010;"PLACAS (PA)";"PA";"PLACAS";58;1;1;60
2010;"PONTA DE PEDRAS (PA)";"PA";"PONTA DE PEDRAS";4;1;2;7
2010;"PORTEL (PA)";"PA";"PORTEL";14;0;4;18
2010;"PORTO DE MOZ (PA)";"PA";"PORTO DE MOZ";10;0;2;12
2010;"PRAINHA (PA)";"PA";"PRAINHA";23;0;3;26
2010;"PRIMAVERA (PA)";"PA";"PRIMAVERA";9;2;12;23
2010;"QUATIPURU (PA)";"PA";"QUATIPURU";9;3;11;23
2010;"REDENCAO (PA)";"PA";"REDENCAO";985;64;97;1146
2010;"RIO MARIA (PA)";"PA";"RIO MARIA";206;44;23;273
2010;"RONDON DO PARA (PA)";"PA";"RONDON DO PARA";432;43;12;487
2010;"RUROPOLIS (PA)";"PA";"RUROPOLIS";153;6;9;168
2010;"SALINOPOLIS (PA)";"PA";"SALINOPOLIS";132;22;50;204
2010;"SALVATERRA (PA)";"PA";"SALVATERRA";24;22;15;61
2010;"SANTA BARBARA DO PARA (PA)";"PA";"SANTA BARBARA DO PARA";44;15;49;108
2010;"SANTA CRUZ DO ARARI (PA)";"PA";"SANTA CRUZ DO ARARI";1;0;0;1
2010;"SANTA ISABEL DO PARA (PA)";"PA";"SANTA ISABEL DO PARA";504;38;126;668
2010;"SANTA LUZIA DO PARA (PA)";"PA";"SANTA LUZIA DO PARA";104;9;26;139
2010;"SANTA MARIA DAS BARREIRAS (PA)";"PA";"SANTA MARIA DAS BARREIRAS";64;2;13;79
2010;"SANTA MARIA DO PARA (PA)";"PA";"SANTA MARIA DO PARA";211;24;46;281
2010;"SANTANA DO ARAGUAIA (PA)";"PA";"SANTANA DO ARAGUAIA";150;11;12;173
2010;"SANTAREM (PA)";"PA";"SANTAREM";2149;81;523;2753
2010;"SANTAREM NOVO (PA)";"PA";"SANTAREM NOVO";7;5;11;23
2010;"SANTO ANTONIO DO TAUA (PA)";"PA";"SANTO ANTONIO DO TAUA";92;31;88;211
2010;"SAO CAETANO DE ODIVELAS (PA)";"PA";"SAO CAETANO DE ODIVELAS";17;0;3;20
2010;"SAO DOMINGOS DO ARAGUAIA (PA)";"PA";"SAO DOMINGOS DO ARAGUAIA";121;25;15;161
2010;"SAO DOMINGOS DO CAPIM (PA)";"PA";"SAO DOMINGOS DO CAPIM";38;0;14;52
2010;"SAO FELIX DO XINGU (PA)";"PA";"SAO FELIX DO XINGU";182;6;18;206
2010;"SAO FRANCISCO DO PARA (PA)";"PA";"SAO FRANCISCO DO PARA";29;35;24;88
2010;"SAO GERALDO DO ARAGUAIA (PA)";"PA";"SAO GERALDO DO ARAGUAIA";108;8;13;129
2010;"SAO JOAO DA PONTA (PA)";"PA";"SAO JOAO DA PONTA";2;3;7;12
2010;"SAO JOAO DE PIRABAS (PA)";"PA";"SAO JOAO DE PIRABAS";22;8;13;43
2010;"SAO JOAO DO ARAGUAIA (PA)";"PA";"SAO JOAO DO ARAGUAIA";19;20;5;44
2010;"SAO MIGUEL DO GUAMA (PA)";"PA";"SAO MIGUEL DO GUAMA";339;24;74;437
2010;"SAO SEBASTIAO DA BOA VISTA (PA)";"PA";"SAO SEBASTIAO DA BOA VISTA";2;0;0;2
2010;"SAPUCAIA (PA)";"PA";"SAPUCAIA";23;3;4;30
2010;"SENADOR JOSE PORFIRIO (PA)";"PA";"SENADOR JOSE PORFIRIO";16;3;1;20
2010;"SOURE (PA)";"PA";"SOURE";28;2;11;41
2010;"TAILANDIA (PA)";"PA";"TAILANDIA";540;27;82;649
2010;"TERRA ALTA (PA)";"PA";"TERRA ALTA";21;19;17;57
2010;"TERRA SANTA (PA)";"PA";"TERRA SANTA";11;0;3;14
2010;"TOME ACU (PA)";"PA";"TOME ACU";373;12;98;483
2010;"TRACUATEUA (PA)";"PA";"TRACUATEUA";22;5;22;49
2010;"TRAIRAO (PA)";"PA";"TRAIRAO";76;4;5;85
2010;"TUCUMA (PA)";"PA";"TUCUMA";394;13;69;476
2010;"TUCURUI (PA)";"PA";"TUCURUI";744;95;161;1000
2010;"ULIANOPOLIS (PA)";"PA";"ULIANOPOLIS";160;16;16;192
2010;"URUARA (PA)";"PA";"URUARA";403;12;17;432
2010;"VIGIA (PA)";"PA";"VIGIA";100;5;65;170
2010;"VISEU (PA)";"PA";"VISEU";48;2;26;76
2010;"VITORIA DO XINGU (PA)";"PA";"VITORIA DO XINGU";13;10;7;30
2010;"XINGUARA (PA)";"PA";"XINGUARA";671;25;71;767
2010;"AGUA BRANCA (PB)";"PB";"AGUA BRANCA";11;7;2;20
2010;"AGUIAR (PB)";"PB";"AGUIAR";6;3;0;9
2010;"ALAGOA GRANDE (PB)";"PB";"ALAGOA GRANDE";86;17;30;133
2010;"ALAGOA NOVA (PB)";"PB";"ALAGOA NOVA";100;73;12;185
2010;"ALAGOINHA (PB)";"PB";"ALAGOINHA";40;10;18;68
2010;"ALCANTIL (PB)";"PB";"ALCANTIL";37;18;11;66
2010;"ALGODAO DE JANDAIRA (PB)";"PB";"ALGODAO DE JANDAIRA";15;0;1;16
2010;"ALHANDRA (PB)";"PB";"ALHANDRA";106;16;13;135
2010;"AMPARO (PB)";"PB";"AMPARO";6;3;3;12
2010;"APARECIDA (PB)";"PB";"APARECIDA";22;3;7;32
2010;"ARACAGI (PB)";"PB";"ARACAGI";44;1;26;71
2010;"ARARA (PB)";"PB";"ARARA";48;3;14;65
2010;"ARARUNA (PB)";"PB";"ARARUNA";69;22;16;107
2010;"AREIA (PB)";"PB";"AREIA";98;23;15;136
2010;"AREIA DE BARAUNAS (PB)";"PB";"AREIA DE BARAUNAS";2;2;2;6
2010;"AREIAL (PB)";"PB";"AREIAL";21;4;4;29
2010;"AROEIRAS (PB)";"PB";"AROEIRAS";41;14;11;66
2010;"ASSUNCAO (PB)";"PB";"ASSUNCAO";18;7;4;29
2010;"BAIA DA TRAICAO (PB)";"PB";"BAIA DA TRAICAO";10;5;6;21
2010;"BANANEIRAS (PB)";"PB";"BANANEIRAS";68;15;21;104
2010;"BARAUNA (PB)";"PB";"BARAUNA";23;0;4;27
2010;"BARRA DE SANTA ROSA (PB)";"PB";"BARRA DE SANTA ROSA";53;6;12;71
2010;"BARRA DE SANTANA (PB)";"PB";"BARRA DE SANTANA";53;3;6;62
2010;"BARRA DE SAO MIGUEL (PB)";"PB";"BARRA DE SAO MIGUEL";5;0;2;7
2010;"BAYEUX (PB)";"PB";"BAYEUX";576;24;137;737
2010;"BELEM (PB)";"PB";"BELEM";102;11;12;125
2010;"BELEM DO BREJO DO CRUZ (PB)";"PB";"BELEM DO BREJO DO CRUZ";10;10;2;22
2010;"BERNARDINO BATISTA (PB)";"PB";"BERNARDINO BATISTA";3;0;3;6
2010;"BOA VENTURA (PB)";"PB";"BOA VENTURA";10;2;1;13
2010;"BOA VISTA (PB)";"PB";"BOA VISTA";95;5;12;112
2010;"BOM JESUS (PB)";"PB";"BOM JESUS";6;0;1;7
2010;"BOM SUCESSO (PB)";"PB";"BOM SUCESSO";2;1;4;7
2010;"BONITO DE SANTA FE (PB)";"PB";"BONITO DE SANTA FE";22;7;0;29
2010;"BOQUEIRAO (PB)";"PB";"BOQUEIRAO";177;8;18;203
2010;"BORBOREMA (PB)";"PB";"BORBOREMA";22;22;1;45
2010;"BREJO DO CRUZ (PB)";"PB";"BREJO DO CRUZ";62;9;3;74
2010;"BREJO DOS SANTOS (PB)";"PB";"BREJO DOS SANTOS";12;2;1;15
2010;"CAAPORA (PB)";"PB";"CAAPORA";27;3;5;35
2010;"CABACEIRAS (PB)";"PB";"CABACEIRAS";19;3;12;34
2010;"CABEDELO (PB)";"PB";"CABEDELO";375;15;26;416
2010;"CACHOEIRA DOS INDIOS (PB)";"PB";"CACHOEIRA DOS INDIOS";16;1;4;21
2010;"CACIMBA DE AREIA (PB)";"PB";"CACIMBA DE AREIA";5;0;5;10
2010;"CACIMBA DE DENTRO (PB)";"PB";"CACIMBA DE DENTRO";54;12;34;100
2010;"CACIMBAS (PB)";"PB";"CACIMBAS";3;4;2;9
2010;"CAICARA (PB)";"PB";"CAICARA";13;3;3;19
2010;"CAJAZEIRAS (PB)";"PB";"CAJAZEIRAS";419;29;40;488
2010;"CAJAZEIRINHAS (PB)";"PB";"CAJAZEIRINHAS";6;3;0;9
2010;"CALDAS BRANDAO (PB)";"PB";"CALDAS BRANDAO";21;2;4;27
2010;"CAMALAU (PB)";"PB";"CAMALAU";22;5;8;35
2010;"CAMPINA GRANDE (PB)";"PB";"CAMPINA GRANDE";3977;282;676;4935
2010;"CAMPO DE SANTANA (PB)";"PB";"CAMPO DE SANTANA";26;3;15;44
2010;"CAPIM (PB)";"PB";"CAPIM";17;1;11;29
2010;"CARAUBAS (PB)";"PB";"CARAUBAS";6;5;2;13
2010;"CARRAPATEIRA (PB)";"PB";"CARRAPATEIRA";0;2;0;2
2010;"CASSERENGUE (PB)";"PB";"CASSERENGUE";23;5;16;44
2010;"CATINGUEIRA (PB)";"PB";"CATINGUEIRA";10;1;1;12
2010;"CATOLE DO ROCHA (PB)";"PB";"CATOLE DO ROCHA";211;31;14;256
2010;"CATURITE (PB)";"PB";"CATURITE";75;11;10;96
2010;"CONCEICAO (PB)";"PB";"CONCEICAO";68;22;7;97
2010;"CONDADO (PB)";"PB";"CONDADO";19;8;7;34
2010;"CONDE (PB)";"PB";"CONDE";80;12;8;100
2010;"CONGO (PB)";"PB";"CONGO";16;3;0;19
2010;"COREMAS (PB)";"PB";"COREMAS";46;13;6;65
2010;"COXIXOLA (PB)";"PB";"COXIXOLA";2;5;0;7
2010;"CRUZ DO ESPIRITO SANTO (PB)";"PB";"CRUZ DO ESPIRITO SANTO";28;4;16;48
2010;"CUBATI (PB)";"PB";"CUBATI";21;3;1;25
2010;"CUITE (PB)";"PB";"CUITE";72;4;10;86
2010;"CUITE DE MAMANGUAPE (PB)";"PB";"CUITE DE MAMANGUAPE";10;8;19;37
2010;"CUITEGI (PB)";"PB";"CUITEGI";16;2;3;21
2010;"CURRAL DE CIMA (PB)";"PB";"CURRAL DE CIMA";15;3;10;28
2010;"CURRAL VELHO (PB)";"PB";"CURRAL VELHO";3;0;2;5
2010;"DAMIAO (PB)";"PB";"DAMIAO";11;2;6;19
2010;"DESTERRO (PB)";"PB";"DESTERRO";24;9;3;36
2010;"DIAMANTE (PB)";"PB";"DIAMANTE";11;1;1;13
2010;"DONA INES (PB)";"PB";"DONA INES";31;4;17;52
2010;"DUAS ESTRADAS (PB)";"PB";"DUAS ESTRADAS";10;4;6;20
2010;"EMAS (PB)";"PB";"EMAS";2;4;2;8
2010;"ESPERANCA (PB)";"PB";"ESPERANCA";429;16;89;534
2010;"FAGUNDES (PB)";"PB";"FAGUNDES";34;6;15;55
2010;"FREI MARTINHO (PB)";"PB";"FREI MARTINHO";4;0;3;7
2010;"GADO BRAVO (PB)";"PB";"GADO BRAVO";30;9;6;45
2010;"GUARABIRA (PB)";"PB";"GUARABIRA";440;47;115;602
2010;"GURINHEM (PB)";"PB";"GURINHEM";35;5;19;59
2010;"GURJAO (PB)";"PB";"GURJAO";8;4;2;14
2010;"IBIARA (PB)";"PB";"IBIARA";8;2;1;11
2010;"IGARACY (PB)";"PB";"IGARACY";11;7;3;21
2010;"IMACULADA (PB)";"PB";"IMACULADA";8;3;2;13
2010;"INGA (PB)";"PB";"INGA";90;11;27;128
2010;"ITABAIANA (PB)";"PB";"ITABAIANA";148;8;33;189
2010;"ITAPORANGA (PB)";"PB";"ITAPORANGA";101;33;13;147
2010;"ITAPOROROCA (PB)";"PB";"ITAPOROROCA";71;3;18;92
2010;"ITATUBA (PB)";"PB";"ITATUBA";32;1;7;40
2010;"JACARAU (PB)";"PB";"JACARAU";52;3;10;65
2010;"JERICO (PB)";"PB";"JERICO";17;4;0;21
2010;"JOAO PESSOA (PB)";"PB";"JOAO PESSOA";4631;779;1312;6722
2010;"JUAREZ TAVORA (PB)";"PB";"JUAREZ TAVORA";25;4;12;41
2010;"JUAZEIRINHO (PB)";"PB";"JUAZEIRINHO";44;16;8;68
2010;"JUNCO DO SERIDO (PB)";"PB";"JUNCO DO SERIDO";48;6;3;57
2010;"JURIPIRANGA (PB)";"PB";"JURIPIRANGA";30;3;17;50
2010;"JURU (PB)";"PB";"JURU";7;8;0;15
2010;"LAGOA (PB)";"PB";"LAGOA";7;2;3;12
2010;"LAGOA DE DENTRO (PB)";"PB";"LAGOA DE DENTRO";27;5;7;39
2010;"LAGOA SECA (PB)";"PB";"LAGOA SECA";152;32;17;201
2010;"LASTRO (PB)";"PB";"LASTRO";3;2;0;5
2010;"LIVRAMENTO (PB)";"PB";"LIVRAMENTO";31;4;1;36
2010;"LOGRADOURO (PB)";"PB";"LOGRADOURO";2;5;6;13
2010;"LUCENA (PB)";"PB";"LUCENA";16;1;6;23
2010;"MAE D AGUA (PB)";"PB";"MAE D AGUA";3;0;4;7
2010;"MALTA (PB)";"PB";"MALTA";9;6;2;17
2010;"MAMANGUAPE (PB)";"PB";"MAMANGUAPE";344;8;75;427
2010;"MANAIRA (PB)";"PB";"MANAIRA";10;7;2;19
2010;"MARCACAO (PB)";"PB";"MARCACAO";1;6;9;16
2010;"MARI (PB)";"PB";"MARI";82;5;39;126
2010;"MARIZOPOLIS (PB)";"PB";"MARIZOPOLIS";18;5;1;24
2010;"MASSARANDUBA (PB)";"PB";"MASSARANDUBA";22;7;6;35
2010;"MATARACA (PB)";"PB";"MATARACA";31;5;13;49
2010;"MATINHAS (PB)";"PB";"MATINHAS";9;2;1;12
2010;"MATO GROSSO (PB)";"PB";"MATO GROSSO";8;3;2;13
2010;"MATUREIA (PB)";"PB";"MATUREIA";15;13;2;30
2010;"MOGEIRO (PB)";"PB";"MOGEIRO";24;5;4;33
2010;"MONTADAS (PB)";"PB";"MONTADAS";20;3;4;27
2010;"MONTE HOREBE (PB)";"PB";"MONTE HOREBE";4;2;3;9
2010;"MONTEIRO (PB)";"PB";"MONTEIRO";218;60;31;309
2010;"MULUNGU (PB)";"PB";"MULUNGU";30;5;12;47
2010;"NATUBA (PB)";"PB";"NATUBA";9;1;3;13
2010;"NAZAREZINHO (PB)";"PB";"NAZAREZINHO";20;4;3;27
2010;"NOVA FLORESTA (PB)";"PB";"NOVA FLORESTA";36;8;6;50
2010;"NOVA OLINDA (PB)";"PB";"NOVA OLINDA";21;5;2;28
2010;"NOVA PALMEIRA (PB)";"PB";"NOVA PALMEIRA";14;1;3;18
2010;"OLHO D AGUA (PB)";"PB";"OLHO D AGUA";3;5;3;11
2010;"OLIVEDOS (PB)";"PB";"OLIVEDOS";23;3;8;34
2010;"OURO VELHO (PB)";"PB";"OURO VELHO";11;5;2;18
2010;"PARARI (PB)";"PB";"PARARI";3;0;0;3
2010;"PASSAGEM (PB)";"PB";"PASSAGEM";14;0;1;15
2010;"PATOS (PB)";"PB";"PATOS";712;118;46;876
2010;"PAULISTA (PB)";"PB";"PAULISTA";39;6;4;49
2010;"PEDRA BRANCA (PB)";"PB";"PEDRA BRANCA";4;3;4;11
2010;"PEDRA LAVRADA (PB)";"PB";"PEDRA LAVRADA";31;3;4;38
2010;"PEDRAS DE FOGO (PB)";"PB";"PEDRAS DE FOGO";227;17;58;302
2010;"PEDRO REGIS (PB)";"PB";"PEDRO REGIS";19;1;2;22
2010;"PIANCO (PB)";"PB";"PIANCO";74;15;3;92
2010;"PICUI (PB)";"PB";"PICUI";97;7;21;125
2010;"PILAR (PB)";"PB";"PILAR";22;1;11;34
2010;"PILOES (PB)";"PB";"PILOES";21;4;5;30
2010;"PILOEZINHOS (PB)";"PB";"PILOEZINHOS";10;3;3;16
2010;"PIRPIRITUBA (PB)";"PB";"PIRPIRITUBA";24;0;8;32
2010;"PITIMBU (PB)";"PB";"PITIMBU";17;13;6;36
2010;"POCINHOS (PB)";"PB";"POCINHOS";86;17;19;122
2010;"POCO DANTAS (PB)";"PB";"POCO DANTAS";2;1;2;5
2010;"POCO DE JOSE DE MOURA (PB)";"PB";"POCO DE JOSE DE MOURA";4;2;3;9
2010;"POMBAL (PB)";"PB";"POMBAL";234;23;10;267
2010;"PRATA (PB)";"PB";"PRATA";17;6;2;25
2010;"PRINCESA ISABEL (PB)";"PB";"PRINCESA ISABEL";74;64;7;145
2010;"PUXINANA (PB)";"PB";"PUXINANA";63;12;7;82
2010;"QUEIMADAS (PB)";"PB";"QUEIMADAS";355;98;86;539
2010;"QUIXABA (PB)";"PB";"QUIXABA";4;3;2;9
2010;"REMIGIO (PB)";"PB";"REMIGIO";184;5;17;206
2010;"RIACHAO (PB)";"PB";"RIACHAO";1;1;5;7
2010;"RIACHAO DO BACAMARTE (PB)";"PB";"RIACHAO DO BACAMARTE";8;0;3;11
2010;"RIACHAO DO POCO (PB)";"PB";"RIACHAO DO POCO";9;1;6;16
2010;"RIACHO DE SANTO ANTONIO (PB)";"PB";"RIACHO DE SANTO ANTONIO";9;6;4;19
2010;"RIACHO DOS CAVALOS (PB)";"PB";"RIACHO DOS CAVALOS";17;3;2;22
2010;"RIO TINTO (PB)";"PB";"RIO TINTO";70;4;26;100
2010;"SALGADINHO (PB)";"PB";"SALGADINHO";2;1;1;4
2010;"SALGADO DE SAO FELIX (PB)";"PB";"SALGADO DE SAO FELIX";16;4;2;22
2010;"SANTA CECILIA (PB)";"PB";"SANTA CECILIA";15;1;5;21
2010;"SANTA CRUZ (PB)";"PB";"SANTA CRUZ";11;4;6;21
2010;"SANTA HELENA (PB)";"PB";"SANTA HELENA";6;0;6;12
2010;"SANTA INES (PB)";"PB";"SANTA INES";9;2;0;11
2010;"SANTA LUZIA (PB)";"PB";"SANTA LUZIA";175;16;12;203
2010;"SANTA RITA (PB)";"PB";"SANTA RITA";583;47;205;835
2010;"SANTA TERESINHA (PB)";"PB";"SANTA TERESINHA";23;1;5;29
2010;"SANTANA DE MANGUEIRA (PB)";"PB";"SANTANA DE MANGUEIRA";3;0;1;4
2010;"SANTANA DOS GARROTES (PB)";"PB";"SANTANA DOS GARROTES";16;4;0;20
2010;"SANTAREM (PB)";"PB";"SANTAREM";2;0;2;4
2010;"SANTO ANDRE (PB)";"PB";"SANTO ANDRE";13;6;11;30
2010;"SAO BENTINHO (PB)";"PB";"SAO BENTINHO";14;3;1;18
2010;"SAO BENTO (PB)";"PB";"SAO BENTO";247;20;14;281
2010;"SAO DOMINGOS DE POMBAL (PB)";"PB";"SAO DOMINGOS DE POMBAL";3;3;2;8
2010;"SAO DOMINGOS DO CARIRI (PB)";"PB";"SAO DOMINGOS DO CARIRI";9;0;1;10
2010;"SAO FRANCISCO (PB)";"PB";"SAO FRANCISCO";10;0;4;14
2010;"SAO JOAO DO CARIRI (PB)";"PB";"SAO JOAO DO CARIRI";17;5;6;28
2010;"SAO JOAO DO RIO DO PEIXE (PB)";"PB";"SAO JOAO DO RIO DO PEIXE";36;3;16;55
2010;"SAO JOAO DO TIGRE (PB)";"PB";"SAO JOAO DO TIGRE";8;2;2;12
2010;"SAO JOSE DA LAGOA TAPADA (PB)";"PB";"SAO JOSE DA LAGOA TAPADA";10;4;4;18
2010;"SAO JOSE DE CAIANA (PB)";"PB";"SAO JOSE DE CAIANA";3;4;3;10
2010;"SAO JOSE DE ESPINHARAS (PB)";"PB";"SAO JOSE DE ESPINHARAS";13;2;3;18
2010;"SAO JOSE DE PIRANHAS (PB)";"PB";"SAO JOSE DE PIRANHAS";29;6;4;39
2010;"SAO JOSE DE PRINCESA (PB)";"PB";"SAO JOSE DE PRINCESA";3;2;1;6
2010;"SAO JOSE DO BONFIM (PB)";"PB";"SAO JOSE DO BONFIM";8;1;3;12
2010;"SAO JOSE DO BREJO DO CRUZ (PB)";"PB";"SAO JOSE DO BREJO DO CRUZ";1;1;1;3
2010;"SAO JOSE DO SABUGI (PB)";"PB";"SAO JOSE DO SABUGI";15;2;2;19
2010;"SAO JOSE DOS CORDEIROS (PB)";"PB";"SAO JOSE DOS CORDEIROS";6;3;3;12
2010;"SAO JOSE DOS RAMOS (PB)";"PB";"SAO JOSE DOS RAMOS";18;1;7;26
2010;"SAO MAMEDE (PB)";"PB";"SAO MAMEDE";17;1;3;21
2010;"SAO MIGUEL DE TAIPU (PB)";"PB";"SAO MIGUEL DE TAIPU";12;0;5;17
2010;"SAO SEBASTIAO DE LAGOA DE ROCA (PB)";"PB";"SAO SEBASTIAO DE LAGOA DE ROCA";51;12;5;68
2010;"SAO SEBASTIAO DO UMBUZEIRO (PB)";"PB";"SAO SEBASTIAO DO UMBUZEIRO";7;0;4;11
2010;"SAO VICENTE DO SERIDO (PB)";"PB";"SAO VICENTE DO SERIDO";11;6;4;21
2010;"SAPE (PB)";"PB";"SAPE";305;21;78;404
2010;"SERRA BRANCA (PB)";"PB";"SERRA BRANCA";71;18;8;97
2010;"SERRA DA RAIZ (PB)";"PB";"SERRA DA RAIZ";4;0;4;8
2010;"SERRA GRANDE (PB)";"PB";"SERRA GRANDE";3;0;2;5
2010;"SERRA REDONDA (PB)";"PB";"SERRA REDONDA";19;5;3;27
2010;"SERRARIA (PB)";"PB";"SERRARIA";14;6;5;25
2010;"SERTAOZINHO (PB)";"PB";"SERTAOZINHO";6;1;7;14
2010;"SOBRADO (PB)";"PB";"SOBRADO";37;3;5;45
2010;"SOLANEA (PB)";"PB";"SOLANEA";153;24;29;206
2010;"SOLEDADE (PB)";"PB";"SOLEDADE";115;16;13;144
2010;"SOSSEGO (PB)";"PB";"SOSSEGO";20;3;3;26
2010;"SOUSA (PB)";"PB";"SOUSA";606;30;50;686
2010;"SUME (PB)";"PB";"SUME";69;14;14;97
2010;"TAPEROA (PB)";"PB";"TAPEROA";62;9;2;73
2010;"TAVARES (PB)";"PB";"TAVARES";22;6;4;32
2010;"TEIXEIRA (PB)";"PB";"TEIXEIRA";81;9;15;105
2010;"TENORIO (PB)";"PB";"TENORIO";12;1;2;15
2010;"TRIUNFO (PB)";"PB";"TRIUNFO";9;3;2;14
2010;"UIRAUNA (PB)";"PB";"UIRAUNA";51;5;6;62
2010;"UMBUZEIRO (PB)";"PB";"UMBUZEIRO";59;29;23;111
2010;"VARZEA (PB)";"PB";"VARZEA";9;3;3;15
2010;"VIEIROPOLIS (PB)";"PB";"VIEIROPOLIS";11;1;6;18
2010;"VISTA SERRANA (PB)";"PB";"VISTA SERRANA";15;1;3;19
2010;"ZABELE (PB)";"PB";"ZABELE";6;1;0;7
2010;"ABREU E LIMA (PE)";"PE";"ABREU E LIMA";453;37;337;827
2010;"AFOGADOS DA INGAZEIRA (PE)";"PE";"AFOGADOS DA INGAZEIRA";276;28;37;341
2010;"AFRANIO (PE)";"PE";"AFRANIO";98;7;7;112
2010;"AGRESTINA (PE)";"PE";"AGRESTINA";140;24;23;187
2010;"AGUA PRETA (PE)";"PE";"AGUA PRETA";131;34;34;199
2010;"AGUAS BELAS (PE)";"PE";"AGUAS BELAS";237;52;35;324
2010;"ALAGOINHA (PE)";"PE";"ALAGOINHA";83;22;9;114
2010;"ALIANCA (PE)";"PE";"ALIANCA";118;10;92;220
2010;"ALTINHO (PE)";"PE";"ALTINHO";62;29;20;111
2010;"AMARAJI (PE)";"PE";"AMARAJI";67;20;27;114
2010;"ANGELIM (PE)";"PE";"ANGELIM";40;11;4;55
2010;"ARACOIABA (PE)";"PE";"ARACOIABA";66;9;63;138
2010;"ARARIPINA (PE)";"PE";"ARARIPINA";1121;29;53;1203
2010;"ARCOVERDE (PE)";"PE";"ARCOVERDE";881;83;95;1059
2010;"BARRA DE GUABIRABA (PE)";"PE";"BARRA DE GUABIRABA";59;15;8;82
2010;"BARREIROS (PE)";"PE";"BARREIROS";235;16;37;288
2010;"BELEM DE MARIA (PE)";"PE";"BELEM DE MARIA";61;12;11;84
2010;"BELEM DE SAO FRANCISCO (PE)";"PE";"BELEM DE SAO FRANCISCO";92;9;9;110
2010;"BELO JARDIM (PE)";"PE";"BELO JARDIM";564;116;55;735
2010;"BETANIA (PE)";"PE";"BETANIA";33;2;4;39
2010;"BEZERROS (PE)";"PE";"BEZERROS";609;76;44;729
2010;"BODOCO (PE)";"PE";"BODOCO";167;1;7;175
2010;"BOM CONSELHO (PE)";"PE";"BOM CONSELHO";248;36;26;310
2010;"BOM JARDIM (PE)";"PE";"BOM JARDIM";140;179;32;351
2010;"BONITO (PE)";"PE";"BONITO";287;54;19;360
2010;"BREJAO (PE)";"PE";"BREJAO";37;8;7;52
2010;"BREJINHO (PE)";"PE";"BREJINHO";25;3;2;30
2010;"BREJO DA MADRE DE DEUS (PE)";"PE";"BREJO DA MADRE DE DEUS";183;250;8;441
2010;"BUENOS AIRES (PE)";"PE";"BUENOS AIRES";52;2;11;65
2010;"BUIQUE (PE)";"PE";"BUIQUE";233;47;28;308
2010;"CABO DE SANTO AGOSTINHO (PE)";"PE";"CABO DE SANTO AGOSTINHO";1120;192;340;1652
2010;"CABROBO (PE)";"PE";"CABROBO";199;7;10;216
2010;"CACHOEIRINHA (PE)";"PE";"CACHOEIRINHA";123;27;7;157
2010;"CAETES (PE)";"PE";"CAETES";203;35;9;247
2010;"CALCADO (PE)";"PE";"CALCADO";50;5;17;72
2010;"CALUMBI (PE)";"PE";"CALUMBI";52;4;4;60
2010;"CAMARAGIBE (PE)";"PE";"CAMARAGIBE";666;212;97;975
2010;"CAMOCIM DE SAO FELIX (PE)";"PE";"CAMOCIM DE SAO FELIX";116;12;8;136
2010;"CAMUTANGA (PE)";"PE";"CAMUTANGA";72;0;14;86
2010;"CANHOTINHO (PE)";"PE";"CANHOTINHO";186;57;4;247
2010;"CAPOEIRAS (PE)";"PE";"CAPOEIRAS";182;27;3;212
2010;"CARNAIBA (PE)";"PE";"CARNAIBA";67;20;4;91
2010;"CARNAUBEIRA DA PENHA (PE)";"PE";"CARNAUBEIRA DA PENHA";35;3;0;38
2010;"CARPINA (PE)";"PE";"CARPINA";799;87;112;998
2010;"CARUARU (PE)";"PE";"CARUARU";3617;519;446;4582
2010;"CASINHAS (PE)";"PE";"CASINHAS";41;126;7;174
2010;"CATENDE (PE)";"PE";"CATENDE";171;39;42;252
2010;"CEDRO (PE)";"PE";"CEDRO";32;4;8;44
2010;"CHA DE ALEGRIA (PE)";"PE";"CHA DE ALEGRIA";40;11;20;71
2010;"CHA GRANDE (PE)";"PE";"CHA GRANDE";215;19;12;246
2010;"CONDADO (PE)";"PE";"CONDADO";117;7;58;182
2010;"CORRENTES (PE)";"PE";"CORRENTES";58;26;6;90
2010;"CORTES (PE)";"PE";"CORTES";149;29;25;203
2010;"CUMARU (PE)";"PE";"CUMARU";88;46;12;146
2010;"CUPIRA (PE)";"PE";"CUPIRA";214;43;14;271
2010;"CUSTODIA (PE)";"PE";"CUSTODIA";288;37;16;341
2010;"DORMENTES (PE)";"PE";"DORMENTES";125;3;6;134
2010;"ESCADA (PE)";"PE";"ESCADA";320;45;119;484
2010;"EXU (PE)";"PE";"EXU";287;5;21;313
2010;"FEIRA NOVA (PE)";"PE";"FEIRA NOVA";168;21;7;196
2010;"FERNANDO DE NORONHA (PE)";"PE";"FERNANDO DE NORONHA";18;21;9;48
2010;"FERREIROS (PE)";"PE";"FERREIROS";48;1;39;88
2010;"FLORES (PE)";"PE";"FLORES";57;11;2;70
2010;"FLORESTA (PE)";"PE";"FLORESTA";379;4;8;391
2010;"FREI MIGUELINHO (PE)";"PE";"FREI MIGUELINHO";120;128;15;263
2010;"GAMELEIRA (PE)";"PE";"GAMELEIRA";77;8;41;126
2010;"GARANHUNS (PE)";"PE";"GARANHUNS";1541;183;95;1819
2010;"GLORIA DO GOITA (PE)";"PE";"GLORIA DO GOITA";141;28;24;193
2010;"GOIANA (PE)";"PE";"GOIANA";639;51;122;812
2010;"GRANITO (PE)";"PE";"GRANITO";20;1;7;28
2010;"GRAVATA (PE)";"PE";"GRAVATA";796;78;46;920
2010;"IATI (PE)";"PE";"IATI";37;21;16;74
2010;"IBIMIRIM (PE)";"PE";"IBIMIRIM";168;25;4;197
2010;"IBIRAJUBA (PE)";"PE";"IBIRAJUBA";46;1;3;50
2010;"IGARASSU (PE)";"PE";"IGARASSU";726;46;490;1262
2010;"IGUARACI (PE)";"PE";"IGUARACI";77;10;21;108
2010;"ILHA DE ITAMARACA (PE)";"PE";"ILHA DE ITAMARACA";64;12;9;85
2010;"INAJA (PE)";"PE";"INAJA";42;4;4;50
2010;"INGAZEIRA (PE)";"PE";"INGAZEIRA";19;2;2;23
2010;"IPOJUCA (PE)";"PE";"IPOJUCA";522;207;165;894
2010;"IPUBI (PE)";"PE";"IPUBI";171;12;21;204
2010;"ITACURUBA (PE)";"PE";"ITACURUBA";16;2;5;23
2010;"ITAIBA (PE)";"PE";"ITAIBA";85;19;5;109
2010;"ITAMBE (PE)";"PE";"ITAMBE";312;10;101;423
2010;"ITAPETIM (PE)";"PE";"ITAPETIM";45;2;6;53
2010;"ITAPISSUMA (PE)";"PE";"ITAPISSUMA";57;33;12;102
2010;"ITAQUITINGA (PE)";"PE";"ITAQUITINGA";32;5;20;57
2010;"JABOATAO DOS GUARARAPES (PE)";"PE";"JABOATAO DOS GUARARAPES";4478;756;1719;6953
2010;"JAQUEIRA (PE)";"PE";"JAQUEIRA";55;4;16;75
2010;"JATAUBA (PE)";"PE";"JATAUBA";55;114;5;174
2010;"JATOBA (PE)";"PE";"JATOBA";26;3;5;34
2010;"JOAO ALFREDO (PE)";"PE";"JOAO ALFREDO";169;427;8;604
2010;"JOAQUIM NABUCO (PE)";"PE";"JOAQUIM NABUCO";92;14;37;143
2010;"JUCATI (PE)";"PE";"JUCATI";101;7;9;117
2010;"JUPI (PE)";"PE";"JUPI";142;18;16;176
2010;"JUREMA (PE)";"PE";"JUREMA";68;12;4;84
2010;"LAGOA DO CARRO (PE)";"PE";"LAGOA DO CARRO";75;10;10;95
2010;"LAGOA DO ITAENGA (PE)";"PE";"LAGOA DO ITAENGA";276;19;45;340
2010;"LAGOA DO OURO (PE)";"PE";"LAGOA DO OURO";38;17;5;60
2010;"LAGOA DOS GATOS (PE)";"PE";"LAGOA DOS GATOS";84;16;4;104
2010;"LAGOA GRANDE (PE)";"PE";"LAGOA GRANDE";85;6;10;101
2010;"LAJEDO (PE)";"PE";"LAJEDO";453;47;34;534
2010;"LIMOEIRO (PE)";"PE";"LIMOEIRO";426;87;45;558
2010;"MACAPARANA (PE)";"PE";"MACAPARANA";147;8;33;188
2010;"MACHADOS (PE)";"PE";"MACHADOS";89;24;8;121
2010;"MANARI (PE)";"PE";"MANARI";31;3;3;37
2010;"MARAIAL (PE)";"PE";"MARAIAL";128;4;13;145
2010;"MIRANDIBA (PE)";"PE";"MIRANDIBA";96;4;1;101
2010;"MOREILANDIA (PE)";"PE";"MOREILANDIA";36;3;2;41
2010;"MORENO (PE)";"PE";"MORENO";475;95;207;777
2010;"NAZARE DA MATA (PE)";"PE";"NAZARE DA MATA";192;12;35;239
2010;"OLINDA (PE)";"PE";"OLINDA";2491;312;1234;4037
2010;"OROBO (PE)";"PE";"OROBO";110;139;31;280
2010;"OROCO (PE)";"PE";"OROCO";51;1;5;57
2010;"OURICURI (PE)";"PE";"OURICURI";505;16;55;576
2010;"PALMARES (PE)";"PE";"PALMARES";480;49;151;680
2010;"PALMEIRINA (PE)";"PE";"PALMEIRINA";19;11;1;31
2010;"PANELAS (PE)";"PE";"PANELAS";82;27;7;116
2010;"PARANATAMA (PE)";"PE";"PARANATAMA";53;14;9;76
2010;"PARNAMIRIM (PE)";"PE";"PARNAMIRIM";132;3;12;147
2010;"PASSIRA (PE)";"PE";"PASSIRA";195;54;19;268
2010;"PAUDALHO (PE)";"PE";"PAUDALHO";442;19;45;506
2010;"PAULISTA (PE)";"PE";"PAULISTA";1222;208;258;1688
2010;"PEDRA (PE)";"PE";"PEDRA";97;22;8;127
2010;"PESQUEIRA (PE)";"PE";"PESQUEIRA";528;51;86;665
2010;"PETROLANDIA (PE)";"PE";"PETROLANDIA";191;2;30;223
2010;"PETROLINA (PE)";"PE";"PETROLINA";2664;201;294;3159
2010;"POCAO (PE)";"PE";"POCAO";40;19;3;62
2010;"POMBOS (PE)";"PE";"POMBOS";372;40;31;443
2010;"PRIMAVERA (PE)";"PE";"PRIMAVERA";73;8;36;117
2010;"QUIPAPA (PE)";"PE";"QUIPAPA";76;13;31;120
2010;"QUIXABA (PE)";"PE";"QUIXABA";23;3;2;28
2010;"RECIFE (PE)";"PE";"RECIFE";16084;1809;3486;21379
2010;"RIACHO DAS ALMAS (PE)";"PE";"RIACHO DAS ALMAS";209;68;17;294
2010;"RIBEIRAO (PE)";"PE";"RIBEIRAO";249;35;77;361
2010;"RIO FORMOSO (PE)";"PE";"RIO FORMOSO";103;15;52;170
2010;"SAIRE (PE)";"PE";"SAIRE";69;6;20;95
2010;"SALGADINHO (PE)";"PE";"SALGADINHO";11;22;3;36
2010;"SALGUEIRO (PE)";"PE";"SALGUEIRO";455;25;44;524
2010;"SALOA (PE)";"PE";"SALOA";58;17;3;78
2010;"SANHARO (PE)";"PE";"SANHARO";78;9;21;108
2010;"SANTA CRUZ (PE)";"PE";"SANTA CRUZ";109;3;9;121
2010;"SANTA CRUZ DA BAIXA VERDE (PE)";"PE";"SANTA CRUZ DA BAIXA VERDE";188;4;4;196
2010;"SANTA CRUZ DO CAPIBARIBE (PE)";"PE";"SANTA CRUZ DO CAPIBARIBE";641;314;38;993
2010;"SANTA FILOMENA (PE)";"PE";"SANTA FILOMENA";54;0;13;67
2010;"SANTA MARIA DA BOA VISTA (PE)";"PE";"SANTA MARIA DA BOA VISTA";162;5;33;200
2010;"SANTA MARIA DO CAMBUCA (PE)";"PE";"SANTA MARIA DO CAMBUCA";127;92;11;230
2010;"SANTA TEREZINHA (PE)";"PE";"SANTA TEREZINHA";35;4;5;44
2010;"SAO BENEDITO DO SUL (PE)";"PE";"SAO BENEDITO DO SUL";27;5;7;39
2010;"SAO BENTO DO UNA (PE)";"PE";"SAO BENTO DO UNA";614;34;60;708
2010;"SAO CAITANO (PE)";"PE";"SAO CAITANO";242;86;33;361
2010;"SAO JOAO (PE)";"PE";"SAO JOAO";93;23;9;125
2010;"SAO JOAQUIM DO MONTE (PE)";"PE";"SAO JOAQUIM DO MONTE";61;16;14;91
2010;"SAO JOSE DA COROA GRANDE (PE)";"PE";"SAO JOSE DA COROA GRANDE";54;8;17;79
2010;"SAO JOSE DO BELMONTE (PE)";"PE";"SAO JOSE DO BELMONTE";229;15;18;262
2010;"SAO JOSE DO EGITO (PE)";"PE";"SAO JOSE DO EGITO";409;33;49;491
2010;"SAO LOURENCO DA MATA (PE)";"PE";"SAO LOURENCO DA MATA";311;33;305;649
2010;"SAO VICENTE FERRER (PE)";"PE";"SAO VICENTE FERRER";117;8;12;137
2010;"SERRA TALHADA (PE)";"PE";"SERRA TALHADA";1303;43;41;1387
2010;"SERRITA (PE)";"PE";"SERRITA";83;6;6;95
2010;"SERTANIA (PE)";"PE";"SERTANIA";328;19;34;381
2010;"SIRINHAEM (PE)";"PE";"SIRINHAEM";187;7;59;253
2010;"SOLIDAO (PE)";"PE";"SOLIDAO";21;2;1;24
2010;"SURUBIM (PE)";"PE";"SURUBIM";578;485;39;1102
2010;"TABIRA (PE)";"PE";"TABIRA";177;16;17;210
2010;"TACAIMBO (PE)";"PE";"TACAIMBO";68;11;15;94
2010;"TACARATU (PE)";"PE";"TACARATU";45;9;6;60
2010;"TAMANDARE (PE)";"PE";"TAMANDARE";53;12;14;79
2010;"TAQUARITINGA DO NORTE (PE)";"PE";"TAQUARITINGA DO NORTE";141;82;10;233
2010;"TEREZINHA (PE)";"PE";"TEREZINHA";24;3;4;31
2010;"TERRA NOVA (PE)";"PE";"TERRA NOVA";77;0;4;81
2010;"TIMBAUBA (PE)";"PE";"TIMBAUBA";615;29;93;737
2010;"TORITAMA (PE)";"PE";"TORITAMA";183;56;20;259
2010;"TRACUNHAEM (PE)";"PE";"TRACUNHAEM";45;13;16;74
2010;"TRINDADE (PE)";"PE";"TRINDADE";278;17;8;303
2010;"TRIUNFO (PE)";"PE";"TRIUNFO";161;11;6;178
2010;"TUPANATINGA (PE)";"PE";"TUPANATINGA";109;24;5;138
2010;"TUPARETAMA (PE)";"PE";"TUPARETAMA";84;16;16;116
2010;"VENTUROSA (PE)";"PE";"VENTUROSA";117;22;7;146
2010;"VERDEJANTE (PE)";"PE";"VERDEJANTE";52;3;11;66
2010;"VERTENTE DO LERIO (PE)";"PE";"VERTENTE DO LERIO";63;70;7;140
2010;"VERTENTES (PE)";"PE";"VERTENTES";112;64;17;193
2010;"VICENCIA (PE)";"PE";"VICENCIA";224;9;59;292
2010;"VITORIA DE SANTO ANTAO (PE)";"PE";"VITORIA DE SANTO ANTAO";1904;83;255;2242
2010;"XEXEU (PE)";"PE";"XEXEU";52;3;30;85
2010;"ACAUA (PI)";"PI";"ACAUA";13;2;1;16
2010;"AGRICOLANDIA (PI)";"PI";"AGRICOLANDIA";10;0;7;17
2010;"AGUA BRANCA (PI)";"PI";"AGUA BRANCA";90;12;7;109
2010;"ALAGOINHA DO PIAUI (PI)";"PI";"ALAGOINHA DO PIAUI";17;1;3;21
2010;"ALEGRETE DO PIAUI (PI)";"PI";"ALEGRETE DO PIAUI";4;1;1;6
2010;"ALTO LONGA (PI)";"PI";"ALTO LONGA";26;4;10;40
2010;"ALTOS (PI)";"PI";"ALTOS";178;5;20;203
2010;"ALVORADA DO GURGUEIA (PI)";"PI";"ALVORADA DO GURGUEIA";12;3;3;18
2010;"AMARANTE (PI)";"PI";"AMARANTE";49;7;8;64
2010;"ANGICAL DO PIAUI (PI)";"PI";"ANGICAL DO PIAUI";13;0;1;14
2010;"ANISIO DE ABREU (PI)";"PI";"ANISIO DE ABREU";8;7;5;20
2010;"ANTONIO ALMEIDA (PI)";"PI";"ANTONIO ALMEIDA";13;2;2;17
2010;"AROAZES (PI)";"PI";"AROAZES";12;3;5;20
2010;"AROEIRAS DO ITAIM (PI)";"PI";"AROEIRAS DO ITAIM";8;0;5;13
2010;"ARRAIAL (PI)";"PI";"ARRAIAL";4;0;2;6
2010;"ASSUNCAO DO PIAUI (PI)";"PI";"ASSUNCAO DO PIAUI";2;0;2;4
2010;"AVELINO LOPES (PI)";"PI";"AVELINO LOPES";11;4;2;17
2010;"BAIXA GRANDE DO RIBEIRO (PI)";"PI";"BAIXA GRANDE DO RIBEIRO";26;0;2;28
2010;"BARRA D ALCANTARA (PI)";"PI";"BARRA D ALCANTARA";16;1;1;18
2010;"BARRAS (PI)";"PI";"BARRAS";91;8;25;124
2010;"BARREIRAS DO PIAUI (PI)";"PI";"BARREIRAS DO PIAUI";4;0;0;4
2010;"BARRO DURO (PI)";"PI";"BARRO DURO";37;3;2;42
2010;"BATALHA (PI)";"PI";"BATALHA";55;2;6;63
2010;"BELA VISTA DO PIAUI (PI)";"PI";"BELA VISTA DO PIAUI";3;1;2;6
2010;"BELEM DO PIAUI (PI)";"PI";"BELEM DO PIAUI";2;0;0;2
2010;"BENEDITINOS (PI)";"PI";"BENEDITINOS";16;1;6;23
2010;"BERTOLINIA (PI)";"PI";"BERTOLINIA";13;2;1;16
2010;"BETANIA DO PIAUI (PI)";"PI";"BETANIA DO PIAUI";7;4;2;13
2010;"BOA HORA (PI)";"PI";"BOA HORA";9;0;3;12
2010;"BOCAINA (PI)";"PI";"BOCAINA";6;4;1;11
2010;"BOM JESUS (PI)";"PI";"BOM JESUS";147;0;10;157
2010;"BOM PRINCIPIO DO PIAUI (PI)";"PI";"BOM PRINCIPIO DO PIAUI";5;4;3;12
2010;"BONFIM DO PIAUI (PI)";"PI";"BONFIM DO PIAUI";5;2;3;10
2010;"BOQUEIRAO DO PIAUI (PI)";"PI";"BOQUEIRAO DO PIAUI";7;0;1;8
2010;"BRASILEIRA (PI)";"PI";"BRASILEIRA";13;0;4;17
2010;"BREJO DO PIAUI (PI)";"PI";"BREJO DO PIAUI";6;4;0;10
2010;"BURITI DOS LOPES (PI)";"PI";"BURITI DOS LOPES";24;4;11;39
2010;"BURITI DOS MONTES (PI)";"PI";"BURITI DOS MONTES";10;3;2;15
2010;"CABECEIRAS DO PIAUI (PI)";"PI";"CABECEIRAS DO PIAUI";9;1;11;21
2010;"CAJAZEIRAS DO PIAUI (PI)";"PI";"CAJAZEIRAS DO PIAUI";2;0;0;2
2010;"CAJUEIRO DA PRAIA (PI)";"PI";"CAJUEIRO DA PRAIA";6;2;5;13
2010;"CALDEIRAO GRANDE DO PIAUI (PI)";"PI";"CALDEIRAO GRANDE DO PIAUI";6;3;2;11
2010;"CAMPINAS DO PIAUI (PI)";"PI";"CAMPINAS DO PIAUI";1;0;1;2
2010;"CAMPO ALEGRE DO FIDALGO (PI)";"PI";"CAMPO ALEGRE DO FIDALGO";1;1;1;3
2010;"CAMPO GRANDE DO PIAUI (PI)";"PI";"CAMPO GRANDE DO PIAUI";21;3;0;24
2010;"CAMPO LARGO DO PIAUI (PI)";"PI";"CAMPO LARGO DO PIAUI";2;2;0;4
2010;"CAMPO MAIOR (PI)";"PI";"CAMPO MAIOR";326;16;51;393
2010;"CANAVIEIRA (PI)";"PI";"CANAVIEIRA";0;0;0;0
2010;"CANTO DO BURITI (PI)";"PI";"CANTO DO BURITI";78;11;6;95
2010;"CAPITAO DE CAMPOS (PI)";"PI";"CAPITAO DE CAMPOS";14;1;8;23
2010;"CAPITAO GERVASIO OLIVEIRA (PI)";"PI";"CAPITAO GERVASIO OLIVEIRA";1;0;3;4
2010;"CARACOL (PI)";"PI";"CARACOL";23;3;1;27
2010;"CARAUBAS DO PIAUI (PI)";"PI";"CARAUBAS DO PIAUI";9;1;2;12
2010;"CARIDADE DO PIAUI (PI)";"PI";"CARIDADE DO PIAUI";4;1;2;7
2010;"CASTELO DO PIAUI (PI)";"PI";"CASTELO DO PIAUI";56;2;4;62
2010;"CAXINGO (PI)";"PI";"CAXINGO";7;1;4;12
2010;"COCAL (PI)";"PI";"COCAL";36;7;9;52
2010;"COCAL DE TELHA (PI)";"PI";"COCAL DE TELHA";6;1;2;9
2010;"COCAL DOS ALVES (PI)";"PI";"COCAL DOS ALVES";1;3;0;4
2010;"COIVARAS (PI)";"PI";"COIVARAS";6;0;4;10
2010;"COLONIA DO GURGUEIA (PI)";"PI";"COLONIA DO GURGUEIA";4;4;1;9
2010;"COLONIA DO PIAUI (PI)";"PI";"COLONIA DO PIAUI";6;1;2;9
2010;"CONCEICAO DO CANINDE (PI)";"PI";"CONCEICAO DO CANINDE";8;1;0;9
2010;"CORONEL JOSE DIAS (PI)";"PI";"CORONEL JOSE DIAS";4;1;0;5
2010;"CORRENTE (PI)";"PI";"CORRENTE";66;5;4;75
2010;"CRISTALANDIA DO PIAUI (PI)";"PI";"CRISTALANDIA DO PIAUI";4;0;2;6
2010;"CRISTINO CASTRO (PI)";"PI";"CRISTINO CASTRO";23;3;7;33
2010;"CURIMATA (PI)";"PI";"CURIMATA";8;1;1;10
2010;"CURRAIS (PI)";"PI";"CURRAIS";0;1;0;1
2010;"CURRAL NOVO DO PIAUI (PI)";"PI";"CURRAL NOVO DO PIAUI";0;1;1;2
2010;"CURRALINHOS (PI)";"PI";"CURRALINHOS";4;0;2;6
2010;"DEMERVAL LOBAO (PI)";"PI";"DEMERVAL LOBAO";46;7;3;56
2010;"DIRCEU ARCOVERDE (PI)";"PI";"DIRCEU ARCOVERDE";6;1;2;9
2010;"DOM EXPEDITO LOPES (PI)";"PI";"DOM EXPEDITO LOPES";66;3;2;71
2010;"DOM INOCENCIO (PI)";"PI";"DOM INOCENCIO";13;2;3;18
2010;"DOMINGOS MOURAO (PI)";"PI";"DOMINGOS MOURAO";1;0;2;3
2010;"ELESBAO VELOSO (PI)";"PI";"ELESBAO VELOSO";53;1;6;60
2010;"ELISEU MARTINS (PI)";"PI";"ELISEU MARTINS";7;1;1;9
2010;"ESPERANTINA (PI)";"PI";"ESPERANTINA";136;13;25;174
2010;"FARTURA DO PIAUI (PI)";"PI";"FARTURA DO PIAUI";4;0;1;5
2010;"FLORES DO PIAUI (PI)";"PI";"FLORES DO PIAUI";2;2;0;4
2010;"FLORESTA DO PIAUI (PI)";"PI";"FLORESTA DO PIAUI";3;1;2;6
2010;"FLORIANO (PI)";"PI";"FLORIANO";972;60;37;1069
2010;"FRANCINOPOLIS (PI)";"PI";"FRANCINOPOLIS";9;4;0;13
2010;"FRANCISCO AYRES (PI)";"PI";"FRANCISCO AYRES";5;6;4;15
2010;"FRANCISCO MACEDO (PI)";"PI";"FRANCISCO MACEDO";2;3;2;7
2010;"FRANCISCO SANTOS (PI)";"PI";"FRANCISCO SANTOS";54;8;3;65
2010;"FRONTEIRAS (PI)";"PI";"FRONTEIRAS";49;7;11;67
2010;"GEMINIANO (PI)";"PI";"GEMINIANO";16;5;8;29
2010;"GILBUES (PI)";"PI";"GILBUES";8;1;4;13
2010;"GUADALUPE (PI)";"PI";"GUADALUPE";54;6;5;65
2010;"GUARIBAS (PI)";"PI";"GUARIBAS";1;0;1;2
2010;"HUGO NAPOLEAO (PI)";"PI";"HUGO NAPOLEAO";6;1;1;8
2010;"ILHA GRANDE (PI)";"PI";"ILHA GRANDE";13;2;2;17
2010;"INHUMA (PI)";"PI";"INHUMA";59;5;10;74
2010;"IPIRANGA DO PIAUI (PI)";"PI";"IPIRANGA DO PIAUI";45;11;3;59
2010;"ISAIAS COELHO (PI)";"PI";"ISAIAS COELHO";5;0;2;7
2010;"ITAINOPOLIS (PI)";"PI";"ITAINOPOLIS";28;20;8;56
2010;"ITAUEIRA (PI)";"PI";"ITAUEIRA";30;4;1;35
2010;"JACOBINA DO PIAUI (PI)";"PI";"JACOBINA DO PIAUI";15;2;1;18
2010;"JAICOS (PI)";"PI";"JAICOS";71;9;4;84
2010;"JARDIM DO MULATO (PI)";"PI";"JARDIM DO MULATO";3;1;0;4
2010;"JATOBA DO PIAUI (PI)";"PI";"JATOBA DO PIAUI";25;0;4;29
2010;"JERUMENHA (PI)";"PI";"JERUMENHA";8;1;0;9
2010;"JOAO COSTA (PI)";"PI";"JOAO COSTA";2;0;0;2
2010;"JOAQUIM PIRES (PI)";"PI";"JOAQUIM PIRES";17;0;1;18
2010;"JOCA MARQUES (PI)";"PI";"JOCA MARQUES";3;0;3;6
2010;"JOSE DE FREITAS (PI)";"PI";"JOSE DE FREITAS";67;8;17;92
2010;"JUAZEIRO DO PIAUI (PI)";"PI";"JUAZEIRO DO PIAUI";7;1;0;8
2010;"JULIO BORGES (PI)";"PI";"JULIO BORGES";1;1;1;3
2010;"JUREMA (PI)";"PI";"JUREMA";5;3;1;9
2010;"LAGOA ALEGRE (PI)";"PI";"LAGOA ALEGRE";6;1;6;13
2010;"LAGOA DE SAO FRANCISCO (PI)";"PI";"LAGOA DE SAO FRANCISCO";4;0;0;4
2010;"LAGOA DO BARRO DO PIAUI (PI)";"PI";"LAGOA DO BARRO DO PIAUI";1;0;6;7
2010;"LAGOA DO PIAUI (PI)";"PI";"LAGOA DO PIAUI";10;0;0;10
2010;"LAGOA DO SITIO (PI)";"PI";"LAGOA DO SITIO";9;1;1;11
2010;"LAGOINHA DO PIAUI (PI)";"PI";"LAGOINHA DO PIAUI";4;2;3;9
2010;"LANDRI SALES (PI)";"PI";"LANDRI SALES";4;4;1;9
2010;"LUIS CORREIA (PI)";"PI";"LUIS CORREIA";30;11;17;58
2010;"LUZILANDIA (PI)";"PI";"LUZILANDIA";28;1;8;37
2010;"MADEIRO (PI)";"PI";"MADEIRO";4;2;2;8
2010;"MANOEL EMIDIO (PI)";"PI";"MANOEL EMIDIO";5;1;3;9
2010;"MARCOLANDIA (PI)";"PI";"MARCOLANDIA";55;14;5;74
2010;"MARCOS PARENTE (PI)";"PI";"MARCOS PARENTE";4;3;0;7
2010;"MASSAPE DO PIAUI (PI)";"PI";"MASSAPE DO PIAUI";2;1;1;4
2010;"MATIAS OLIMPIO (PI)";"PI";"MATIAS OLIMPIO";13;5;5;23
2010;"MIGUEL ALVES (PI)";"PI";"MIGUEL ALVES";28;1;8;37
2010;"MIGUEL LEAO (PI)";"PI";"MIGUEL LEAO";3;0;1;4
2010;"MILTON BRANDAO (PI)";"PI";"MILTON BRANDAO";6;0;1;7
2010;"MONSENHOR GIL (PI)";"PI";"MONSENHOR GIL";16;1;1;18
2010;"MONSENHOR HIPOLITO (PI)";"PI";"MONSENHOR HIPOLITO";15;11;1;27
2010;"MONTE ALEGRE DO PIAUI (PI)";"PI";"MONTE ALEGRE DO PIAUI";5;1;2;8
2010;"MORRO CABECA NO TEMPO (PI)";"PI";"MORRO CABECA NO TEMPO";0;0;0;0
2010;"MORRO DO CHAPEU DO PIAUI (PI)";"PI";"MORRO DO CHAPEU DO PIAUI";3;0;2;5
2010;"MURICI DOS PORTELAS (PI)";"PI";"MURICI DOS PORTELAS";4;1;1;6
2010;"NAZARE DO PIAUI (PI)";"PI";"NAZARE DO PIAUI";12;11;2;25
2010;"NAZARIA (PI)";"PI";"NAZARIA";2;0;0;2
2010;"NOSSA SENHORA DE NAZARE (PI)";"PI";"NOSSA SENHORA DE NAZARE";6;0;4;10
2010;"NOSSA SENHORA DOS REMEDIOS (PI)";"PI";"NOSSA SENHORA DOS REMEDIOS";3;4;0;7
2010;"NOVA SANTA RITA (PI)";"PI";"NOVA SANTA RITA";1;3;0;4
2010;"NOVO ORIENTE DO PIAUI (PI)";"PI";"NOVO ORIENTE DO PIAUI";12;3;5;20
2010;"NOVO SANTO ANTONIO (PI)";"PI";"NOVO SANTO ANTONIO";8;2;2;12
2010;"OEIRAS (PI)";"PI";"OEIRAS";263;29;29;321
2010;"OLHO D AGUA DO PIAUI (PI)";"PI";"OLHO D AGUA DO PIAUI";3;1;2;6
2010;"PADRE MARCOS (PI)";"PI";"PADRE MARCOS";9;3;1;13
2010;"PAES LANDIM (PI)";"PI";"PAES LANDIM";4;1;0;5
2010;"PAJEU DO PIAUI (PI)";"PI";"PAJEU DO PIAUI";7;2;0;9
2010;"PALMEIRA DO PIAUI (PI)";"PI";"PALMEIRA DO PIAUI";19;1;1;21
2010;"PALMEIRAIS (PI)";"PI";"PALMEIRAIS";12;3;4;19
2010;"PAQUETA (PI)";"PI";"PAQUETA";4;7;3;14
2010;"PARNAGUA (PI)";"PI";"PARNAGUA";5;1;1;7
2010;"PARNAIBA (PI)";"PI";"PARNAIBA";862;95;190;1147
2010;"PASSAGEM FRANCA DO PIAUI (PI)";"PI";"PASSAGEM FRANCA DO PIAUI";2;0;1;3
2010;"PATOS DO PIAUI (PI)";"PI";"PATOS DO PIAUI";11;2;6;19
2010;"PAU D ARCO DO PIAUI (PI)";"PI";"PAU D ARCO DO PIAUI";3;0;2;5
2010;"PAULISTANA (PI)";"PI";"PAULISTANA";91;11;8;110
2010;"PAVUSSU (PI)";"PI";"PAVUSSU";3;3;0;6
2010;"PEDRO II (PI)";"PI";"PEDRO II";66;7;3;76
2010;"PEDRO LAURENTINO (PI)";"PI";"PEDRO LAURENTINO";2;0;0;2
2010;"PICOS (PI)";"PI";"PICOS";1431;106;66;1603
2010;"PIMENTEIRAS (PI)";"PI";"PIMENTEIRAS";27;6;1;34
2010;"PIO IX (PI)";"PI";"PIO IX";22;6;3;31
2010;"PIRACURUCA (PI)";"PI";"PIRACURUCA";160;9;25;194
2010;"PIRIPIRI (PI)";"PI";"PIRIPIRI";275;26;75;376
2010;"PORTO (PI)";"PI";"PORTO";3;3;0;6
2010;"PORTO ALEGRE DO PIAUI (PI)";"PI";"PORTO ALEGRE DO PIAUI";5;3;1;9
2010;"PRATA DO PIAUI (PI)";"PI";"PRATA DO PIAUI";5;1;1;7
2010;"QUEIMADA NOVA (PI)";"PI";"QUEIMADA NOVA";6;1;3;10
2010;"REDENCAO DO GURGUEIA (PI)";"PI";"REDENCAO DO GURGUEIA";9;0;7;16
2010;"REGENERACAO (PI)";"PI";"REGENERACAO";59;7;7;73
2010;"RIACHO FRIO (PI)";"PI";"RIACHO FRIO";2;1;1;4
2010;"RIBEIRA DO PIAUI (PI)";"PI";"RIBEIRA DO PIAUI";3;1;1;5
2010;"RIBEIRO GONCALVES (PI)";"PI";"RIBEIRO GONCALVES";13;0;0;13
2010;"RIO GRANDE DO PIAUI (PI)";"PI";"RIO GRANDE DO PIAUI";14;6;2;22
2010;"SANTA CRUZ DO PIAUI (PI)";"PI";"SANTA CRUZ DO PIAUI";14;8;0;22
2010;"SANTA CRUZ DOS MILAGRES (PI)";"PI";"SANTA CRUZ DOS MILAGRES";3;0;1;4
2010;"SANTA FILOMENA (PI)";"PI";"SANTA FILOMENA";7;1;1;9
2010;"SANTA LUZ (PI)";"PI";"SANTA LUZ";6;1;2;9
2010;"SANTA ROSA DO PIAUI (PI)";"PI";"SANTA ROSA DO PIAUI";6;3;4;13
2010;"SANTANA DO PIAUI (PI)";"PI";"SANTANA DO PIAUI";19;8;5;32
2010;"SANTO ANTONIO DE LISBOA (PI)";"PI";"SANTO ANTONIO DE LISBOA";29;9;4;42
2010;"SANTO ANTONIO DOS MILAGRES (PI)";"PI";"SANTO ANTONIO DOS MILAGRES";1;3;0;4
2010;"SANTO INACIO DO PIAUI (PI)";"PI";"SANTO INACIO DO PIAUI";2;3;0;5
2010;"SAO BRAZ DO PIAUI (PI)";"PI";"SAO BRAZ DO PIAUI";2;1;1;4
2010;"SAO FELIX DO PIAUI (PI)";"PI";"SAO FELIX DO PIAUI";6;1;0;7
2010;"SAO FRANCISCO DE ASSIS DO PIAU (PI)";"PI";"SAO FRANCISCO DE ASSIS DO PIAU";0;0;0;0
2010;"SAO FRANCISCO DO PIAUI (PI)";"PI";"SAO FRANCISCO DO PIAUI";5;1;2;8
2010;"SAO GONCALO DO GURGUEIA (PI)";"PI";"SAO GONCALO DO GURGUEIA";1;1;0;2
2010;"SAO GONCALO DO PIAUI (PI)";"PI";"SAO GONCALO DO PIAUI";5;5;4;14
2010;"SAO JOAO DA CANABRAVA (PI)";"PI";"SAO JOAO DA CANABRAVA";9;5;3;17
2010;"SAO JOAO DA FRONTEIRA (PI)";"PI";"SAO JOAO DA FRONTEIRA";2;1;3;6
2010;"SAO JOAO DA SERRA (PI)";"PI";"SAO JOAO DA SERRA";6;0;0;6
2010;"SAO JOAO DA VARJOTA (PI)";"PI";"SAO JOAO DA VARJOTA";2;3;2;7
2010;"SAO JOAO DO ARRAIAL (PI)";"PI";"SAO JOAO DO ARRAIAL";7;1;1;9
2010;"SAO JOAO DO PIAUI (PI)";"PI";"SAO JOAO DO PIAUI";67;8;9;84
2010;"SAO JOSE DO DIVINO (PI)";"PI";"SAO JOSE DO DIVINO";8;1;1;10
2010;"SAO JOSE DO PEIXE (PI)";"PI";"SAO JOSE DO PEIXE";1;1;1;3
2010;"SAO JOSE DO PIAUI (PI)";"PI";"SAO JOSE DO PIAUI";20;10;3;33
2010;"SAO JULIAO (PI)";"PI";"SAO JULIAO";8;8;3;19
2010;"SAO LOURENCO DO PIAUI (PI)";"PI";"SAO LOURENCO DO PIAUI";0;0;1;1
2010;"SAO LUIS DO PIAUI (PI)";"PI";"SAO LUIS DO PIAUI";4;4;0;8
2010;"SAO MIGUEL DA BAIXA GRANDE (PI)";"PI";"SAO MIGUEL DA BAIXA GRANDE";8;1;1;10
2010;"SAO MIGUEL DO FIDALGO (PI)";"PI";"SAO MIGUEL DO FIDALGO";1;1;1;3
2010;"SAO MIGUEL DO TAPUIO (PI)";"PI";"SAO MIGUEL DO TAPUIO";12;0;5;17
2010;"SAO PEDRO DO PIAUI (PI)";"PI";"SAO PEDRO DO PIAUI";27;1;2;30
2010;"SAO RAIMUNDO NONATO (PI)";"PI";"SAO RAIMUNDO NONATO";170;7;21;198
2010;"SEBASTIAO BARROS (PI)";"PI";"SEBASTIAO BARROS";1;2;0;3
2010;"SEBASTIAO LEAL (PI)";"PI";"SEBASTIAO LEAL";11;1;1;13
2010;"SIGEFREDO PACHECO (PI)";"PI";"SIGEFREDO PACHECO";21;3;1;25
2010;"SIMOES (PI)";"PI";"SIMOES";32;4;1;37
2010;"SIMPLICIO MENDES (PI)";"PI";"SIMPLICIO MENDES";42;6;5;53
2010;"SOCORRO DO PIAUI (PI)";"PI";"SOCORRO DO PIAUI";2;0;1;3
2010;"SUSSUAPARA (PI)";"PI";"SUSSUAPARA";20;12;4;36
2010;"TAMBORIL DO PIAUI (PI)";"PI";"TAMBORIL DO PIAUI";2;0;1;3
2010;"TANQUE DO PIAUI (PI)";"PI";"TANQUE DO PIAUI";5;1;2;8
2010;"TERESINA (PI)";"PI";"TERESINA";9109;813;2225;12147
2010;"UNIAO (PI)";"PI";"UNIAO";86;23;31;140
2010;"URUCUI (PI)";"PI";"URUCUI";102;7;6;115
2010;"VALENCA DO PIAUI (PI)";"PI";"VALENCA DO PIAUI";104;21;11;136
2010;"VARZEA BRANCA (PI)";"PI";"VARZEA BRANCA";2;0;6;8
2010;"VARZEA GRANDE (PI)";"PI";"VARZEA GRANDE";7;4;0;11
2010;"VERA MENDES (PI)";"PI";"VERA MENDES";6;4;0;10
2010;"VILA NOVA DO PIAUI (PI)";"PI";"VILA NOVA DO PIAUI";7;5;2;14
2010;"WALL FERRAZ (PI)";"PI";"WALL FERRAZ";5;6;1;12
2010;"ABATIA (PR)";"PR";"ABATIA";108;2;35;145
2010;"ADRIANOPOLIS (PR)";"PR";"ADRIANOPOLIS";114;4;15;133
2010;"AGUDOS DO SUL (PR)";"PR";"AGUDOS DO SUL";308;10;17;335
2010;"ALMIRANTE TAMANDARE (PR)";"PR";"ALMIRANTE TAMANDARE";1219;65;206;1490
2010;"ALTAMIRA DO PARANA (PR)";"PR";"ALTAMIRA DO PARANA";41;3;9;53
2010;"ALTO PARAISO (PR)";"PR";"ALTO PARAISO";34;6;10;50
2010;"ALTO PARANA (PR)";"PR";"ALTO PARANA";233;10;70;313
2010;"ALTO PIQUIRI (PR)";"PR";"ALTO PIQUIRI";177;4;35;216
2010;"ALTONIA (PR)";"PR";"ALTONIA";398;15;37;450
2010;"ALVORADA DO SUL (PR)";"PR";"ALVORADA DO SUL";250;9;48;307
2010;"AMAPORA (PR)";"PR";"AMAPORA";73;4;37;114
2010;"AMPERE (PR)";"PR";"AMPERE";378;10;28;416
2010;"ANAHY (PR)";"PR";"ANAHY";64;2;6;72
2010;"ANDIRA (PR)";"PR";"ANDIRA";481;14;79;574
2010;"ANGULO (PR)";"PR";"ANGULO";60;1;6;67
2010;"ANTONINA (PR)";"PR";"ANTONINA";84;13;27;124
2010;"ANTONIO OLINTO (PR)";"PR";"ANTONIO OLINTO";131;3;24;158
2010;"APUCARANA (PR)";"PR";"APUCARANA";2247;262;276;2785
2010;"ARAPONGAS (PR)";"PR";"ARAPONGAS";3047;161;98;3306
2010;"ARAPOTI (PR)";"PR";"ARAPOTI";475;29;58;562
2010;"ARAPUA (PR)";"PR";"ARAPUA";75;4;18;97
2010;"ARARUNA (PR)";"PR";"ARARUNA";343;11;25;379
2010;"ARAUCARIA (PR)";"PR";"ARAUCARIA";2735;313;686;3734
2010;"ARIRANHA DO IVAI (PR)";"PR";"ARIRANHA DO IVAI";41;3;13;57
2010;"ASSAI (PR)";"PR";"ASSAI";438;21;35;494
2010;"ASSIS CHATEAUBRIAND (PR)";"PR";"ASSIS CHATEAUBRIAND";1029;35;63;1127
2010;"ASTORGA (PR)";"PR";"ASTORGA";564;34;84;682
2010;"ATALAIA (PR)";"PR";"ATALAIA";87;10;22;119
2010;"BALSA NOVA (PR)";"PR";"BALSA NOVA";292;12;35;339
2010;"BANDEIRANTES (PR)";"PR";"BANDEIRANTES";752;34;98;884
2010;"BARBOSA FERRAZ (PR)";"PR";"BARBOSA FERRAZ";162;5;23;190
2010;"BARRA DO JACARE (PR)";"PR";"BARRA DO JACARE";39;6;7;52
2010;"BARRACAO (PR)";"PR";"BARRACAO";195;19;40;254
2010;"BELA VISTA DO CAROBA (PR)";"PR";"BELA VISTA DO CAROBA";49;2;15;66
2010;"BELA VISTA DO PARAISO (PR)";"PR";"BELA VISTA DO PARAISO";370;17;55;442
2010;"BITURUNA (PR)";"PR";"BITURUNA";361;21;99;481
2010;"BOA ESPERANCA (PR)";"PR";"BOA ESPERANCA";156;8;14;178
2010;"BOA ESPERANCA DO IGUACU (PR)";"PR";"BOA ESPERANCA DO IGUACU";54;4;7;65
2010;"BOA VENTURA DE SAO ROQUE (PR)";"PR";"BOA VENTURA DE SAO ROQUE";155;7;26;188
2010;"BOA VISTA DA APARECIDA (PR)";"PR";"BOA VISTA DA APARECIDA";150;7;21;178
2010;"BOCAIUVA DO SUL (PR)";"PR";"BOCAIUVA DO SUL";259;13;15;287
2010;"BOM JESUS DO SUL (PR)";"PR";"BOM JESUS DO SUL";43;3;7;53
2010;"BOM SUCESSO (PR)";"PR";"BOM SUCESSO";86;4;37;127
2010;"BOM SUCESSO DO SUL (PR)";"PR";"BOM SUCESSO DO SUL";92;9;6;107
2010;"BORRAZOPOLIS (PR)";"PR";"BORRAZOPOLIS";230;3;7;240
2010;"BRAGANEY (PR)";"PR";"BRAGANEY";147;5;20;172
2010;"BRASILANDIA DO SUL (PR)";"PR";"BRASILANDIA DO SUL";54;2;7;63
2010;"CAFEARA (PR)";"PR";"CAFEARA";32;5;11;48
2010;"CAFELANDIA (PR)";"PR";"CAFELANDIA";506;11;44;561
2010;"CAFEZAL DO SUL (PR)";"PR";"CAFEZAL DO SUL";78;1;25;104
2010;"CALIFORNIA (PR)";"PR";"CALIFORNIA";238;9;16;263
2010;"CAMBARA (PR)";"PR";"CAMBARA";794;25;76;895
2010;"CAMBE (PR)";"PR";"CAMBE";1675;193;136;2004
2010;"CAMBIRA (PR)";"PR";"CAMBIRA";229;1;18;248
2010;"CAMPINA DA LAGOA (PR)";"PR";"CAMPINA DA LAGOA";344;15;33;392
2010;"CAMPINA DO SIMAO (PR)";"PR";"CAMPINA DO SIMAO";66;3;18;87
2010;"CAMPINA GRANDE DO SUL (PR)";"PR";"CAMPINA GRANDE DO SUL";735;65;48;848
2010;"CAMPO BONITO (PR)";"PR";"CAMPO BONITO";90;6;8;104
2010;"CAMPO DO TENENTE (PR)";"PR";"CAMPO DO TENENTE";137;9;32;178
2010;"CAMPO LARGO (PR)";"PR";"CAMPO LARGO";2049;212;418;2679
2010;"CAMPO MAGRO (PR)";"PR";"CAMPO MAGRO";373;44;20;437
2010;"CAMPO MOURAO (PR)";"PR";"CAMPO MOURAO";1898;79;490;2467
2010;"CANDIDO DE ABREU (PR)";"PR";"CANDIDO DE ABREU";203;7;41;251
2010;"CANDOI (PR)";"PR";"CANDOI";334;9;80;423
2010;"CANTAGALO (PR)";"PR";"CANTAGALO";227;7;36;270
2010;"CAPANEMA (PR)";"PR";"CAPANEMA";403;10;47;460
2010;"CAPITAO LEONIDAS MARQUES (PR)";"PR";"CAPITAO LEONIDAS MARQUES";513;14;29;556
2010;"CARAMBEI (PR)";"PR";"CARAMBEI";522;32;46;600
2010;"CARLOPOLIS (PR)";"PR";"CARLOPOLIS";250;17;46;313
2010;"CASCAVEL (PR)";"PR";"CASCAVEL";6975;306;788;8069
2010;"CASTRO (PR)";"PR";"CASTRO";1592;133;228;1953
2010;"CATANDUVAS (PR)";"PR";"CATANDUVAS";191;11;22;224
2010;"CENTENARIO DO SUL (PR)";"PR";"CENTENARIO DO SUL";108;18;52;178
2010;"CERRO AZUL (PR)";"PR";"CERRO AZUL";367;11;50;428
2010;"CEU AZUL (PR)";"PR";"CEU AZUL";299;12;39;350
2010;"CHOPINZINHO (PR)";"PR";"CHOPINZINHO";494;19;63;576
2010;"CIANORTE (PR)";"PR";"CIANORTE";1444;59;173;1676
2010;"CIDADE GAUCHA (PR)";"PR";"CIDADE GAUCHA";246;12;69;327
2010;"CLEVELANDIA (PR)";"PR";"CLEVELANDIA";488;28;38;554
2010;"COLOMBO (PR)";"PR";"COLOMBO";3820;241;439;4500
2010;"COLORADO (PR)";"PR";"COLORADO";576;35;94;705
2010;"CONGONHINHAS (PR)";"PR";"CONGONHINHAS";115;6;29;150
2010;"CONSELHEIRO MAIRINCK (PR)";"PR";"CONSELHEIRO MAIRINCK";35;3;7;45
2010;"CONTENDA (PR)";"PR";"CONTENDA";653;15;44;712
2010;"CORBELIA (PR)";"PR";"CORBELIA";674;18;33;725
2010;"CORNELIO PROCOPIO (PR)";"PR";"CORNELIO PROCOPIO";972;103;107;1182
2010;"CORONEL DOMINGOS SOARES (PR)";"PR";"CORONEL DOMINGOS SOARES";113;7;20;140
2010;"CORONEL VIVIDA (PR)";"PR";"CORONEL VIVIDA";615;14;91;720
2010;"CORUMBATAI DO SUL (PR)";"PR";"CORUMBATAI DO SUL";47;1;22;70
2010;"CRUZ MACHADO (PR)";"PR";"CRUZ MACHADO";423;14;64;501
2010;"CRUZEIRO DO IGUACU (PR)";"PR";"CRUZEIRO DO IGUACU";66;2;13;81
2010;"CRUZEIRO DO OESTE (PR)";"PR";"CRUZEIRO DO OESTE";431;15;65;511
2010;"CRUZEIRO DO SUL (PR)";"PR";"CRUZEIRO DO SUL";67;7;17;91
2010;"CRUZMALTINA (PR)";"PR";"CRUZMALTINA";69;2;5;76
2010;"CURITIBA (PR)";"PR";"CURITIBA";36280;3571;7093;46944
2010;"CURIUVA (PR)";"PR";"CURIUVA";217;24;68;309
2010;"DIAMANTE D OESTE (PR)";"PR";"DIAMANTE D OESTE";68;4;14;86
2010;"DIAMANTE DO NORTE (PR)";"PR";"DIAMANTE DO NORTE";62;4;21;87
2010;"DIAMANTE DO SUL (PR)";"PR";"DIAMANTE DO SUL";38;2;5;45
2010;"DOIS VIZINHOS (PR)";"PR";"DOIS VIZINHOS";909;41;90;1040
2010;"DOURADINA (PR)";"PR";"DOURADINA";303;7;10;320
2010;"DOUTOR CAMARGO (PR)";"PR";"DOUTOR CAMARGO";151;5;33;189
2010;"DOUTOR ULYSSES (PR)";"PR";"DOUTOR ULYSSES";37;1;11;49
2010;"ENEAS MARQUES (PR)";"PR";"ENEAS MARQUES";150;9;20;179
2010;"ENGENHEIRO BELTRAO (PR)";"PR";"ENGENHEIRO BELTRAO";442;11;76;529
2010;"ENTRE RIOS DO OESTE (PR)";"PR";"ENTRE RIOS DO OESTE";119;4;5;128
2010;"ESPERANCA NOVA (PR)";"PR";"ESPERANCA NOVA";22;2;3;27
2010;"ESPIGAO ALTO DO IGUACU (PR)";"PR";"ESPIGAO ALTO DO IGUACU";58;6;7;71
2010;"FAROL (PR)";"PR";"FAROL";74;1;8;83
2010;"FAXINAL (PR)";"PR";"FAXINAL";340;7;38;385
2010;"FAZENDA RIO GRANDE (PR)";"PR";"FAZENDA RIO GRANDE";862;57;232;1151
2010;"FENIX (PR)";"PR";"FENIX";90;1;11;102
2010;"FERNANDES PINHEIRO (PR)";"PR";"FERNANDES PINHEIRO";99;3;18;120
2010;"FIGUEIRA (PR)";"PR";"FIGUEIRA";128;6;25;159
2010;"FLOR DA SERRA DO SUL (PR)";"PR";"FLOR DA SERRA DO SUL";85;3;21;109
2010;"FLORAI (PR)";"PR";"FLORAI";124;5;24;153
2010;"FLORESTA (PR)";"PR";"FLORESTA";228;9;22;259
2010;"FLORESTOPOLIS (PR)";"PR";"FLORESTOPOLIS";195;11;86;292
2010;"FLORIDA (PR)";"PR";"FLORIDA";50;8;12;70
2010;"FORMOSA DO OESTE (PR)";"PR";"FORMOSA DO OESTE";186;26;15;227
2010;"FOZ DO IGUACU (PR)";"PR";"FOZ DO IGUACU";3044;876;945;4865
2010;"FOZ DO JORDAO (PR)";"PR";"FOZ DO JORDAO";68;3;12;83
2010;"FRANCISCO ALVES (PR)";"PR";"FRANCISCO ALVES";143;2;19;164
2010;"FRANCISCO BELTRAO (PR)";"PR";"FRANCISCO BELTRAO";1798;105;192;2095
2010;"GENERAL CARNEIRO (PR)";"PR";"GENERAL CARNEIRO";376;11;55;442
2010;"GODOY MOREIRA (PR)";"PR";"GODOY MOREIRA";43;2;7;52
2010;"GOIOERE (PR)";"PR";"GOIOERE";638;28;54;720
2010;"GOIOXIM (PR)";"PR";"GOIOXIM";83;7;23;113
2010;"GRANDES RIOS (PR)";"PR";"GRANDES RIOS";70;6;7;83
2010;"GUAIRA (PR)";"PR";"GUAIRA";1088;29;68;1185
2010;"GUAIRACA (PR)";"PR";"GUAIRACA";123;3;26;152
2010;"GUAMIRANGA (PR)";"PR";"GUAMIRANGA";142;7;22;171
2010;"GUAPIRAMA (PR)";"PR";"GUAPIRAMA";105;1;17;123
2010;"GUAPOREMA (PR)";"PR";"GUAPOREMA";46;2;7;55
2010;"GUARACI (PR)";"PR";"GUARACI";93;2;25;120
2010;"GUARANIACU (PR)";"PR";"GUARANIACU";380;20;51;451
2010;"GUARAPUAVA (PR)";"PR";"GUARAPUAVA";4080;401;406;4887
2010;"GUARAQUECABA (PR)";"PR";"GUARAQUECABA";21;1;8;30
2010;"GUARATUBA (PR)";"PR";"GUARATUBA";275;24;43;342
2010;"HONORIO SERPA (PR)";"PR";"HONORIO SERPA";100;4;29;133
2010;"IBAITI (PR)";"PR";"IBAITI";489;25;158;672
2010;"IBEMA (PR)";"PR";"IBEMA";138;4;14;156
2010;"IBIPORA (PR)";"PR";"IBIPORA";878;40;121;1039
2010;"ICARAIMA (PR)";"PR";"ICARAIMA";105;4;24;133
2010;"IGUARACU (PR)";"PR";"IGUARACU";66;5;12;83
2010;"IGUATU (PR)";"PR";"IGUATU";31;1;7;39
2010;"IMBAU (PR)";"PR";"IMBAU";169;20;25;214
2010;"IMBITUVA (PR)";"PR";"IMBITUVA";671;17;46;734
2010;"INACIO MARTINS (PR)";"PR";"INACIO MARTINS";239;20;29;288
2010;"INAJA (PR)";"PR";"INAJA";33;1;19;53
2010;"INDIANOPOLIS (PR)";"PR";"INDIANOPOLIS";138;2;7;147
2010;"IPIRANGA (PR)";"PR";"IPIRANGA";300;28;45;373
2010;"IPORA (PR)";"PR";"IPORA";326;12;33;371
2010;"IRACEMA DO OESTE (PR)";"PR";"IRACEMA DO OESTE";67;5;4;76
2010;"IRATI (PR)";"PR";"IRATI";1359;75;117;1551
2010;"IRETAMA (PR)";"PR";"IRETAMA";152;3;27;182
2010;"ITAGUAJE (PR)";"PR";"ITAGUAJE";66;7;19;92
2010;"ITAIPULANDIA (PR)";"PR";"ITAIPULANDIA";182;15;25;222
2010;"ITAMBARACA (PR)";"PR";"ITAMBARACA";140;6;26;172
2010;"ITAMBE (PR)";"PR";"ITAMBE";175;5;21;201
2010;"ITAPEJARA D OESTE (PR)";"PR";"ITAPEJARA D OESTE";266;5;21;292
2010;"ITAPERUCU (PR)";"PR";"ITAPERUCU";544;41;45;630
2010;"ITAUNA DO SUL (PR)";"PR";"ITAUNA DO SUL";40;2;6;48
2010;"IVAI (PR)";"PR";"IVAI";303;6;31;340
2010;"IVAIPORA (PR)";"PR";"IVAIPORA";755;32;79;866
2010;"IVATE (PR)";"PR";"IVATE";159;10;50;219
2010;"IVATUBA (PR)";"PR";"IVATUBA";50;4;7;61
2010;"JABOTI (PR)";"PR";"JABOTI";72;4;8;84
2010;"JACAREZINHO (PR)";"PR";"JACAREZINHO";515;64;135;714
2010;"JAGUAPITA (PR)";"PR";"JAGUAPITA";308;17;48;373
2010;"JAGUARIAIVA (PR)";"PR";"JAGUARIAIVA";663;42;99;804
2010;"JANDAIA DO SUL (PR)";"PR";"JANDAIA DO SUL";563;24;87;674
2010;"JANIOPOLIS (PR)";"PR";"JANIOPOLIS";122;4;19;145
2010;"JAPIRA (PR)";"PR";"JAPIRA";35;1;7;43
2010;"JAPURA (PR)";"PR";"JAPURA";219;5;13;237
2010;"JARDIM ALEGRE (PR)";"PR";"JARDIM ALEGRE";185;10;21;216
2010;"JARDIM OLINDA (PR)";"PR";"JARDIM OLINDA";34;3;4;41
2010;"JATAIZINHO (PR)";"PR";"JATAIZINHO";294;22;23;339
2010;"JESUITAS (PR)";"PR";"JESUITAS";231;7;23;261
2010;"JOAQUIM TAVORA (PR)";"PR";"JOAQUIM TAVORA";214;8;18;240
2010;"JUNDIAI DO SUL (PR)";"PR";"JUNDIAI DO SUL";28;3;13;44
2010;"JURANDA (PR)";"PR";"JURANDA";276;2;12;290
2010;"JUSSARA (PR)";"PR";"JUSSARA";154;7;29;190
2010;"KALORE (PR)";"PR";"KALORE";124;9;17;150
2010;"LAPA (PR)";"PR";"LAPA";1129;84;150;1363
2010;"LARANJAL (PR)";"PR";"LARANJAL";47;3;16;66
2010;"LARANJEIRAS DO SUL (PR)";"PR";"LARANJEIRAS DO SUL";639;27;69;735
2010;"LEOPOLIS (PR)";"PR";"LEOPOLIS";68;5;4;77
2010;"LIDIANOPOLIS (PR)";"PR";"LIDIANOPOLIS";60;5;17;82
2010;"LINDOESTE (PR)";"PR";"LINDOESTE";82;7;14;103
2010;"LOANDA (PR)";"PR";"LOANDA";378;11;54;443
2010;"LOBATO (PR)";"PR";"LOBATO";160;4;27;191
2010;"LONDRINA (PR)";"PR";"LONDRINA";8332;753;1849;10934
2010;"LUIZIANA (PR)";"PR";"LUIZIANA";141;4;13;158
2010;"LUNARDELLI (PR)";"PR";"LUNARDELLI";79;7;6;92
2010;"LUPIONOPOLIS (PR)";"PR";"LUPIONOPOLIS";89;17;123;229
2010;"MALLET (PR)";"PR";"MALLET";304;13;32;349
2010;"MAMBORE (PR)";"PR";"MAMBORE";507;3;30;540
2010;"MANDAGUACU (PR)";"PR";"MANDAGUACU";388;11;46;445
2010;"MANDAGUARI (PR)";"PR";"MANDAGUARI";672;26;60;758
2010;"MANDIRITUBA (PR)";"PR";"MANDIRITUBA";892;20;52;964
2010;"MANFRINOPOLIS (PR)";"PR";"MANFRINOPOLIS";32;4;16;52
2010;"MANGUEIRINHA (PR)";"PR";"MANGUEIRINHA";426;22;59;507
2010;"MANOEL RIBAS (PR)";"PR";"MANOEL RIBAS";280;11;27;318
2010;"MARECHAL CANDIDO RONDON (PR)";"PR";"MARECHAL CANDIDO RONDON";1306;56;127;1489
2010;"MARIA HELENA (PR)";"PR";"MARIA HELENA";103;4;20;127
2010;"MARIALVA (PR)";"PR";"MARIALVA";789;41;68;898
2010;"MARILANDIA DO SUL (PR)";"PR";"MARILANDIA DO SUL";224;13;19;256
2010;"MARILENA (PR)";"PR";"MARILENA";108;5;22;135
2010;"MARILUZ (PR)";"PR";"MARILUZ";179;9;62;250
2010;"MARINGA (PR)";"PR";"MARINGA";8209;448;863;9520
2010;"MARIOPOLIS (PR)";"PR";"MARIOPOLIS";192;8;25;225
2010;"MARIPA (PR)";"PR";"MARIPA";270;8;13;291
2010;"MARMELEIRO (PR)";"PR";"MARMELEIRO";308;13;46;367
2010;"MARQUINHO (PR)";"PR";"MARQUINHO";54;7;12;73
2010;"MARUMBI (PR)";"PR";"MARUMBI";88;4;13;105
2010;"MATELANDIA (PR)";"PR";"MATELANDIA";424;4;37;465
2010;"MATINHOS (PR)";"PR";"MATINHOS";254;27;22;303
2010;"MATO RICO (PR)";"PR";"MATO RICO";38;3;9;50
2010;"MAUA DA SERRA (PR)";"PR";"MAUA DA SERRA";184;7;19;210
2010;"MEDIANEIRA (PR)";"PR";"MEDIANEIRA";1070;42;87;1199
2010;"MERCEDES (PR)";"PR";"MERCEDES";191;9;25;225
2010;"MIRADOR (PR)";"PR";"MIRADOR";12;1;9;22
2010;"MIRASELVA (PR)";"PR";"MIRASELVA";34;4;20;58
2010;"MISSAL (PR)";"PR";"MISSAL";315;20;29;364
2010;"MOREIRA SALES (PR)";"PR";"MOREIRA SALES";148;8;58;214
2010;"MORRETES (PR)";"PR";"MORRETES";170;17;29;216
2010;"MUNHOZ DE MELLO (PR)";"PR";"MUNHOZ DE MELLO";57;4;8;69
2010;"NOSSA SENHORA DAS GRACAS (PR)";"PR";"NOSSA SENHORA DAS GRACAS";24;6;28;58
2010;"NOVA ALIANCA DO IVAI (PR)";"PR";"NOVA ALIANCA DO IVAI";16;8;4;28
2010;"NOVA AMERICA DA COLINA (PR)";"PR";"NOVA AMERICA DA COLINA";109;5;11;125
2010;"NOVA AURORA (PR)";"PR";"NOVA AURORA";365;9;35;409
2010;"NOVA CANTU (PR)";"PR";"NOVA CANTU";102;0;19;121
2010;"NOVA ESPERANCA (PR)";"PR";"NOVA ESPERANCA";735;25;61;821
2010;"NOVA ESPERANCA DO SUDOESTE (PR)";"PR";"NOVA ESPERANCA DO SUDOESTE";90;11;16;117
2010;"NOVA FATIMA (PR)";"PR";"NOVA FATIMA";209;2;31;242
2010;"NOVA LARANJEIRAS (PR)";"PR";"NOVA LARANJEIRAS";131;3;25;159
2010;"NOVA LONDRINA (PR)";"PR";"NOVA LONDRINA";359;11;37;407
2010;"NOVA OLIMPIA (PR)";"PR";"NOVA OLIMPIA";83;3;17;103
2010;"NOVA PRATA DO IGUACU (PR)";"PR";"NOVA PRATA DO IGUACU";203;4;23;230
2010;"NOVA SANTA BARBARA (PR)";"PR";"NOVA SANTA BARBARA";117;7;4;128
2010;"NOVA SANTA ROSA (PR)";"PR";"NOVA SANTA ROSA";301;10;19;330
2010;"NOVA TEBAS (PR)";"PR";"NOVA TEBAS";98;4;11;113
2010;"NOVO ITACOLOMI (PR)";"PR";"NOVO ITACOLOMI";73;1;7;81
2010;"ORTIGUEIRA (PR)";"PR";"ORTIGUEIRA";313;18;63;394
2010;"OURIZONA (PR)";"PR";"OURIZONA";74;4;16;94
2010;"OURO VERDE DO OESTE (PR)";"PR";"OURO VERDE DO OESTE";146;1;11;158
2010;"PAICANDU (PR)";"PR";"PAICANDU";404;21;56;481
2010;"PALMAS (PR)";"PR";"PALMAS";819;52;73;944
2010;"PALMEIRA (PR)";"PR";"PALMEIRA";843;35;67;945
2010;"PALMITAL (PR)";"PR";"PALMITAL";214;11;44;269
2010;"PALOTINA (PR)";"PR";"PALOTINA";1084;28;104;1216
2010;"PARAISO DO NORTE (PR)";"PR";"PARAISO DO NORTE";227;11;51;289
2010;"PARANACITY (PR)";"PR";"PARANACITY";211;13;40;264
2010;"PARANAGUA (PR)";"PR";"PARANAGUA";1508;133;132;1773
2010;"PARANAPOEMA (PR)";"PR";"PARANAPOEMA";56;2;14;72
2010;"PARANAVAI (PR)";"PR";"PARANAVAI";1802;81;176;2059
2010;"PATO BRAGADO (PR)";"PR";"PATO BRAGADO";124;4;14;142
2010;"PATO BRANCO (PR)";"PR";"PATO BRANCO";1861;131;358;2350
2010;"PAULA FREITAS (PR)";"PR";"PAULA FREITAS";130;2;17;149
2010;"PAULO FRONTIN (PR)";"PR";"PAULO FRONTIN";153;2;13;168
2010;"PEABIRU (PR)";"PR";"PEABIRU";260;16;23;299
2010;"PEROBAL (PR)";"PR";"PEROBAL";85;2;30;117
2010;"PEROLA (PR)";"PR";"PEROLA";201;7;11;219
2010;"PEROLA D OESTE (PR)";"PR";"PEROLA D OESTE";143;2;18;163
2010;"PIEN (PR)";"PR";"PIEN";353;18;15;386
2010;"PINHAIS (PR)";"PR";"PINHAIS";1866;161;367;2394
2010;"PINHAL DO SAO BENTO (PR)";"PR";"PINHAL DO SAO BENTO";33;4;8;45
2010;"PINHALAO (PR)";"PR";"PINHALAO";89;7;14;110
2010;"PINHAO (PR)";"PR";"PINHAO";425;25;83;533
2010;"PIRAI DO SUL (PR)";"PR";"PIRAI DO SUL";414;24;74;512
2010;"PIRAQUARA (PR)";"PR";"PIRAQUARA";502;69;167;738
2010;"PITANGA (PR)";"PR";"PITANGA";690;26;95;811
2010;"PITANGUEIRAS (PR)";"PR";"PITANGUEIRAS";54;4;25;83
2010;"PLANALTINA DO PARANA (PR)";"PR";"PLANALTINA DO PARANA";102;4;15;121
2010;"PLANALTO (PR)";"PR";"PLANALTO";289;11;27;327
2010;"PONTA GROSSA (PR)";"PR";"PONTA GROSSA";5634;510;961;7105
2010;"PONTAL DO PARANA (PR)";"PR";"PONTAL DO PARANA";194;6;44;244
2010;"PORECATU (PR)";"PR";"PORECATU";297;27;126;450
2010;"PORTO AMAZONAS (PR)";"PR";"PORTO AMAZONAS";71;7;11;89
2010;"PORTO BARREIRO (PR)";"PR";"PORTO BARREIRO";52;4;16;72
2010;"PORTO RICO (PR)";"PR";"PORTO RICO";16;0;6;22
2010;"PORTO VITORIA (PR)";"PR";"PORTO VITORIA";160;2;9;171
2010;"PRADO FERREIRA (PR)";"PR";"PRADO FERREIRA";75;3;13;91
2010;"PRANCHITA (PR)";"PR";"PRANCHITA";208;5;13;226
2010;"PRESIDENTE CASTELO BRANCO (PR)";"PR";"PRESIDENTE CASTELO BRANCO";79;4;23;106
2010;"PRIMEIRO DE MAIO (PR)";"PR";"PRIMEIRO DE MAIO";277;12;22;311
2010;"PRUDENTOPOLIS (PR)";"PR";"PRUDENTOPOLIS";1068;31;104;1203
2010;"QUARTO CENTENARIO (PR)";"PR";"QUARTO CENTENARIO";135;7;7;149
2010;"QUATIGUA (PR)";"PR";"QUATIGUA";356;9;14;379
2010;"QUATRO BARRAS (PR)";"PR";"QUATRO BARRAS";526;38;130;694
2010;"QUATRO PONTES (PR)";"PR";"QUATRO PONTES";151;4;4;159
2010;"QUEDAS DO IGUACU (PR)";"PR";"QUEDAS DO IGUACU";601;23;121;745
2010;"QUERENCIA DO NORTE (PR)";"PR";"QUERENCIA DO NORTE";181;4;23;208
2010;"QUINTA DO SOL (PR)";"PR";"QUINTA DO SOL";104;2;18;124
2010;"QUITANDINHA (PR)";"PR";"QUITANDINHA";484;6;59;549
2010;"RAMILANDIA (PR)";"PR";"RAMILANDIA";52;2;11;65
2010;"RANCHO ALEGRE (PR)";"PR";"RANCHO ALEGRE";100;3;10;113
2010;"RANCHO ALEGRE D OESTE (PR)";"PR";"RANCHO ALEGRE D OESTE";81;2;7;90
2010;"REALEZA (PR)";"PR";"REALEZA";501;16;38;555
2010;"REBOUCAS (PR)";"PR";"REBOUCAS";239;11;35;285
2010;"RENASCENCA (PR)";"PR";"RENASCENCA";196;7;26;229
2010;"RESERVA (PR)";"PR";"RESERVA";500;22;61;583
2010;"RESERVA DO IGUACU (PR)";"PR";"RESERVA DO IGUACU";70;7;18;95
2010;"RIBEIRAO CLARO (PR)";"PR";"RIBEIRAO CLARO";169;27;23;219
2010;"RIBEIRAO DO PINHAL (PR)";"PR";"RIBEIRAO DO PINHAL";193;27;26;246
2010;"RIO AZUL (PR)";"PR";"RIO AZUL";223;7;57;287
2010;"RIO BOM (PR)";"PR";"RIO BOM";66;3;6;75
2010;"RIO BONITO DO IGUACU (PR)";"PR";"RIO BONITO DO IGUACU";220;6;59;285
2010;"RIO BRANCO DO IVAI (PR)";"PR";"RIO BRANCO DO IVAI";41;4;11;56
2010;"RIO BRANCO DO SUL (PR)";"PR";"RIO BRANCO DO SUL";641;76;95;812
2010;"RIO NEGRO (PR)";"PR";"RIO NEGRO";838;65;52;955
2010;"ROLANDIA (PR)";"PR";"ROLANDIA";1556;73;92;1721
2010;"RONCADOR (PR)";"PR";"RONCADOR";276;2;29;307
2010;"RONDON (PR)";"PR";"RONDON";255;8;49;312
2010;"ROSARIO DO IVAI (PR)";"PR";"ROSARIO DO IVAI";62;6;17;85
2010;"SABAUDIA (PR)";"PR";"SABAUDIA";162;7;14;183
2010;"SALGADO FILHO (PR)";"PR";"SALGADO FILHO";74;4;17;95
2010;"SALTO DO ITARARE (PR)";"PR";"SALTO DO ITARARE";90;4;16;110
2010;"SALTO DO LONTRA (PR)";"PR";"SALTO DO LONTRA";236;6;24;266
2010;"SANTA AMELIA (PR)";"PR";"SANTA AMELIA";73;5;15;93
2010;"SANTA CECILIA DO PAVAO (PR)";"PR";"SANTA CECILIA DO PAVAO";68;7;10;85
2010;"SANTA CRUZ DO MONTE CASTELO (PR)";"PR";"SANTA CRUZ DO MONTE CASTELO";193;8;29;230
2010;"SANTA FE (PR)";"PR";"SANTA FE";198;5;26;229
2010;"SANTA HELENA (PR)";"PR";"SANTA HELENA";587;33;97;717
2010;"SANTA INES (PR)";"PR";"SANTA INES";12;3;8;23
2010;"SANTA ISABEL DO IVAI (PR)";"PR";"SANTA ISABEL DO IVAI";169;9;33;211
2010;"SANTA IZABEL DO OESTE (PR)";"PR";"SANTA IZABEL DO OESTE";195;13;28;236
2010;"SANTA LUCIA (PR)";"PR";"SANTA LUCIA";90;1;8;99
2010;"SANTA MARIA DO OESTE (PR)";"PR";"SANTA MARIA DO OESTE";180;7;20;207
2010;"SANTA MARIANA (PR)";"PR";"SANTA MARIANA";263;13;44;320
2010;"SANTA MONICA (PR)";"PR";"SANTA MONICA";44;2;10;56
2010;"SANTA TEREZA DO OESTE (PR)";"PR";"SANTA TEREZA DO OESTE";187;13;23;223
2010;"SANTA TEREZINHA DE ITAIPU (PR)";"PR";"SANTA TEREZINHA DE ITAIPU";407;38;43;488
2010;"SANTANA DO ITARARE (PR)";"PR";"SANTANA DO ITARARE";78;3;15;96
2010;"SANTO ANTONIO DA PLATINA (PR)";"PR";"SANTO ANTONIO DA PLATINA";587;48;242;877
2010;"SANTO ANTONIO DO CAIUA (PR)";"PR";"SANTO ANTONIO DO CAIUA";18;2;12;32
2010;"SANTO ANTONIO DO PARAISO (PR)";"PR";"SANTO ANTONIO DO PARAISO";66;4;7;77
2010;"SANTO ANTONIO DO SUDOESTE (PR)";"PR";"SANTO ANTONIO DO SUDOESTE";325;15;38;378
2010;"SANTO INACIO (PR)";"PR";"SANTO INACIO";77;6;16;99
2010;"SAO CARLOS DO IVAI (PR)";"PR";"SAO CARLOS DO IVAI";215;9;24;248
2010;"SAO JERONIMO DA SERRA (PR)";"PR";"SAO JERONIMO DA SERRA";130;5;20;155
2010;"SAO JOAO (PR)";"PR";"SAO JOAO";285;11;34;330
2010;"SAO JOAO DO CAIUA (PR)";"PR";"SAO JOAO DO CAIUA";68;2;28;98
2010;"SAO JOAO DO IVAI (PR)";"PR";"SAO JOAO DO IVAI";275;9;30;314
2010;"SAO JOAO DO TRIUNFO (PR)";"PR";"SAO JOAO DO TRIUNFO";211;9;32;252
2010;"SAO JORGE D OESTE (PR)";"PR";"SAO JORGE D OESTE";185;7;28;220
2010;"SAO JORGE DO IVAI (PR)";"PR";"SAO JORGE DO IVAI";236;4;16;256
2010;"SAO JORGE DO PATROCINIO (PR)";"PR";"SAO JORGE DO PATROCINIO";114;4;12;130
2010;"SAO JOSE DA BOA VISTA (PR)";"PR";"SAO JOSE DA BOA VISTA";81;4;15;100
2010;"SAO JOSE DAS PALMEIRAS (PR)";"PR";"SAO JOSE DAS PALMEIRAS";67;10;27;104
2010;"SAO JOSE DOS PINHAIS (PR)";"PR";"SAO JOSE DOS PINHAIS";6267;624;715;7606
2010;"SAO MANOEL DO PARANA (PR)";"PR";"SAO MANOEL DO PARANA";41;3;10;54
2010;"SAO MATEUS DO SUL (PR)";"PR";"SAO MATEUS DO SUL";850;66;143;1059
2010;"SAO MIGUEL DO IGUACU (PR)";"PR";"SAO MIGUEL DO IGUACU";775;25;76;876
2010;"SAO PEDRO DO IGUACU (PR)";"PR";"SAO PEDRO DO IGUACU";149;11;25;185
2010;"SAO PEDRO DO IVAI (PR)";"PR";"SAO PEDRO DO IVAI";305;6;45;356
2010;"SAO PEDRO DO PARANA (PR)";"PR";"SAO PEDRO DO PARANA";26;3;4;33
2010;"SAO SEBASTIAO DA AMOREIRA (PR)";"PR";"SAO SEBASTIAO DA AMOREIRA";171;7;26;204
2010;"SAO TOME (PR)";"PR";"SAO TOME";112;9;26;147
2010;"SAPOPEMA (PR)";"PR";"SAPOPEMA";94;3;12;109
2010;"SARANDI (PR)";"PR";"SARANDI";874;55;124;1053
2010;"SAUDADE DO IGUACU (PR)";"PR";"SAUDADE DO IGUACU";66;11;16;93
2010;"SENGES (PR)";"PR";"SENGES";436;26;59;521
2010;"SERRANOPOLIS DO IGUACU (PR)";"PR";"SERRANOPOLIS DO IGUACU";138;12;9;159
2010;"SERTANEJA (PR)";"PR";"SERTANEJA";192;10;23;225
2010;"SERTANOPOLIS (PR)";"PR";"SERTANOPOLIS";525;8;43;576
2010;"SIQUEIRA CAMPOS (PR)";"PR";"SIQUEIRA CAMPOS";311;14;39;364
2010;"SULINA (PR)";"PR";"SULINA";73;4;11;88
2010;"TAMARANA (PR)";"PR";"TAMARANA";247;10;32;289
2010;"TAMBOARA (PR)";"PR";"TAMBOARA";73;7;12;92
2010;"TAPEJARA (PR)";"PR";"TAPEJARA";338;13;94;445
2010;"TAPIRA (PR)";"PR";"TAPIRA";127;5;22;154
2010;"TEIXEIRA SOARES (PR)";"PR";"TEIXEIRA SOARES";193;10;65;268
2010;"TELEMACO BORBA (PR)";"PR";"TELEMACO BORBA";989;187;208;1384
2010;"TERRA BOA (PR)";"PR";"TERRA BOA";277;13;63;353
2010;"TERRA RICA (PR)";"PR";"TERRA RICA";337;11;55;403
2010;"TERRA ROXA (PR)";"PR";"TERRA ROXA";447;10;42;499
2010;"TIBAGI (PR)";"PR";"TIBAGI";289;23;50;362
2010;"TIJUCAS DO SUL (PR)";"PR";"TIJUCAS DO SUL";400;7;35;442
2010;"TOLEDO (PR)";"PR";"TOLEDO";2639;185;252;3076
2010;"TOMAZINA (PR)";"PR";"TOMAZINA";87;6;16;109
2010;"TRES BARRAS DO PARANA (PR)";"PR";"TRES BARRAS DO PARANA";294;3;20;317
2010;"TUNAS DO PARANA (PR)";"PR";"TUNAS DO PARANA";75;9;28;112
2010;"TUNEIRAS DO OESTE (PR)";"PR";"TUNEIRAS DO OESTE";113;5;30;148
2010;"TUPASSI (PR)";"PR";"TUPASSI";301;9;31;341
2010;"TURVO (PR)";"PR";"TURVO";389;14;47;450
2010;"UBIRATA (PR)";"PR";"UBIRATA";630;21;43;694
2010;"UMUARAMA (PR)";"PR";"UMUARAMA";2306;58;241;2605
2010;"UNIAO DA VITORIA (PR)";"PR";"UNIAO DA VITORIA";1317;43;65;1425
2010;"UNIFLOR (PR)";"PR";"UNIFLOR";37;5;10;52
2010;"URAI (PR)";"PR";"URAI";269;17;23;309
2010;"VENTANIA (PR)";"PR";"VENTANIA";164;20;29;213
2010;"VERA CRUZ DO OESTE (PR)";"PR";"VERA CRUZ DO OESTE";230;5;10;245
2010;"VERE (PR)";"PR";"VERE";187;11;20;218
2010;"VIRMOND (PR)";"PR";"VIRMOND";97;2;13;112
2010;"VITORINO (PR)";"PR";"VITORINO";184;4;21;209
2010;"WENCESLAU BRAZ (PR)";"PR";"WENCESLAU BRAZ";381;17;72;470
2010;"XAMBRE (PR)";"PR";"XAMBRE";75;4;11;90
2010;"ANGRA DOS REIS (RJ)";"RJ";"ANGRA DOS REIS";910;170;249;1329
2010;"APERIBE (RJ)";"RJ";"APERIBE";91;11;5;107
2010;"ARARUAMA (RJ)";"RJ";"ARARUAMA";1616;281;90;1987
2010;"AREAL (RJ)";"RJ";"AREAL";121;29;28;178
2010;"ARMACAO DE BUZIOS (RJ)";"RJ";"ARMACAO DE BUZIOS";234;265;40;539
2010;"ARRAIAL DO CABO (RJ)";"RJ";"ARRAIAL DO CABO";111;41;11;163
2010;"BARRA DO PIRAI (RJ)";"RJ";"BARRA DO PIRAI";1434;143;216;1793
2010;"BARRA MANSA (RJ)";"RJ";"BARRA MANSA";1772;124;537;2433
2010;"BELFORD ROXO (RJ)";"RJ";"BELFORD ROXO";1245;268;687;2200
2010;"BOM JARDIM (RJ)";"RJ";"BOM JARDIM";491;29;29;549
2010;"BOM JESUS DO ITABAPOANA (RJ)";"RJ";"BOM JESUS DO ITABAPOANA";338;47;47;432
2010;"CABO FRIO (RJ)";"RJ";"CABO FRIO";3508;295;441;4244
2010;"CACHOEIRAS DE MACACU (RJ)";"RJ";"CACHOEIRAS DE MACACU";726;120;39;885
2010;"CAMBUCI (RJ)";"RJ";"CAMBUCI";78;15;17;110
2010;"CAMPOS DOS GOYTACAZES (RJ)";"RJ";"CAMPOS DOS GOYTACAZES";5747;629;1099;7475
2010;"CANTAGALO (RJ)";"RJ";"CANTAGALO";154;25;32;211
2010;"CARAPEBUS (RJ)";"RJ";"CARAPEBUS";67;17;5;89
2010;"CARDOSO MOREIRA (RJ)";"RJ";"CARDOSO MOREIRA";148;20;27;195
2010;"CARMO (RJ)";"RJ";"CARMO";96;18;30;144
2010;"CASIMIRO DE ABREU (RJ)";"RJ";"CASIMIRO DE ABREU";454;79;37;570
2010;"COMENDADOR LEVY GASPARIAN (RJ)";"RJ";"COMENDADOR LEVY GASPARIAN";116;32;15;163
2010;"CONCEICAO DE MACABU (RJ)";"RJ";"CONCEICAO DE MACABU";149;35;58;242
2010;"CORDEIRO (RJ)";"RJ";"CORDEIRO";273;36;41;350
2010;"DUAS BARRAS (RJ)";"RJ";"DUAS BARRAS";94;16;6;116
2010;"DUQUE DE CAXIAS (RJ)";"RJ";"DUQUE DE CAXIAS";7351;776;3295;11422
2010;"ENGENHEIRO PAULO DE FRONTIN (RJ)";"RJ";"ENGENHEIRO PAULO DE FRONTIN";127;29;18;174
2010;"GUAPIMIRIM (RJ)";"RJ";"GUAPIMIRIM";269;49;35;353
2010;"IGUABA GRANDE (RJ)";"RJ";"IGUABA GRANDE";135;62;21;218
2010;"ITABORAI (RJ)";"RJ";"ITABORAI";2797;794;445;4036
2010;"ITAGUAI (RJ)";"RJ";"ITAGUAI";1283;248;268;1799
2010;"ITALVA (RJ)";"RJ";"ITALVA";187;20;15;222
2010;"ITAOCARA (RJ)";"RJ";"ITAOCARA";282;39;27;348
2010;"ITAPERUNA (RJ)";"RJ";"ITAPERUNA";1155;103;107;1365
2010;"ITATIAIA (RJ)";"RJ";"ITATIAIA";133;68;41;242
2010;"JAPERI (RJ)";"RJ";"JAPERI";404;57;39;500
2010;"LAJE DO MURIAE (RJ)";"RJ";"LAJE DO MURIAE";41;6;12;59
2010;"MACAE (RJ)";"RJ";"MACAE";2536;631;810;3977
2010;"MACUCO (RJ)";"RJ";"MACUCO";141;11;11;163
2010;"MAGE (RJ)";"RJ";"MAGE";1184;395;203;1782
2010;"MANGARATIBA (RJ)";"RJ";"MANGARATIBA";107;84;129;320
2010;"MARICA (RJ)";"RJ";"MARICA";860;271;293;1424
2010;"MENDES (RJ)";"RJ";"MENDES";207;33;20;260
2010;"MESQUITA (RJ)";"RJ";"MESQUITA";478;102;648;1228
2010;"MIGUEL PEREIRA (RJ)";"RJ";"MIGUEL PEREIRA";309;71;27;407
2010;"MIRACEMA (RJ)";"RJ";"MIRACEMA";215;17;28;260
2010;"NATIVIDADE (RJ)";"RJ";"NATIVIDADE";84;12;28;124
2010;"NILOPOLIS (RJ)";"RJ";"NILOPOLIS";539;132;323;994
2010;"NITEROI (RJ)";"RJ";"NITEROI";2061;1209;2129;5399
2010;"NOVA FRIBURGO (RJ)";"RJ";"NOVA FRIBURGO";3265;199;313;3777
2010;"NOVA IGUACU (RJ)";"RJ";"NOVA IGUACU";4847;1150;1370;7367
2010;"PARACAMBI (RJ)";"RJ";"PARACAMBI";663;68;86;817
2010;"PARAIBA DO SUL (RJ)";"RJ";"PARAIBA DO SUL";469;67;106;642
2010;"PARATI (RJ)";"RJ";"PARATI";160;52;27;239
2010;"PATY DO ALFERES (RJ)";"RJ";"PATY DO ALFERES";415;72;42;529
2010;"PETROPOLIS (RJ)";"RJ";"PETROPOLIS";2832;524;706;4062
2010;"PINHEIRAL (RJ)";"RJ";"PINHEIRAL";153;30;69;252
2010;"PIRAI (RJ)";"RJ";"PIRAI";378;45;43;466
2010;"PORCIUNCULA (RJ)";"RJ";"PORCIUNCULA";66;8;17;91
2010;"PORTO REAL (RJ)";"RJ";"PORTO REAL";287;39;23;349
2010;"QUATIS (RJ)";"RJ";"QUATIS";164;68;28;260
2010;"QUEIMADOS (RJ)";"RJ";"QUEIMADOS";377;205;95;677
2010;"QUISSAMA (RJ)";"RJ";"QUISSAMA";180;21;87;288
2010;"RESENDE (RJ)";"RJ";"RESENDE";1123;207;389;1719
2010;"RIO BONITO (RJ)";"RJ";"RIO BONITO";3732;361;153;4246
2010;"RIO CLARO (RJ)";"RJ";"RIO CLARO";74;7;8;89
2010;"RIO DAS FLORES (RJ)";"RJ";"RIO DAS FLORES";48;17;7;72
2010;"RIO DAS OSTRAS (RJ)";"RJ";"RIO DAS OSTRAS";780;633;63;1476
2010;"RIO DE JANEIRO (RJ)";"RJ";"RIO DE JANEIRO";31599;14421;15066;61086
2010;"SANTA MARIA MADALENA (RJ)";"RJ";"SANTA MARIA MADALENA";48;13;3;64
2010;"SANTO ANTONIO DE PADUA (RJ)";"RJ";"SANTO ANTONIO DE PADUA";549;83;20;652
2010;"SAO FIDELIS (RJ)";"RJ";"SAO FIDELIS";390;29;41;460
2010;"SAO FRANCISCO DE ITABAPOANA (RJ)";"RJ";"SAO FRANCISCO DE ITABAPOANA";289;54;31;374
2010;"SAO GONCALO (RJ)";"RJ";"SAO GONCALO";2872;1743;2670;7285
2010;"SAO JOAO DA BARRA (RJ)";"RJ";"SAO JOAO DA BARRA";333;70;41;444
2010;"SAO JOAO DE MERITI (RJ)";"RJ";"SAO JOAO DE MERITI";2707;444;1281;4432
2010;"SAO JOSE DE UBA (RJ)";"RJ";"SAO JOSE DE UBA";29;8;4;41
2010;"SAO JOSE DO VALE DO RIO PRETO (RJ)";"RJ";"SAO JOSE DO VALE DO RIO PRETO";514;34;12;560
2010;"SAO PEDRO DA ALDEIA (RJ)";"RJ";"SAO PEDRO DA ALDEIA";586;73;53;712
2010;"SAO SEBASTIAO DO ALTO (RJ)";"RJ";"SAO SEBASTIAO DO ALTO";90;12;5;107
2010;"SAPUCAIA (RJ)";"RJ";"SAPUCAIA";100;8;10;118
2010;"SAQUAREMA (RJ)";"RJ";"SAQUAREMA";597;104;87;788
2010;"SEROPEDICA (RJ)";"RJ";"SEROPEDICA";679;48;206;933
2010;"SILVA JARDIM (RJ)";"RJ";"SILVA JARDIM";247;48;29;324
2010;"SUMIDOURO (RJ)";"RJ";"SUMIDOURO";198;6;10;214
2010;"TANGUA (RJ)";"RJ";"TANGUA";237;26;22;285
2010;"TERESOPOLIS (RJ)";"RJ";"TERESOPOLIS";1789;223;272;2284
2010;"TRAJANO DE MORAIS (RJ)";"RJ";"TRAJANO DE MORAIS";49;11;11;71
2010;"TRES RIOS (RJ)";"RJ";"TRES RIOS";789;86;194;1069
2010;"VALENCA (RJ)";"RJ";"VALENCA";282;67;63;412
2010;"VARRE SAI (RJ)";"RJ";"VARRE SAI";50;8;2;60
2010;"VASSOURAS (RJ)";"RJ";"VASSOURAS";442;67;100;609
2010;"VOLTA REDONDA (RJ)";"RJ";"VOLTA REDONDA";2132;266;551;2949
2010;"ACARI (RN)";"RN";"ACARI";89;9;7;105
2010;"AFONSO BEZERRA (RN)";"RN";"AFONSO BEZERRA";18;2;3;23
2010;"AGUA NOVA (RN)";"RN";"AGUA NOVA";3;10;1;14
2010;"ALEXANDRIA (RN)";"RN";"ALEXANDRIA";48;30;11;89
2010;"ALMINO AFONSO (RN)";"RN";"ALMINO AFONSO";15;8;1;24
2010;"ALTO DO RODRIGUES (RN)";"RN";"ALTO DO RODRIGUES";124;13;19;156
2010;"ANGICOS (RN)";"RN";"ANGICOS";97;9;10;116
2010;"ANTONIO MARTINS (RN)";"RN";"ANTONIO MARTINS";13;10;1;24
2010;"APODI (RN)";"RN";"APODI";227;14;18;259
2010;"AREIA BRANCA (RN)";"RN";"AREIA BRANCA";101;33;49;183
2010;"ARES (RN)";"RN";"ARES";73;7;19;99
2010;"ASSU (RN)";"RN";"ASSU";456;43;64;563
2010;"BAIA FORMOSA (RN)";"RN";"BAIA FORMOSA";41;2;13;56
2010;"BARAUNA (RN)";"RN";"BARAUNA";135;15;14;164
2010;"BARCELONA (RN)";"RN";"BARCELONA";19;2;2;23
2010;"BENTO FERNANDES (RN)";"RN";"BENTO FERNANDES";13;6;5;24
2010;"BOA SAUDE (RN)";"RN";"BOA SAUDE";51;5;5;61
2010;"BODO (RN)";"RN";"BODO";5;6;1;12
2010;"BOM JESUS (RN)";"RN";"BOM JESUS";44;3;4;51
2010;"BREJINHO (RN)";"RN";"BREJINHO";57;10;11;78
2010;"CAICARA DO NORTE (RN)";"RN";"CAICARA DO NORTE";11;1;4;16
2010;"CAICARA DO RIO DO VENTO (RN)";"RN";"CAICARA DO RIO DO VENTO";20;5;1;26
2010;"CAICO (RN)";"RN";"CAICO";1381;71;40;1492
2010;"CAMPO GRANDE (RN)";"RN";"CAMPO GRANDE";32;9;0;41
2010;"CAMPO REDONDO (RN)";"RN";"CAMPO REDONDO";40;13;9;62
2010;"CANGUARETAMA (RN)";"RN";"CANGUARETAMA";121;19;60;200
2010;"CARAUBAS (RN)";"RN";"CARAUBAS";121;13;6;140
2010;"CARNAUBA DOS DANTAS (RN)";"RN";"CARNAUBA DOS DANTAS";159;5;6;170
2010;"CARNAUBAIS (RN)";"RN";"CARNAUBAIS";42;19;11;72
2010;"CEARA MIRIM (RN)";"RN";"CEARA MIRIM";275;31;101;407
2010;"CERRO CORA (RN)";"RN";"CERRO CORA";69;5;4;78
2010;"CORONEL EZEQUIEL (RN)";"RN";"CORONEL EZEQUIEL";21;8;3;32
2010;"CORONEL JOAO PESSOA (RN)";"RN";"CORONEL JOAO PESSOA";9;3;1;13
2010;"CRUZETA (RN)";"RN";"CRUZETA";66;13;2;81
2010;"CURRAIS NOVOS (RN)";"RN";"CURRAIS NOVOS";557;43;51;651
2010;"DOUTOR SEVERIANO (RN)";"RN";"DOUTOR SEVERIANO";10;8;2;20
2010;"ENCANTO (RN)";"RN";"ENCANTO";13;9;8;30
2010;"EQUADOR (RN)";"RN";"EQUADOR";74;4;1;79
2010;"ESPIRITO SANTO (RN)";"RN";"ESPIRITO SANTO";17;4;11;32
2010;"EXTREMOZ (RN)";"RN";"EXTREMOZ";44;13;37;94
2010;"FELIPE GUERRA (RN)";"RN";"FELIPE GUERRA";13;5;4;22
2010;"FERNANDO PEDROZA (RN)";"RN";"FERNANDO PEDROZA";18;2;2;22
2010;"FLORANIA (RN)";"RN";"FLORANIA";43;7;3;53
2010;"FRANCISCO DANTAS (RN)";"RN";"FRANCISCO DANTAS";7;3;2;12
2010;"FRUTUOSO GOMES (RN)";"RN";"FRUTUOSO GOMES";17;12;0;29
2010;"GALINHOS (RN)";"RN";"GALINHOS";7;3;2;12
2010;"GOIANINHA (RN)";"RN";"GOIANINHA";123;28;46;197
2010;"GOVERNADOR DIX SEPT ROSADO (RN)";"RN";"GOVERNADOR DIX SEPT ROSADO";117;18;11;146
2010;"GROSSOS (RN)";"RN";"GROSSOS";41;5;10;56
2010;"GUAMARE (RN)";"RN";"GUAMARE";67;19;22;108
2010;"IELMO MARINHO (RN)";"RN";"IELMO MARINHO";40;2;17;59
2010;"IPANGUACU (RN)";"RN";"IPANGUACU";63;20;55;138
2010;"IPUEIRA (RN)";"RN";"IPUEIRA";13;7;6;26
2010;"ITAJA (RN)";"RN";"ITAJA";85;3;4;92
2010;"ITAU (RN)";"RN";"ITAU";24;6;2;32
2010;"JACANA (RN)";"RN";"JACANA";85;31;16;132
2010;"JANDAIRA (RN)";"RN";"JANDAIRA";33;1;10;44
2010;"JANDUIS (RN)";"RN";"JANDUIS";10;4;3;17
2010;"JAPI (RN)";"RN";"JAPI";32;8;7;47
2010;"JARDIM DE ANGICOS (RN)";"RN";"JARDIM DE ANGICOS";4;0;1;5
2010;"JARDIM DE PIRANHAS (RN)";"RN";"JARDIM DE PIRANHAS";83;17;7;107
2010;"JARDIM DO SERIDO (RN)";"RN";"JARDIM DO SERIDO";123;19;45;187
2010;"JOAO CAMARA (RN)";"RN";"JOAO CAMARA";267;15;21;303
2010;"JOAO DIAS (RN)";"RN";"JOAO DIAS";3;0;1;4
2010;"JOSE DA PENHA (RN)";"RN";"JOSE DA PENHA";17;9;3;29
2010;"JUCURUTU (RN)";"RN";"JUCURUTU";113;29;9;151
2010;"JUNDIA (RN)";"RN";"JUNDIA";9;4;9;22
2010;"LAGOA DANTA (RN)";"RN";"LAGOA DANTA";32;4;13;49
2010;"LAGOA DE PEDRAS (RN)";"RN";"LAGOA DE PEDRAS";24;4;11;39
2010;"LAGOA DE VELHOS (RN)";"RN";"LAGOA DE VELHOS";18;1;0;19
2010;"LAGOA NOVA (RN)";"RN";"LAGOA NOVA";65;5;6;76
2010;"LAGOA SALGADA (RN)";"RN";"LAGOA SALGADA";55;4;4;63
2010;"LAJES (RN)";"RN";"LAJES";48;3;8;59
2010;"LAJES PINTADAS (RN)";"RN";"LAJES PINTADAS";18;8;4;30
2010;"LUCRECIA (RN)";"RN";"LUCRECIA";19;6;2;27
2010;"LUIS GOMES (RN)";"RN";"LUIS GOMES";26;34;4;64
2010;"MACAIBA (RN)";"RN";"MACAIBA";608;60;56;724
2010;"MACAU (RN)";"RN";"MACAU";138;28;43;209
2010;"MAJOR SALES (RN)";"RN";"MAJOR SALES";10;10;0;20
2010;"MARCELINO VIEIRA (RN)";"RN";"MARCELINO VIEIRA";12;9;2;23
2010;"MARTINS (RN)";"RN";"MARTINS";32;8;5;45
2010;"MAXARANGUAPE (RN)";"RN";"MAXARANGUAPE";15;6;6;27
2010;"MESSIAS TARGINO (RN)";"RN";"MESSIAS TARGINO";28;7;2;37
2010;"MONTANHAS (RN)";"RN";"MONTANHAS";43;5;13;61
2010;"MONTE ALEGRE (RN)";"RN";"MONTE ALEGRE";83;9;9;101
2010;"MONTE DAS GAMELEIRAS (RN)";"RN";"MONTE DAS GAMELEIRAS";10;3;6;19
2010;"MOSSORO (RN)";"RN";"MOSSORO";3127;253;196;3576
2010;"NATAL (RN)";"RN";"NATAL";5963;1106;2142;9211
2010;"NISIA FLORESTA (RN)";"RN";"NISIA FLORESTA";63;34;53;150
2010;"NOVA CRUZ (RN)";"RN";"NOVA CRUZ";292;22;48;362
2010;"OLHO D AGUA DO BORGES (RN)";"RN";"OLHO D AGUA DO BORGES";15;2;1;18
2010;"OURO BRANCO (RN)";"RN";"OURO BRANCO";36;3;5;44
2010;"PARANA (RN)";"RN";"PARANA";13;9;2;24
2010;"PARAU (RN)";"RN";"PARAU";13;8;2;23
2010;"PARAZINHO (RN)";"RN";"PARAZINHO";20;3;6;29
2010;"PARELHAS (RN)";"RN";"PARELHAS";317;22;28;367
2010;"PARNAMIRIM (RN)";"RN";"PARNAMIRIM";1585;300;259;2144
2010;"PASSA E FICA (RN)";"RN";"PASSA E FICA";90;26;18;134
2010;"PASSAGEM (RN)";"RN";"PASSAGEM";15;6;2;23
2010;"PATU (RN)";"RN";"PATU";65;21;1;87
2010;"PAU DOS FERROS (RN)";"RN";"PAU DOS FERROS";338;36;26;400
2010;"PEDRA GRANDE (RN)";"RN";"PEDRA GRANDE";8;1;5;14
2010;"PEDRA PRETA (RN)";"RN";"PEDRA PRETA";22;1;7;30
2010;"PEDRO AVELINO (RN)";"RN";"PEDRO AVELINO";29;3;3;35
2010;"PEDRO VELHO (RN)";"RN";"PEDRO VELHO";43;5;11;59
2010;"PENDENCIAS (RN)";"RN";"PENDENCIAS";39;12;13;64
2010;"PILOES (RN)";"RN";"PILOES";6;4;1;11
2010;"POCO BRANCO (RN)";"RN";"POCO BRANCO";28;2;4;34
2010;"PORTALEGRE (RN)";"RN";"PORTALEGRE";34;6;3;43
2010;"PORTO DO MANGUE (RN)";"RN";"PORTO DO MANGUE";40;9;7;56
2010;"PUREZA (RN)";"RN";"PUREZA";56;4;12;72
2010;"RAFAEL FERNANDES (RN)";"RN";"RAFAEL FERNANDES";10;5;1;16
2010;"RAFAEL GODEIRO (RN)";"RN";"RAFAEL GODEIRO";7;1;0;8
2010;"RIACHO DA CRUZ (RN)";"RN";"RIACHO DA CRUZ";3;3;1;7
2010;"RIACHO DE SANTANA (RN)";"RN";"RIACHO DE SANTANA";4;9;1;14
2010;"RIACHUELO (RN)";"RN";"RIACHUELO";23;2;4;29
2010;"RIO DO FOGO (RN)";"RN";"RIO DO FOGO";33;5;6;44
2010;"RODOLFO FERNANDES (RN)";"RN";"RODOLFO FERNANDES";14;7;2;23
2010;"RUY BARBOSA (RN)";"RN";"RUY BARBOSA";13;1;2;16
2010;"SANTA CRUZ (RN)";"RN";"SANTA CRUZ";345;16;25;386
2010;"SANTA MARIA (RN)";"RN";"SANTA MARIA";43;2;5;50
2010;"SANTANA DO MATOS (RN)";"RN";"SANTANA DO MATOS";66;10;4;80
2010;"SANTANA DO SERIDO (RN)";"RN";"SANTANA DO SERIDO";16;2;1;19
2010;"SANTO ANTONIO (RN)";"RN";"SANTO ANTONIO";98;33;19;150
2010;"SAO BENTO DO NORTE (RN)";"RN";"SAO BENTO DO NORTE";7;0;4;11
2010;"SAO BENTO DO TRAIRI (RN)";"RN";"SAO BENTO DO TRAIRI";16;2;2;20
2010;"SAO FERNANDO (RN)";"RN";"SAO FERNANDO";7;6;2;15
2010;"SAO FRANCISCO DO OESTE (RN)";"RN";"SAO FRANCISCO DO OESTE";12;3;2;17
2010;"SAO GONCALO DO AMARANTE (RN)";"RN";"SAO GONCALO DO AMARANTE";290;90;176;556
2010;"SAO JOAO DO SABUGI (RN)";"RN";"SAO JOAO DO SABUGI";34;16;2;52
2010;"SAO JOSE DE MIPIBU (RN)";"RN";"SAO JOSE DE MIPIBU";213;35;48;296
2010;"SAO JOSE DO CAMPESTRE (RN)";"RN";"SAO JOSE DO CAMPESTRE";67;5;10;82
2010;"SAO JOSE DO SERIDO (RN)";"RN";"SAO JOSE DO SERIDO";25;9;2;36
2010;"SAO MIGUEL (RN)";"RN";"SAO MIGUEL";151;17;21;189
2010;"SAO MIGUEL DO GOSTOSO (RN)";"RN";"SAO MIGUEL DO GOSTOSO";18;6;9;33
2010;"SAO PAULO DO POTENGI (RN)";"RN";"SAO PAULO DO POTENGI";112;9;8;129
2010;"SAO PEDRO (RN)";"RN";"SAO PEDRO";27;2;5;34
2010;"SAO RAFAEL (RN)";"RN";"SAO RAFAEL";27;14;3;44
2010;"SAO TOME (RN)";"RN";"SAO TOME";46;3;18;67
2010;"SAO VICENTE (RN)";"RN";"SAO VICENTE";42;3;1;46
2010;"SENADOR ELOI DE SOUZA (RN)";"RN";"SENADOR ELOI DE SOUZA";10;5;6;21
2010;"SENADOR GEORGINO AVELINO (RN)";"RN";"SENADOR GEORGINO AVELINO";8;1;2;11
2010;"SERRA CAIADA (RN)";"RN";"SERRA CAIADA";26;3;9;38
2010;"SERRA DE SAO BENTO (RN)";"RN";"SERRA DE SAO BENTO";24;7;2;33
2010;"SERRA DO MEL (RN)";"RN";"SERRA DO MEL";61;10;9;80
2010;"SERRA NEGRA DO NORTE (RN)";"RN";"SERRA NEGRA DO NORTE";87;14;4;105
2010;"SERRINHA (RN)";"RN";"SERRINHA";19;14;4;37
2010;"SERRINHA DOS PINTOS (RN)";"RN";"SERRINHA DOS PINTOS";25;7;2;34
2010;"SEVERIANO MELO (RN)";"RN";"SEVERIANO MELO";27;3;5;35
2010;"SITIO NOVO (RN)";"RN";"SITIO NOVO";16;5;1;22
2010;"TABOLEIRO GRANDE (RN)";"RN";"TABOLEIRO GRANDE";8;7;1;16
2010;"TAIPU (RN)";"RN";"TAIPU";53;3;10;66
2010;"TANGARA (RN)";"RN";"TANGARA";90;8;23;121
2010;"TENENTE ANANIAS (RN)";"RN";"TENENTE ANANIAS";33;9;4;46
2010;"TENENTE LAURENTINO CRUZ (RN)";"RN";"TENENTE LAURENTINO CRUZ";32;6;5;43
2010;"TIBAU (RN)";"RN";"TIBAU";22;9;6;37
2010;"TIBAU DO SUL (RN)";"RN";"TIBAU DO SUL";42;39;11;92
2010;"TIMBAUBA DOS BATISTAS (RN)";"RN";"TIMBAUBA DOS BATISTAS";20;6;2;28
2010;"TOUROS (RN)";"RN";"TOUROS";137;22;33;192
2010;"TRIUNFO POTIGUAR (RN)";"RN";"TRIUNFO POTIGUAR";8;7;1;16
2010;"UMARIZAL (RN)";"RN";"UMARIZAL";56;25;2;83
2010;"UPANEMA (RN)";"RN";"UPANEMA";46;11;9;66
2010;"VARZEA (RN)";"RN";"VARZEA";9;4;7;20
2010;"VENHA VER (RN)";"RN";"VENHA VER";14;4;2;20
2010;"VERA CRUZ (RN)";"RN";"VERA CRUZ";112;5;17;134
2010;"VICOSA (RN)";"RN";"VICOSA";4;1;1;6
2010;"VILA FLOR (RN)";"RN";"VILA FLOR";11;1;3;15
2010;"ALTA FLORESTA D OESTE (RO)";"RO";"ALTA FLORESTA D OESTE";488;12;38;538
2010;"ALTO ALEGRE DOS PARECIS (RO)";"RO";"ALTO ALEGRE DOS PARECIS";102;6;20;128
2010;"ALTO PARAISO (RO)";"RO";"ALTO PARAISO";194;7;33;234
2010;"ALVORADA D OESTE (RO)";"RO";"ALVORADA D OESTE";249;6;64;319
2010;"ARIQUEMES (RO)";"RO";"ARIQUEMES";1885;26;154;2065
2010;"BURITIS (RO)";"RO";"BURITIS";371;5;18;394
2010;"CABIXI (RO)";"RO";"CABIXI";58;1;15;74
2010;"CACAULANDIA (RO)";"RO";"CACAULANDIA";56;2;11;69
2010;"CACOAL (RO)";"RO";"CACOAL";1410;41;243;1694
2010;"CAMPO NOVO DE RONDONIA (RO)";"RO";"CAMPO NOVO DE RONDONIA";49;1;9;59
2010;"CANDEIAS DO JAMARI (RO)";"RO";"CANDEIAS DO JAMARI";119;2;8;129
2010;"CASTANHEIRAS (RO)";"RO";"CASTANHEIRAS";29;1;6;36
2010;"CEREJEIRAS (RO)";"RO";"CEREJEIRAS";312;7;39;358
2010;"CHUPINGUAIA (RO)";"RO";"CHUPINGUAIA";80;5;20;105
2010;"COLORADO DO OESTE (RO)";"RO";"COLORADO DO OESTE";359;8;38;405
2010;"CORUMBIARA (RO)";"RO";"CORUMBIARA";54;4;11;69
2010;"COSTA MARQUES (RO)";"RO";"COSTA MARQUES";58;3;12;73
2010;"CUJUBIM (RO)";"RO";"CUJUBIM";122;4;13;139
2010;"ESPIGAO D OESTE (RO)";"RO";"ESPIGAO D OESTE";460;4;75;539
2010;"GOVERNADOR JORGE TEIXEIRA (RO)";"RO";"GOVERNADOR JORGE TEIXEIRA";36;1;11;48
2010;"GUAJARA MIRIM (RO)";"RO";"GUAJARA MIRIM";619;11;41;671
2010;"ITAPUA DO OESTE (RO)";"RO";"ITAPUA DO OESTE";84;0;29;113
2010;"JARU (RO)";"RO";"JARU";974;20;176;1170
2010;"JI PARANA (RO)";"RO";"JI PARANA";2486;61;542;3089
2010;"MACHADINHO D OESTE (RO)";"RO";"MACHADINHO D OESTE";262;5;39;306
2010;"MINISTRO ANDREAZZA (RO)";"RO";"MINISTRO ANDREAZZA";155;3;11;169
2010;"MIRANTE DA SERRA (RO)";"RO";"MIRANTE DA SERRA";157;3;21;181
2010;"MONTE NEGRO (RO)";"RO";"MONTE NEGRO";218;6;49;273
2010;"NOVA BRASILANDIA D OESTE (RO)";"RO";"NOVA BRASILANDIA D OESTE";226;6;37;269
2010;"NOVA DO MAMORE (RO)";"RO";"NOVA DO MAMORE";156;1;14;171
2010;"NOVA UNIAO (RO)";"RO";"NOVA UNIAO";39;1;8;48
2010;"NOVO HORIZONTE DO OESTE (RO)";"RO";"NOVO HORIZONTE DO OESTE";72;2;13;87
2010;"OURO PRETO DO OESTE (RO)";"RO";"OURO PRETO DO OESTE";666;23;97;786
2010;"PARECIS (RO)";"RO";"PARECIS";24;1;10;35
2010;"PIMENTA BUENO (RO)";"RO";"PIMENTA BUENO";866;30;68;964
2010;"PIMENTEIRAS DO OESTE (RO)";"RO";"PIMENTEIRAS DO OESTE";8;1;9;18
2010;"PORTO VELHO (RO)";"RO";"PORTO VELHO";5197;320;1067;6584
2010;"PRESIDENTE MEDICI (RO)";"RO";"PRESIDENTE MEDICI";275;6;39;320
2010;"PRIMAVERA DE RONDONIA (RO)";"RO";"PRIMAVERA DE RONDONIA";27;2;10;39
2010;"RIO CRESPO (RO)";"RO";"RIO CRESPO";48;1;15;64
2010;"ROLIM DE MOURA (RO)";"RO";"ROLIM DE MOURA";1012;27;99;1138
2010;"SANTA LUZIA D OESTE (RO)";"RO";"SANTA LUZIA D OESTE";121;3;32;156
2010;"SAO FELIPE D OESTE (RO)";"RO";"SAO FELIPE D OESTE";61;1;18;80
2010;"SAO FRANCISCO DO GUAPORE (RO)";"RO";"SAO FRANCISCO DO GUAPORE";177;2;34;213
2010;"SAO MIGUEL DO GUAPORE (RO)";"RO";"SAO MIGUEL DO GUAPORE";219;5;48;272
2010;"SERINGUEIRAS (RO)";"RO";"SERINGUEIRAS";142;4;21;167
2010;"TEIXEIROPOLIS (RO)";"RO";"TEIXEIROPOLIS";27;0;8;35
2010;"THEOBROMA (RO)";"RO";"THEOBROMA";57;1;15;73
2010;"URUPA (RO)";"RO";"URUPA";98;2;30;130
2010;"VALE DO ANARI (RO)";"RO";"VALE DO ANARI";55;3;5;63
2010;"VALE DO PARAISO (RO)";"RO";"VALE DO PARAISO";56;1;10;67
2010;"VILHENA (RO)";"RO";"VILHENA";1346;45;156;1547
2010;"ALTO ALEGRE (RR)";"RR";"ALTO ALEGRE";42;4;7;53
2010;"AMAJARI (RR)";"RR";"AMAJARI";11;3;0;14
2010;"BOA VISTA (RR)";"RR";"BOA VISTA";2724;337;585;3646
2010;"BONFIM (RR)";"RR";"BONFIM";9;1;0;10
2010;"CANTA (RR)";"RR";"CANTA";23;4;9;36
2010;"CARACARAI (RR)";"RR";"CARACARAI";69;3;5;77
2010;"CAROEBE (RR)";"RR";"CAROEBE";18;5;13;36
2010;"IRACEMA (RR)";"RR";"IRACEMA";20;13;1;34
2010;"MUCAJAI (RR)";"RR";"MUCAJAI";78;29;26;133
2010;"NORMANDIA (RR)";"RR";"NORMANDIA";10;0;1;11
2010;"PACARAIMA (RR)";"RR";"PACARAIMA";41;2;3;46
2010;"RORAINOPOLIS (RR)";"RR";"RORAINOPOLIS";69;11;6;86
2010;"SAO JOAO DA BALIZA (RR)";"RR";"SAO JOAO DA BALIZA";37;7;4;48
2010;"SAO LUIZ (RR)";"RR";"SAO LUIZ";27;3;2;32
2010;"UIRAMUTA (RR)";"RR";"UIRAMUTA";1;0;0;1
2010;"ACEGUA (RS)";"RS";"ACEGUA";56;12;12;80
2010;"AGUA SANTA (RS)";"RS";"AGUA SANTA";141;8;15;164
2010;"AGUDO (RS)";"RS";"AGUDO";293;9;51;353
2010;"AJURICABA (RS)";"RS";"AJURICABA";333;17;31;381
2010;"ALECRIM (RS)";"RS";"ALECRIM";77;5;23;105
2010;"ALEGRETE (RS)";"RS";"ALEGRETE";899;44;192;1135
2010;"ALEGRIA (RS)";"RS";"ALEGRIA";81;4;18;103
2010;"ALMIRANTE TAMANDARE DO SUL (RS)";"RS";"ALMIRANTE TAMANDARE DO SUL";73;9;5;87
2010;"ALPESTRE (RS)";"RS";"ALPESTRE";124;18;42;184
2010;"ALTO ALEGRE (RS)";"RS";"ALTO ALEGRE";77;5;6;88
2010;"ALTO FELIZ (RS)";"RS";"ALTO FELIZ";83;10;11;104
2010;"ALVORADA (RS)";"RS";"ALVORADA";1538;150;628;2316
2010;"AMARAL FERRADOR (RS)";"RS";"AMARAL FERRADOR";135;10;17;162
2010;"AMETISTA DO SUL (RS)";"RS";"AMETISTA DO SUL";56;5;47;108
2010;"ANDRE DA ROCHA (RS)";"RS";"ANDRE DA ROCHA";48;4;5;57
2010;"ANTA GORDA (RS)";"RS";"ANTA GORDA";201;14;21;236
2010;"ANTONIO PRADO (RS)";"RS";"ANTONIO PRADO";623;15;36;674
2010;"ARAMBARE (RS)";"RS";"ARAMBARE";39;6;8;53
2010;"ARARICA (RS)";"RS";"ARARICA";92;5;7;104
2010;"ARATIBA (RS)";"RS";"ARATIBA";149;24;23;196
2010;"ARROIO DO MEIO (RS)";"RS";"ARROIO DO MEIO";467;37;43;547
2010;"ARROIO DO PADRE (RS)";"RS";"ARROIO DO PADRE";88;6;11;105
2010;"ARROIO DO SAL (RS)";"RS";"ARROIO DO SAL";97;11;9;117
2010;"ARROIO DO TIGRE (RS)";"RS";"ARROIO DO TIGRE";252;21;32;305
2010;"ARROIO DOS RATOS (RS)";"RS";"ARROIO DOS RATOS";187;11;57;255
2010;"ARROIO GRANDE (RS)";"RS";"ARROIO GRANDE";242;15;45;302
2010;"ARVOREZINHA (RS)";"RS";"ARVOREZINHA";430;33;30;493
2010;"AUGUSTO PESTANA (RS)";"RS";"AUGUSTO PESTANA";374;13;27;414
2010;"AUREA (RS)";"RS";"AUREA";115;5;7;127
2010;"BAGE (RS)";"RS";"BAGE";1069;151;279;1499
2010;"BALNEARIO PINHAL (RS)";"RS";"BALNEARIO PINHAL";99;6;17;122
2010;"BARAO (RS)";"RS";"BARAO";173;28;30;231
2010;"BARAO DE COTEGIPE (RS)";"RS";"BARAO DE COTEGIPE";202;16;15;233
2010;"BARAO DO TRIUNFO (RS)";"RS";"BARAO DO TRIUNFO";127;20;30;177
2010;"BARRA DO GUARITA (RS)";"RS";"BARRA DO GUARITA";21;5;4;30
2010;"BARRA DO QUARAI (RS)";"RS";"BARRA DO QUARAI";30;3;12;45
2010;"BARRA DO RIBEIRO (RS)";"RS";"BARRA DO RIBEIRO";144;10;40;194
2010;"BARRA DO RIO AZUL (RS)";"RS";"BARRA DO RIO AZUL";39;10;8;57
2010;"BARRA FUNDA (RS)";"RS";"BARRA FUNDA";168;6;7;181
2010;"BARRACAO (RS)";"RS";"BARRACAO";138;7;17;162
2010;"BARROS CASSAL (RS)";"RS";"BARROS CASSAL";147;12;45;204
2010;"BENJAMIN CONSTANT DO SUL (RS)";"RS";"BENJAMIN CONSTANT DO SUL";25;5;6;36
2010;"BENTO GONCALVES (RS)";"RS";"BENTO GONCALVES";3100;225;304;3629
2010;"BOA VISTA DAS MISSOES (RS)";"RS";"BOA VISTA DAS MISSOES";76;4;15;95
2010;"BOA VISTA DO BURICA (RS)";"RS";"BOA VISTA DO BURICA";207;11;19;237
2010;"BOA VISTA DO CADEADO (RS)";"RS";"BOA VISTA DO CADEADO";73;2;18;93
2010;"BOA VISTA DO INCRA (RS)";"RS";"BOA VISTA DO INCRA";60;1;6;67
2010;"BOA VISTA DO SUL (RS)";"RS";"BOA VISTA DO SUL";324;6;10;340
2010;"BOM JESUS (RS)";"RS";"BOM JESUS";250;26;40;316
2010;"BOM PRINCIPIO (RS)";"RS";"BOM PRINCIPIO";398;30;23;451
2010;"BOM PROGRESSO (RS)";"RS";"BOM PROGRESSO";40;6;4;50
2010;"BOM RETIRO DO SUL (RS)";"RS";"BOM RETIRO DO SUL";154;10;30;194
2010;"BOQUEIRAO DO LEAO (RS)";"RS";"BOQUEIRAO DO LEAO";151;9;17;177
2010;"BOSSOROCA (RS)";"RS";"BOSSOROCA";167;3;19;189
2010;"BOZANO (RS)";"RS";"BOZANO";121;2;5;128
2010;"BRAGA (RS)";"RS";"BRAGA";62;1;12;75
2010;"BROCHIER (RS)";"RS";"BROCHIER";252;12;21;285
2010;"BUTIA (RS)";"RS";"BUTIA";402;18;94;514
2010;"CACAPAVA DO SUL (RS)";"RS";"CACAPAVA DO SUL";540;51;94;685
2010;"CACEQUI (RS)";"RS";"CACEQUI";119;16;19;154
2010;"CACHOEIRA DO SUL (RS)";"RS";"CACHOEIRA DO SUL";1087;73;202;1362
2010;"CACHOEIRINHA (RS)";"RS";"CACHOEIRINHA";2043;206;430;2679
2010;"CACIQUE DOBLE (RS)";"RS";"CACIQUE DOBLE";100;4;12;116
2010;"CAIBATE (RS)";"RS";"CAIBATE";112;8;3;123
2010;"CAICARA (RS)";"RS";"CAICARA";70;8;18;96
2010;"CAMAQUA (RS)";"RS";"CAMAQUA";1223;55;216;1494
2010;"CAMARGO (RS)";"RS";"CAMARGO";121;8;17;146
2010;"CAMBARA DO SUL (RS)";"RS";"CAMBARA DO SUL";264;12;31;307
2010;"CAMPESTRE DA SERRA (RS)";"RS";"CAMPESTRE DA SERRA";151;3;11;165
2010;"CAMPINA DAS MISSOES (RS)";"RS";"CAMPINA DAS MISSOES";117;14;29;160
2010;"CAMPINAS DO SUL (RS)";"RS";"CAMPINAS DO SUL";185;13;23;221
2010;"CAMPO BOM (RS)";"RS";"CAMPO BOM";665;79;92;836
2010;"CAMPO NOVO (RS)";"RS";"CAMPO NOVO";136;14;20;170
2010;"CAMPOS BORGES (RS)";"RS";"CAMPOS BORGES";119;10;12;141
2010;"CANDELARIA (RS)";"RS";"CANDELARIA";385;22;68;475
2010;"CANDIDO GODOI (RS)";"RS";"CANDIDO GODOI";193;14;18;225
2010;"CANDIOTA (RS)";"RS";"CANDIOTA";121;30;37;188
2010;"CANELA (RS)";"RS";"CANELA";510;76;105;691
2010;"CANGUCU (RS)";"RS";"CANGUCU";1002;77;144;1223
2010;"CANOAS (RS)";"RS";"CANOAS";4060;386;867;5313
2010;"CANUDOS DO VALE (RS)";"RS";"CANUDOS DO VALE";25;12;2;39
2010;"CAPAO BONITO DO SUL (RS)";"RS";"CAPAO BONITO DO SUL";37;3;8;48
2010;"CAPAO DA CANOA (RS)";"RS";"CAPAO DA CANOA";387;58;86;531
2010;"CAPAO DO CIPO (RS)";"RS";"CAPAO DO CIPO";80;7;5;92
2010;"CAPAO DO LEAO (RS)";"RS";"CAPAO DO LEAO";446;19;26;491
2010;"CAPELA DE SANTANA (RS)";"RS";"CAPELA DE SANTANA";162;13;12;187
2010;"CAPITAO (RS)";"RS";"CAPITAO";64;8;6;78
2010;"CAPIVARI DO SUL (RS)";"RS";"CAPIVARI DO SUL";118;10;4;132
2010;"CARAA (RS)";"RS";"CARAA";92;2;19;113
2010;"CARAZINHO (RS)";"RS";"CARAZINHO";1267;65;176;1508
2010;"CARLOS BARBOSA (RS)";"RS";"CARLOS BARBOSA";744;46;93;883
2010;"CARLOS GOMES (RS)";"RS";"CARLOS GOMES";23;3;5;31
2010;"CASCA (RS)";"RS";"CASCA";370;19;17;406
2010;"CASEIROS (RS)";"RS";"CASEIROS";135;4;13;152
2010;"CATUIPE (RS)";"RS";"CATUIPE";328;9;25;362
2010;"CAXIAS DO SUL (RS)";"RS";"CAXIAS DO SUL";8037;1253;1487;10777
2010;"CENTENARIO (RS)";"RS";"CENTENARIO";73;9;9;91
2010;"CERRITO (RS)";"RS";"CERRITO";171;4;8;183
2010;"CERRO BRANCO (RS)";"RS";"CERRO BRANCO";62;6;15;83
2010;"CERRO GRANDE (RS)";"RS";"CERRO GRANDE";36;2;11;49
2010;"CERRO GRANDE DO SUL (RS)";"RS";"CERRO GRANDE DO SUL";218;15;17;250
2010;"CERRO LARGO (RS)";"RS";"CERRO LARGO";336;12;36;384
2010;"CHAPADA (RS)";"RS";"CHAPADA";301;35;27;363
2010;"CHARQUEADAS (RS)";"RS";"CHARQUEADAS";326;60;69;455
2010;"CHARRUA (RS)";"RS";"CHARRUA";89;3;9;101
2010;"CHIAPETTA (RS)";"RS";"CHIAPETTA";125;7;9;141
2010;"CHUI (RS)";"RS";"CHUI";120;13;10;143
2010;"CHUVISCA (RS)";"RS";"CHUVISCA";103;6;31;140
2010;"CIDREIRA (RS)";"RS";"CIDREIRA";92;9;22;123
2010;"CIRIACO (RS)";"RS";"CIRIACO";146;14;16;176
2010;"COLINAS (RS)";"RS";"COLINAS";61;6;8;75
2010;"COLORADO (RS)";"RS";"COLORADO";190;13;11;214
2010;"CONDOR (RS)";"RS";"CONDOR";217;15;23;255
2010;"CONSTANTINA (RS)";"RS";"CONSTANTINA";262;17;62;341
2010;"COQUEIRO BAIXO (RS)";"RS";"COQUEIRO BAIXO";19;5;2;26
2010;"COQUEIROS DO SUL (RS)";"RS";"COQUEIROS DO SUL";107;4;10;121
2010;"CORONEL BARROS (RS)";"RS";"CORONEL BARROS";92;1;10;103
2010;"CORONEL BICACO (RS)";"RS";"CORONEL BICACO";187;21;16;224
2010;"CORONEL PILAR (RS)";"RS";"CORONEL PILAR";187;5;9;201
2010;"COTIPORA (RS)";"RS";"COTIPORA";191;11;11;213
2010;"COXILHA (RS)";"RS";"COXILHA";95;4;13;112
2010;"CRISSIUMAL (RS)";"RS";"CRISSIUMAL";276;18;47;341
2010;"CRISTAL (RS)";"RS";"CRISTAL";161;9;24;194
2010;"CRISTAL DO SUL (RS)";"RS";"CRISTAL DO SUL";23;4;15;42
2010;"CRUZ ALTA (RS)";"RS";"CRUZ ALTA";1141;79;104;1324
2010;"CRUZALTENSE (RS)";"RS";"CRUZALTENSE";56;3;6;65
2010;"CRUZEIRO DO SUL (RS)";"RS";"CRUZEIRO DO SUL";330;11;11;352
2010;"DAVID CANABARRO (RS)";"RS";"DAVID CANABARRO";166;6;23;195
2010;"DERRUBADAS (RS)";"RS";"DERRUBADAS";75;11;4;90
2010;"DEZESSEIS DE NOVEMBRO (RS)";"RS";"DEZESSEIS DE NOVEMBRO";51;2;5;58
2010;"DILERMANDO DE AGUIAR (RS)";"RS";"DILERMANDO DE AGUIAR";43;2;27;72
2010;"DOIS IRMAOS (RS)";"RS";"DOIS IRMAOS";418;24;108;550
2010;"DOIS IRMAOS DAS MISSOES (RS)";"RS";"DOIS IRMAOS DAS MISSOES";57;7;5;69
2010;"DOIS LAJEADOS (RS)";"RS";"DOIS LAJEADOS";115;2;16;133
2010;"DOM FELICIANO (RS)";"RS";"DOM FELICIANO";226;15;76;317
2010;"DOM PEDRITO (RS)";"RS";"DOM PEDRITO";546;31;41;618
2010;"DOM PEDRO DE ALCANTARA (RS)";"RS";"DOM PEDRO DE ALCANTARA";88;2;4;94
2010;"DONA FRANCISCA (RS)";"RS";"DONA FRANCISCA";43;1;7;51
2010;"DOUTOR MAURICIO CARDOSO (RS)";"RS";"DOUTOR MAURICIO CARDOSO";164;15;16;195
2010;"DOUTOR RICARDO (RS)";"RS";"DOUTOR RICARDO";58;7;10;75
2010;"ELDORADO DO SUL (RS)";"RS";"ELDORADO DO SUL";418;34;42;494
2010;"ENCANTADO (RS)";"RS";"ENCANTADO";644;46;125;815
2010;"ENCRUZILHADA DO SUL (RS)";"RS";"ENCRUZILHADA DO SUL";352;12;144;508
2010;"ENGENHO VELHO (RS)";"RS";"ENGENHO VELHO";34;2;10;46
2010;"ENTRE IJUIS (RS)";"RS";"ENTRE IJUIS";279;10;22;311
2010;"ENTRE RIOS DO SUL (RS)";"RS";"ENTRE RIOS DO SUL";53;11;15;79
2010;"EREBANGO (RS)";"RS";"EREBANGO";99;1;7;107
2010;"ERECHIM (RS)";"RS";"ERECHIM";1766;240;499;2505
2010;"ERNESTINA (RS)";"RS";"ERNESTINA";146;16;13;175
2010;"ERVAL GRANDE (RS)";"RS";"ERVAL GRANDE";103;19;17;139
2010;"ERVAL SECO (RS)";"RS";"ERVAL SECO";132;8;31;171
2010;"ESMERALDA (RS)";"RS";"ESMERALDA";68;3;11;82
2010;"ESPERANCA DO SUL (RS)";"RS";"ESPERANCA DO SUL";41;2;8;51
2010;"ESPUMOSO (RS)";"RS";"ESPUMOSO";583;26;65;674
2010;"ESTACAO (RS)";"RS";"ESTACAO";180;14;9;203
2010;"ESTANCIA VELHA (RS)";"RS";"ESTANCIA VELHA";758;66;90;914
2010;"ESTEIO (RS)";"RS";"ESTEIO";1108;142;267;1517
2010;"ESTRELA (RS)";"RS";"ESTRELA";919;41;76;1036
2010;"ESTRELA VELHA (RS)";"RS";"ESTRELA VELHA";107;6;14;127
2010;"EUGENIO DE CASTRO (RS)";"RS";"EUGENIO DE CASTRO";86;8;6;100
2010;"FAGUNDES VARELA (RS)";"RS";"FAGUNDES VARELA";102;5;14;121
2010;"FARROUPILHA (RS)";"RS";"FARROUPILHA";1910;222;163;2295
2010;"FAXINAL DO SOTURNO (RS)";"RS";"FAXINAL DO SOTURNO";129;6;8;143
2010;"FAXINALZINHO (RS)";"RS";"FAXINALZINHO";54;9;8;71
2010;"FAZENDA VILANOVA (RS)";"RS";"FAZENDA VILANOVA";132;9;14;155
2010;"FELIZ (RS)";"RS";"FELIZ";380;26;70;476
2010;"FLORES DA CUNHA (RS)";"RS";"FLORES DA CUNHA";1358;67;105;1530
2010;"FLORIANO PEIXOTO (RS)";"RS";"FLORIANO PEIXOTO";55;14;14;83
2010;"FONTOURA XAVIER (RS)";"RS";"FONTOURA XAVIER";196;16;30;242
2010;"FORMIGUEIRO (RS)";"RS";"FORMIGUEIRO";138;5;22;165
2010;"FORQUETINHA (RS)";"RS";"FORQUETINHA";61;3;3;67
2010;"FORTALEZA DOS VALOS (RS)";"RS";"FORTALEZA DOS VALOS";217;2;17;236
2010;"FREDERICO WESTPHALEN (RS)";"RS";"FREDERICO WESTPHALEN";640;28;75;743
2010;"GARIBALDI (RS)";"RS";"GARIBALDI";1307;66;112;1485
2010;"GARRUCHOS (RS)";"RS";"GARRUCHOS";34;7;10;51
2010;"GAURAMA (RS)";"RS";"GAURAMA";172;16;14;202
2010;"GENERAL CAMARA (RS)";"RS";"GENERAL CAMARA";73;9;20;102
2010;"GENTIL (RS)";"RS";"GENTIL";76;7;21;104
2010;"GETULIO VARGAS (RS)";"RS";"GETULIO VARGAS";463;24;27;514
2010;"GIRUA (RS)";"RS";"GIRUA";500;34;44;578
2010;"GLORINHA (RS)";"RS";"GLORINHA";192;26;11;229
2010;"GRAMADO (RS)";"RS";"GRAMADO";620;125;113;858
2010;"GRAMADO DOS LOUREIROS (RS)";"RS";"GRAMADO DOS LOUREIROS";27;1;7;35
2010;"GRAMADO XAVIER (RS)";"RS";"GRAMADO XAVIER";56;4;5;65
2010;"GRAVATAI (RS)";"RS";"GRAVATAI";2935;452;506;3893
2010;"GUABIJU (RS)";"RS";"GUABIJU";49;4;8;61
2010;"GUAIBA (RS)";"RS";"GUAIBA";931;158;380;1469
2010;"GUAPORE (RS)";"RS";"GUAPORE";425;33;69;527
2010;"GUARANI DAS MISSOES (RS)";"RS";"GUARANI DAS MISSOES";211;7;20;238
2010;"HARMONIA (RS)";"RS";"HARMONIA";202;4;9;215
2010;"HERVAL (RS)";"RS";"HERVAL";108;6;7;121
2010;"HERVEIRAS (RS)";"RS";"HERVEIRAS";47;0;2;49
2010;"HORIZONTINA (RS)";"RS";"HORIZONTINA";312;28;47;387
2010;"HULHA NEGRA (RS)";"RS";"HULHA NEGRA";55;10;35;100
2010;"HUMAITA (RS)";"RS";"HUMAITA";103;2;7;112
2010;"IBARAMA (RS)";"RS";"IBARAMA";85;3;15;103
2010;"IBIACA (RS)";"RS";"IBIACA";247;11;18;276
2010;"IBIRAIARAS (RS)";"RS";"IBIRAIARAS";410;8;23;441
2010;"IBIRAPUITA (RS)";"RS";"IBIRAPUITA";121;6;25;152
2010;"IBIRUBA (RS)";"RS";"IBIRUBA";797;44;70;911
2010;"IGREJINHA (RS)";"RS";"IGREJINHA";373;40;76;489
2010;"IJUI (RS)";"RS";"IJUI";1752;105;119;1976
2010;"ILOPOLIS (RS)";"RS";"ILOPOLIS";184;5;5;194
2010;"IMBE (RS)";"RS";"IMBE";227;14;46;287
2010;"IMIGRANTE (RS)";"RS";"IMIGRANTE";89;17;20;126
2010;"INDEPENDENCIA (RS)";"RS";"INDEPENDENCIA";183;19;37;239
2010;"INHACORA (RS)";"RS";"INHACORA";60;5;7;72
2010;"IPE (RS)";"RS";"IPE";258;26;28;312
2010;"IPIRANGA DO SUL (RS)";"RS";"IPIRANGA DO SUL";108;9;11;128
2010;"IRAI (RS)";"RS";"IRAI";111;7;18;136
2010;"ITAARA (RS)";"RS";"ITAARA";105;3;16;124
2010;"ITACURUBI (RS)";"RS";"ITACURUBI";35;6;7;48
2010;"ITAPUCA (RS)";"RS";"ITAPUCA";44;3;9;56
2010;"ITAQUI (RS)";"RS";"ITAQUI";601;22;63;686
2010;"ITATI (RS)";"RS";"ITATI";69;4;9;82
2010;"ITATIBA DO SUL (RS)";"RS";"ITATIBA DO SUL";76;14;7;97
2010;"IVORA (RS)";"RS";"IVORA";60;3;4;67
2010;"IVOTI (RS)";"RS";"IVOTI";488;34;101;623
2010;"JABOTICABA (RS)";"RS";"JABOTICABA";53;3;15;71
2010;"JACUIZINHO (RS)";"RS";"JACUIZINHO";48;4;13;65
2010;"JACUTINGA (RS)";"RS";"JACUTINGA";103;7;7;117
2010;"JAGUARAO (RS)";"RS";"JAGUARAO";287;13;36;336
2010;"JAGUARI (RS)";"RS";"JAGUARI";223;19;51;293
2010;"JAQUIRANA (RS)";"RS";"JAQUIRANA";139;7;10;156
2010;"JARI (RS)";"RS";"JARI";52;5;9;66
2010;"JOIA (RS)";"RS";"JOIA";266;13;34;313
2010;"JULIO DE CASTILHOS (RS)";"RS";"JULIO DE CASTILHOS";558;23;48;629
2010;"LAGOA BONITA DO SUL (RS)";"RS";"LAGOA BONITA DO SUL";46;5;13;64
2010;"LAGOA DOS TRES CANTOS (RS)";"RS";"LAGOA DOS TRES CANTOS";79;6;4;89
2010;"LAGOA VERMELHA (RS)";"RS";"LAGOA VERMELHA";605;40;75;720
2010;"LAGOAO (RS)";"RS";"LAGOAO";69;4;30;103
2010;"LAJEADO (RS)";"RS";"LAJEADO";1883;148;238;2269
2010;"LAJEADO DO BUGRE (RS)";"RS";"LAJEADO DO BUGRE";18;2;6;26
2010;"LAVRAS DO SUL (RS)";"RS";"LAVRAS DO SUL";72;11;20;103
2010;"LIBERATO SALZANO (RS)";"RS";"LIBERATO SALZANO";103;7;23;133
2010;"LINDOLFO COLLOR (RS)";"RS";"LINDOLFO COLLOR";106;9;9;124
2010;"LINHA NOVA (RS)";"RS";"LINHA NOVA";66;5;3;74
2010;"MACAMBARA (RS)";"RS";"MACAMBARA";35;3;30;68
2010;"MACHADINHO (RS)";"RS";"MACHADINHO";91;7;27;125
2010;"MAMPITUBA (RS)";"RS";"MAMPITUBA";30;1;10;41
2010;"MANOEL VIANA (RS)";"RS";"MANOEL VIANA";152;5;11;168
2010;"MAQUINE (RS)";"RS";"MAQUINE";257;10;12;279
2010;"MARATA (RS)";"RS";"MARATA";101;11;25;137
2010;"MARAU (RS)";"RS";"MARAU";995;66;125;1186
2010;"MARCELINO RAMOS (RS)";"RS";"MARCELINO RAMOS";122;17;23;162
2010;"MARIANA PIMENTEL (RS)";"RS";"MARIANA PIMENTEL";104;7;24;135
2010;"MARIANO MORO (RS)";"RS";"MARIANO MORO";60;11;8;79
2010;"MARQUES DE SOUZA (RS)";"RS";"MARQUES DE SOUZA";127;14;22;163
2010;"MATA (RS)";"RS";"MATA";91;3;18;112
2010;"MATO CASTELHANO (RS)";"RS";"MATO CASTELHANO";109;9;20;138
2010;"MATO LEITAO (RS)";"RS";"MATO LEITAO";288;8;8;304
2010;"MATO QUEIMADO (RS)";"RS";"MATO QUEIMADO";51;5;5;61
2010;"MAXIMILIANO DE ALMEIDA (RS)";"RS";"MAXIMILIANO DE ALMEIDA";125;7;76;208
2010;"MINAS DO LEAO (RS)";"RS";"MINAS DO LEAO";101;11;26;138
2010;"MIRAGUAI (RS)";"RS";"MIRAGUAI";81;4;21;106
2010;"MONTAURI (RS)";"RS";"MONTAURI";55;3;7;65
2010;"MONTE ALEGRE DOS CAMPOS (RS)";"RS";"MONTE ALEGRE DOS CAMPOS";65;4;28;97
2010;"MONTE BELO DO SUL (RS)";"RS";"MONTE BELO DO SUL";188;9;15;212
2010;"MONTENEGRO (RS)";"RS";"MONTENEGRO";1194;131;189;1514
2010;"MORMACO (RS)";"RS";"MORMACO";73;4;7;84
2010;"MORRINHOS DO SUL (RS)";"RS";"MORRINHOS DO SUL";135;1;5;141
2010;"MORRO REDONDO (RS)";"RS";"MORRO REDONDO";200;3;16;219
2010;"MORRO REUTER (RS)";"RS";"MORRO REUTER";148;9;23;180
2010;"MOSTARDAS (RS)";"RS";"MOSTARDAS";265;7;53;325
2010;"MUCUM (RS)";"RS";"MUCUM";85;10;17;112
2010;"MUITOS CAPOES (RS)";"RS";"MUITOS CAPOES";63;3;6;72
2010;"MULITERNO (RS)";"RS";"MULITERNO";85;4;9;98
2010;"NAO ME TOQUE (RS)";"RS";"NAO ME TOQUE";503;27;53;583
2010;"NICOLAU VERGUEIRO (RS)";"RS";"NICOLAU VERGUEIRO";88;5;14;107
2010;"NONOAI (RS)";"RS";"NONOAI";204;12;45;261
2010;"NOVA ALVORADA (RS)";"RS";"NOVA ALVORADA";128;3;14;145
2010;"NOVA ARACA (RS)";"RS";"NOVA ARACA";151;18;26;195
2010;"NOVA BASSANO (RS)";"RS";"NOVA BASSANO";452;31;38;521
2010;"NOVA BOA VISTA (RS)";"RS";"NOVA BOA VISTA";61;7;11;79
2010;"NOVA BRESCIA (RS)";"RS";"NOVA BRESCIA";105;13;9;127
2010;"NOVA CANDELARIA (RS)";"RS";"NOVA CANDELARIA";64;6;7;77
2010;"NOVA ESPERANCA DO SUL (RS)";"RS";"NOVA ESPERANCA DO SUL";63;5;24;92
2010;"NOVA HARTZ (RS)";"RS";"NOVA HARTZ";126;14;62;202
2010;"NOVA PADUA (RS)";"RS";"NOVA PADUA";304;3;6;313
2010;"NOVA PALMA (RS)";"RS";"NOVA PALMA";214;12;24;250
2010;"NOVA PETROPOLIS (RS)";"RS";"NOVA PETROPOLIS";506;41;61;608
2010;"NOVA PRATA (RS)";"RS";"NOVA PRATA";585;20;53;658
2010;"NOVA RAMADA (RS)";"RS";"NOVA RAMADA";87;7;8;102
2010;"NOVA ROMA DO SUL (RS)";"RS";"NOVA ROMA DO SUL";268;7;23;298
2010;"NOVA SANTA RITA (RS)";"RS";"NOVA SANTA RITA";490;41;40;571
2010;"NOVO BARREIRO (RS)";"RS";"NOVO BARREIRO";104;7;15;126
2010;"NOVO CABRAIS (RS)";"RS";"NOVO CABRAIS";80;2;8;90
2010;"NOVO HAMBURGO (RS)";"RS";"NOVO HAMBURGO";2695;254;377;3326
2010;"NOVO MACHADO (RS)";"RS";"NOVO MACHADO";131;19;11;161
2010;"NOVO TIRADENTES (RS)";"RS";"NOVO TIRADENTES";31;3;5;39
2010;"NOVO XINGU (RS)";"RS";"NOVO XINGU";30;11;8;49
2010;"OSORIO (RS)";"RS";"OSORIO";871;47;95;1013
2010;"PAIM FILHO (RS)";"RS";"PAIM FILHO";110;4;22;136
2010;"PALMARES DO SUL (RS)";"RS";"PALMARES DO SUL";172;18;27;217
2010;"PALMEIRA DAS MISSOES (RS)";"RS";"PALMEIRA DAS MISSOES";839;21;76;936
2010;"PALMITINHO (RS)";"RS";"PALMITINHO";144;5;34;183
2010;"PANAMBI (RS)";"RS";"PANAMBI";914;53;109;1076
2010;"PANTANO GRANDE (RS)";"RS";"PANTANO GRANDE";296;6;20;322
2010;"PARAI (RS)";"RS";"PARAI";403;7;19;429
2010;"PARAISO DO SUL (RS)";"RS";"PARAISO DO SUL";82;7;8;97
2010;"PARECI NOVO (RS)";"RS";"PARECI NOVO";406;9;19;434
2010;"PAROBE (RS)";"RS";"PAROBE";479;64;133;676
2010;"PASSA SETE (RS)";"RS";"PASSA SETE";81;1;25;107
2010;"PASSO DO SOBRADO (RS)";"RS";"PASSO DO SOBRADO";122;7;39;168
2010;"PASSO FUNDO (RS)";"RS";"PASSO FUNDO";3054;192;337;3583
2010;"PAULO BENTO (RS)";"RS";"PAULO BENTO";68;11;8;87
2010;"PAVERAMA (RS)";"RS";"PAVERAMA";198;27;39;264
2010;"PEDRAS ALTAS (RS)";"RS";"PEDRAS ALTAS";14;15;0;29
2010;"PEDRO OSORIO (RS)";"RS";"PEDRO OSORIO";100;6;29;135
2010;"PEJUCARA (RS)";"RS";"PEJUCARA";207;3;18;228
2010;"PELOTAS (RS)";"RS";"PELOTAS";4883;277;1003;6163
2010;"PICADA CAFE (RS)";"RS";"PICADA CAFE";104;20;59;183
2010;"PINHAL (RS)";"RS";"PINHAL";69;2;10;81
2010;"PINHAL DA SERRA (RS)";"RS";"PINHAL DA SERRA";38;8;12;58
2010;"PINHAL GRANDE (RS)";"RS";"PINHAL GRANDE";103;12;20;135
2010;"PINHEIRINHO DO VALE (RS)";"RS";"PINHEIRINHO DO VALE";55;4;19;78
2010;"PINHEIRO MACHADO (RS)";"RS";"PINHEIRO MACHADO";134;9;45;188
2010;"PINTO BANDEIRA (RS)";"RS";"PINTO BANDEIRA";4;0;0;4
2010;"PIRAPO (RS)";"RS";"PIRAPO";33;9;8;50
2010;"PIRATINI (RS)";"RS";"PIRATINI";229;25;87;341
2010;"PLANALTO (RS)";"RS";"PLANALTO";184;5;31;220
2010;"POCO DAS ANTAS (RS)";"RS";"POCO DAS ANTAS";80;9;15;104
2010;"PONTAO (RS)";"RS";"PONTAO";90;4;20;114
2010;"PONTE PRETA (RS)";"RS";"PONTE PRETA";57;6;4;67
2010;"PORTAO (RS)";"RS";"PORTAO";1808;91;98;1997
2010;"PORTO ALEGRE (RS)";"RS";"PORTO ALEGRE";14651;2082;4457;21190
2010;"PORTO LUCENA (RS)";"RS";"PORTO LUCENA";87;10;15;112
2010;"PORTO MAUA (RS)";"RS";"PORTO MAUA";52;6;6;64
2010;"PORTO VERA CRUZ (RS)";"RS";"PORTO VERA CRUZ";7;2;8;17
2010;"PORTO XAVIER (RS)";"RS";"PORTO XAVIER";185;11;28;224
2010;"POUSO NOVO (RS)";"RS";"POUSO NOVO";39;8;5;52
2010;"PRESIDENTE LUCENA (RS)";"RS";"PRESIDENTE LUCENA";135;3;9;147
2010;"PROGRESSO (RS)";"RS";"PROGRESSO";96;14;22;132
2010;"PROTASIO ALVES (RS)";"RS";"PROTASIO ALVES";54;4;5;63
2010;"PUTINGA (RS)";"RS";"PUTINGA";103;11;13;127
2010;"QUARAI (RS)";"RS";"QUARAI";163;12;44;219
2010;"QUATRO IRMAOS (RS)";"RS";"QUATRO IRMAOS";49;11;3;63
2010;"QUEVEDOS (RS)";"RS";"QUEVEDOS";23;4;6;33
2010;"QUINZE DE NOVEMBRO (RS)";"RS";"QUINZE DE NOVEMBRO";164;16;18;198
2010;"REDENTORA (RS)";"RS";"REDENTORA";94;13;15;122
2010;"RELVADO (RS)";"RS";"RELVADO";43;6;3;52
2010;"RESTINGA SECA (RS)";"RS";"RESTINGA SECA";290;7;53;350
2010;"RIO DOS INDIOS (RS)";"RS";"RIO DOS INDIOS";62;5;32;99
2010;"RIO GRANDE (RS)";"RS";"RIO GRANDE";1953;144;431;2528
2010;"RIO PARDO (RS)";"RS";"RIO PARDO";394;35;66;495
2010;"RIOZINHO (RS)";"RS";"RIOZINHO";46;4;25;75
2010;"ROCA SALES (RS)";"RS";"ROCA SALES";151;20;43;214
2010;"RODEIO BONITO (RS)";"RS";"RODEIO BONITO";100;7;23;130
2010;"ROLADOR (RS)";"RS";"ROLADOR";55;4;6;65
2010;"ROLANTE (RS)";"RS";"ROLANTE";216;21;59;296
2010;"RONDA ALTA (RS)";"RS";"RONDA ALTA";250;12;23;285
2010;"RONDINHA (RS)";"RS";"RONDINHA";160;10;17;187
2010;"ROQUE GONZALES (RS)";"RS";"ROQUE GONZALES";124;4;19;147
2010;"ROSARIO DO SUL (RS)";"RS";"ROSARIO DO SUL";451;32;69;552
2010;"SAGRADA FAMILIA (RS)";"RS";"SAGRADA FAMILIA";29;4;6;39
2010;"SALDANHA MARINHO (RS)";"RS";"SALDANHA MARINHO";153;10;5;168
2010;"SALTO DO JACUI (RS)";"RS";"SALTO DO JACUI";173;16;27;216
2010;"SALVADOR DAS MISSOES (RS)";"RS";"SALVADOR DAS MISSOES";99;2;3;104
2010;"SALVADOR DO SUL (RS)";"RS";"SALVADOR DO SUL";257;28;26;311
2010;"SANANDUVA (RS)";"RS";"SANANDUVA";586;21;47;654
2010;"SANTA BARBARA DO SUL (RS)";"RS";"SANTA BARBARA DO SUL";325;16;33;374
2010;"SANTA CECILIA DO SUL (RS)";"RS";"SANTA CECILIA DO SUL";51;3;12;66
2010;"SANTA CLARA DO SUL (RS)";"RS";"SANTA CLARA DO SUL";131;25;9;165
2010;"SANTA CRUZ DO SUL (RS)";"RS";"SANTA CRUZ DO SUL";1934;147;529;2610
2010;"SANTA MARGARIDA DO SUL (RS)";"RS";"SANTA MARGARIDA DO SUL";40;6;1;47
2010;"SANTA MARIA (RS)";"RS";"SANTA MARIA";3022;331;933;4286
2010;"SANTA MARIA DO HERVAL (RS)";"RS";"SANTA MARIA DO HERVAL";198;12;46;256
2010;"SANTA ROSA (RS)";"RS";"SANTA ROSA";1363;78;153;1594
2010;"SANTA TEREZA (RS)";"RS";"SANTA TEREZA";79;5;5;89
2010;"SANTA VITORIA DO PALMAR (RS)";"RS";"SANTA VITORIA DO PALMAR";503;10;55;568
2010;"SANTANA DA BOA VISTA (RS)";"RS";"SANTANA DA BOA VISTA";67;8;34;109
2010;"SANTANA DO LIVRAMENTO (RS)";"RS";"SANTANA DO LIVRAMENTO";674;56;174;904
2010;"SANTIAGO (RS)";"RS";"SANTIAGO";747;63;87;897
2010;"SANTO ANGELO (RS)";"RS";"SANTO ANGELO";1108;80;94;1282
2010;"SANTO ANTONIO DA PATRULHA (RS)";"RS";"SANTO ANTONIO DA PATRULHA";830;40;154;1024
2010;"SANTO ANTONIO DAS MISSOES (RS)";"RS";"SANTO ANTONIO DAS MISSOES";148;28;25;201
2010;"SANTO ANTONIO DO PALMA (RS)";"RS";"SANTO ANTONIO DO PALMA";51;3;7;61
2010;"SANTO ANTONIO DO PLANALTO (RS)";"RS";"SANTO ANTONIO DO PLANALTO";87;4;7;98
2010;"SANTO AUGUSTO (RS)";"RS";"SANTO AUGUSTO";461;31;22;514
2010;"SANTO CRISTO (RS)";"RS";"SANTO CRISTO";427;18;42;487
2010;"SANTO EXPEDITO DO SUL (RS)";"RS";"SANTO EXPEDITO DO SUL";85;2;9;96
2010;"SAO BORJA (RS)";"RS";"SAO BORJA";1072;47;91;1210
2010;"SAO DOMINGOS DO SUL (RS)";"RS";"SAO DOMINGOS DO SUL";81;10;4;95
2010;"SAO FRANCISCO DE ASSIS (RS)";"RS";"SAO FRANCISCO DE ASSIS";280;19;86;385
2010;"SAO FRANCISCO DE PAULA (RS)";"RS";"SAO FRANCISCO DE PAULA";491;33;57;581
2010;"SAO GABRIEL (RS)";"RS";"SAO GABRIEL";814;25;97;936
2010;"SAO JERONIMO (RS)";"RS";"SAO JERONIMO";256;19;112;387
2010;"SAO JOAO DA URTIGA (RS)";"RS";"SAO JOAO DA URTIGA";127;6;19;152
2010;"SAO JOAO DO POLESINE (RS)";"RS";"SAO JOAO DO POLESINE";59;0;6;65
2010;"SAO JORGE (RS)";"RS";"SAO JORGE";123;5;17;145
2010;"SAO JOSE DAS MISSOES (RS)";"RS";"SAO JOSE DAS MISSOES";42;4;9;55
2010;"SAO JOSE DO HERVAL (RS)";"RS";"SAO JOSE DO HERVAL";65;5;10;80
2010;"SAO JOSE DO HORTENCIO (RS)";"RS";"SAO JOSE DO HORTENCIO";178;10;31;219
2010;"SAO JOSE DO INHACORA (RS)";"RS";"SAO JOSE DO INHACORA";40;4;4;48
2010;"SAO JOSE DO NORTE (RS)";"RS";"SAO JOSE DO NORTE";301;5;53;359
2010;"SAO JOSE DO OURO (RS)";"RS";"SAO JOSE DO OURO";290;6;32;328
2010;"SAO JOSE DO SUL (RS)";"RS";"SAO JOSE DO SUL";127;11;5;143
2010;"SAO JOSE DOS AUSENTES (RS)";"RS";"SAO JOSE DOS AUSENTES";92;7;13;112
2010;"SAO LEOPOLDO (RS)";"RS";"SAO LEOPOLDO";1851;226;479;2556
2010;"SAO LOURENCO DO SUL (RS)";"RS";"SAO LOURENCO DO SUL";871;40;128;1039
2010;"SAO LUIZ GONZAGA (RS)";"RS";"SAO LUIZ GONZAGA";565;50;77;692
2010;"SAO MARCOS (RS)";"RS";"SAO MARCOS";665;11;100;776
2010;"SAO MARTINHO (RS)";"RS";"SAO MARTINHO";173;10;15;198
2010;"SAO MARTINHO DA SERRA (RS)";"RS";"SAO MARTINHO DA SERRA";42;2;2;46
2010;"SAO MIGUEL DAS MISSOES (RS)";"RS";"SAO MIGUEL DAS MISSOES";203;22;25;250
2010;"SAO NICOLAU (RS)";"RS";"SAO NICOLAU";62;10;9;81
2010;"SAO PAULO DAS MISSOES (RS)";"RS";"SAO PAULO DAS MISSOES";98;8;27;133
2010;"SAO PEDRO DA SERRA (RS)";"RS";"SAO PEDRO DA SERRA";99;8;9;116
2010;"SAO PEDRO DAS MISSOES (RS)";"RS";"SAO PEDRO DAS MISSOES";31;5;4;40
2010;"SAO PEDRO DO BUTIA (RS)";"RS";"SAO PEDRO DO BUTIA";100;1;11;112
2010;"SAO PEDRO DO SUL (RS)";"RS";"SAO PEDRO DO SUL";263;44;31;338
2010;"SAO SEBASTIAO DO CAI (RS)";"RS";"SAO SEBASTIAO DO CAI";667;24;62;753
2010;"SAO SEPE (RS)";"RS";"SAO SEPE";404;34;90;528
2010;"SAO VALENTIM (RS)";"RS";"SAO VALENTIM";67;11;9;87
2010;"SAO VALENTIM DO SUL (RS)";"RS";"SAO VALENTIM DO SUL";78;2;8;88
2010;"SAO VALERIO DO SUL (RS)";"RS";"SAO VALERIO DO SUL";41;4;5;50
2010;"SAO VENDELINO (RS)";"RS";"SAO VENDELINO";79;11;5;95
2010;"SAO VICENTE DO SUL (RS)";"RS";"SAO VICENTE DO SUL";109;3;39;151
2010;"SAPIRANGA (RS)";"RS";"SAPIRANGA";816;105;142;1063
2010;"SAPUCAIA DO SUL (RS)";"RS";"SAPUCAIA DO SUL";1461;105;112;1678
2010;"SARANDI (RS)";"RS";"SARANDI";556;31;67;654
2010;"SEBERI (RS)";"RS";"SEBERI";230;8;32;270
2010;"SEDE NOVA (RS)";"RS";"SEDE NOVA";63;8;9;80
2010;"SEGREDO (RS)";"RS";"SEGREDO";144;3;33;180
2010;"SELBACH (RS)";"RS";"SELBACH";272;9;15;296
2010;"SENADOR SALGADO FILHO (RS)";"RS";"SENADOR SALGADO FILHO";108;8;11;127
2010;"SENTINELA DO SUL (RS)";"RS";"SENTINELA DO SUL";117;2;14;133
2010;"SERAFINA CORREA (RS)";"RS";"SERAFINA CORREA";294;42;46;382
2010;"SERIO (RS)";"RS";"SERIO";51;7;5;63
2010;"SERTAO (RS)";"RS";"SERTAO";222;12;27;261
2010;"SERTAO SANTANA (RS)";"RS";"SERTAO SANTANA";165;8;21;194
2010;"SETE DE SETEMBRO (RS)";"RS";"SETE DE SETEMBRO";52;2;10;64
2010;"SEVERIANO DE ALMEIDA (RS)";"RS";"SEVERIANO DE ALMEIDA";98;14;10;122
2010;"SILVEIRA MARTINS (RS)";"RS";"SILVEIRA MARTINS";125;1;5;131
2010;"SINIMBU (RS)";"RS";"SINIMBU";132;1;5;138
2010;"SOBRADINHO (RS)";"RS";"SOBRADINHO";286;15;57;358
2010;"SOLEDADE (RS)";"RS";"SOLEDADE";500;22;94;616
2010;"TABAI (RS)";"RS";"TABAI";180;21;9;210
2010;"TAPEJARA (RS)";"RS";"TAPEJARA";705;25;73;803
2010;"TAPERA (RS)";"RS";"TAPERA";337;24;22;383
2010;"TAPES (RS)";"RS";"TAPES";269;14;32;315
2010;"TAQUARA (RS)";"RS";"TAQUARA";706;54;235;995
2010;"TAQUARI (RS)";"RS";"TAQUARI";439;29;122;590
2010;"TAQUARUCU DO SUL (RS)";"RS";"TAQUARUCU DO SUL";70;2;12;84
2010;"TAVARES (RS)";"RS";"TAVARES";117;3;10;130
2010;"TENENTE PORTELA (RS)";"RS";"TENENTE PORTELA";255;12;38;305
2010;"TERRA DE AREIA (RS)";"RS";"TERRA DE AREIA";316;9;21;346
2010;"TEUTONIA (RS)";"RS";"TEUTONIA";596;35;70;701
2010;"TIO HUGO (RS)";"RS";"TIO HUGO";86;5;15;106
2010;"TIRADENTES DO SUL (RS)";"RS";"TIRADENTES DO SUL";82;7;11;100
2010;"TOROPI (RS)";"RS";"TOROPI";46;1;17;64
2010;"TORRES (RS)";"RS";"TORRES";389;25;64;478
2010;"TRAMANDAI (RS)";"RS";"TRAMANDAI";537;58;131;726
2010;"TRAVESSEIRO (RS)";"RS";"TRAVESSEIRO";44;9;9;62
2010;"TRES ARROIOS (RS)";"RS";"TRES ARROIOS";85;11;3;99
2010;"TRES CACHOEIRAS (RS)";"RS";"TRES CACHOEIRAS";617;11;17;645
2010;"TRES COROAS (RS)";"RS";"TRES COROAS";238;28;57;323
2010;"TRES DE MAIO (RS)";"RS";"TRES DE MAIO";647;41;68;756
2010;"TRES FORQUILHAS (RS)";"RS";"TRES FORQUILHAS";92;2;3;97
2010;"TRES PALMEIRAS (RS)";"RS";"TRES PALMEIRAS";69;5;18;92
2010;"TRES PASSOS (RS)";"RS";"TRES PASSOS";364;23;116;503
2010;"TRINDADE DO SUL (RS)";"RS";"TRINDADE DO SUL";120;10;25;155
2010;"TRIUNFO (RS)";"RS";"TRIUNFO";468;119;147;734
2010;"TUCUNDUVA (RS)";"RS";"TUCUNDUVA";211;11;11;233
2010;"TUNAS (RS)";"RS";"TUNAS";47;4;18;69
2010;"TUPANCI DO SUL (RS)";"RS";"TUPANCI DO SUL";47;3;11;61
2010;"TUPANCIRETA (RS)";"RS";"TUPANCIRETA";488;42;43;573
2010;"TUPANDI (RS)";"RS";"TUPANDI";105;26;27;158
2010;"TUPARENDI (RS)";"RS";"TUPARENDI";217;12;26;255
2010;"TURUCU (RS)";"RS";"TURUCU";83;6;10;99
2010;"UBIRETAMA (RS)";"RS";"UBIRETAMA";70;8;2;80
2010;"UNIAO DA SERRA (RS)";"RS";"UNIAO DA SERRA";56;2;9;67
2010;"UNISTALDA (RS)";"RS";"UNISTALDA";26;7;15;48
2010;"URUGUAIANA (RS)";"RS";"URUGUAIANA";1737;73;160;1970
2010;"VACARIA (RS)";"RS";"VACARIA";1610;123;433;2166
2010;"VALE DO SOL (RS)";"RS";"VALE DO SOL";182;6;30;218
2010;"VALE REAL (RS)";"RS";"VALE REAL";228;12;11;251
2010;"VALE VERDE (RS)";"RS";"VALE VERDE";50;3;5;58
2010;"VANINI (RS)";"RS";"VANINI";88;14;12;114
2010;"VENANCIO AIRES (RS)";"RS";"VENANCIO AIRES";1092;71;170;1333
2010;"VERA CRUZ (RS)";"RS";"VERA CRUZ";366;19;91;476
2010;"VERANOPOLIS (RS)";"RS";"VERANOPOLIS";867;40;54;961
2010;"VESPASIANO CORREA (RS)";"RS";"VESPASIANO CORREA";85;5;12;102
2010;"VIADUTOS (RS)";"RS";"VIADUTOS";124;10;21;155
2010;"VIAMAO (RS)";"RS";"VIAMAO";1827;267;597;2691
2010;"VICENTE DUTRA (RS)";"RS";"VICENTE DUTRA";49;2;16;67
2010;"VICTOR GRAEFF (RS)";"RS";"VICTOR GRAEFF";147;14;5;166
2010;"VILA FLORES (RS)";"RS";"VILA FLORES";165;11;11;187
2010;"VILA LANGARO (RS)";"RS";"VILA LANGARO";93;5;10;108
2010;"VILA MARIA (RS)";"RS";"VILA MARIA";231;9;45;285
2010;"VILA NOVA DO SUL (RS)";"RS";"VILA NOVA DO SUL";87;6;11;104
2010;"VISTA ALEGRE (RS)";"RS";"VISTA ALEGRE";57;6;8;71
2010;"VISTA ALEGRE DO PRATA (RS)";"RS";"VISTA ALEGRE DO PRATA";40;8;4;52
2010;"VISTA GAUCHA (RS)";"RS";"VISTA GAUCHA";58;1;14;73
2010;"VITORIA DAS MISSOES (RS)";"RS";"VITORIA DAS MISSOES";86;1;12;99
2010;"WESTFALIA (RS)";"RS";"WESTFALIA";112;18;8;138
2010;"XANGRI LA (RS)";"RS";"XANGRI LA";153;12;6;171
2010;"ABDON BATISTA (SC)";"SC";"ABDON BATISTA";49;5;8;62
2010;"ABELARDO LUZ (SC)";"SC";"ABELARDO LUZ";341;11;64;416
2010;"AGROLANDIA (SC)";"SC";"AGROLANDIA";213;10;12;235
2010;"AGRONOMICA (SC)";"SC";"AGRONOMICA";143;3;9;155
2010;"AGUA DOCE (SC)";"SC";"AGUA DOCE";169;23;17;209
2010;"AGUAS DE CHAPECO (SC)";"SC";"AGUAS DE CHAPECO";75;8;22;105
2010;"AGUAS FRIAS (SC)";"SC";"AGUAS FRIAS";50;5;4;59
2010;"AGUAS MORNAS (SC)";"SC";"AGUAS MORNAS";249;5;13;267
2010;"ALFREDO WAGNER (SC)";"SC";"ALFREDO WAGNER";237;24;10;271
2010;"ALTO BELA VISTA (SC)";"SC";"ALTO BELA VISTA";53;6;8;67
2010;"ANCHIETA (SC)";"SC";"ANCHIETA";185;14;17;216
2010;"ANGELINA (SC)";"SC";"ANGELINA";194;18;10;222
2010;"ANITA GARIBALDI (SC)";"SC";"ANITA GARIBALDI";131;11;25;167
2010;"ANITAPOLIS (SC)";"SC";"ANITAPOLIS";84;9;10;103
2010;"ANTONIO CARLOS (SC)";"SC";"ANTONIO CARLOS";550;8;9;567
2010;"APIUNA (SC)";"SC";"APIUNA";142;18;20;180
2010;"ARABUTA (SC)";"SC";"ARABUTA";100;8;25;133
2010;"ARAQUARI (SC)";"SC";"ARAQUARI";411;28;29;468
2010;"ARARANGUA (SC)";"SC";"ARARANGUA";1248;59;147;1454
2010;"ARMAZEM (SC)";"SC";"ARMAZEM";237;14;12;263
2010;"ARROIO TRINTA (SC)";"SC";"ARROIO TRINTA";163;13;10;186
2010;"ARVOREDO (SC)";"SC";"ARVOREDO";31;12;6;49
2010;"ASCURRA (SC)";"SC";"ASCURRA";194;16;25;235
2010;"ATALANTA (SC)";"SC";"ATALANTA";84;3;5;92
2010;"AURORA (SC)";"SC";"AURORA";176;4;8;188
2010;"BALNEARIO ARROIO DO SILVA (SC)";"SC";"BALNEARIO ARROIO DO SILVA";97;9;7;113
2010;"BALNEARIO BARRA DO SUL (SC)";"SC";"BALNEARIO BARRA DO SUL";108;7;5;120
2010;"BALNEARIO CAMBORIU (SC)";"SC";"BALNEARIO CAMBORIU";895;201;237;1333
2010;"BALNEARIO DE PICARRAS (SC)";"SC";"BALNEARIO DE PICARRAS";302;26;29;357
2010;"BALNEARIO GAIVOTA (SC)";"SC";"BALNEARIO GAIVOTA";138;10;13;161
2010;"BANDEIRANTE (SC)";"SC";"BANDEIRANTE";30;3;13;46
2010;"BARRA BONITA (SC)";"SC";"BARRA BONITA";31;4;10;45
2010;"BARRA VELHA (SC)";"SC";"BARRA VELHA";365;29;23;417
2010;"BELA VISTA DO TOLDO (SC)";"SC";"BELA VISTA DO TOLDO";84;3;21;108
2010;"BELMONTE (SC)";"SC";"BELMONTE";50;8;9;67
2010;"BENEDITO NOVO (SC)";"SC";"BENEDITO NOVO";287;31;19;337
2010;"BIGUACU (SC)";"SC";"BIGUACU";937;60;143;1140
2010;"BLUMENAU (SC)";"SC";"BLUMENAU";4806;384;754;5944
2010;"BOCAINA DO SUL (SC)";"SC";"BOCAINA DO SUL";44;4;15;63
2010;"BOM JARDIM DA SERRA (SC)";"SC";"BOM JARDIM DA SERRA";82;5;19;106
2010;"BOM JESUS (SC)";"SC";"BOM JESUS";46;2;8;56
2010;"BOM JESUS DO OESTE (SC)";"SC";"BOM JESUS DO OESTE";47;1;8;56
2010;"BOM RETIRO (SC)";"SC";"BOM RETIRO";168;19;28;215
2010;"BOMBINHAS (SC)";"SC";"BOMBINHAS";122;32;23;177
2010;"BOTUVERA (SC)";"SC";"BOTUVERA";213;8;14;235
2010;"BRACO DO NORTE (SC)";"SC";"BRACO DO NORTE";952;43;58;1053
2010;"BRACO DO TROMBUDO (SC)";"SC";"BRACO DO TROMBUDO";119;6;2;127
2010;"BRUNOPOLIS (SC)";"SC";"BRUNOPOLIS";70;5;8;83
2010;"BRUSQUE (SC)";"SC";"BRUSQUE";2158;133;196;2487
2010;"CACADOR (SC)";"SC";"CACADOR";1860;95;768;2723
2010;"CAIBI (SC)";"SC";"CAIBI";170;6;23;199
2010;"CALMON (SC)";"SC";"CALMON";28;5;18;51
2010;"CAMBORIU (SC)";"SC";"CAMBORIU";921;40;23;984
2010;"CAMPO ALEGRE (SC)";"SC";"CAMPO ALEGRE";357;12;8;377
2010;"CAMPO BELO DO SUL (SC)";"SC";"CAMPO BELO DO SUL";169;7;25;201
2010;"CAMPO ERE (SC)";"SC";"CAMPO ERE";216;9;26;251
2010;"CAMPOS NOVOS (SC)";"SC";"CAMPOS NOVOS";877;59;92;1028
2010;"CANELINHA (SC)";"SC";"CANELINHA";484;18;11;513
2010;"CANOINHAS (SC)";"SC";"CANOINHAS";1172;48;119;1339
2010;"CAPAO ALTO (SC)";"SC";"CAPAO ALTO";46;5;12;63
2010;"CAPINZAL (SC)";"SC";"CAPINZAL";388;32;35;455
2010;"CAPIVARI DE BAIXO (SC)";"SC";"CAPIVARI DE BAIXO";326;16;29;371
2010;"CATANDUVAS (SC)";"SC";"CATANDUVAS";305;21;38;364
2010;"CAXAMBU DO SUL (SC)";"SC";"CAXAMBU DO SUL";92;4;15;111
2010;"CELSO RAMOS (SC)";"SC";"CELSO RAMOS";47;3;3;53
2010;"CERRO NEGRO (SC)";"SC";"CERRO NEGRO";36;5;15;56
2010;"CHAPADAO DO LAGEADO (SC)";"SC";"CHAPADAO DO LAGEADO";45;5;7;57
2010;"CHAPECO (SC)";"SC";"CHAPECO";3918;236;332;4486
2010;"COCAL DO SUL (SC)";"SC";"COCAL DO SUL";263;19;18;300
2010;"CONCORDIA (SC)";"SC";"CONCORDIA";2056;123;170;2349
2010;"CORDILHEIRA ALTA (SC)";"SC";"CORDILHEIRA ALTA";244;10;3;257
2010;"CORONEL FREITAS (SC)";"SC";"CORONEL FREITAS";249;9;26;284
2010;"CORONEL MARTINS (SC)";"SC";"CORONEL MARTINS";39;7;12;58
2010;"CORREIA PINTO (SC)";"SC";"CORREIA PINTO";328;30;51;409
2010;"CORUPA (SC)";"SC";"CORUPA";344;7;36;387
2010;"CRICIUMA (SC)";"SC";"CRICIUMA";3369;286;392;4047
2010;"CUNHA PORA (SC)";"SC";"CUNHA PORA";309;14;44;367
2010;"CUNHATAI (SC)";"SC";"CUNHATAI";28;2;7;37
2010;"CURITIBANOS (SC)";"SC";"CURITIBANOS";884;46;89;1019
2010;"DESCANSO (SC)";"SC";"DESCANSO";206;13;21;240
2010;"DIONISIO CERQUEIRA (SC)";"SC";"DIONISIO CERQUEIRA";133;15;20;168
2010;"DONA EMMA (SC)";"SC";"DONA EMMA";101;11;9;121
2010;"DOUTOR PEDRINHO (SC)";"SC";"DOUTOR PEDRINHO";117;7;6;130
2010;"ENTRE RIOS (SC)";"SC";"ENTRE RIOS";22;4;12;38
2010;"ERMO (SC)";"SC";"ERMO";53;3;6;62
2010;"ERVAL VELHO (SC)";"SC";"ERVAL VELHO";88;4;22;114
2010;"FAXINAL DOS GUEDES (SC)";"SC";"FAXINAL DOS GUEDES";363;17;24;404
2010;"FLOR DO SERTAO (SC)";"SC";"FLOR DO SERTAO";16;6;15;37
2010;"FLORIANOPOLIS (SC)";"SC";"FLORIANOPOLIS";3275;802;1661;5738
2010;"FORMOSA DO SUL (SC)";"SC";"FORMOSA DO SUL";57;6;15;78
2010;"FORQUILHINHA (SC)";"SC";"FORQUILHINHA";476;16;39;531
2010;"FRAIBURGO (SC)";"SC";"FRAIBURGO";790;44;204;1038
2010;"FREI ROGERIO (SC)";"SC";"FREI ROGERIO";66;10;11;87
2010;"GALVAO (SC)";"SC";"GALVAO";74;5;15;94
2010;"GAROPABA (SC)";"SC";"GAROPABA";226;16;31;273
2010;"GARUVA (SC)";"SC";"GARUVA";364;24;18;406
2010;"GASPAR (SC)";"SC";"GASPAR";1223;54;72;1349
2010;"GOVERNADOR CELSO RAMOS (SC)";"SC";"GOVERNADOR CELSO RAMOS";143;16;10;169
2010;"GRAO PARA (SC)";"SC";"GRAO PARA";235;9;10;254
2010;"GRAVATAL (SC)";"SC";"GRAVATAL";244;9;15;268
2010;"GUABIRUBA (SC)";"SC";"GUABIRUBA";289;11;15;315
2010;"GUARACIABA (SC)";"SC";"GUARACIABA";210;9;37;256
2010;"GUARAMIRIM (SC)";"SC";"GUARAMIRIM";947;26;22;995
2010;"GUARUJA DO SUL (SC)";"SC";"GUARUJA DO SUL";151;8;14;173
2010;"GUATAMBU (SC)";"SC";"GUATAMBU";82;8;22;112
2010;"HERVAL D OESTE (SC)";"SC";"HERVAL D OESTE";295;31;49;375
2010;"IBIAM (SC)";"SC";"IBIAM";64;3;13;80
2010;"IBICARE (SC)";"SC";"IBICARE";129;9;8;146
2010;"IBIRAMA (SC)";"SC";"IBIRAMA";404;35;63;502
2010;"ICARA (SC)";"SC";"ICARA";1544;73;115;1732
2010;"ILHOTA (SC)";"SC";"ILHOTA";288;20;19;327
2010;"IMARUI (SC)";"SC";"IMARUI";99;20;24;143
2010;"IMBITUBA (SC)";"SC";"IMBITUBA";545;65;73;683
2010;"IMBUIA (SC)";"SC";"IMBUIA";171;6;17;194
2010;"INDAIAL (SC)";"SC";"INDAIAL";1242;65;84;1391
2010;"IOMERE (SC)";"SC";"IOMERE";140;7;10;157
2010;"IPIRA (SC)";"SC";"IPIRA";99;8;12;119
2010;"IPORA DO OESTE (SC)";"SC";"IPORA DO OESTE";231;14;40;285
2010;"IPUACU (SC)";"SC";"IPUACU";83;9;16;108
2010;"IPUMIRIM (SC)";"SC";"IPUMIRIM";222;22;22;266
2010;"IRACEMINHA (SC)";"SC";"IRACEMINHA";92;5;17;114
2010;"IRANI (SC)";"SC";"IRANI";301;26;49;376
2010;"IRATI (SC)";"SC";"IRATI";25;6;9;40
2010;"IRINEOPOLIS (SC)";"SC";"IRINEOPOLIS";227;3;8;238
2010;"ITA (SC)";"SC";"ITA";87;17;28;132
2010;"ITAIOPOLIS (SC)";"SC";"ITAIOPOLIS";542;27;70;639
2010;"ITAJAI (SC)";"SC";"ITAJAI";3937;270;319;4526
2010;"ITAPEMA (SC)";"SC";"ITAPEMA";489;47;40;576
2010;"ITAPIRANGA (SC)";"SC";"ITAPIRANGA";276;20;50;346
2010;"ITAPOA (SC)";"SC";"ITAPOA";149;6;12;167
2010;"ITUPORANGA (SC)";"SC";"ITUPORANGA";636;21;42;699
2010;"JABORA (SC)";"SC";"JABORA";121;14;21;156
2010;"JACINTO MACHADO (SC)";"SC";"JACINTO MACHADO";380;9;30;419
2010;"JAGUARUNA (SC)";"SC";"JAGUARUNA";415;15;42;472
2010;"JARAGUA DO SUL (SC)";"SC";"JARAGUA DO SUL";2289;188;323;2800
2010;"JARDINOPOLIS (SC)";"SC";"JARDINOPOLIS";17;4;4;25
2010;"JOACABA (SC)";"SC";"JOACABA";815;48;40;903
2010;"JOINVILLE (SC)";"SC";"JOINVILLE";7577;600;832;9009
2010;"JOSE BOITEUX (SC)";"SC";"JOSE BOITEUX";110;23;7;140
2010;"JUPIA (SC)";"SC";"JUPIA";37;4;6;47
2010;"LACERDOPOLIS (SC)";"SC";"LACERDOPOLIS";105;5;5;115
2010;"LAGEADO GRANDE (SC)";"SC";"LAGEADO GRANDE";32;2;4;38
2010;"LAGES (SC)";"SC";"LAGES";3283;216;322;3821
2010;"LAGUNA (SC)";"SC";"LAGUNA";525;82;89;696
2010;"LAURENTINO (SC)";"SC";"LAURENTINO";278;5;4;287
2010;"LAURO MULLER (SC)";"SC";"LAURO MULLER";431;20;39;490
2010;"LEBON REGIS (SC)";"SC";"LEBON REGIS";190;15;34;239
2010;"LEOBERTO LEAL (SC)";"SC";"LEOBERTO LEAL";115;10;6;131
2010;"LINDOIA DO SUL (SC)";"SC";"LINDOIA DO SUL";131;10;41;182
2010;"LONTRAS (SC)";"SC";"LONTRAS";293;20;31;344
2010;"LUIZ ALVES (SC)";"SC";"LUIZ ALVES";443;10;18;471
2010;"LUZERNA (SC)";"SC";"LUZERNA";121;10;16;147
2010;"MACIEIRA (SC)";"SC";"MACIEIRA";61;7;10;78
2010;"MAFRA (SC)";"SC";"MAFRA";1218;90;122;1430
2010;"MAJOR GERCINO (SC)";"SC";"MAJOR GERCINO";126;9;11;146
2010;"MAJOR VIEIRA (SC)";"SC";"MAJOR VIEIRA";159;4;9;172
2010;"MARACAJA (SC)";"SC";"MARACAJA";203;2;12;217
2010;"MARAVILHA (SC)";"SC";"MARAVILHA";638;58;55;751
2010;"MAREMA (SC)";"SC";"MAREMA";55;8;8;71
2010;"MASSARANDUBA (SC)";"SC";"MASSARANDUBA";516;13;33;562
2010;"MATOS COSTA (SC)";"SC";"MATOS COSTA";34;6;10;50
2010;"MELEIRO (SC)";"SC";"MELEIRO";250;4;22;276
2010;"MIRIM DOCE (SC)";"SC";"MIRIM DOCE";50;2;9;61
2010;"MODELO (SC)";"SC";"MODELO";101;7;7;115
2010;"MONDAI (SC)";"SC";"MONDAI";188;9;37;234
2010;"MONTE CARLO (SC)";"SC";"MONTE CARLO";164;13;85;262
2010;"MONTE CASTELO (SC)";"SC";"MONTE CASTELO";162;8;16;186
2010;"MORRO DA FUMACA (SC)";"SC";"MORRO DA FUMACA";779;24;25;828
2010;"MORRO GRANDE (SC)";"SC";"MORRO GRANDE";97;2;8;107
2010;"NAVEGANTES (SC)";"SC";"NAVEGANTES";599;63;47;709
2010;"NOVA ERECHIM (SC)";"SC";"NOVA ERECHIM";89;6;9;104
2010;"NOVA ITABERABA (SC)";"SC";"NOVA ITABERABA";79;3;13;95
2010;"NOVA TRENTO (SC)";"SC";"NOVA TRENTO";243;19;31;293
2010;"NOVA VENEZA (SC)";"SC";"NOVA VENEZA";396;29;24;449
2010;"NOVO HORIZONTE (SC)";"SC";"NOVO HORIZONTE";51;9;12;72
2010;"ORLEANS (SC)";"SC";"ORLEANS";809;15;43;867
2010;"OTACILIO COSTA (SC)";"SC";"OTACILIO COSTA";393;32;39;464
2010;"OURO (SC)";"SC";"OURO";219;24;28;271
2010;"OURO VERDE (SC)";"SC";"OURO VERDE";77;2;10;89
2010;"PAIAL (SC)";"SC";"PAIAL";11;4;21;36
2010;"PAINEL (SC)";"SC";"PAINEL";27;3;7;37
2010;"PALHOCA (SC)";"SC";"PALHOCA";1883;106;368;2357
2010;"PALMA SOLA (SC)";"SC";"PALMA SOLA";168;6;24;198
2010;"PALMEIRA (SC)";"SC";"PALMEIRA";82;3;4;89
2010;"PALMITOS (SC)";"SC";"PALMITOS";340;30;59;429
2010;"PAPANDUVA (SC)";"SC";"PAPANDUVA";507;19;71;597
2010;"PARAISO (SC)";"SC";"PARAISO";56;6;7;69
2010;"PASSO DE TORRES (SC)";"SC";"PASSO DE TORRES";118;5;14;137
2010;"PASSOS MAIA (SC)";"SC";"PASSOS MAIA";99;3;21;123
2010;"PAULO LOPES (SC)";"SC";"PAULO LOPES";237;15;10;262
2010;"PEDRAS GRANDES (SC)";"SC";"PEDRAS GRANDES";225;12;13;250
2010;"PENHA (SC)";"SC";"PENHA";309;22;41;372
2010;"PERITIBA (SC)";"SC";"PERITIBA";74;4;13;91
2010;"PETROLANDIA (SC)";"SC";"PETROLANDIA";150;11;22;183
2010;"PINHALZINHO (SC)";"SC";"PINHALZINHO";408;18;47;473
2010;"PINHEIRO PRETO (SC)";"SC";"PINHEIRO PRETO";262;8;13;283
2010;"PIRATUBA (SC)";"SC";"PIRATUBA";84;11;26;121
2010;"PLANALTO ALEGRE (SC)";"SC";"PLANALTO ALEGRE";48;5;4;57
2010;"POMERODE (SC)";"SC";"POMERODE";588;28;93;709
2010;"PONTE ALTA (SC)";"SC";"PONTE ALTA";107;7;13;127
2010;"PONTE ALTA DO NORTE (SC)";"SC";"PONTE ALTA DO NORTE";69;4;12;85
2010;"PONTE SERRADA (SC)";"SC";"PONTE SERRADA";297;32;63;392
2010;"PORTO BELO (SC)";"SC";"PORTO BELO";197;26;25;248
2010;"PORTO UNIAO (SC)";"SC";"PORTO UNIAO";543;14;32;589
2010;"POUSO REDONDO (SC)";"SC";"POUSO REDONDO";436;18;33;487
2010;"PRAIA GRANDE (SC)";"SC";"PRAIA GRANDE";195;13;23;231
2010;"PRESIDENTE CASTELO BRANCO (SC)";"SC";"PRESIDENTE CASTELO BRANCO";54;5;7;66
2010;"PRESIDENTE GETULIO (SC)";"SC";"PRESIDENTE GETULIO";306;31;54;391
2010;"PRESIDENTE NEREU (SC)";"SC";"PRESIDENTE NEREU";26;6;5;37
2010;"PRINCESA (SC)";"SC";"PRINCESA";45;3;10;58
2010;"QUILOMBO (SC)";"SC";"QUILOMBO";181;16;34;231
2010;"RANCHO QUEIMADO (SC)";"SC";"RANCHO QUEIMADO";122;4;5;131
2010;"RIO DAS ANTAS (SC)";"SC";"RIO DAS ANTAS";167;6;23;196
2010;"RIO DO CAMPO (SC)";"SC";"RIO DO CAMPO";157;11;20;188
2010;"RIO DO OESTE (SC)";"SC";"RIO DO OESTE";178;16;22;216
2010;"RIO DO SUL (SC)";"SC";"RIO DO SUL";1371;85;113;1569
2010;"RIO DOS CEDROS (SC)";"SC";"RIO DOS CEDROS";224;20;25;269
2010;"RIO FORTUNA (SC)";"SC";"RIO FORTUNA";243;11;14;268
2010;"RIO NEGRINHO (SC)";"SC";"RIO NEGRINHO";865;60;63;988
2010;"RIO RUFINO (SC)";"SC";"RIO RUFINO";44;5;17;66
2010;"RIQUEZA (SC)";"SC";"RIQUEZA";105;4;21;130
2010;"RODEIO (SC)";"SC";"RODEIO";224;12;16;252
2010;"ROMELANDIA (SC)";"SC";"ROMELANDIA";86;6;20;112
2010;"SALETE (SC)";"SC";"SALETE";153;11;15;179
2010;"SALTINHO (SC)";"SC";"SALTINHO";42;5;19;66
2010;"SALTO VELOSO (SC)";"SC";"SALTO VELOSO";132;4;5;141
2010;"SANGAO (SC)";"SC";"SANGAO";422;11;16;449
2010;"SANTA CECILIA (SC)";"SC";"SANTA CECILIA";331;30;43;404
2010;"SANTA HELENA (SC)";"SC";"SANTA HELENA";51;11;9;71
2010;"SANTA ROSA DE LIMA (SC)";"SC";"SANTA ROSA DE LIMA";98;7;9;114
2010;"SANTA ROSA DO SUL (SC)";"SC";"SANTA ROSA DO SUL";264;11;14;289
2010;"SANTA TEREZINHA (SC)";"SC";"SANTA TEREZINHA";154;15;23;192
2010;"SANTA TEREZINHA DO PROGRESSO (SC)";"SC";"SANTA TEREZINHA DO PROGRESSO";41;6;9;56
2010;"SANTIAGO DO SUL (SC)";"SC";"SANTIAGO DO SUL";38;6;4;48
2010;"SANTO AMARO DA IMPERATRIZ (SC)";"SC";"SANTO AMARO DA IMPERATRIZ";588;24;63;675
2010;"SAO BENTO DO SUL (SC)";"SC";"SAO BENTO DO SUL";1370;114;140;1624
2010;"SAO BERNARDINO (SC)";"SC";"SAO BERNARDINO";38;3;18;59
2010;"SAO BONIFACIO (SC)";"SC";"SAO BONIFACIO";112;5;9;126
2010;"SAO CARLOS (SC)";"SC";"SAO CARLOS";173;19;39;231
2010;"SAO CRISTOVAO DO SUL (SC)";"SC";"SAO CRISTOVAO DO SUL";182;5;12;199
2010;"SAO DOMINGOS (SC)";"SC";"SAO DOMINGOS";266;15;37;318
2010;"SAO FRANCISCO DO SUL (SC)";"SC";"SAO FRANCISCO DO SUL";548;59;87;694
2010;"SAO JOAO BATISTA (SC)";"SC";"SAO JOAO BATISTA";542;14;42;598
2010;"SAO JOAO DO ITAPERIU (SC)";"SC";"SAO JOAO DO ITAPERIU";187;3;6;196
2010;"SAO JOAO DO OESTE (SC)";"SC";"SAO JOAO DO OESTE";151;10;13;174
2010;"SAO JOAO DO SUL (SC)";"SC";"SAO JOAO DO SUL";201;3;14;218
2010;"SAO JOAQUIM (SC)";"SC";"SAO JOAQUIM";788;58;155;1001
2010;"SAO JOSE (SC)";"SC";"SAO JOSE";3397;233;188;3818
2010;"SAO JOSE DO CEDRO (SC)";"SC";"SAO JOSE DO CEDRO";371;18;73;462
2010;"SAO JOSE DO CERRITO (SC)";"SC";"SAO JOSE DO CERRITO";155;4;33;192
2010;"SAO LOURENCO D OESTE (SC)";"SC";"SAO LOURENCO D OESTE";756;42;59;857
2010;"SAO LUDGERO (SC)";"SC";"SAO LUDGERO";552;10;20;582
2010;"SAO MARTINHO (SC)";"SC";"SAO MARTINHO";128;7;5;140
2010;"SAO MIGUEL D OESTE (SC)";"SC";"SAO MIGUEL D OESTE";941;52;104;1097
2010;"SAO MIGUEL DA BOA VISTA (SC)";"SC";"SAO MIGUEL DA BOA VISTA";16;2;10;28
2010;"SAO PEDRO DE ALCANTARA (SC)";"SC";"SAO PEDRO DE ALCANTARA";115;5;4;124
2010;"SAUDADES (SC)";"SC";"SAUDADES";175;8;30;213
2010;"SCHROEDER (SC)";"SC";"SCHROEDER";183;4;18;205
2010;"SEARA (SC)";"SC";"SEARA";387;48;59;494
2010;"SERRA ALTA (SC)";"SC";"SERRA ALTA";59;11;14;84
2010;"SIDEROPOLIS (SC)";"SC";"SIDEROPOLIS";397;21;67;485
2010;"SOMBRIO (SC)";"SC";"SOMBRIO";677;49;38;764
2010;"SUL BRASIL (SC)";"SC";"SUL BRASIL";40;4;11;55
2010;"TAIO (SC)";"SC";"TAIO";502;20;42;564
2010;"TANGARA (SC)";"SC";"TANGARA";378;10;36;424
2010;"TIGRINHOS (SC)";"SC";"TIGRINHOS";20;2;16;38
2010;"TIJUCAS (SC)";"SC";"TIJUCAS";826;45;44;915
2010;"TIMBE DO SUL (SC)";"SC";"TIMBE DO SUL";150;8;11;169
2010;"TIMBO (SC)";"SC";"TIMBO";615;41;47;703
2010;"TIMBO GRANDE (SC)";"SC";"TIMBO GRANDE";140;5;14;159
2010;"TRES BARRAS (SC)";"SC";"TRES BARRAS";247;23;48;318
2010;"TREVISO (SC)";"SC";"TREVISO";99;7;7;113
2010;"TREZE DE MAIO (SC)";"SC";"TREZE DE MAIO";373;7;15;395
2010;"TREZE TILIAS (SC)";"SC";"TREZE TILIAS";236;11;20;267
2010;"TROMBUDO CENTRAL (SC)";"SC";"TROMBUDO CENTRAL";206;16;19;241
2010;"TUBARAO (SC)";"SC";"TUBARAO";2230;81;382;2693
2010;"TUNAPOLIS (SC)";"SC";"TUNAPOLIS";87;8;19;114
2010;"TURVO (SC)";"SC";"TURVO";401;17;37;455
2010;"UNIAO DO OESTE (SC)";"SC";"UNIAO DO OESTE";50;4;15;69
2010;"URUBICI (SC)";"SC";"URUBICI";228;10;43;281
2010;"URUPEMA (SC)";"SC";"URUPEMA";51;7;9;67
2010;"URUSSANGA (SC)";"SC";"URUSSANGA";411;33;78;522
2010;"VARGEAO (SC)";"SC";"VARGEAO";117;2;10;129
2010;"VARGEM (SC)";"SC";"VARGEM";42;4;12;58
2010;"VARGEM BONITA (SC)";"SC";"VARGEM BONITA";133;9;24;166
2010;"VIDAL RAMOS (SC)";"SC";"VIDAL RAMOS";146;13;12;171
2010;"VIDEIRA (SC)";"SC";"VIDEIRA";1505;93;123;1721
2010;"VITOR MEIRELES (SC)";"SC";"VITOR MEIRELES";86;11;18;115
2010;"WITMARSUM (SC)";"SC";"WITMARSUM";100;10;10;120
2010;"XANXERE (SC)";"SC";"XANXERE";1193;101;119;1413
2010;"XAVANTINA (SC)";"SC";"XAVANTINA";145;14;4;163
2010;"XAXIM (SC)";"SC";"XAXIM";646;46;114;806
2010;"ZORTEA (SC)";"SC";"ZORTEA";32;5;3;40
2010;"AMPARO DE SAO FRANCISCO (SE)";"SE";"AMPARO DE SAO FRANCISCO";4;6;3;13
2010;"AQUIDABA (SE)";"SE";"AQUIDABA";115;11;44;170
2010;"ARACAJU (SE)";"SE";"ARACAJU";5137;859;1848;7844
2010;"ARAUA (SE)";"SE";"ARAUA";44;18;17;79
2010;"AREIA BRANCA (SE)";"SE";"AREIA BRANCA";129;11;16;156
2010;"BARRA DOS COQUEIROS (SE)";"SE";"BARRA DOS COQUEIROS";42;13;24;79
2010;"BOQUIM (SE)";"SE";"BOQUIM";184;15;22;221
2010;"BREJO GRANDE (SE)";"SE";"BREJO GRANDE";4;4;8;16
2010;"CAMPO DO BRITO (SE)";"SE";"CAMPO DO BRITO";282;20;63;365
2010;"CANHOBA (SE)";"SE";"CANHOBA";5;4;4;13
2010;"CANINDE DE SAO FRANCISCO (SE)";"SE";"CANINDE DE SAO FRANCISCO";121;38;19;178
2010;"CAPELA (SE)";"SE";"CAPELA";87;20;48;155
2010;"CARIRA (SE)";"SE";"CARIRA";191;36;77;304
2010;"CARMOPOLIS (SE)";"SE";"CARMOPOLIS";77;41;69;187
2010;"CEDRO DE SAO JOAO (SE)";"SE";"CEDRO DE SAO JOAO";19;6;4;29
2010;"CRISTINAPOLIS (SE)";"SE";"CRISTINAPOLIS";49;21;26;96
2010;"CUMBE (SE)";"SE";"CUMBE";20;8;7;35
2010;"DIVINA PASTORA (SE)";"SE";"DIVINA PASTORA";9;4;7;20
2010;"ESTANCIA (SE)";"SE";"ESTANCIA";386;137;169;692
2010;"FEIRA NOVA (SE)";"SE";"FEIRA NOVA";12;7;2;21
2010;"FREI PAULO (SE)";"SE";"FREI PAULO";92;25;27;144
2010;"GARARU (SE)";"SE";"GARARU";27;7;23;57
2010;"GENERAL MAYNARD (SE)";"SE";"GENERAL MAYNARD";12;15;20;47
2010;"GRACCHO CARDOSO (SE)";"SE";"GRACCHO CARDOSO";17;5;9;31
2010;"ILHA DAS FLORES (SE)";"SE";"ILHA DAS FLORES";10;8;7;25
2010;"INDIAROBA (SE)";"SE";"INDIAROBA";31;17;14;62
2010;"ITABAIANA (SE)";"SE";"ITABAIANA";2575;103;117;2795
2010;"ITABAIANINHA (SE)";"SE";"ITABAIANINHA";461;53;41;555
2010;"ITABI (SE)";"SE";"ITABI";14;4;7;25
2010;"ITAPORANGA D AJUDA (SE)";"SE";"ITAPORANGA D AJUDA";177;27;49;253
2010;"JAPARATUBA (SE)";"SE";"JAPARATUBA";45;15;36;96
2010;"JAPOATA (SE)";"SE";"JAPOATA";38;5;29;72
2010;"LAGARTO (SE)";"SE";"LAGARTO";814;128;155;1097
2010;"LARANJEIRAS (SE)";"SE";"LARANJEIRAS";102;34;35;171
2010;"MACAMBIRA (SE)";"SE";"MACAMBIRA";32;10;7;49
2010;"MALHADA DOS BOIS (SE)";"SE";"MALHADA DOS BOIS";10;7;4;21
2010;"MALHADOR (SE)";"SE";"MALHADOR";170;18;38;226
2010;"MARUIM (SE)";"SE";"MARUIM";41;12;21;74
2010;"MOITA BONITA (SE)";"SE";"MOITA BONITA";368;21;15;404
2010;"MONTE ALEGRE DE SERGIPE (SE)";"SE";"MONTE ALEGRE DE SERGIPE";102;18;19;139
2010;"MURIBECA (SE)";"SE";"MURIBECA";21;9;22;52
2010;"NEOPOLIS (SE)";"SE";"NEOPOLIS";42;13;16;71
2010;"NOSSA SENHORA APARECIDA (SE)";"SE";"NOSSA SENHORA APARECIDA";117;19;11;147
2010;"NOSSA SENHORA DA GLORIA (SE)";"SE";"NOSSA SENHORA DA GLORIA";361;36;85;482
2010;"NOSSA SENHORA DAS DORES (SE)";"SE";"NOSSA SENHORA DAS DORES";173;14;59;246
2010;"NOSSA SENHORA DE LOURDES (SE)";"SE";"NOSSA SENHORA DE LOURDES";24;2;7;33
2010;"NOSSA SENHORA DO SOCORRO (SE)";"SE";"NOSSA SENHORA DO SOCORRO";682;77;140;899
2010;"PACATUBA (SE)";"SE";"PACATUBA";25;5;28;58
2010;"PEDRA MOLE (SE)";"SE";"PEDRA MOLE";6;3;7;16
2010;"PEDRINHAS (SE)";"SE";"PEDRINHAS";51;3;10;64
2010;"PINHAO (SE)";"SE";"PINHAO";29;17;3;49
2010;"PIRAMBU (SE)";"SE";"PIRAMBU";14;5;16;35
2010;"POCO REDONDO (SE)";"SE";"POCO REDONDO";101;27;41;169
2010;"POCO VERDE (SE)";"SE";"POCO VERDE";76;23;107;206
2010;"PORTO DA FOLHA (SE)";"SE";"PORTO DA FOLHA";76;28;30;134
2010;"PROPRIA (SE)";"SE";"PROPRIA";199;31;50;280
2010;"RIACHAO DO DANTAS (SE)";"SE";"RIACHAO DO DANTAS";22;9;12;43
2010;"RIACHUELO (SE)";"SE";"RIACHUELO";31;10;12;53
2010;"RIBEIROPOLIS (SE)";"SE";"RIBEIROPOLIS";250;50;53;353
2010;"ROSARIO DO CATETE (SE)";"SE";"ROSARIO DO CATETE";27;20;13;60
2010;"SALGADO (SE)";"SE";"SALGADO";91;15;59;165
2010;"SANTA LUZIA DO ITANHY (SE)";"SE";"SANTA LUZIA DO ITANHY";14;10;7;31
2010;"SANTA ROSA DE LIMA (SE)";"SE";"SANTA ROSA DE LIMA";14;5;6;25
2010;"SANTANA DO SAO FRANCISCO (SE)";"SE";"SANTANA DO SAO FRANCISCO";9;3;8;20
2010;"SANTO AMARO DAS BROTAS (SE)";"SE";"SANTO AMARO DAS BROTAS";15;4;15;34
2010;"SAO CRISTOVAO (SE)";"SE";"SAO CRISTOVAO";287;65;124;476
2010;"SAO DOMINGOS (SE)";"SE";"SAO DOMINGOS";109;11;22;142
2010;"SAO FRANCISCO (SE)";"SE";"SAO FRANCISCO";13;4;22;39
2010;"SAO MIGUEL DO ALEIXO (SE)";"SE";"SAO MIGUEL DO ALEIXO";31;6;9;46
2010;"SIMAO DIAS (SE)";"SE";"SIMAO DIAS";199;50;157;406
2010;"SIRIRI (SE)";"SE";"SIRIRI";30;8;29;67
2010;"TELHA (SE)";"SE";"TELHA";9;4;2;15
2010;"TOBIAS BARRETO (SE)";"SE";"TOBIAS BARRETO";214;48;121;383
2010;"TOMAR DO GERU (SE)";"SE";"TOMAR DO GERU";37;6;10;53
2010;"UMBAUBA (SE)";"SE";"UMBAUBA";243;35;31;309
2010;"ADAMANTINA (SP)";"SP";"ADAMANTINA";665;52;75;792
2010;"ADOLFO (SP)";"SP";"ADOLFO";66;3;22;91
2010;"AGUAI (SP)";"SP";"AGUAI";771;75;117;963
2010;"AGUAS DA PRATA (SP)";"SP";"AGUAS DA PRATA";119;14;10;143
2010;"AGUAS DE LINDOIA (SP)";"SP";"AGUAS DE LINDOIA";158;61;47;266
2010;"AGUAS DE SANTA BARBARA (SP)";"SP";"AGUAS DE SANTA BARBARA";83;14;14;111
2010;"AGUAS DE SAO PEDRO (SP)";"SP";"AGUAS DE SAO PEDRO";24;6;3;33
2010;"AGUDOS (SP)";"SP";"AGUDOS";532;72;78;682
2010;"ALAMBARI (SP)";"SP";"ALAMBARI";82;14;6;102
2010;"ALFREDO MARCONDES (SP)";"SP";"ALFREDO MARCONDES";55;6;9;70
2010;"ALTAIR (SP)";"SP";"ALTAIR";61;7;30;98
2010;"ALTINOPOLIS (SP)";"SP";"ALTINOPOLIS";317;38;89;444
2010;"ALTO ALEGRE (SP)";"SP";"ALTO ALEGRE";79;4;36;119
2010;"ALUMINIO (SP)";"SP";"ALUMINIO";206;31;31;268
2010;"ALVARES FLORENCE (SP)";"SP";"ALVARES FLORENCE";56;5;15;76
2010;"ALVARES MACHADO (SP)";"SP";"ALVARES MACHADO";390;21;37;448
2010;"ALVARO DE CARVALHO (SP)";"SP";"ALVARO DE CARVALHO";14;3;22;39
2010;"ALVINLANDIA (SP)";"SP";"ALVINLANDIA";36;4;14;54
2010;"AMERICANA (SP)";"SP";"AMERICANA";3270;446;722;4438
2010;"AMERICO BRASILIENSE (SP)";"SP";"AMERICO BRASILIENSE";631;50;223;904
2010;"AMERICO DE CAMPOS (SP)";"SP";"AMERICO DE CAMPOS";136;7;24;167
2010;"AMPARO (SP)";"SP";"AMPARO";1296;185;124;1605
2010;"ANALANDIA (SP)";"SP";"ANALANDIA";67;14;10;91
2010;"ANDRADINA (SP)";"SP";"ANDRADINA";1256;57;123;1436
2010;"ANGATUBA (SP)";"SP";"ANGATUBA";355;39;83;477
2010;"ANHEMBI (SP)";"SP";"ANHEMBI";72;18;12;102
2010;"ANHUMAS (SP)";"SP";"ANHUMAS";66;6;7;79
2010;"APARECIDA (SP)";"SP";"APARECIDA";736;55;563;1354
2010;"APARECIDA D OESTE (SP)";"SP";"APARECIDA D OESTE";100;7;20;127
2010;"APIAI (SP)";"SP";"APIAI";306;34;49;389
2010;"ARACARIGUAMA (SP)";"SP";"ARACARIGUAMA";497;60;44;601
2010;"ARACATUBA (SP)";"SP";"ARACATUBA";3226;225;647;4098
2010;"ARACOIABA DA SERRA (SP)";"SP";"ARACOIABA DA SERRA";418;60;18;496
2010;"ARAMINA (SP)";"SP";"ARAMINA";56;6;25;87
2010;"ARANDU (SP)";"SP";"ARANDU";45;6;20;71
2010;"ARAPEI (SP)";"SP";"ARAPEI";38;9;13;60
2010;"ARARAQUARA (SP)";"SP";"ARARAQUARA";3223;330;939;4492
2010;"ARARAS (SP)";"SP";"ARARAS";2040;206;274;2520
2010;"ARCO IRIS (SP)";"SP";"ARCO IRIS";54;4;9;67
2010;"AREALVA (SP)";"SP";"AREALVA";145;5;21;171
2010;"AREIAS (SP)";"SP";"AREIAS";42;5;6;53
2010;"AREIOPOLIS (SP)";"SP";"AREIOPOLIS";109;25;74;208
2010;"ARIRANHA (SP)";"SP";"ARIRANHA";245;21;128;394
2010;"ARTUR NOGUEIRA (SP)";"SP";"ARTUR NOGUEIRA";912;83;143;1138
2010;"ARUJA (SP)";"SP";"ARUJA";2357;230;298;2885
2010;"ASPASIA (SP)";"SP";"ASPASIA";31;5;4;40
2010;"ASSIS (SP)";"SP";"ASSIS";1523;140;338;2001
2010;"ATIBAIA (SP)";"SP";"ATIBAIA";2096;279;290;2665
2010;"AURIFLAMA (SP)";"SP";"AURIFLAMA";308;18;36;362
2010;"AVAI (SP)";"SP";"AVAI";62;11;18;91
2010;"AVANHANDAVA (SP)";"SP";"AVANHANDAVA";120;8;33;161
2010;"AVARE (SP)";"SP";"AVARE";1168;114;244;1526
2010;"BADY BASSITT (SP)";"SP";"BADY BASSITT";335;34;63;432
2010;"BALBINOS (SP)";"SP";"BALBINOS";17;1;7;25
2010;"BALSAMO (SP)";"SP";"BALSAMO";162;5;16;183
2010;"BANANAL (SP)";"SP";"BANANAL";108;11;23;142
2010;"BARAO DE ANTONINA (SP)";"SP";"BARAO DE ANTONINA";23;3;13;39
2010;"BARBOSA (SP)";"SP";"BARBOSA";110;4;31;145
2010;"BARIRI (SP)";"SP";"BARIRI";745;56;87;888
2010;"BARRA BONITA (SP)";"SP";"BARRA BONITA";1162;75;187;1424
2010;"BARRA DO CHAPEU (SP)";"SP";"BARRA DO CHAPEU";26;2;8;36
2010;"BARRA DO TURVO (SP)";"SP";"BARRA DO TURVO";48;9;40;97
2010;"BARRETOS (SP)";"SP";"BARRETOS";1740;157;511;2408
2010;"BARRINHA (SP)";"SP";"BARRINHA";402;28;151;581
2010;"BARUERI (SP)";"SP";"BARUERI";5557;615;955;7127
2010;"BASTOS (SP)";"SP";"BASTOS";681;20;64;765
2010;"BATATAIS (SP)";"SP";"BATATAIS";997;88;148;1233
2010;"BAURU (SP)";"SP";"BAURU";4863;426;1045;6334
2010;"BEBEDOURO (SP)";"SP";"BEBEDOURO";1482;117;228;1827
2010;"BENTO DE ABREU (SP)";"SP";"BENTO DE ABREU";78;10;12;100
2010;"BERNARDINO DE CAMPOS (SP)";"SP";"BERNARDINO DE CAMPOS";306;19;30;355
2010;"BERTIOGA (SP)";"SP";"BERTIOGA";415;47;95;557
2010;"BILAC (SP)";"SP";"BILAC";130;9;23;162
2010;"BIRIGUI (SP)";"SP";"BIRIGUI";1522;69;117;1708
2010;"BIRITIBA MIRIM (SP)";"SP";"BIRITIBA MIRIM";311;18;20;349
2010;"BOA ESPERANCA DO SUL (SP)";"SP";"BOA ESPERANCA DO SUL";333;33;90;456
2010;"BOCAINA (SP)";"SP";"BOCAINA";212;32;32;276
2010;"BOFETE (SP)";"SP";"BOFETE";157;25;50;232
2010;"BOITUVA (SP)";"SP";"BOITUVA";1002;79;117;1198
2010;"BOM JESUS DOS PERDOES (SP)";"SP";"BOM JESUS DOS PERDOES";391;57;40;488
2010;"BOM SUCESSO DE ITARARE (SP)";"SP";"BOM SUCESSO DE ITARARE";64;9;11;84
2010;"BORA (SP)";"SP";"BORA";34;1;6;41
2010;"BORACEIA (SP)";"SP";"BORACEIA";202;7;18;227
2010;"BORBOREMA (SP)";"SP";"BORBOREMA";298;14;75;387
2010;"BOREBI (SP)";"SP";"BOREBI";45;9;7;61
2010;"BOTUCATU (SP)";"SP";"BOTUCATU";1506;221;385;2112
2010;"BRAGANCA PAULISTA (SP)";"SP";"BRAGANCA PAULISTA";2356;266;300;2922
2010;"BRAUNA (SP)";"SP";"BRAUNA";76;2;66;144
2010;"BREJO ALEGRE (SP)";"SP";"BREJO ALEGRE";170;1;21;192
2010;"BRODOWSKI (SP)";"SP";"BRODOWSKI";505;24;31;560
2010;"BROTAS (SP)";"SP";"BROTAS";461;48;124;633
2010;"BURI (SP)";"SP";"BURI";367;29;50;446
2010;"BURITAMA (SP)";"SP";"BURITAMA";303;23;48;374
2010;"BURITIZAL (SP)";"SP";"BURITIZAL";103;11;35;149
2010;"CABRALIA PAULISTA (SP)";"SP";"CABRALIA PAULISTA";120;5;10;135
2010;"CABREUVA (SP)";"SP";"CABREUVA";836;95;70;1001
2010;"CACAPAVA (SP)";"SP";"CACAPAVA";803;224;131;1158
2010;"CACHOEIRA PAULISTA (SP)";"SP";"CACHOEIRA PAULISTA";294;65;18;377
2010;"CACONDE (SP)";"SP";"CACONDE";191;31;72;294
2010;"CAFELANDIA (SP)";"SP";"CAFELANDIA";251;12;62;325
2010;"CAIABU (SP)";"SP";"CAIABU";36;2;38;76
2010;"CAIEIRAS (SP)";"SP";"CAIEIRAS";961;161;359;1481
2010;"CAIUA (SP)";"SP";"CAIUA";53;9;20;82
2010;"CAJAMAR (SP)";"SP";"CAJAMAR";1196;135;221;1552
2010;"CAJATI (SP)";"SP";"CAJATI";445;60;70;575
2010;"CAJOBI (SP)";"SP";"CAJOBI";278;7;73;358
2010;"CAJURU (SP)";"SP";"CAJURU";423;20;91;534
2010;"CAMPINA DO MONTE ALEGRE (SP)";"SP";"CAMPINA DO MONTE ALEGRE";65;15;24;104
2010;"CAMPINAS (SP)";"SP";"CAMPINAS";17620;3110;4445;25175
2010;"CAMPO LIMPO PAULISTA (SP)";"SP";"CAMPO LIMPO PAULISTA";518;83;29;630
2010;"CAMPOS DO JORDAO (SP)";"SP";"CAMPOS DO JORDAO";569;146;60;775
2010;"CAMPOS NOVOS PAULISTA (SP)";"SP";"CAMPOS NOVOS PAULISTA";79;4;26;109
2010;"CANANEIA (SP)";"SP";"CANANEIA";75;3;8;86
2010;"CANAS (SP)";"SP";"CANAS";56;6;7;69
2010;"CANDIDO MOTA (SP)";"SP";"CANDIDO MOTA";757;30;62;849
2010;"CANDIDO RODRIGUES (SP)";"SP";"CANDIDO RODRIGUES";104;6;8;118
2010;"CANITAR (SP)";"SP";"CANITAR";47;17;20;84
2010;"CAPAO BONITO (SP)";"SP";"CAPAO BONITO";823;80;148;1051
2010;"CAPELA DO ALTO (SP)";"SP";"CAPELA DO ALTO";377;38;30;445
2010;"CAPIVARI (SP)";"SP";"CAPIVARI";1155;87;180;1422
2010;"CARAGUATATUBA (SP)";"SP";"CARAGUATATUBA";1235;139;103;1477
2010;"CARAPICUIBA (SP)";"SP";"CARAPICUIBA";3043;650;836;4529
2010;"CARDOSO (SP)";"SP";"CARDOSO";152;10;40;202
2010;"CASA BRANCA (SP)";"SP";"CASA BRANCA";494;47;76;617
2010;"CASSIA DOS COQUEIROS (SP)";"SP";"CASSIA DOS COQUEIROS";18;4;11;33
2010;"CASTILHO (SP)";"SP";"CASTILHO";211;25;88;324
2010;"CATANDUVA (SP)";"SP";"CATANDUVA";2784;214;483;3481
2010;"CATIGUA (SP)";"SP";"CATIGUA";97;13;35;145
2010;"CEDRAL (SP)";"SP";"CEDRAL";199;11;16;226
2010;"CERQUEIRA CESAR (SP)";"SP";"CERQUEIRA CESAR";272;43;103;418
2010;"CERQUILHO (SP)";"SP";"CERQUILHO";838;83;85;1006
2010;"CESARIO LANGE (SP)";"SP";"CESARIO LANGE";319;41;43;403
2010;"CHARQUEADA (SP)";"SP";"CHARQUEADA";418;21;78;517
2010;"CHAVANTES (SP)";"SP";"CHAVANTES";139;17;44;200
2010;"CLEMENTINA (SP)";"SP";"CLEMENTINA";223;10;56;289
2010;"COLINA (SP)";"SP";"COLINA";345;22;66;433
2010;"COLOMBIA (SP)";"SP";"COLOMBIA";116;31;66;213
2010;"CONCHAL (SP)";"SP";"CONCHAL";681;42;215;938
2010;"CONCHAS (SP)";"SP";"CONCHAS";289;25;32;346
2010;"CORDEIROPOLIS (SP)";"SP";"CORDEIROPOLIS";582;58;33;673
2010;"COROADOS (SP)";"SP";"COROADOS";72;4;16;92
2010;"CORONEL MACEDO (SP)";"SP";"CORONEL MACEDO";51;10;24;85
2010;"CORUMBATAI (SP)";"SP";"CORUMBATAI";136;13;9;158
2010;"COSMOPOLIS (SP)";"SP";"COSMOPOLIS";729;242;239;1210
2010;"COSMORAMA (SP)";"SP";"COSMORAMA";131;3;37;171
2010;"COTIA (SP)";"SP";"COTIA";2569;711;573;3853
2010;"CRAVINHOS (SP)";"SP";"CRAVINHOS";871;36;140;1047
2010;"CRISTAIS PAULISTA (SP)";"SP";"CRISTAIS PAULISTA";108;3;23;134
2010;"CRUZALIA (SP)";"SP";"CRUZALIA";64;9;4;77
2010;"CRUZEIRO (SP)";"SP";"CRUZEIRO";622;102;45;769
2010;"CUBATAO (SP)";"SP";"CUBATAO";2955;378;476;3809
2010;"CUNHA (SP)";"SP";"CUNHA";229;24;25;278
2010;"DESCALVADO (SP)";"SP";"DESCALVADO";845;74;157;1076
2010;"DIADEMA (SP)";"SP";"DIADEMA";3764;682;541;4987
2010;"DIRCE REIS (SP)";"SP";"DIRCE REIS";59;4;7;70
2010;"DIVINOLANDIA (SP)";"SP";"DIVINOLANDIA";400;18;30;448
2010;"DOBRADA (SP)";"SP";"DOBRADA";64;7;74;145
2010;"DOIS CORREGOS (SP)";"SP";"DOIS CORREGOS";646;45;125;816
2010;"DOLCINOPOLIS (SP)";"SP";"DOLCINOPOLIS";25;4;7;36
2010;"DOURADO (SP)";"SP";"DOURADO";174;26;51;251
2010;"DRACENA (SP)";"SP";"DRACENA";944;46;121;1111
2010;"DUARTINA (SP)";"SP";"DUARTINA";247;28;52;327
2010;"DUMONT (SP)";"SP";"DUMONT";275;9;53;337
2010;"ECHAPORA (SP)";"SP";"ECHAPORA";114;1;16;131
2010;"ELDORADO (SP)";"SP";"ELDORADO";207;12;38;257
2010;"ELIAS FAUSTO (SP)";"SP";"ELIAS FAUSTO";316;14;60;390
2010;"ELISIARIO (SP)";"SP";"ELISIARIO";47;4;5;56
2010;"EMBAUBA (SP)";"SP";"EMBAUBA";72;5;26;103
2010;"EMBU (SP)";"SP";"EMBU";2054;528;599;3181
2010;"EMBU GUACU (SP)";"SP";"EMBU GUACU";1549;148;238;1935
2010;"EMILIANOPOLIS (SP)";"SP";"EMILIANOPOLIS";52;2;18;72
2010;"ENGENHEIRO COELHO (SP)";"SP";"ENGENHEIRO COELHO";296;34;130;460
2010;"ESPIRITO SANTO DO PINHAL (SP)";"SP";"ESPIRITO SANTO DO PINHAL";583;102;83;768
2010;"ESPIRITO SANTO DO TURVO (SP)";"SP";"ESPIRITO SANTO DO TURVO";146;19;34;199
2010;"ESTIVA GERBI (SP)";"SP";"ESTIVA GERBI";251;8;22;281
2010;"ESTRELA D OESTE (SP)";"SP";"ESTRELA D OESTE";235;7;20;262
2010;"ESTRELA DO NORTE (SP)";"SP";"ESTRELA DO NORTE";24;2;9;35
2010;"EUCLIDES DA CUNHA PAULISTA (SP)";"SP";"EUCLIDES DA CUNHA PAULISTA";82;5;39;126
2010;"FARTURA (SP)";"SP";"FARTURA";222;21;27;270
2010;"FERNANDO PRESTES (SP)";"SP";"FERNANDO PRESTES";204;5;15;224
2010;"FERNANDOPOLIS (SP)";"SP";"FERNANDOPOLIS";1248;63;152;1463
2010;"FERNAO (SP)";"SP";"FERNAO";22;3;7;32
2010;"FERRAZ DE VASCONCELOS (SP)";"SP";"FERRAZ DE VASCONCELOS";1272;173;287;1732
2010;"FLORA RICA (SP)";"SP";"FLORA RICA";13;0;9;22
2010;"FLOREAL (SP)";"SP";"FLOREAL";55;12;6;73
2010;"FLORIDA PAULISTA (SP)";"SP";"FLORIDA PAULISTA";292;9;107;408
2010;"FLORINEA (SP)";"SP";"FLORINEA";42;4;6;52
2010;"FRANCA (SP)";"SP";"FRANCA";2839;307;509;3655
2010;"FRANCISCO MORATO (SP)";"SP";"FRANCISCO MORATO";480;151;178;809
2010;"FRANCO DA ROCHA (SP)";"SP";"FRANCO DA ROCHA";656;153;154;963
2010;"GABRIEL MONTEIRO (SP)";"SP";"GABRIEL MONTEIRO";51;1;13;65
2010;"GALIA (SP)";"SP";"GALIA";133;13;36;182
2010;"GARCA (SP)";"SP";"GARCA";699;43;106;848
2010;"GASTAO VIDIGAL (SP)";"SP";"GASTAO VIDIGAL";65;9;45;119
2010;"GAVIAO PEIXOTO (SP)";"SP";"GAVIAO PEIXOTO";47;7;21;75
2010;"GENERAL SALGADO (SP)";"SP";"GENERAL SALGADO";283;17;85;385
2010;"GETULINA (SP)";"SP";"GETULINA";133;5;58;196
2010;"GLICERIO (SP)";"SP";"GLICERIO";96;4;19;119
2010;"GUAICARA (SP)";"SP";"GUAICARA";75;5;24;104
2010;"GUAIMBE (SP)";"SP";"GUAIMBE";109;1;23;133
2010;"GUAIRA (SP)";"SP";"GUAIRA";1102;43;149;1294
2010;"GUAPIACU (SP)";"SP";"GUAPIACU";391;19;62;472
2010;"GUAPIARA (SP)";"SP";"GUAPIARA";302;32;42;376
2010;"GUARA (SP)";"SP";"GUARA";195;27;143;365
2010;"GUARACAI (SP)";"SP";"GUARACAI";285;20;27;332
2010;"GUARACI (SP)";"SP";"GUARACI";141;11;60;212
2010;"GUARANI D OESTE (SP)";"SP";"GUARANI D OESTE";24;3;6;33
2010;"GUARANTA (SP)";"SP";"GUARANTA";83;2;39;124
2010;"GUARARAPES (SP)";"SP";"GUARARAPES";673;39;133;845
2010;"GUARAREMA (SP)";"SP";"GUARAREMA";387;50;74;511
2010;"GUARATINGUETA (SP)";"SP";"GUARATINGUETA";1010;259;158;1427
2010;"GUAREI (SP)";"SP";"GUAREI";234;19;49;302
2010;"GUARIBA (SP)";"SP";"GUARIBA";847;54;264;1165
2010;"GUARUJA (SP)";"SP";"GUARUJA";1914;388;360;2662
2010;"GUARULHOS (SP)";"SP";"GUARULHOS";18144;3544;3131;24819
2010;"GUATAPARA (SP)";"SP";"GUATAPARA";140;11;42;193
2010;"GUZOLANDIA (SP)";"SP";"GUZOLANDIA";58;4;36;98
2010;"HERCULANDIA (SP)";"SP";"HERCULANDIA";396;5;19;420
2010;"HOLAMBRA (SP)";"SP";"HOLAMBRA";355;32;64;451
2010;"HORTOLANDIA (SP)";"SP";"HORTOLANDIA";1437;288;311;2036
2010;"IACANGA (SP)";"SP";"IACANGA";172;12;28;212
2010;"IACRI (SP)";"SP";"IACRI";120;2;16;138
2010;"IARAS (SP)";"SP";"IARAS";38;16;30;84
2010;"IBATE (SP)";"SP";"IBATE";500;83;199;782
2010;"IBIRA (SP)";"SP";"IBIRA";167;18;61;246
2010;"IBIRAREMA (SP)";"SP";"IBIRAREMA";128;11;27;166
2010;"IBITINGA (SP)";"SP";"IBITINGA";775;60;130;965
2010;"IBIUNA (SP)";"SP";"IBIUNA";1707;127;106;1940
2010;"ICEM (SP)";"SP";"ICEM";179;7;68;254
2010;"IEPE (SP)";"SP";"IEPE";142;8;25;175
2010;"IGARACU DO TIETE (SP)";"SP";"IGARACU DO TIETE";356;22;73;451
2010;"IGARAPAVA (SP)";"SP";"IGARAPAVA";367;36;98;501
2010;"IGARATA (SP)";"SP";"IGARATA";126;20;11;157
2010;"IGUAPE (SP)";"SP";"IGUAPE";185;33;25;243
2010;"ILHA COMPRIDA (SP)";"SP";"ILHA COMPRIDA";116;15;57;188
2010;"ILHA SOLTEIRA (SP)";"SP";"ILHA SOLTEIRA";214;28;76;318
2010;"ILHABELA (SP)";"SP";"ILHABELA";266;55;43;364
2010;"INDAIATUBA (SP)";"SP";"INDAIATUBA";2627;441;205;3273
2010;"INDIANA (SP)";"SP";"INDIANA";109;5;11;125
2010;"INDIAPORA (SP)";"SP";"INDIAPORA";54;4;18;76
2010;"INUBIA PAULISTA (SP)";"SP";"INUBIA PAULISTA";57;7;14;78
2010;"IPAUSSU (SP)";"SP";"IPAUSSU";177;23;45;245
2010;"IPERO (SP)";"SP";"IPERO";193;14;39;246
2010;"IPEUNA (SP)";"SP";"IPEUNA";140;28;26;194
2010;"IPIGUA (SP)";"SP";"IPIGUA";23;1;8;32
2010;"IPORANGA (SP)";"SP";"IPORANGA";25;4;8;37
2010;"IPUA (SP)";"SP";"IPUA";259;16;71;346
2010;"IRACEMAPOLIS (SP)";"SP";"IRACEMAPOLIS";524;47;79;650
2010;"IRAPUA (SP)";"SP";"IRAPUA";144;6;74;224
2010;"IRAPURU (SP)";"SP";"IRAPURU";102;11;23;136
2010;"ITABERA (SP)";"SP";"ITABERA";215;21;26;262
2010;"ITAI (SP)";"SP";"ITAI";448;53;124;625
2010;"ITAJOBI (SP)";"SP";"ITAJOBI";459;14;41;514
2010;"ITAJU (SP)";"SP";"ITAJU";70;3;15;88
2010;"ITANHAEM (SP)";"SP";"ITANHAEM";638;151;100;889
2010;"ITAOCA (SP)";"SP";"ITAOCA";24;7;5;36
2010;"ITAPECERICA DA SERRA (SP)";"SP";"ITAPECERICA DA SERRA";2166;544;562;3272
2010;"ITAPETININGA (SP)";"SP";"ITAPETININGA";2313;310;327;2950
2010;"ITAPEVA (SP)";"SP";"ITAPEVA";1661;227;319;2207
2010;"ITAPEVI (SP)";"SP";"ITAPEVI";1418;198;152;1768
2010;"ITAPIRA (SP)";"SP";"ITAPIRA";1583;125;203;1911
2010;"ITAPIRAPUA PAULISTA (SP)";"SP";"ITAPIRAPUA PAULISTA";36;16;10;62
2010;"ITAPOLIS (SP)";"SP";"ITAPOLIS";1173;55;160;1388
2010;"ITAPORANGA (SP)";"SP";"ITAPORANGA";197;18;61;276
2010;"ITAPUI (SP)";"SP";"ITAPUI";371;27;65;463
2010;"ITAPURA (SP)";"SP";"ITAPURA";30;3;10;43
2010;"ITAQUAQUECETUBA (SP)";"SP";"ITAQUAQUECETUBA";2161;281;354;2796
2010;"ITARARE (SP)";"SP";"ITARARE";847;68;255;1170
2010;"ITARIRI (SP)";"SP";"ITARIRI";279;23;19;321
2010;"ITATIBA (SP)";"SP";"ITATIBA";2366;207;283;2856
2010;"ITATINGA (SP)";"SP";"ITATINGA";187;30;108;325
2010;"ITIRAPINA (SP)";"SP";"ITIRAPINA";228;29;51;308
2010;"ITIRAPUA (SP)";"SP";"ITIRAPUA";56;3;18;77
2010;"ITOBI (SP)";"SP";"ITOBI";125;11;73;209
2010;"ITU (SP)";"SP";"ITU";2586;317;522;3425
2010;"ITUPEVA (SP)";"SP";"ITUPEVA";883;94;94;1071
2010;"ITUVERAVA (SP)";"SP";"ITUVERAVA";622;38;122;782
2010;"JABORANDI (SP)";"SP";"JABORANDI";154;7;44;205
2010;"JABOTICABAL (SP)";"SP";"JABOTICABAL";1664;100;209;1973
2010;"JACAREI (SP)";"SP";"JACAREI";2441;520;345;3306
2010;"JACI (SP)";"SP";"JACI";176;9;27;212
2010;"JACUPIRANGA (SP)";"SP";"JACUPIRANGA";364;30;316;710
2010;"JAGUARIUNA (SP)";"SP";"JAGUARIUNA";997;88;150;1235
2010;"JALES (SP)";"SP";"JALES";1096;29;64;1189
2010;"JAMBEIRO (SP)";"SP";"JAMBEIRO";46;27;9;82
2010;"JANDIRA (SP)";"SP";"JANDIRA";1127;192;159;1478
2010;"JARDINOPOLIS (SP)";"SP";"JARDINOPOLIS";829;77;111;1017
2010;"JARINU (SP)";"SP";"JARINU";515;31;44;590
2010;"JAU (SP)";"SP";"JAU";2167;253;325;2745
2010;"JERIQUARA (SP)";"SP";"JERIQUARA";47;6;10;63
2010;"JOANOPOLIS (SP)";"SP";"JOANOPOLIS";303;17;15;335
2010;"JOAO RAMALHO (SP)";"SP";"JOAO RAMALHO";26;7;20;53
2010;"JOSE BONIFACIO (SP)";"SP";"JOSE BONIFACIO";786;46;88;920
2010;"JULIO MESQUITA (SP)";"SP";"JULIO MESQUITA";39;3;21;63
2010;"JUMIRIM (SP)";"SP";"JUMIRIM";89;7;6;102
2010;"JUNDIAI (SP)";"SP";"JUNDIAI";6935;777;1059;8771
2010;"JUNQUEIROPOLIS (SP)";"SP";"JUNQUEIROPOLIS";415;27;149;591
2010;"JUQUIA (SP)";"SP";"JUQUIA";364;19;16;399
2010;"JUQUITIBA (SP)";"SP";"JUQUITIBA";548;62;83;693
2010;"LAGOINHA (SP)";"SP";"LAGOINHA";100;10;17;127
2010;"LARANJAL PAULISTA (SP)";"SP";"LARANJAL PAULISTA";594;39;147;780
2010;"LAVINIA (SP)";"SP";"LAVINIA";75;10;10;95
2010;"LAVRINHAS (SP)";"SP";"LAVRINHAS";92;22;13;127
2010;"LEME (SP)";"SP";"LEME";2227;114;460;2801
2010;"LENCOIS PAULISTA (SP)";"SP";"LENCOIS PAULISTA";1278;136;232;1646
2010;"LIMEIRA (SP)";"SP";"LIMEIRA";4525;684;589;5798
2010;"LINDOIA (SP)";"SP";"LINDOIA";129;22;15;166
2010;"LINS (SP)";"SP";"LINS";1468;76;150;1694
2010;"LORENA (SP)";"SP";"LORENA";809;139;34;982
2010;"LOURDES (SP)";"SP";"LOURDES";26;5;13;44
2010;"LOUVEIRA (SP)";"SP";"LOUVEIRA";861;109;47;1017
2010;"LUCELIA (SP)";"SP";"LUCELIA";377;29;162;568
2010;"LUCIANOPOLIS (SP)";"SP";"LUCIANOPOLIS";44;5;14;63
2010;"LUIS ANTONIO (SP)";"SP";"LUIS ANTONIO";269;23;134;426
2010;"LUIZIANIA (SP)";"SP";"LUIZIANIA";52;2;26;80
2010;"LUPERCIO (SP)";"SP";"LUPERCIO";63;3;27;93
2010;"LUTECIA (SP)";"SP";"LUTECIA";40;8;10;58
2010;"MACATUBA (SP)";"SP";"MACATUBA";489;24;68;581
2010;"MACAUBAL (SP)";"SP";"MACAUBAL";131;14;20;165
2010;"MACEDONIA (SP)";"SP";"MACEDONIA";42;3;12;57
2010;"MAGDA (SP)";"SP";"MAGDA";91;11;10;112
2010;"MAIRINQUE (SP)";"SP";"MAIRINQUE";505;69;92;666
2010;"MAIRIPORA (SP)";"SP";"MAIRIPORA";1363;203;147;1713
2010;"MANDURI (SP)";"SP";"MANDURI";170;23;69;262
2010;"MARABA PAULISTA (SP)";"SP";"MARABA PAULISTA";24;3;14;41
2010;"MARACAI (SP)";"SP";"MARACAI";310;56;48;414
2010;"MARAPOAMA (SP)";"SP";"MARAPOAMA";122;10;10;142
2010;"MARIAPOLIS (SP)";"SP";"MARIAPOLIS";34;0;22;56
2010;"MARILIA (SP)";"SP";"MARILIA";2868;228;402;3498
2010;"MARINOPOLIS (SP)";"SP";"MARINOPOLIS";68;4;5;77
2010;"MARTINOPOLIS (SP)";"SP";"MARTINOPOLIS";378;38;79;495
2010;"MATAO (SP)";"SP";"MATAO";1472;71;268;1811
2010;"MAUA (SP)";"SP";"MAUA";3264;988;984;5236
2010;"MENDONCA (SP)";"SP";"MENDONCA";98;4;21;123
2010;"MERIDIANO (SP)";"SP";"MERIDIANO";115;10;14;139
2010;"MESOPOLIS (SP)";"SP";"MESOPOLIS";17;3;12;32
2010;"MIGUELOPOLIS (SP)";"SP";"MIGUELOPOLIS";291;12;93;396
2010;"MINEIROS DO TIETE (SP)";"SP";"MINEIROS DO TIETE";229;8;36;273
2010;"MIRA ESTRELA (SP)";"SP";"MIRA ESTRELA";35;6;22;63
2010;"MIRACATU (SP)";"SP";"MIRACATU";558;69;22;649
2010;"MIRANDOPOLIS (SP)";"SP";"MIRANDOPOLIS";523;31;151;705
2010;"MIRANTE DO PARANAPANEMA (SP)";"SP";"MIRANTE DO PARANAPANEMA";196;34;71;301
2010;"MIRASSOL (SP)";"SP";"MIRASSOL";1055;42;62;1159
2010;"MIRASSOLANDIA (SP)";"SP";"MIRASSOLANDIA";34;11;11;56
2010;"MOCOCA (SP)";"SP";"MOCOCA";1010;108;272;1390
2010;"MOGI DAS CRUZES (SP)";"SP";"MOGI DAS CRUZES";5084;699;1057;6840
2010;"MOGI GUACU (SP)";"SP";"MOGI GUACU";2079;339;354;2772
2010;"MOGI MIRIM (SP)";"SP";"MOGI MIRIM";1813;188;488;2489
2010;"MOMBUCA (SP)";"SP";"MOMBUCA";86;3;18;107
2010;"MONCOES (SP)";"SP";"MONCOES";62;7;11;80
2010;"MONGAGUA (SP)";"SP";"MONGAGUA";437;70;45;552
2010;"MONTE ALEGRE DO SUL (SP)";"SP";"MONTE ALEGRE DO SUL";211;35;32;278
2010;"MONTE ALTO (SP)";"SP";"MONTE ALTO";1405;57;92;1554
2010;"MONTE APRAZIVEL (SP)";"SP";"MONTE APRAZIVEL";567;28;134;729
2010;"MONTE AZUL PAULISTA (SP)";"SP";"MONTE AZUL PAULISTA";480;24;123;627
2010;"MONTE CASTELO (SP)";"SP";"MONTE CASTELO";67;5;12;84
2010;"MONTE MOR (SP)";"SP";"MONTE MOR";633;70;117;820
2010;"MONTEIRO LOBATO (SP)";"SP";"MONTEIRO LOBATO";265;35;16;316
2010;"MORRO AGUDO (SP)";"SP";"MORRO AGUDO";670;31;169;870
2010;"MORUNGABA (SP)";"SP";"MORUNGABA";346;51;21;418
2010;"MOTUCA (SP)";"SP";"MOTUCA";134;6;30;170
2010;"MUNICIPIO NAO INFORMADO (SP)";"SP";"MUNICIPIO NAO INFORMADO";0;0;0;0
2010;"MURUTINGA DO SUL (SP)";"SP";"MURUTINGA DO SUL";78;9;8;95
2010;"NANTES (SP)";"SP";"NANTES";16;3;17;36
2010;"NARANDIBA (SP)";"SP";"NARANDIBA";83;8;18;109
2010;"NATIVIDADE DA SERRA (SP)";"SP";"NATIVIDADE DA SERRA";70;29;9;108
2010;"NAZARE PAULISTA (SP)";"SP";"NAZARE PAULISTA";505;14;24;543
2010;"NEVES PAULISTA (SP)";"SP";"NEVES PAULISTA";188;6;31;225
2010;"NHANDEARA (SP)";"SP";"NHANDEARA";182;8;35;225
2010;"NIPOA (SP)";"SP";"NIPOA";106;6;22;134
2010;"NOVA ALIANCA (SP)";"SP";"NOVA ALIANCA";117;11;18;146
2010;"NOVA CAMPINA (SP)";"SP";"NOVA CAMPINA";63;11;13;87
2010;"NOVA CANAA PAULISTA (SP)";"SP";"NOVA CANAA PAULISTA";26;6;6;38
2010;"NOVA CASTILHO (SP)";"SP";"NOVA CASTILHO";15;4;9;28
2010;"NOVA EUROPA (SP)";"SP";"NOVA EUROPA";156;5;106;267
2010;"NOVA GRANADA (SP)";"SP";"NOVA GRANADA";308;35;91;434
2010;"NOVA GUATAPORANGA (SP)";"SP";"NOVA GUATAPORANGA";30;4;14;48
2010;"NOVA INDEPENDENCIA (SP)";"SP";"NOVA INDEPENDENCIA";32;8;8;48
2010;"NOVA LUZITANIA (SP)";"SP";"NOVA LUZITANIA";36;2;23;61
2010;"NOVA ODESSA (SP)";"SP";"NOVA ODESSA";777;115;119;1011
2010;"NOVAIS (SP)";"SP";"NOVAIS";108;9;40;157
2010;"NOVO HORIZONTE (SP)";"SP";"NOVO HORIZONTE";987;23;192;1202
2010;"NUPORANGA (SP)";"SP";"NUPORANGA";191;17;52;260
2010;"OCAUCU (SP)";"SP";"OCAUCU";100;6;13;119
2010;"OLEO (SP)";"SP";"OLEO";24;9;6;39
2010;"OLIMPIA (SP)";"SP";"OLIMPIA";895;91;171;1157
2010;"ONDA VERDE (SP)";"SP";"ONDA VERDE";79;4;21;104
2010;"ORIENTE (SP)";"SP";"ORIENTE";64;7;19;90
2010;"ORINDIUVA (SP)";"SP";"ORINDIUVA";151;11;97;259
2010;"ORLANDIA (SP)";"SP";"ORLANDIA";873;48;280;1201
2010;"OSASCO (SP)";"SP";"OSASCO";9221;1587;2468;13276
2010;"OSCAR BRESSANE (SP)";"SP";"OSCAR BRESSANE";53;4;7;64
2010;"OSVALDO CRUZ (SP)";"SP";"OSVALDO CRUZ";550;30;94;674
2010;"OURINHOS (SP)";"SP";"OURINHOS";2048;124;427;2599
2010;"OURO VERDE (SP)";"SP";"OURO VERDE";114;5;57;176
2010;"OUROESTE (SP)";"SP";"OUROESTE";109;12;33;154
2010;"PACAEMBU (SP)";"SP";"PACAEMBU";156;19;45;220
2010;"PALESTINA (SP)";"SP";"PALESTINA";153;13;33;199
2010;"PALMARES PAULISTA (SP)";"SP";"PALMARES PAULISTA";67;9;101;177
2010;"PALMEIRA D OESTE (SP)";"SP";"PALMEIRA D OESTE";223;6;33;262
2010;"PALMITAL (SP)";"SP";"PALMITAL";580;33;66;679
2010;"PANORAMA (SP)";"SP";"PANORAMA";311;8;15;334
2010;"PARAGUACU PAULISTA (SP)";"SP";"PARAGUACU PAULISTA";676;106;86;868
2010;"PARAIBUNA (SP)";"SP";"PARAIBUNA";209;66;42;317
2010;"PARAISO (SP)";"SP";"PARAISO";176;11;62;249
2010;"PARANAPANEMA (SP)";"SP";"PARANAPANEMA";492;27;57;576
2010;"PARANAPUA (SP)";"SP";"PARANAPUA";67;7;11;85
2010;"PARAPUA (SP)";"SP";"PARAPUA";281;5;47;333
2010;"PARDINHO (SP)";"SP";"PARDINHO";123;13;22;158
2010;"PARIQUERA ACU (SP)";"SP";"PARIQUERA ACU";357;18;15;390
2010;"PARISI (SP)";"SP";"PARISI";24;6;8;38
2010;"PATROCINIO PAULISTA (SP)";"SP";"PATROCINIO PAULISTA";210;8;42;260
2010;"PAULICEIA (SP)";"SP";"PAULICEIA";243;7;21;271
2010;"PAULINIA (SP)";"SP";"PAULINIA";1771;196;370;2337
2010;"PAULISTANIA (SP)";"SP";"PAULISTANIA";21;5;8;34
2010;"PAULO DE FARIA (SP)";"SP";"PAULO DE FARIA";95;15;41;151
2010;"PEDERNEIRAS (SP)";"SP";"PEDERNEIRAS";938;84;193;1215
2010;"PEDRA BELA (SP)";"SP";"PEDRA BELA";165;8;14;187
2010;"PEDRANOPOLIS (SP)";"SP";"PEDRANOPOLIS";45;1;16;62
2010;"PEDREGULHO (SP)";"SP";"PEDREGULHO";240;22;86;348
2010;"PEDREIRA (SP)";"SP";"PEDREIRA";673;101;64;838
2010;"PEDRINHAS PAULISTA (SP)";"SP";"PEDRINHAS PAULISTA";129;4;14;147
2010;"PEDRO DE TOLEDO (SP)";"SP";"PEDRO DE TOLEDO";125;16;9;150
2010;"PENAPOLIS (SP)";"SP";"PENAPOLIS";1244;50;229;1523
2010;"PEREIRA BARRETO (SP)";"SP";"PEREIRA BARRETO";344;29;94;467
2010;"PEREIRAS (SP)";"SP";"PEREIRAS";219;11;27;257
2010;"PERUIBE (SP)";"SP";"PERUIBE";545;156;89;790
2010;"PIACATU (SP)";"SP";"PIACATU";77;1;13;91
2010;"PIEDADE (SP)";"SP";"PIEDADE";1261;111;80;1452
2010;"PILAR DO SUL (SP)";"SP";"PILAR DO SUL";772;48;66;886
2010;"PINDAMONHANGABA (SP)";"SP";"PINDAMONHANGABA";1671;289;216;2176
2010;"PINDORAMA (SP)";"SP";"PINDORAMA";268;15;59;342
2010;"PINHALZINHO (SP)";"SP";"PINHALZINHO";353;27;9;389
2010;"PIQUEROBI (SP)";"SP";"PIQUEROBI";36;4;6;46
2010;"PIQUETE (SP)";"SP";"PIQUETE";153;38;18;209
2010;"PIRACAIA (SP)";"SP";"PIRACAIA";424;69;31;524
2010;"PIRACICABA (SP)";"SP";"PIRACICABA";6933;735;1220;8888
2010;"PIRAJU (SP)";"SP";"PIRAJU";401;51;68;520
2010;"PIRAJUI (SP)";"SP";"PIRAJUI";313;18;66;397
2010;"PIRANGI (SP)";"SP";"PIRANGI";376;22;56;454
2010;"PIRAPORA DO BOM JESUS (SP)";"SP";"PIRAPORA DO BOM JESUS";207;22;13;242
2010;"PIRAPOZINHO (SP)";"SP";"PIRAPOZINHO";413;26;66;505
2010;"PIRASSUNUNGA (SP)";"SP";"PIRASSUNUNGA";934;141;225;1300
2010;"PIRATININGA (SP)";"SP";"PIRATININGA";218;25;37;280
2010;"PITANGUEIRAS (SP)";"SP";"PITANGUEIRAS";819;41;234;1094
2010;"PLANALTO (SP)";"SP";"PLANALTO";73;8;25;106
2010;"PLATINA (SP)";"SP";"PLATINA";46;12;13;71
2010;"POA (SP)";"SP";"POA";850;149;185;1184
2010;"POLONI (SP)";"SP";"POLONI";164;5;47;216
2010;"POMPEIA (SP)";"SP";"POMPEIA";250;15;47;312
2010;"PONGAI (SP)";"SP";"PONGAI";47;4;17;68
2010;"PONTAL (SP)";"SP";"PONTAL";881;27;431;1339
2010;"PONTALINDA (SP)";"SP";"PONTALINDA";35;3;18;56
2010;"PONTES GESTAL (SP)";"SP";"PONTES GESTAL";52;1;23;76
2010;"POPULINA (SP)";"SP";"POPULINA";59;5;19;83
2010;"PORANGABA (SP)";"SP";"PORANGABA";108;11;11;130
2010;"PORTO FELIZ (SP)";"SP";"PORTO FELIZ";1193;78;170;1441
2010;"PORTO FERREIRA (SP)";"SP";"PORTO FERREIRA";1018;75;151;1244
2010;"POTIM (SP)";"SP";"POTIM";69;48;20;137
2010;"POTIRENDABA (SP)";"SP";"POTIRENDABA";436;15;65;516
2010;"PRACINHA (SP)";"SP";"PRACINHA";11;0;15;26
2010;"PRADOPOLIS (SP)";"SP";"PRADOPOLIS";371;15;195;581
2010;"PRAIA GRANDE (SP)";"SP";"PRAIA GRANDE";1802;276;224;2302
2010;"PRATANIA (SP)";"SP";"PRATANIA";94;12;35;141
2010;"PRESIDENTE ALVES (SP)";"SP";"PRESIDENTE ALVES";69;4;35;108
2010;"PRESIDENTE BERNARDES (SP)";"SP";"PRESIDENTE BERNARDES";219;23;28;270
2010;"PRESIDENTE EPITACIO (SP)";"SP";"PRESIDENTE EPITACIO";445;47;97;589
2010;"PRESIDENTE PRUDENTE (SP)";"SP";"PRESIDENTE PRUDENTE";3514;291;798;4603
2010;"PRESIDENTE VENCESLAU (SP)";"SP";"PRESIDENTE VENCESLAU";594;42;59;695
2010;"PROMISSAO (SP)";"SP";"PROMISSAO";657;57;177;891
2010;"QUADRA (SP)";"SP";"QUADRA";58;6;12;76
2010;"QUATA (SP)";"SP";"QUATA";209;16;58;283
2010;"QUEIROZ (SP)";"SP";"QUEIROZ";21;5;9;35
2010;"QUELUZ (SP)";"SP";"QUELUZ";100;28;6;134
2010;"QUINTANA (SP)";"SP";"QUINTANA";98;10;18;126
2010;"RAFARD (SP)";"SP";"RAFARD";259;17;26;302
2010;"RANCHARIA (SP)";"SP";"RANCHARIA";541;60;74;675
2010;"REDENCAO DA SERRA (SP)";"SP";"REDENCAO DA SERRA";62;15;20;97
2010;"REGENTE FEIJO (SP)";"SP";"REGENTE FEIJO";356;30;26;412
2010;"REGINOPOLIS (SP)";"SP";"REGINOPOLIS";80;7;22;109
2010;"REGISTRO (SP)";"SP";"REGISTRO";1042;75;274;1391
2010;"RESTINGA (SP)";"SP";"RESTINGA";59;7;18;84
2010;"RIBEIRA (SP)";"SP";"RIBEIRA";22;7;5;34
2010;"RIBEIRAO BONITO (SP)";"SP";"RIBEIRAO BONITO";289;29;86;404
2010;"RIBEIRAO BRANCO (SP)";"SP";"RIBEIRAO BRANCO";138;20;32;190
2010;"RIBEIRAO CORRENTE (SP)";"SP";"RIBEIRAO CORRENTE";59;6;29;94
2010;"RIBEIRAO DO SUL (SP)";"SP";"RIBEIRAO DO SUL";107;10;14;131
2010;"RIBEIRAO DOS INDIOS (SP)";"SP";"RIBEIRAO DOS INDIOS";19;2;11;32
2010;"RIBEIRAO GRANDE (SP)";"SP";"RIBEIRAO GRANDE";68;15;12;95
2010;"RIBEIRAO PIRES (SP)";"SP";"RIBEIRAO PIRES";3476;478;400;4354
2010;"RIBEIRAO PRETO (SP)";"SP";"RIBEIRAO PRETO";9430;825;1472;11727
2010;"RIFAINA (SP)";"SP";"RIFAINA";37;4;10;51
2010;"RINCAO (SP)";"SP";"RINCAO";245;12;46;303
2010;"RINOPOLIS (SP)";"SP";"RINOPOLIS";160;5;51;216
2010;"RIO CLARO (SP)";"SP";"RIO CLARO";3005;301;378;3684
2010;"RIO DAS PEDRAS (SP)";"SP";"RIO DAS PEDRAS";653;67;166;886
2010;"RIO GRANDE DA SERRA (SP)";"SP";"RIO GRANDE DA SERRA";250;95;51;396
2010;"RIOLANDIA (SP)";"SP";"RIOLANDIA";88;10;48;146
2010;"RIVERSUL (SP)";"SP";"RIVERSUL";61;13;27;101
2010;"ROSANA (SP)";"SP";"ROSANA";166;12;51;229
2010;"ROSEIRA (SP)";"SP";"ROSEIRA";133;45;13;191
2010;"RUBIACEA (SP)";"SP";"RUBIACEA";29;3;9;41
2010;"RUBINEIA (SP)";"SP";"RUBINEIA";21;8;6;35
2010;"SABINO (SP)";"SP";"SABINO";58;5;12;75
2010;"SAGRES (SP)";"SP";"SAGRES";17;2;5;24
2010;"SALES (SP)";"SP";"SALES";77;3;29;109
2010;"SALES OLIVEIRA (SP)";"SP";"SALES OLIVEIRA";235;8;38;281
2010;"SALESOPOLIS (SP)";"SP";"SALESOPOLIS";591;77;44;712
2010;"SALMOURAO (SP)";"SP";"SALMOURAO";36;2;31;69
2010;"SALTINHO (SP)";"SP";"SALTINHO";308;13;6;327
2010;"SALTO (SP)";"SP";"SALTO";1917;213;200;2330
2010;"SALTO DE PIRAPORA (SP)";"SP";"SALTO DE PIRAPORA";574;45;43;662
2010;"SALTO GRANDE (SP)";"SP";"SALTO GRANDE";135;11;29;175
2010;"SANDOVALINA (SP)";"SP";"SANDOVALINA";23;3;10;36
2010;"SANTA ADELIA (SP)";"SP";"SANTA ADELIA";548;33;76;657
2010;"SANTA ALBERTINA (SP)";"SP";"SANTA ALBERTINA";124;6;21;151
2010;"SANTA BARBARA D OESTE (SP)";"SP";"SANTA BARBARA D OESTE";2290;365;275;2930
2010;"SANTA BRANCA (SP)";"SP";"SANTA BRANCA";136;31;32;199
2010;"SANTA CLARA D OESTE (SP)";"SP";"SANTA CLARA D OESTE";25;2;4;31
2010;"SANTA CRUZ DA CONCEICAO (SP)";"SP";"SANTA CRUZ DA CONCEICAO";124;13;13;150
2010;"SANTA CRUZ DA ESPERANCA (SP)";"SP";"SANTA CRUZ DA ESPERANCA";21;2;4;27
2010;"SANTA CRUZ DAS PALMEIRAS (SP)";"SP";"SANTA CRUZ DAS PALMEIRAS";594;32;192;818
2010;"SANTA CRUZ DO RIO PARDO (SP)";"SP";"SANTA CRUZ DO RIO PARDO";1146;88;77;1311
2010;"SANTA ERNESTINA (SP)";"SP";"SANTA ERNESTINA";78;10;49;137
2010;"SANTA FE DO SUL (SP)";"SP";"SANTA FE DO SUL";592;26;41;659
2010;"SANTA GERTRUDES (SP)";"SP";"SANTA GERTRUDES";559;46;23;628
2010;"SANTA ISABEL (SP)";"SP";"SANTA ISABEL";1043;64;96;1203
2010;"SANTA LUCIA (SP)";"SP";"SANTA LUCIA";121;17;45;183
2010;"SANTA MARIA DA SERRA (SP)";"SP";"SANTA MARIA DA SERRA";214;23;28;265
2010;"SANTA MERCEDES (SP)";"SP";"SANTA MERCEDES";43;7;11;61
2010;"SANTA RITA D OESTE (SP)";"SP";"SANTA RITA D OESTE";26;1;6;33
2010;"SANTA RITA DO PASSA QUATRO (SP)";"SP";"SANTA RITA DO PASSA QUATRO";544;53;42;639
2010;"SANTA ROSA DE VITERBO (SP)";"SP";"SANTA ROSA DE VITERBO";366;33;85;484
2010;"SANTA SALETE (SP)";"SP";"SANTA SALETE";37;7;6;50
2010;"SANTANA DA PONTE PENSA (SP)";"SP";"SANTANA DA PONTE PENSA";22;3;3;28
2010;"SANTANA DE PARNAIBA (SP)";"SP";"SANTANA DE PARNAIBA";1597;358;155;2110
2010;"SANTO ANASTACIO (SP)";"SP";"SANTO ANASTACIO";452;18;55;525
2010;"SANTO ANDRE (SP)";"SP";"SANTO ANDRE";9521;1689;1716;12926
2010;"SANTO ANTONIO DA ALEGRIA (SP)";"SP";"SANTO ANTONIO DA ALEGRIA";91;6;22;119
2010;"SANTO ANTONIO DE POSSE (SP)";"SP";"SANTO ANTONIO DE POSSE";674;40;117;831
2010;"SANTO ANTONIO DO ARACANGUA (SP)";"SP";"SANTO ANTONIO DO ARACANGUA";202;19;88;309
2010;"SANTO ANTONIO DO JARDIM (SP)";"SP";"SANTO ANTONIO DO JARDIM";194;11;10;215
2010;"SANTO ANTONIO DO PINHAL (SP)";"SP";"SANTO ANTONIO DO PINHAL";104;22;6;132
2010;"SANTO EXPEDITO (SP)";"SP";"SANTO EXPEDITO";26;2;9;37
2010;"SANTOPOLIS DO AGUAPEI (SP)";"SP";"SANTOPOLIS DO AGUAPEI";62;4;25;91
2010;"SANTOS (SP)";"SP";"SANTOS";5236;787;701;6724
2010;"SAO BENTO DO SAPUCAI (SP)";"SP";"SAO BENTO DO SAPUCAI";117;34;11;162
2010;"SAO BERNARDO DO CAMPO (SP)";"SP";"SAO BERNARDO DO CAMPO";10984;2088;3057;16129
2010;"SAO CAETANO DO SUL (SP)";"SP";"SAO CAETANO DO SUL";2722;556;501;3779
2010;"SAO CARLOS (SP)";"SP";"SAO CARLOS";3385;372;399;4156
2010;"SAO FRANCISCO (SP)";"SP";"SAO FRANCISCO";29;4;15;48
2010;"SAO JOAO DA BOA VISTA (SP)";"SP";"SAO JOAO DA BOA VISTA";1719;224;92;2035
2010;"SAO JOAO DAS DUAS PONTES (SP)";"SP";"SAO JOAO DAS DUAS PONTES";15;8;6;29
2010;"SAO JOAO DE IRACEMA (SP)";"SP";"SAO JOAO DE IRACEMA";20;6;10;36
2010;"SAO JOAO DO PAU D ALHO (SP)";"SP";"SAO JOAO DO PAU D ALHO";33;5;6;44
2010;"SAO JOAQUIM DA BARRA (SP)";"SP";"SAO JOAQUIM DA BARRA";760;48;176;984
2010;"SAO JOSE DA BELA VISTA (SP)";"SP";"SAO JOSE DA BELA VISTA";71;9;45;125
2010;"SAO JOSE DO BARREIRO (SP)";"SP";"SAO JOSE DO BARREIRO";33;13;6;52
2010;"SAO JOSE DO RIO PARDO (SP)";"SP";"SAO JOSE DO RIO PARDO";1109;66;106;1281
2010;"SAO JOSE DO RIO PRETO (SP)";"SP";"SAO JOSE DO RIO PRETO";7303;552;1228;9083
2010;"SAO JOSE DOS CAMPOS (SP)";"SP";"SAO JOSE DOS CAMPOS";6207;1632;1398;9237
2010;"SAO LOURENCO DA SERRA (SP)";"SP";"SAO LOURENCO DA SERRA";252;16;18;286
2010;"SAO LUIZ DO PARAITINGA (SP)";"SP";"SAO LUIZ DO PARAITINGA";128;25;24;177
2010;"SAO MANUEL (SP)";"SP";"SAO MANUEL";728;73;176;977
2010;"SAO MIGUEL ARCANJO (SP)";"SP";"SAO MIGUEL ARCANJO";627;74;60;761
2010;"SAO PAULO (SP)";"SP";"SAO PAULO";128606;31192;39397;199195
2010;"SAO PEDRO (SP)";"SP";"SAO PEDRO";529;68;71;668
2010;"SAO PEDRO DO TURVO (SP)";"SP";"SAO PEDRO DO TURVO";146;15;29;190
2010;"SAO ROQUE (SP)";"SP";"SAO ROQUE";957;173;187;1317
2010;"SAO SEBASTIAO (SP)";"SP";"SAO SEBASTIAO";567;109;173;849
2010;"SAO SEBASTIAO DA GRAMA (SP)";"SP";"SAO SEBASTIAO DA GRAMA";231;22;24;277
2010;"SAO SIMAO (SP)";"SP";"SAO SIMAO";318;14;34;366
2010;"SAO VICENTE (SP)";"SP";"SAO VICENTE";1691;642;836;3169
2010;"SARAPUI (SP)";"SP";"SARAPUI";134;12;9;155
2010;"SARUTAIA (SP)";"SP";"SARUTAIA";36;12;22;70
2010;"SEBASTIANOPOLIS DO SUL (SP)";"SP";"SEBASTIANOPOLIS DO SUL";151;5;15;171
2010;"SERRA AZUL (SP)";"SP";"SERRA AZUL";131;14;84;229
2010;"SERRA NEGRA (SP)";"SP";"SERRA NEGRA";393;45;24;462
2010;"SERRANA (SP)";"SP";"SERRANA";599;95;217;911
2010;"SERTAOZINHO (SP)";"SP";"SERTAOZINHO";2490;138;406;3034
2010;"SETE BARRAS (SP)";"SP";"SETE BARRAS";182;8;30;220
2010;"SEVERINIA (SP)";"SP";"SEVERINIA";322;18;177;517
2010;"SILVEIRAS (SP)";"SP";"SILVEIRAS";75;17;6;98
2010;"SOCORRO (SP)";"SP";"SOCORRO";748;103;42;893
2010;"SOROCABA (SP)";"SP";"SOROCABA";7100;1079;1412;9591
2010;"SUD MENNUCCI (SP)";"SP";"SUD MENNUCCI";134;15;53;202
2010;"SUMARE (SP)";"SP";"SUMARE";2240;504;449;3193
2010;"SUZANAPOLIS (SP)";"SP";"SUZANAPOLIS";47;6;16;69
2010;"SUZANO (SP)";"SP";"SUZANO";2480;519;417;3416
2010;"TABAPUA (SP)";"SP";"TABAPUA";145;14;49;208
2010;"TABATINGA (SP)";"SP";"TABATINGA";327;15;126;468
2010;"TABOAO DA SERRA (SP)";"SP";"TABOAO DA SERRA";2301;674;525;3500
2010;"TACIBA (SP)";"SP";"TACIBA";80;7;17;104
2010;"TAGUAI (SP)";"SP";"TAGUAI";158;5;20;183
2010;"TAIACU (SP)";"SP";"TAIACU";130;5;18;153
2010;"TAIUVA (SP)";"SP";"TAIUVA";144;7;21;172
2010;"TAMBAU (SP)";"SP";"TAMBAU";488;37;52;577
2010;"TANABI (SP)";"SP";"TANABI";460;41;97;598
2010;"TAPIRAI (SP)";"SP";"TAPIRAI";169;10;10;189
2010;"TAPIRATIBA (SP)";"SP";"TAPIRATIBA";361;16;60;437
2010;"TAQUARAL (SP)";"SP";"TAQUARAL";54;5;18;77
2010;"TAQUARITINGA (SP)";"SP";"TAQUARITINGA";1427;68;311;1806
2010;"TAQUARITUBA (SP)";"SP";"TAQUARITUBA";588;45;68;701
2010;"TAQUARIVAI (SP)";"SP";"TAQUARIVAI";46;9;12;67
2010;"TARABAI (SP)";"SP";"TARABAI";90;8;23;121
2010;"TARUMA (SP)";"SP";"TARUMA";347;15;257;619
2010;"TATUI (SP)";"SP";"TATUI";1900;132;667;2699
2010;"TAUBATE (SP)";"SP";"TAUBATE";2935;704;707;4346
2010;"TEJUPA (SP)";"SP";"TEJUPA";44;11;7;62
2010;"TEODORO SAMPAIO (SP)";"SP";"TEODORO SAMPAIO";259;17;291;567
2010;"TERRA ROXA (SP)";"SP";"TERRA ROXA";165;12;59;236
2010;"TIETE (SP)";"SP";"TIETE";1145;44;149;1338
2010;"TIMBURI (SP)";"SP";"TIMBURI";27;4;7;38
2010;"TORRE DE PEDRA (SP)";"SP";"TORRE DE PEDRA";39;4;7;50
2010;"TORRINHA (SP)";"SP";"TORRINHA";394;18;38;450
2010;"TRABIJU (SP)";"SP";"TRABIJU";44;13;8;65
2010;"TREMEMBE (SP)";"SP";"TREMEMBE";361;53;10;424
2010;"TRES FRONTEIRAS (SP)";"SP";"TRES FRONTEIRAS";60;4;9;73
2010;"TUIUTI (SP)";"SP";"TUIUTI";92;21;13;126
2010;"TUPA (SP)";"SP";"TUPA";1340;48;198;1586
2010;"TUPI PAULISTA (SP)";"SP";"TUPI PAULISTA";280;14;23;317
2010;"TURIUBA (SP)";"SP";"TURIUBA";20;0;9;29
2010;"TURMALINA (SP)";"SP";"TURMALINA";27;2;9;38
2010;"UBARANA (SP)";"SP";"UBARANA";119;5;28;152
2010;"UBATUBA (SP)";"SP";"UBATUBA";584;75;63;722
2010;"UBIRAJARA (SP)";"SP";"UBIRAJARA";86;5;21;112
2010;"UCHOA (SP)";"SP";"UCHOA";144;8;42;194
2010;"UNIAO PAULISTA (SP)";"SP";"UNIAO PAULISTA";45;4;6;55
2010;"URANIA (SP)";"SP";"URANIA";151;14;28;193
2010;"URU (SP)";"SP";"URU";11;9;9;29
2010;"URUPES (SP)";"SP";"URUPES";333;19;48;400
2010;"VALENTIM GENTIL (SP)";"SP";"VALENTIM GENTIL";221;15;26;262
2010;"VALINHOS (SP)";"SP";"VALINHOS";1991;422;1550;3963
2010;"VALPARAISO (SP)";"SP";"VALPARAISO";425;30;144;599
2010;"VARGEM (SP)";"SP";"VARGEM";256;18;16;290
2010;"VARGEM GRANDE DO SUL (SP)";"SP";"VARGEM GRANDE DO SUL";1047;72;195;1314
2010;"VARGEM GRANDE PAULISTA (SP)";"SP";"VARGEM GRANDE PAULISTA";818;89;59;966
2010;"VARZEA PAULISTA (SP)";"SP";"VARZEA PAULISTA";930;311;189;1430
2010;"VERA CRUZ (SP)";"SP";"VERA CRUZ";129;16;27;172
2010;"VINHEDO (SP)";"SP";"VINHEDO";1397;145;113;1655
2010;"VIRADOURO (SP)";"SP";"VIRADOURO";337;16;62;415
2010;"VISTA ALEGRE DO ALTO (SP)";"SP";"VISTA ALEGRE DO ALTO";307;19;114;440
2010;"VITORIA BRASIL (SP)";"SP";"VITORIA BRASIL";20;2;9;31
2010;"VOTORANTIM (SP)";"SP";"VOTORANTIM";1118;234;194;1546
2010;"VOTUPORANGA (SP)";"SP";"VOTUPORANGA";1792;85;177;2054
2010;"ZACARIAS (SP)";"SP";"ZACARIAS";41;6;16;63
2010;"ABREULANDIA (TO)";"TO";"ABREULANDIA";10;1;1;12
2010;"AGUIARNOPOLIS (TO)";"TO";"AGUIARNOPOLIS";56;8;13;77
2010;"ALIANCA DO TOCANTINS (TO)";"TO";"ALIANCA DO TOCANTINS";64;7;6;77
2010;"ALMAS (TO)";"TO";"ALMAS";46;0;2;48
2010;"ALVORADA (TO)";"TO";"ALVORADA";135;1;3;139
2010;"ANANAS (TO)";"TO";"ANANAS";54;3;24;81
2010;"ANGICO (TO)";"TO";"ANGICO";11;3;3;17
2010;"APARECIDA DO RIO NEGRO (TO)";"TO";"APARECIDA DO RIO NEGRO";59;11;2;72
2010;"ARAGOMINAS (TO)";"TO";"ARAGOMINAS";81;2;17;100
2010;"ARAGUACEMA (TO)";"TO";"ARAGUACEMA";25;1;6;32
2010;"ARAGUACU (TO)";"TO";"ARAGUACU";77;8;6;91
2010;"ARAGUAINA (TO)";"TO";"ARAGUAINA";3375;125;426;3926
2010;"ARAGUANA (TO)";"TO";"ARAGUANA";198;12;44;254
2010;"ARAGUATINS (TO)";"TO";"ARAGUATINS";345;38;59;442
2010;"ARAPOEMA (TO)";"TO";"ARAPOEMA";42;4;11;57
2010;"ARRAIAS (TO)";"TO";"ARRAIAS";31;1;5;37
2010;"AUGUSTINOPOLIS (TO)";"TO";"AUGUSTINOPOLIS";140;31;20;191
2010;"AURORA DO TOCANTINS (TO)";"TO";"AURORA DO TOCANTINS";5;0;2;7
2010;"AXIXA DO TOCANTINS (TO)";"TO";"AXIXA DO TOCANTINS";36;16;4;56
2010;"BABACULANDIA (TO)";"TO";"BABACULANDIA";563;13;32;608
2010;"BANDEIRANTES DO TOCANTINS (TO)";"TO";"BANDEIRANTES DO TOCANTINS";19;1;3;23
2010;"BARRA DO OURO (TO)";"TO";"BARRA DO OURO";5;0;0;5
2010;"BARROLANDIA (TO)";"TO";"BARROLANDIA";44;4;3;51
2010;"BERNARDO SAYAO (TO)";"TO";"BERNARDO SAYAO";37;1;7;45
2010;"BOM JESUS DO TOCANTINS (TO)";"TO";"BOM JESUS DO TOCANTINS";6;1;1;8
2010;"BRASILANDIA DO TOCANTINS (TO)";"TO";"BRASILANDIA DO TOCANTINS";13;1;1;15
2010;"BREJINHO DE NAZARE (TO)";"TO";"BREJINHO DE NAZARE";40;1;5;46
2010;"BURITI DO TOCANTINS (TO)";"TO";"BURITI DO TOCANTINS";51;10;5;66
2010;"CACHOEIRINHA (TO)";"TO";"CACHOEIRINHA";5;0;0;5
2010;"CAMPOS LINDOS (TO)";"TO";"CAMPOS LINDOS";35;0;2;37
2010;"CARIRI DO TOCANTINS (TO)";"TO";"CARIRI DO TOCANTINS";32;2;8;42
2010;"CARMOLANDIA (TO)";"TO";"CARMOLANDIA";470;29;145;644
2010;"CARRASCO BONITO (TO)";"TO";"CARRASCO BONITO";4;3;1;8
2010;"CASEARA (TO)";"TO";"CASEARA";23;2;2;27
2010;"CENTENARIO (TO)";"TO";"CENTENARIO";4;0;1;5
2010;"CHAPADA DA NATIVIDADE (TO)";"TO";"CHAPADA DA NATIVIDADE";15;2;6;23
2010;"CHAPADA DE AREIA (TO)";"TO";"CHAPADA DE AREIA";2;0;2;4
2010;"COLINAS DO TOCANTINS (TO)";"TO";"COLINAS DO TOCANTINS";483;9;60;552
2010;"COLMEIA (TO)";"TO";"COLMEIA";111;8;14;133
2010;"COMBINADO (TO)";"TO";"COMBINADO";19;2;5;26
2010;"CONCEICAO DO TOCANTINS (TO)";"TO";"CONCEICAO DO TOCANTINS";9;0;0;9
2010;"COUTO DE MAGALHAES (TO)";"TO";"COUTO DE MAGALHAES";7;5;6;18
2010;"CRISTALANDIA (TO)";"TO";"CRISTALANDIA";82;0;2;84
2010;"CRIXAS DO TOCANTINS (TO)";"TO";"CRIXAS DO TOCANTINS";5;1;1;7
2010;"DARCINOPOLIS (TO)";"TO";"DARCINOPOLIS";93;10;4;107
2010;"DIANOPOLIS (TO)";"TO";"DIANOPOLIS";132;8;29;169
2010;"DIVINOPOLIS DO TOCANTINS (TO)";"TO";"DIVINOPOLIS DO TOCANTINS";57;3;4;64
2010;"DOIS IRMAOS DO TOCANTINS (TO)";"TO";"DOIS IRMAOS DO TOCANTINS";34;5;7;46
2010;"DUERE (TO)";"TO";"DUERE";26;2;4;32
2010;"ESPERANTINA (TO)";"TO";"ESPERANTINA";17;15;6;38
2010;"FATIMA (TO)";"TO";"FATIMA";29;2;3;34
2010;"FIGUEIROPOLIS (TO)";"TO";"FIGUEIROPOLIS";43;4;4;51
2010;"FILADELFIA (TO)";"TO";"FILADELFIA";47;10;9;66
2010;"FORMOSO DO ARAGUAIA (TO)";"TO";"FORMOSO DO ARAGUAIA";178;6;20;204
2010;"FORTALEZA DO TABOCAO (TO)";"TO";"FORTALEZA DO TABOCAO";21;6;4;31
2010;"GOIANORTE (TO)";"TO";"GOIANORTE";27;5;6;38
2010;"GOIATINS (TO)";"TO";"GOIATINS";79;5;11;95
2010;"GUARAI (TO)";"TO";"GUARAI";332;10;30;372
2010;"GURUPI (TO)";"TO";"GURUPI";1354;33;170;1557
2010;"IPUEIRAS (TO)";"TO";"IPUEIRAS";3;0;3;6
2010;"ITACAJA (TO)";"TO";"ITACAJA";27;0;0;27
2010;"ITAGUATINS (TO)";"TO";"ITAGUATINS";49;5;22;76
2010;"ITAPIRATINS (TO)";"TO";"ITAPIRATINS";13;2;7;22
2010;"ITAPORA DO TOCANTINS (TO)";"TO";"ITAPORA DO TOCANTINS";13;4;4;21
2010;"JAU DO TOCANTINS (TO)";"TO";"JAU DO TOCANTINS";14;1;7;22
2010;"JUARINA (TO)";"TO";"JUARINA";13;1;3;17
2010;"LAGOA DA CONFUSAO (TO)";"TO";"LAGOA DA CONFUSAO";91;3;8;102
2010;"LAGOA DO TOCANTINS (TO)";"TO";"LAGOA DO TOCANTINS";5;2;5;12
2010;"LAJEADO (TO)";"TO";"LAJEADO";22;1;8;31
2010;"LAVANDEIRA (TO)";"TO";"LAVANDEIRA";2;1;1;4
2010;"LIZARDA (TO)";"TO";"LIZARDA";12;1;0;13
2010;"LUZINOPOLIS (TO)";"TO";"LUZINOPOLIS";9;2;0;11
2010;"MARIANOPOLIS DO TOCANTINS (TO)";"TO";"MARIANOPOLIS DO TOCANTINS";28;0;4;32
2010;"MATEIROS (TO)";"TO";"MATEIROS";13;0;2;15
2010;"MAURILANDIA DO TOCANTINS (TO)";"TO";"MAURILANDIA DO TOCANTINS";9;6;2;17
2010;"MIRACEMA DO TOCANTINS (TO)";"TO";"MIRACEMA DO TOCANTINS";183;15;35;233
2010;"MIRANORTE (TO)";"TO";"MIRANORTE";210;13;9;232
2010;"MONTE DO CARMO (TO)";"TO";"MONTE DO CARMO";14;0;4;18
2010;"MONTE SANTO DO TOCANTINS (TO)";"TO";"MONTE SANTO DO TOCANTINS";26;3;2;31
2010;"MURICILANDIA (TO)";"TO";"MURICILANDIA";13;2;1;16
2010;"NATIVIDADE (TO)";"TO";"NATIVIDADE";55;1;2;58
2010;"NAZARE (TO)";"TO";"NAZARE";21;3;3;27
2010;"NOVA OLINDA (TO)";"TO";"NOVA OLINDA";74;3;16;93
2010;"NOVA ROSALANDIA (TO)";"TO";"NOVA ROSALANDIA";18;0;2;20
2010;"NOVO ACORDO (TO)";"TO";"NOVO ACORDO";17;0;1;18
2010;"NOVO ALEGRE (TO)";"TO";"NOVO ALEGRE";6;2;4;12
2010;"NOVO JARDIM (TO)";"TO";"NOVO JARDIM";14;0;2;16
2010;"OLIVEIRA DE FATIMA (TO)";"TO";"OLIVEIRA DE FATIMA";7;0;3;10
2010;"PALMAS (TO)";"TO";"PALMAS";3801;297;918;5016
2010;"PALMEIRANTE (TO)";"TO";"PALMEIRANTE";11;4;2;17
2010;"PALMEIRAS DO TOCANTINS (TO)";"TO";"PALMEIRAS DO TOCANTINS";28;7;4;39
2010;"PALMEIROPOLIS (TO)";"TO";"PALMEIROPOLIS";89;3;11;103
2010;"PARAISO DO TOCANTINS (TO)";"TO";"PARAISO DO TOCANTINS";1035;28;96;1159
2010;"PARANA (TO)";"TO";"PARANA";14;4;1;19
2010;"PAU D ARCO (TO)";"TO";"PAU D ARCO";11;1;2;14
2010;"PEDRO AFONSO (TO)";"TO";"PEDRO AFONSO";137;2;26;165
2010;"PEIXE (TO)";"TO";"PEIXE";58;7;42;107
2010;"PEQUIZEIRO (TO)";"TO";"PEQUIZEIRO";27;0;5;32
2010;"PINDORAMA DO TOCANTINS (TO)";"TO";"PINDORAMA DO TOCANTINS";24;0;5;29
2010;"PIRAQUE (TO)";"TO";"PIRAQUE";0;0;4;4
2010;"PIUM (TO)";"TO";"PIUM";32;3;9;44
2010;"PONTE ALTA DO BOM JESUS (TO)";"TO";"PONTE ALTA DO BOM JESUS";11;0;0;11
2010;"PONTE ALTA DO TOCANTINS (TO)";"TO";"PONTE ALTA DO TOCANTINS";26;2;2;30
2010;"PORTO ALEGRE DO TOCANTINS (TO)";"TO";"PORTO ALEGRE DO TOCANTINS";7;0;4;11
2010;"PORTO NACIONAL (TO)";"TO";"PORTO NACIONAL";565;30;88;683
2010;"PRAIA NORTE (TO)";"TO";"PRAIA NORTE";7;6;2;15
2010;"PRESIDENTE KENNEDY (TO)";"TO";"PRESIDENTE KENNEDY";31;2;1;34
2010;"PUGMIL (TO)";"TO";"PUGMIL";9;1;1;11
2010;"RECURSOLANDIA (TO)";"TO";"RECURSOLANDIA";8;0;0;8
2010;"RIACHINHO (TO)";"TO";"RIACHINHO";179;20;80;279
2010;"RIO DA CONCEICAO (TO)";"TO";"RIO DA CONCEICAO";4;1;1;6
2010;"RIO DOS BOIS (TO)";"TO";"RIO DOS BOIS";7;0;3;10
2010;"RIO SONO (TO)";"TO";"RIO SONO";14;1;6;21
2010;"SAMPAIO (TO)";"TO";"SAMPAIO";80;3;4;87
2010;"SANDOLANDIA (TO)";"TO";"SANDOLANDIA";12;6;1;19
2010;"SANTA FE DO ARAGUAIA (TO)";"TO";"SANTA FE DO ARAGUAIA";73;10;10;93
2010;"SANTA MARIA DO TOCANTINS (TO)";"TO";"SANTA MARIA DO TOCANTINS";11;3;2;16
2010;"SANTA RITA DO TOCANTINS (TO)";"TO";"SANTA RITA DO TOCANTINS";10;2;2;14
2010;"SANTA ROSA DO TOCANTINS (TO)";"TO";"SANTA ROSA DO TOCANTINS";22;0;3;25
2010;"SANTA TEREZA DO TOCANTINS (TO)";"TO";"SANTA TEREZA DO TOCANTINS";9;1;1;11
2010;"SANTA TEREZINHA DO TOCANTINS (TO)";"TO";"SANTA TEREZINHA DO TOCANTINS";10;3;1;14
2010;"SAO BENTO DO TOCANTINS (TO)";"TO";"SAO BENTO DO TOCANTINS";15;4;10;29
2010;"SAO FELIX DO TOCANTINS (TO)";"TO";"SAO FELIX DO TOCANTINS";4;1;0;5
2010;"SAO MIGUEL DO TOCANTINS (TO)";"TO";"SAO MIGUEL DO TOCANTINS";127;18;50;195
2010;"SAO SALVADOR DO TOCANTINS (TO)";"TO";"SAO SALVADOR DO TOCANTINS";23;2;2;27
2010;"SAO SEBASTIAO DO TOCANTINS (TO)";"TO";"SAO SEBASTIAO DO TOCANTINS";8;2;3;13
2010;"SAO VALERIO DA NATIVIDADE (TO)";"TO";"SAO VALERIO DA NATIVIDADE";40;1;5;46
2010;"SILVANOPOLIS (TO)";"TO";"SILVANOPOLIS";30;1;1;32
2010;"SITIO NOVO DO TOCANTINS (TO)";"TO";"SITIO NOVO DO TOCANTINS";40;7;15;62
2010;"SUCUPIRA (TO)";"TO";"SUCUPIRA";10;0;6;16
2010;"TAGUATINGA (TO)";"TO";"TAGUATINGA";64;7;16;87
2010;"TAIPAS DO TOCANTINS (TO)";"TO";"TAIPAS DO TOCANTINS";5;1;0;6
2010;"TALISMA (TO)";"TO";"TALISMA";12;4;1;17
2010;"TOCANTINIA (TO)";"TO";"TOCANTINIA";20;0;3;23
2010;"TOCANTINOPOLIS (TO)";"TO";"TOCANTINOPOLIS";1458;188;264;1910
2010;"TUPIRAMA (TO)";"TO";"TUPIRAMA";17;2;1;20
2010;"TUPIRATINS (TO)";"TO";"TUPIRATINS";8;0;6;14
2010;"WANDERLANDIA (TO)";"TO";"WANDERLANDIA";53;3;6;62
2010;"XAMBIOA (TO)";"TO";"XAMBIOA";108;3;15;126
