"ano";"chave";"UF";"MUNICIPIO";"CAMINHAO";"MICRO_ONIBUS";"ONIBUS";"total"
2013;"ACRELANDIA (AC)";"AC";"ACRELANDIA";201;6;41;248
2013;"ASSIS BRASIL (AC)";"AC";"ASSIS BRASIL";15;2;3;20
2013;"BRASILEIA (AC)";"AC";"BRASILEIA";186;3;11;200
2013;"BUJARI (AC)";"AC";"BUJARI";86;3;10;99
2013;"CAPIXABA (AC)";"AC";"CAPIXABA";67;1;9;77
2013;"CRUZEIRO DO SUL (AC)";"AC";"CRUZEIRO DO SUL";616;53;60;729
2013;"EPITACIOLANDIA (AC)";"AC";"EPITACIOLANDIA";183;1;13;197
2013;"FEIJO (AC)";"AC";"FEIJO";93;1;6;100
2013;"JORDAO (AC)";"AC";"JORDAO";2;0;0;2
2013;"MANCIO LIMA (AC)";"AC";"MANCIO LIMA";71;2;9;82
2013;"MANOEL URBANO (AC)";"AC";"MANOEL URBANO";23;0;2;25
2013;"MARECHAL THAUMATURGO (AC)";"AC";"MARECHAL THAUMATURGO";7;0;4;11
2013;"PLACIDO DE CASTRO (AC)";"AC";"PLACIDO DE CASTRO";134;2;15;151
2013;"PORTO ACRE (AC)";"AC";"PORTO ACRE";140;2;36;178
2013;"PORTO WALTER (AC)";"AC";"PORTO WALTER";4;0;2;6
2013;"RIO BRANCO (AC)";"AC";"RIO BRANCO";3856;188;654;4698
2013;"RODRIGUES ALVES (AC)";"AC";"RODRIGUES ALVES";10;0;1;11
2013;"SANTA ROSA DO PURUS (AC)";"AC";"SANTA ROSA DO PURUS";3;0;1;4
2013;"SENA MADUREIRA (AC)";"AC";"SENA MADUREIRA";87;3;7;97
2013;"SENADOR GUIOMARD (AC)";"AC";"SENADOR GUIOMARD";314;8;21;343
2013;"TARAUACA (AC)";"AC";"TARAUACA";138;12;14;164
2013;"XAPURI (AC)";"AC";"XAPURI";61;3;2;66
2013;"AGUA BRANCA (AL)";"AL";"AGUA BRANCA";60;63;10;133
2013;"ANADIA (AL)";"AL";"ANADIA";46;47;40;133
2013;"ARAPIRACA (AL)";"AL";"ARAPIRACA";2803;402;316;3521
2013;"ATALAIA (AL)";"AL";"ATALAIA";196;51;125;372
2013;"BARRA DE SANTO ANTONIO (AL)";"AL";"BARRA DE SANTO ANTONIO";28;5;19;52
2013;"BARRA DE SAO MIGUEL (AL)";"AL";"BARRA DE SAO MIGUEL";25;1;5;31
2013;"BATALHA (AL)";"AL";"BATALHA";91;22;3;116
2013;"BELEM (AL)";"AL";"BELEM";12;25;5;42
2013;"BELO MONTE (AL)";"AL";"BELO MONTE";35;8;2;45
2013;"BOCA DA MATA (AL)";"AL";"BOCA DA MATA";224;69;87;380
2013;"BRANQUINHA (AL)";"AL";"BRANQUINHA";25;21;15;61
2013;"CACIMBINHAS (AL)";"AL";"CACIMBINHAS";41;31;9;81
2013;"CAJUEIRO (AL)";"AL";"CAJUEIRO";92;8;49;149
2013;"CAMPESTRE (AL)";"AL";"CAMPESTRE";19;49;8;76
2013;"CAMPO ALEGRE (AL)";"AL";"CAMPO ALEGRE";132;116;119;367
2013;"CAMPO GRANDE (AL)";"AL";"CAMPO GRANDE";43;23;13;79
2013;"CANAPI (AL)";"AL";"CANAPI";36;31;17;84
2013;"CAPELA (AL)";"AL";"CAPELA";63;7;47;117
2013;"CARNEIROS (AL)";"AL";"CARNEIROS";25;10;5;40
2013;"CHA PRETA (AL)";"AL";"CHA PRETA";27;8;6;41
2013;"COITE DO NOIA (AL)";"AL";"COITE DO NOIA";48;6;24;78
2013;"COLONIA LEOPOLDINA (AL)";"AL";"COLONIA LEOPOLDINA";60;26;31;117
2013;"COQUEIRO SECO (AL)";"AL";"COQUEIRO SECO";8;2;4;14
2013;"CORURIPE (AL)";"AL";"CORURIPE";340;70;197;607
2013;"CRAIBAS (AL)";"AL";"CRAIBAS";123;31;25;179
2013;"DELMIRO GOUVEIA (AL)";"AL";"DELMIRO GOUVEIA";419;334;46;799
2013;"DOIS RIACHOS (AL)";"AL";"DOIS RIACHOS";58;12;9;79
2013;"ESTRELA DE ALAGOAS (AL)";"AL";"ESTRELA DE ALAGOAS";40;82;19;141
2013;"FEIRA GRANDE (AL)";"AL";"FEIRA GRANDE";59;2;47;108
2013;"FELIZ DESERTO (AL)";"AL";"FELIZ DESERTO";5;5;8;18
2013;"FLEXEIRAS (AL)";"AL";"FLEXEIRAS";23;18;35;76
2013;"GIRAU DO PONCIANO (AL)";"AL";"GIRAU DO PONCIANO";161;53;50;264
2013;"IBATEGUARA (AL)";"AL";"IBATEGUARA";39;55;15;109
2013;"IGACI (AL)";"AL";"IGACI";94;86;26;206
2013;"IGREJA NOVA (AL)";"AL";"IGREJA NOVA";83;23;78;184
2013;"INHAPI (AL)";"AL";"INHAPI";51;21;9;81
2013;"JACARE DOS HOMENS (AL)";"AL";"JACARE DOS HOMENS";35;6;6;47
2013;"JACUIPE (AL)";"AL";"JACUIPE";9;8;14;31
2013;"JAPARATINGA (AL)";"AL";"JAPARATINGA";12;23;7;42
2013;"JARAMATAIA (AL)";"AL";"JARAMATAIA";23;9;4;36
2013;"JEQUIA DA PRAIA (AL)";"AL";"JEQUIA DA PRAIA";29;11;38;78
2013;"JOAQUIM GOMES (AL)";"AL";"JOAQUIM GOMES";93;23;70;186
2013;"JUNDIA (AL)";"AL";"JUNDIA";12;4;8;24
2013;"JUNQUEIRO (AL)";"AL";"JUNQUEIRO";208;28;103;339
2013;"LAGOA DA CANOA (AL)";"AL";"LAGOA DA CANOA";84;15;23;122
2013;"LIMOEIRO DE ANADIA (AL)";"AL";"LIMOEIRO DE ANADIA";107;18;45;170
2013;"MACEIO (AL)";"AL";"MACEIO";6899;1052;1845;9796
2013;"MAJOR ISIDORO (AL)";"AL";"MAJOR ISIDORO";74;23;25;122
2013;"MAR VERMELHO (AL)";"AL";"MAR VERMELHO";11;2;9;22
2013;"MARAGOGI (AL)";"AL";"MARAGOGI";60;93;38;191
2013;"MARAVILHA (AL)";"AL";"MARAVILHA";31;41;8;80
2013;"MARECHAL DEODORO (AL)";"AL";"MARECHAL DEODORO";259;75;109;443
2013;"MARIBONDO (AL)";"AL";"MARIBONDO";62;18;13;93
2013;"MATA GRANDE (AL)";"AL";"MATA GRANDE";55;29;9;93
2013;"MATRIZ DE CAMARAGIBE (AL)";"AL";"MATRIZ DE CAMARAGIBE";135;29;125;289
2013;"MESSIAS (AL)";"AL";"MESSIAS";59;28;75;162
2013;"MINADOR DO NEGRAO (AL)";"AL";"MINADOR DO NEGRAO";43;15;6;64
2013;"MONTEIROPOLIS (AL)";"AL";"MONTEIROPOLIS";9;3;5;17
2013;"MURICI (AL)";"AL";"MURICI";106;25;103;234
2013;"NOVO LINO (AL)";"AL";"NOVO LINO";42;23;48;113
2013;"OLHO D AGUA DAS FLORES (AL)";"AL";"OLHO D AGUA DAS FLORES";104;74;20;198
2013;"OLHO D AGUA DO CASADO (AL)";"AL";"OLHO D AGUA DO CASADO";28;16;6;50
2013;"OLHO D AGUA GRANDE (AL)";"AL";"OLHO D AGUA GRANDE";12;1;8;21
2013;"OLIVENCA (AL)";"AL";"OLIVENCA";49;18;6;73
2013;"OURO BRANCO (AL)";"AL";"OURO BRANCO";55;34;18;107
2013;"PALESTINA (AL)";"AL";"PALESTINA";8;6;5;19
2013;"PALMEIRA DOS INDIOS (AL)";"AL";"PALMEIRA DOS INDIOS";593;188;63;844
2013;"PAO DE ACUCAR (AL)";"AL";"PAO DE ACUCAR";68;20;7;95
2013;"PARICONHA (AL)";"AL";"PARICONHA";34;18;8;60
2013;"PARIPUEIRA (AL)";"AL";"PARIPUEIRA";52;4;13;69
2013;"PASSO DE CAMARAGIBE (AL)";"AL";"PASSO DE CAMARAGIBE";31;8;26;65
2013;"PAULO JACINTO (AL)";"AL";"PAULO JACINTO";13;11;8;32
2013;"PENEDO (AL)";"AL";"PENEDO";244;70;191;505
2013;"PIACABUCU (AL)";"AL";"PIACABUCU";24;13;13;50
2013;"PILAR (AL)";"AL";"PILAR";160;49;60;269
2013;"PINDOBA (AL)";"AL";"PINDOBA";9;1;3;13
2013;"PIRANHAS (AL)";"AL";"PIRANHAS";59;73;15;147
2013;"POCO DAS TRINCHEIRAS (AL)";"AL";"POCO DAS TRINCHEIRAS";49;55;21;125
2013;"PORTO CALVO (AL)";"AL";"PORTO CALVO";180;120;64;364
2013;"PORTO DE PEDRAS (AL)";"AL";"PORTO DE PEDRAS";10;9;9;28
2013;"PORTO REAL DO COLEGIO (AL)";"AL";"PORTO REAL DO COLEGIO";18;31;18;67
2013;"QUEBRANGULO (AL)";"AL";"QUEBRANGULO";33;6;10;49
2013;"RIO LARGO (AL)";"AL";"RIO LARGO";432;177;190;799
2013;"ROTEIRO (AL)";"AL";"ROTEIRO";10;24;8;42
2013;"SANTA LUZIA DO NORTE (AL)";"AL";"SANTA LUZIA DO NORTE";19;6;63;88
2013;"SANTANA DO IPANEMA (AL)";"AL";"SANTANA DO IPANEMA";371;141;42;554
2013;"SANTANA DO MUNDAU (AL)";"AL";"SANTANA DO MUNDAU";62;31;7;100
2013;"SAO BRAS (AL)";"AL";"SAO BRAS";2;5;4;11
2013;"SAO JOSE DA LAJE (AL)";"AL";"SAO JOSE DA LAJE";96;77;48;221
2013;"SAO JOSE DA TAPERA (AL)";"AL";"SAO JOSE DA TAPERA";104;38;16;158
2013;"SAO LUIS DO QUITUNDE (AL)";"AL";"SAO LUIS DO QUITUNDE";193;25;135;353
2013;"SAO MIGUEL DOS CAMPOS (AL)";"AL";"SAO MIGUEL DOS CAMPOS";473;160;153;786
2013;"SAO MIGUEL DOS MILAGRES (AL)";"AL";"SAO MIGUEL DOS MILAGRES";23;2;5;30
2013;"SAO SEBASTIAO (AL)";"AL";"SAO SEBASTIAO";147;42;108;297
2013;"SATUBA (AL)";"AL";"SATUBA";65;16;22;103
2013;"SENADOR RUI PALMEIRA (AL)";"AL";"SENADOR RUI PALMEIRA";33;19;11;63
2013;"TANQUE D ARCA (AL)";"AL";"TANQUE D ARCA";12;17;7;36
2013;"TAQUARANA (AL)";"AL";"TAQUARANA";92;51;27;170
2013;"TEOTONIO VILELA (AL)";"AL";"TEOTONIO VILELA";198;85;172;455
2013;"TRAIPU (AL)";"AL";"TRAIPU";88;16;14;118
2013;"UNIAO DOS PALMARES (AL)";"AL";"UNIAO DOS PALMARES";478;210;167;855
2013;"VICOSA (AL)";"AL";"VICOSA";127;16;48;191
2013;"ALVARAES (AM)";"AM";"ALVARAES";7;0;3;10
2013;"AMATURA (AM)";"AM";"AMATURA";2;0;1;3
2013;"ANAMA (AM)";"AM";"ANAMA";0;0;3;3
2013;"ANORI (AM)";"AM";"ANORI";4;0;3;7
2013;"APUI (AM)";"AM";"APUI";101;1;22;124
2013;"ATALAIA DO NORTE (AM)";"AM";"ATALAIA DO NORTE";1;0;1;2
2013;"AUTAZES (AM)";"AM";"AUTAZES";28;4;13;45
2013;"BARCELOS (AM)";"AM";"BARCELOS";11;1;0;12
2013;"BARREIRINHA (AM)";"AM";"BARREIRINHA";5;0;0;5
2013;"BENJAMIN CONSTANT (AM)";"AM";"BENJAMIN CONSTANT";11;4;3;18
2013;"BERURI (AM)";"AM";"BERURI";0;0;0;0
2013;"BOA VISTA DO RAMOS (AM)";"AM";"BOA VISTA DO RAMOS";2;0;1;3
2013;"BOCA DO ACRE (AM)";"AM";"BOCA DO ACRE";43;3;6;52
2013;"BORBA (AM)";"AM";"BORBA";13;0;5;18
2013;"CAAPIRANGA (AM)";"AM";"CAAPIRANGA";8;1;8;17
2013;"CANUTAMA (AM)";"AM";"CANUTAMA";2;0;0;2
2013;"CARAUARI (AM)";"AM";"CARAUARI";37;1;1;39
2013;"CAREIRO (AM)";"AM";"CAREIRO";57;34;53;144
2013;"CAREIRO DA VARZEA (AM)";"AM";"CAREIRO DA VARZEA";13;24;38;75
2013;"COARI (AM)";"AM";"COARI";117;4;12;133
2013;"CODAJAS (AM)";"AM";"CODAJAS";7;0;4;11
2013;"EIRUNEPE (AM)";"AM";"EIRUNEPE";28;1;5;34
2013;"ENVIRA (AM)";"AM";"ENVIRA";15;0;4;19
2013;"FONTE BOA (AM)";"AM";"FONTE BOA";11;0;0;11
2013;"GUAJARA (AM)";"AM";"GUAJARA";0;0;5;5
2013;"HUMAITA (AM)";"AM";"HUMAITA";142;4;15;161
2013;"IPIXUNA (AM)";"AM";"IPIXUNA";2;0;2;4
2013;"IRANDUBA (AM)";"AM";"IRANDUBA";215;20;71;306
2013;"ITACOATIARA (AM)";"AM";"ITACOATIARA";362;34;142;538
2013;"ITAMARATI (AM)";"AM";"ITAMARATI";4;0;0;4
2013;"ITAPIRANGA (AM)";"AM";"ITAPIRANGA";14;1;6;21
2013;"JAPURA (AM)";"AM";"JAPURA";4;0;1;5
2013;"JURUA (AM)";"AM";"JURUA";6;0;2;8
2013;"JUTAI (AM)";"AM";"JUTAI";2;0;0;2
2013;"LABREA (AM)";"AM";"LABREA";28;1;5;34
2013;"MANACAPURU (AM)";"AM";"MANACAPURU";295;70;79;444
2013;"MANAQUIRI (AM)";"AM";"MANAQUIRI";12;5;7;24
2013;"MANAUS (AM)";"AM";"MANAUS";16470;2905;7718;27093
2013;"MANICORE (AM)";"AM";"MANICORE";35;1;12;48
2013;"MARAA (AM)";"AM";"MARAA";4;0;0;4
2013;"MAUES (AM)";"AM";"MAUES";38;2;16;56
2013;"NHAMUNDA (AM)";"AM";"NHAMUNDA";7;0;1;8
2013;"NOVA OLINDA DO NORTE (AM)";"AM";"NOVA OLINDA DO NORTE";15;6;8;29
2013;"NOVO AIRAO (AM)";"AM";"NOVO AIRAO";26;6;11;43
2013;"NOVO ARIPUANA (AM)";"AM";"NOVO ARIPUANA";21;2;7;30
2013;"PARINTINS (AM)";"AM";"PARINTINS";146;5;22;173
2013;"PAUINI (AM)";"AM";"PAUINI";2;1;1;4
2013;"PRESIDENTE FIGUEIREDO (AM)";"AM";"PRESIDENTE FIGUEIREDO";255;47;73;375
2013;"RIO PRETO DA EVA (AM)";"AM";"RIO PRETO DA EVA";129;13;68;210
2013;"SANTA ISABEL DO RIO NEGRO (AM)";"AM";"SANTA ISABEL DO RIO NEGRO";7;2;3;12
2013;"SANTO ANTONIO DO ICA (AM)";"AM";"SANTO ANTONIO DO ICA";6;0;0;6
2013;"SAO GABRIEL DA CACHOEIRA (AM)";"AM";"SAO GABRIEL DA CACHOEIRA";71;11;25;107
2013;"SAO PAULO DE OLIVENCA (AM)";"AM";"SAO PAULO DE OLIVENCA";4;0;5;9
2013;"SAO SEBASTIAO DO UATUMA (AM)";"AM";"SAO SEBASTIAO DO UATUMA";5;0;0;5
2013;"SILVES (AM)";"AM";"SILVES";10;5;3;18
2013;"TABATINGA (AM)";"AM";"TABATINGA";63;8;3;74
2013;"TAPAUA (AM)";"AM";"TAPAUA";3;0;2;5
2013;"TEFE (AM)";"AM";"TEFE";65;18;11;94
2013;"TONANTINS (AM)";"AM";"TONANTINS";3;0;1;4
2013;"UARINI (AM)";"AM";"UARINI";10;0;2;12
2013;"URUCARA (AM)";"AM";"URUCARA";14;3;2;19
2013;"URUCURITUBA (AM)";"AM";"URUCURITUBA";5;0;2;7
2013;"AMAPA (AP)";"AP";"AMAPA";8;1;2;11
2013;"CALCOENE (AP)";"AP";"CALCOENE";18;2;3;23
2013;"CUTIAS (AP)";"AP";"CUTIAS";3;2;0;5
2013;"FERREIRA GOMES (AP)";"AP";"FERREIRA GOMES";4;2;1;7
2013;"ITAUBAL (AP)";"AP";"ITAUBAL";5;0;5;10
2013;"LARANJAL DO JARI (AP)";"AP";"LARANJAL DO JARI";86;6;11;103
2013;"MACAPA (AP)";"AP";"MACAPA";2752;315;689;3756
2013;"MAZAGAO (AP)";"AP";"MAZAGAO";52;13;19;84
2013;"OIAPOQUE (AP)";"AP";"OIAPOQUE";60;4;15;79
2013;"PEDRA BRANCA DO AMAPARI (AP)";"AP";"PEDRA BRANCA DO AMAPARI";30;6;7;43
2013;"PORTO GRANDE (AP)";"AP";"PORTO GRANDE";34;5;15;54
2013;"PRACUUBA (AP)";"AP";"PRACUUBA";3;1;2;6
2013;"SANTANA (AP)";"AP";"SANTANA";598;46;143;787
2013;"SERRA DO NAVIO (AP)";"AP";"SERRA DO NAVIO";8;3;3;14
2013;"TARTARUGALZINHO (AP)";"AP";"TARTARUGALZINHO";15;5;1;21
2013;"VITORIA DO JARI (AP)";"AP";"VITORIA DO JARI";2;0;1;3
2013;"ABAIRA (BA)";"BA";"ABAIRA";54;21;16;91
2013;"ABARE (BA)";"BA";"ABARE";53;31;25;109
2013;"ACAJUTIBA (BA)";"BA";"ACAJUTIBA";74;17;18;109
2013;"ADUSTINA (BA)";"BA";"ADUSTINA";15;7;13;35
2013;"AGUA FRIA (BA)";"BA";"AGUA FRIA";21;20;39;80
2013;"AIQUARA (BA)";"BA";"AIQUARA";4;5;6;15
2013;"ALAGOINHAS (BA)";"BA";"ALAGOINHAS";1288;316;538;2142
2013;"ALCOBACA (BA)";"BA";"ALCOBACA";47;8;30;85
2013;"ALMADINA (BA)";"BA";"ALMADINA";16;0;5;21
2013;"AMARGOSA (BA)";"BA";"AMARGOSA";265;67;82;414
2013;"AMELIA RODRIGUES (BA)";"BA";"AMELIA RODRIGUES";184;107;31;322
2013;"AMERICA DOURADA (BA)";"BA";"AMERICA DOURADA";27;18;9;54
2013;"ANAGE (BA)";"BA";"ANAGE";89;71;45;205
2013;"ANDARAI (BA)";"BA";"ANDARAI";32;7;22;61
2013;"ANDORINHA (BA)";"BA";"ANDORINHA";72;15;41;128
2013;"ANGICAL (BA)";"BA";"ANGICAL";30;11;23;64
2013;"ANGUERA (BA)";"BA";"ANGUERA";19;6;14;39
2013;"ANTAS (BA)";"BA";"ANTAS";29;9;11;49
2013;"ANTONIO CARDOSO (BA)";"BA";"ANTONIO CARDOSO";3;36;18;57
2013;"ANTONIO GONCALVES (BA)";"BA";"ANTONIO GONCALVES";24;9;11;44
2013;"APORA (BA)";"BA";"APORA";37;27;31;95
2013;"APUAREMA (BA)";"BA";"APUAREMA";28;7;8;43
2013;"ARACAS (BA)";"BA";"ARACAS";62;19;31;112
2013;"ARACATU (BA)";"BA";"ARACATU";107;32;33;172
2013;"ARACI (BA)";"BA";"ARACI";282;24;65;371
2013;"ARAMARI (BA)";"BA";"ARAMARI";44;5;10;59
2013;"ARATACA (BA)";"BA";"ARATACA";27;0;3;30
2013;"ARATUIPE (BA)";"BA";"ARATUIPE";36;5;13;54
2013;"AURELINO LEAL (BA)";"BA";"AURELINO LEAL";51;4;12;67
2013;"BAIANOPOLIS (BA)";"BA";"BAIANOPOLIS";47;6;39;92
2013;"BAIXA GRANDE (BA)";"BA";"BAIXA GRANDE";95;56;47;198
2013;"BANZAE (BA)";"BA";"BANZAE";21;6;22;49
2013;"BARRA (BA)";"BA";"BARRA";68;35;36;139
2013;"BARRA DA ESTIVA (BA)";"BA";"BARRA DA ESTIVA";228;60;64;352
2013;"BARRA DO CHOCA (BA)";"BA";"BARRA DO CHOCA";130;191;30;351
2013;"BARRA DO MENDES (BA)";"BA";"BARRA DO MENDES";68;26;17;111
2013;"BARRA DO ROCHA (BA)";"BA";"BARRA DO ROCHA";9;5;4;18
2013;"BARREIRAS (BA)";"BA";"BARREIRAS";2637;152;444;3233
2013;"BARRO ALTO (BA)";"BA";"BARRO ALTO";51;17;22;90
2013;"BARRO PRETO (BA)";"BA";"BARRO PRETO";16;1;11;28
2013;"BARROCAS (BA)";"BA";"BARROCAS";95;4;19;118
2013;"BELMONTE (BA)";"BA";"BELMONTE";54;7;9;70
2013;"BELO CAMPO (BA)";"BA";"BELO CAMPO";113;20;32;165
2013;"BIRITINGA (BA)";"BA";"BIRITINGA";27;14;31;72
2013;"BOA NOVA (BA)";"BA";"BOA NOVA";35;46;25;106
2013;"BOA VISTA DO TUPIM (BA)";"BA";"BOA VISTA DO TUPIM";56;12;24;92
2013;"BOM JESUS DA LAPA (BA)";"BA";"BOM JESUS DA LAPA";438;74;134;646
2013;"BOM JESUS DA SERRA (BA)";"BA";"BOM JESUS DA SERRA";32;47;20;99
2013;"BONINAL (BA)";"BA";"BONINAL";75;26;38;139
2013;"BONITO (BA)";"BA";"BONITO";80;14;15;109
2013;"BOQUIRA (BA)";"BA";"BOQUIRA";139;9;69;217
2013;"BOTUPORA (BA)";"BA";"BOTUPORA";65;3;47;115
2013;"BREJOES (BA)";"BA";"BREJOES";88;10;37;135
2013;"BREJOLANDIA (BA)";"BA";"BREJOLANDIA";33;8;19;60
2013;"BROTAS DE MACAUBAS (BA)";"BA";"BROTAS DE MACAUBAS";32;55;22;109
2013;"BRUMADO (BA)";"BA";"BRUMADO";1439;253;358;2050
2013;"BUERAREMA (BA)";"BA";"BUERAREMA";162;10;41;213
2013;"BURITIRAMA (BA)";"BA";"BURITIRAMA";32;6;25;63
2013;"CAATIBA (BA)";"BA";"CAATIBA";20;4;2;26
2013;"CABACEIRAS DO PARAGUACU (BA)";"BA";"CABACEIRAS DO PARAGUACU";69;20;50;139
2013;"CACHOEIRA (BA)";"BA";"CACHOEIRA";111;111;74;296
2013;"CACULE (BA)";"BA";"CACULE";381;28;51;460
2013;"CAEM (BA)";"BA";"CAEM";24;12;20;56
2013;"CAETANOS (BA)";"BA";"CAETANOS";61;14;15;90
2013;"CAETITE (BA)";"BA";"CAETITE";569;103;111;783
2013;"CAFARNAUM (BA)";"BA";"CAFARNAUM";75;5;33;113
2013;"CAIRU (BA)";"BA";"CAIRU";9;12;7;28
2013;"CALDEIRAO GRANDE (BA)";"BA";"CALDEIRAO GRANDE";23;4;16;43
2013;"CAMACAN (BA)";"BA";"CAMACAN";184;23;41;248
2013;"CAMACARI (BA)";"BA";"CAMACARI";2306;541;1247;4094
2013;"CAMAMU (BA)";"BA";"CAMAMU";150;41;37;228
2013;"CAMPO ALEGRE DE LOURDES (BA)";"BA";"CAMPO ALEGRE DE LOURDES";109;12;11;132
2013;"CAMPO FORMOSO (BA)";"BA";"CAMPO FORMOSO";249;31;100;380
2013;"CANAPOLIS (BA)";"BA";"CANAPOLIS";21;25;12;58
2013;"CANARANA (BA)";"BA";"CANARANA";183;26;30;239
2013;"CANAVIEIRAS (BA)";"BA";"CANAVIEIRAS";99;9;15;123
2013;"CANDEAL (BA)";"BA";"CANDEAL";19;23;24;66
2013;"CANDEIAS (BA)";"BA";"CANDEIAS";868;367;350;1585
2013;"CANDIBA (BA)";"BA";"CANDIBA";61;0;26;87
2013;"CANDIDO SALES (BA)";"BA";"CANDIDO SALES";319;37;47;403
2013;"CANSANCAO (BA)";"BA";"CANSANCAO";184;68;64;316
2013;"CANUDOS (BA)";"BA";"CANUDOS";57;9;46;112
2013;"CAPELA DO ALTO ALEGRE (BA)";"BA";"CAPELA DO ALTO ALEGRE";85;24;23;132
2013;"CAPIM GROSSO (BA)";"BA";"CAPIM GROSSO";526;70;65;661
2013;"CARAIBAS (BA)";"BA";"CARAIBAS";51;26;23;100
2013;"CARAVELAS (BA)";"BA";"CARAVELAS";44;16;43;103
2013;"CARDEAL DA SILVA (BA)";"BA";"CARDEAL DA SILVA";30;8;8;46
2013;"CARINHANHA (BA)";"BA";"CARINHANHA";118;35;43;196
2013;"CASA NOVA (BA)";"BA";"CASA NOVA";501;213;227;941
2013;"CASTRO ALVES (BA)";"BA";"CASTRO ALVES";153;22;59;234
2013;"CATOLANDIA (BA)";"BA";"CATOLANDIA";9;3;9;21
2013;"CATU (BA)";"BA";"CATU";419;133;109;661
2013;"CATURAMA (BA)";"BA";"CATURAMA";40;11;15;66
2013;"CENTRAL (BA)";"BA";"CENTRAL";86;31;14;131
2013;"CHORROCHO (BA)";"BA";"CHORROCHO";30;6;10;46
2013;"CICERO DANTAS (BA)";"BA";"CICERO DANTAS";153;35;48;236
2013;"CIPO (BA)";"BA";"CIPO";51;8;16;75
2013;"COARACI (BA)";"BA";"COARACI";118;6;19;143
2013;"COCOS (BA)";"BA";"COCOS";90;7;44;141
2013;"CONCEICAO DA FEIRA (BA)";"BA";"CONCEICAO DA FEIRA";251;111;15;377
2013;"CONCEICAO DO ALMEIDA (BA)";"BA";"CONCEICAO DO ALMEIDA";121;38;32;191
2013;"CONCEICAO DO COITE (BA)";"BA";"CONCEICAO DO COITE";491;115;117;723
2013;"CONCEICAO DO JACUIPE (BA)";"BA";"CONCEICAO DO JACUIPE";319;149;28;496
2013;"CONDE (BA)";"BA";"CONDE";61;24;25;110
2013;"CONDEUBA (BA)";"BA";"CONDEUBA";131;47;75;253
2013;"CONTENDAS DO SINCORA (BA)";"BA";"CONTENDAS DO SINCORA";20;9;10;39
2013;"CORACAO DE MARIA (BA)";"BA";"CORACAO DE MARIA";95;44;59;198
2013;"CORDEIROS (BA)";"BA";"CORDEIROS";36;18;21;75
2013;"CORIBE (BA)";"BA";"CORIBE";51;17;27;95
2013;"CORONEL JOAO SA (BA)";"BA";"CORONEL JOAO SA";17;1;24;42
2013;"CORRENTINA (BA)";"BA";"CORRENTINA";160;33;88;281
2013;"COTEGIPE (BA)";"BA";"COTEGIPE";45;13;21;79
2013;"CRAVOLANDIA (BA)";"BA";"CRAVOLANDIA";17;1;9;27
2013;"CRISOPOLIS (BA)";"BA";"CRISOPOLIS";69;29;36;134
2013;"CRISTOPOLIS (BA)";"BA";"CRISTOPOLIS";62;10;34;106
2013;"CRUZ DAS ALMAS (BA)";"BA";"CRUZ DAS ALMAS";1042;304;88;1434
2013;"CURACA (BA)";"BA";"CURACA";85;33;36;154
2013;"DARIO MEIRA (BA)";"BA";"DARIO MEIRA";20;17;5;42
2013;"DIAS D AVILA (BA)";"BA";"DIAS D AVILA";652;105;421;1178
2013;"DOM BASILIO (BA)";"BA";"DOM BASILIO";302;16;28;346
2013;"DOM MACEDO COSTA (BA)";"BA";"DOM MACEDO COSTA";11;27;8;46
2013;"ELISIO MEDRADO (BA)";"BA";"ELISIO MEDRADO";31;18;16;65
2013;"ENCRUZILHADA (BA)";"BA";"ENCRUZILHADA";88;34;13;135
2013;"ENTRE RIOS (BA)";"BA";"ENTRE RIOS";217;88;102;407
2013;"ERICO CARDOSO (BA)";"BA";"ERICO CARDOSO";34;8;18;60
2013;"ESPLANADA (BA)";"BA";"ESPLANADA";148;37;81;266
2013;"EUCLIDES DA CUNHA (BA)";"BA";"EUCLIDES DA CUNHA";282;53;164;499
2013;"EUNAPOLIS (BA)";"BA";"EUNAPOLIS";1333;109;379;1821
2013;"FATIMA (BA)";"BA";"FATIMA";22;9;26;57
2013;"FEIRA DA MATA (BA)";"BA";"FEIRA DA MATA";18;10;13;41
2013;"FEIRA DE SANTANA (BA)";"BA";"FEIRA DE SANTANA";8476;1211;1304;10991
2013;"FILADELFIA (BA)";"BA";"FILADELFIA";121;12;27;160
2013;"FIRMINO ALVES (BA)";"BA";"FIRMINO ALVES";14;4;5;23
2013;"FLORESTA AZUL (BA)";"BA";"FLORESTA AZUL";44;2;2;48
2013;"FORMOSA DO RIO PRETO (BA)";"BA";"FORMOSA DO RIO PRETO";149;7;27;183
2013;"GANDU (BA)";"BA";"GANDU";294;111;27;432
2013;"GAVIAO (BA)";"BA";"GAVIAO";21;15;8;44
2013;"GENTIO DO OURO (BA)";"BA";"GENTIO DO OURO";19;8;6;33
2013;"GLORIA (BA)";"BA";"GLORIA";51;23;46;120
2013;"GONGOGI (BA)";"BA";"GONGOGI";11;1;2;14
2013;"GOVERNADOR MANGABEIRA (BA)";"BA";"GOVERNADOR MANGABEIRA";185;45;39;269
2013;"GUAJERU (BA)";"BA";"GUAJERU";24;35;15;74
2013;"GUANAMBI (BA)";"BA";"GUANAMBI";1275;101;193;1569
2013;"GUARATINGA (BA)";"BA";"GUARATINGA";85;5;32;122
2013;"HELIOPOLIS (BA)";"BA";"HELIOPOLIS";30;12;20;62
2013;"IACU (BA)";"BA";"IACU";144;26;34;204
2013;"IBIASSUCE (BA)";"BA";"IBIASSUCE";85;22;18;125
2013;"IBICARAI (BA)";"BA";"IBICARAI";140;12;29;181
2013;"IBICOARA (BA)";"BA";"IBICOARA";225;54;64;343
2013;"IBICUI (BA)";"BA";"IBICUI";49;20;15;84
2013;"IBIPEBA (BA)";"BA";"IBIPEBA";43;26;18;87
2013;"IBIPITANGA (BA)";"BA";"IBIPITANGA";88;23;36;147
2013;"IBIQUERA (BA)";"BA";"IBIQUERA";7;7;3;17
2013;"IBIRAPITANGA (BA)";"BA";"IBIRAPITANGA";60;25;14;99
2013;"IBIRAPUA (BA)";"BA";"IBIRAPUA";78;5;25;108
2013;"IBIRATAIA (BA)";"BA";"IBIRATAIA";79;48;15;142
2013;"IBITIARA (BA)";"BA";"IBITIARA";99;51;50;200
2013;"IBITITA (BA)";"BA";"IBITITA";51;14;26;91
2013;"IBOTIRAMA (BA)";"BA";"IBOTIRAMA";242;71;34;347
2013;"ICHU (BA)";"BA";"ICHU";34;22;14;70
2013;"IGAPORA (BA)";"BA";"IGAPORA";106;32;40;178
2013;"IGRAPIUNA (BA)";"BA";"IGRAPIUNA";48;32;23;103
2013;"IGUAI (BA)";"BA";"IGUAI";68;42;42;152
2013;"ILHEUS (BA)";"BA";"ILHEUS";715;162;292;1169
2013;"INHAMBUPE (BA)";"BA";"INHAMBUPE";204;100;86;390
2013;"IPECAETA (BA)";"BA";"IPECAETA";22;5;49;76
2013;"IPIAU (BA)";"BA";"IPIAU";387;43;54;484
2013;"IPIRA (BA)";"BA";"IPIRA";418;59;112;589
2013;"IPUPIARA (BA)";"BA";"IPUPIARA";59;24;6;89
2013;"IRAJUBA (BA)";"BA";"IRAJUBA";32;1;21;54
2013;"IRAMAIA (BA)";"BA";"IRAMAIA";36;12;18;66
2013;"IRAQUARA (BA)";"BA";"IRAQUARA";126;32;40;198
2013;"IRARA (BA)";"BA";"IRARA";145;35;71;251
2013;"IRECE (BA)";"BA";"IRECE";913;98;188;1199
2013;"ITABELA (BA)";"BA";"ITABELA";266;12;98;376
2013;"ITABERABA (BA)";"BA";"ITABERABA";514;92;82;688
2013;"ITABUNA (BA)";"BA";"ITABUNA";1919;78;799;2796
2013;"ITACARE (BA)";"BA";"ITACARE";22;28;8;58
2013;"ITAETE (BA)";"BA";"ITAETE";69;15;26;110
2013;"ITAGI (BA)";"BA";"ITAGI";43;3;7;53
2013;"ITAGIBA (BA)";"BA";"ITAGIBA";30;51;21;102
2013;"ITAGIMIRIM (BA)";"BA";"ITAGIMIRIM";52;3;6;61
2013;"ITAGUACU DA BAHIA (BA)";"BA";"ITAGUACU DA BAHIA";22;8;8;38
2013;"ITAJU DO COLONIA (BA)";"BA";"ITAJU DO COLONIA";19;1;7;27
2013;"ITAJUIPE (BA)";"BA";"ITAJUIPE";77;15;17;109
2013;"ITAMARAJU (BA)";"BA";"ITAMARAJU";455;42;172;669
2013;"ITAMARI (BA)";"BA";"ITAMARI";44;9;2;55
2013;"ITAMBE (BA)";"BA";"ITAMBE";69;58;9;136
2013;"ITANAGRA (BA)";"BA";"ITANAGRA";19;1;5;25
2013;"ITANHEM (BA)";"BA";"ITANHEM";73;12;27;112
2013;"ITAPARICA (BA)";"BA";"ITAPARICA";34;35;70;139
2013;"ITAPE (BA)";"BA";"ITAPE";26;0;2;28
2013;"ITAPEBI (BA)";"BA";"ITAPEBI";52;3;8;63
2013;"ITAPETINGA (BA)";"BA";"ITAPETINGA";515;54;168;737
2013;"ITAPICURU (BA)";"BA";"ITAPICURU";45;13;49;107
2013;"ITAPITANGA (BA)";"BA";"ITAPITANGA";10;5;3;18
2013;"ITAQUARA (BA)";"BA";"ITAQUARA";39;10;9;58
2013;"ITARANTIM (BA)";"BA";"ITARANTIM";97;15;5;117
2013;"ITATIM (BA)";"BA";"ITATIM";212;33;33;278
2013;"ITIRUCU (BA)";"BA";"ITIRUCU";106;15;20;141
2013;"ITIUBA (BA)";"BA";"ITIUBA";99;42;67;208
2013;"ITORORO (BA)";"BA";"ITORORO";98;21;23;142
2013;"ITUACU (BA)";"BA";"ITUACU";149;39;44;232
2013;"ITUBERA (BA)";"BA";"ITUBERA";153;18;24;195
2013;"IUIU (BA)";"BA";"IUIU";43;6;13;62
2013;"JABORANDI (BA)";"BA";"JABORANDI";64;1;31;96
2013;"JACARACI (BA)";"BA";"JACARACI";48;17;37;102
2013;"JACOBINA (BA)";"BA";"JACOBINA";756;131;199;1086
2013;"JAGUAQUARA (BA)";"BA";"JAGUAQUARA";610;31;61;702
2013;"JAGUARARI (BA)";"BA";"JAGUARARI";251;73;77;401
2013;"JAGUARIPE (BA)";"BA";"JAGUARIPE";40;32;25;97
2013;"JANDAIRA (BA)";"BA";"JANDAIRA";20;5;16;41
2013;"JEQUIE (BA)";"BA";"JEQUIE";1665;120;414;2199
2013;"JEREMOABO (BA)";"BA";"JEREMOABO";90;31;57;178
2013;"JIQUIRICA (BA)";"BA";"JIQUIRICA";47;26;24;97
2013;"JITAUNA (BA)";"BA";"JITAUNA";33;12;12;57
2013;"JOAO DOURADO (BA)";"BA";"JOAO DOURADO";122;31;29;182
2013;"JUAZEIRO (BA)";"BA";"JUAZEIRO";3040;1009;958;5007
2013;"JUCURUCU (BA)";"BA";"JUCURUCU";13;1;5;19
2013;"JUSSARA (BA)";"BA";"JUSSARA";66;19;20;105
2013;"JUSSARI (BA)";"BA";"JUSSARI";16;1;3;20
2013;"JUSSIAPE (BA)";"BA";"JUSSIAPE";64;24;26;114
2013;"LAFAIETE COUTINHO (BA)";"BA";"LAFAIETE COUTINHO";22;6;10;38
2013;"LAGEDO DO TABOCAL (BA)";"BA";"LAGEDO DO TABOCAL";39;1;9;49
2013;"LAGOA REAL (BA)";"BA";"LAGOA REAL";58;12;25;95
2013;"LAJE (BA)";"BA";"LAJE";161;86;51;298
2013;"LAJEDAO (BA)";"BA";"LAJEDAO";12;0;21;33
2013;"LAJEDINHO (BA)";"BA";"LAJEDINHO";9;7;10;26
2013;"LAMARAO (BA)";"BA";"LAMARAO";4;8;6;18
2013;"LAPAO (BA)";"BA";"LAPAO";144;16;41;201
2013;"LAURO DE FREITAS (BA)";"BA";"LAURO DE FREITAS";2491;519;699;3709
2013;"LENCOIS (BA)";"BA";"LENCOIS";25;14;3;42
2013;"LICINIO DE ALMEIDA (BA)";"BA";"LICINIO DE ALMEIDA";109;16;22;147
2013;"LIVRAMENTO DE NOSSA SENHORA (BA)";"BA";"LIVRAMENTO DE NOSSA SENHORA";484;64;130;678
2013;"LUIS EDUARDO MAGALHAES (BA)";"BA";"LUIS EDUARDO MAGALHAES";1642;77;158;1877
2013;"MACAJUBA (BA)";"BA";"MACAJUBA";28;26;35;89
2013;"MACARANI (BA)";"BA";"MACARANI";95;14;16;125
2013;"MACAUBAS (BA)";"BA";"MACAUBAS";225;30;223;478
2013;"MACURURE (BA)";"BA";"MACURURE";18;4;8;30
2013;"MADRE DE DEUS (BA)";"BA";"MADRE DE DEUS";91;50;32;173
2013;"MAETINGA (BA)";"BA";"MAETINGA";39;11;11;61
2013;"MAIQUINIQUE (BA)";"BA";"MAIQUINIQUE";52;8;13;73
2013;"MAIRI (BA)";"BA";"MAIRI";74;31;44;149
2013;"MALHADA (BA)";"BA";"MALHADA";43;14;22;79
2013;"MALHADA DE PEDRAS (BA)";"BA";"MALHADA DE PEDRAS";93;38;36;167
2013;"MANOEL VITORINO (BA)";"BA";"MANOEL VITORINO";54;16;10;80
2013;"MANSIDAO (BA)";"BA";"MANSIDAO";22;0;11;33
2013;"MARACAS (BA)";"BA";"MARACAS";237;23;55;315
2013;"MARAGOGIPE (BA)";"BA";"MARAGOGIPE";124;47;53;224
2013;"MARAU (BA)";"BA";"MARAU";24;3;8;35
2013;"MARCIONILIO SOUZA (BA)";"BA";"MARCIONILIO SOUZA";36;23;15;74
2013;"MASCOTE (BA)";"BA";"MASCOTE";44;4;10;58
2013;"MATA DE SAO JOAO (BA)";"BA";"MATA DE SAO JOAO";235;89;83;407
2013;"MATINA (BA)";"BA";"MATINA";18;17;31;66
2013;"MEDEIROS NETO (BA)";"BA";"MEDEIROS NETO";92;18;48;158
2013;"MIGUEL CALMON (BA)";"BA";"MIGUEL CALMON";85;26;39;150
2013;"MILAGRES (BA)";"BA";"MILAGRES";143;13;18;174
2013;"MIRANGABA (BA)";"BA";"MIRANGABA";55;14;35;104
2013;"MIRANTE (BA)";"BA";"MIRANTE";55;20;17;92
2013;"MONTE SANTO (BA)";"BA";"MONTE SANTO";232;64;162;458
2013;"MORPARA (BA)";"BA";"MORPARA";20;16;7;43
2013;"MORRO DO CHAPEU (BA)";"BA";"MORRO DO CHAPEU";149;46;22;217
2013;"MORTUGABA (BA)";"BA";"MORTUGABA";94;8;14;116
2013;"MUCUGE (BA)";"BA";"MUCUGE";113;18;56;187
2013;"MUCURI (BA)";"BA";"MUCURI";154;35;135;324
2013;"MULUNGU DO MORRO (BA)";"BA";"MULUNGU DO MORRO";93;8;13;114
2013;"MUNDO NOVO (BA)";"BA";"MUNDO NOVO";52;22;27;101
2013;"MUNIZ FERREIRA (BA)";"BA";"MUNIZ FERREIRA";54;44;7;105
2013;"MUQUEM DO SAO FRANCISCO (BA)";"BA";"MUQUEM DO SAO FRANCISCO";30;18;26;74
2013;"MURITIBA (BA)";"BA";"MURITIBA";134;46;36;216
2013;"MUTUIPE (BA)";"BA";"MUTUIPE";137;73;47;257
2013;"NAZARE (BA)";"BA";"NAZARE";265;71;41;377
2013;"NILO PECANHA (BA)";"BA";"NILO PECANHA";41;27;21;89
2013;"NORDESTINA (BA)";"BA";"NORDESTINA";58;9;28;95
2013;"NOVA CANAA (BA)";"BA";"NOVA CANAA";58;18;15;91
2013;"NOVA FATIMA (BA)";"BA";"NOVA FATIMA";71;6;12;89
2013;"NOVA IBIA (BA)";"BA";"NOVA IBIA";17;7;7;31
2013;"NOVA ITARANA (BA)";"BA";"NOVA ITARANA";35;8;6;49
2013;"NOVA REDENCAO (BA)";"BA";"NOVA REDENCAO";13;9;7;29
2013;"NOVA SOURE (BA)";"BA";"NOVA SOURE";64;15;30;109
2013;"NOVA VICOSA (BA)";"BA";"NOVA VICOSA";180;55;61;296
2013;"NOVO HORIZONTE (BA)";"BA";"NOVO HORIZONTE";50;13;13;76
2013;"NOVO TRIUNFO (BA)";"BA";"NOVO TRIUNFO";19;2;3;24
2013;"OLINDINA (BA)";"BA";"OLINDINA";92;34;68;194
2013;"OLIVEIRA DOS BREJINHOS (BA)";"BA";"OLIVEIRA DOS BREJINHOS";112;50;37;199
2013;"OURICANGAS (BA)";"BA";"OURICANGAS";42;12;23;77
2013;"OUROLANDIA (BA)";"BA";"OUROLANDIA";62;20;7;89
2013;"PALMAS DE MONTE ALTO (BA)";"BA";"PALMAS DE MONTE ALTO";65;8;42;115
2013;"PALMEIRAS (BA)";"BA";"PALMEIRAS";44;25;11;80
2013;"PARAMIRIM (BA)";"BA";"PARAMIRIM";175;17;65;257
2013;"PARATINGA (BA)";"BA";"PARATINGA";74;33;47;154
2013;"PARIPIRANGA (BA)";"BA";"PARIPIRANGA";70;7;52;129
2013;"PAU BRASIL (BA)";"BA";"PAU BRASIL";52;14;35;101
2013;"PAULO AFONSO (BA)";"BA";"PAULO AFONSO";948;346;363;1657
2013;"PE DE SERRA (BA)";"BA";"PE DE SERRA";78;12;27;117
2013;"PEDRAO (BA)";"BA";"PEDRAO";6;6;10;22
2013;"PEDRO ALEXANDRE (BA)";"BA";"PEDRO ALEXANDRE";3;5;10;18
2013;"PIATA (BA)";"BA";"PIATA";102;43;33;178
2013;"PILAO ARCADO (BA)";"BA";"PILAO ARCADO";49;37;8;94
2013;"PINDAI (BA)";"BA";"PINDAI";56;13;27;96
2013;"PINDOBACU (BA)";"BA";"PINDOBACU";60;24;28;112
2013;"PINTADAS (BA)";"BA";"PINTADAS";61;28;51;140
2013;"PIRAI DO NORTE (BA)";"BA";"PIRAI DO NORTE";28;4;2;34
2013;"PIRIPA (BA)";"BA";"PIRIPA";103;33;19;155
2013;"PIRITIBA (BA)";"BA";"PIRITIBA";67;24;21;112
2013;"PLANALTINO (BA)";"BA";"PLANALTINO";39;8;22;69
2013;"PLANALTO (BA)";"BA";"PLANALTO";123;45;62;230
2013;"POCOES (BA)";"BA";"POCOES";393;318;88;799
2013;"POJUCA (BA)";"BA";"POJUCA";370;105;74;549
2013;"PONTO NOVO (BA)";"BA";"PONTO NOVO";75;8;35;118
2013;"PORTO SEGURO (BA)";"BA";"PORTO SEGURO";639;285;422;1346
2013;"POTIRAGUA (BA)";"BA";"POTIRAGUA";42;8;6;56
2013;"PRADO (BA)";"BA";"PRADO";71;12;42;125
2013;"PRESIDENTE DUTRA (BA)";"BA";"PRESIDENTE DUTRA";60;5;8;73
2013;"PRESIDENTE JANIO QUADROS (BA)";"BA";"PRESIDENTE JANIO QUADROS";47;27;14;88
2013;"PRESIDENTE TANCREDO NEVES (BA)";"BA";"PRESIDENTE TANCREDO NEVES";225;149;34;408
2013;"QUEIMADAS (BA)";"BA";"QUEIMADAS";111;22;67;200
2013;"QUIJINGUE (BA)";"BA";"QUIJINGUE";61;23;69;153
2013;"QUIXABEIRA (BA)";"BA";"QUIXABEIRA";49;16;13;78
2013;"RAFAEL JAMBEIRO (BA)";"BA";"RAFAEL JAMBEIRO";76;30;76;182
2013;"REMANSO (BA)";"BA";"REMANSO";297;89;34;420
2013;"RETIROLANDIA (BA)";"BA";"RETIROLANDIA";87;8;19;114
2013;"RIACHAO DAS NEVES (BA)";"BA";"RIACHAO DAS NEVES";76;22;30;128
2013;"RIACHAO DO JACUIPE (BA)";"BA";"RIACHAO DO JACUIPE";298;53;42;393
2013;"RIACHO DE SANTANA (BA)";"BA";"RIACHO DE SANTANA";238;27;71;336
2013;"RIBEIRA DO AMPARO (BA)";"BA";"RIBEIRA DO AMPARO";11;15;40;66
2013;"RIBEIRA DO POMBAL (BA)";"BA";"RIBEIRA DO POMBAL";277;87;129;493
2013;"RIBEIRAO DO LARGO (BA)";"BA";"RIBEIRAO DO LARGO";33;17;6;56
2013;"RIO DE CONTAS (BA)";"BA";"RIO DE CONTAS";78;29;22;129
2013;"RIO DO ANTONIO (BA)";"BA";"RIO DO ANTONIO";148;25;21;194
2013;"RIO DO PIRES (BA)";"BA";"RIO DO PIRES";73;13;20;106
2013;"RIO REAL (BA)";"BA";"RIO REAL";213;23;60;296
2013;"RODELAS (BA)";"BA";"RODELAS";26;7;6;39
2013;"RUY BARBOSA (BA)";"BA";"RUY BARBOSA";129;65;21;215
2013;"SALINAS DA MARGARIDA (BA)";"BA";"SALINAS DA MARGARIDA";27;14;9;50
2013;"SALVADOR (BA)";"BA";"SALVADOR";17747;4039;8194;29980
2013;"SANTA BARBARA (BA)";"BA";"SANTA BARBARA";74;14;23;111
2013;"SANTA BRIGIDA (BA)";"BA";"SANTA BRIGIDA";29;34;27;90
2013;"SANTA CRUZ CABRALIA (BA)";"BA";"SANTA CRUZ CABRALIA";89;30;29;148
2013;"SANTA CRUZ DA VITORIA (BA)";"BA";"SANTA CRUZ DA VITORIA";12;5;5;22
2013;"SANTA INES (BA)";"BA";"SANTA INES";44;13;6;63
2013;"SANTA LUZIA (BA)";"BA";"SANTA LUZIA";42;3;7;52
2013;"SANTA MARIA DA VITORIA (BA)";"BA";"SANTA MARIA DA VITORIA";407;56;61;524
2013;"SANTA RITA DE CASSIA (BA)";"BA";"SANTA RITA DE CASSIA";70;10;18;98
2013;"SANTA TERESINHA (BA)";"BA";"SANTA TERESINHA";38;15;28;81
2013;"SANTALUZ (BA)";"BA";"SANTALUZ";291;34;47;372
2013;"SANTANA (BA)";"BA";"SANTANA";161;11;63;235
2013;"SANTANOPOLIS (BA)";"BA";"SANTANOPOLIS";27;11;14;52
2013;"SANTO AMARO (BA)";"BA";"SANTO AMARO";236;128;221;585
2013;"SANTO ANTONIO DE JESUS (BA)";"BA";"SANTO ANTONIO DE JESUS";2078;242;169;2489
2013;"SANTO ESTEVAO (BA)";"BA";"SANTO ESTEVAO";301;95;65;461
2013;"SAO DESIDERIO (BA)";"BA";"SAO DESIDERIO";278;24;79;381
2013;"SAO DOMINGOS (BA)";"BA";"SAO DOMINGOS";45;1;9;55
2013;"SAO FELIPE (BA)";"BA";"SAO FELIPE";243;56;40;339
2013;"SAO FELIX (BA)";"BA";"SAO FELIX";51;25;17;93
2013;"SAO FELIX DO CORIBE (BA)";"BA";"SAO FELIX DO CORIBE";142;21;18;181
2013;"SAO FRANCISCO DO CONDE (BA)";"BA";"SAO FRANCISCO DO CONDE";139;94;96;329
2013;"SAO GABRIEL (BA)";"BA";"SAO GABRIEL";31;8;20;59
2013;"SAO GONCALO DOS CAMPOS (BA)";"BA";"SAO GONCALO DOS CAMPOS";157;186;40;383
2013;"SAO JOSE DA VITORIA (BA)";"BA";"SAO JOSE DA VITORIA";12;0;5;17
2013;"SAO JOSE DO JACUIPE (BA)";"BA";"SAO JOSE DO JACUIPE";66;17;6;89
2013;"SAO MIGUEL DAS MATAS (BA)";"BA";"SAO MIGUEL DAS MATAS";57;6;20;83
2013;"SAO SEBASTIAO DO PASSE (BA)";"BA";"SAO SEBASTIAO DO PASSE";211;216;146;573
2013;"SAPEACU (BA)";"BA";"SAPEACU";99;75;38;212
2013;"SATIRO DIAS (BA)";"BA";"SATIRO DIAS";28;12;17;57
2013;"SAUBARA (BA)";"BA";"SAUBARA";29;22;3;54
2013;"SAUDE (BA)";"BA";"SAUDE";43;23;18;84
2013;"SEABRA (BA)";"BA";"SEABRA";435;125;145;705
2013;"SEBASTIAO LARANJEIRAS (BA)";"BA";"SEBASTIAO LARANJEIRAS";24;1;27;52
2013;"SENHOR DO BONFIM (BA)";"BA";"SENHOR DO BONFIM";635;136;196;967
2013;"SENTO SE (BA)";"BA";"SENTO SE";55;10;20;85
2013;"SERRA DO RAMALHO (BA)";"BA";"SERRA DO RAMALHO";92;29;37;158
2013;"SERRA DOURADA (BA)";"BA";"SERRA DOURADA";72;17;38;127
2013;"SERRA PRETA (BA)";"BA";"SERRA PRETA";51;17;60;128
2013;"SERRINHA (BA)";"BA";"SERRINHA";707;131;193;1031
2013;"SERROLANDIA (BA)";"BA";"SERROLANDIA";54;43;22;119
2013;"SIMOES FILHO (BA)";"BA";"SIMOES FILHO";2433;484;829;3746
2013;"SITIO DO MATO (BA)";"BA";"SITIO DO MATO";32;11;22;65
2013;"SITIO DO QUINTO (BA)";"BA";"SITIO DO QUINTO";23;3;9;35
2013;"SOBRADINHO (BA)";"BA";"SOBRADINHO";94;47;42;183
2013;"SOUTO SOARES (BA)";"BA";"SOUTO SOARES";113;11;26;150
2013;"TABOCAS DO BREJO VELHO (BA)";"BA";"TABOCAS DO BREJO VELHO";38;4;14;56
2013;"TANHACU (BA)";"BA";"TANHACU";233;56;49;338
2013;"TANQUE NOVO (BA)";"BA";"TANQUE NOVO";258;5;44;307
2013;"TANQUINHO (BA)";"BA";"TANQUINHO";30;19;12;61
2013;"TAPEROA (BA)";"BA";"TAPEROA";130;27;16;173
2013;"TAPIRAMUTA (BA)";"BA";"TAPIRAMUTA";45;10;15;70
2013;"TEIXEIRA DE FREITAS (BA)";"BA";"TEIXEIRA DE FREITAS";1555;111;369;2035
2013;"TEODORO SAMPAIO (BA)";"BA";"TEODORO SAMPAIO";13;13;10;36
2013;"TEOFILANDIA (BA)";"BA";"TEOFILANDIA";103;39;36;178
2013;"TEOLANDIA (BA)";"BA";"TEOLANDIA";136;29;11;176
2013;"TERRA NOVA (BA)";"BA";"TERRA NOVA";24;11;22;57
2013;"TREMEDAL (BA)";"BA";"TREMEDAL";53;28;41;122
2013;"TUCANO (BA)";"BA";"TUCANO";286;53;95;434
2013;"UAUA (BA)";"BA";"UAUA";219;38;29;286
2013;"UBAIRA (BA)";"BA";"UBAIRA";100;29;48;177
2013;"UBAITABA (BA)";"BA";"UBAITABA";179;13;20;212
2013;"UBATA (BA)";"BA";"UBATA";212;20;15;247
2013;"UIBAI (BA)";"BA";"UIBAI";48;15;17;80
2013;"UMBURANAS (BA)";"BA";"UMBURANAS";46;21;18;85
2013;"UNA (BA)";"BA";"UNA";64;9;31;104
2013;"URANDI (BA)";"BA";"URANDI";129;16;27;172
2013;"URUCUCA (BA)";"BA";"URUCUCA";102;9;16;127
2013;"UTINGA (BA)";"BA";"UTINGA";71;14;7;92
2013;"VALENCA (BA)";"BA";"VALENCA";739;188;127;1054
2013;"VALENTE (BA)";"BA";"VALENTE";165;19;33;217
2013;"VARZEA DA ROCA (BA)";"BA";"VARZEA DA ROCA";44;16;22;82
2013;"VARZEA DO POCO (BA)";"BA";"VARZEA DO POCO";69;15;13;97
2013;"VARZEA NOVA (BA)";"BA";"VARZEA NOVA";59;12;15;86
2013;"VARZEDO (BA)";"BA";"VARZEDO";64;10;23;97
2013;"VERA CRUZ (BA)";"BA";"VERA CRUZ";182;174;34;390
2013;"VEREDA (BA)";"BA";"VEREDA";10;3;2;15
2013;"VITORIA DA CONQUISTA (BA)";"BA";"VITORIA DA CONQUISTA";4180;839;1361;6380
2013;"WAGNER (BA)";"BA";"WAGNER";33;4;14;51
2013;"WANDERLEY (BA)";"BA";"WANDERLEY";72;7;20;99
2013;"WENCESLAU GUIMARAES (BA)";"BA";"WENCESLAU GUIMARAES";125;14;16;155
2013;"XIQUE XIQUE (BA)";"BA";"XIQUE XIQUE";155;26;19;200
2013;"ABAIARA (CE)";"CE";"ABAIARA";14;23;6;43
2013;"ACARAPE (CE)";"CE";"ACARAPE";96;18;138;252
2013;"ACARAU (CE)";"CE";"ACARAU";221;22;60;303
2013;"ACOPIARA (CE)";"CE";"ACOPIARA";352;23;38;413
2013;"AIUABA (CE)";"CE";"AIUABA";27;6;3;36
2013;"ALCANTARAS (CE)";"CE";"ALCANTARAS";44;14;20;78
2013;"ALTANEIRA (CE)";"CE";"ALTANEIRA";22;8;5;35
2013;"ALTO SANTO (CE)";"CE";"ALTO SANTO";150;11;16;177
2013;"AMONTADA (CE)";"CE";"AMONTADA";192;27;30;249
2013;"ANTONINA DO NORTE (CE)";"CE";"ANTONINA DO NORTE";40;3;4;47
2013;"APUIARES (CE)";"CE";"APUIARES";78;7;5;90
2013;"AQUIRAZ (CE)";"CE";"AQUIRAZ";557;142;107;806
2013;"ARACATI (CE)";"CE";"ARACATI";456;98;127;681
2013;"ARACOIABA (CE)";"CE";"ARACOIABA";117;14;18;149
2013;"ARARENDA (CE)";"CE";"ARARENDA";35;3;3;41
2013;"ARARIPE (CE)";"CE";"ARARIPE";61;104;42;207
2013;"ARATUBA (CE)";"CE";"ARATUBA";67;0;16;83
2013;"ARNEIROZ (CE)";"CE";"ARNEIROZ";32;12;4;48
2013;"ASSARE (CE)";"CE";"ASSARE";94;33;9;136
2013;"AURORA (CE)";"CE";"AURORA";79;34;13;126
2013;"BAIXIO (CE)";"CE";"BAIXIO";15;16;8;39
2013;"BANABUIU (CE)";"CE";"BANABUIU";104;12;25;141
2013;"BARBALHA (CE)";"CE";"BARBALHA";339;82;85;506
2013;"BARREIRA (CE)";"CE";"BARREIRA";134;11;16;161
2013;"BARRO (CE)";"CE";"BARRO";64;36;15;115
2013;"BARROQUINHA (CE)";"CE";"BARROQUINHA";42;6;5;53
2013;"BATURITE (CE)";"CE";"BATURITE";223;21;35;279
2013;"BEBERIBE (CE)";"CE";"BEBERIBE";226;63;64;353
2013;"BELA CRUZ (CE)";"CE";"BELA CRUZ";111;9;28;148
2013;"BOA VIAGEM (CE)";"CE";"BOA VIAGEM";449;20;57;526
2013;"BREJO SANTO (CE)";"CE";"BREJO SANTO";402;76;54;532
2013;"CAMOCIM (CE)";"CE";"CAMOCIM";214;46;34;294
2013;"CAMPOS SALES (CE)";"CE";"CAMPOS SALES";203;82;48;333
2013;"CANINDE (CE)";"CE";"CANINDE";568;28;76;672
2013;"CAPISTRANO (CE)";"CE";"CAPISTRANO";64;10;19;93
2013;"CARIDADE (CE)";"CE";"CARIDADE";72;8;15;95
2013;"CARIRE (CE)";"CE";"CARIRE";70;15;28;113
2013;"CARIRIACU (CE)";"CE";"CARIRIACU";62;41;8;111
2013;"CARIUS (CE)";"CE";"CARIUS";56;20;7;83
2013;"CARNAUBAL (CE)";"CE";"CARNAUBAL";77;25;10;112
2013;"CASCAVEL (CE)";"CE";"CASCAVEL";472;61;126;659
2013;"CATARINA (CE)";"CE";"CATARINA";41;4;2;47
2013;"CATUNDA (CE)";"CE";"CATUNDA";35;10;6;51
2013;"CAUCAIA (CE)";"CE";"CAUCAIA";1599;259;370;2228
2013;"CEDRO (CE)";"CE";"CEDRO";85;38;32;155
2013;"CHAVAL (CE)";"CE";"CHAVAL";29;13;7;49
2013;"CHORO (CE)";"CE";"CHORO";51;10;20;81
2013;"CHOROZINHO (CE)";"CE";"CHOROZINHO";136;16;36;188
2013;"COREAU (CE)";"CE";"COREAU";105;16;45;166
2013;"CRATEUS (CE)";"CE";"CRATEUS";347;81;80;508
2013;"CRATO (CE)";"CE";"CRATO";1019;163;110;1292
2013;"CROATA (CE)";"CE";"CROATA";60;22;14;96
2013;"CRUZ (CE)";"CE";"CRUZ";152;19;78;249
2013;"DEPUTADO IRAPUAN PINHEIRO (CE)";"CE";"DEPUTADO IRAPUAN PINHEIRO";22;6;12;40
2013;"ERERE (CE)";"CE";"ERERE";3;1;6;10
2013;"EUSEBIO (CE)";"CE";"EUSEBIO";1224;75;62;1361
2013;"FARIAS BRITO (CE)";"CE";"FARIAS BRITO";96;33;20;149
2013;"FORQUILHA (CE)";"CE";"FORQUILHA";114;31;42;187
2013;"FORTALEZA (CE)";"CE";"FORTALEZA";21479;3263;6563;31305
2013;"FORTIM (CE)";"CE";"FORTIM";32;30;18;80
2013;"FRECHEIRINHA (CE)";"CE";"FRECHEIRINHA";87;16;24;127
2013;"GENERAL SAMPAIO (CE)";"CE";"GENERAL SAMPAIO";34;2;7;43
2013;"GRACA (CE)";"CE";"GRACA";29;9;8;46
2013;"GRANJA (CE)";"CE";"GRANJA";185;55;30;270
2013;"GRANJEIRO (CE)";"CE";"GRANJEIRO";7;4;2;13
2013;"GROAIRAS (CE)";"CE";"GROAIRAS";62;25;27;114
2013;"GUAIUBA (CE)";"CE";"GUAIUBA";77;23;9;109
2013;"GUARACIABA DO NORTE (CE)";"CE";"GUARACIABA DO NORTE";423;16;19;458
2013;"GUARAMIRANGA (CE)";"CE";"GUARAMIRANGA";34;2;9;45
2013;"HIDROLANDIA (CE)";"CE";"HIDROLANDIA";140;18;15;173
2013;"HORIZONTE (CE)";"CE";"HORIZONTE";415;93;83;591
2013;"IBARETAMA (CE)";"CE";"IBARETAMA";66;6;21;93
2013;"IBIAPINA (CE)";"CE";"IBIAPINA";152;30;21;203
2013;"IBICUITINGA (CE)";"CE";"IBICUITINGA";77;8;12;97
2013;"ICAPUI (CE)";"CE";"ICAPUI";82;21;59;162
2013;"ICO (CE)";"CE";"ICO";337;71;72;480
2013;"IGUATU (CE)";"CE";"IGUATU";1011;75;116;1202
2013;"INDEPENDENCIA (CE)";"CE";"INDEPENDENCIA";217;3;19;239
2013;"IPAPORANGA (CE)";"CE";"IPAPORANGA";23;3;5;31
2013;"IPAUMIRIM (CE)";"CE";"IPAUMIRIM";263;66;37;366
2013;"IPU (CE)";"CE";"IPU";260;31;28;319
2013;"IPUEIRAS (CE)";"CE";"IPUEIRAS";90;34;9;133
2013;"IRACEMA (CE)";"CE";"IRACEMA";58;13;13;84
2013;"IRAUCUBA (CE)";"CE";"IRAUCUBA";101;16;26;143
2013;"ITAICABA (CE)";"CE";"ITAICABA";33;7;14;54
2013;"ITAITINGA (CE)";"CE";"ITAITINGA";376;63;25;464
2013;"ITAPAJE (CE)";"CE";"ITAPAJE";303;29;35;367
2013;"ITAPIPOCA (CE)";"CE";"ITAPIPOCA";861;31;70;962
2013;"ITAPIUNA (CE)";"CE";"ITAPIUNA";66;8;26;100
2013;"ITAREMA (CE)";"CE";"ITAREMA";116;11;35;162
2013;"ITATIRA (CE)";"CE";"ITATIRA";123;6;15;144
2013;"JAGUARETAMA (CE)";"CE";"JAGUARETAMA";105;7;19;131
2013;"JAGUARIBARA (CE)";"CE";"JAGUARIBARA";78;13;11;102
2013;"JAGUARIBE (CE)";"CE";"JAGUARIBE";394;39;32;465
2013;"JAGUARUANA (CE)";"CE";"JAGUARUANA";269;20;17;306
2013;"JARDIM (CE)";"CE";"JARDIM";108;63;15;186
2013;"JATI (CE)";"CE";"JATI";26;35;9;70
2013;"JIJOCA DE JERICOACOARA (CE)";"CE";"JIJOCA DE JERICOACOARA";81;13;19;113
2013;"JUAZEIRO DO NORTE (CE)";"CE";"JUAZEIRO DO NORTE";1810;182;232;2224
2013;"JUCAS (CE)";"CE";"JUCAS";112;5;24;141
2013;"LAVRAS DA MANGABEIRA (CE)";"CE";"LAVRAS DA MANGABEIRA";100;22;25;147
2013;"LIMOEIRO DO NORTE (CE)";"CE";"LIMOEIRO DO NORTE";702;35;122;859
2013;"MADALENA (CE)";"CE";"MADALENA";102;5;17;124
2013;"MARACANAU (CE)";"CE";"MARACANAU";1704;234;367;2305
2013;"MARANGUAPE (CE)";"CE";"MARANGUAPE";592;133;251;976
2013;"MARCO (CE)";"CE";"MARCO";258;18;18;294
2013;"MARTINOPOLE (CE)";"CE";"MARTINOPOLE";33;13;2;48
2013;"MASSAPE (CE)";"CE";"MASSAPE";98;32;90;220
2013;"MAURITI (CE)";"CE";"MAURITI";133;61;46;240
2013;"MERUOCA (CE)";"CE";"MERUOCA";37;14;16;67
2013;"MILAGRES (CE)";"CE";"MILAGRES";87;47;23;157
2013;"MILHA (CE)";"CE";"MILHA";85;5;16;106
2013;"MIRAIMA (CE)";"CE";"MIRAIMA";26;1;13;40
2013;"MISSAO VELHA (CE)";"CE";"MISSAO VELHA";217;69;11;297
2013;"MOMBACA (CE)";"CE";"MOMBACA";246;18;17;281
2013;"MONSENHOR TABOSA (CE)";"CE";"MONSENHOR TABOSA";79;8;3;90
2013;"MORADA NOVA (CE)";"CE";"MORADA NOVA";485;56;95;636
2013;"MORAUJO (CE)";"CE";"MORAUJO";23;4;8;35
2013;"MORRINHOS (CE)";"CE";"MORRINHOS";76;15;25;116
2013;"MUCAMBO (CE)";"CE";"MUCAMBO";34;19;14;67
2013;"MULUNGU (CE)";"CE";"MULUNGU";67;8;10;85
2013;"NOVA OLINDA (CE)";"CE";"NOVA OLINDA";105;34;12;151
2013;"NOVA RUSSAS (CE)";"CE";"NOVA RUSSAS";204;17;9;230
2013;"NOVO ORIENTE (CE)";"CE";"NOVO ORIENTE";69;34;18;121
2013;"OCARA (CE)";"CE";"OCARA";134;14;45;193
2013;"OROS (CE)";"CE";"OROS";137;29;29;195
2013;"PACAJUS (CE)";"CE";"PACAJUS";650;92;183;925
2013;"PACATUBA (CE)";"CE";"PACATUBA";195;70;21;286
2013;"PACOTI (CE)";"CE";"PACOTI";105;4;13;122
2013;"PACUJA (CE)";"CE";"PACUJA";28;5;7;40
2013;"PALHANO (CE)";"CE";"PALHANO";60;15;13;88
2013;"PALMACIA (CE)";"CE";"PALMACIA";40;11;17;68
2013;"PARACURU (CE)";"CE";"PARACURU";201;27;36;264
2013;"PARAIPABA (CE)";"CE";"PARAIPABA";229;14;26;269
2013;"PARAMBU (CE)";"CE";"PARAMBU";223;6;17;246
2013;"PARAMOTI (CE)";"CE";"PARAMOTI";58;5;15;78
2013;"PEDRA BRANCA (CE)";"CE";"PEDRA BRANCA";305;24;38;367
2013;"PENAFORTE (CE)";"CE";"PENAFORTE";37;45;22;104
2013;"PENTECOSTE (CE)";"CE";"PENTECOSTE";262;14;22;298
2013;"PEREIRO (CE)";"CE";"PEREIRO";93;13;27;133
2013;"PINDORETAMA (CE)";"CE";"PINDORETAMA";161;23;16;200
2013;"PIQUET CARNEIRO (CE)";"CE";"PIQUET CARNEIRO";49;6;13;68
2013;"PIRES FERREIRA (CE)";"CE";"PIRES FERREIRA";16;5;3;24
2013;"PORANGA (CE)";"CE";"PORANGA";23;11;6;40
2013;"PORTEIRAS (CE)";"CE";"PORTEIRAS";29;190;26;245
2013;"POTENGI (CE)";"CE";"POTENGI";30;6;7;43
2013;"POTIRETAMA (CE)";"CE";"POTIRETAMA";40;4;6;50
2013;"QUITERIANOPOLIS (CE)";"CE";"QUITERIANOPOLIS";62;12;8;82
2013;"QUIXADA (CE)";"CE";"QUIXADA";720;61;111;892
2013;"QUIXELO (CE)";"CE";"QUIXELO";65;19;35;119
2013;"QUIXERAMOBIM (CE)";"CE";"QUIXERAMOBIM";481;35;104;620
2013;"QUIXERE (CE)";"CE";"QUIXERE";213;14;48;275
2013;"REDENCAO (CE)";"CE";"REDENCAO";222;38;45;305
2013;"RERIUTABA (CE)";"CE";"RERIUTABA";89;20;22;131
2013;"RUSSAS (CE)";"CE";"RUSSAS";842;44;117;1003
2013;"SABOEIRO (CE)";"CE";"SABOEIRO";44;8;10;62
2013;"SALITRE (CE)";"CE";"SALITRE";77;13;30;120
2013;"SANTA QUITERIA (CE)";"CE";"SANTA QUITERIA";304;36;18;358
2013;"SANTANA DO ACARAU (CE)";"CE";"SANTANA DO ACARAU";152;51;45;248
2013;"SANTANA DO CARIRI (CE)";"CE";"SANTANA DO CARIRI";74;33;14;121
2013;"SAO BENEDITO (CE)";"CE";"SAO BENEDITO";435;95;60;590
2013;"SAO GONCALO DO AMARANTE (CE)";"CE";"SAO GONCALO DO AMARANTE";357;75;157;589
2013;"SAO JOAO DO JAGUARIBE (CE)";"CE";"SAO JOAO DO JAGUARIBE";48;3;10;61
2013;"SAO LUIS DO CURU (CE)";"CE";"SAO LUIS DO CURU";59;4;9;72
2013;"SENADOR POMPEU (CE)";"CE";"SENADOR POMPEU";156;19;52;227
2013;"SENADOR SA (CE)";"CE";"SENADOR SA";25;4;15;44
2013;"SOBRAL (CE)";"CE";"SOBRAL";1558;239;403;2200
2013;"SOLONOPOLE (CE)";"CE";"SOLONOPOLE";95;13;17;125
2013;"TABULEIRO DO NORTE (CE)";"CE";"TABULEIRO DO NORTE";361;37;47;445
2013;"TAMBORIL (CE)";"CE";"TAMBORIL";108;19;24;151
2013;"TARRAFAS (CE)";"CE";"TARRAFAS";17;5;6;28
2013;"TAUA (CE)";"CE";"TAUA";438;49;40;527
2013;"TEJUCUOCA (CE)";"CE";"TEJUCUOCA";87;7;13;107
2013;"TIANGUA (CE)";"CE";"TIANGUA";1393;181;162;1736
2013;"TRAIRI (CE)";"CE";"TRAIRI";210;25;46;281
2013;"TURURU (CE)";"CE";"TURURU";56;7;8;71
2013;"UBAJARA (CE)";"CE";"UBAJARA";284;24;57;365
2013;"UMARI (CE)";"CE";"UMARI";9;4;5;18
2013;"UMIRIM (CE)";"CE";"UMIRIM";51;37;28;116
2013;"URUBURETAMA (CE)";"CE";"URUBURETAMA";75;11;37;123
2013;"URUOCA (CE)";"CE";"URUOCA";59;8;21;88
2013;"VARJOTA (CE)";"CE";"VARJOTA";130;31;10;171
2013;"VARZEA ALEGRE (CE)";"CE";"VARZEA ALEGRE";250;44;50;344
2013;"VICOSA DO CEARA (CE)";"CE";"VICOSA DO CEARA";353;42;75;470
2013;"BRASILIA (DF)";"DF";"BRASILIA";21801;4924;10755;37480
2013;"AFONSO CLAUDIO (ES)";"ES";"AFONSO CLAUDIO";592;95;108;795
2013;"AGUA DOCE DO NORTE (ES)";"ES";"AGUA DOCE DO NORTE";116;27;29;172
2013;"AGUIA BRANCA (ES)";"ES";"AGUIA BRANCA";163;6;22;191
2013;"ALEGRE (ES)";"ES";"ALEGRE";239;42;29;310
2013;"ALFREDO CHAVES (ES)";"ES";"ALFREDO CHAVES";441;30;35;506
2013;"ALTO RIO NOVO (ES)";"ES";"ALTO RIO NOVO";115;25;25;165
2013;"ANCHIETA (ES)";"ES";"ANCHIETA";309;76;52;437
2013;"APIACA (ES)";"ES";"APIACA";113;22;7;142
2013;"ARACRUZ (ES)";"ES";"ARACRUZ";1343;223;531;2097
2013;"ATILIO VIVACQUA (ES)";"ES";"ATILIO VIVACQUA";209;14;21;244
2013;"BAIXO GUANDU (ES)";"ES";"BAIXO GUANDU";544;50;96;690
2013;"BARRA DE SAO FRANCISCO (ES)";"ES";"BARRA DE SAO FRANCISCO";547;40;131;718
2013;"BOA ESPERANCA (ES)";"ES";"BOA ESPERANCA";246;20;46;312
2013;"BOM JESUS DO NORTE (ES)";"ES";"BOM JESUS DO NORTE";205;32;27;264
2013;"BREJETUBA (ES)";"ES";"BREJETUBA";229;21;56;306
2013;"CACHOEIRO DE ITAPEMIRIM (ES)";"ES";"CACHOEIRO DE ITAPEMIRIM";4887;222;1949;7058
2013;"CARIACICA (ES)";"ES";"CARIACICA";5496;600;1479;7575
2013;"CASTELO (ES)";"ES";"CASTELO";1259;90;82;1431
2013;"COLATINA (ES)";"ES";"COLATINA";2514;171;520;3205
2013;"CONCEICAO DA BARRA (ES)";"ES";"CONCEICAO DA BARRA";235;19;119;373
2013;"CONCEICAO DO CASTELO (ES)";"ES";"CONCEICAO DO CASTELO";287;57;55;399
2013;"DIVINO DE SAO LOURENCO (ES)";"ES";"DIVINO DE SAO LOURENCO";67;10;9;86
2013;"DOMINGOS MARTINS (ES)";"ES";"DOMINGOS MARTINS";1142;113;76;1331
2013;"DORES DO RIO PRETO (ES)";"ES";"DORES DO RIO PRETO";144;27;15;186
2013;"ECOPORANGA (ES)";"ES";"ECOPORANGA";173;44;84;301
2013;"FUNDAO (ES)";"ES";"FUNDAO";347;54;44;445
2013;"GOVERNADOR LINDENBERG (ES)";"ES";"GOVERNADOR LINDENBERG";293;6;6;305
2013;"GUACUI (ES)";"ES";"GUACUI";504;47;43;594
2013;"GUARAPARI (ES)";"ES";"GUARAPARI";1189;324;253;1766
2013;"IBATIBA (ES)";"ES";"IBATIBA";493;52;69;614
2013;"IBIRACU (ES)";"ES";"IBIRACU";382;36;58;476
2013;"IBITIRAMA (ES)";"ES";"IBITIRAMA";139;31;19;189
2013;"ICONHA (ES)";"ES";"ICONHA";704;23;65;792
2013;"IRUPI (ES)";"ES";"IRUPI";228;40;30;298
2013;"ITAGUACU (ES)";"ES";"ITAGUACU";283;12;62;357
2013;"ITAPEMIRIM (ES)";"ES";"ITAPEMIRIM";529;44;71;644
2013;"ITARANA (ES)";"ES";"ITARANA";367;37;41;445
2013;"IUNA (ES)";"ES";"IUNA";445;69;81;595
2013;"JAGUARE (ES)";"ES";"JAGUARE";473;26;95;594
2013;"JERONIMO MONTEIRO (ES)";"ES";"JERONIMO MONTEIRO";107;22;17;146
2013;"JOAO NEIVA (ES)";"ES";"JOAO NEIVA";334;29;34;397
2013;"LARANJA DA TERRA (ES)";"ES";"LARANJA DA TERRA";297;21;30;348
2013;"LINHARES (ES)";"ES";"LINHARES";2890;180;501;3571
2013;"MANTENOPOLIS (ES)";"ES";"MANTENOPOLIS";169;28;29;226
2013;"MARATAIZES (ES)";"ES";"MARATAIZES";932;48;68;1048
2013;"MARECHAL FLORIANO (ES)";"ES";"MARECHAL FLORIANO";682;52;34;768
2013;"MARILANDIA (ES)";"ES";"MARILANDIA";410;28;23;461
2013;"MIMOSO DO SUL (ES)";"ES";"MIMOSO DO SUL";304;53;74;431
2013;"MONTANHA (ES)";"ES";"MONTANHA";207;12;47;266
2013;"MUCURICI (ES)";"ES";"MUCURICI";60;10;21;91
2013;"MUNIZ FREIRE (ES)";"ES";"MUNIZ FREIRE";226;47;45;318
2013;"MUQUI (ES)";"ES";"MUQUI";190;19;27;236
2013;"NOVA VENECIA (ES)";"ES";"NOVA VENECIA";942;45;189;1176
2013;"PANCAS (ES)";"ES";"PANCAS";304;31;16;351
2013;"PEDRO CANARIO (ES)";"ES";"PEDRO CANARIO";459;47;248;754
2013;"PINHEIROS (ES)";"ES";"PINHEIROS";309;25;133;467
2013;"PIUMA (ES)";"ES";"PIUMA";247;34;15;296
2013;"PONTO BELO (ES)";"ES";"PONTO BELO";60;10;16;86
2013;"PRESIDENTE KENNEDY (ES)";"ES";"PRESIDENTE KENNEDY";301;17;22;340
2013;"RIO BANANAL (ES)";"ES";"RIO BANANAL";610;23;58;691
2013;"RIO NOVO DO SUL (ES)";"ES";"RIO NOVO DO SUL";349;18;30;397
2013;"SANTA LEOPOLDINA (ES)";"ES";"SANTA LEOPOLDINA";418;43;30;491
2013;"SANTA MARIA DE JETIBA (ES)";"ES";"SANTA MARIA DE JETIBA";2206;99;78;2383
2013;"SANTA TERESA (ES)";"ES";"SANTA TERESA";703;44;113;860
2013;"SAO DOMINGOS DO NORTE (ES)";"ES";"SAO DOMINGOS DO NORTE";233;14;28;275
2013;"SAO GABRIEL DA PALHA (ES)";"ES";"SAO GABRIEL DA PALHA";704;27;108;839
2013;"SAO JOSE DO CALCADO (ES)";"ES";"SAO JOSE DO CALCADO";89;19;17;125
2013;"SAO MATEUS (ES)";"ES";"SAO MATEUS";1118;117;371;1606
2013;"SAO ROQUE DO CANAA (ES)";"ES";"SAO ROQUE DO CANAA";311;19;26;356
2013;"SERRA (ES)";"ES";"SERRA";8742;647;2090;11479
2013;"SOORETAMA (ES)";"ES";"SOORETAMA";335;20;56;411
2013;"VARGEM ALTA (ES)";"ES";"VARGEM ALTA";483;25;57;565
2013;"VENDA NOVA DO IMIGRANTE (ES)";"ES";"VENDA NOVA DO IMIGRANTE";812;30;118;960
2013;"VIANA (ES)";"ES";"VIANA";1246;97;365;1708
2013;"VILA PAVAO (ES)";"ES";"VILA PAVAO";156;6;25;187
2013;"VILA VALERIO (ES)";"ES";"VILA VALERIO";379;15;57;451
2013;"VILA VELHA (ES)";"ES";"VILA VELHA";4440;861;828;6129
2013;"VITORIA (ES)";"ES";"VITORIA";3994;1116;971;6081
2013;"ABADIA DE GOIAS (GO)";"GO";"ABADIA DE GOIAS";89;7;7;103
2013;"ABADIANIA (GO)";"GO";"ABADIANIA";301;31;24;356
2013;"ACREUNA (GO)";"GO";"ACREUNA";406;13;97;516
2013;"ADELANDIA (GO)";"GO";"ADELANDIA";33;1;5;39
2013;"AGUA FRIA DE GOIAS (GO)";"GO";"AGUA FRIA DE GOIAS";39;8;18;65
2013;"AGUA LIMPA (GO)";"GO";"AGUA LIMPA";17;6;2;25
2013;"AGUAS LINDAS DE GOIAS (GO)";"GO";"AGUAS LINDAS DE GOIAS";959;140;549;1648
2013;"ALEXANIA (GO)";"GO";"ALEXANIA";393;44;34;471
2013;"ALOANDIA (GO)";"GO";"ALOANDIA";25;3;3;31
2013;"ALTO HORIZONTE (GO)";"GO";"ALTO HORIZONTE";47;7;20;74
2013;"ALTO PARAISO DE GOIAS (GO)";"GO";"ALTO PARAISO DE GOIAS";59;10;12;81
2013;"ALVORADA DO NORTE (GO)";"GO";"ALVORADA DO NORTE";135;6;15;156
2013;"AMARALINA (GO)";"GO";"AMARALINA";14;2;7;23
2013;"AMERICANO DO BRASIL (GO)";"GO";"AMERICANO DO BRASIL";62;8;15;85
2013;"AMORINOPOLIS (GO)";"GO";"AMORINOPOLIS";40;5;9;54
2013;"ANAPOLIS (GO)";"GO";"ANAPOLIS";10179;315;1656;12150
2013;"ANHANGUERA (GO)";"GO";"ANHANGUERA";4;2;1;7
2013;"ANICUNS (GO)";"GO";"ANICUNS";392;21;113;526
2013;"APARECIDA DE GOIANIA (GO)";"GO";"APARECIDA DE GOIANIA";6734;325;582;7641
2013;"APARECIDA DO RIO DOCE (GO)";"GO";"APARECIDA DO RIO DOCE";45;4;10;59
2013;"APORE (GO)";"GO";"APORE";64;15;26;105
2013;"ARACU (GO)";"GO";"ARACU";29;6;8;43
2013;"ARAGARCAS (GO)";"GO";"ARAGARCAS";503;12;26;541
2013;"ARAGOIANIA (GO)";"GO";"ARAGOIANIA";86;1;7;94
2013;"ARAGUAPAZ (GO)";"GO";"ARAGUAPAZ";92;10;14;116
2013;"ARENOPOLIS (GO)";"GO";"ARENOPOLIS";18;7;7;32
2013;"ARUANA (GO)";"GO";"ARUANA";52;1;19;72
2013;"AURILANDIA (GO)";"GO";"AURILANDIA";27;5;3;35
2013;"AVELINOPOLIS (GO)";"GO";"AVELINOPOLIS";52;4;2;58
2013;"BALIZA (GO)";"GO";"BALIZA";8;0;5;13
2013;"BARRO ALTO (GO)";"GO";"BARRO ALTO";152;24;73;249
2013;"BELA VISTA DE GOIAS (GO)";"GO";"BELA VISTA DE GOIAS";406;19;42;467
2013;"BOM JARDIM DE GOIAS (GO)";"GO";"BOM JARDIM DE GOIAS";127;9;32;168
2013;"BOM JESUS (GO)";"GO";"BOM JESUS";369;46;95;510
2013;"BONFINOPOLIS (GO)";"GO";"BONFINOPOLIS";63;4;11;78
2013;"BONOPOLIS (GO)";"GO";"BONOPOLIS";17;5;6;28
2013;"BRAZABRANTES (GO)";"GO";"BRAZABRANTES";64;3;2;69
2013;"BRITANIA (GO)";"GO";"BRITANIA";88;4;8;100
2013;"BURITI ALEGRE (GO)";"GO";"BURITI ALEGRE";209;36;16;261
2013;"BURITI DE GOIAS (GO)";"GO";"BURITI DE GOIAS";19;10;2;31
2013;"BURITINOPOLIS (GO)";"GO";"BURITINOPOLIS";17;3;7;27
2013;"CABECEIRAS (GO)";"GO";"CABECEIRAS";159;10;25;194
2013;"CACHOEIRA ALTA (GO)";"GO";"CACHOEIRA ALTA";142;20;36;198
2013;"CACHOEIRA DE GOIAS (GO)";"GO";"CACHOEIRA DE GOIAS";7;2;2;11
2013;"CACHOEIRA DOURADA (GO)";"GO";"CACHOEIRA DOURADA";106;11;35;152
2013;"CACU (GO)";"GO";"CACU";266;18;32;316
2013;"CAIAPONIA (GO)";"GO";"CAIAPONIA";190;6;10;206
2013;"CALDAS NOVAS (GO)";"GO";"CALDAS NOVAS";737;121;111;969
2013;"CALDAZINHA (GO)";"GO";"CALDAZINHA";33;2;2;37
2013;"CAMPESTRE DE GOIAS (GO)";"GO";"CAMPESTRE DE GOIAS";41;2;6;49
2013;"CAMPINACU (GO)";"GO";"CAMPINACU";28;2;8;38
2013;"CAMPINORTE (GO)";"GO";"CAMPINORTE";173;17;16;206
2013;"CAMPO ALEGRE DE GOIAS (GO)";"GO";"CAMPO ALEGRE DE GOIAS";138;12;25;175
2013;"CAMPO LIMPO DE GOIAS (GO)";"GO";"CAMPO LIMPO DE GOIAS";141;0;5;146
2013;"CAMPOS BELOS (GO)";"GO";"CAMPOS BELOS";232;17;48;297
2013;"CAMPOS VERDES (GO)";"GO";"CAMPOS VERDES";38;6;1;45
2013;"CARMO DO RIO VERDE (GO)";"GO";"CARMO DO RIO VERDE";86;10;59;155
2013;"CASTELANDIA (GO)";"GO";"CASTELANDIA";62;6;8;76
2013;"CATALAO (GO)";"GO";"CATALAO";1796;190;303;2289
2013;"CATURAI (GO)";"GO";"CATURAI";48;2;7;57
2013;"CAVALCANTE (GO)";"GO";"CAVALCANTE";35;3;5;43
2013;"CERES (GO)";"GO";"CERES";496;25;44;565
2013;"CEZARINA (GO)";"GO";"CEZARINA";129;7;20;156
2013;"CHAPADAO DO CEU (GO)";"GO";"CHAPADAO DO CEU";271;20;23;314
2013;"CIDADE OCIDENTAL (GO)";"GO";"CIDADE OCIDENTAL";131;52;65;248
2013;"COCALZINHO DE GOIAS (GO)";"GO";"COCALZINHO DE GOIAS";168;24;24;216
2013;"COLINAS DO SUL (GO)";"GO";"COLINAS DO SUL";12;2;2;16
2013;"CORREGO DO OURO (GO)";"GO";"CORREGO DO OURO";16;2;3;21
2013;"CORUMBA DE GOIAS (GO)";"GO";"CORUMBA DE GOIAS";74;16;23;113
2013;"CORUMBAIBA (GO)";"GO";"CORUMBAIBA";159;24;10;193
2013;"CRISTALINA (GO)";"GO";"CRISTALINA";1871;111;441;2423
2013;"CRISTIANOPOLIS (GO)";"GO";"CRISTIANOPOLIS";54;10;2;66
2013;"CRIXAS (GO)";"GO";"CRIXAS";148;20;20;188
2013;"CROMINIA (GO)";"GO";"CROMINIA";44;3;2;49
2013;"CUMARI (GO)";"GO";"CUMARI";30;8;0;38
2013;"DAMIANOPOLIS (GO)";"GO";"DAMIANOPOLIS";18;2;10;30
2013;"DAMOLANDIA (GO)";"GO";"DAMOLANDIA";43;6;4;53
2013;"DAVINOPOLIS (GO)";"GO";"DAVINOPOLIS";29;5;3;37
2013;"DIORAMA (GO)";"GO";"DIORAMA";10;7;6;23
2013;"DIVINOPOLIS DE GOIAS (GO)";"GO";"DIVINOPOLIS DE GOIAS";26;2;9;37
2013;"DOVERLANDIA (GO)";"GO";"DOVERLANDIA";114;6;35;155
2013;"EDEALINA (GO)";"GO";"EDEALINA";65;12;9;86
2013;"EDEIA (GO)";"GO";"EDEIA";183;10;19;212
2013;"ESTRELA DO NORTE (GO)";"GO";"ESTRELA DO NORTE";32;3;2;37
2013;"FAINA (GO)";"GO";"FAINA";50;17;6;73
2013;"FAZENDA NOVA (GO)";"GO";"FAZENDA NOVA";49;3;9;61
2013;"FIRMINOPOLIS (GO)";"GO";"FIRMINOPOLIS";96;5;6;107
2013;"FLORES DE GOIAS (GO)";"GO";"FLORES DE GOIAS";38;4;8;50
2013;"FORMOSA (GO)";"GO";"FORMOSA";3183;175;644;4002
2013;"FORMOSO (GO)";"GO";"FORMOSO";37;6;8;51
2013;"GAMELEIRA DE GOIAS (GO)";"GO";"GAMELEIRA DE GOIAS";30;6;14;50
2013;"GOIANAPOLIS (GO)";"GO";"GOIANAPOLIS";221;14;14;249
2013;"GOIANDIRA (GO)";"GO";"GOIANDIRA";47;7;5;59
2013;"GOIANESIA (GO)";"GO";"GOIANESIA";967;79;265;1311
2013;"GOIANIA (GO)";"GO";"GOIANIA";25401;1955;6450;33806
2013;"GOIANIRA (GO)";"GO";"GOIANIRA";317;12;70;399
2013;"GOIAS (GO)";"GO";"GOIAS";227;19;43;289
2013;"GOIATUBA (GO)";"GO";"GOIATUBA";739;44;128;911
2013;"GOUVELANDIA (GO)";"GO";"GOUVELANDIA";61;9;7;77
2013;"GUAPO (GO)";"GO";"GUAPO";205;25;31;261
2013;"GUARAITA (GO)";"GO";"GUARAITA";17;2;2;21
2013;"GUARANI DE GOIAS (GO)";"GO";"GUARANI DE GOIAS";15;4;10;29
2013;"GUARINOS (GO)";"GO";"GUARINOS";9;5;3;17
2013;"HEITORAI (GO)";"GO";"HEITORAI";29;3;5;37
2013;"HIDROLANDIA (GO)";"GO";"HIDROLANDIA";672;26;38;736
2013;"HIDROLINA (GO)";"GO";"HIDROLINA";18;0;1;19
2013;"IACIARA (GO)";"GO";"IACIARA";117;8;23;148
2013;"INACIOLANDIA (GO)";"GO";"INACIOLANDIA";49;7;11;67
2013;"INDIARA (GO)";"GO";"INDIARA";234;13;29;276
2013;"INHUMAS (GO)";"GO";"INHUMAS";1086;61;156;1303
2013;"IPAMERI (GO)";"GO";"IPAMERI";338;72;84;494
2013;"IPIRANGA DE GOIAS (GO)";"GO";"IPIRANGA DE GOIAS";26;8;6;40
2013;"IPORA (GO)";"GO";"IPORA";482;39;53;574
2013;"ISRAELANDIA (GO)";"GO";"ISRAELANDIA";25;2;6;33
2013;"ITABERAI (GO)";"GO";"ITABERAI";733;37;79;849
2013;"ITAGUARI (GO)";"GO";"ITAGUARI";61;8;11;80
2013;"ITAGUARU (GO)";"GO";"ITAGUARU";76;8;12;96
2013;"ITAJA (GO)";"GO";"ITAJA";75;10;19;104
2013;"ITAPACI (GO)";"GO";"ITAPACI";185;24;82;291
2013;"ITAPIRAPUA (GO)";"GO";"ITAPIRAPUA";55;5;12;72
2013;"ITAPURANGA (GO)";"GO";"ITAPURANGA";371;24;71;466
2013;"ITARUMA (GO)";"GO";"ITARUMA";89;17;14;120
2013;"ITAUCU (GO)";"GO";"ITAUCU";116;8;10;134
2013;"ITUMBIARA (GO)";"GO";"ITUMBIARA";2039;207;438;2684
2013;"IVOLANDIA (GO)";"GO";"IVOLANDIA";7;4;1;12
2013;"JANDAIA (GO)";"GO";"JANDAIA";103;6;15;124
2013;"JARAGUA (GO)";"GO";"JARAGUA";406;38;40;484
2013;"JATAI (GO)";"GO";"JATAI";2180;127;220;2527
2013;"JAUPACI (GO)";"GO";"JAUPACI";27;5;7;39
2013;"JESUPOLIS (GO)";"GO";"JESUPOLIS";17;2;7;26
2013;"JOVIANIA (GO)";"GO";"JOVIANIA";129;15;23;167
2013;"JUSSARA (GO)";"GO";"JUSSARA";392;18;20;430
2013;"LAGOA SANTA (GO)";"GO";"LAGOA SANTA";11;3;6;20
2013;"LEOPOLDO DE BULHOES (GO)";"GO";"LEOPOLDO DE BULHOES";139;15;7;161
2013;"LUZIANIA (GO)";"GO";"LUZIANIA";2265;183;441;2889
2013;"MAIRIPOTABA (GO)";"GO";"MAIRIPOTABA";23;4;4;31
2013;"MAMBAI (GO)";"GO";"MAMBAI";69;4;17;90
2013;"MARA ROSA (GO)";"GO";"MARA ROSA";131;8;16;155
2013;"MARZAGAO (GO)";"GO";"MARZAGAO";28;2;3;33
2013;"MATRINCHA (GO)";"GO";"MATRINCHA";36;4;6;46
2013;"MAURILANDIA (GO)";"GO";"MAURILANDIA";382;19;111;512
2013;"MIMOSO DE GOIAS (GO)";"GO";"MIMOSO DE GOIAS";9;4;4;17
2013;"MINACU (GO)";"GO";"MINACU";453;50;42;545
2013;"MINEIROS (GO)";"GO";"MINEIROS";1254;92;161;1507
2013;"MOIPORA (GO)";"GO";"MOIPORA";6;0;2;8
2013;"MONTE ALEGRE DE GOIAS (GO)";"GO";"MONTE ALEGRE DE GOIAS";23;3;5;31
2013;"MONTES CLAROS DE GOIAS (GO)";"GO";"MONTES CLAROS DE GOIAS";80;15;26;121
2013;"MONTIVIDIU (GO)";"GO";"MONTIVIDIU";353;23;67;443
2013;"MONTIVIDIU DO NORTE (GO)";"GO";"MONTIVIDIU DO NORTE";21;1;19;41
2013;"MORRINHOS (GO)";"GO";"MORRINHOS";765;49;119;933
2013;"MORRO AGUDO DE GOIAS (GO)";"GO";"MORRO AGUDO DE GOIAS";23;5;3;31
2013;"MOSSAMEDES (GO)";"GO";"MOSSAMEDES";36;9;4;49
2013;"MOZARLANDIA (GO)";"GO";"MOZARLANDIA";134;15;35;184
2013;"MUNDO NOVO (GO)";"GO";"MUNDO NOVO";30;6;19;55
2013;"MUTUNOPOLIS (GO)";"GO";"MUTUNOPOLIS";25;3;13;41
2013;"NAZARIO (GO)";"GO";"NAZARIO";98;11;10;119
2013;"NEROPOLIS (GO)";"GO";"NEROPOLIS";540;19;29;588
2013;"NIQUELANDIA (GO)";"GO";"NIQUELANDIA";588;72;148;808
2013;"NOVA AMERICA (GO)";"GO";"NOVA AMERICA";20;1;2;23
2013;"NOVA AURORA (GO)";"GO";"NOVA AURORA";36;5;4;45
2013;"NOVA CRIXAS (GO)";"GO";"NOVA CRIXAS";80;10;37;127
2013;"NOVA GLORIA (GO)";"GO";"NOVA GLORIA";74;5;24;103
2013;"NOVA IGUACU DE GOIAS (GO)";"GO";"NOVA IGUACU DE GOIAS";22;7;5;34
2013;"NOVA ROMA (GO)";"GO";"NOVA ROMA";4;3;5;12
2013;"NOVA VENEZA (GO)";"GO";"NOVA VENEZA";152;10;14;176
2013;"NOVO BRASIL (GO)";"GO";"NOVO BRASIL";24;6;1;31
2013;"NOVO GAMA (GO)";"GO";"NOVO GAMA";359;86;110;555
2013;"NOVO PLANALTO (GO)";"GO";"NOVO PLANALTO";34;9;3;46
2013;"ORIZONA (GO)";"GO";"ORIZONA";204;42;39;285
2013;"OURO VERDE DE GOIAS (GO)";"GO";"OURO VERDE DE GOIAS";97;0;10;107
2013;"OUVIDOR (GO)";"GO";"OUVIDOR";90;6;15;111
2013;"PADRE BERNARDO (GO)";"GO";"PADRE BERNARDO";468;30;92;590
2013;"PALESTINA DE GOIAS (GO)";"GO";"PALESTINA DE GOIAS";22;18;9;49
2013;"PALMEIRAS DE GOIAS (GO)";"GO";"PALMEIRAS DE GOIAS";352;15;103;470
2013;"PALMELO (GO)";"GO";"PALMELO";20;2;5;27
2013;"PALMINOPOLIS (GO)";"GO";"PALMINOPOLIS";44;2;5;51
2013;"PANAMA (GO)";"GO";"PANAMA";53;11;10;74
2013;"PARANAIGUARA (GO)";"GO";"PARANAIGUARA";99;13;14;126
2013;"PARAUNA (GO)";"GO";"PARAUNA";160;21;46;227
2013;"PEROLANDIA (GO)";"GO";"PEROLANDIA";54;8;7;69
2013;"PETROLINA DE GOIAS (GO)";"GO";"PETROLINA DE GOIAS";153;5;20;178
2013;"PILAR DE GOIAS (GO)";"GO";"PILAR DE GOIAS";20;8;7;35
2013;"PIRACANJUBA (GO)";"GO";"PIRACANJUBA";419;28;32;479
2013;"PIRANHAS (GO)";"GO";"PIRANHAS";185;7;38;230
2013;"PIRENOPOLIS (GO)";"GO";"PIRENOPOLIS";272;50;36;358
2013;"PIRES DO RIO (GO)";"GO";"PIRES DO RIO";533;38;37;608
2013;"PLANALTINA (GO)";"GO";"PLANALTINA";545;55;384;984
2013;"PONTALINA (GO)";"GO";"PONTALINA";272;19;33;324
2013;"PORANGATU (GO)";"GO";"PORANGATU";642;46;72;760
2013;"PORTEIRAO (GO)";"GO";"PORTEIRAO";86;9;12;107
2013;"PORTELANDIA (GO)";"GO";"PORTELANDIA";42;30;4;76
2013;"POSSE (GO)";"GO";"POSSE";602;42;101;745
2013;"PROFESSOR JAMIL (GO)";"GO";"PROFESSOR JAMIL";35;4;5;44
2013;"QUIRINOPOLIS (GO)";"GO";"QUIRINOPOLIS";946;65;230;1241
2013;"RIALMA (GO)";"GO";"RIALMA";293;24;29;346
2013;"RIANAPOLIS (GO)";"GO";"RIANAPOLIS";73;5;6;84
2013;"RIO QUENTE (GO)";"GO";"RIO QUENTE";46;18;57;121
2013;"RIO VERDE (GO)";"GO";"RIO VERDE";3571;313;539;4423
2013;"RUBIATABA (GO)";"GO";"RUBIATABA";328;26;70;424
2013;"SANCLERLANDIA (GO)";"GO";"SANCLERLANDIA";110;10;9;129
2013;"SANTA BARBARA DE GOIAS (GO)";"GO";"SANTA BARBARA DE GOIAS";107;4;6;117
2013;"SANTA CRUZ DE GOIAS (GO)";"GO";"SANTA CRUZ DE GOIAS";7;2;4;13
2013;"SANTA FE DE GOIAS (GO)";"GO";"SANTA FE DE GOIAS";36;7;5;48
2013;"SANTA HELENA DE GOIAS (GO)";"GO";"SANTA HELENA DE GOIAS";912;50;223;1185
2013;"SANTA ISABEL (GO)";"GO";"SANTA ISABEL";9;8;5;22
2013;"SANTA RITA DO ARAGUAIA (GO)";"GO";"SANTA RITA DO ARAGUAIA";133;17;4;154
2013;"SANTA RITA DO NOVO DESTINO (GO)";"GO";"SANTA RITA DO NOVO DESTINO";25;9;9;43
2013;"SANTA ROSA DE GOIAS (GO)";"GO";"SANTA ROSA DE GOIAS";23;3;5;31
2013;"SANTA TEREZA DE GOIAS (GO)";"GO";"SANTA TEREZA DE GOIAS";38;3;5;46
2013;"SANTA TEREZINHA DE GOIAS (GO)";"GO";"SANTA TEREZINHA DE GOIAS";98;11;20;129
2013;"SANTO ANTONIO DA BARRA (GO)";"GO";"SANTO ANTONIO DA BARRA";42;12;18;72
2013;"SANTO ANTONIO DE GOIAS (GO)";"GO";"SANTO ANTONIO DE GOIAS";74;10;13;97
2013;"SANTO ANTONIO DO DESCOBERTO (GO)";"GO";"SANTO ANTONIO DO DESCOBERTO";313;41;202;556
2013;"SAO DOMINGOS (GO)";"GO";"SAO DOMINGOS";40;6;21;67
2013;"SAO FRANCISCO DE GOIAS (GO)";"GO";"SAO FRANCISCO DE GOIAS";47;7;8;62
2013;"SAO JOAO D ALIANCA (GO)";"GO";"SAO JOAO D ALIANCA";117;8;18;143
2013;"SAO JOAO DA PARAUNA (GO)";"GO";"SAO JOAO DA PARAUNA";22;1;2;25
2013;"SAO LUIS DE MONTES BELOS (GO)";"GO";"SAO LUIS DE MONTES BELOS";400;35;79;514
2013;"SAO LUIZ DO NORTE (GO)";"GO";"SAO LUIZ DO NORTE";46;7;17;70
2013;"SAO MIGUEL DO ARAGUAIA (GO)";"GO";"SAO MIGUEL DO ARAGUAIA";327;13;63;403
2013;"SAO MIGUEL DO PASSA QUATRO (GO)";"GO";"SAO MIGUEL DO PASSA QUATRO";49;3;4;56
2013;"SAO PATRICIO (GO)";"GO";"SAO PATRICIO";13;0;5;18
2013;"SAO SIMAO (GO)";"GO";"SAO SIMAO";221;34;62;317
2013;"SENADOR CANEDO (GO)";"GO";"SENADOR CANEDO";750;75;77;902
2013;"SERRANOPOLIS (GO)";"GO";"SERRANOPOLIS";104;12;22;138
2013;"SILVANIA (GO)";"GO";"SILVANIA";383;30;41;454
2013;"SIMOLANDIA (GO)";"GO";"SIMOLANDIA";116;3;8;127
2013;"SITIO D ABADIA (GO)";"GO";"SITIO D ABADIA";10;1;8;19
2013;"TAQUARAL DE GOIAS (GO)";"GO";"TAQUARAL DE GOIAS";26;6;6;38
2013;"TERESINA DE GOIAS (GO)";"GO";"TERESINA DE GOIAS";13;1;2;16
2013;"TEREZOPOLIS DE GOIAS (GO)";"GO";"TEREZOPOLIS DE GOIAS";91;2;19;112
2013;"TRES RANCHOS (GO)";"GO";"TRES RANCHOS";49;11;5;65
2013;"TRINDADE (GO)";"GO";"TRINDADE";1080;56;124;1260
2013;"TROMBAS (GO)";"GO";"TROMBAS";29;3;11;43
2013;"TURVANIA (GO)";"GO";"TURVANIA";66;3;8;77
2013;"TURVELANDIA (GO)";"GO";"TURVELANDIA";45;6;17;68
2013;"UIRAPURU (GO)";"GO";"UIRAPURU";17;9;7;33
2013;"URUACU (GO)";"GO";"URUACU";565;34;84;683
2013;"URUANA (GO)";"GO";"URUANA";269;5;10;284
2013;"URUTAI (GO)";"GO";"URUTAI";24;1;7;32
2013;"VALPARAISO DE GOIAS (GO)";"GO";"VALPARAISO DE GOIAS";625;195;203;1023
2013;"VARJAO (GO)";"GO";"VARJAO";43;0;5;48
2013;"VIANOPOLIS (GO)";"GO";"VIANOPOLIS";480;26;36;542
2013;"VICENTINOPOLIS (GO)";"GO";"VICENTINOPOLIS";181;13;50;244
2013;"VILA BOA (GO)";"GO";"VILA BOA";17;3;19;39
2013;"VILA PROPICIO (GO)";"GO";"VILA PROPICIO";16;11;16;43
2013;"ACAILANDIA (MA)";"MA";"ACAILANDIA";1225;121;183;1529
2013;"AFONSO CUNHA (MA)";"MA";"AFONSO CUNHA";4;2;3;9
2013;"AGUA DOCE DO MARANHAO (MA)";"MA";"AGUA DOCE DO MARANHAO";3;1;4;8
2013;"ALCANTARA (MA)";"MA";"ALCANTARA";47;13;17;77
2013;"ALDEIAS ALTAS (MA)";"MA";"ALDEIAS ALTAS";42;5;24;71
2013;"ALTAMIRA DO MARANHAO (MA)";"MA";"ALTAMIRA DO MARANHAO";19;3;2;24
2013;"ALTO ALEGRE DO MARANHAO (MA)";"MA";"ALTO ALEGRE DO MARANHAO";39;23;3;65
2013;"ALTO ALEGRE DO PINDARE (MA)";"MA";"ALTO ALEGRE DO PINDARE";38;10;3;51
2013;"ALTO PARNAIBA (MA)";"MA";"ALTO PARNAIBA";61;2;7;70
2013;"AMAPA DO MARANHAO (MA)";"MA";"AMAPA DO MARANHAO";11;2;2;15
2013;"AMARANTE DO MARANHAO (MA)";"MA";"AMARANTE DO MARANHAO";97;4;6;107
2013;"ANAJATUBA (MA)";"MA";"ANAJATUBA";33;3;7;43
2013;"ANAPURUS (MA)";"MA";"ANAPURUS";50;1;17;68
2013;"APICUM ACU (MA)";"MA";"APICUM ACU";14;8;3;25
2013;"ARAGUANA (MA)";"MA";"ARAGUANA";9;0;7;16
2013;"ARAIOSES (MA)";"MA";"ARAIOSES";26;6;26;58
2013;"ARAME (MA)";"MA";"ARAME";101;10;3;114
2013;"ARARI (MA)";"MA";"ARARI";83;6;5;94
2013;"AXIXA (MA)";"MA";"AXIXA";16;6;9;31
2013;"BACABAL (MA)";"MA";"BACABAL";867;85;85;1037
2013;"BACABEIRA (MA)";"MA";"BACABEIRA";105;5;20;130
2013;"BACURI (MA)";"MA";"BACURI";10;7;3;20
2013;"BACURITUBA (MA)";"MA";"BACURITUBA";3;0;5;8
2013;"BALSAS (MA)";"MA";"BALSAS";1515;43;104;1662
2013;"BARAO DE GRAJAU (MA)";"MA";"BARAO DE GRAJAU";69;2;4;75
2013;"BARRA DO CORDA (MA)";"MA";"BARRA DO CORDA";585;24;16;625
2013;"BARREIRINHAS (MA)";"MA";"BARREIRINHAS";78;5;16;99
2013;"BELA VISTA DO MARANHAO (MA)";"MA";"BELA VISTA DO MARANHAO";42;4;4;50
2013;"BELAGUA (MA)";"MA";"BELAGUA";1;6;3;10
2013;"BENEDITO LEITE (MA)";"MA";"BENEDITO LEITE";6;3;1;10
2013;"BEQUIMAO (MA)";"MA";"BEQUIMAO";80;10;12;102
2013;"BERNARDO DO MEARIM (MA)";"MA";"BERNARDO DO MEARIM";27;1;1;29
2013;"BOA VISTA DO GURUPI (MA)";"MA";"BOA VISTA DO GURUPI";5;3;2;10
2013;"BOM JARDIM (MA)";"MA";"BOM JARDIM";105;7;6;118
2013;"BOM JESUS DAS SELVAS (MA)";"MA";"BOM JESUS DAS SELVAS";108;6;5;119
2013;"BOM LUGAR (MA)";"MA";"BOM LUGAR";25;10;15;50
2013;"BREJO (MA)";"MA";"BREJO";62;16;15;93
2013;"BREJO DE AREIA (MA)";"MA";"BREJO DE AREIA";23;3;3;29
2013;"BURITI (MA)";"MA";"BURITI";17;11;17;45
2013;"BURITI BRAVO (MA)";"MA";"BURITI BRAVO";32;1;6;39
2013;"BURITICUPU (MA)";"MA";"BURITICUPU";419;40;14;473
2013;"BURITIRANA (MA)";"MA";"BURITIRANA";20;2;0;22
2013;"CACHOEIRA GRANDE (MA)";"MA";"CACHOEIRA GRANDE";5;2;2;9
2013;"CAJAPIO (MA)";"MA";"CAJAPIO";8;0;2;10
2013;"CAJARI (MA)";"MA";"CAJARI";5;3;2;10
2013;"CAMPESTRE DO MARANHAO (MA)";"MA";"CAMPESTRE DO MARANHAO";20;12;9;41
2013;"CANDIDO MENDES (MA)";"MA";"CANDIDO MENDES";12;6;2;20
2013;"CANTANHEDE (MA)";"MA";"CANTANHEDE";21;3;5;29
2013;"CAPINZAL DO NORTE (MA)";"MA";"CAPINZAL DO NORTE";32;13;2;47
2013;"CAROLINA (MA)";"MA";"CAROLINA";65;2;9;76
2013;"CARUTAPERA (MA)";"MA";"CARUTAPERA";26;15;9;50
2013;"CAXIAS (MA)";"MA";"CAXIAS";822;53;110;985
2013;"CEDRAL (MA)";"MA";"CEDRAL";8;0;6;14
2013;"CENTRAL DO MARANHAO (MA)";"MA";"CENTRAL DO MARANHAO";11;3;2;16
2013;"CENTRO DO GUILHERME (MA)";"MA";"CENTRO DO GUILHERME";16;0;4;20
2013;"CENTRO NOVO DO MARANHAO (MA)";"MA";"CENTRO NOVO DO MARANHAO";29;3;6;38
2013;"CHAPADINHA (MA)";"MA";"CHAPADINHA";336;37;14;387
2013;"CIDELANDIA (MA)";"MA";"CIDELANDIA";35;10;11;56
2013;"CODO (MA)";"MA";"CODO";596;29;40;665
2013;"COELHO NETO (MA)";"MA";"COELHO NETO";99;14;48;161
2013;"COLINAS (MA)";"MA";"COLINAS";133;12;18;163
2013;"CONCEICAO DO LAGO ACU (MA)";"MA";"CONCEICAO DO LAGO ACU";16;4;1;21
2013;"COROATA (MA)";"MA";"COROATA";190;37;10;237
2013;"CURURUPU (MA)";"MA";"CURURUPU";26;10;7;43
2013;"DAVINOPOLIS (MA)";"MA";"DAVINOPOLIS";56;3;4;63
2013;"DOM PEDRO (MA)";"MA";"DOM PEDRO";416;14;36;466
2013;"DUQUE BACELAR (MA)";"MA";"DUQUE BACELAR";2;2;5;9
2013;"ESPERANTINOPOLIS (MA)";"MA";"ESPERANTINOPOLIS";88;18;1;107
2013;"ESTREITO (MA)";"MA";"ESTREITO";140;18;16;174
2013;"FEIRA NOVA DO MARANHAO (MA)";"MA";"FEIRA NOVA DO MARANHAO";8;0;3;11
2013;"FERNANDO FALCAO (MA)";"MA";"FERNANDO FALCAO";14;0;5;19
2013;"FORMOSA DA SERRA NEGRA (MA)";"MA";"FORMOSA DA SERRA NEGRA";29;4;3;36
2013;"FORTALEZA DOS NOGUEIRAS (MA)";"MA";"FORTALEZA DOS NOGUEIRAS";72;4;6;82
2013;"FORTUNA (MA)";"MA";"FORTUNA";40;13;1;54
2013;"GODOFREDO VIANA (MA)";"MA";"GODOFREDO VIANA";11;9;10;30
2013;"GONCALVES DIAS (MA)";"MA";"GONCALVES DIAS";55;4;6;65
2013;"GOVERNADOR ARCHER (MA)";"MA";"GOVERNADOR ARCHER";26;8;6;40
2013;"GOVERNADOR EDISON LOBAO (MA)";"MA";"GOVERNADOR EDISON LOBAO";69;1;9;79
2013;"GOVERNADOR EUGENIO BARROS (MA)";"MA";"GOVERNADOR EUGENIO BARROS";49;10;16;75
2013;"GOVERNADOR LUIZ ROCHA (MA)";"MA";"GOVERNADOR LUIZ ROCHA";21;3;5;29
2013;"GOVERNADOR NEWTON BELLO (MA)";"MA";"GOVERNADOR NEWTON BELLO";17;1;1;19
2013;"GOVERNADOR NUNES FREIRE (MA)";"MA";"GOVERNADOR NUNES FREIRE";82;7;3;92
2013;"GRACA ARANHA (MA)";"MA";"GRACA ARANHA";12;4;5;21
2013;"GRAJAU (MA)";"MA";"GRAJAU";453;23;26;502
2013;"GUIMARAES (MA)";"MA";"GUIMARAES";16;1;11;28
2013;"HUMBERTO DE CAMPOS (MA)";"MA";"HUMBERTO DE CAMPOS";13;5;3;21
2013;"ICATU (MA)";"MA";"ICATU";20;3;6;29
2013;"IGARAPE DO MEIO (MA)";"MA";"IGARAPE DO MEIO";23;3;7;33
2013;"IGARAPE GRANDE (MA)";"MA";"IGARAPE GRANDE";69;8;7;84
2013;"IMPERATRIZ (MA)";"MA";"IMPERATRIZ";3412;235;388;4035
2013;"ITAIPAVA DO GRAJAU (MA)";"MA";"ITAIPAVA DO GRAJAU";24;4;3;31
2013;"ITAPECURU MIRIM (MA)";"MA";"ITAPECURU MIRIM";364;22;34;420
2013;"ITINGA DO MARANHAO (MA)";"MA";"ITINGA DO MARANHAO";133;5;9;147
2013;"JATOBA (MA)";"MA";"JATOBA";2;2;4;8
2013;"JENIPAPO DOS VIEIRAS (MA)";"MA";"JENIPAPO DOS VIEIRAS";42;2;3;47
2013;"JOAO LISBOA (MA)";"MA";"JOAO LISBOA";111;8;3;122
2013;"JOSELANDIA (MA)";"MA";"JOSELANDIA";56;9;8;73
2013;"JUNCO DO MARANHAO (MA)";"MA";"JUNCO DO MARANHAO";8;14;1;23
2013;"LAGO DA PEDRA (MA)";"MA";"LAGO DA PEDRA";268;46;11;325
2013;"LAGO DO JUNCO (MA)";"MA";"LAGO DO JUNCO";18;2;7;27
2013;"LAGO DOS RODRIGUES (MA)";"MA";"LAGO DOS RODRIGUES";41;10;6;57
2013;"LAGO VERDE (MA)";"MA";"LAGO VERDE";22;1;8;31
2013;"LAGOA DO MATO (MA)";"MA";"LAGOA DO MATO";18;0;7;25
2013;"LAGOA GRANDE DO MARANHAO (MA)";"MA";"LAGOA GRANDE DO MARANHAO";23;1;1;25
2013;"LAJEADO NOVO (MA)";"MA";"LAJEADO NOVO";13;5;2;20
2013;"LIMA CAMPOS (MA)";"MA";"LIMA CAMPOS";75;29;5;109
2013;"LORETO (MA)";"MA";"LORETO";22;4;6;32
2013;"LUIS DOMINGUES (MA)";"MA";"LUIS DOMINGUES";4;3;2;9
2013;"MAGALHAES DE ALMEIDA (MA)";"MA";"MAGALHAES DE ALMEIDA";16;2;4;22
2013;"MARACACUME (MA)";"MA";"MARACACUME";63;43;3;109
2013;"MARAJA DO SENA (MA)";"MA";"MARAJA DO SENA";8;0;1;9
2013;"MARANHAOZINHO (MA)";"MA";"MARANHAOZINHO";31;4;2;37
2013;"MATA ROMA (MA)";"MA";"MATA ROMA";39;7;13;59
2013;"MATINHA (MA)";"MA";"MATINHA";43;8;5;56
2013;"MATOES (MA)";"MA";"MATOES";34;4;21;59
2013;"MATOES DO NORTE (MA)";"MA";"MATOES DO NORTE";18;5;5;28
2013;"MILAGRES DO MARANHAO (MA)";"MA";"MILAGRES DO MARANHAO";4;2;5;11
2013;"MIRADOR (MA)";"MA";"MIRADOR";21;3;3;27
2013;"MIRANDA DO NORTE (MA)";"MA";"MIRANDA DO NORTE";135;7;10;152
2013;"MIRINZAL (MA)";"MA";"MIRINZAL";38;3;6;47
2013;"MONCAO (MA)";"MA";"MONCAO";21;6;6;33
2013;"MONTES ALTOS (MA)";"MA";"MONTES ALTOS";30;0;1;31
2013;"MORROS (MA)";"MA";"MORROS";13;4;4;21
2013;"NINA RODRIGUES (MA)";"MA";"NINA RODRIGUES";5;2;4;11
2013;"NOVA COLINAS (MA)";"MA";"NOVA COLINAS";12;2;8;22
2013;"NOVA IORQUE (MA)";"MA";"NOVA IORQUE";7;1;1;9
2013;"NOVA OLINDA DO MARANHAO (MA)";"MA";"NOVA OLINDA DO MARANHAO";50;16;7;73
2013;"OLHO D AGUA DAS CUNHAS (MA)";"MA";"OLHO D AGUA DAS CUNHAS";73;16;11;100
2013;"OLINDA NOVA DO MARANHAO (MA)";"MA";"OLINDA NOVA DO MARANHAO";26;2;10;38
2013;"PACO DO LUMIAR (MA)";"MA";"PACO DO LUMIAR";418;117;130;665
2013;"PALMEIRANDIA (MA)";"MA";"PALMEIRANDIA";19;2;11;32
2013;"PARAIBANO (MA)";"MA";"PARAIBANO";59;12;4;75
2013;"PARNARAMA (MA)";"MA";"PARNARAMA";43;3;5;51
2013;"PASSAGEM FRANCA (MA)";"MA";"PASSAGEM FRANCA";36;4;6;46
2013;"PASTOS BONS (MA)";"MA";"PASTOS BONS";95;8;4;107
2013;"PAULINO NEVES (MA)";"MA";"PAULINO NEVES";6;1;8;15
2013;"PAULO RAMOS (MA)";"MA";"PAULO RAMOS";68;9;3;80
2013;"PEDREIRAS (MA)";"MA";"PEDREIRAS";375;47;40;462
2013;"PEDRO DO ROSARIO (MA)";"MA";"PEDRO DO ROSARIO";20;1;6;27
2013;"PENALVA (MA)";"MA";"PENALVA";30;4;2;36
2013;"PERI MIRIM (MA)";"MA";"PERI MIRIM";20;6;8;34
2013;"PERITORO (MA)";"MA";"PERITORO";48;62;13;123
2013;"PINDARE MIRIM (MA)";"MA";"PINDARE MIRIM";95;15;15;125
2013;"PINHEIRO (MA)";"MA";"PINHEIRO";440;26;73;539
2013;"PIO XII (MA)";"MA";"PIO XII";100;6;6;112
2013;"PIRAPEMAS (MA)";"MA";"PIRAPEMAS";18;7;2;27
2013;"POCAO DE PEDRAS (MA)";"MA";"POCAO DE PEDRAS";45;16;4;65
2013;"PORTO FRANCO (MA)";"MA";"PORTO FRANCO";71;24;8;103
2013;"PORTO RICO DO MARANHAO (MA)";"MA";"PORTO RICO DO MARANHAO";2;1;3;6
2013;"PRESIDENTE DUTRA (MA)";"MA";"PRESIDENTE DUTRA";426;23;27;476
2013;"PRESIDENTE JUSCELINO (MA)";"MA";"PRESIDENTE JUSCELINO";4;2;3;9
2013;"PRESIDENTE MEDICI (MA)";"MA";"PRESIDENTE MEDICI";13;6;3;22
2013;"PRESIDENTE SARNEY (MA)";"MA";"PRESIDENTE SARNEY";9;7;2;18
2013;"PRESIDENTE VARGAS (MA)";"MA";"PRESIDENTE VARGAS";18;7;3;28
2013;"PRIMEIRA CRUZ (MA)";"MA";"PRIMEIRA CRUZ";1;1;1;3
2013;"RAPOSA (MA)";"MA";"RAPOSA";97;6;59;162
2013;"RIACHAO (MA)";"MA";"RIACHAO";60;8;16;84
2013;"RIBAMAR FIQUENE (MA)";"MA";"RIBAMAR FIQUENE";17;3;3;23
2013;"ROSARIO (MA)";"MA";"ROSARIO";210;30;50;290
2013;"SAMBAIBA (MA)";"MA";"SAMBAIBA";22;3;2;27
2013;"SANTA FILOMENA DO MARANHAO (MA)";"MA";"SANTA FILOMENA DO MARANHAO";5;7;4;16
2013;"SANTA HELENA (MA)";"MA";"SANTA HELENA";104;8;8;120
2013;"SANTA INES (MA)";"MA";"SANTA INES";767;167;98;1032
2013;"SANTA LUZIA (MA)";"MA";"SANTA LUZIA";263;88;14;365
2013;"SANTA LUZIA DO PARUA (MA)";"MA";"SANTA LUZIA DO PARUA";129;13;9;151
2013;"SANTA QUITERIA DO MARANHAO (MA)";"MA";"SANTA QUITERIA DO MARANHAO";31;3;14;48
2013;"SANTA RITA (MA)";"MA";"SANTA RITA";148;8;8;164
2013;"SANTANA DO MARANHAO (MA)";"MA";"SANTANA DO MARANHAO";9;1;5;15
2013;"SANTO AMARO DO MARANHAO (MA)";"MA";"SANTO AMARO DO MARANHAO";1;4;2;7
2013;"SANTO ANTONIO DOS LOPES (MA)";"MA";"SANTO ANTONIO DOS LOPES";97;7;8;112
2013;"SAO BENEDITO DO RIO PRETO (MA)";"MA";"SAO BENEDITO DO RIO PRETO";13;8;3;24
2013;"SAO BENTO (MA)";"MA";"SAO BENTO";136;34;18;188
2013;"SAO BERNARDO (MA)";"MA";"SAO BERNARDO";88;6;16;110
2013;"SAO DOMINGOS DO AZEITAO (MA)";"MA";"SAO DOMINGOS DO AZEITAO";36;0;1;37
2013;"SAO DOMINGOS DO MARANHAO (MA)";"MA";"SAO DOMINGOS DO MARANHAO";172;2;10;184
2013;"SAO FELIX DE BALSAS (MA)";"MA";"SAO FELIX DE BALSAS";4;0;1;5
2013;"SAO FRANCISCO DO BREJAO (MA)";"MA";"SAO FRANCISCO DO BREJAO";49;1;2;52
2013;"SAO FRANCISCO DO MARANHAO (MA)";"MA";"SAO FRANCISCO DO MARANHAO";7;0;2;9
2013;"SAO JOAO BATISTA (MA)";"MA";"SAO JOAO BATISTA";33;5;10;48
2013;"SAO JOAO DO CARU (MA)";"MA";"SAO JOAO DO CARU";31;1;1;33
2013;"SAO JOAO DO PARAISO (MA)";"MA";"SAO JOAO DO PARAISO";13;4;2;19
2013;"SAO JOAO DO SOTER (MA)";"MA";"SAO JOAO DO SOTER";21;1;4;26
2013;"SAO JOAO DOS PATOS (MA)";"MA";"SAO JOAO DOS PATOS";179;5;5;189
2013;"SAO JOSE DE RIBAMAR (MA)";"MA";"SAO JOSE DE RIBAMAR";709;146;183;1038
2013;"SAO JOSE DOS BASILIOS (MA)";"MA";"SAO JOSE DOS BASILIOS";13;2;2;17
2013;"SAO LUIS (MA)";"MA";"SAO LUIS";9005;1346;3765;14116
2013;"SAO LUIS GONZAGA DO MARANHAO (MA)";"MA";"SAO LUIS GONZAGA DO MARANHAO";31;7;7;45
2013;"SAO MATEUS DO MARANHAO (MA)";"MA";"SAO MATEUS DO MARANHAO";120;40;18;178
2013;"SAO PEDRO DA AGUA BRANCA (MA)";"MA";"SAO PEDRO DA AGUA BRANCA";16;6;3;25
2013;"SAO PEDRO DOS CRENTES (MA)";"MA";"SAO PEDRO DOS CRENTES";22;1;4;27
2013;"SAO RAIMUNDO DAS MANGABEIRAS (MA)";"MA";"SAO RAIMUNDO DAS MANGABEIRAS";135;8;40;183
2013;"SAO RAIMUNDO DO DOCA BEZERRA (MA)";"MA";"SAO RAIMUNDO DO DOCA BEZERRA";11;0;1;12
2013;"SAO ROBERTO (MA)";"MA";"SAO ROBERTO";17;4;1;22
2013;"SAO VICENTE FERRER (MA)";"MA";"SAO VICENTE FERRER";28;2;5;35
2013;"SATUBINHA (MA)";"MA";"SATUBINHA";17;4;1;22
2013;"SENADOR ALEXANDRE COSTA (MA)";"MA";"SENADOR ALEXANDRE COSTA";25;6;4;35
2013;"SENADOR LA ROCQUE (MA)";"MA";"SENADOR LA ROCQUE";58;0;3;61
2013;"SERRANO DO MARANHAO (MA)";"MA";"SERRANO DO MARANHAO";2;0;2;4
2013;"SITIO NOVO (MA)";"MA";"SITIO NOVO";53;5;6;64
2013;"SUCUPIRA DO NORTE (MA)";"MA";"SUCUPIRA DO NORTE";18;3;5;26
2013;"SUCUPIRA DO RIACHAO (MA)";"MA";"SUCUPIRA DO RIACHAO";8;5;2;15
2013;"TASSO FRAGOSO (MA)";"MA";"TASSO FRAGOSO";69;3;6;78
2013;"TIMBIRAS (MA)";"MA";"TIMBIRAS";36;5;3;44
2013;"TIMON (MA)";"MA";"TIMON";604;48;87;739
2013;"TRIZIDELA DO VALE (MA)";"MA";"TRIZIDELA DO VALE";130;19;6;155
2013;"TUFILANDIA (MA)";"MA";"TUFILANDIA";9;7;1;17
2013;"TUNTUM (MA)";"MA";"TUNTUM";117;6;16;139
2013;"TURIACU (MA)";"MA";"TURIACU";36;3;3;42
2013;"TURILANDIA (MA)";"MA";"TURILANDIA";12;4;2;18
2013;"TUTOIA (MA)";"MA";"TUTOIA";70;8;8;86
2013;"URBANO SANTOS (MA)";"MA";"URBANO SANTOS";55;7;13;75
2013;"VARGEM GRANDE (MA)";"MA";"VARGEM GRANDE";112;7;11;130
2013;"VIANA (MA)";"MA";"VIANA";199;8;5;212
2013;"VILA NOVA DOS MARTIRIOS (MA)";"MA";"VILA NOVA DOS MARTIRIOS";36;4;2;42
2013;"VITORIA DO MEARIM (MA)";"MA";"VITORIA DO MEARIM";92;13;8;113
2013;"VITORINO FREIRE (MA)";"MA";"VITORINO FREIRE";127;12;8;147
2013;"ZE DOCA (MA)";"MA";"ZE DOCA";224;24;26;274
2013;"ABADIA DOS DOURADOS (MG)";"MG";"ABADIA DOS DOURADOS";119;33;13;165
2013;"ABAETE (MG)";"MG";"ABAETE";458;29;162;649
2013;"ABRE CAMPO (MG)";"MG";"ABRE CAMPO";204;18;48;270
2013;"ACAIACA (MG)";"MG";"ACAIACA";29;9;8;46
2013;"ACUCENA (MG)";"MG";"ACUCENA";40;14;33;87
2013;"AGUA BOA (MG)";"MG";"AGUA BOA";66;8;29;103
2013;"AGUA COMPRIDA (MG)";"MG";"AGUA COMPRIDA";34;10;8;52
2013;"AGUANIL (MG)";"MG";"AGUANIL";56;10;13;79
2013;"AGUAS FORMOSAS (MG)";"MG";"AGUAS FORMOSAS";101;22;34;157
2013;"AGUAS VERMELHAS (MG)";"MG";"AGUAS VERMELHAS";85;17;21;123
2013;"AIMORES (MG)";"MG";"AIMORES";196;40;32;268
2013;"AIURUOCA (MG)";"MG";"AIURUOCA";108;22;17;147
2013;"ALAGOA (MG)";"MG";"ALAGOA";23;4;15;42
2013;"ALBERTINA (MG)";"MG";"ALBERTINA";41;16;5;62
2013;"ALEM PARAIBA (MG)";"MG";"ALEM PARAIBA";1294;94;71;1459
2013;"ALFENAS (MG)";"MG";"ALFENAS";1266;122;329;1717
2013;"ALFREDO VASCONCELOS (MG)";"MG";"ALFREDO VASCONCELOS";137;10;19;166
2013;"ALMENARA (MG)";"MG";"ALMENARA";270;71;108;449
2013;"ALPERCATA (MG)";"MG";"ALPERCATA";72;5;8;85
2013;"ALPINOPOLIS (MG)";"MG";"ALPINOPOLIS";444;45;53;542
2013;"ALTEROSA (MG)";"MG";"ALTEROSA";235;33;54;322
2013;"ALTO CAPARAO (MG)";"MG";"ALTO CAPARAO";63;12;11;86
2013;"ALTO JEQUITIBA (MG)";"MG";"ALTO JEQUITIBA";101;9;13;123
2013;"ALTO RIO DOCE (MG)";"MG";"ALTO RIO DOCE";105;32;27;164
2013;"ALVARENGA (MG)";"MG";"ALVARENGA";34;4;15;53
2013;"ALVINOPOLIS (MG)";"MG";"ALVINOPOLIS";203;21;22;246
2013;"ALVORADA DE MINAS (MG)";"MG";"ALVORADA DE MINAS";21;14;19;54
2013;"AMPARO DA SERRA (MG)";"MG";"AMPARO DA SERRA";36;6;29;71
2013;"ANDRADAS (MG)";"MG";"ANDRADAS";1053;82;97;1232
2013;"ANDRELANDIA (MG)";"MG";"ANDRELANDIA";147;42;19;208
2013;"ANGELANDIA (MG)";"MG";"ANGELANDIA";70;9;31;110
2013;"ANTONIO CARLOS (MG)";"MG";"ANTONIO CARLOS";171;25;40;236
2013;"ANTONIO DIAS (MG)";"MG";"ANTONIO DIAS";109;14;48;171
2013;"ANTONIO PRADO DE MINAS (MG)";"MG";"ANTONIO PRADO DE MINAS";13;4;4;21
2013;"ARACAI (MG)";"MG";"ARACAI";14;7;7;28
2013;"ARACITABA (MG)";"MG";"ARACITABA";11;2;3;16
2013;"ARACUAI (MG)";"MG";"ARACUAI";246;20;93;359
2013;"ARAGUARI (MG)";"MG";"ARAGUARI";2528;360;184;3072
2013;"ARANTINA (MG)";"MG";"ARANTINA";36;2;4;42
2013;"ARAPONGA (MG)";"MG";"ARAPONGA";67;8;8;83
2013;"ARAPORA (MG)";"MG";"ARAPORA";198;13;56;267
2013;"ARAPUA (MG)";"MG";"ARAPUA";40;3;12;55
2013;"ARAUJOS (MG)";"MG";"ARAUJOS";146;14;6;166
2013;"ARAXA (MG)";"MG";"ARAXA";1656;194;306;2156
2013;"ARCEBURGO (MG)";"MG";"ARCEBURGO";116;22;51;189
2013;"ARCOS (MG)";"MG";"ARCOS";1256;108;287;1651
2013;"AREADO (MG)";"MG";"AREADO";223;22;82;327
2013;"ARGIRITA (MG)";"MG";"ARGIRITA";23;6;7;36
2013;"ARICANDUVA (MG)";"MG";"ARICANDUVA";17;4;15;36
2013;"ARINOS (MG)";"MG";"ARINOS";307;29;102;438
2013;"ASTOLFO DUTRA (MG)";"MG";"ASTOLFO DUTRA";243;8;32;283
2013;"ATALEIA (MG)";"MG";"ATALEIA";93;23;30;146
2013;"AUGUSTO DE LIMA (MG)";"MG";"AUGUSTO DE LIMA";32;5;22;59
2013;"BAEPENDI (MG)";"MG";"BAEPENDI";368;54;31;453
2013;"BALDIM (MG)";"MG";"BALDIM";187;14;18;219
2013;"BAMBUI (MG)";"MG";"BAMBUI";516;45;78;639
2013;"BANDEIRA (MG)";"MG";"BANDEIRA";6;4;9;19
2013;"BANDEIRA DO SUL (MG)";"MG";"BANDEIRA DO SUL";126;30;7;163
2013;"BARAO DE COCAIS (MG)";"MG";"BARAO DE COCAIS";522;73;109;704
2013;"BARAO D0 MONTE ALTO (MG)";"MG";"BARAO D0 MONTE ALTO";53;7;11;71
2013;"BARBACENA (MG)";"MG";"BARBACENA";1762;316;235;2313
2013;"BARRA LONGA (MG)";"MG";"BARRA LONGA";46;8;12;66
2013;"BARROSO (MG)";"MG";"BARROSO";409;31;35;475
2013;"BELA VISTA DE MINAS (MG)";"MG";"BELA VISTA DE MINAS";153;16;9;178
2013;"BELMIRO BRAGA (MG)";"MG";"BELMIRO BRAGA";67;13;5;85
2013;"BELO HORIZONTE (MG)";"MG";"BELO HORIZONTE";35642;5939;8903;50484
2013;"BELO ORIENTE (MG)";"MG";"BELO ORIENTE";238;23;97;358
2013;"BELO VALE (MG)";"MG";"BELO VALE";181;22;38;241
2013;"BERILO (MG)";"MG";"BERILO";69;5;27;101
2013;"BERIZAL (MG)";"MG";"BERIZAL";19;5;9;33
2013;"BERTOPOLIS (MG)";"MG";"BERTOPOLIS";14;3;3;20
2013;"BETIM (MG)";"MG";"BETIM";5520;592;1363;7475
2013;"BIAS FORTES (MG)";"MG";"BIAS FORTES";24;6;5;35
2013;"BICAS (MG)";"MG";"BICAS";220;30;35;285
2013;"BIQUINHAS (MG)";"MG";"BIQUINHAS";51;9;3;63
2013;"BOA ESPERANCA (MG)";"MG";"BOA ESPERANCA";701;97;193;991
2013;"BOCAINA DE MINAS (MG)";"MG";"BOCAINA DE MINAS";69;15;9;93
2013;"BOCAIUVA (MG)";"MG";"BOCAIUVA";479;56;156;691
2013;"BOM DESPACHO (MG)";"MG";"BOM DESPACHO";1014;86;427;1527
2013;"BOM JARDIM DE MINAS (MG)";"MG";"BOM JARDIM DE MINAS";117;13;16;146
2013;"BOM JESUS DA PENHA (MG)";"MG";"BOM JESUS DA PENHA";114;18;17;149
2013;"BOM JESUS DO AMPARO (MG)";"MG";"BOM JESUS DO AMPARO";86;9;10;105
2013;"BOM JESUS DO GALHO (MG)";"MG";"BOM JESUS DO GALHO";104;8;23;135
2013;"BOM REPOUSO (MG)";"MG";"BOM REPOUSO";194;14;14;222
2013;"BOM SUCESSO (MG)";"MG";"BOM SUCESSO";226;29;52;307
2013;"BONFIM (MG)";"MG";"BONFIM";140;21;21;182
2013;"BONFINOPOLIS DE MINAS (MG)";"MG";"BONFINOPOLIS DE MINAS";82;3;31;116
2013;"BONITO DE MINAS (MG)";"MG";"BONITO DE MINAS";24;4;27;55
2013;"BORDA DA MATA (MG)";"MG";"BORDA DA MATA";286;38;92;416
2013;"BOTELHOS (MG)";"MG";"BOTELHOS";235;68;41;344
2013;"BOTUMIRIM (MG)";"MG";"BOTUMIRIM";33;4;16;53
2013;"BRAS PIRES (MG)";"MG";"BRAS PIRES";47;14;7;68
2013;"BRASILANDIA DE MINAS (MG)";"MG";"BRASILANDIA DE MINAS";211;24;95;330
2013;"BRASILIA DE MINAS (MG)";"MG";"BRASILIA DE MINAS";297;16;82;395
2013;"BRASOPOLIS (MG)";"MG";"BRASOPOLIS";201;40;33;274
2013;"BRAUNAS (MG)";"MG";"BRAUNAS";17;9;18;44
2013;"BRUMADINHO (MG)";"MG";"BRUMADINHO";916;126;358;1400
2013;"BUENO BRANDAO (MG)";"MG";"BUENO BRANDAO";196;46;20;262
2013;"BUENOPOLIS (MG)";"MG";"BUENOPOLIS";108;12;28;148
2013;"BUGRE (MG)";"MG";"BUGRE";20;4;6;30
2013;"BURITIS (MG)";"MG";"BURITIS";261;13;95;369
2013;"BURITIZEIRO (MG)";"MG";"BURITIZEIRO";253;27;103;383
2013;"CABECEIRA GRANDE (MG)";"MG";"CABECEIRA GRANDE";56;2;10;68
2013;"CABO VERDE (MG)";"MG";"CABO VERDE";173;41;44;258
2013;"CACHOEIRA DA PRATA (MG)";"MG";"CACHOEIRA DA PRATA";55;3;4;62
2013;"CACHOEIRA DE MINAS (MG)";"MG";"CACHOEIRA DE MINAS";125;27;19;171
2013;"CACHOEIRA DE PAJEU (MG)";"MG";"CACHOEIRA DE PAJEU";38;12;19;69
2013;"CACHOEIRA DOURADA (MG)";"MG";"CACHOEIRA DOURADA";16;11;3;30
2013;"CAETANOPOLIS (MG)";"MG";"CAETANOPOLIS";140;20;47;207
2013;"CAETE (MG)";"MG";"CAETE";544;97;56;697
2013;"CAIANA (MG)";"MG";"CAIANA";42;10;11;63
2013;"CAJURI (MG)";"MG";"CAJURI";47;6;10;63
2013;"CALDAS (MG)";"MG";"CALDAS";293;38;29;360
2013;"CAMACHO (MG)";"MG";"CAMACHO";56;10;13;79
2013;"CAMANDUCAIA (MG)";"MG";"CAMANDUCAIA";491;48;47;586
2013;"CAMBUI (MG)";"MG";"CAMBUI";594;64;111;769
2013;"CAMBUQUIRA (MG)";"MG";"CAMBUQUIRA";146;36;26;208
2013;"CAMPANARIO (MG)";"MG";"CAMPANARIO";16;5;4;25
2013;"CAMPANHA (MG)";"MG";"CAMPANHA";256;56;42;354
2013;"CAMPESTRE (MG)";"MG";"CAMPESTRE";502;56;60;618
2013;"CAMPINA VERDE (MG)";"MG";"CAMPINA VERDE";253;37;49;339
2013;"CAMPO AZUL (MG)";"MG";"CAMPO AZUL";8;4;7;19
2013;"CAMPO BELO (MG)";"MG";"CAMPO BELO";1229;93;124;1446
2013;"CAMPO DO MEIO (MG)";"MG";"CAMPO DO MEIO";123;22;75;220
2013;"CAMPO FLORIDO (MG)";"MG";"CAMPO FLORIDO";166;35;89;290
2013;"CAMPOS ALTOS (MG)";"MG";"CAMPOS ALTOS";321;32;106;459
2013;"CAMPOS GERAIS (MG)";"MG";"CAMPOS GERAIS";326;35;137;498
2013;"CANA VERDE (MG)";"MG";"CANA VERDE";72;9;13;94
2013;"CANAA (MG)";"MG";"CANAA";57;6;9;72
2013;"CANAPOLIS (MG)";"MG";"CANAPOLIS";227;11;98;336
2013;"CANDEIAS (MG)";"MG";"CANDEIAS";242;28;35;305
2013;"CANTAGALO (MG)";"MG";"CANTAGALO";15;4;8;27
2013;"CAPARAO (MG)";"MG";"CAPARAO";99;6;11;116
2013;"CAPELA NOVA (MG)";"MG";"CAPELA NOVA";20;14;3;37
2013;"CAPELINHA (MG)";"MG";"CAPELINHA";700;40;161;901
2013;"CAPETINGA (MG)";"MG";"CAPETINGA";159;22;38;219
2013;"CAPIM BRANCO (MG)";"MG";"CAPIM BRANCO";81;15;8;104
2013;"CAPINOPOLIS (MG)";"MG";"CAPINOPOLIS";272;30;85;387
2013;"CAPITAO ANDRADE (MG)";"MG";"CAPITAO ANDRADE";49;5;6;60
2013;"CAPITAO ENEAS (MG)";"MG";"CAPITAO ENEAS";75;6;28;109
2013;"CAPITOLIO (MG)";"MG";"CAPITOLIO";168;20;20;208
2013;"CAPUTIRA (MG)";"MG";"CAPUTIRA";130;7;49;186
2013;"CARAI (MG)";"MG";"CARAI";60;33;48;141
2013;"CARANAIBA (MG)";"MG";"CARANAIBA";24;10;13;47
2013;"CARANDAI (MG)";"MG";"CARANDAI";564;63;105;732
2013;"CARANGOLA (MG)";"MG";"CARANGOLA";405;46;59;510
2013;"CARATINGA (MG)";"MG";"CARATINGA";1316;77;507;1900
2013;"CARBONITA (MG)";"MG";"CARBONITA";160;18;38;216
2013;"CAREACU (MG)";"MG";"CAREACU";122;12;12;146
2013;"CARLOS CHAGAS (MG)";"MG";"CARLOS CHAGAS";143;35;60;238
2013;"CARMESIA (MG)";"MG";"CARMESIA";68;2;1413;1483
2013;"CARMO DA CACHOEIRA (MG)";"MG";"CARMO DA CACHOEIRA";158;38;55;251
2013;"CARMO DA MATA (MG)";"MG";"CARMO DA MATA";133;39;42;214
2013;"CARMO DE MINAS (MG)";"MG";"CARMO DE MINAS";136;49;25;210
2013;"CARMO DO CAJURU (MG)";"MG";"CARMO DO CAJURU";395;55;84;534
2013;"CARMO DO PARANAIBA (MG)";"MG";"CARMO DO PARANAIBA";653;76;118;847
2013;"CARMO DO RIO CLARO (MG)";"MG";"CARMO DO RIO CLARO";381;32;97;510
2013;"CARMOPOLIS DE MINAS (MG)";"MG";"CARMOPOLIS DE MINAS";463;57;46;566
2013;"CARNEIRINHO (MG)";"MG";"CARNEIRINHO";184;18;64;266
2013;"CARRANCAS (MG)";"MG";"CARRANCAS";50;11;11;72
2013;"CARVALHOPOLIS (MG)";"MG";"CARVALHOPOLIS";45;11;8;64
2013;"CARVALHOS (MG)";"MG";"CARVALHOS";66;6;7;79
2013;"CASA GRANDE (MG)";"MG";"CASA GRANDE";38;6;2;46
2013;"CASCALHO RICO (MG)";"MG";"CASCALHO RICO";46;29;3;78
2013;"CASSIA (MG)";"MG";"CASSIA";403;47;65;515
2013;"CATAGUASES (MG)";"MG";"CATAGUASES";700;88;175;963
2013;"CATAS ALTAS (MG)";"MG";"CATAS ALTAS";117;18;7;142
2013;"CATAS ALTAS DA NORUEGA (MG)";"MG";"CATAS ALTAS DA NORUEGA";43;4;9;56
2013;"CATUJI (MG)";"MG";"CATUJI";46;18;14;78
2013;"CATUTI (MG)";"MG";"CATUTI";26;5;22;53
2013;"CAXAMBU (MG)";"MG";"CAXAMBU";200;45;23;268
2013;"CEDRO DO ABAETE (MG)";"MG";"CEDRO DO ABAETE";10;2;2;14
2013;"CENTRAL DE MINAS (MG)";"MG";"CENTRAL DE MINAS";74;9;15;98
2013;"CENTRALINA (MG)";"MG";"CENTRALINA";95;7;15;117
2013;"CHACARA (MG)";"MG";"CHACARA";32;8;12;52
2013;"CHALE (MG)";"MG";"CHALE";65;10;10;85
2013;"CHAPADA DO NORTE (MG)";"MG";"CHAPADA DO NORTE";44;23;25;92
2013;"CHAPADA GAUCHA (MG)";"MG";"CHAPADA GAUCHA";91;6;31;128
2013;"CHIADOR (MG)";"MG";"CHIADOR";69;11;8;88
2013;"CIPOTANEA (MG)";"MG";"CIPOTANEA";44;3;14;61
2013;"CLARAVAL (MG)";"MG";"CLARAVAL";116;7;23;146
2013;"CLARO DOS POCOES (MG)";"MG";"CLARO DOS POCOES";47;9;28;84
2013;"CLAUDIO (MG)";"MG";"CLAUDIO";753;41;56;850
2013;"COIMBRA (MG)";"MG";"COIMBRA";132;4;11;147
2013;"COLUNA (MG)";"MG";"COLUNA";57;2;14;73
2013;"COMENDADOR GOMES (MG)";"MG";"COMENDADOR GOMES";44;8;14;66
2013;"COMERCINHO (MG)";"MG";"COMERCINHO";28;7;19;54
2013;"CONCEICAO DA APARECIDA (MG)";"MG";"CONCEICAO DA APARECIDA";154;16;23;193
2013;"CONCEICAO DA BARRA DE MINAS (MG)";"MG";"CONCEICAO DA BARRA DE MINAS";33;12;7;52
2013;"CONCEICAO DAS ALAGOAS (MG)";"MG";"CONCEICAO DAS ALAGOAS";524;55;106;685
2013;"CONCEICAO DAS PEDRAS (MG)";"MG";"CONCEICAO DAS PEDRAS";22;12;5;39
2013;"CONCEICAO DE IPANEMA (MG)";"MG";"CONCEICAO DE IPANEMA";43;8;5;56
2013;"CONCEICAO DO MATO DENTRO (MG)";"MG";"CONCEICAO DO MATO DENTRO";145;56;213;414
2013;"CONCEICAO DO PARA (MG)";"MG";"CONCEICAO DO PARA";71;15;16;102
2013;"CONCEICAO DO RIO VERDE (MG)";"MG";"CONCEICAO DO RIO VERDE";184;51;31;266
2013;"CONCEICAO DOS OUROS (MG)";"MG";"CONCEICAO DOS OUROS";277;31;18;326
2013;"CONEGO MARINHO (MG)";"MG";"CONEGO MARINHO";19;4;18;41
2013;"CONFINS (MG)";"MG";"CONFINS";133;19;19;171
2013;"CONGONHAL (MG)";"MG";"CONGONHAL";251;11;14;276
2013;"CONGONHAS (MG)";"MG";"CONGONHAS";975;195;128;1298
2013;"CONGONHAS DO NORTE (MG)";"MG";"CONGONHAS DO NORTE";40;6;9;55
2013;"CONQUISTA (MG)";"MG";"CONQUISTA";172;25;41;238
2013;"CONSELHEIRO LAFAIETE (MG)";"MG";"CONSELHEIRO LAFAIETE";1489;359;669;2517
2013;"CONSELHEIRO PENA (MG)";"MG";"CONSELHEIRO PENA";200;5;55;260
2013;"CONSOLACAO (MG)";"MG";"CONSOLACAO";14;9;3;26
2013;"CONTAGEM (MG)";"MG";"CONTAGEM";14582;1620;2937;19139
2013;"COQUEIRAL (MG)";"MG";"COQUEIRAL";112;16;20;148
2013;"CORACAO DE JESUS (MG)";"MG";"CORACAO DE JESUS";174;9;102;285
2013;"CORDISBURGO (MG)";"MG";"CORDISBURGO";92;15;13;120
2013;"CORDISLANDIA (MG)";"MG";"CORDISLANDIA";42;9;7;58
2013;"CORINTO (MG)";"MG";"CORINTO";335;26;75;436
2013;"COROACI (MG)";"MG";"COROACI";60;8;12;80
2013;"COROMANDEL (MG)";"MG";"COROMANDEL";572;86;90;748
2013;"CORONEL FABRICIANO (MG)";"MG";"CORONEL FABRICIANO";1265;181;556;2002
2013;"CORONEL MURTA (MG)";"MG";"CORONEL MURTA";31;3;15;49
2013;"CORONEL PACHECO (MG)";"MG";"CORONEL PACHECO";34;7;8;49
2013;"CORONEL XAVIER CHAVES (MG)";"MG";"CORONEL XAVIER CHAVES";85;8;3;96
2013;"CORREGO DANTA (MG)";"MG";"CORREGO DANTA";41;5;15;61
2013;"CORREGO DO BOM JESUS (MG)";"MG";"CORREGO DO BOM JESUS";33;11;11;55
2013;"CORREGO FUNDO (MG)";"MG";"CORREGO FUNDO";354;16;19;389
2013;"CORREGO NOVO (MG)";"MG";"CORREGO NOVO";12;5;7;24
2013;"COUTO DE MAGALHAES DE MINAS (MG)";"MG";"COUTO DE MAGALHAES DE MINAS";51;3;11;65
2013;"CRISOLITA (MG)";"MG";"CRISOLITA";10;18;14;42
2013;"CRISTAIS (MG)";"MG";"CRISTAIS";148;24;27;199
2013;"CRISTALIA (MG)";"MG";"CRISTALIA";26;7;22;55
2013;"CRISTIANO OTONI (MG)";"MG";"CRISTIANO OTONI";79;18;10;107
2013;"CRISTINA (MG)";"MG";"CRISTINA";110;25;13;148
2013;"CRUCILANDIA (MG)";"MG";"CRUCILANDIA";143;8;14;165
2013;"CRUZEIRO DA FORTALEZA (MG)";"MG";"CRUZEIRO DA FORTALEZA";82;5;15;102
2013;"CRUZILIA (MG)";"MG";"CRUZILIA";331;38;34;403
2013;"CUPARAQUE (MG)";"MG";"CUPARAQUE";45;8;5;58
2013;"CURRAL DE DENTRO (MG)";"MG";"CURRAL DE DENTRO";58;12;14;84
2013;"CURVELO (MG)";"MG";"CURVELO";1153;60;1917;3130
2013;"DATAS (MG)";"MG";"DATAS";34;3;12;49
2013;"DELFIM MOREIRA (MG)";"MG";"DELFIM MOREIRA";84;9;24;117
2013;"DELFINOPOLIS (MG)";"MG";"DELFINOPOLIS";93;20;10;123
2013;"DELTA (MG)";"MG";"DELTA";455;42;130;627
2013;"DESCOBERTO (MG)";"MG";"DESCOBERTO";41;10;3;54
2013;"DESTERRO DE ENTRE RIOS (MG)";"MG";"DESTERRO DE ENTRE RIOS";98;18;21;137
2013;"DESTERRO DO MELO (MG)";"MG";"DESTERRO DO MELO";36;9;16;61
2013;"DIAMANTINA (MG)";"MG";"DIAMANTINA";371;78;348;797
2013;"DIOGO DE VASCONCELOS (MG)";"MG";"DIOGO DE VASCONCELOS";17;6;7;30
2013;"DIONISIO (MG)";"MG";"DIONISIO";41;5;17;63
2013;"DIVINESIA (MG)";"MG";"DIVINESIA";87;7;14;108
2013;"DIVINO (MG)";"MG";"DIVINO";249;16;47;312
2013;"DIVINO DAS LARANJEIRAS (MG)";"MG";"DIVINO DAS LARANJEIRAS";40;0;6;46
2013;"DIVINOLANDIA DE MINAS (MG)";"MG";"DIVINOLANDIA DE MINAS";64;5;13;82
2013;"DIVINOPOLIS (MG)";"MG";"DIVINOPOLIS";3347;253;746;4346
2013;"DIVISA ALEGRE (MG)";"MG";"DIVISA ALEGRE";44;4;7;55
2013;"DIVISA NOVA (MG)";"MG";"DIVISA NOVA";76;26;29;131
2013;"DIVISOPOLIS (MG)";"MG";"DIVISOPOLIS";42;11;8;61
2013;"DOM BOSCO (MG)";"MG";"DOM BOSCO";19;6;11;36
2013;"DOM CAVATI (MG)";"MG";"DOM CAVATI";181;8;9;198
2013;"DOM JOAQUIM (MG)";"MG";"DOM JOAQUIM";31;5;9;45
2013;"DOM SILVERIO (MG)";"MG";"DOM SILVERIO";68;9;8;85
2013;"DOM VICOSO (MG)";"MG";"DOM VICOSO";30;12;11;53
2013;"DONA EUZEBIA (MG)";"MG";"DONA EUZEBIA";298;4;6;308
2013;"DORES DE CAMPOS (MG)";"MG";"DORES DE CAMPOS";99;20;40;159
2013;"DORES DE GUANHAES (MG)";"MG";"DORES DE GUANHAES";39;5;20;64
2013;"DORES DO INDAIA (MG)";"MG";"DORES DO INDAIA";232;36;18;286
2013;"DORES DO TURVO (MG)";"MG";"DORES DO TURVO";45;5;17;67
2013;"DORESOPOLIS (MG)";"MG";"DORESOPOLIS";14;8;6;28
2013;"DOURADOQUARA (MG)";"MG";"DOURADOQUARA";19;9;1;29
2013;"DURANDE (MG)";"MG";"DURANDE";95;11;15;121
2013;"ELOI MENDES (MG)";"MG";"ELOI MENDES";503;73;53;629
2013;"ENGENHEIRO CALDAS (MG)";"MG";"ENGENHEIRO CALDAS";150;8;13;171
2013;"ENGENHEIRO NAVARRO (MG)";"MG";"ENGENHEIRO NAVARRO";62;2;21;85
2013;"ENTRE FOLHAS (MG)";"MG";"ENTRE FOLHAS";57;4;9;70
2013;"ENTRE RIOS DE MINAS (MG)";"MG";"ENTRE RIOS DE MINAS";300;25;79;404
2013;"ERVALIA (MG)";"MG";"ERVALIA";326;21;46;393
2013;"ESMERALDAS (MG)";"MG";"ESMERALDAS";471;42;309;822
2013;"ESPERA FELIZ (MG)";"MG";"ESPERA FELIZ";344;37;52;433
2013;"ESPINOSA (MG)";"MG";"ESPINOSA";300;19;71;390
2013;"ESPIRITO SANTO DO DOURADO (MG)";"MG";"ESPIRITO SANTO DO DOURADO";75;6;5;86
2013;"ESTIVA (MG)";"MG";"ESTIVA";280;21;18;319
2013;"ESTRELA DALVA (MG)";"MG";"ESTRELA DALVA";30;4;3;37
2013;"ESTRELA DO INDAIA (MG)";"MG";"ESTRELA DO INDAIA";44;9;5;58
2013;"ESTRELA DO SUL (MG)";"MG";"ESTRELA DO SUL";102;18;22;142
2013;"EUGENOPOLIS (MG)";"MG";"EUGENOPOLIS";112;28;29;169
2013;"EWBANK DA CAMARA (MG)";"MG";"EWBANK DA CAMARA";40;4;3;47
2013;"EXTREMA (MG)";"MG";"EXTREMA";566;101;113;780
2013;"FAMA (MG)";"MG";"FAMA";18;7;1;26
2013;"FARIA LEMOS (MG)";"MG";"FARIA LEMOS";28;5;3;36
2013;"FELICIO DOS SANTOS (MG)";"MG";"FELICIO DOS SANTOS";39;11;23;73
2013;"FELISBURGO (MG)";"MG";"FELISBURGO";20;7;11;38
2013;"FELIXLANDIA (MG)";"MG";"FELIXLANDIA";211;20;64;295
2013;"FERNANDES TOURINHO (MG)";"MG";"FERNANDES TOURINHO";20;10;11;41
2013;"FERROS (MG)";"MG";"FERROS";106;15;54;175
2013;"FERVEDOURO (MG)";"MG";"FERVEDOURO";125;12;15;152
2013;"FLORESTAL (MG)";"MG";"FLORESTAL";113;14;44;171
2013;"FORMIGA (MG)";"MG";"FORMIGA";1657;163;235;2055
2013;"FORMOSO (MG)";"MG";"FORMOSO";43;3;29;75
2013;"FORTALEZA DE MINAS (MG)";"MG";"FORTALEZA DE MINAS";56;23;12;91
2013;"FORTUNA DE MINAS (MG)";"MG";"FORTUNA DE MINAS";31;6;11;48
2013;"FRANCISCO BADARO (MG)";"MG";"FRANCISCO BADARO";58;8;20;86
2013;"FRANCISCO DUMONT (MG)";"MG";"FRANCISCO DUMONT";51;7;32;90
2013;"FRANCISCO SA (MG)";"MG";"FRANCISCO SA";150;11;90;251
2013;"FRANCISCOPOLIS (MG)";"MG";"FRANCISCOPOLIS";16;8;16;40
2013;"FREI GASPAR (MG)";"MG";"FREI GASPAR";29;9;12;50
2013;"FREI INOCENCIO (MG)";"MG";"FREI INOCENCIO";96;10;24;130
2013;"FREI LAGONEGRO (MG)";"MG";"FREI LAGONEGRO";8;3;10;21
2013;"FRONTEIRA (MG)";"MG";"FRONTEIRA";203;43;75;321
2013;"FRONTEIRA DOS VALES (MG)";"MG";"FRONTEIRA DOS VALES";11;4;2;17
2013;"FRUTA DE LEITE (MG)";"MG";"FRUTA DE LEITE";19;3;23;45
2013;"FRUTAL (MG)";"MG";"FRUTAL";1487;132;198;1817
2013;"FUNILANDIA (MG)";"MG";"FUNILANDIA";49;4;14;67
2013;"GALILEIA (MG)";"MG";"GALILEIA";67;1;11;79
2013;"GAMELEIRAS (MG)";"MG";"GAMELEIRAS";25;6;16;47
2013;"GLAUCILANDIA (MG)";"MG";"GLAUCILANDIA";3;2;4;9
2013;"GOIABEIRA (MG)";"MG";"GOIABEIRA";23;9;4;36
2013;"GOIANA (MG)";"MG";"GOIANA";24;8;4;36
2013;"GONCALVES (MG)";"MG";"GONCALVES";98;15;9;122
2013;"GONZAGA (MG)";"MG";"GONZAGA";38;6;11;55
2013;"GOUVEA (MG)";"MG";"GOUVEA";126;16;33;175
2013;"GOVERNADOR VALADARES (MG)";"MG";"GOVERNADOR VALADARES";3406;283;350;4039
2013;"GRAO MOGOL (MG)";"MG";"GRAO MOGOL";86;17;71;174
2013;"GRUPIARA (MG)";"MG";"GRUPIARA";9;3;4;16
2013;"GUANHAES (MG)";"MG";"GUANHAES";575;55;113;743
2013;"GUAPE (MG)";"MG";"GUAPE";247;25;55;327
2013;"GUARACIABA (MG)";"MG";"GUARACIABA";77;19;31;127
2013;"GUARACIAMA (MG)";"MG";"GUARACIAMA";41;3;17;61
2013;"GUARANESIA (MG)";"MG";"GUARANESIA";342;51;106;499
2013;"GUARANI (MG)";"MG";"GUARANI";83;19;13;115
2013;"GUARARA (MG)";"MG";"GUARARA";54;12;3;69
2013;"GUARDA MOR (MG)";"MG";"GUARDA MOR";100;12;26;138
2013;"GUAXUPE (MG)";"MG";"GUAXUPE";857;89;164;1110
2013;"GUIDOVAL (MG)";"MG";"GUIDOVAL";151;3;10;164
2013;"GUIMARANIA (MG)";"MG";"GUIMARANIA";141;11;35;187
2013;"GUIRICEMA (MG)";"MG";"GUIRICEMA";263;16;24;303
2013;"GURINHATA (MG)";"MG";"GURINHATA";74;15;28;117
2013;"HELIODORA (MG)";"MG";"HELIODORA";78;11;16;105
2013;"IAPU (MG)";"MG";"IAPU";131;15;21;167
2013;"IBERTIOGA (MG)";"MG";"IBERTIOGA";38;13;8;59
2013;"IBIA (MG)";"MG";"IBIA";392;55;93;540
2013;"IBIAI (MG)";"MG";"IBIAI";53;9;9;71
2013;"IBIRACATU (MG)";"MG";"IBIRACATU";16;9;17;42
2013;"IBIRACI (MG)";"MG";"IBIRACI";352;34;39;425
2013;"IBIRITE (MG)";"MG";"IBIRITE";1363;223;309;1895
2013;"IBITIURA DE MINAS (MG)";"MG";"IBITIURA DE MINAS";100;9;4;113
2013;"IBITURUNA (MG)";"MG";"IBITURUNA";23;3;3;29
2013;"ICARAI DE MINAS (MG)";"MG";"ICARAI DE MINAS";23;1;6;30
2013;"IGARAPE (MG)";"MG";"IGARAPE";694;50;197;941
2013;"IGARATINGA (MG)";"MG";"IGARATINGA";495;9;15;519
2013;"IGUATAMA (MG)";"MG";"IGUATAMA";129;17;18;164
2013;"IJACI (MG)";"MG";"IJACI";206;11;21;238
2013;"ILICINEA (MG)";"MG";"ILICINEA";219;16;39;274
2013;"IMBE DE MINAS (MG)";"MG";"IMBE DE MINAS";44;6;11;61
2013;"INCONFIDENTES (MG)";"MG";"INCONFIDENTES";82;22;27;131
2013;"INDAIABIRA (MG)";"MG";"INDAIABIRA";61;12;22;95
2013;"INDIANOPOLIS (MG)";"MG";"INDIANOPOLIS";85;35;25;145
2013;"INGAI (MG)";"MG";"INGAI";21;15;10;46
2013;"INHAPIM (MG)";"MG";"INHAPIM";415;25;78;518
2013;"INHAUMA (MG)";"MG";"INHAUMA";103;6;21;130
2013;"INIMUTABA (MG)";"MG";"INIMUTABA";41;5;12;58
2013;"IPABA (MG)";"MG";"IPABA";89;18;17;124
2013;"IPANEMA (MG)";"MG";"IPANEMA";254;35;37;326
2013;"IPATINGA (MG)";"MG";"IPATINGA";3178;560;641;4379
2013;"IPIACU (MG)";"MG";"IPIACU";53;4;13;70
2013;"IPUIUNA (MG)";"MG";"IPUIUNA";362;33;30;425
2013;"IRAI DE MINAS (MG)";"MG";"IRAI DE MINAS";213;24;32;269
2013;"ITABIRA (MG)";"MG";"ITABIRA";1801;359;623;2783
2013;"ITABIRINHA (MG)";"MG";"ITABIRINHA";120;9;29;158
2013;"ITABIRITO (MG)";"MG";"ITABIRITO";1004;235;399;1638
2013;"ITACAMBIRA (MG)";"MG";"ITACAMBIRA";14;1;9;24
2013;"ITACARAMBI (MG)";"MG";"ITACARAMBI";115;10;36;161
2013;"ITAGUARA (MG)";"MG";"ITAGUARA";450;22;64;536
2013;"ITAIPE (MG)";"MG";"ITAIPE";66;10;25;101
2013;"ITAJUBA (MG)";"MG";"ITAJUBA";845;114;118;1077
2013;"ITAMARANDIBA (MG)";"MG";"ITAMARANDIBA";640;47;125;812
2013;"ITAMARATI DE MINAS (MG)";"MG";"ITAMARATI DE MINAS";116;14;16;146
2013;"ITAMBACURI (MG)";"MG";"ITAMBACURI";191;33;46;270
2013;"ITAMBE DO MATO DENTRO (MG)";"MG";"ITAMBE DO MATO DENTRO";22;8;6;36
2013;"ITAMOGI (MG)";"MG";"ITAMOGI";254;24;40;318
2013;"ITAMONTE (MG)";"MG";"ITAMONTE";296;23;28;347
2013;"ITANHANDU (MG)";"MG";"ITANHANDU";437;31;30;498
2013;"ITANHOMI (MG)";"MG";"ITANHOMI";104;19;18;141
2013;"ITAOBIM (MG)";"MG";"ITAOBIM";220;25;44;289
2013;"ITAPAGIPE (MG)";"MG";"ITAPAGIPE";257;23;45;325
2013;"ITAPECERICA (MG)";"MG";"ITAPECERICA";336;60;61;457
2013;"ITAPEVA (MG)";"MG";"ITAPEVA";259;27;8;294
2013;"ITATIAIUCU (MG)";"MG";"ITATIAIUCU";358;18;41;417
2013;"ITAU DE MINAS (MG)";"MG";"ITAU DE MINAS";330;49;48;427
2013;"ITAUNA (MG)";"MG";"ITAUNA";1556;236;276;2068
2013;"ITAVERAVA (MG)";"MG";"ITAVERAVA";55;7;14;76
2013;"ITINGA (MG)";"MG";"ITINGA";69;22;38;129
2013;"ITUETA (MG)";"MG";"ITUETA";60;7;17;84
2013;"ITUIUTABA (MG)";"MG";"ITUIUTABA";1284;229;325;1838
2013;"ITUMIRIM (MG)";"MG";"ITUMIRIM";55;23;7;85
2013;"ITURAMA (MG)";"MG";"ITURAMA";838;88;317;1243
2013;"ITUTINGA (MG)";"MG";"ITUTINGA";62;27;2;91
2013;"JABOTICATUBAS (MG)";"MG";"JABOTICATUBAS";281;12;67;360
2013;"JACINTO (MG)";"MG";"JACINTO";31;7;38;76
2013;"JACUI (MG)";"MG";"JACUI";136;13;28;177
2013;"JACUTINGA (MG)";"MG";"JACUTINGA";374;71;69;514
2013;"JAGUARACU (MG)";"MG";"JAGUARACU";52;4;5;61
2013;"JAIBA (MG)";"MG";"JAIBA";348;21;142;511
2013;"JAMPRUCA (MG)";"MG";"JAMPRUCA";17;4;26;47
2013;"JANAUBA (MG)";"MG";"JANAUBA";853;32;158;1043
2013;"JANUARIA (MG)";"MG";"JANUARIA";392;26;128;546
2013;"JAPARAIBA (MG)";"MG";"JAPARAIBA";81;5;21;107
2013;"JAPONVAR (MG)";"MG";"JAPONVAR";26;10;13;49
2013;"JECEABA (MG)";"MG";"JECEABA";126;31;15;172
2013;"JENIPAPO DE MINAS (MG)";"MG";"JENIPAPO DE MINAS";31;9;25;65
2013;"JEQUERI (MG)";"MG";"JEQUERI";99;9;29;137
2013;"JEQUITAI (MG)";"MG";"JEQUITAI";67;3;28;98
2013;"JEQUITIBA (MG)";"MG";"JEQUITIBA";87;13;26;126
2013;"JEQUITINHONHA (MG)";"MG";"JEQUITINHONHA";94;35;28;157
2013;"JESUANIA (MG)";"MG";"JESUANIA";70;21;12;103
2013;"JOAIMA (MG)";"MG";"JOAIMA";61;9;31;101
2013;"JOANESIA (MG)";"MG";"JOANESIA";13;8;16;37
2013;"JOAO MONLEVADE (MG)";"MG";"JOAO MONLEVADE";1254;160;271;1685
2013;"JOAO PINHEIRO (MG)";"MG";"JOAO PINHEIRO";939;61;226;1226
2013;"JOAQUIM FELICIO (MG)";"MG";"JOAQUIM FELICIO";47;3;11;61
2013;"JORDANIA (MG)";"MG";"JORDANIA";30;11;20;61
2013;"JOSE GONCALVES DE MINAS (MG)";"MG";"JOSE GONCALVES DE MINAS";25;10;19;54
2013;"JOSE RAYDAN (MG)";"MG";"JOSE RAYDAN";25;3;17;45
2013;"JOSENOPOLIS (MG)";"MG";"JOSENOPOLIS";20;6;13;39
2013;"JUATUBA (MG)";"MG";"JUATUBA";298;39;183;520
2013;"JUIZ DE FORA (MG)";"MG";"JUIZ DE FORA";6140;806;1631;8577
2013;"JURAMENTO (MG)";"MG";"JURAMENTO";19;3;13;35
2013;"JURUAIA (MG)";"MG";"JURUAIA";102;21;23;146
2013;"JUVENILIA (MG)";"MG";"JUVENILIA";22;4;8;34
2013;"LADAINHA (MG)";"MG";"LADAINHA";50;17;38;105
2013;"LAGAMAR (MG)";"MG";"LAGAMAR";90;30;22;142
2013;"LAGOA DA PRATA (MG)";"MG";"LAGOA DA PRATA";1035;67;151;1253
2013;"LAGOA DOS PATOS (MG)";"MG";"LAGOA DOS PATOS";36;2;14;52
2013;"LAGOA DOURADA (MG)";"MG";"LAGOA DOURADA";411;29;100;540
2013;"LAGOA FORMOSA (MG)";"MG";"LAGOA FORMOSA";337;26;89;452
2013;"LAGOA GRANDE (MG)";"MG";"LAGOA GRANDE";106;11;53;170
2013;"LAGOA SANTA (MG)";"MG";"LAGOA SANTA";820;121;155;1096
2013;"LAJINHA (MG)";"MG";"LAJINHA";279;35;50;364
2013;"LAMBARI (MG)";"MG";"LAMBARI";320;56;26;402
2013;"LAMIM (MG)";"MG";"LAMIM";44;4;5;53
2013;"LARANJAL (MG)";"MG";"LARANJAL";126;11;3;140
2013;"LASSANCE (MG)";"MG";"LASSANCE";46;8;7;61
2013;"LAVRAS (MG)";"MG";"LAVRAS";1413;218;275;1906
2013;"LEANDRO FERREIRA (MG)";"MG";"LEANDRO FERREIRA";35;5;9;49
2013;"LEME DO PRADO (MG)";"MG";"LEME DO PRADO";30;5;27;62
2013;"LEOPOLDINA (MG)";"MG";"LEOPOLDINA";670;71;75;816
2013;"LIBERDADE (MG)";"MG";"LIBERDADE";93;19;8;120
2013;"LIMA DUARTE (MG)";"MG";"LIMA DUARTE";194;31;30;255
2013;"LIMEIRA DO OESTE (MG)";"MG";"LIMEIRA DO OESTE";168;42;57;267
2013;"LONTRA (MG)";"MG";"LONTRA";30;6;10;46
2013;"LUISBURGO (MG)";"MG";"LUISBURGO";32;10;21;63
2013;"LUISLANDIA (MG)";"MG";"LUISLANDIA";25;5;12;42
2013;"LUMINARIAS (MG)";"MG";"LUMINARIAS";101;5;47;153
2013;"LUZ (MG)";"MG";"LUZ";328;55;33;416
2013;"MACHACALIS (MG)";"MG";"MACHACALIS";27;3;9;39
2013;"MACHADO (MG)";"MG";"MACHADO";752;144;120;1016
2013;"MADRE DE DEUS DE MINAS (MG)";"MG";"MADRE DE DEUS DE MINAS";98;8;9;115
2013;"MALACACHETA (MG)";"MG";"MALACACHETA";112;13;48;173
2013;"MAMONAS (MG)";"MG";"MAMONAS";99;8;25;132
2013;"MANGA (MG)";"MG";"MANGA";137;11;55;203
2013;"MANHUACU (MG)";"MG";"MANHUACU";1640;128;172;1940
2013;"MANHUMIRIM (MG)";"MG";"MANHUMIRIM";321;35;42;398
2013;"MANTENA (MG)";"MG";"MANTENA";549;47;85;681
2013;"MAR DE ESPANHA (MG)";"MG";"MAR DE ESPANHA";152;25;15;192
2013;"MARAVILHAS (MG)";"MG";"MARAVILHAS";162;19;11;192
2013;"MARIA DA FE (MG)";"MG";"MARIA DA FE";245;16;30;291
2013;"MARIANA (MG)";"MG";"MARIANA";671;187;336;1194
2013;"MARILAC (MG)";"MG";"MARILAC";21;6;11;38
2013;"MARIO CAMPOS (MG)";"MG";"MARIO CAMPOS";219;23;17;259
2013;"MARIPA DE MINAS (MG)";"MG";"MARIPA DE MINAS";43;6;5;54
2013;"MARLIERIA (MG)";"MG";"MARLIERIA";38;3;8;49
2013;"MARMELOPOLIS (MG)";"MG";"MARMELOPOLIS";42;10;8;60
2013;"MARTINHO CAMPOS (MG)";"MG";"MARTINHO CAMPOS";396;37;79;512
2013;"MARTINS SOARES (MG)";"MG";"MARTINS SOARES";98;6;14;118
2013;"MATA VERDE (MG)";"MG";"MATA VERDE";30;22;7;59
2013;"MATERLANDIA (MG)";"MG";"MATERLANDIA";12;5;3;20
2013;"MATEUS LEME (MG)";"MG";"MATEUS LEME";633;85;131;849
2013;"MATHIAS LOBATO (MG)";"MG";"MATHIAS LOBATO";33;2;7;42
2013;"MATIAS BARBOSA (MG)";"MG";"MATIAS BARBOSA";626;41;42;709
2013;"MATIAS CARDOSO (MG)";"MG";"MATIAS CARDOSO";33;4;22;59
2013;"MATIPO (MG)";"MG";"MATIPO";278;31;47;356
2013;"MATO VERDE (MG)";"MG";"MATO VERDE";161;8;30;199
2013;"MATOZINHOS (MG)";"MG";"MATOZINHOS";377;97;174;648
2013;"MATUTINA (MG)";"MG";"MATUTINA";81;20;6;107
2013;"MEDEIROS (MG)";"MG";"MEDEIROS";56;20;8;84
2013;"MEDINA (MG)";"MG";"MEDINA";153;57;39;249
2013;"MENDES PIMENTEL (MG)";"MG";"MENDES PIMENTEL";47;8;10;65
2013;"MERCES (MG)";"MG";"MERCES";188;19;17;224
2013;"MESQUITA (MG)";"MG";"MESQUITA";23;17;10;50
2013;"MINAS NOVAS (MG)";"MG";"MINAS NOVAS";146;38;110;294
2013;"MINDURI (MG)";"MG";"MINDURI";74;12;3;89
2013;"MIRABELA (MG)";"MG";"MIRABELA";99;19;30;148
2013;"MIRADOURO (MG)";"MG";"MIRADOURO";108;25;32;165
2013;"MIRAI (MG)";"MG";"MIRAI";163;15;23;201
2013;"MIRAVANIA (MG)";"MG";"MIRAVANIA";12;4;17;33
2013;"MOEDA (MG)";"MG";"MOEDA";132;6;33;171
2013;"MOEMA (MG)";"MG";"MOEMA";173;14;126;313
2013;"MONJOLOS (MG)";"MG";"MONJOLOS";7;3;7;17
2013;"MONSENHOR PAULO (MG)";"MG";"MONSENHOR PAULO";189;24;15;228
2013;"MONTALVANIA (MG)";"MG";"MONTALVANIA";121;8;60;189
2013;"MONTE ALEGRE DE MINAS (MG)";"MG";"MONTE ALEGRE DE MINAS";537;55;53;645
2013;"MONTE AZUL (MG)";"MG";"MONTE AZUL";177;12;65;254
2013;"MONTE BELO (MG)";"MG";"MONTE BELO";262;47;50;359
2013;"MONTE CARMELO (MG)";"MG";"MONTE CARMELO";1410;124;153;1687
2013;"MONTE FORMOSO (MG)";"MG";"MONTE FORMOSO";16;12;34;62
2013;"MONTE SANTO DE MINAS (MG)";"MG";"MONTE SANTO DE MINAS";461;54;116;631
2013;"MONTE SIAO (MG)";"MG";"MONTE SIAO";257;42;36;335
2013;"MONTES CLAROS (MG)";"MG";"MONTES CLAROS";4626;322;1072;6020
2013;"MONTEZUMA (MG)";"MG";"MONTEZUMA";29;10;26;65
2013;"MORADA NOVA DE MINAS (MG)";"MG";"MORADA NOVA DE MINAS";128;23;29;180
2013;"MORRO DA GARCA (MG)";"MG";"MORRO DA GARCA";44;5;20;69
2013;"MORRO DO PILAR (MG)";"MG";"MORRO DO PILAR";33;7;3;43
2013;"MUNHOZ (MG)";"MG";"MUNHOZ";142;16;12;170
2013;"MURIAE (MG)";"MG";"MURIAE";1419;120;197;1736
2013;"MUTUM (MG)";"MG";"MUTUM";228;27;75;330
2013;"MUZAMBINHO (MG)";"MG";"MUZAMBINHO";449;87;54;590
2013;"NACIP RAYDAN (MG)";"MG";"NACIP RAYDAN";9;0;5;14
2013;"NANUQUE (MG)";"MG";"NANUQUE";583;61;198;842
2013;"NAQUE (MG)";"MG";"NAQUE";37;5;18;60
2013;"NATALANDIA (MG)";"MG";"NATALANDIA";28;2;18;48
2013;"NATERCIA (MG)";"MG";"NATERCIA";84;14;19;117
2013;"NAZARENO (MG)";"MG";"NAZARENO";172;17;31;220
2013;"NEPOMUCENO (MG)";"MG";"NEPOMUCENO";442;45;97;584
2013;"NINHEIRA (MG)";"MG";"NINHEIRA";41;6;31;78
2013;"NOVA BELEM (MG)";"MG";"NOVA BELEM";40;2;14;56
2013;"NOVA ERA (MG)";"MG";"NOVA ERA";234;22;69;325
2013;"NOVA LIMA (MG)";"MG";"NOVA LIMA";1514;391;230;2135
2013;"NOVA MODICA (MG)";"MG";"NOVA MODICA";22;4;14;40
2013;"NOVA PONTE (MG)";"MG";"NOVA PONTE";244;63;74;381
2013;"NOVA PORTEIRINHA (MG)";"MG";"NOVA PORTEIRINHA";39;4;14;57
2013;"NOVA RESENDE (MG)";"MG";"NOVA RESENDE";336;35;65;436
2013;"NOVA SERRANA (MG)";"MG";"NOVA SERRANA";568;62;101;731
2013;"NOVA UNIAO (MG)";"MG";"NOVA UNIAO";151;12;19;182
2013;"NOVO CRUZEIRO (MG)";"MG";"NOVO CRUZEIRO";180;38;120;338
2013;"NOVO ORIENTE DE MINAS (MG)";"MG";"NOVO ORIENTE DE MINAS";41;28;15;84
2013;"NOVORIZONTE (MG)";"MG";"NOVORIZONTE";63;2;19;84
2013;"OLARIA (MG)";"MG";"OLARIA";17;8;5;30
2013;"OLHOS D AGUA (MG)";"MG";"OLHOS D AGUA";75;15;48;138
2013;"OLIMPIO NORONHA (MG)";"MG";"OLIMPIO NORONHA";22;12;7;41
2013;"OLIVEIRA (MG)";"MG";"OLIVEIRA";788;85;112;985
2013;"OLIVEIRA FORTES (MG)";"MG";"OLIVEIRA FORTES";24;2;1;27
2013;"ONCA DE PITANGUI (MG)";"MG";"ONCA DE PITANGUI";29;10;10;49
2013;"ORATORIOS (MG)";"MG";"ORATORIOS";78;8;19;105
2013;"ORIZANIA (MG)";"MG";"ORIZANIA";68;16;12;96
2013;"OURO BRANCO (MG)";"MG";"OURO BRANCO";551;143;213;907
2013;"OURO FINO (MG)";"MG";"OURO FINO";571;93;86;750
2013;"OURO PRETO (MG)";"MG";"OURO PRETO";1031;248;278;1557
2013;"OURO VERDE DE MINAS (MG)";"MG";"OURO VERDE DE MINAS";27;9;7;43
2013;"PADRE CARVALHO (MG)";"MG";"PADRE CARVALHO";29;9;26;64
2013;"PADRE PARAISO (MG)";"MG";"PADRE PARAISO";148;65;65;278
2013;"PAI PEDRO (MG)";"MG";"PAI PEDRO";14;3;25;42
2013;"PAINEIRAS (MG)";"MG";"PAINEIRAS";80;18;11;109
2013;"PAINS (MG)";"MG";"PAINS";250;19;25;294
2013;"PAIVA (MG)";"MG";"PAIVA";10;2;2;14
2013;"PALMA (MG)";"MG";"PALMA";107;10;6;123
2013;"PALMOPOLIS (MG)";"MG";"PALMOPOLIS";16;8;9;33
2013;"PAPAGAIOS (MG)";"MG";"PAPAGAIOS";551;11;58;620
2013;"PARA DE MINAS (MG)";"MG";"PARA DE MINAS";2291;186;221;2698
2013;"PARACATU (MG)";"MG";"PARACATU";1546;139;361;2046
2013;"PARAGUACU (MG)";"MG";"PARAGUACU";320;59;40;419
2013;"PARAISOPOLIS (MG)";"MG";"PARAISOPOLIS";335;52;47;434
2013;"PARAOPEBA (MG)";"MG";"PARAOPEBA";467;24;48;539
2013;"PASSA QUATRO (MG)";"MG";"PASSA QUATRO";349;31;26;406
2013;"PASSA TEMPO (MG)";"MG";"PASSA TEMPO";189;35;24;248
2013;"PASSA VINTE (MG)";"MG";"PASSA VINTE";129;20;11;160
2013;"PASSABEM (MG)";"MG";"PASSABEM";13;5;4;22
2013;"PASSOS (MG)";"MG";"PASSOS";2023;176;393;2592
2013;"PATIS (MG)";"MG";"PATIS";14;4;13;31
2013;"PATOS DE MINAS (MG)";"MG";"PATOS DE MINAS";3136;165;368;3669
2013;"PATROCINIO (MG)";"MG";"PATROCINIO";1796;168;579;2543
2013;"PATROCINIO DO MURIAE (MG)";"MG";"PATROCINIO DO MURIAE";85;11;7;103
2013;"PAULA CANDIDO (MG)";"MG";"PAULA CANDIDO";78;12;13;103
2013;"PAULISTAS (MG)";"MG";"PAULISTAS";29;3;9;41
2013;"PAVAO (MG)";"MG";"PAVAO";41;22;11;74
2013;"PECANHA (MG)";"MG";"PECANHA";130;11;59;200
2013;"PEDRA AZUL (MG)";"MG";"PEDRA AZUL";148;20;62;230
2013;"PEDRA BONITA (MG)";"MG";"PEDRA BONITA";58;14;20;92
2013;"PEDRA DO ANTA (MG)";"MG";"PEDRA DO ANTA";32;4;17;53
2013;"PEDRA DO INDAIA (MG)";"MG";"PEDRA DO INDAIA";79;13;4;96
2013;"PEDRA DOURADA (MG)";"MG";"PEDRA DOURADA";17;7;14;38
2013;"PEDRALVA (MG)";"MG";"PEDRALVA";159;30;30;219
2013;"PEDRAS DE MARIA DA CRUZ (MG)";"MG";"PEDRAS DE MARIA DA CRUZ";26;4;42;72
2013;"PEDRINOPOLIS (MG)";"MG";"PEDRINOPOLIS";62;22;6;90
2013;"PEDRO LEOPOLDO (MG)";"MG";"PEDRO LEOPOLDO";1211;192;250;1653
2013;"PEDRO TEIXEIRA (MG)";"MG";"PEDRO TEIXEIRA";18;8;5;31
2013;"PEQUERI (MG)";"MG";"PEQUERI";88;7;4;99
2013;"PEQUI (MG)";"MG";"PEQUI";64;17;9;90
2013;"PERDIGAO (MG)";"MG";"PERDIGAO";156;15;9;180
2013;"PERDIZES (MG)";"MG";"PERDIZES";273;52;50;375
2013;"PERDOES (MG)";"MG";"PERDOES";528;35;74;637
2013;"PERIQUITO (MG)";"MG";"PERIQUITO";57;5;19;81
2013;"PESCADOR (MG)";"MG";"PESCADOR";15;9;7;31
2013;"PIAU (MG)";"MG";"PIAU";44;10;8;62
2013;"PIEDADE DE CARATINGA (MG)";"MG";"PIEDADE DE CARATINGA";149;13;16;178
2013;"PIEDADE DE PONTE NOVA (MG)";"MG";"PIEDADE DE PONTE NOVA";35;2;17;54
2013;"PIEDADE DO RIO GRANDE (MG)";"MG";"PIEDADE DO RIO GRANDE";59;7;8;74
2013;"PIEDADE DOS GERAIS (MG)";"MG";"PIEDADE DOS GERAIS";87;6;14;107
2013;"PIMENTA (MG)";"MG";"PIMENTA";240;16;25;281
2013;"PINGO D AGUA (MG)";"MG";"PINGO D AGUA";23;3;5;31
2013;"PINTOPOLIS (MG)";"MG";"PINTOPOLIS";20;2;8;30
2013;"PIRACEMA (MG)";"MG";"PIRACEMA";106;11;18;135
2013;"PIRAJUBA (MG)";"MG";"PIRAJUBA";155;21;8;184
2013;"PIRANGA (MG)";"MG";"PIRANGA";145;23;58;226
2013;"PIRANGUCU (MG)";"MG";"PIRANGUCU";47;25;31;103
2013;"PIRANGUINHO (MG)";"MG";"PIRANGUINHO";201;27;23;251
2013;"PIRAPETINGA (MG)";"MG";"PIRAPETINGA";382;25;35;442
2013;"PIRAPORA (MG)";"MG";"PIRAPORA";603;42;176;821
2013;"PIRAUBA (MG)";"MG";"PIRAUBA";128;21;14;163
2013;"PITANGUI (MG)";"MG";"PITANGUI";543;75;90;708
2013;"PIUMHI (MG)";"MG";"PIUMHI";801;79;86;966
2013;"PLANURA (MG)";"MG";"PLANURA";155;18;55;228
2013;"POCO FUNDO (MG)";"MG";"POCO FUNDO";305;47;27;379
2013;"POCOS DE CALDAS (MG)";"MG";"POCOS DE CALDAS";2831;580;456;3867
2013;"POCRANE (MG)";"MG";"POCRANE";78;7;10;95
2013;"POMPEU (MG)";"MG";"POMPEU";442;30;136;608
2013;"PONTE NOVA (MG)";"MG";"PONTE NOVA";1080;133;194;1407
2013;"PONTO CHIQUE (MG)";"MG";"PONTO CHIQUE";14;1;13;28
2013;"PONTO DOS VOLANTES (MG)";"MG";"PONTO DOS VOLANTES";42;10;34;86
2013;"PORTEIRINHA (MG)";"MG";"PORTEIRINHA";345;23;206;574
2013;"PORTO FIRME (MG)";"MG";"PORTO FIRME";87;9;18;114
2013;"POTE (MG)";"MG";"POTE";81;18;33;132
2013;"POUSO ALEGRE (MG)";"MG";"POUSO ALEGRE";2687;313;531;3531
2013;"POUSO ALTO (MG)";"MG";"POUSO ALTO";103;13;12;128
2013;"PRADOS (MG)";"MG";"PRADOS";103;21;11;135
2013;"PRATA (MG)";"MG";"PRATA";415;105;94;614
2013;"PRATAPOLIS (MG)";"MG";"PRATAPOLIS";196;24;23;243
2013;"PRATINHA (MG)";"MG";"PRATINHA";64;11;7;82
2013;"PRESIDENTE BERNARDES (MG)";"MG";"PRESIDENTE BERNARDES";29;10;11;50
2013;"PRESIDENTE JUSCELINO (MG)";"MG";"PRESIDENTE JUSCELINO";45;5;19;69
2013;"PRESIDENTE KUBITSCHEK (MG)";"MG";"PRESIDENTE KUBITSCHEK";24;13;8;45
2013;"PRESIDENTE OLEGARIO (MG)";"MG";"PRESIDENTE OLEGARIO";242;19;104;365
2013;"PRUDENTE DE MORAIS (MG)";"MG";"PRUDENTE DE MORAIS";121;12;9;142
2013;"QUARTEL GERAL (MG)";"MG";"QUARTEL GERAL";42;7;4;53
2013;"QUELUZITA (MG)";"MG";"QUELUZITA";21;11;3;35
2013;"RAPOSOS (MG)";"MG";"RAPOSOS";80;43;29;152
2013;"RAUL SOARES (MG)";"MG";"RAUL SOARES";251;28;53;332
2013;"RECREIO (MG)";"MG";"RECREIO";191;28;25;244
2013;"REDUTO (MG)";"MG";"REDUTO";86;14;5;105
2013;"RESENDE COSTA (MG)";"MG";"RESENDE COSTA";212;17;25;254
2013;"RESPLENDOR (MG)";"MG";"RESPLENDOR";225;36;39;300
2013;"RESSAQUINHA (MG)";"MG";"RESSAQUINHA";172;13;24;209
2013;"RIACHINHO (MG)";"MG";"RIACHINHO";89;5;24;118
2013;"RIACHO DOS MACHADOS (MG)";"MG";"RIACHO DOS MACHADOS";56;5;43;104
2013;"RIBEIRAO DAS NEVES (MG)";"MG";"RIBEIRAO DAS NEVES";2740;444;745;3929
2013;"RIBEIRAO VERMELHO (MG)";"MG";"RIBEIRAO VERMELHO";36;12;3;51
2013;"RIO ACIMA (MG)";"MG";"RIO ACIMA";115;20;15;150
2013;"RIO CASCA (MG)";"MG";"RIO CASCA";220;11;53;284
2013;"RIO DO PRADO (MG)";"MG";"RIO DO PRADO";18;9;8;35
2013;"RIO DOCE (MG)";"MG";"RIO DOCE";15;8;6;29
2013;"RIO ESPERA (MG)";"MG";"RIO ESPERA";37;0;10;47
2013;"RIO MANSO (MG)";"MG";"RIO MANSO";158;5;17;180
2013;"RIO NOVO (MG)";"MG";"RIO NOVO";150;27;30;207
2013;"RIO PARANAIBA (MG)";"MG";"RIO PARANAIBA";232;17;74;323
2013;"RIO PARDO DE MINAS (MG)";"MG";"RIO PARDO DE MINAS";244;21;139;404
2013;"RIO PIRACICABA (MG)";"MG";"RIO PIRACICABA";205;24;30;259
2013;"RIO POMBA (MG)";"MG";"RIO POMBA";283;34;40;357
2013;"RIO PRETO (MG)";"MG";"RIO PRETO";638;61;66;765
2013;"RIO VERMELHO (MG)";"MG";"RIO VERMELHO";78;26;40;144
2013;"RITAPOLIS (MG)";"MG";"RITAPOLIS";36;11;8;55
2013;"ROCHEDO DE MINAS (MG)";"MG";"ROCHEDO DE MINAS";25;6;2;33
2013;"RODEIRO (MG)";"MG";"RODEIRO";270;6;22;298
2013;"ROMARIA (MG)";"MG";"ROMARIA";47;24;10;81
2013;"ROSARIO DA LIMEIRA (MG)";"MG";"ROSARIO DA LIMEIRA";69;8;37;114
2013;"RUBELITA (MG)";"MG";"RUBELITA";19;5;10;34
2013;"RUBIM (MG)";"MG";"RUBIM";28;1;29;58
2013;"SABARA (MG)";"MG";"SABARA";755;217;346;1318
2013;"SABINOPOLIS (MG)";"MG";"SABINOPOLIS";129;35;57;221
2013;"SACRAMENTO (MG)";"MG";"SACRAMENTO";524;89;73;686
2013;"SALINAS (MG)";"MG";"SALINAS";457;48;132;637
2013;"SALTO DA DIVISA (MG)";"MG";"SALTO DA DIVISA";13;8;11;32
2013;"SANTA BARBARA (MG)";"MG";"SANTA BARBARA";445;77;102;624
2013;"SANTA BARBARA DO LESTE (MG)";"MG";"SANTA BARBARA DO LESTE";175;10;9;194
2013;"SANTA BARBARA DO MONTE VERDE (MG)";"MG";"SANTA BARBARA DO MONTE VERDE";805;68;142;1015
2013;"SANTA BARBARA DO TUGURIO (MG)";"MG";"SANTA BARBARA DO TUGURIO";74;30;64;168
2013;"SANTA CRUZ DE MINAS (MG)";"MG";"SANTA CRUZ DE MINAS";80;12;3;95
2013;"SANTA CRUZ DE SALINAS (MG)";"MG";"SANTA CRUZ DE SALINAS";24;2;26;52
2013;"SANTA CRUZ DO ESCALVADO (MG)";"MG";"SANTA CRUZ DO ESCALVADO";35;9;14;58
2013;"SANTA EFIGENIA DE MINAS (MG)";"MG";"SANTA EFIGENIA DE MINAS";27;9;6;42
2013;"SANTA FE DE MINAS (MG)";"MG";"SANTA FE DE MINAS";7;2;5;14
2013;"SANTA HELENA DE MINAS (MG)";"MG";"SANTA HELENA DE MINAS";9;8;8;25
2013;"SANTA JULIANA (MG)";"MG";"SANTA JULIANA";427;50;53;530
2013;"SANTA LUZIA (MG)";"MG";"SANTA LUZIA";1996;279;673;2948
2013;"SANTA MARGARIDA (MG)";"MG";"SANTA MARGARIDA";226;29;38;293
2013;"SANTA MARIA DE ITABIRA (MG)";"MG";"SANTA MARIA DE ITABIRA";133;18;53;204
2013;"SANTA MARIA DO SALTO (MG)";"MG";"SANTA MARIA DO SALTO";10;6;6;22
2013;"SANTA MARIA DO SUACUI (MG)";"MG";"SANTA MARIA DO SUACUI";92;7;50;149
2013;"SANTA RITA DE CALDAS (MG)";"MG";"SANTA RITA DE CALDAS";303;33;18;354
2013;"SANTA RITA DE IBITIPOCA (MG)";"MG";"SANTA RITA DE IBITIPOCA";46;9;4;59
2013;"SANTA RITA DE JACUTINGA (MG)";"MG";"SANTA RITA DE JACUTINGA";84;11;8;103
2013;"SANTA RITA DE MINAS (MG)";"MG";"SANTA RITA DE MINAS";110;13;14;137
2013;"SANTA RITA DO ITUETO (MG)";"MG";"SANTA RITA DO ITUETO";78;8;18;104
2013;"SANTA RITA DO SAPUCAI (MG)";"MG";"SANTA RITA DO SAPUCAI";431;82;93;606
2013;"SANTA ROSA DA SERRA (MG)";"MG";"SANTA ROSA DA SERRA";48;9;13;70
2013;"SANTA VITORIA (MG)";"MG";"SANTA VITORIA";429;34;44;507
2013;"SANTANA DA VARGEM (MG)";"MG";"SANTANA DA VARGEM";94;14;24;132
2013;"SANTANA DE CATAGUASES (MG)";"MG";"SANTANA DE CATAGUASES";34;13;6;53
2013;"SANTANA DE PIRAPAMA (MG)";"MG";"SANTANA DE PIRAPAMA";74;3;36;113
2013;"SANTANA DO DESERTO (MG)";"MG";"SANTANA DO DESERTO";60;13;11;84
2013;"SANTANA DO GARAMBEU (MG)";"MG";"SANTANA DO GARAMBEU";12;5;6;23
2013;"SANTANA DO JACARE (MG)";"MG";"SANTANA DO JACARE";48;8;16;72
2013;"SANTANA DO MANHUACU (MG)";"MG";"SANTANA DO MANHUACU";194;9;23;226
2013;"SANTANA DO PARAISO (MG)";"MG";"SANTANA DO PARAISO";127;19;30;176
2013;"SANTANA DO RIACHO (MG)";"MG";"SANTANA DO RIACHO";37;8;7;52
2013;"SANTANA DOS MONTES (MG)";"MG";"SANTANA DOS MONTES";32;7;6;45
2013;"SANTO ANTONIO DO AMPARO (MG)";"MG";"SANTO ANTONIO DO AMPARO";250;51;96;397
2013;"SANTO ANTONIO DO AVENTUREIRO (MG)";"MG";"SANTO ANTONIO DO AVENTUREIRO";59;4;10;73
2013;"SANTO ANTONIO DO GRAMA (MG)";"MG";"SANTO ANTONIO DO GRAMA";53;9;14;76
2013;"SANTO ANTONIO DO ITAMBE (MG)";"MG";"SANTO ANTONIO DO ITAMBE";17;7;9;33
2013;"SANTO ANTONIO DO JACINTO (MG)";"MG";"SANTO ANTONIO DO JACINTO";38;3;41;82
2013;"SANTO ANTONIO DO MONTE (MG)";"MG";"SANTO ANTONIO DO MONTE";542;69;105;716
2013;"SANTO ANTONIO DO RETIRO (MG)";"MG";"SANTO ANTONIO DO RETIRO";39;5;26;70
2013;"SANTO ANTONIO DO RIO ABAIXO (MG)";"MG";"SANTO ANTONIO DO RIO ABAIXO";9;9;7;25
2013;"SANTO HIPOLITO (MG)";"MG";"SANTO HIPOLITO";22;5;4;31
2013;"SANTOS DUMONT (MG)";"MG";"SANTOS DUMONT";420;106;163;689
2013;"SAO BENTO ABADE (MG)";"MG";"SAO BENTO ABADE";41;18;17;76
2013;"SAO BRAS DO SUACUI (MG)";"MG";"SAO BRAS DO SUACUI";54;5;7;66
2013;"SAO DOMINGOS DAS DORES (MG)";"MG";"SAO DOMINGOS DAS DORES";103;8;13;124
2013;"SAO DOMINGOS DO PRATA (MG)";"MG";"SAO DOMINGOS DO PRATA";282;18;61;361
2013;"SAO FELIX DE MINAS (MG)";"MG";"SAO FELIX DE MINAS";21;2;13;36
2013;"SAO FRANCISCO (MG)";"MG";"SAO FRANCISCO";264;24;124;412
2013;"SAO FRANCISCO DE PAULA (MG)";"MG";"SAO FRANCISCO DE PAULA";70;22;18;110
2013;"SAO FRANCISCO DE SALES (MG)";"MG";"SAO FRANCISCO DE SALES";74;10;21;105
2013;"SAO FRANCISCO DO GLORIA (MG)";"MG";"SAO FRANCISCO DO GLORIA";61;11;10;82
2013;"SAO GERALDO (MG)";"MG";"SAO GERALDO";182;11;12;205
2013;"SAO GERALDO DA PIEDADE (MG)";"MG";"SAO GERALDO DA PIEDADE";13;6;7;26
2013;"SAO GERALDO DO BAIXIO (MG)";"MG";"SAO GERALDO DO BAIXIO";17;6;9;32
2013;"SAO GONCALO DO ABAETE (MG)";"MG";"SAO GONCALO DO ABAETE";91;15;19;125
2013;"SAO GONCALO DO PARA (MG)";"MG";"SAO GONCALO DO PARA";204;15;18;237
2013;"SAO GONCALO DO RIO ABAIXO (MG)";"MG";"SAO GONCALO DO RIO ABAIXO";208;53;34;295
2013;"SAO GONCALO DO RIO PRETO (MG)";"MG";"SAO GONCALO DO RIO PRETO";29;9;6;44
2013;"SAO GONCALO DO SAPUCAI (MG)";"MG";"SAO GONCALO DO SAPUCAI";430;54;78;562
2013;"SAO GOTARDO (MG)";"MG";"SAO GOTARDO";898;87;234;1219
2013;"SAO JOAO BATISTA DO GLORIA (MG)";"MG";"SAO JOAO BATISTA DO GLORIA";139;12;14;165
2013;"SAO JOAO DA LAGOA (MG)";"MG";"SAO JOAO DA LAGOA";34;11;15;60
2013;"SAO JOAO DA MATA (MG)";"MG";"SAO JOAO DA MATA";58;20;3;81
2013;"SAO JOAO DA PONTE (MG)";"MG";"SAO JOAO DA PONTE";72;12;64;148
2013;"SAO JOAO DAS MISSOES (MG)";"MG";"SAO JOAO DAS MISSOES";29;3;19;51
2013;"SAO JOAO DEL REI (MG)";"MG";"SAO JOAO DEL REI";1196;202;226;1624
2013;"SAO JOAO DO MANHUACU (MG)";"MG";"SAO JOAO DO MANHUACU";143;18;26;187
2013;"SAO JOAO DO MANTENINHA (MG)";"MG";"SAO JOAO DO MANTENINHA";93;12;5;110
2013;"SAO JOAO DO ORIENTE (MG)";"MG";"SAO JOAO DO ORIENTE";110;12;4;126
2013;"SAO JOAO DO PACUI (MG)";"MG";"SAO JOAO DO PACUI";14;2;4;20
2013;"SAO JOAO DO PARAISO (MG)";"MG";"SAO JOAO DO PARAISO";208;18;79;305
2013;"SAO JOAO EVANGELISTA (MG)";"MG";"SAO JOAO EVANGELISTA";118;12;48;178
2013;"SAO JOAO NEPOMUCENO (MG)";"MG";"SAO JOAO NEPOMUCENO";280;35;26;341
2013;"SAO JOAQUIM DE BICAS (MG)";"MG";"SAO JOAQUIM DE BICAS";617;79;45;741
2013;"SAO JOSE DA BARRA (MG)";"MG";"SAO JOSE DA BARRA";104;14;28;146
2013;"SAO JOSE DA LAPA (MG)";"MG";"SAO JOSE DA LAPA";295;50;33;378
2013;"SAO JOSE DA SAFIRA (MG)";"MG";"SAO JOSE DA SAFIRA";8;1;5;14
2013;"SAO JOSE DA VARGINHA (MG)";"MG";"SAO JOSE DA VARGINHA";60;3;21;84
2013;"SAO JOSE DO ALEGRE (MG)";"MG";"SAO JOSE DO ALEGRE";44;7;7;58
2013;"SAO JOSE DO DIVINO (MG)";"MG";"SAO JOSE DO DIVINO";18;5;14;37
2013;"SAO JOSE DO GOIABAL (MG)";"MG";"SAO JOSE DO GOIABAL";38;13;31;82
2013;"SAO JOSE DO JACURI (MG)";"MG";"SAO JOSE DO JACURI";25;5;6;36
2013;"SAO JOSE DO MANTIMENTO (MG)";"MG";"SAO JOSE DO MANTIMENTO";37;3;4;44
2013;"SAO LOURENCO (MG)";"MG";"SAO LOURENCO";540;75;54;669
2013;"SAO MIGUEL DO ANTA (MG)";"MG";"SAO MIGUEL DO ANTA";89;10;12;111
2013;"SAO PEDRO DA UNIAO (MG)";"MG";"SAO PEDRO DA UNIAO";113;17;12;142
2013;"SAO PEDRO DO SUACUI (MG)";"MG";"SAO PEDRO DO SUACUI";29;3;9;41
2013;"SAO PEDRO DOS FERROS (MG)";"MG";"SAO PEDRO DOS FERROS";110;10;38;158
2013;"SAO ROMAO (MG)";"MG";"SAO ROMAO";38;2;10;50
2013;"SAO ROQUE DE MINAS (MG)";"MG";"SAO ROQUE DE MINAS";183;12;20;215
2013;"SAO SEBASTIAO DA BELA VISTA (MG)";"MG";"SAO SEBASTIAO DA BELA VISTA";70;13;16;99
2013;"SAO SEBASTIAO DA VARGEM ALEGRE (MG)";"MG";"SAO SEBASTIAO DA VARGEM ALEGRE";28;4;8;40
2013;"SAO SEBASTIAO DO ANTA (MG)";"MG";"SAO SEBASTIAO DO ANTA";55;7;6;68
2013;"SAO SEBASTIAO DO MARANHAO (MG)";"MG";"SAO SEBASTIAO DO MARANHAO";28;7;14;49
2013;"SAO SEBASTIAO DO OESTE (MG)";"MG";"SAO SEBASTIAO DO OESTE";150;6;17;173
2013;"SAO SEBASTIAO DO PARAISO (MG)";"MG";"SAO SEBASTIAO DO PARAISO";1595;131;207;1933
2013;"SAO SEBASTIAO DO RIO PRETO (MG)";"MG";"SAO SEBASTIAO DO RIO PRETO";10;6;4;20
2013;"SAO SEBASTIAO DO RIO VERDE (MG)";"MG";"SAO SEBASTIAO DO RIO VERDE";14;2;5;21
2013;"SAO TIAGO (MG)";"MG";"SAO TIAGO";192;18;20;230
2013;"SAO TOMAS DE AQUINO (MG)";"MG";"SAO TOMAS DE AQUINO";87;28;14;129
2013;"SAO TOME DAS LETRAS (MG)";"MG";"SAO TOME DAS LETRAS";96;12;19;127
2013;"SAO VICENTE DE MINAS (MG)";"MG";"SAO VICENTE DE MINAS";110;21;4;135
2013;"SAPUCAI MIRIM (MG)";"MG";"SAPUCAI MIRIM";221;42;12;275
2013;"SARDOA (MG)";"MG";"SARDOA";48;8;10;66
2013;"SARZEDO (MG)";"MG";"SARZEDO";706;56;76;838
2013;"SEM PEIXE (MG)";"MG";"SEM PEIXE";15;4;12;31
2013;"SENADOR AMARAL (MG)";"MG";"SENADOR AMARAL";108;11;10;129
2013;"SENADOR CORTES (MG)";"MG";"SENADOR CORTES";19;7;3;29
2013;"SENADOR FIRMINO (MG)";"MG";"SENADOR FIRMINO";109;10;24;143
2013;"SENADOR JOSE BENTO (MG)";"MG";"SENADOR JOSE BENTO";14;2;10;26
2013;"SENADOR MODESTINO GONCALVES (MG)";"MG";"SENADOR MODESTINO GONCALVES";26;5;13;44
2013;"SENHORA DE OLIVEIRA (MG)";"MG";"SENHORA DE OLIVEIRA";64;2;16;82
2013;"SENHORA DO PORTO (MG)";"MG";"SENHORA DO PORTO";26;6;12;44
2013;"SENHORA DOS REMEDIOS (MG)";"MG";"SENHORA DOS REMEDIOS";106;36;24;166
2013;"SERICITA (MG)";"MG";"SERICITA";98;3;7;108
2013;"SERITINGA (MG)";"MG";"SERITINGA";23;2;3;28
2013;"SERRA AZUL DE MINAS (MG)";"MG";"SERRA AZUL DE MINAS";15;7;11;33
2013;"SERRA DA SAUDADE (MG)";"MG";"SERRA DA SAUDADE";5;7;2;14
2013;"SERRA DO SALITRE (MG)";"MG";"SERRA DO SALITRE";254;16;83;353
2013;"SERRA DOS AIMORES (MG)";"MG";"SERRA DOS AIMORES";73;5;24;102
2013;"SERRANIA (MG)";"MG";"SERRANIA";129;22;20;171
2013;"SERRANOPOLIS DE MINAS (MG)";"MG";"SERRANOPOLIS DE MINAS";16;0;19;35
2013;"SERRANOS (MG)";"MG";"SERRANOS";18;6;4;28
2013;"SERRO (MG)";"MG";"SERRO";176;29;68;273
2013;"SETE LAGOAS (MG)";"MG";"SETE LAGOAS";3449;441;674;4564
2013;"SETUBINHA (MG)";"MG";"SETUBINHA";22;5;26;53
2013;"SILVEIRANIA (MG)";"MG";"SILVEIRANIA";16;4;5;25
2013;"SILVIANOPOLIS (MG)";"MG";"SILVIANOPOLIS";94;9;12;115
2013;"SIMAO PEREIRA (MG)";"MG";"SIMAO PEREIRA";50;11;6;67
2013;"SIMONESIA (MG)";"MG";"SIMONESIA";234;14;43;291
2013;"SOBRALIA (MG)";"MG";"SOBRALIA";43;7;9;59
2013;"SOLEDADE DE MINAS (MG)";"MG";"SOLEDADE DE MINAS";52;9;1;62
2013;"TABULEIRO (MG)";"MG";"TABULEIRO";77;8;9;94
2013;"TAIOBEIRAS (MG)";"MG";"TAIOBEIRAS";691;37;169;897
2013;"TAPARUBA (MG)";"MG";"TAPARUBA";28;3;10;41
2013;"TAPIRA (MG)";"MG";"TAPIRA";47;9;18;74
2013;"TAPIRAI (MG)";"MG";"TAPIRAI";15;8;3;26
2013;"TAQUARACU DE MINAS (MG)";"MG";"TAQUARACU DE MINAS";93;8;12;113
2013;"TARUMIRIM (MG)";"MG";"TARUMIRIM";129;18;26;173
2013;"TEIXEIRAS (MG)";"MG";"TEIXEIRAS";153;13;18;184
2013;"TEOFILO OTONI (MG)";"MG";"TEOFILO OTONI";1537;179;178;1894
2013;"TIMOTEO (MG)";"MG";"TIMOTEO";1019;204;138;1361
2013;"TIRADENTES (MG)";"MG";"TIRADENTES";85;18;11;114
2013;"TIROS (MG)";"MG";"TIROS";156;19;13;188
2013;"TOCANTINS (MG)";"MG";"TOCANTINS";266;11;19;296
2013;"TOCOS DO MOJI (MG)";"MG";"TOCOS DO MOJI";54;13;10;77
2013;"TOLEDO (MG)";"MG";"TOLEDO";103;9;15;127
2013;"TOMBOS (MG)";"MG";"TOMBOS";111;31;28;170
2013;"TRES CORACOES (MG)";"MG";"TRES CORACOES";974;98;219;1291
2013;"TRES MARIAS (MG)";"MG";"TRES MARIAS";393;44;100;537
2013;"TRES PONTAS (MG)";"MG";"TRES PONTAS";886;121;204;1211
2013;"TUMIRITINGA (MG)";"MG";"TUMIRITINGA";33;6;7;46
2013;"TUPACIGUARA (MG)";"MG";"TUPACIGUARA";524;86;74;684
2013;"TURMALINA (MG)";"MG";"TURMALINA";340;42;60;442
2013;"TURVOLANDIA (MG)";"MG";"TURVOLANDIA";104;34;5;143
2013;"UBA (MG)";"MG";"UBA";2089;97;187;2373
2013;"UBAI (MG)";"MG";"UBAI";38;10;28;76
2013;"UBAPORANGA (MG)";"MG";"UBAPORANGA";167;12;25;204
2013;"UBERABA (MG)";"MG";"UBERABA";5034;1004;1025;7063
2013;"UBERLANDIA (MG)";"MG";"UBERLANDIA";11938;1167;1442;14547
2013;"UMBURATIBA (MG)";"MG";"UMBURATIBA";6;4;3;13
2013;"UNAI (MG)";"MG";"UNAI";1456;81;374;1911
2013;"UNIAO DE MINAS (MG)";"MG";"UNIAO DE MINAS";48;8;38;94
2013;"URUANA DE MINAS (MG)";"MG";"URUANA DE MINAS";19;4;13;36
2013;"URUCANIA (MG)";"MG";"URUCANIA";150;12;47;209
2013;"URUCUIA (MG)";"MG";"URUCUIA";77;7;29;113
2013;"VARGEM ALEGRE (MG)";"MG";"VARGEM ALEGRE";67;7;10;84
2013;"VARGEM BONITA (MG)";"MG";"VARGEM BONITA";39;3;6;48
2013;"VARGEM GRANDE DO RIO PARDO (MG)";"MG";"VARGEM GRANDE DO RIO PARDO";53;5;15;73
2013;"VARGINHA (MG)";"MG";"VARGINHA";1970;181;307;2458
2013;"VARJAO DE MINAS (MG)";"MG";"VARJAO DE MINAS";94;12;49;155
2013;"VARZEA DA PALMA (MG)";"MG";"VARZEA DA PALMA";472;22;95;589
2013;"VARZELANDIA (MG)";"MG";"VARZELANDIA";63;12;43;118
2013;"VAZANTE (MG)";"MG";"VAZANTE";340;39;99;478
2013;"VERDELANDIA (MG)";"MG";"VERDELANDIA";15;2;9;26
2013;"VEREDINHA (MG)";"MG";"VEREDINHA";47;11;22;80
2013;"VERISSIMO (MG)";"MG";"VERISSIMO";37;28;6;71
2013;"VERMELHO NOVO (MG)";"MG";"VERMELHO NOVO";97;10;28;135
2013;"VESPASIANO (MG)";"MG";"VESPASIANO";1019;207;159;1385
2013;"VICOSA (MG)";"MG";"VICOSA";686;162;194;1042
2013;"VIEIRAS (MG)";"MG";"VIEIRAS";42;13;6;61
2013;"VIRGEM DA LAPA (MG)";"MG";"VIRGEM DA LAPA";69;12;24;105
2013;"VIRGINIA (MG)";"MG";"VIRGINIA";152;17;6;175
2013;"VIRGINOPOLIS (MG)";"MG";"VIRGINOPOLIS";99;6;30;135
2013;"VIRGOLANDIA (MG)";"MG";"VIRGOLANDIA";21;6;9;36
2013;"VISCONDE DO RIO BRANCO (MG)";"MG";"VISCONDE DO RIO BRANCO";1002;53;66;1121
2013;"VOLTA GRANDE (MG)";"MG";"VOLTA GRANDE";47;11;7;65
2013;"WENCESLAU BRAZ (MG)";"MG";"WENCESLAU BRAZ";39;7;9;55
2013;"AGUA CLARA (MS)";"MS";"AGUA CLARA";404;30;105;539
2013;"ALCINOPOLIS (MS)";"MS";"ALCINOPOLIS";91;21;16;128
2013;"AMAMBAI (MS)";"MS";"AMAMBAI";709;26;60;795
2013;"ANASTACIO (MS)";"MS";"ANASTACIO";389;26;30;445
2013;"ANAURILANDIA (MS)";"MS";"ANAURILANDIA";104;18;59;181
2013;"ANGELICA (MS)";"MS";"ANGELICA";265;48;55;368
2013;"ANTONIO JOAO (MS)";"MS";"ANTONIO JOAO";118;5;30;153
2013;"APARECIDA DO TABOADO (MS)";"MS";"APARECIDA DO TABOADO";443;37;59;539
2013;"AQUIDAUANA (MS)";"MS";"AQUIDAUANA";353;23;75;451
2013;"ARAL MOREIRA (MS)";"MS";"ARAL MOREIRA";203;13;28;244
2013;"BANDEIRANTES (MS)";"MS";"BANDEIRANTES";170;11;49;230
2013;"BATAGUASSU (MS)";"MS";"BATAGUASSU";496;44;184;724
2013;"BATAYPORA (MS)";"MS";"BATAYPORA";174;17;32;223
2013;"BELA VISTA (MS)";"MS";"BELA VISTA";267;36;57;360
2013;"BODOQUENA (MS)";"MS";"BODOQUENA";93;23;38;154
2013;"BONITO (MS)";"MS";"BONITO";274;73;59;406
2013;"BRASILANDIA (MS)";"MS";"BRASILANDIA";264;34;71;369
2013;"CAARAPO (MS)";"MS";"CAARAPO";574;14;136;724
2013;"CAMAPUA (MS)";"MS";"CAMAPUA";342;39;46;427
2013;"CAMPO GRANDE (MS)";"MS";"CAMPO GRANDE";13862;923;2191;16976
2013;"CARACOL (MS)";"MS";"CARACOL";56;17;13;86
2013;"CASSILANDIA (MS)";"MS";"CASSILANDIA";480;17;48;545
2013;"CHAPADAO DO SUL (MS)";"MS";"CHAPADAO DO SUL";827;27;113;967
2013;"CORGUINHO (MS)";"MS";"CORGUINHO";61;13;24;98
2013;"CORONEL SAPUCAIA (MS)";"MS";"CORONEL SAPUCAIA";310;9;30;349
2013;"CORUMBA (MS)";"MS";"CORUMBA";888;75;208;1171
2013;"COSTA RICA (MS)";"MS";"COSTA RICA";497;20;142;659
2013;"COXIM (MS)";"MS";"COXIM";606;19;73;698
2013;"DEODAPOLIS (MS)";"MS";"DEODAPOLIS";245;25;97;367
2013;"DOIS IRMAOS DO BURITI (MS)";"MS";"DOIS IRMAOS DO BURITI";132;20;32;184
2013;"DOURADINA (MS)";"MS";"DOURADINA";222;9;25;256
2013;"DOURADOS (MS)";"MS";"DOURADOS";4010;210;458;4678
2013;"ELDORADO (MS)";"MS";"ELDORADO";263;15;38;316
2013;"FATIMA DO SUL (MS)";"MS";"FATIMA DO SUL";425;12;32;469
2013;"FIGUEIRAO (MS)";"MS";"FIGUEIRAO";40;21;5;66
2013;"GLORIA DE DOURADOS (MS)";"MS";"GLORIA DE DOURADOS";202;11;39;252
2013;"GUIA LOPES DA LAGUNA (MS)";"MS";"GUIA LOPES DA LAGUNA";178;18;32;228
2013;"IGUATEMI (MS)";"MS";"IGUATEMI";239;9;72;320
2013;"INOCENCIA (MS)";"MS";"INOCENCIA";175;2;36;213
2013;"ITAPORA (MS)";"MS";"ITAPORA";423;25;48;496
2013;"ITAQUIRAI (MS)";"MS";"ITAQUIRAI";229;14;100;343
2013;"IVINHEMA (MS)";"MS";"IVINHEMA";614;37;200;851
2013;"JAPORA (MS)";"MS";"JAPORA";30;4;20;54
2013;"JARAGUARI (MS)";"MS";"JARAGUARI";74;7;19;100
2013;"JARDIM (MS)";"MS";"JARDIM";465;32;47;544
2013;"JATEI (MS)";"MS";"JATEI";52;8;81;141
2013;"JUTI (MS)";"MS";"JUTI";72;9;20;101
2013;"LADARIO (MS)";"MS";"LADARIO";144;20;64;228
2013;"LAGUNA CARAPA (MS)";"MS";"LAGUNA CARAPA";185;3;25;213
2013;"MARACAJU (MS)";"MS";"MARACAJU";1006;28;130;1164
2013;"MIRANDA (MS)";"MS";"MIRANDA";338;25;83;446
2013;"MUNDO NOVO (MS)";"MS";"MUNDO NOVO";303;37;20;360
2013;"NAVIRAI (MS)";"MS";"NAVIRAI";903;45;176;1124
2013;"NIOAQUE (MS)";"MS";"NIOAQUE";153;24;59;236
2013;"NOVA ALVORADA DO SUL (MS)";"MS";"NOVA ALVORADA DO SUL";377;33;76;486
2013;"NOVA ANDRADINA (MS)";"MS";"NOVA ANDRADINA";1030;30;237;1297
2013;"NOVO HORIZONTE DO SUL (MS)";"MS";"NOVO HORIZONTE DO SUL";74;9;25;108
2013;"PARAISO DAS AGUAS (MS)";"MS";"PARAISO DAS AGUAS";12;10;4;26
2013;"PARANAIBA (MS)";"MS";"PARANAIBA";891;41;114;1046
2013;"PARANHOS (MS)";"MS";"PARANHOS";120;5;31;156
2013;"PEDRO GOMES (MS)";"MS";"PEDRO GOMES";96;5;14;115
2013;"PONTA PORA (MS)";"MS";"PONTA PORA";1846;84;289;2219
2013;"PORTO MURTINHO (MS)";"MS";"PORTO MURTINHO";75;10;25;110
2013;"RIBAS DO RIO PARDO (MS)";"MS";"RIBAS DO RIO PARDO";602;44;68;714
2013;"RIO BRILHANTE (MS)";"MS";"RIO BRILHANTE";728;62;142;932
2013;"RIO NEGRO (MS)";"MS";"RIO NEGRO";74;13;13;100
2013;"RIO VERDE DE MATO GROSSO (MS)";"MS";"RIO VERDE DE MATO GROSSO";375;21;30;426
2013;"ROCHEDO (MS)";"MS";"ROCHEDO";59;3;11;73
2013;"SANTA RITA DO PARDO (MS)";"MS";"SANTA RITA DO PARDO";124;7;33;164
2013;"SAO GABRIEL DO OESTE (MS)";"MS";"SAO GABRIEL DO OESTE";917;24;68;1009
2013;"SELVIRIA (MS)";"MS";"SELVIRIA";100;15;23;138
2013;"SETE QUEDAS (MS)";"MS";"SETE QUEDAS";229;8;22;259
2013;"SIDROLANDIA (MS)";"MS";"SIDROLANDIA";696;93;234;1023
2013;"SONORA (MS)";"MS";"SONORA";226;20;96;342
2013;"TACURU (MS)";"MS";"TACURU";111;8;18;137
2013;"TAQUARUSSU (MS)";"MS";"TAQUARUSSU";44;4;14;62
2013;"TERENOS (MS)";"MS";"TERENOS";363;18;46;427
2013;"TRES LAGOAS (MS)";"MS";"TRES LAGOAS";1738;186;465;2389
2013;"VICENTINA (MS)";"MS";"VICENTINA";138;8;112;258
2013;"ACORIZAL (MT)";"MT";"ACORIZAL";17;4;3;24
2013;"AGUA BOA (MT)";"MT";"AGUA BOA";601;15;45;661
2013;"ALTA FLORESTA (MT)";"MT";"ALTA FLORESTA";1270;23;104;1397
2013;"ALTO ARAGUAIA (MT)";"MT";"ALTO ARAGUAIA";180;21;34;235
2013;"ALTO BOA VISTA (MT)";"MT";"ALTO BOA VISTA";51;1;7;59
2013;"ALTO GARCAS (MT)";"MT";"ALTO GARCAS";282;15;48;345
2013;"ALTO PARAGUAI (MT)";"MT";"ALTO PARAGUAI";37;7;8;52
2013;"ALTO TAQUARI (MT)";"MT";"ALTO TAQUARI";232;25;22;279
2013;"APIACAS (MT)";"MT";"APIACAS";116;9;9;134
2013;"ARAGUAIANA (MT)";"MT";"ARAGUAIANA";13;0;3;16
2013;"ARAGUAINHA (MT)";"MT";"ARAGUAINHA";6;1;1;8
2013;"ARAPUTANGA (MT)";"MT";"ARAPUTANGA";265;11;25;301
2013;"ARENAPOLIS (MT)";"MT";"ARENAPOLIS";196;11;61;268
2013;"ARIPUANA (MT)";"MT";"ARIPUANA";384;10;44;438
2013;"BARAO DE MELGACO (MT)";"MT";"BARAO DE MELGACO";12;4;4;20
2013;"BARRA DO BUGRES (MT)";"MT";"BARRA DO BUGRES";532;23;144;699
2013;"BARRA DO GARCAS (MT)";"MT";"BARRA DO GARCAS";853;34;188;1075
2013;"BOM JESUS DO ARAGUAIA (MT)";"MT";"BOM JESUS DO ARAGUAIA";43;1;14;58
2013;"BRASNORTE (MT)";"MT";"BRASNORTE";322;8;64;394
2013;"CACERES (MT)";"MT";"CACERES";839;50;276;1165
2013;"CAMPINAPOLIS (MT)";"MT";"CAMPINAPOLIS";79;4;15;98
2013;"CAMPO NOVO DO PARECIS (MT)";"MT";"CAMPO NOVO DO PARECIS";734;38;119;891
2013;"CAMPO VERDE (MT)";"MT";"CAMPO VERDE";913;54;128;1095
2013;"CAMPOS DE JULIO (MT)";"MT";"CAMPOS DE JULIO";176;14;34;224
2013;"CANABRAVA DO NORTE (MT)";"MT";"CANABRAVA DO NORTE";38;0;7;45
2013;"CANARANA (MT)";"MT";"CANARANA";534;15;26;575
2013;"CARLINDA (MT)";"MT";"CARLINDA";126;0;22;148
2013;"CASTANHEIRA (MT)";"MT";"CASTANHEIRA";126;2;21;149
2013;"CHAPADA DOS GUIMARAES (MT)";"MT";"CHAPADA DOS GUIMARAES";215;23;49;287
2013;"CLAUDIA (MT)";"MT";"CLAUDIA";416;6;25;447
2013;"COCALINHO (MT)";"MT";"COCALINHO";29;1;9;39
2013;"COLIDER (MT)";"MT";"COLIDER";856;20;107;983
2013;"COLNIZA (MT)";"MT";"COLNIZA";325;0;22;347
2013;"COMODORO (MT)";"MT";"COMODORO";507;9;81;597
2013;"CONFRESA (MT)";"MT";"CONFRESA";235;6;53;294
2013;"CONQUISTA D OESTE (MT)";"MT";"CONQUISTA D OESTE";30;2;13;45
2013;"COTRIGUACU (MT)";"MT";"COTRIGUACU";143;5;41;189
2013;"CUIABA (MT)";"MT";"CUIABA";9610;798;2908;13316
2013;"CURVELANDIA (MT)";"MT";"CURVELANDIA";73;0;14;87
2013;"DENISE (MT)";"MT";"DENISE";73;5;33;111
2013;"DIAMANTINO (MT)";"MT";"DIAMANTINO";496;19;67;582
2013;"DOM AQUINO (MT)";"MT";"DOM AQUINO";118;8;21;147
2013;"FELIZ NATAL (MT)";"MT";"FELIZ NATAL";249;4;25;278
2013;"FIGUEIROPOLIS D OESTE (MT)";"MT";"FIGUEIROPOLIS D OESTE";71;4;9;84
2013;"GAUCHA DO NORTE (MT)";"MT";"GAUCHA DO NORTE";94;5;21;120
2013;"GENERAL CARNEIRO (MT)";"MT";"GENERAL CARNEIRO";24;5;6;35
2013;"GLORIA D OESTE (MT)";"MT";"GLORIA D OESTE";59;3;17;79
2013;"GUARANTA DO NORTE (MT)";"MT";"GUARANTA DO NORTE";918;13;69;1000
2013;"GUIRATINGA (MT)";"MT";"GUIRATINGA";179;10;14;203
2013;"INDIAVAI (MT)";"MT";"INDIAVAI";16;2;7;25
2013;"IPIRANGA DO NORTE (MT)";"MT";"IPIRANGA DO NORTE";151;3;9;163
2013;"ITANHANGA (MT)";"MT";"ITANHANGA";167;1;17;185
2013;"ITAUBA (MT)";"MT";"ITAUBA";130;6;11;147
2013;"ITIQUIRA (MT)";"MT";"ITIQUIRA";119;21;52;192
2013;"JACIARA (MT)";"MT";"JACIARA";604;44;141;789
2013;"JANGADA (MT)";"MT";"JANGADA";49;9;18;76
2013;"JAURU (MT)";"MT";"JAURU";148;8;39;195
2013;"JUARA (MT)";"MT";"JUARA";785;20;63;868
2013;"JUINA (MT)";"MT";"JUINA";895;18;76;989
2013;"JURUENA (MT)";"MT";"JURUENA";189;2;17;208
2013;"JUSCIMEIRA (MT)";"MT";"JUSCIMEIRA";139;6;54;199
2013;"LAMBARI D OESTE (MT)";"MT";"LAMBARI D OESTE";79;3;28;110
2013;"LUCAS DO RIO VERDE (MT)";"MT";"LUCAS DO RIO VERDE";1594;52;134;1780
2013;"LUCIARA (MT)";"MT";"LUCIARA";10;0;2;12
2013;"MARCELANDIA (MT)";"MT";"MARCELANDIA";374;7;19;400
2013;"MATUPA (MT)";"MT";"MATUPA";386;10;44;440
2013;"MIRASSOL D OESTE (MT)";"MT";"MIRASSOL D OESTE";723;8;84;815
2013;"NOBRES (MT)";"MT";"NOBRES";303;21;63;387
2013;"NORTELANDIA (MT)";"MT";"NORTELANDIA";77;9;15;101
2013;"NOSSA SENHORA DO LIVRAMENTO (MT)";"MT";"NOSSA SENHORA DO LIVRAMENTO";88;5;32;125
2013;"NOVA BANDEIRANTES (MT)";"MT";"NOVA BANDEIRANTES";173;3;29;205
2013;"NOVA BRASILANDIA (MT)";"MT";"NOVA BRASILANDIA";60;2;12;74
2013;"NOVA CANAA DO NORTE (MT)";"MT";"NOVA CANAA DO NORTE";218;8;62;288
2013;"NOVA GUARITA (MT)";"MT";"NOVA GUARITA";89;1;17;107
2013;"NOVA LACERDA (MT)";"MT";"NOVA LACERDA";113;1;30;144
2013;"NOVA MARILANDIA (MT)";"MT";"NOVA MARILANDIA";30;5;7;42
2013;"NOVA MARINGA (MT)";"MT";"NOVA MARINGA";122;2;11;135
2013;"NOVA MONTE VERDE (MT)";"MT";"NOVA MONTE VERDE";137;6;12;155
2013;"NOVA MUTUM (MT)";"MT";"NOVA MUTUM";1032;14;103;1149
2013;"NOVA NAZARE (MT)";"MT";"NOVA NAZARE";6;3;4;13
2013;"NOVA OLIMPIA (MT)";"MT";"NOVA OLIMPIA";337;14;136;487
2013;"NOVA SANTA HELENA (MT)";"MT";"NOVA SANTA HELENA";65;4;11;80
2013;"NOVA UBIRATA (MT)";"MT";"NOVA UBIRATA";174;17;29;220
2013;"NOVA XAVANTINA (MT)";"MT";"NOVA XAVANTINA";410;20;42;472
2013;"NOVO HORIZONTE DO NORTE (MT)";"MT";"NOVO HORIZONTE DO NORTE";44;1;15;60
2013;"NOVO MUNDO (MT)";"MT";"NOVO MUNDO";97;3;21;121
2013;"NOVO SANTO ANTONIO (MT)";"MT";"NOVO SANTO ANTONIO";1;0;2;3
2013;"NOVO SAO JOAQUIM (MT)";"MT";"NOVO SAO JOAQUIM";90;0;14;104
2013;"PARANAITA (MT)";"MT";"PARANAITA";204;10;81;295
2013;"PARANATINGA (MT)";"MT";"PARANATINGA";438;15;68;521
2013;"PEDRA PRETA (MT)";"MT";"PEDRA PRETA";320;11;45;376
2013;"PEIXOTO DE AZEVEDO (MT)";"MT";"PEIXOTO DE AZEVEDO";389;11;71;471
2013;"PLANALTO DA SERRA (MT)";"MT";"PLANALTO DA SERRA";18;1;9;28
2013;"POCONE (MT)";"MT";"POCONE";449;24;33;506
2013;"PONTAL DO ARAGUAIA (MT)";"MT";"PONTAL DO ARAGUAIA";21;2;2;25
2013;"PONTE BRANCA (MT)";"MT";"PONTE BRANCA";6;1;1;8
2013;"PONTES E LACERDA (MT)";"MT";"PONTES E LACERDA";916;25;115;1056
2013;"PORTO ALEGRE DO NORTE (MT)";"MT";"PORTO ALEGRE DO NORTE";65;6;34;105
2013;"PORTO DOS GAUCHOS (MT)";"MT";"PORTO DOS GAUCHOS";112;10;9;131
2013;"PORTO ESPERIDIAO (MT)";"MT";"PORTO ESPERIDIAO";136;7;45;188
2013;"PORTO ESTRELA (MT)";"MT";"PORTO ESTRELA";20;3;8;31
2013;"POXOREO (MT)";"MT";"POXOREO";117;19;44;180
2013;"PRIMAVERA DO LESTE (MT)";"MT";"PRIMAVERA DO LESTE";1928;88;171;2187
2013;"QUERENCIA (MT)";"MT";"QUERENCIA";319;19;27;365
2013;"RESERVA DO CABACAL (MT)";"MT";"RESERVA DO CABACAL";16;2;7;25
2013;"RIBEIRAO CASCALHEIRA (MT)";"MT";"RIBEIRAO CASCALHEIRA";115;12;16;143
2013;"RIBEIRAOZINHO (MT)";"MT";"RIBEIRAOZINHO";6;1;7;14
2013;"RIO BRANCO (MT)";"MT";"RIO BRANCO";80;4;29;113
2013;"RONDOLANDIA (MT)";"MT";"RONDOLANDIA";12;0;16;28
2013;"RONDONOPOLIS (MT)";"MT";"RONDONOPOLIS";4324;198;471;4993
2013;"ROSARIO OESTE (MT)";"MT";"ROSARIO OESTE";156;13;29;198
2013;"SALTO DO CEU (MT)";"MT";"SALTO DO CEU";46;6;21;73
2013;"SANTA CARMEM (MT)";"MT";"SANTA CARMEM";143;3;14;160
2013;"SANTA CRUZ DO XINGU (MT)";"MT";"SANTA CRUZ DO XINGU";10;1;4;15
2013;"SANTA RITA DO TRIVELATO (MT)";"MT";"SANTA RITA DO TRIVELATO";72;4;9;85
2013;"SANTA TEREZINHA (MT)";"MT";"SANTA TEREZINHA";9;1;16;26
2013;"SANTO AFONSO (MT)";"MT";"SANTO AFONSO";28;3;12;43
2013;"SANTO ANTONIO DO LESTE (MT)";"MT";"SANTO ANTONIO DO LESTE";65;3;16;84
2013;"SANTO ANTONIO DO LEVERGER (MT)";"MT";"SANTO ANTONIO DO LEVERGER";113;7;16;136
2013;"SAO FELIX DO ARAGUAIA (MT)";"MT";"SAO FELIX DO ARAGUAIA";43;7;22;72
2013;"SAO JOSE DO POVO (MT)";"MT";"SAO JOSE DO POVO";13;2;5;20
2013;"SAO JOSE DO RIO CLARO (MT)";"MT";"SAO JOSE DO RIO CLARO";313;16;53;382
2013;"SAO JOSE DO XINGU (MT)";"MT";"SAO JOSE DO XINGU";18;0;12;30
2013;"SAO JOSE DOS QUATRO MARCOS (MT)";"MT";"SAO JOSE DOS QUATRO MARCOS";457;11;64;532
2013;"SAO PEDRO DA CIPA (MT)";"MT";"SAO PEDRO DA CIPA";20;7;22;49
2013;"SAPEZAL (MT)";"MT";"SAPEZAL";557;42;84;683
2013;"SERRA NOVA DOURADA (MT)";"MT";"SERRA NOVA DOURADA";6;1;2;9
2013;"SINOP (MT)";"MT";"SINOP";3404;97;179;3680
2013;"SORRISO (MT)";"MT";"SORRISO";2297;64;174;2535
2013;"TABAPORA (MT)";"MT";"TABAPORA";146;4;28;178
2013;"TANGARA DA SERRA (MT)";"MT";"TANGARA DA SERRA";1943;82;201;2226
2013;"TAPURAH (MT)";"MT";"TAPURAH";326;5;32;363
2013;"TERRA NOVA DO NORTE (MT)";"MT";"TERRA NOVA DO NORTE";273;13;35;321
2013;"TESOURO (MT)";"MT";"TESOURO";13;2;3;18
2013;"TORIXOREU (MT)";"MT";"TORIXOREU";29;3;4;36
2013;"UNIAO DO SUL (MT)";"MT";"UNIAO DO SUL";99;0;11;110
2013;"VALE DE SAO DOMINGOS (MT)";"MT";"VALE DE SAO DOMINGOS";29;0;15;44
2013;"VARZEA GRANDE (MT)";"MT";"VARZEA GRANDE";4791;301;570;5662
2013;"VERA (MT)";"MT";"VERA";265;5;25;295
2013;"VILA BELA DA SANTISSIMA TRINDA (MT)";"MT";"VILA BELA DA SANTISSIMA TRINDA";110;2;35;147
2013;"VILA RICA (MT)";"MT";"VILA RICA";256;1;36;293
2013;"ABAETETUBA (PA)";"PA";"ABAETETUBA";329;23;264;616
2013;"ABEL FIGUEIREDO (PA)";"PA";"ABEL FIGUEIREDO";64;5;4;73
2013;"ACARA (PA)";"PA";"ACARA";78;7;69;154
2013;"AFUA (PA)";"PA";"AFUA";2;0;0;2
2013;"AGUA AZUL DO NORTE (PA)";"PA";"AGUA AZUL DO NORTE";60;8;22;90
2013;"ALENQUER (PA)";"PA";"ALENQUER";171;4;44;219
2013;"ALMEIRIM (PA)";"PA";"ALMEIRIM";252;20;113;385
2013;"ALTAMIRA (PA)";"PA";"ALTAMIRA";1807;156;350;2313
2013;"ANAJAS (PA)";"PA";"ANAJAS";0;0;1;1
2013;"ANANINDEUA (PA)";"PA";"ANANINDEUA";4439;422;1473;6334
2013;"ANAPU (PA)";"PA";"ANAPU";76;14;9;99
2013;"AUGUSTO CORREA (PA)";"PA";"AUGUSTO CORREA";45;2;55;102
2013;"AURORA DO PARA (PA)";"PA";"AURORA DO PARA";72;11;67;150
2013;"AVEIRO (PA)";"PA";"AVEIRO";3;0;4;7
2013;"BAGRE (PA)";"PA";"BAGRE";1;0;2;3
2013;"BAIAO (PA)";"PA";"BAIAO";39;2;16;57
2013;"BANNACH (PA)";"PA";"BANNACH";13;0;3;16
2013;"BARCARENA (PA)";"PA";"BARCARENA";888;185;646;1719
2013;"BELEM (PA)";"PA";"BELEM";8350;1718;3378;13446
2013;"BELTERRA (PA)";"PA";"BELTERRA";38;9;28;75
2013;"BENEVIDES (PA)";"PA";"BENEVIDES";704;57;114;875
2013;"BOM JESUS DO TOCANTINS (PA)";"PA";"BOM JESUS DO TOCANTINS";71;9;7;87
2013;"BONITO (PA)";"PA";"BONITO";60;5;42;107
2013;"BRAGANCA (PA)";"PA";"BRAGANCA";417;30;166;613
2013;"BRASIL NOVO (PA)";"PA";"BRASIL NOVO";175;18;12;205
2013;"BREJO GRANDE DO ARAGUAIA (PA)";"PA";"BREJO GRANDE DO ARAGUAIA";22;6;9;37
2013;"BREU BRANCO (PA)";"PA";"BREU BRANCO";260;7;86;353
2013;"BREVES (PA)";"PA";"BREVES";50;1;9;60
2013;"BUJARU (PA)";"PA";"BUJARU";45;9;24;78
2013;"CACHOEIRA DO ARARI (PA)";"PA";"CACHOEIRA DO ARARI";11;5;12;28
2013;"CACHOEIRA DO PIRIA (PA)";"PA";"CACHOEIRA DO PIRIA";34;4;22;60
2013;"CAMETA (PA)";"PA";"CAMETA";130;10;56;196
2013;"CANAA DOS CARAJAS (PA)";"PA";"CANAA DOS CARAJAS";276;66;125;467
2013;"CAPANEMA (PA)";"PA";"CAPANEMA";661;30;111;802
2013;"CAPITAO POCO (PA)";"PA";"CAPITAO POCO";348;26;78;452
2013;"CASTANHAL (PA)";"PA";"CASTANHAL";2612;164;392;3168
2013;"CHAVES (PA)";"PA";"CHAVES";0;0;0;0
2013;"COLARES (PA)";"PA";"COLARES";7;0;4;11
2013;"CONCEICAO DO ARAGUAIA (PA)";"PA";"CONCEICAO DO ARAGUAIA";353;40;70;463
2013;"CONCORDIA DO PARA (PA)";"PA";"CONCORDIA DO PARA";146;12;73;231
2013;"CUMARU DO NORTE (PA)";"PA";"CUMARU DO NORTE";23;1;7;31
2013;"CURIONOPOLIS (PA)";"PA";"CURIONOPOLIS";108;90;18;216
2013;"CURRALINHO (PA)";"PA";"CURRALINHO";1;0;2;3
2013;"CURUA (PA)";"PA";"CURUA";6;1;3;10
2013;"CURUCA (PA)";"PA";"CURUCA";50;12;16;78
2013;"DOM ELISEU (PA)";"PA";"DOM ELISEU";528;51;45;624
2013;"ELDORADO DOS CARAJAS (PA)";"PA";"ELDORADO DOS CARAJAS";155;45;15;215
2013;"FARO (PA)";"PA";"FARO";2;1;1;4
2013;"FLORESTA DO ARAGUAIA (PA)";"PA";"FLORESTA DO ARAGUAIA";104;2;9;115
2013;"GARRAFAO DO NORTE (PA)";"PA";"GARRAFAO DO NORTE";93;6;18;117
2013;"GOIANESIA DO PARA (PA)";"PA";"GOIANESIA DO PARA";300;19;35;354
2013;"GURUPA (PA)";"PA";"GURUPA";7;0;3;10
2013;"IGARAPE ACU (PA)";"PA";"IGARAPE ACU";177;71;76;324
2013;"IGARAPE MIRI (PA)";"PA";"IGARAPE MIRI";71;25;31;127
2013;"INHANGAPI (PA)";"PA";"INHANGAPI";39;1;31;71
2013;"IPIXUNA DO PARA (PA)";"PA";"IPIXUNA DO PARA";66;7;40;113
2013;"IRITUIA (PA)";"PA";"IRITUIA";78;3;48;129
2013;"ITAITUBA (PA)";"PA";"ITAITUBA";901;36;114;1051
2013;"ITUPIRANGA (PA)";"PA";"ITUPIRANGA";184;90;28;302
2013;"JACAREACANGA (PA)";"PA";"JACAREACANGA";17;1;1;19
2013;"JACUNDA (PA)";"PA";"JACUNDA";604;20;53;677
2013;"JURUTI (PA)";"PA";"JURUTI";79;13;10;102
2013;"LIMOEIRO DO AJURU (PA)";"PA";"LIMOEIRO DO AJURU";0;0;3;3
2013;"MAE DO RIO (PA)";"PA";"MAE DO RIO";322;24;67;413
2013;"MAGALHAES BARATA (PA)";"PA";"MAGALHAES BARATA";6;20;7;33
2013;"MARABA (PA)";"PA";"MARABA";3501;335;586;4422
2013;"MARACANA (PA)";"PA";"MARACANA";34;12;23;69
2013;"MARAPANIM (PA)";"PA";"MARAPANIM";35;13;31;79
2013;"MARITUBA (PA)";"PA";"MARITUBA";813;108;425;1346
2013;"MEDICILANDIA (PA)";"PA";"MEDICILANDIA";180;15;27;222
2013;"MELGACO (PA)";"PA";"MELGACO";4;0;2;6
2013;"MOCAJUBA (PA)";"PA";"MOCAJUBA";20;2;11;33
2013;"MOJU (PA)";"PA";"MOJU";186;21;147;354
2013;"MOJUI DOS CAMPOS (PA)";"PA";"MOJUI DOS CAMPOS";0;0;0;0
2013;"MONTE ALEGRE (PA)";"PA";"MONTE ALEGRE";253;10;133;396
2013;"MUANA (PA)";"PA";"MUANA";3;3;12;18
2013;"NOVA ESPERANCA DO PIRIA (PA)";"PA";"NOVA ESPERANCA DO PIRIA";73;4;21;98
2013;"NOVA IPIXUNA (PA)";"PA";"NOVA IPIXUNA";149;3;26;178
2013;"NOVA TIMBOTEUA (PA)";"PA";"NOVA TIMBOTEUA";54;4;17;75
2013;"NOVO PROGRESSO (PA)";"PA";"NOVO PROGRESSO";500;7;28;535
2013;"NOVO REPARTIMENTO (PA)";"PA";"NOVO REPARTIMENTO";398;24;47;469
2013;"OBIDOS (PA)";"PA";"OBIDOS";179;2;53;234
2013;"OEIRAS DO PARA (PA)";"PA";"OEIRAS DO PARA";7;1;8;16
2013;"ORIXIMINA (PA)";"PA";"ORIXIMINA";356;15;35;406
2013;"OUREM (PA)";"PA";"OUREM";158;3;17;178
2013;"OURILANDIA DO NORTE (PA)";"PA";"OURILANDIA DO NORTE";240;11;44;295
2013;"PACAJA (PA)";"PA";"PACAJA";125;23;10;158
2013;"PALESTINA DO PARA (PA)";"PA";"PALESTINA DO PARA";31;6;5;42
2013;"PARAGOMINAS (PA)";"PA";"PARAGOMINAS";1369;42;162;1573
2013;"PARAUAPEBAS (PA)";"PA";"PARAUAPEBAS";2032;665;1125;3822
2013;"PAU D ARCO (PA)";"PA";"PAU D ARCO";14;8;5;27
2013;"PEIXE BOI (PA)";"PA";"PEIXE BOI";20;6;13;39
2013;"PICARRA (PA)";"PA";"PICARRA";25;0;6;31
2013;"PLACAS (PA)";"PA";"PLACAS";72;4;3;79
2013;"PONTA DE PEDRAS (PA)";"PA";"PONTA DE PEDRAS";7;1;5;13
2013;"PORTEL (PA)";"PA";"PORTEL";20;0;9;29
2013;"PORTO DE MOZ (PA)";"PA";"PORTO DE MOZ";20;0;5;25
2013;"PRAINHA (PA)";"PA";"PRAINHA";28;0;5;33
2013;"PRIMAVERA (PA)";"PA";"PRIMAVERA";17;1;14;32
2013;"QUATIPURU (PA)";"PA";"QUATIPURU";9;2;10;21
2013;"REDENCAO (PA)";"PA";"REDENCAO";1437;79;143;1659
2013;"RIO MARIA (PA)";"PA";"RIO MARIA";270;35;46;351
2013;"RONDON DO PARA (PA)";"PA";"RONDON DO PARA";474;47;22;543
2013;"RUROPOLIS (PA)";"PA";"RUROPOLIS";195;6;14;215
2013;"SALINOPOLIS (PA)";"PA";"SALINOPOLIS";142;30;68;240
2013;"SALVATERRA (PA)";"PA";"SALVATERRA";35;28;25;88
2013;"SANTA BARBARA DO PARA (PA)";"PA";"SANTA BARBARA DO PARA";58;26;68;152
2013;"SANTA CRUZ DO ARARI (PA)";"PA";"SANTA CRUZ DO ARARI";4;0;1;5
2013;"SANTA ISABEL DO PARA (PA)";"PA";"SANTA ISABEL DO PARA";621;47;144;812
2013;"SANTA LUZIA DO PARA (PA)";"PA";"SANTA LUZIA DO PARA";111;12;29;152
2013;"SANTA MARIA DAS BARREIRAS (PA)";"PA";"SANTA MARIA DAS BARREIRAS";69;3;30;102
2013;"SANTA MARIA DO PARA (PA)";"PA";"SANTA MARIA DO PARA";279;20;46;345
2013;"SANTANA DO ARAGUAIA (PA)";"PA";"SANTANA DO ARAGUAIA";212;10;24;246
2013;"SANTAREM (PA)";"PA";"SANTAREM";2649;130;678;3457
2013;"SANTAREM NOVO (PA)";"PA";"SANTAREM NOVO";8;5;15;28
2013;"SANTO ANTONIO DO TAUA (PA)";"PA";"SANTO ANTONIO DO TAUA";141;24;93;258
2013;"SAO CAETANO DE ODIVELAS (PA)";"PA";"SAO CAETANO DE ODIVELAS";25;0;6;31
2013;"SAO DOMINGOS DO ARAGUAIA (PA)";"PA";"SAO DOMINGOS DO ARAGUAIA";134;27;25;186
2013;"SAO DOMINGOS DO CAPIM (PA)";"PA";"SAO DOMINGOS DO CAPIM";39;0;29;68
2013;"SAO FELIX DO XINGU (PA)";"PA";"SAO FELIX DO XINGU";256;8;24;288
2013;"SAO FRANCISCO DO PARA (PA)";"PA";"SAO FRANCISCO DO PARA";48;36;31;115
2013;"SAO GERALDO DO ARAGUAIA (PA)";"PA";"SAO GERALDO DO ARAGUAIA";127;5;18;150
2013;"SAO JOAO DA PONTA (PA)";"PA";"SAO JOAO DA PONTA";4;4;8;16
2013;"SAO JOAO DE PIRABAS (PA)";"PA";"SAO JOAO DE PIRABAS";31;11;17;59
2013;"SAO JOAO DO ARAGUAIA (PA)";"PA";"SAO JOAO DO ARAGUAIA";24;16;8;48
2013;"SAO MIGUEL DO GUAMA (PA)";"PA";"SAO MIGUEL DO GUAMA";405;23;111;539
2013;"SAO SEBASTIAO DA BOA VISTA (PA)";"PA";"SAO SEBASTIAO DA BOA VISTA";4;0;1;5
2013;"SAPUCAIA (PA)";"PA";"SAPUCAIA";28;4;8;40
2013;"SENADOR JOSE PORFIRIO (PA)";"PA";"SENADOR JOSE PORFIRIO";23;4;8;35
2013;"SOURE (PA)";"PA";"SOURE";34;4;14;52
2013;"TAILANDIA (PA)";"PA";"TAILANDIA";709;41;165;915
2013;"TERRA ALTA (PA)";"PA";"TERRA ALTA";27;19;21;67
2013;"TERRA SANTA (PA)";"PA";"TERRA SANTA";23;0;3;26
2013;"TOME ACU (PA)";"PA";"TOME ACU";501;20;138;659
2013;"TRACUATEUA (PA)";"PA";"TRACUATEUA";27;8;32;67
2013;"TRAIRAO (PA)";"PA";"TRAIRAO";117;2;7;126
2013;"TUCUMA (PA)";"PA";"TUCUMA";544;25;92;661
2013;"TUCURUI (PA)";"PA";"TUCURUI";876;89;201;1166
2013;"ULIANOPOLIS (PA)";"PA";"ULIANOPOLIS";180;21;31;232
2013;"URUARA (PA)";"PA";"URUARA";490;18;32;540
2013;"VIGIA (PA)";"PA";"VIGIA";159;21;79;259
2013;"VISEU (PA)";"PA";"VISEU";70;4;43;117
2013;"VITORIA DO XINGU (PA)";"PA";"VITORIA DO XINGU";33;11;8;52
2013;"XINGUARA (PA)";"PA";"XINGUARA";817;29;97;943
2013;"AGUA BRANCA (PB)";"PB";"AGUA BRANCA";11;6;7;24
2013;"AGUIAR (PB)";"PB";"AGUIAR";8;6;2;16
2013;"ALAGOA GRANDE (PB)";"PB";"ALAGOA GRANDE";102;33;40;175
2013;"ALAGOA NOVA (PB)";"PB";"ALAGOA NOVA";131;42;13;186
2013;"ALAGOINHA (PB)";"PB";"ALAGOINHA";41;19;25;85
2013;"ALCANTIL (PB)";"PB";"ALCANTIL";50;20;16;86
2013;"ALGODAO DE JANDAIRA (PB)";"PB";"ALGODAO DE JANDAIRA";26;0;4;30
2013;"ALHANDRA (PB)";"PB";"ALHANDRA";156;22;23;201
2013;"AMPARO (PB)";"PB";"AMPARO";9;7;5;21
2013;"APARECIDA (PB)";"PB";"APARECIDA";35;5;15;55
2013;"ARACAGI (PB)";"PB";"ARACAGI";57;2;50;109
2013;"ARARA (PB)";"PB";"ARARA";66;7;20;93
2013;"ARARUNA (PB)";"PB";"ARARUNA";89;37;16;142
2013;"AREIA (PB)";"PB";"AREIA";109;41;25;175
2013;"AREIA DE BARAUNAS (PB)";"PB";"AREIA DE BARAUNAS";4;2;2;8
2013;"AREIAL (PB)";"PB";"AREIAL";36;4;10;50
2013;"AROEIRAS (PB)";"PB";"AROEIRAS";66;47;15;128
2013;"ASSUNCAO (PB)";"PB";"ASSUNCAO";28;9;5;42
2013;"BAIA DA TRAICAO (PB)";"PB";"BAIA DA TRAICAO";14;5;10;29
2013;"BANANEIRAS (PB)";"PB";"BANANEIRAS";82;21;25;128
2013;"BARAUNA (PB)";"PB";"BARAUNA";31;2;5;38
2013;"BARRA DE SANTA ROSA (PB)";"PB";"BARRA DE SANTA ROSA";87;8;22;117
2013;"BARRA DE SANTANA (PB)";"PB";"BARRA DE SANTANA";61;8;16;85
2013;"BARRA DE SAO MIGUEL (PB)";"PB";"BARRA DE SAO MIGUEL";7;1;5;13
2013;"BAYEUX (PB)";"PB";"BAYEUX";678;37;159;874
2013;"BELEM (PB)";"PB";"BELEM";127;11;14;152
2013;"BELEM DO BREJO DO CRUZ (PB)";"PB";"BELEM DO BREJO DO CRUZ";14;12;4;30
2013;"BERNARDINO BATISTA (PB)";"PB";"BERNARDINO BATISTA";2;0;5;7
2013;"BOA VENTURA (PB)";"PB";"BOA VENTURA";13;3;1;17
2013;"BOA VISTA (PB)";"PB";"BOA VISTA";100;9;18;127
2013;"BOM JESUS (PB)";"PB";"BOM JESUS";10;0;3;13
2013;"BOM SUCESSO (PB)";"PB";"BOM SUCESSO";7;2;8;17
2013;"BONITO DE SANTA FE (PB)";"PB";"BONITO DE SANTA FE";24;11;3;38
2013;"BOQUEIRAO (PB)";"PB";"BOQUEIRAO";206;12;24;242
2013;"BORBOREMA (PB)";"PB";"BORBOREMA";34;16;3;53
2013;"BREJO DO CRUZ (PB)";"PB";"BREJO DO CRUZ";74;14;5;93
2013;"BREJO DOS SANTOS (PB)";"PB";"BREJO DOS SANTOS";19;2;2;23
2013;"CAAPORA (PB)";"PB";"CAAPORA";41;8;10;59
2013;"CABACEIRAS (PB)";"PB";"CABACEIRAS";21;4;16;41
2013;"CABEDELO (PB)";"PB";"CABEDELO";468;46;27;541
2013;"CACHOEIRA DOS INDIOS (PB)";"PB";"CACHOEIRA DOS INDIOS";15;1;8;24
2013;"CACIMBA DE AREIA (PB)";"PB";"CACIMBA DE AREIA";5;1;4;10
2013;"CACIMBA DE DENTRO (PB)";"PB";"CACIMBA DE DENTRO";69;15;35;119
2013;"CACIMBAS (PB)";"PB";"CACIMBAS";4;6;3;13
2013;"CAICARA (PB)";"PB";"CAICARA";14;3;5;22
2013;"CAJAZEIRAS (PB)";"PB";"CAJAZEIRAS";455;48;59;562
2013;"CAJAZEIRINHAS (PB)";"PB";"CAJAZEIRINHAS";4;1;2;7
2013;"CALDAS BRANDAO (PB)";"PB";"CALDAS BRANDAO";38;4;6;48
2013;"CAMALAU (PB)";"PB";"CAMALAU";27;8;15;50
2013;"CAMPINA GRANDE (PB)";"PB";"CAMPINA GRANDE";4325;339;759;5423
2013;"CAMPO DE SANTANA (PB)";"PB";"CAMPO DE SANTANA";35;6;15;56
2013;"CAPIM (PB)";"PB";"CAPIM";25;7;15;47
2013;"CARAUBAS (PB)";"PB";"CARAUBAS";10;5;4;19
2013;"CARRAPATEIRA (PB)";"PB";"CARRAPATEIRA";2;0;2;4
2013;"CASSERENGUE (PB)";"PB";"CASSERENGUE";39;8;18;65
2013;"CATINGUEIRA (PB)";"PB";"CATINGUEIRA";12;4;2;18
2013;"CATOLE DO ROCHA (PB)";"PB";"CATOLE DO ROCHA";245;47;18;310
2013;"CATURITE (PB)";"PB";"CATURITE";104;12;14;130
2013;"CONCEICAO (PB)";"PB";"CONCEICAO";90;36;8;134
2013;"CONDADO (PB)";"PB";"CONDADO";32;7;8;47
2013;"CONDE (PB)";"PB";"CONDE";93;21;14;128
2013;"CONGO (PB)";"PB";"CONGO";22;8;6;36
2013;"COREMAS (PB)";"PB";"COREMAS";57;20;10;87
2013;"COXIXOLA (PB)";"PB";"COXIXOLA";3;7;0;10
2013;"CRUZ DO ESPIRITO SANTO (PB)";"PB";"CRUZ DO ESPIRITO SANTO";27;7;24;58
2013;"CUBATI (PB)";"PB";"CUBATI";42;3;5;50
2013;"CUITE (PB)";"PB";"CUITE";99;8;18;125
2013;"CUITE DE MAMANGUAPE (PB)";"PB";"CUITE DE MAMANGUAPE";11;9;26;46
2013;"CUITEGI (PB)";"PB";"CUITEGI";22;6;3;31
2013;"CURRAL DE CIMA (PB)";"PB";"CURRAL DE CIMA";15;5;19;39
2013;"CURRAL VELHO (PB)";"PB";"CURRAL VELHO";4;3;2;9
2013;"DAMIAO (PB)";"PB";"DAMIAO";27;6;7;40
2013;"DESTERRO (PB)";"PB";"DESTERRO";30;9;6;45
2013;"DIAMANTE (PB)";"PB";"DIAMANTE";15;2;3;20
2013;"DONA INES (PB)";"PB";"DONA INES";46;13;19;78
2013;"DUAS ESTRADAS (PB)";"PB";"DUAS ESTRADAS";11;5;6;22
2013;"EMAS (PB)";"PB";"EMAS";3;3;3;9
2013;"ESPERANCA (PB)";"PB";"ESPERANCA";518;28;97;643
2013;"FAGUNDES (PB)";"PB";"FAGUNDES";40;10;24;74
2013;"FREI MARTINHO (PB)";"PB";"FREI MARTINHO";9;1;4;14
2013;"GADO BRAVO (PB)";"PB";"GADO BRAVO";38;20;17;75
2013;"GUARABIRA (PB)";"PB";"GUARABIRA";519;64;160;743
2013;"GURINHEM (PB)";"PB";"GURINHEM";38;8;23;69
2013;"GURJAO (PB)";"PB";"GURJAO";10;3;4;17
2013;"IBIARA (PB)";"PB";"IBIARA";11;2;3;16
2013;"IGARACY (PB)";"PB";"IGARACY";12;10;3;25
2013;"IMACULADA (PB)";"PB";"IMACULADA";9;10;5;24
2013;"INGA (PB)";"PB";"INGA";111;11;27;149
2013;"ITABAIANA (PB)";"PB";"ITABAIANA";155;10;40;205
2013;"ITAPORANGA (PB)";"PB";"ITAPORANGA";127;35;21;183
2013;"ITAPOROROCA (PB)";"PB";"ITAPOROROCA";94;3;24;121
2013;"ITATUBA (PB)";"PB";"ITATUBA";41;4;13;58
2013;"JACARAU (PB)";"PB";"JACARAU";62;6;19;87
2013;"JERICO (PB)";"PB";"JERICO";21;4;1;26
2013;"JOAO PESSOA (PB)";"PB";"JOAO PESSOA";5610;1021;2315;8946
2013;"JUAREZ TAVORA (PB)";"PB";"JUAREZ TAVORA";26;3;15;44
2013;"JUAZEIRINHO (PB)";"PB";"JUAZEIRINHO";80;20;14;114
2013;"JUNCO DO SERIDO (PB)";"PB";"JUNCO DO SERIDO";52;5;4;61
2013;"JURIPIRANGA (PB)";"PB";"JURIPIRANGA";50;3;20;73
2013;"JURU (PB)";"PB";"JURU";14;7;2;23
2013;"LAGOA (PB)";"PB";"LAGOA";13;3;5;21
2013;"LAGOA DE DENTRO (PB)";"PB";"LAGOA DE DENTRO";34;6;14;54
2013;"LAGOA SECA (PB)";"PB";"LAGOA SECA";196;60;16;272
2013;"LASTRO (PB)";"PB";"LASTRO";4;4;4;12
2013;"LIVRAMENTO (PB)";"PB";"LIVRAMENTO";32;8;5;45
2013;"LOGRADOURO (PB)";"PB";"LOGRADOURO";3;4;11;18
2013;"LUCENA (PB)";"PB";"LUCENA";23;4;11;38
2013;"MAE D AGUA (PB)";"PB";"MAE D AGUA";4;0;4;8
2013;"MALTA (PB)";"PB";"MALTA";11;7;2;20
2013;"MAMANGUAPE (PB)";"PB";"MAMANGUAPE";425;14;77;516
2013;"MANAIRA (PB)";"PB";"MANAIRA";16;8;2;26
2013;"MARCACAO (PB)";"PB";"MARCACAO";2;7;13;22
2013;"MARI (PB)";"PB";"MARI";105;13;46;164
2013;"MARIZOPOLIS (PB)";"PB";"MARIZOPOLIS";26;6;2;34
2013;"MASSARANDUBA (PB)";"PB";"MASSARANDUBA";37;9;14;60
2013;"MATARACA (PB)";"PB";"MATARACA";41;3;15;59
2013;"MATINHAS (PB)";"PB";"MATINHAS";10;5;4;19
2013;"MATO GROSSO (PB)";"PB";"MATO GROSSO";11;3;2;16
2013;"MATUREIA (PB)";"PB";"MATUREIA";16;15;3;34
2013;"MOGEIRO (PB)";"PB";"MOGEIRO";33;6;7;46
2013;"MONTADAS (PB)";"PB";"MONTADAS";28;3;9;40
2013;"MONTE HOREBE (PB)";"PB";"MONTE HOREBE";7;3;5;15
2013;"MONTEIRO (PB)";"PB";"MONTEIRO";250;75;49;374
2013;"MULUNGU (PB)";"PB";"MULUNGU";45;6;15;66
2013;"NATUBA (PB)";"PB";"NATUBA";23;2;4;29
2013;"NAZAREZINHO (PB)";"PB";"NAZAREZINHO";24;6;4;34
2013;"NOVA FLORESTA (PB)";"PB";"NOVA FLORESTA";44;13;10;67
2013;"NOVA OLINDA (PB)";"PB";"NOVA OLINDA";18;8;4;30
2013;"NOVA PALMEIRA (PB)";"PB";"NOVA PALMEIRA";27;2;5;34
2013;"OLHO D AGUA (PB)";"PB";"OLHO D AGUA";9;7;4;20
2013;"OLIVEDOS (PB)";"PB";"OLIVEDOS";32;5;8;45
2013;"OURO VELHO (PB)";"PB";"OURO VELHO";10;3;4;17
2013;"PARARI (PB)";"PB";"PARARI";5;1;1;7
2013;"PASSAGEM (PB)";"PB";"PASSAGEM";15;0;2;17
2013;"PATOS (PB)";"PB";"PATOS";774;148;54;976
2013;"PAULISTA (PB)";"PB";"PAULISTA";53;9;13;75
2013;"PEDRA BRANCA (PB)";"PB";"PEDRA BRANCA";6;8;4;18
2013;"PEDRA LAVRADA (PB)";"PB";"PEDRA LAVRADA";46;4;9;59
2013;"PEDRAS DE FOGO (PB)";"PB";"PEDRAS DE FOGO";254;29;90;373
2013;"PEDRO REGIS (PB)";"PB";"PEDRO REGIS";21;1;4;26
2013;"PIANCO (PB)";"PB";"PIANCO";92;16;5;113
2013;"PICUI (PB)";"PB";"PICUI";127;11;43;181
2013;"PILAR (PB)";"PB";"PILAR";31;2;13;46
2013;"PILOES (PB)";"PB";"PILOES";30;3;8;41
2013;"PILOEZINHOS (PB)";"PB";"PILOEZINHOS";16;5;6;27
2013;"PIRPIRITUBA (PB)";"PB";"PIRPIRITUBA";30;0;13;43
2013;"PITIMBU (PB)";"PB";"PITIMBU";25;16;8;49
2013;"POCINHOS (PB)";"PB";"POCINHOS";117;22;28;167
2013;"POCO DANTAS (PB)";"PB";"POCO DANTAS";7;1;5;13
2013;"POCO DE JOSE DE MOURA (PB)";"PB";"POCO DE JOSE DE MOURA";5;5;6;16
2013;"POMBAL (PB)";"PB";"POMBAL";317;41;18;376
2013;"PRATA (PB)";"PB";"PRATA";22;10;5;37
2013;"PRINCESA ISABEL (PB)";"PB";"PRINCESA ISABEL";98;78;15;191
2013;"PUXINANA (PB)";"PB";"PUXINANA";67;28;16;111
2013;"QUEIMADAS (PB)";"PB";"QUEIMADAS";464;106;89;659
2013;"QUIXABA (PB)";"PB";"QUIXABA";7;3;3;13
2013;"REMIGIO (PB)";"PB";"REMIGIO";244;7;22;273
2013;"RIACHAO (PB)";"PB";"RIACHAO";3;2;7;12
2013;"RIACHAO DO BACAMARTE (PB)";"PB";"RIACHAO DO BACAMARTE";19;0;4;23
2013;"RIACHAO DO POCO (PB)";"PB";"RIACHAO DO POCO";13;1;8;22
2013;"RIACHO DE SANTO ANTONIO (PB)";"PB";"RIACHO DE SANTO ANTONIO";9;4;3;16
2013;"RIACHO DOS CAVALOS (PB)";"PB";"RIACHO DOS CAVALOS";21;3;6;30
2013;"RIO TINTO (PB)";"PB";"RIO TINTO";93;9;38;140
2013;"SALGADINHO (PB)";"PB";"SALGADINHO";5;3;4;12
2013;"SALGADO DE SAO FELIX (PB)";"PB";"SALGADO DE SAO FELIX";14;3;9;26
2013;"SANTA CECILIA (PB)";"PB";"SANTA CECILIA";24;10;9;43
2013;"SANTA CRUZ (PB)";"PB";"SANTA CRUZ";12;4;12;28
2013;"SANTA HELENA (PB)";"PB";"SANTA HELENA";7;2;11;20
2013;"SANTA INES (PB)";"PB";"SANTA INES";10;3;3;16
2013;"SANTA LUZIA (PB)";"PB";"SANTA LUZIA";174;18;16;208
2013;"SANTA RITA (PB)";"PB";"SANTA RITA";805;70;247;1122
2013;"SANTA TERESINHA (PB)";"PB";"SANTA TERESINHA";25;5;6;36
2013;"SANTANA DE MANGUEIRA (PB)";"PB";"SANTANA DE MANGUEIRA";5;1;3;9
2013;"SANTANA DOS GARROTES (PB)";"PB";"SANTANA DOS GARROTES";23;11;2;36
2013;"SANTAREM (PB)";"PB";"SANTAREM";3;2;4;9
2013;"SANTO ANDRE (PB)";"PB";"SANTO ANDRE";18;7;18;43
2013;"SAO BENTINHO (PB)";"PB";"SAO BENTINHO";20;4;2;26
2013;"SAO BENTO (PB)";"PB";"SAO BENTO";262;25;20;307
2013;"SAO DOMINGOS DE POMBAL (PB)";"PB";"SAO DOMINGOS DE POMBAL";5;4;4;13
2013;"SAO DOMINGOS DO CARIRI (PB)";"PB";"SAO DOMINGOS DO CARIRI";10;1;4;15
2013;"SAO FRANCISCO (PB)";"PB";"SAO FRANCISCO";9;1;4;14
2013;"SAO JOAO DO CARIRI (PB)";"PB";"SAO JOAO DO CARIRI";25;4;8;37
2013;"SAO JOAO DO RIO DO PEIXE (PB)";"PB";"SAO JOAO DO RIO DO PEIXE";52;9;23;84
2013;"SAO JOAO DO TIGRE (PB)";"PB";"SAO JOAO DO TIGRE";12;3;2;17
2013;"SAO JOSE DA LAGOA TAPADA (PB)";"PB";"SAO JOSE DA LAGOA TAPADA";21;6;6;33
2013;"SAO JOSE DE CAIANA (PB)";"PB";"SAO JOSE DE CAIANA";4;4;4;12
2013;"SAO JOSE DE ESPINHARAS (PB)";"PB";"SAO JOSE DE ESPINHARAS";17;5;6;28
2013;"SAO JOSE DE PIRANHAS (PB)";"PB";"SAO JOSE DE PIRANHAS";37;13;9;59
2013;"SAO JOSE DE PRINCESA (PB)";"PB";"SAO JOSE DE PRINCESA";4;1;3;8
2013;"SAO JOSE DO BONFIM (PB)";"PB";"SAO JOSE DO BONFIM";10;3;4;17
2013;"SAO JOSE DO BREJO DO CRUZ (PB)";"PB";"SAO JOSE DO BREJO DO CRUZ";4;1;2;7
2013;"SAO JOSE DO SABUGI (PB)";"PB";"SAO JOSE DO SABUGI";14;1;5;20
2013;"SAO JOSE DOS CORDEIROS (PB)";"PB";"SAO JOSE DOS CORDEIROS";11;3;3;17
2013;"SAO JOSE DOS RAMOS (PB)";"PB";"SAO JOSE DOS RAMOS";20;1;9;30
2013;"SAO MAMEDE (PB)";"PB";"SAO MAMEDE";25;2;5;32
2013;"SAO MIGUEL DE TAIPU (PB)";"PB";"SAO MIGUEL DE TAIPU";23;0;7;30
2013;"SAO SEBASTIAO DE LAGOA DE ROCA (PB)";"PB";"SAO SEBASTIAO DE LAGOA DE ROCA";57;19;13;89
2013;"SAO SEBASTIAO DO UMBUZEIRO (PB)";"PB";"SAO SEBASTIAO DO UMBUZEIRO";10;2;4;16
2013;"SAO VICENTE DO SERIDO (PB)";"PB";"SAO VICENTE DO SERIDO";20;8;9;37
2013;"SAPE (PB)";"PB";"SAPE";336;29;97;462
2013;"SERRA BRANCA (PB)";"PB";"SERRA BRANCA";87;21;10;118
2013;"SERRA DA RAIZ (PB)";"PB";"SERRA DA RAIZ";10;1;5;16
2013;"SERRA GRANDE (PB)";"PB";"SERRA GRANDE";6;0;4;10
2013;"SERRA REDONDA (PB)";"PB";"SERRA REDONDA";19;9;4;32
2013;"SERRARIA (PB)";"PB";"SERRARIA";14;9;5;28
2013;"SERTAOZINHO (PB)";"PB";"SERTAOZINHO";9;3;10;22
2013;"SOBRADO (PB)";"PB";"SOBRADO";59;6;6;71
2013;"SOLANEA (PB)";"PB";"SOLANEA";209;31;39;279
2013;"SOLEDADE (PB)";"PB";"SOLEDADE";167;24;17;208
2013;"SOSSEGO (PB)";"PB";"SOSSEGO";28;3;6;37
2013;"SOUSA (PB)";"PB";"SOUSA";780;53;62;895
2013;"SUME (PB)";"PB";"SUME";105;27;18;150
2013;"TAPEROA (PB)";"PB";"TAPEROA";81;12;7;100
2013;"TAVARES (PB)";"PB";"TAVARES";24;9;9;42
2013;"TEIXEIRA (PB)";"PB";"TEIXEIRA";93;18;22;133
2013;"TENORIO (PB)";"PB";"TENORIO";15;0;4;19
2013;"TRIUNFO (PB)";"PB";"TRIUNFO";16;4;5;25
2013;"UIRAUNA (PB)";"PB";"UIRAUNA";77;14;9;100
2013;"UMBUZEIRO (PB)";"PB";"UMBUZEIRO";62;26;24;112
2013;"VARZEA (PB)";"PB";"VARZEA";19;4;5;28
2013;"VIEIROPOLIS (PB)";"PB";"VIEIROPOLIS";12;4;11;27
2013;"VISTA SERRANA (PB)";"PB";"VISTA SERRANA";15;0;6;21
2013;"ZABELE (PB)";"PB";"ZABELE";10;2;7;19
2013;"ABREU E LIMA (PE)";"PE";"ABREU E LIMA";551;64;369;984
2013;"AFOGADOS DA INGAZEIRA (PE)";"PE";"AFOGADOS DA INGAZEIRA";416;55;63;534
2013;"AFRANIO (PE)";"PE";"AFRANIO";163;6;20;189
2013;"AGRESTINA (PE)";"PE";"AGRESTINA";173;39;27;239
2013;"AGUA PRETA (PE)";"PE";"AGUA PRETA";158;50;59;267
2013;"AGUAS BELAS (PE)";"PE";"AGUAS BELAS";302;64;38;404
2013;"ALAGOINHA (PE)";"PE";"ALAGOINHA";125;39;15;179
2013;"ALIANCA (PE)";"PE";"ALIANCA";163;18;123;304
2013;"ALTINHO (PE)";"PE";"ALTINHO";83;62;34;179
2013;"AMARAJI (PE)";"PE";"AMARAJI";100;23;36;159
2013;"ANGELIM (PE)";"PE";"ANGELIM";49;19;7;75
2013;"ARACOIABA (PE)";"PE";"ARACOIABA";70;7;86;163
2013;"ARARIPINA (PE)";"PE";"ARARIPINA";1179;55;69;1303
2013;"ARCOVERDE (PE)";"PE";"ARCOVERDE";1092;156;117;1365
2013;"BARRA DE GUABIRABA (PE)";"PE";"BARRA DE GUABIRABA";71;19;9;99
2013;"BARREIROS (PE)";"PE";"BARREIROS";269;30;60;359
2013;"BELEM DE MARIA (PE)";"PE";"BELEM DE MARIA";75;46;17;138
2013;"BELEM DE SAO FRANCISCO (PE)";"PE";"BELEM DE SAO FRANCISCO";106;13;18;137
2013;"BELO JARDIM (PE)";"PE";"BELO JARDIM";714;277;91;1082
2013;"BETANIA (PE)";"PE";"BETANIA";53;3;9;65
2013;"BEZERROS (PE)";"PE";"BEZERROS";778;124;75;977
2013;"BODOCO (PE)";"PE";"BODOCO";227;4;21;252
2013;"BOM CONSELHO (PE)";"PE";"BOM CONSELHO";286;58;41;385
2013;"BOM JARDIM (PE)";"PE";"BOM JARDIM";198;239;44;481
2013;"BONITO (PE)";"PE";"BONITO";357;77;34;468
2013;"BREJAO (PE)";"PE";"BREJAO";62;13;13;88
2013;"BREJINHO (PE)";"PE";"BREJINHO";46;6;7;59
2013;"BREJO DA MADRE DE DEUS (PE)";"PE";"BREJO DA MADRE DE DEUS";251;361;18;630
2013;"BUENOS AIRES (PE)";"PE";"BUENOS AIRES";59;6;19;84
2013;"BUIQUE (PE)";"PE";"BUIQUE";262;66;36;364
2013;"CABO DE SANTO AGOSTINHO (PE)";"PE";"CABO DE SANTO AGOSTINHO";1328;287;502;2117
2013;"CABROBO (PE)";"PE";"CABROBO";232;13;32;277
2013;"CACHOEIRINHA (PE)";"PE";"CACHOEIRINHA";151;65;13;229
2013;"CAETES (PE)";"PE";"CAETES";246;41;32;319
2013;"CALCADO (PE)";"PE";"CALCADO";60;10;26;96
2013;"CALUMBI (PE)";"PE";"CALUMBI";60;4;6;70
2013;"CAMARAGIBE (PE)";"PE";"CAMARAGIBE";732;260;191;1183
2013;"CAMOCIM DE SAO FELIX (PE)";"PE";"CAMOCIM DE SAO FELIX";141;44;6;191
2013;"CAMUTANGA (PE)";"PE";"CAMUTANGA";86;1;16;103
2013;"CANHOTINHO (PE)";"PE";"CANHOTINHO";208;72;14;294
2013;"CAPOEIRAS (PE)";"PE";"CAPOEIRAS";235;38;14;287
2013;"CARNAIBA (PE)";"PE";"CARNAIBA";146;28;24;198
2013;"CARNAUBEIRA DA PENHA (PE)";"PE";"CARNAUBEIRA DA PENHA";54;8;4;66
2013;"CARPINA (PE)";"PE";"CARPINA";857;115;144;1116
2013;"CARUARU (PE)";"PE";"CARUARU";4293;760;556;5609
2013;"CASINHAS (PE)";"PE";"CASINHAS";58;132;16;206
2013;"CATENDE (PE)";"PE";"CATENDE";187;73;65;325
2013;"CEDRO (PE)";"PE";"CEDRO";38;6;12;56
2013;"CHA DE ALEGRIA (PE)";"PE";"CHA DE ALEGRIA";51;19;36;106
2013;"CHA GRANDE (PE)";"PE";"CHA GRANDE";244;51;25;320
2013;"CONDADO (PE)";"PE";"CONDADO";131;7;71;209
2013;"CORRENTES (PE)";"PE";"CORRENTES";86;26;14;126
2013;"CORTES (PE)";"PE";"CORTES";156;50;31;237
2013;"CUMARU (PE)";"PE";"CUMARU";125;76;19;220
2013;"CUPIRA (PE)";"PE";"CUPIRA";259;83;18;360
2013;"CUSTODIA (PE)";"PE";"CUSTODIA";325;58;30;413
2013;"DORMENTES (PE)";"PE";"DORMENTES";210;10;24;244
2013;"ESCADA (PE)";"PE";"ESCADA";362;87;144;593
2013;"EXU (PE)";"PE";"EXU";291;8;31;330
2013;"FEIRA NOVA (PE)";"PE";"FEIRA NOVA";208;38;13;259
2013;"FERNANDO DE NORONHA (PE)";"PE";"FERNANDO DE NORONHA";20;23;7;50
2013;"FERREIROS (PE)";"PE";"FERREIROS";75;2;47;124
2013;"FLORES (PE)";"PE";"FLORES";103;22;10;135
2013;"FLORESTA (PE)";"PE";"FLORESTA";481;11;19;511
2013;"FREI MIGUELINHO (PE)";"PE";"FREI MIGUELINHO";170;139;19;328
2013;"GAMELEIRA (PE)";"PE";"GAMELEIRA";86;13;52;151
2013;"GARANHUNS (PE)";"PE";"GARANHUNS";1721;269;138;2128
2013;"GLORIA DO GOITA (PE)";"PE";"GLORIA DO GOITA";160;53;39;252
2013;"GOIANA (PE)";"PE";"GOIANA";755;151;136;1042
2013;"GRANITO (PE)";"PE";"GRANITO";28;2;13;43
2013;"GRAVATA (PE)";"PE";"GRAVATA";924;98;77;1099
2013;"IATI (PE)";"PE";"IATI";58;31;26;115
2013;"IBIMIRIM (PE)";"PE";"IBIMIRIM";220;27;16;263
2013;"IBIRAJUBA (PE)";"PE";"IBIRAJUBA";56;10;7;73
2013;"IGARASSU (PE)";"PE";"IGARASSU";888;97;730;1715
2013;"IGUARACI (PE)";"PE";"IGUARACI";114;19;27;160
2013;"ILHA DE ITAMARACA (PE)";"PE";"ILHA DE ITAMARACA";88;15;15;118
2013;"INAJA (PE)";"PE";"INAJA";59;8;7;74
2013;"INGAZEIRA (PE)";"PE";"INGAZEIRA";23;9;6;38
2013;"IPOJUCA (PE)";"PE";"IPOJUCA";652;270;198;1120
2013;"IPUBI (PE)";"PE";"IPUBI";253;12;37;302
2013;"ITACURUBA (PE)";"PE";"ITACURUBA";26;4;7;37
2013;"ITAIBA (PE)";"PE";"ITAIBA";116;33;16;165
2013;"ITAMBE (PE)";"PE";"ITAMBE";401;23;125;549
2013;"ITAPETIM (PE)";"PE";"ITAPETIM";71;3;9;83
2013;"ITAPISSUMA (PE)";"PE";"ITAPISSUMA";107;30;23;160
2013;"ITAQUITINGA (PE)";"PE";"ITAQUITINGA";40;8;31;79
2013;"JABOATAO DOS GUARARAPES (PE)";"PE";"JABOATAO DOS GUARARAPES";5289;852;1998;8139
2013;"JAQUEIRA (PE)";"PE";"JAQUEIRA";58;6;27;91
2013;"JATAUBA (PE)";"PE";"JATAUBA";105;143;11;259
2013;"JATOBA (PE)";"PE";"JATOBA";39;13;11;63
2013;"JOAO ALFREDO (PE)";"PE";"JOAO ALFREDO";200;584;15;799
2013;"JOAQUIM NABUCO (PE)";"PE";"JOAQUIM NABUCO";86;18;45;149
2013;"JUCATI (PE)";"PE";"JUCATI";127;20;21;168
2013;"JUPI (PE)";"PE";"JUPI";162;29;35;226
2013;"JUREMA (PE)";"PE";"JUREMA";83;29;11;123
2013;"LAGOA DO CARRO (PE)";"PE";"LAGOA DO CARRO";100;15;15;130
2013;"LAGOA DO ITAENGA (PE)";"PE";"LAGOA DO ITAENGA";422;31;63;516
2013;"LAGOA DO OURO (PE)";"PE";"LAGOA DO OURO";49;29;12;90
2013;"LAGOA DOS GATOS (PE)";"PE";"LAGOA DOS GATOS";102;30;7;139
2013;"LAGOA GRANDE (PE)";"PE";"LAGOA GRANDE";115;10;14;139
2013;"LAJEDO (PE)";"PE";"LAJEDO";531;86;45;662
2013;"LIMOEIRO (PE)";"PE";"LIMOEIRO";497;133;56;686
2013;"MACAPARANA (PE)";"PE";"MACAPARANA";176;13;41;230
2013;"MACHADOS (PE)";"PE";"MACHADOS";117;31;17;165
2013;"MANARI (PE)";"PE";"MANARI";62;12;7;81
2013;"MARAIAL (PE)";"PE";"MARAIAL";131;13;20;164
2013;"MIRANDIBA (PE)";"PE";"MIRANDIBA";118;5;7;130
2013;"MOREILANDIA (PE)";"PE";"MOREILANDIA";66;4;10;80
2013;"MORENO (PE)";"PE";"MORENO";588;168;242;998
2013;"NAZARE DA MATA (PE)";"PE";"NAZARE DA MATA";239;21;55;315
2013;"OLINDA (PE)";"PE";"OLINDA";3081;378;1466;4925
2013;"OROBO (PE)";"PE";"OROBO";162;168;60;390
2013;"OROCO (PE)";"PE";"OROCO";71;2;12;85
2013;"OURICURI (PE)";"PE";"OURICURI";633;27;89;749
2013;"PALMARES (PE)";"PE";"PALMARES";540;73;192;805
2013;"PALMEIRINA (PE)";"PE";"PALMEIRINA";27;14;8;49
2013;"PANELAS (PE)";"PE";"PANELAS";94;61;18;173
2013;"PARANATAMA (PE)";"PE";"PARANATAMA";78;24;18;120
2013;"PARNAMIRIM (PE)";"PE";"PARNAMIRIM";170;8;19;197
2013;"PASSIRA (PE)";"PE";"PASSIRA";240;92;27;359
2013;"PAUDALHO (PE)";"PE";"PAUDALHO";599;29;70;698
2013;"PAULISTA (PE)";"PE";"PAULISTA";1457;304;303;2064
2013;"PEDRA (PE)";"PE";"PEDRA";150;39;18;207
2013;"PESQUEIRA (PE)";"PE";"PESQUEIRA";699;78;125;902
2013;"PETROLANDIA (PE)";"PE";"PETROLANDIA";274;6;54;334
2013;"PETROLINA (PE)";"PE";"PETROLINA";3231;267;385;3883
2013;"POCAO (PE)";"PE";"POCAO";48;33;11;92
2013;"POMBOS (PE)";"PE";"POMBOS";551;47;40;638
2013;"PRIMAVERA (PE)";"PE";"PRIMAVERA";73;12;37;122
2013;"QUIPAPA (PE)";"PE";"QUIPAPA";85;35;46;166
2013;"QUIXABA (PE)";"PE";"QUIXABA";41;8;10;59
2013;"RECIFE (PE)";"PE";"RECIFE";19555;2574;4217;26346
2013;"RIACHO DAS ALMAS (PE)";"PE";"RIACHO DAS ALMAS";284;74;25;383
2013;"RIBEIRAO (PE)";"PE";"RIBEIRAO";267;45;96;408
2013;"RIO FORMOSO (PE)";"PE";"RIO FORMOSO";114;28;66;208
2013;"SAIRE (PE)";"PE";"SAIRE";105;10;18;133
2013;"SALGADINHO (PE)";"PE";"SALGADINHO";21;41;6;68
2013;"SALGUEIRO (PE)";"PE";"SALGUEIRO";511;43;61;615
2013;"SALOA (PE)";"PE";"SALOA";65;37;10;112
2013;"SANHARO (PE)";"PE";"SANHARO";120;22;32;174
2013;"SANTA CRUZ (PE)";"PE";"SANTA CRUZ";149;6;15;170
2013;"SANTA CRUZ DA BAIXA VERDE (PE)";"PE";"SANTA CRUZ DA BAIXA VERDE";213;10;9;232
2013;"SANTA CRUZ DO CAPIBARIBE (PE)";"PE";"SANTA CRUZ DO CAPIBARIBE";806;415;58;1279
2013;"SANTA FILOMENA (PE)";"PE";"SANTA FILOMENA";101;2;26;129
2013;"SANTA MARIA DA BOA VISTA (PE)";"PE";"SANTA MARIA DA BOA VISTA";221;10;50;281
2013;"SANTA MARIA DO CAMBUCA (PE)";"PE";"SANTA MARIA DO CAMBUCA";179;115;25;319
2013;"SANTA TEREZINHA (PE)";"PE";"SANTA TEREZINHA";65;9;10;84
2013;"SAO BENEDITO DO SUL (PE)";"PE";"SAO BENEDITO DO SUL";33;10;15;58
2013;"SAO BENTO DO UNA (PE)";"PE";"SAO BENTO DO UNA";853;75;91;1019
2013;"SAO CAITANO (PE)";"PE";"SAO CAITANO";305;177;38;520
2013;"SAO JOAO (PE)";"PE";"SAO JOAO";106;38;21;165
2013;"SAO JOAQUIM DO MONTE (PE)";"PE";"SAO JOAQUIM DO MONTE";79;30;23;132
2013;"SAO JOSE DA COROA GRANDE (PE)";"PE";"SAO JOSE DA COROA GRANDE";69;15;25;109
2013;"SAO JOSE DO BELMONTE (PE)";"PE";"SAO JOSE DO BELMONTE";291;22;32;345
2013;"SAO JOSE DO EGITO (PE)";"PE";"SAO JOSE DO EGITO";463;50;68;581
2013;"SAO LOURENCO DA MATA (PE)";"PE";"SAO LOURENCO DA MATA";387;73;392;852
2013;"SAO VICENTE FERRER (PE)";"PE";"SAO VICENTE FERRER";159;13;19;191
2013;"SERRA TALHADA (PE)";"PE";"SERRA TALHADA";1541;67;67;1675
2013;"SERRITA (PE)";"PE";"SERRITA";102;7;12;121
2013;"SERTANIA (PE)";"PE";"SERTANIA";403;51;52;506
2013;"SIRINHAEM (PE)";"PE";"SIRINHAEM";191;17;80;288
2013;"SOLIDAO (PE)";"PE";"SOLIDAO";27;4;5;36
2013;"SURUBIM (PE)";"PE";"SURUBIM";744;618;62;1424
2013;"TABIRA (PE)";"PE";"TABIRA";245;35;26;306
2013;"TACAIMBO (PE)";"PE";"TACAIMBO";78;30;19;127
2013;"TACARATU (PE)";"PE";"TACARATU";61;17;13;91
2013;"TAMANDARE (PE)";"PE";"TAMANDARE";66;29;19;114
2013;"TAQUARITINGA DO NORTE (PE)";"PE";"TAQUARITINGA DO NORTE";206;85;29;320
2013;"TEREZINHA (PE)";"PE";"TEREZINHA";23;5;6;34
2013;"TERRA NOVA (PE)";"PE";"TERRA NOVA";88;2;12;102
2013;"TIMBAUBA (PE)";"PE";"TIMBAUBA";669;36;110;815
2013;"TORITAMA (PE)";"PE";"TORITAMA";240;78;27;345
2013;"TRACUNHAEM (PE)";"PE";"TRACUNHAEM";50;22;20;92
2013;"TRINDADE (PE)";"PE";"TRINDADE";365;29;20;414
2013;"TRIUNFO (PE)";"PE";"TRIUNFO";229;17;11;257
2013;"TUPANATINGA (PE)";"PE";"TUPANATINGA";139;41;15;195
2013;"TUPARETAMA (PE)";"PE";"TUPARETAMA";124;22;19;165
2013;"VENTUROSA (PE)";"PE";"VENTUROSA";164;36;13;213
2013;"VERDEJANTE (PE)";"PE";"VERDEJANTE";73;7;17;97
2013;"VERTENTE DO LERIO (PE)";"PE";"VERTENTE DO LERIO";78;79;15;172
2013;"VERTENTES (PE)";"PE";"VERTENTES";164;89;22;275
2013;"VICENCIA (PE)";"PE";"VICENCIA";250;12;74;336
2013;"VITORIA DE SANTO ANTAO (PE)";"PE";"VITORIA DE SANTO ANTAO";2270;132;314;2716
2013;"XEXEU (PE)";"PE";"XEXEU";62;10;42;114
2013;"ACAUA (PI)";"PI";"ACAUA";56;7;9;72
2013;"AGRICOLANDIA (PI)";"PI";"AGRICOLANDIA";15;2;6;23
2013;"AGUA BRANCA (PI)";"PI";"AGUA BRANCA";159;14;14;187
2013;"ALAGOINHA DO PIAUI (PI)";"PI";"ALAGOINHA DO PIAUI";43;3;4;50
2013;"ALEGRETE DO PIAUI (PI)";"PI";"ALEGRETE DO PIAUI";39;3;5;47
2013;"ALTO LONGA (PI)";"PI";"ALTO LONGA";44;5;18;67
2013;"ALTOS (PI)";"PI";"ALTOS";250;9;33;292
2013;"ALVORADA DO GURGUEIA (PI)";"PI";"ALVORADA DO GURGUEIA";13;3;8;24
2013;"AMARANTE (PI)";"PI";"AMARANTE";77;11;17;105
2013;"ANGICAL DO PIAUI (PI)";"PI";"ANGICAL DO PIAUI";15;3;4;22
2013;"ANISIO DE ABREU (PI)";"PI";"ANISIO DE ABREU";40;12;12;64
2013;"ANTONIO ALMEIDA (PI)";"PI";"ANTONIO ALMEIDA";21;2;5;28
2013;"AROAZES (PI)";"PI";"AROAZES";15;5;9;29
2013;"AROEIRAS DO ITAIM (PI)";"PI";"AROEIRAS DO ITAIM";11;2;11;24
2013;"ARRAIAL (PI)";"PI";"ARRAIAL";10;1;4;15
2013;"ASSUNCAO DO PIAUI (PI)";"PI";"ASSUNCAO DO PIAUI";9;0;2;11
2013;"AVELINO LOPES (PI)";"PI";"AVELINO LOPES";17;5;2;24
2013;"BAIXA GRANDE DO RIBEIRO (PI)";"PI";"BAIXA GRANDE DO RIBEIRO";72;5;13;90
2013;"BARRA D ALCANTARA (PI)";"PI";"BARRA D ALCANTARA";20;0;2;22
2013;"BARRAS (PI)";"PI";"BARRAS";130;11;65;206
2013;"BARREIRAS DO PIAUI (PI)";"PI";"BARREIRAS DO PIAUI";4;0;2;6
2013;"BARRO DURO (PI)";"PI";"BARRO DURO";45;5;3;53
2013;"BATALHA (PI)";"PI";"BATALHA";74;3;15;92
2013;"BELA VISTA DO PIAUI (PI)";"PI";"BELA VISTA DO PIAUI";12;1;6;19
2013;"BELEM DO PIAUI (PI)";"PI";"BELEM DO PIAUI";15;1;2;18
2013;"BENEDITINOS (PI)";"PI";"BENEDITINOS";35;1;11;47
2013;"BERTOLINIA (PI)";"PI";"BERTOLINIA";19;8;6;33
2013;"BETANIA DO PIAUI (PI)";"PI";"BETANIA DO PIAUI";30;8;4;42
2013;"BOA HORA (PI)";"PI";"BOA HORA";15;1;7;23
2013;"BOCAINA (PI)";"PI";"BOCAINA";9;5;3;17
2013;"BOM JESUS (PI)";"PI";"BOM JESUS";227;5;15;247
2013;"BOM PRINCIPIO DO PIAUI (PI)";"PI";"BOM PRINCIPIO DO PIAUI";11;4;6;21
2013;"BONFIM DO PIAUI (PI)";"PI";"BONFIM DO PIAUI";29;4;8;41
2013;"BOQUEIRAO DO PIAUI (PI)";"PI";"BOQUEIRAO DO PIAUI";14;0;4;18
2013;"BRASILEIRA (PI)";"PI";"BRASILEIRA";17;3;8;28
2013;"BREJO DO PIAUI (PI)";"PI";"BREJO DO PIAUI";4;5;2;11
2013;"BURITI DOS LOPES (PI)";"PI";"BURITI DOS LOPES";29;8;21;58
2013;"BURITI DOS MONTES (PI)";"PI";"BURITI DOS MONTES";15;4;4;23
2013;"CABECEIRAS DO PIAUI (PI)";"PI";"CABECEIRAS DO PIAUI";17;2;20;39
2013;"CAJAZEIRAS DO PIAUI (PI)";"PI";"CAJAZEIRAS DO PIAUI";6;0;3;9
2013;"CAJUEIRO DA PRAIA (PI)";"PI";"CAJUEIRO DA PRAIA";10;3;9;22
2013;"CALDEIRAO GRANDE DO PIAUI (PI)";"PI";"CALDEIRAO GRANDE DO PIAUI";14;6;6;26
2013;"CAMPINAS DO PIAUI (PI)";"PI";"CAMPINAS DO PIAUI";4;0;2;6
2013;"CAMPO ALEGRE DO FIDALGO (PI)";"PI";"CAMPO ALEGRE DO FIDALGO";24;6;2;32
2013;"CAMPO GRANDE DO PIAUI (PI)";"PI";"CAMPO GRANDE DO PIAUI";39;7;4;50
2013;"CAMPO LARGO DO PIAUI (PI)";"PI";"CAMPO LARGO DO PIAUI";5;2;3;10
2013;"CAMPO MAIOR (PI)";"PI";"CAMPO MAIOR";425;29;75;529
2013;"CANAVIEIRA (PI)";"PI";"CANAVIEIRA";0;1;1;2
2013;"CANTO DO BURITI (PI)";"PI";"CANTO DO BURITI";113;27;16;156
2013;"CAPITAO DE CAMPOS (PI)";"PI";"CAPITAO DE CAMPOS";27;5;9;41
2013;"CAPITAO GERVASIO OLIVEIRA (PI)";"PI";"CAPITAO GERVASIO OLIVEIRA";8;1;8;17
2013;"CARACOL (PI)";"PI";"CARACOL";49;3;1;53
2013;"CARAUBAS DO PIAUI (PI)";"PI";"CARAUBAS DO PIAUI";14;2;5;21
2013;"CARIDADE DO PIAUI (PI)";"PI";"CARIDADE DO PIAUI";9;2;5;16
2013;"CASTELO DO PIAUI (PI)";"PI";"CASTELO DO PIAUI";68;9;15;92
2013;"CAXINGO (PI)";"PI";"CAXINGO";10;1;6;17
2013;"COCAL (PI)";"PI";"COCAL";75;6;15;96
2013;"COCAL DE TELHA (PI)";"PI";"COCAL DE TELHA";10;1;4;15
2013;"COCAL DOS ALVES (PI)";"PI";"COCAL DOS ALVES";4;5;3;12
2013;"COIVARAS (PI)";"PI";"COIVARAS";6;0;6;12
2013;"COLONIA DO GURGUEIA (PI)";"PI";"COLONIA DO GURGUEIA";9;9;1;19
2013;"COLONIA DO PIAUI (PI)";"PI";"COLONIA DO PIAUI";12;4;6;22
2013;"CONCEICAO DO CANINDE (PI)";"PI";"CONCEICAO DO CANINDE";11;2;3;16
2013;"CORONEL JOSE DIAS (PI)";"PI";"CORONEL JOSE DIAS";6;3;5;14
2013;"CORRENTE (PI)";"PI";"CORRENTE";99;6;10;115
2013;"CRISTALANDIA DO PIAUI (PI)";"PI";"CRISTALANDIA DO PIAUI";5;4;3;12
2013;"CRISTINO CASTRO (PI)";"PI";"CRISTINO CASTRO";36;3;7;46
2013;"CURIMATA (PI)";"PI";"CURIMATA";24;1;6;31
2013;"CURRAIS (PI)";"PI";"CURRAIS";2;1;1;4
2013;"CURRAL NOVO DO PIAUI (PI)";"PI";"CURRAL NOVO DO PIAUI";5;5;3;13
2013;"CURRALINHOS (PI)";"PI";"CURRALINHOS";5;0;2;7
2013;"DEMERVAL LOBAO (PI)";"PI";"DEMERVAL LOBAO";61;2;8;71
2013;"DIRCEU ARCOVERDE (PI)";"PI";"DIRCEU ARCOVERDE";23;6;3;32
2013;"DOM EXPEDITO LOPES (PI)";"PI";"DOM EXPEDITO LOPES";67;9;6;82
2013;"DOM INOCENCIO (PI)";"PI";"DOM INOCENCIO";31;10;9;50
2013;"DOMINGOS MOURAO (PI)";"PI";"DOMINGOS MOURAO";3;1;5;9
2013;"ELESBAO VELOSO (PI)";"PI";"ELESBAO VELOSO";64;3;8;75
2013;"ELISEU MARTINS (PI)";"PI";"ELISEU MARTINS";10;1;2;13
2013;"ESPERANTINA (PI)";"PI";"ESPERANTINA";194;19;42;255
2013;"FARTURA DO PIAUI (PI)";"PI";"FARTURA DO PIAUI";12;3;2;17
2013;"FLORES DO PIAUI (PI)";"PI";"FLORES DO PIAUI";9;3;3;15
2013;"FLORESTA DO PIAUI (PI)";"PI";"FLORESTA DO PIAUI";5;6;3;14
2013;"FLORIANO (PI)";"PI";"FLORIANO";1069;81;66;1216
2013;"FRANCINOPOLIS (PI)";"PI";"FRANCINOPOLIS";13;8;2;23
2013;"FRANCISCO AYRES (PI)";"PI";"FRANCISCO AYRES";9;10;7;26
2013;"FRANCISCO MACEDO (PI)";"PI";"FRANCISCO MACEDO";25;2;7;34
2013;"FRANCISCO SANTOS (PI)";"PI";"FRANCISCO SANTOS";71;8;9;88
2013;"FRONTEIRAS (PI)";"PI";"FRONTEIRAS";75;14;8;97
2013;"GEMINIANO (PI)";"PI";"GEMINIANO";31;9;8;48
2013;"GILBUES (PI)";"PI";"GILBUES";6;3;7;16
2013;"GUADALUPE (PI)";"PI";"GUADALUPE";79;16;7;102
2013;"GUARIBAS (PI)";"PI";"GUARIBAS";5;0;4;9
2013;"HUGO NAPOLEAO (PI)";"PI";"HUGO NAPOLEAO";7;1;2;10
2013;"ILHA GRANDE (PI)";"PI";"ILHA GRANDE";13;5;3;21
2013;"INHUMA (PI)";"PI";"INHUMA";89;10;14;113
2013;"IPIRANGA DO PIAUI (PI)";"PI";"IPIRANGA DO PIAUI";49;11;8;68
2013;"ISAIAS COELHO (PI)";"PI";"ISAIAS COELHO";14;0;6;20
2013;"ITAINOPOLIS (PI)";"PI";"ITAINOPOLIS";43;21;17;81
2013;"ITAUEIRA (PI)";"PI";"ITAUEIRA";56;9;4;69
2013;"JACOBINA DO PIAUI (PI)";"PI";"JACOBINA DO PIAUI";46;2;1;49
2013;"JAICOS (PI)";"PI";"JAICOS";117;11;9;137
2013;"JARDIM DO MULATO (PI)";"PI";"JARDIM DO MULATO";7;2;2;11
2013;"JATOBA DO PIAUI (PI)";"PI";"JATOBA DO PIAUI";31;0;10;41
2013;"JERUMENHA (PI)";"PI";"JERUMENHA";14;1;1;16
2013;"JOAO COSTA (PI)";"PI";"JOAO COSTA";5;0;3;8
2013;"JOAQUIM PIRES (PI)";"PI";"JOAQUIM PIRES";31;2;7;40
2013;"JOCA MARQUES (PI)";"PI";"JOCA MARQUES";5;0;5;10
2013;"JOSE DE FREITAS (PI)";"PI";"JOSE DE FREITAS";103;12;36;151
2013;"JUAZEIRO DO PIAUI (PI)";"PI";"JUAZEIRO DO PIAUI";18;1;3;22
2013;"JULIO BORGES (PI)";"PI";"JULIO BORGES";4;2;2;8
2013;"JUREMA (PI)";"PI";"JUREMA";13;3;6;22
2013;"LAGOA ALEGRE (PI)";"PI";"LAGOA ALEGRE";9;2;14;25
2013;"LAGOA DE SAO FRANCISCO (PI)";"PI";"LAGOA DE SAO FRANCISCO";8;2;3;13
2013;"LAGOA DO BARRO DO PIAUI (PI)";"PI";"LAGOA DO BARRO DO PIAUI";18;5;9;32
2013;"LAGOA DO PIAUI (PI)";"PI";"LAGOA DO PIAUI";11;0;2;13
2013;"LAGOA DO SITIO (PI)";"PI";"LAGOA DO SITIO";13;1;4;18
2013;"LAGOINHA DO PIAUI (PI)";"PI";"LAGOINHA DO PIAUI";4;0;4;8
2013;"LANDRI SALES (PI)";"PI";"LANDRI SALES";12;5;2;19
2013;"LUIS CORREIA (PI)";"PI";"LUIS CORREIA";57;13;36;106
2013;"LUZILANDIA (PI)";"PI";"LUZILANDIA";50;4;19;73
2013;"MADEIRO (PI)";"PI";"MADEIRO";7;3;2;12
2013;"MANOEL EMIDIO (PI)";"PI";"MANOEL EMIDIO";11;3;7;21
2013;"MARCOLANDIA (PI)";"PI";"MARCOLANDIA";242;27;8;277
2013;"MARCOS PARENTE (PI)";"PI";"MARCOS PARENTE";7;6;0;13
2013;"MASSAPE DO PIAUI (PI)";"PI";"MASSAPE DO PIAUI";16;1;2;19
2013;"MATIAS OLIMPIO (PI)";"PI";"MATIAS OLIMPIO";22;7;5;34
2013;"MIGUEL ALVES (PI)";"PI";"MIGUEL ALVES";40;6;25;71
2013;"MIGUEL LEAO (PI)";"PI";"MIGUEL LEAO";2;0;1;3
2013;"MILTON BRANDAO (PI)";"PI";"MILTON BRANDAO";12;1;3;16
2013;"MONSENHOR GIL (PI)";"PI";"MONSENHOR GIL";28;3;6;37
2013;"MONSENHOR HIPOLITO (PI)";"PI";"MONSENHOR HIPOLITO";34;9;5;48
2013;"MONTE ALEGRE DO PIAUI (PI)";"PI";"MONTE ALEGRE DO PIAUI";11;0;3;14
2013;"MORRO CABECA NO TEMPO (PI)";"PI";"MORRO CABECA NO TEMPO";5;0;4;9
2013;"MORRO DO CHAPEU DO PIAUI (PI)";"PI";"MORRO DO CHAPEU DO PIAUI";9;1;8;18
2013;"MURICI DOS PORTELAS (PI)";"PI";"MURICI DOS PORTELAS";7;0;4;11
2013;"NAZARE DO PIAUI (PI)";"PI";"NAZARE DO PIAUI";21;16;3;40
2013;"NAZARIA (PI)";"PI";"NAZARIA";9;0;7;16
2013;"NOSSA SENHORA DE NAZARE (PI)";"PI";"NOSSA SENHORA DE NAZARE";13;2;8;23
2013;"NOSSA SENHORA DOS REMEDIOS (PI)";"PI";"NOSSA SENHORA DOS REMEDIOS";7;5;5;17
2013;"NOVA SANTA RITA (PI)";"PI";"NOVA SANTA RITA";3;6;4;13
2013;"NOVO ORIENTE DO PIAUI (PI)";"PI";"NOVO ORIENTE DO PIAUI";20;3;13;36
2013;"NOVO SANTO ANTONIO (PI)";"PI";"NOVO SANTO ANTONIO";12;2;4;18
2013;"OEIRAS (PI)";"PI";"OEIRAS";326;47;42;415
2013;"OLHO D AGUA DO PIAUI (PI)";"PI";"OLHO D AGUA DO PIAUI";6;1;3;10
2013;"PADRE MARCOS (PI)";"PI";"PADRE MARCOS";29;8;5;42
2013;"PAES LANDIM (PI)";"PI";"PAES LANDIM";5;2;1;8
2013;"PAJEU DO PIAUI (PI)";"PI";"PAJEU DO PIAUI";12;2;4;18
2013;"PALMEIRA DO PIAUI (PI)";"PI";"PALMEIRA DO PIAUI";33;3;3;39
2013;"PALMEIRAIS (PI)";"PI";"PALMEIRAIS";16;3;6;25
2013;"PAQUETA (PI)";"PI";"PAQUETA";16;7;6;29
2013;"PARNAGUA (PI)";"PI";"PARNAGUA";12;2;1;15
2013;"PARNAIBA (PI)";"PI";"PARNAIBA";1072;111;246;1429
2013;"PASSAGEM FRANCA DO PIAUI (PI)";"PI";"PASSAGEM FRANCA DO PIAUI";7;1;4;12
2013;"PATOS DO PIAUI (PI)";"PI";"PATOS DO PIAUI";22;3;6;31
2013;"PAU D ARCO DO PIAUI (PI)";"PI";"PAU D ARCO DO PIAUI";4;0;5;9
2013;"PAULISTANA (PI)";"PI";"PAULISTANA";203;13;29;245
2013;"PAVUSSU (PI)";"PI";"PAVUSSU";8;3;1;12
2013;"PEDRO II (PI)";"PI";"PEDRO II";112;30;18;160
2013;"PEDRO LAURENTINO (PI)";"PI";"PEDRO LAURENTINO";6;0;2;8
2013;"PICOS (PI)";"PI";"PICOS";1639;133;98;1870
2013;"PIMENTEIRAS (PI)";"PI";"PIMENTEIRAS";39;8;6;53
2013;"PIO IX (PI)";"PI";"PIO IX";61;8;14;83
2013;"PIRACURUCA (PI)";"PI";"PIRACURUCA";247;17;48;312
2013;"PIRIPIRI (PI)";"PI";"PIRIPIRI";356;49;144;549
2013;"PORTO (PI)";"PI";"PORTO";7;3;1;11
2013;"PORTO ALEGRE DO PIAUI (PI)";"PI";"PORTO ALEGRE DO PIAUI";7;3;2;12
2013;"PRATA DO PIAUI (PI)";"PI";"PRATA DO PIAUI";8;1;3;12
2013;"QUEIMADA NOVA (PI)";"PI";"QUEIMADA NOVA";39;2;13;54
2013;"REDENCAO DO GURGUEIA (PI)";"PI";"REDENCAO DO GURGUEIA";13;0;14;27
2013;"REGENERACAO (PI)";"PI";"REGENERACAO";84;9;14;107
2013;"RIACHO FRIO (PI)";"PI";"RIACHO FRIO";4;2;2;8
2013;"RIBEIRA DO PIAUI (PI)";"PI";"RIBEIRA DO PIAUI";6;3;2;11
2013;"RIBEIRO GONCALVES (PI)";"PI";"RIBEIRO GONCALVES";24;0;1;25
2013;"RIO GRANDE DO PIAUI (PI)";"PI";"RIO GRANDE DO PIAUI";24;9;5;38
2013;"SANTA CRUZ DO PIAUI (PI)";"PI";"SANTA CRUZ DO PIAUI";23;14;6;43
2013;"SANTA CRUZ DOS MILAGRES (PI)";"PI";"SANTA CRUZ DOS MILAGRES";4;1;3;8
2013;"SANTA FILOMENA (PI)";"PI";"SANTA FILOMENA";16;1;2;19
2013;"SANTA LUZ (PI)";"PI";"SANTA LUZ";8;1;4;13
2013;"SANTA ROSA DO PIAUI (PI)";"PI";"SANTA ROSA DO PIAUI";10;9;10;29
2013;"SANTANA DO PIAUI (PI)";"PI";"SANTANA DO PIAUI";22;15;10;47
2013;"SANTO ANTONIO DE LISBOA (PI)";"PI";"SANTO ANTONIO DE LISBOA";48;12;6;66
2013;"SANTO ANTONIO DOS MILAGRES (PI)";"PI";"SANTO ANTONIO DOS MILAGRES";3;3;2;8
2013;"SANTO INACIO DO PIAUI (PI)";"PI";"SANTO INACIO DO PIAUI";7;4;2;13
2013;"SAO BRAZ DO PIAUI (PI)";"PI";"SAO BRAZ DO PIAUI";16;1;5;22
2013;"SAO FELIX DO PIAUI (PI)";"PI";"SAO FELIX DO PIAUI";6;2;3;11
2013;"SAO FRANCISCO DE ASSIS DO PIAU (PI)";"PI";"SAO FRANCISCO DE ASSIS DO PIAU";10;0;1;11
2013;"SAO FRANCISCO DO PIAUI (PI)";"PI";"SAO FRANCISCO DO PIAUI";11;6;8;25
2013;"SAO GONCALO DO GURGUEIA (PI)";"PI";"SAO GONCALO DO GURGUEIA";2;1;1;4
2013;"SAO GONCALO DO PIAUI (PI)";"PI";"SAO GONCALO DO PIAUI";12;3;5;20
2013;"SAO JOAO DA CANABRAVA (PI)";"PI";"SAO JOAO DA CANABRAVA";17;9;5;31
2013;"SAO JOAO DA FRONTEIRA (PI)";"PI";"SAO JOAO DA FRONTEIRA";5;1;6;12
2013;"SAO JOAO DA SERRA (PI)";"PI";"SAO JOAO DA SERRA";13;0;2;15
2013;"SAO JOAO DA VARJOTA (PI)";"PI";"SAO JOAO DA VARJOTA";4;6;4;14
2013;"SAO JOAO DO ARRAIAL (PI)";"PI";"SAO JOAO DO ARRAIAL";11;3;3;17
2013;"SAO JOAO DO PIAUI (PI)";"PI";"SAO JOAO DO PIAUI";107;15;17;139
2013;"SAO JOSE DO DIVINO (PI)";"PI";"SAO JOSE DO DIVINO";19;3;3;25
2013;"SAO JOSE DO PEIXE (PI)";"PI";"SAO JOSE DO PEIXE";3;2;4;9
2013;"SAO JOSE DO PIAUI (PI)";"PI";"SAO JOSE DO PIAUI";33;8;6;47
2013;"SAO JULIAO (PI)";"PI";"SAO JULIAO";21;8;5;34
2013;"SAO LOURENCO DO PIAUI (PI)";"PI";"SAO LOURENCO DO PIAUI";5;4;5;14
2013;"SAO LUIS DO PIAUI (PI)";"PI";"SAO LUIS DO PIAUI";13;4;2;19
2013;"SAO MIGUEL DA BAIXA GRANDE (PI)";"PI";"SAO MIGUEL DA BAIXA GRANDE";9;2;3;14
2013;"SAO MIGUEL DO FIDALGO (PI)";"PI";"SAO MIGUEL DO FIDALGO";3;1;2;6
2013;"SAO MIGUEL DO TAPUIO (PI)";"PI";"SAO MIGUEL DO TAPUIO";30;3;17;50
2013;"SAO PEDRO DO PIAUI (PI)";"PI";"SAO PEDRO DO PIAUI";41;2;9;52
2013;"SAO RAIMUNDO NONATO (PI)";"PI";"SAO RAIMUNDO NONATO";282;42;41;365
2013;"SEBASTIAO BARROS (PI)";"PI";"SEBASTIAO BARROS";4;2;2;8
2013;"SEBASTIAO LEAL (PI)";"PI";"SEBASTIAO LEAL";27;1;3;31
2013;"SIGEFREDO PACHECO (PI)";"PI";"SIGEFREDO PACHECO";30;5;6;41
2013;"SIMOES (PI)";"PI";"SIMOES";59;7;7;73
2013;"SIMPLICIO MENDES (PI)";"PI";"SIMPLICIO MENDES";68;7;8;83
2013;"SOCORRO DO PIAUI (PI)";"PI";"SOCORRO DO PIAUI";3;2;1;6
2013;"SUSSUAPARA (PI)";"PI";"SUSSUAPARA";37;15;5;57
2013;"TAMBORIL DO PIAUI (PI)";"PI";"TAMBORIL DO PIAUI";3;1;1;5
2013;"TANQUE DO PIAUI (PI)";"PI";"TANQUE DO PIAUI";13;2;5;20
2013;"TERESINA (PI)";"PI";"TERESINA";10674;1028;2972;14674
2013;"UNIAO (PI)";"PI";"UNIAO";126;31;47;204
2013;"URUCUI (PI)";"PI";"URUCUI";156;10;19;185
2013;"VALENCA DO PIAUI (PI)";"PI";"VALENCA DO PIAUI";145;28;30;203
2013;"VARZEA BRANCA (PI)";"PI";"VARZEA BRANCA";18;4;10;32
2013;"VARZEA GRANDE (PI)";"PI";"VARZEA GRANDE";12;5;3;20
2013;"VERA MENDES (PI)";"PI";"VERA MENDES";12;6;2;20
2013;"VILA NOVA DO PIAUI (PI)";"PI";"VILA NOVA DO PIAUI";16;7;5;28
2013;"WALL FERRAZ (PI)";"PI";"WALL FERRAZ";15;11;8;34
2013;"ABATIA (PR)";"PR";"ABATIA";122;3;43;168
2013;"ADRIANOPOLIS (PR)";"PR";"ADRIANOPOLIS";130;9;18;157
2013;"AGUDOS DO SUL (PR)";"PR";"AGUDOS DO SUL";374;11;27;412
2013;"ALMIRANTE TAMANDARE (PR)";"PR";"ALMIRANTE TAMANDARE";1479;94;228;1801
2013;"ALTAMIRA DO PARANA (PR)";"PR";"ALTAMIRA DO PARANA";46;2;16;64
2013;"ALTO PARAISO (PR)";"PR";"ALTO PARAISO";46;8;11;65
2013;"ALTO PARANA (PR)";"PR";"ALTO PARANA";284;14;83;381
2013;"ALTO PIQUIRI (PR)";"PR";"ALTO PIQUIRI";197;9;44;250
2013;"ALTONIA (PR)";"PR";"ALTONIA";442;23;43;508
2013;"ALVORADA DO SUL (PR)";"PR";"ALVORADA DO SUL";298;9;47;354
2013;"AMAPORA (PR)";"PR";"AMAPORA";76;8;56;140
2013;"AMPERE (PR)";"PR";"AMPERE";480;15;39;534
2013;"ANAHY (PR)";"PR";"ANAHY";92;2;6;100
2013;"ANDIRA (PR)";"PR";"ANDIRA";568;12;83;663
2013;"ANGULO (PR)";"PR";"ANGULO";77;3;8;88
2013;"ANTONINA (PR)";"PR";"ANTONINA";103;15;43;161
2013;"ANTONIO OLINTO (PR)";"PR";"ANTONIO OLINTO";167;5;43;215
2013;"APUCARANA (PR)";"PR";"APUCARANA";2498;342;292;3132
2013;"ARAPONGAS (PR)";"PR";"ARAPONGAS";3377;235;119;3731
2013;"ARAPOTI (PR)";"PR";"ARAPOTI";572;38;60;670
2013;"ARAPUA (PR)";"PR";"ARAPUA";93;4;28;125
2013;"ARARUNA (PR)";"PR";"ARARUNA";404;21;32;457
2013;"ARAUCARIA (PR)";"PR";"ARAUCARIA";2916;359;651;3926
2013;"ARIRANHA DO IVAI (PR)";"PR";"ARIRANHA DO IVAI";61;2;15;78
2013;"ASSAI (PR)";"PR";"ASSAI";487;24;44;555
2013;"ASSIS CHATEAUBRIAND (PR)";"PR";"ASSIS CHATEAUBRIAND";1171;43;71;1285
2013;"ASTORGA (PR)";"PR";"ASTORGA";674;43;99;816
2013;"ATALAIA (PR)";"PR";"ATALAIA";116;12;28;156
2013;"BALSA NOVA (PR)";"PR";"BALSA NOVA";385;13;57;455
2013;"BANDEIRANTES (PR)";"PR";"BANDEIRANTES";819;57;106;982
2013;"BARBOSA FERRAZ (PR)";"PR";"BARBOSA FERRAZ";197;8;36;241
2013;"BARRA DO JACARE (PR)";"PR";"BARRA DO JACARE";51;7;9;67
2013;"BARRACAO (PR)";"PR";"BARRACAO";235;26;40;301
2013;"BELA VISTA DO CAROBA (PR)";"PR";"BELA VISTA DO CAROBA";57;2;18;77
2013;"BELA VISTA DO PARAISO (PR)";"PR";"BELA VISTA DO PARAISO";429;27;55;511
2013;"BITURUNA (PR)";"PR";"BITURUNA";439;23;171;633
2013;"BOA ESPERANCA (PR)";"PR";"BOA ESPERANCA";194;7;13;214
2013;"BOA ESPERANCA DO IGUACU (PR)";"PR";"BOA ESPERANCA DO IGUACU";70;2;12;84
2013;"BOA VENTURA DE SAO ROQUE (PR)";"PR";"BOA VENTURA DE SAO ROQUE";187;12;37;236
2013;"BOA VISTA DA APARECIDA (PR)";"PR";"BOA VISTA DA APARECIDA";174;9;23;206
2013;"BOCAIUVA DO SUL (PR)";"PR";"BOCAIUVA DO SUL";301;11;22;334
2013;"BOM JESUS DO SUL (PR)";"PR";"BOM JESUS DO SUL";50;4;14;68
2013;"BOM SUCESSO (PR)";"PR";"BOM SUCESSO";125;7;67;199
2013;"BOM SUCESSO DO SUL (PR)";"PR";"BOM SUCESSO DO SUL";115;7;9;131
2013;"BORRAZOPOLIS (PR)";"PR";"BORRAZOPOLIS";276;8;8;292
2013;"BRAGANEY (PR)";"PR";"BRAGANEY";172;6;21;199
2013;"BRASILANDIA DO SUL (PR)";"PR";"BRASILANDIA DO SUL";73;5;8;86
2013;"CAFEARA (PR)";"PR";"CAFEARA";38;4;19;61
2013;"CAFELANDIA (PR)";"PR";"CAFELANDIA";576;29;57;662
2013;"CAFEZAL DO SUL (PR)";"PR";"CAFEZAL DO SUL";86;1;27;114
2013;"CALIFORNIA (PR)";"PR";"CALIFORNIA";257;15;19;291
2013;"CAMBARA (PR)";"PR";"CAMBARA";799;35;92;926
2013;"CAMBE (PR)";"PR";"CAMBE";1953;258;144;2355
2013;"CAMBIRA (PR)";"PR";"CAMBIRA";271;5;24;300
2013;"CAMPINA DA LAGOA (PR)";"PR";"CAMPINA DA LAGOA";414;22;39;475
2013;"CAMPINA DO SIMAO (PR)";"PR";"CAMPINA DO SIMAO";90;2;27;119
2013;"CAMPINA GRANDE DO SUL (PR)";"PR";"CAMPINA GRANDE DO SUL";852;94;79;1025
2013;"CAMPO BONITO (PR)";"PR";"CAMPO BONITO";99;10;10;119
2013;"CAMPO DO TENENTE (PR)";"PR";"CAMPO DO TENENTE";163;10;42;215
2013;"CAMPO LARGO (PR)";"PR";"CAMPO LARGO";2369;309;480;3158
2013;"CAMPO MAGRO (PR)";"PR";"CAMPO MAGRO";507;67;21;595
2013;"CAMPO MOURAO (PR)";"PR";"CAMPO MOURAO";2292;124;575;2991
2013;"CANDIDO DE ABREU (PR)";"PR";"CANDIDO DE ABREU";237;11;56;304
2013;"CANDOI (PR)";"PR";"CANDOI";405;11;113;529
2013;"CANTAGALO (PR)";"PR";"CANTAGALO";264;9;45;318
2013;"CAPANEMA (PR)";"PR";"CAPANEMA";461;13;58;532
2013;"CAPITAO LEONIDAS MARQUES (PR)";"PR";"CAPITAO LEONIDAS MARQUES";599;17;49;665
2013;"CARAMBEI (PR)";"PR";"CARAMBEI";647;37;65;749
2013;"CARLOPOLIS (PR)";"PR";"CARLOPOLIS";283;23;58;364
2013;"CASCAVEL (PR)";"PR";"CASCAVEL";7930;383;980;9293
2013;"CASTRO (PR)";"PR";"CASTRO";1847;218;273;2338
2013;"CATANDUVAS (PR)";"PR";"CATANDUVAS";211;12;37;260
2013;"CENTENARIO DO SUL (PR)";"PR";"CENTENARIO DO SUL";141;29;72;242
2013;"CERRO AZUL (PR)";"PR";"CERRO AZUL";443;18;62;523
2013;"CEU AZUL (PR)";"PR";"CEU AZUL";330;17;42;389
2013;"CHOPINZINHO (PR)";"PR";"CHOPINZINHO";582;20;76;678
2013;"CIANORTE (PR)";"PR";"CIANORTE";1662;95;222;1979
2013;"CIDADE GAUCHA (PR)";"PR";"CIDADE GAUCHA";300;14;80;394
2013;"CLEVELANDIA (PR)";"PR";"CLEVELANDIA";564;40;43;647
2013;"COLOMBO (PR)";"PR";"COLOMBO";4341;318;525;5184
2013;"COLORADO (PR)";"PR";"COLORADO";574;41;130;745
2013;"CONGONHINHAS (PR)";"PR";"CONGONHINHAS";122;6;37;165
2013;"CONSELHEIRO MAIRINCK (PR)";"PR";"CONSELHEIRO MAIRINCK";44;4;11;59
2013;"CONTENDA (PR)";"PR";"CONTENDA";738;18;48;804
2013;"CORBELIA (PR)";"PR";"CORBELIA";765;23;54;842
2013;"CORNELIO PROCOPIO (PR)";"PR";"CORNELIO PROCOPIO";1080;114;137;1331
2013;"CORONEL DOMINGOS SOARES (PR)";"PR";"CORONEL DOMINGOS SOARES";137;7;27;171
2013;"CORONEL VIVIDA (PR)";"PR";"CORONEL VIVIDA";734;25;107;866
2013;"CORUMBATAI DO SUL (PR)";"PR";"CORUMBATAI DO SUL";64;2;25;91
2013;"CRUZ MACHADO (PR)";"PR";"CRUZ MACHADO";566;19;98;683
2013;"CRUZEIRO DO IGUACU (PR)";"PR";"CRUZEIRO DO IGUACU";75;3;16;94
2013;"CRUZEIRO DO OESTE (PR)";"PR";"CRUZEIRO DO OESTE";497;19;72;588
2013;"CRUZEIRO DO SUL (PR)";"PR";"CRUZEIRO DO SUL";74;6;23;103
2013;"CRUZMALTINA (PR)";"PR";"CRUZMALTINA";87;2;9;98
2013;"CURITIBA (PR)";"PR";"CURITIBA";40115;3940;7453;51508
2013;"CURIUVA (PR)";"PR";"CURIUVA";253;20;92;365
2013;"DIAMANTE D OESTE (PR)";"PR";"DIAMANTE D OESTE";77;6;21;104
2013;"DIAMANTE DO NORTE (PR)";"PR";"DIAMANTE DO NORTE";68;3;30;101
2013;"DIAMANTE DO SUL (PR)";"PR";"DIAMANTE DO SUL";40;3;10;53
2013;"DOIS VIZINHOS (PR)";"PR";"DOIS VIZINHOS";1103;68;105;1276
2013;"DOURADINA (PR)";"PR";"DOURADINA";406;10;16;432
2013;"DOUTOR CAMARGO (PR)";"PR";"DOUTOR CAMARGO";177;4;55;236
2013;"DOUTOR ULYSSES (PR)";"PR";"DOUTOR ULYSSES";56;3;21;80
2013;"ENEAS MARQUES (PR)";"PR";"ENEAS MARQUES";172;7;25;204
2013;"ENGENHEIRO BELTRAO (PR)";"PR";"ENGENHEIRO BELTRAO";499;15;88;602
2013;"ENTRE RIOS DO OESTE (PR)";"PR";"ENTRE RIOS DO OESTE";134;4;7;145
2013;"ESPERANCA NOVA (PR)";"PR";"ESPERANCA NOVA";30;4;4;38
2013;"ESPIGAO ALTO DO IGUACU (PR)";"PR";"ESPIGAO ALTO DO IGUACU";75;8;10;93
2013;"FAROL (PR)";"PR";"FAROL";90;0;12;102
2013;"FAXINAL (PR)";"PR";"FAXINAL";422;18;42;482
2013;"FAZENDA RIO GRANDE (PR)";"PR";"FAZENDA RIO GRANDE";1202;67;246;1515
2013;"FENIX (PR)";"PR";"FENIX";104;5;14;123
2013;"FERNANDES PINHEIRO (PR)";"PR";"FERNANDES PINHEIRO";107;6;22;135
2013;"FIGUEIRA (PR)";"PR";"FIGUEIRA";142;10;27;179
2013;"FLOR DA SERRA DO SUL (PR)";"PR";"FLOR DA SERRA DO SUL";108;4;25;137
2013;"FLORAI (PR)";"PR";"FLORAI";151;6;24;181
2013;"FLORESTA (PR)";"PR";"FLORESTA";262;19;23;304
2013;"FLORESTOPOLIS (PR)";"PR";"FLORESTOPOLIS";192;20;100;312
2013;"FLORIDA (PR)";"PR";"FLORIDA";66;7;18;91
2013;"FORMOSA DO OESTE (PR)";"PR";"FORMOSA DO OESTE";230;13;22;265
2013;"FOZ DO IGUACU (PR)";"PR";"FOZ DO IGUACU";3453;1129;1053;5635
2013;"FOZ DO JORDAO (PR)";"PR";"FOZ DO JORDAO";79;5;19;103
2013;"FRANCISCO ALVES (PR)";"PR";"FRANCISCO ALVES";176;3;23;202
2013;"FRANCISCO BELTRAO (PR)";"PR";"FRANCISCO BELTRAO";2114;156;209;2479
2013;"GENERAL CARNEIRO (PR)";"PR";"GENERAL CARNEIRO";414;22;68;504
2013;"GODOY MOREIRA (PR)";"PR";"GODOY MOREIRA";55;3;12;70
2013;"GOIOERE (PR)";"PR";"GOIOERE";680;45;59;784
2013;"GOIOXIM (PR)";"PR";"GOIOXIM";106;12;31;149
2013;"GRANDES RIOS (PR)";"PR";"GRANDES RIOS";102;10;12;124
2013;"GUAIRA (PR)";"PR";"GUAIRA";1110;38;120;1268
2013;"GUAIRACA (PR)";"PR";"GUAIRACA";138;7;34;179
2013;"GUAMIRANGA (PR)";"PR";"GUAMIRANGA";169;10;37;216
2013;"GUAPIRAMA (PR)";"PR";"GUAPIRAMA";117;4;19;140
2013;"GUAPOREMA (PR)";"PR";"GUAPOREMA";49;2;9;60
2013;"GUARACI (PR)";"PR";"GUARACI";110;4;31;145
2013;"GUARANIACU (PR)";"PR";"GUARANIACU";421;30;51;502
2013;"GUARAPUAVA (PR)";"PR";"GUARAPUAVA";4577;480;470;5527
2013;"GUARAQUECABA (PR)";"PR";"GUARAQUECABA";28;2;11;41
2013;"GUARATUBA (PR)";"PR";"GUARATUBA";381;29;51;461
2013;"HONORIO SERPA (PR)";"PR";"HONORIO SERPA";114;5;39;158
2013;"IBAITI (PR)";"PR";"IBAITI";561;35;160;756
2013;"IBEMA (PR)";"PR";"IBEMA";150;8;16;174
2013;"IBIPORA (PR)";"PR";"IBIPORA";1076;53;155;1284
2013;"ICARAIMA (PR)";"PR";"ICARAIMA";143;11;39;193
2013;"IGUARACU (PR)";"PR";"IGUARACU";83;6;7;96
2013;"IGUATU (PR)";"PR";"IGUATU";43;1;6;50
2013;"IMBAU (PR)";"PR";"IMBAU";216;18;27;261
2013;"IMBITUVA (PR)";"PR";"IMBITUVA";762;30;54;846
2013;"INACIO MARTINS (PR)";"PR";"INACIO MARTINS";272;33;38;343
2013;"INAJA (PR)";"PR";"INAJA";34;3;19;56
2013;"INDIANOPOLIS (PR)";"PR";"INDIANOPOLIS";195;3;12;210
2013;"IPIRANGA (PR)";"PR";"IPIRANGA";324;27;59;410
2013;"IPORA (PR)";"PR";"IPORA";387;13;39;439
2013;"IRACEMA DO OESTE (PR)";"PR";"IRACEMA DO OESTE";77;4;7;88
2013;"IRATI (PR)";"PR";"IRATI";1581;103;141;1825
2013;"IRETAMA (PR)";"PR";"IRETAMA";184;3;38;225
2013;"ITAGUAJE (PR)";"PR";"ITAGUAJE";76;10;37;123
2013;"ITAIPULANDIA (PR)";"PR";"ITAIPULANDIA";224;23;35;282
2013;"ITAMBARACA (PR)";"PR";"ITAMBARACA";148;10;26;184
2013;"ITAMBE (PR)";"PR";"ITAMBE";180;4;31;215
2013;"ITAPEJARA D OESTE (PR)";"PR";"ITAPEJARA D OESTE";320;11;36;367
2013;"ITAPERUCU (PR)";"PR";"ITAPERUCU";641;72;95;808
2013;"ITAUNA DO SUL (PR)";"PR";"ITAUNA DO SUL";49;5;10;64
2013;"IVAI (PR)";"PR";"IVAI";352;12;38;402
2013;"IVAIPORA (PR)";"PR";"IVAIPORA";887;34;99;1020
2013;"IVATE (PR)";"PR";"IVATE";202;9;68;279
2013;"IVATUBA (PR)";"PR";"IVATUBA";57;6;6;69
2013;"JABOTI (PR)";"PR";"JABOTI";84;8;15;107
2013;"JACAREZINHO (PR)";"PR";"JACAREZINHO";587;105;145;837
2013;"JAGUAPITA (PR)";"PR";"JAGUAPITA";341;29;60;430
2013;"JAGUARIAIVA (PR)";"PR";"JAGUARIAIVA";769;58;112;939
2013;"JANDAIA DO SUL (PR)";"PR";"JANDAIA DO SUL";628;38;96;762
2013;"JANIOPOLIS (PR)";"PR";"JANIOPOLIS";154;5;27;186
2013;"JAPIRA (PR)";"PR";"JAPIRA";52;1;20;73
2013;"JAPURA (PR)";"PR";"JAPURA";277;6;23;306
2013;"JARDIM ALEGRE (PR)";"PR";"JARDIM ALEGRE";234;9;33;276
2013;"JARDIM OLINDA (PR)";"PR";"JARDIM OLINDA";41;2;6;49
2013;"JATAIZINHO (PR)";"PR";"JATAIZINHO";354;27;26;407
2013;"JESUITAS (PR)";"PR";"JESUITAS";289;16;31;336
2013;"JOAQUIM TAVORA (PR)";"PR";"JOAQUIM TAVORA";252;19;29;300
2013;"JUNDIAI DO SUL (PR)";"PR";"JUNDIAI DO SUL";30;3;26;59
2013;"JURANDA (PR)";"PR";"JURANDA";310;3;11;324
2013;"JUSSARA (PR)";"PR";"JUSSARA";180;5;40;225
2013;"KALORE (PR)";"PR";"KALORE";157;14;19;190
2013;"LAPA (PR)";"PR";"LAPA";1272;126;168;1566
2013;"LARANJAL (PR)";"PR";"LARANJAL";61;6;21;88
2013;"LARANJEIRAS DO SUL (PR)";"PR";"LARANJEIRAS DO SUL";802;39;86;927
2013;"LEOPOLIS (PR)";"PR";"LEOPOLIS";85;5;9;99
2013;"LIDIANOPOLIS (PR)";"PR";"LIDIANOPOLIS";84;6;23;113
2013;"LINDOESTE (PR)";"PR";"LINDOESTE";107;10;32;149
2013;"LOANDA (PR)";"PR";"LOANDA";441;15;57;513
2013;"LOBATO (PR)";"PR";"LOBATO";162;4;33;199
2013;"LONDRINA (PR)";"PR";"LONDRINA";9179;803;1948;11930
2013;"LUIZIANA (PR)";"PR";"LUIZIANA";176;8;16;200
2013;"LUNARDELLI (PR)";"PR";"LUNARDELLI";95;8;9;112
2013;"LUPIONOPOLIS (PR)";"PR";"LUPIONOPOLIS";103;32;90;225
2013;"MALLET (PR)";"PR";"MALLET";376;13;57;446
2013;"MAMBORE (PR)";"PR";"MAMBORE";578;5;43;626
2013;"MANDAGUACU (PR)";"PR";"MANDAGUACU";474;24;46;544
2013;"MANDAGUARI (PR)";"PR";"MANDAGUARI";803;43;65;911
2013;"MANDIRITUBA (PR)";"PR";"MANDIRITUBA";1044;40;69;1153
2013;"MANFRINOPOLIS (PR)";"PR";"MANFRINOPOLIS";38;5;22;65
2013;"MANGUEIRINHA (PR)";"PR";"MANGUEIRINHA";499;31;63;593
2013;"MANOEL RIBAS (PR)";"PR";"MANOEL RIBAS";346;16;32;394
2013;"MARECHAL CANDIDO RONDON (PR)";"PR";"MARECHAL CANDIDO RONDON";1474;84;175;1733
2013;"MARIA HELENA (PR)";"PR";"MARIA HELENA";111;6;25;142
2013;"MARIALVA (PR)";"PR";"MARIALVA";914;53;81;1048
2013;"MARILANDIA DO SUL (PR)";"PR";"MARILANDIA DO SUL";274;15;27;316
2013;"MARILENA (PR)";"PR";"MARILENA";116;7;30;153
2013;"MARILUZ (PR)";"PR";"MARILUZ";185;13;69;267
2013;"MARINGA (PR)";"PR";"MARINGA";9548;521;941;11010
2013;"MARIOPOLIS (PR)";"PR";"MARIOPOLIS";240;17;35;292
2013;"MARIPA (PR)";"PR";"MARIPA";315;8;12;335
2013;"MARMELEIRO (PR)";"PR";"MARMELEIRO";359;24;53;436
2013;"MARQUINHO (PR)";"PR";"MARQUINHO";67;7;15;89
2013;"MARUMBI (PR)";"PR";"MARUMBI";98;15;21;134
2013;"MATELANDIA (PR)";"PR";"MATELANDIA";595;10;60;665
2013;"MATINHOS (PR)";"PR";"MATINHOS";342;35;28;405
2013;"MATO RICO (PR)";"PR";"MATO RICO";57;3;10;70
2013;"MAUA DA SERRA (PR)";"PR";"MAUA DA SERRA";216;9;24;249
2013;"MEDIANEIRA (PR)";"PR";"MEDIANEIRA";1320;58;102;1480
2013;"MERCEDES (PR)";"PR";"MERCEDES";232;6;31;269
2013;"MIRADOR (PR)";"PR";"MIRADOR";14;0;10;24
2013;"MIRASELVA (PR)";"PR";"MIRASELVA";36;4;24;64
2013;"MISSAL (PR)";"PR";"MISSAL";375;25;35;435
2013;"MOREIRA SALES (PR)";"PR";"MOREIRA SALES";254;11;95;360
2013;"MORRETES (PR)";"PR";"MORRETES";217;22;40;279
2013;"MUNHOZ DE MELLO (PR)";"PR";"MUNHOZ DE MELLO";70;6;9;85
2013;"NOSSA SENHORA DAS GRACAS (PR)";"PR";"NOSSA SENHORA DAS GRACAS";33;8;36;77
2013;"NOVA ALIANCA DO IVAI (PR)";"PR";"NOVA ALIANCA DO IVAI";20;3;4;27
2013;"NOVA AMERICA DA COLINA (PR)";"PR";"NOVA AMERICA DA COLINA";126;6;15;147
2013;"NOVA AURORA (PR)";"PR";"NOVA AURORA";448;12;46;506
2013;"NOVA CANTU (PR)";"PR";"NOVA CANTU";127;0;23;150
2013;"NOVA ESPERANCA (PR)";"PR";"NOVA ESPERANCA";849;41;73;963
2013;"NOVA ESPERANCA DO SUDOESTE (PR)";"PR";"NOVA ESPERANCA DO SUDOESTE";137;12;31;180
2013;"NOVA FATIMA (PR)";"PR";"NOVA FATIMA";265;3;42;310
2013;"NOVA LARANJEIRAS (PR)";"PR";"NOVA LARANJEIRAS";167;7;32;206
2013;"NOVA LONDRINA (PR)";"PR";"NOVA LONDRINA";400;14;45;459
2013;"NOVA OLIMPIA (PR)";"PR";"NOVA OLIMPIA";104;3;20;127
2013;"NOVA PRATA DO IGUACU (PR)";"PR";"NOVA PRATA DO IGUACU";299;10;31;340
2013;"NOVA SANTA BARBARA (PR)";"PR";"NOVA SANTA BARBARA";125;12;7;144
2013;"NOVA SANTA ROSA (PR)";"PR";"NOVA SANTA ROSA";365;13;16;394
2013;"NOVA TEBAS (PR)";"PR";"NOVA TEBAS";112;7;26;145
2013;"NOVO ITACOLOMI (PR)";"PR";"NOVO ITACOLOMI";93;2;10;105
2013;"ORTIGUEIRA (PR)";"PR";"ORTIGUEIRA";353;29;87;469
2013;"OURIZONA (PR)";"PR";"OURIZONA";84;5;17;106
2013;"OURO VERDE DO OESTE (PR)";"PR";"OURO VERDE DO OESTE";156;2;15;173
2013;"PAICANDU (PR)";"PR";"PAICANDU";513;30;59;602
2013;"PALMAS (PR)";"PR";"PALMAS";933;72;95;1100
2013;"PALMEIRA (PR)";"PR";"PALMEIRA";958;45;85;1088
2013;"PALMITAL (PR)";"PR";"PALMITAL";262;16;54;332
2013;"PALOTINA (PR)";"PR";"PALOTINA";1269;31;106;1406
2013;"PARAISO DO NORTE (PR)";"PR";"PARAISO DO NORTE";257;18;59;334
2013;"PARANACITY (PR)";"PR";"PARANACITY";271;20;50;341
2013;"PARANAGUA (PR)";"PR";"PARANAGUA";1813;167;159;2139
2013;"PARANAPOEMA (PR)";"PR";"PARANAPOEMA";67;4;18;89
2013;"PARANAVAI (PR)";"PR";"PARANAVAI";2066;122;236;2424
2013;"PATO BRAGADO (PR)";"PR";"PATO BRAGADO";155;5;15;175
2013;"PATO BRANCO (PR)";"PR";"PATO BRANCO";2243;162;413;2818
2013;"PAULA FREITAS (PR)";"PR";"PAULA FREITAS";145;3;22;170
2013;"PAULO FRONTIN (PR)";"PR";"PAULO FRONTIN";210;3;13;226
2013;"PEABIRU (PR)";"PR";"PEABIRU";311;12;27;350
2013;"PEROBAL (PR)";"PR";"PEROBAL";109;5;30;144
2013;"PEROLA (PR)";"PR";"PEROLA";213;14;16;243
2013;"PEROLA D OESTE (PR)";"PR";"PEROLA D OESTE";190;4;22;216
2013;"PIEN (PR)";"PR";"PIEN";411;22;20;453
2013;"PINHAIS (PR)";"PR";"PINHAIS";2376;239;456;3071
2013;"PINHAL DO SAO BENTO (PR)";"PR";"PINHAL DO SAO BENTO";49;4;14;67
2013;"PINHALAO (PR)";"PR";"PINHALAO";106;7;20;133
2013;"PINHAO (PR)";"PR";"PINHAO";540;43;112;695
2013;"PIRAI DO SUL (PR)";"PR";"PIRAI DO SUL";460;42;97;599
2013;"PIRAQUARA (PR)";"PR";"PIRAQUARA";637;94;195;926
2013;"PITANGA (PR)";"PR";"PITANGA";866;34;121;1021
2013;"PITANGUEIRAS (PR)";"PR";"PITANGUEIRAS";62;4;28;94
2013;"PLANALTINA DO PARANA (PR)";"PR";"PLANALTINA DO PARANA";108;6;20;134
2013;"PLANALTO (PR)";"PR";"PLANALTO";318;17;39;374
2013;"PONTA GROSSA (PR)";"PR";"PONTA GROSSA";6287;639;1074;8000
2013;"PONTAL DO PARANA (PR)";"PR";"PONTAL DO PARANA";260;16;49;325
2013;"PORECATU (PR)";"PR";"PORECATU";299;30;139;468
2013;"PORTO AMAZONAS (PR)";"PR";"PORTO AMAZONAS";86;8;11;105
2013;"PORTO BARREIRO (PR)";"PR";"PORTO BARREIRO";68;5;27;100
2013;"PORTO RICO (PR)";"PR";"PORTO RICO";31;0;7;38
2013;"PORTO VITORIA (PR)";"PR";"PORTO VITORIA";170;3;11;184
2013;"PRADO FERREIRA (PR)";"PR";"PRADO FERREIRA";100;4;14;118
2013;"PRANCHITA (PR)";"PR";"PRANCHITA";251;9;16;276
2013;"PRESIDENTE CASTELO BRANCO (PR)";"PR";"PRESIDENTE CASTELO BRANCO";113;4;26;143
2013;"PRIMEIRO DE MAIO (PR)";"PR";"PRIMEIRO DE MAIO";335;16;28;379
2013;"PRUDENTOPOLIS (PR)";"PR";"PRUDENTOPOLIS";1323;47;118;1488
2013;"QUARTO CENTENARIO (PR)";"PR";"QUARTO CENTENARIO";137;6;8;151
2013;"QUATIGUA (PR)";"PR";"QUATIGUA";366;11;22;399
2013;"QUATRO BARRAS (PR)";"PR";"QUATRO BARRAS";627;43;125;795
2013;"QUATRO PONTES (PR)";"PR";"QUATRO PONTES";173;6;7;186
2013;"QUEDAS DO IGUACU (PR)";"PR";"QUEDAS DO IGUACU";751;34;137;922
2013;"QUERENCIA DO NORTE (PR)";"PR";"QUERENCIA DO NORTE";212;6;33;251
2013;"QUINTA DO SOL (PR)";"PR";"QUINTA DO SOL";120;4;20;144
2013;"QUITANDINHA (PR)";"PR";"QUITANDINHA";506;9;78;593
2013;"RAMILANDIA (PR)";"PR";"RAMILANDIA";59;3;13;75
2013;"RANCHO ALEGRE (PR)";"PR";"RANCHO ALEGRE";115;5;13;133
2013;"RANCHO ALEGRE D OESTE (PR)";"PR";"RANCHO ALEGRE D OESTE";83;1;10;94
2013;"REALEZA (PR)";"PR";"REALEZA";589;24;40;653
2013;"REBOUCAS (PR)";"PR";"REBOUCAS";286;17;47;350
2013;"RENASCENCA (PR)";"PR";"RENASCENCA";241;10;39;290
2013;"RESERVA (PR)";"PR";"RESERVA";614;28;81;723
2013;"RESERVA DO IGUACU (PR)";"PR";"RESERVA DO IGUACU";80;11;21;112
2013;"RIBEIRAO CLARO (PR)";"PR";"RIBEIRAO CLARO";223;32;33;288
2013;"RIBEIRAO DO PINHAL (PR)";"PR";"RIBEIRAO DO PINHAL";208;31;44;283
2013;"RIO AZUL (PR)";"PR";"RIO AZUL";290;11;39;340
2013;"RIO BOM (PR)";"PR";"RIO BOM";83;6;9;98
2013;"RIO BONITO DO IGUACU (PR)";"PR";"RIO BONITO DO IGUACU";265;9;74;348
2013;"RIO BRANCO DO IVAI (PR)";"PR";"RIO BRANCO DO IVAI";42;6;13;61
2013;"RIO BRANCO DO SUL (PR)";"PR";"RIO BRANCO DO SUL";732;98;156;986
2013;"RIO NEGRO (PR)";"PR";"RIO NEGRO";961;73;65;1099
2013;"ROLANDIA (PR)";"PR";"ROLANDIA";1708;122;126;1956
2013;"RONCADOR (PR)";"PR";"RONCADOR";345;5;41;391
2013;"RONDON (PR)";"PR";"RONDON";270;15;68;353
2013;"ROSARIO DO IVAI (PR)";"PR";"ROSARIO DO IVAI";89;7;25;121
2013;"SABAUDIA (PR)";"PR";"SABAUDIA";206;9;18;233
2013;"SALGADO FILHO (PR)";"PR";"SALGADO FILHO";81;4;26;111
2013;"SALTO DO ITARARE (PR)";"PR";"SALTO DO ITARARE";104;5;17;126
2013;"SALTO DO LONTRA (PR)";"PR";"SALTO DO LONTRA";273;13;35;321
2013;"SANTA AMELIA (PR)";"PR";"SANTA AMELIA";95;4;20;119
2013;"SANTA CECILIA DO PAVAO (PR)";"PR";"SANTA CECILIA DO PAVAO";82;7;11;100
2013;"SANTA CRUZ DO MONTE CASTELO (PR)";"PR";"SANTA CRUZ DO MONTE CASTELO";205;9;44;258
2013;"SANTA FE (PR)";"PR";"SANTA FE";257;10;33;300
2013;"SANTA HELENA (PR)";"PR";"SANTA HELENA";613;50;124;787
2013;"SANTA INES (PR)";"PR";"SANTA INES";15;7;7;29
2013;"SANTA ISABEL DO IVAI (PR)";"PR";"SANTA ISABEL DO IVAI";192;14;32;238
2013;"SANTA IZABEL DO OESTE (PR)";"PR";"SANTA IZABEL DO OESTE";211;25;33;269
2013;"SANTA LUCIA (PR)";"PR";"SANTA LUCIA";109;1;11;121
2013;"SANTA MARIA DO OESTE (PR)";"PR";"SANTA MARIA DO OESTE";226;8;23;257
2013;"SANTA MARIANA (PR)";"PR";"SANTA MARIANA";298;22;48;368
2013;"SANTA MONICA (PR)";"PR";"SANTA MONICA";50;3;12;65
2013;"SANTA TEREZA DO OESTE (PR)";"PR";"SANTA TEREZA DO OESTE";226;10;13;249
2013;"SANTA TEREZINHA DE ITAIPU (PR)";"PR";"SANTA TEREZINHA DE ITAIPU";479;48;60;587
2013;"SANTANA DO ITARARE (PR)";"PR";"SANTANA DO ITARARE";83;5;18;106
2013;"SANTO ANTONIO DA PLATINA (PR)";"PR";"SANTO ANTONIO DA PLATINA";683;63;228;974
2013;"SANTO ANTONIO DO CAIUA (PR)";"PR";"SANTO ANTONIO DO CAIUA";24;2;14;40
2013;"SANTO ANTONIO DO PARAISO (PR)";"PR";"SANTO ANTONIO DO PARAISO";75;7;10;92
2013;"SANTO ANTONIO DO SUDOESTE (PR)";"PR";"SANTO ANTONIO DO SUDOESTE";396;12;47;455
2013;"SANTO INACIO (PR)";"PR";"SANTO INACIO";108;7;19;134
2013;"SAO CARLOS DO IVAI (PR)";"PR";"SAO CARLOS DO IVAI";234;8;27;269
2013;"SAO JERONIMO DA SERRA (PR)";"PR";"SAO JERONIMO DA SERRA";169;7;24;200
2013;"SAO JOAO (PR)";"PR";"SAO JOAO";356;13;43;412
2013;"SAO JOAO DO CAIUA (PR)";"PR";"SAO JOAO DO CAIUA";72;2;30;104
2013;"SAO JOAO DO IVAI (PR)";"PR";"SAO JOAO DO IVAI";336;12;30;378
2013;"SAO JOAO DO TRIUNFO (PR)";"PR";"SAO JOAO DO TRIUNFO";257;12;40;309
2013;"SAO JORGE D OESTE (PR)";"PR";"SAO JORGE D OESTE";233;11;41;285
2013;"SAO JORGE DO IVAI (PR)";"PR";"SAO JORGE DO IVAI";271;5;17;293
2013;"SAO JORGE DO PATROCINIO (PR)";"PR";"SAO JORGE DO PATROCINIO";139;4;19;162
2013;"SAO JOSE DA BOA VISTA (PR)";"PR";"SAO JOSE DA BOA VISTA";96;5;23;124
2013;"SAO JOSE DAS PALMEIRAS (PR)";"PR";"SAO JOSE DAS PALMEIRAS";75;7;27;109
2013;"SAO JOSE DOS PINHAIS (PR)";"PR";"SAO JOSE DOS PINHAIS";7340;900;799;9039
2013;"SAO MANOEL DO PARANA (PR)";"PR";"SAO MANOEL DO PARANA";44;0;9;53
2013;"SAO MATEUS DO SUL (PR)";"PR";"SAO MATEUS DO SUL";997;89;150;1236
2013;"SAO MIGUEL DO IGUACU (PR)";"PR";"SAO MIGUEL DO IGUACU";880;37;79;996
2013;"SAO PEDRO DO IGUACU (PR)";"PR";"SAO PEDRO DO IGUACU";185;7;30;222
2013;"SAO PEDRO DO IVAI (PR)";"PR";"SAO PEDRO DO IVAI";342;10;49;401
2013;"SAO PEDRO DO PARANA (PR)";"PR";"SAO PEDRO DO PARANA";39;5;5;49
2013;"SAO SEBASTIAO DA AMOREIRA (PR)";"PR";"SAO SEBASTIAO DA AMOREIRA";187;5;46;238
2013;"SAO TOME (PR)";"PR";"SAO TOME";140;11;34;185
2013;"SAPOPEMA (PR)";"PR";"SAPOPEMA";118;4;18;140
2013;"SARANDI (PR)";"PR";"SARANDI";1039;88;154;1281
2013;"SAUDADE DO IGUACU (PR)";"PR";"SAUDADE DO IGUACU";76;18;20;114
2013;"SENGES (PR)";"PR";"SENGES";515;33;67;615
2013;"SERRANOPOLIS DO IGUACU (PR)";"PR";"SERRANOPOLIS DO IGUACU";158;14;12;184
2013;"SERTANEJA (PR)";"PR";"SERTANEJA";207;11;29;247
2013;"SERTANOPOLIS (PR)";"PR";"SERTANOPOLIS";601;16;60;677
2013;"SIQUEIRA CAMPOS (PR)";"PR";"SIQUEIRA CAMPOS";401;20;64;485
2013;"SULINA (PR)";"PR";"SULINA";84;3;13;100
2013;"TAMARANA (PR)";"PR";"TAMARANA";295;12;49;356
2013;"TAMBOARA (PR)";"PR";"TAMBOARA";89;9;13;111
2013;"TAPEJARA (PR)";"PR";"TAPEJARA";432;9;104;545
2013;"TAPIRA (PR)";"PR";"TAPIRA";155;6;25;186
2013;"TEIXEIRA SOARES (PR)";"PR";"TEIXEIRA SOARES";214;12;90;316
2013;"TELEMACO BORBA (PR)";"PR";"TELEMACO BORBA";1051;218;203;1472
2013;"TERRA BOA (PR)";"PR";"TERRA BOA";346;19;89;454
2013;"TERRA RICA (PR)";"PR";"TERRA RICA";374;16;74;464
2013;"TERRA ROXA (PR)";"PR";"TERRA ROXA";525;16;51;592
2013;"TIBAGI (PR)";"PR";"TIBAGI";342;42;51;435
2013;"TIJUCAS DO SUL (PR)";"PR";"TIJUCAS DO SUL";465;17;39;521
2013;"TOLEDO (PR)";"PR";"TOLEDO";3079;229;247;3555
2013;"TOMAZINA (PR)";"PR";"TOMAZINA";111;10;23;144
2013;"TRES BARRAS DO PARANA (PR)";"PR";"TRES BARRAS DO PARANA";316;7;35;358
2013;"TUNAS DO PARANA (PR)";"PR";"TUNAS DO PARANA";107;13;36;156
2013;"TUNEIRAS DO OESTE (PR)";"PR";"TUNEIRAS DO OESTE";140;6;48;194
2013;"TUPASSI (PR)";"PR";"TUPASSI";340;14;39;393
2013;"TURVO (PR)";"PR";"TURVO";407;20;62;489
2013;"UBIRATA (PR)";"PR";"UBIRATA";733;28;49;810
2013;"UMUARAMA (PR)";"PR";"UMUARAMA";2714;90;272;3076
2013;"UNIAO DA VITORIA (PR)";"PR";"UNIAO DA VITORIA";1493;66;75;1634
2013;"UNIFLOR (PR)";"PR";"UNIFLOR";46;8;11;65
2013;"URAI (PR)";"PR";"URAI";312;23;26;361
2013;"VENTANIA (PR)";"PR";"VENTANIA";173;22;32;227
2013;"VERA CRUZ DO OESTE (PR)";"PR";"VERA CRUZ DO OESTE";270;7;18;295
2013;"VERE (PR)";"PR";"VERE";234;7;26;267
2013;"VIRMOND (PR)";"PR";"VIRMOND";118;1;18;137
2013;"VITORINO (PR)";"PR";"VITORINO";213;5;26;244
2013;"WENCESLAU BRAZ (PR)";"PR";"WENCESLAU BRAZ";434;26;86;546
2013;"XAMBRE (PR)";"PR";"XAMBRE";162;9;13;184
2013;"ANGRA DOS REIS (RJ)";"RJ";"ANGRA DOS REIS";1109;192;345;1646
2013;"APERIBE (RJ)";"RJ";"APERIBE";130;14;8;152
2013;"ARARUAMA (RJ)";"RJ";"ARARUAMA";1807;291;133;2231
2013;"AREAL (RJ)";"RJ";"AREAL";172;31;38;241
2013;"ARMACAO DE BUZIOS (RJ)";"RJ";"ARMACAO DE BUZIOS";320;310;51;681
2013;"ARRAIAL DO CABO (RJ)";"RJ";"ARRAIAL DO CABO";139;50;13;202
2013;"BARRA DO PIRAI (RJ)";"RJ";"BARRA DO PIRAI";1461;201;277;1939
2013;"BARRA MANSA (RJ)";"RJ";"BARRA MANSA";2048;218;631;2897
2013;"BELFORD ROXO (RJ)";"RJ";"BELFORD ROXO";1729;333;918;2980
2013;"BOM JARDIM (RJ)";"RJ";"BOM JARDIM";619;46;47;712
2013;"BOM JESUS DO ITABAPOANA (RJ)";"RJ";"BOM JESUS DO ITABAPOANA";326;60;60;446
2013;"CABO FRIO (RJ)";"RJ";"CABO FRIO";3235;344;479;4058
2013;"CACHOEIRAS DE MACACU (RJ)";"RJ";"CACHOEIRAS DE MACACU";836;153;46;1035
2013;"CAMBUCI (RJ)";"RJ";"CAMBUCI";105;24;22;151
2013;"CAMPOS DOS GOYTACAZES (RJ)";"RJ";"CAMPOS DOS GOYTACAZES";6741;1000;1272;9013
2013;"CANTAGALO (RJ)";"RJ";"CANTAGALO";186;35;43;264
2013;"CARAPEBUS (RJ)";"RJ";"CARAPEBUS";97;19;10;126
2013;"CARDOSO MOREIRA (RJ)";"RJ";"CARDOSO MOREIRA";163;26;41;230
2013;"CARMO (RJ)";"RJ";"CARMO";139;27;34;200
2013;"CASIMIRO DE ABREU (RJ)";"RJ";"CASIMIRO DE ABREU";550;105;35;690
2013;"COMENDADOR LEVY GASPARIAN (RJ)";"RJ";"COMENDADOR LEVY GASPARIAN";149;34;18;201
2013;"CONCEICAO DE MACABU (RJ)";"RJ";"CONCEICAO DE MACABU";168;37;53;258
2013;"CORDEIRO (RJ)";"RJ";"CORDEIRO";290;44;51;385
2013;"DUAS BARRAS (RJ)";"RJ";"DUAS BARRAS";124;36;9;169
2013;"DUQUE DE CAXIAS (RJ)";"RJ";"DUQUE DE CAXIAS";8971;897;3779;13647
2013;"ENGENHEIRO PAULO DE FRONTIN (RJ)";"RJ";"ENGENHEIRO PAULO DE FRONTIN";136;26;16;178
2013;"GUAPIMIRIM (RJ)";"RJ";"GUAPIMIRIM";366;65;47;478
2013;"IGUABA GRANDE (RJ)";"RJ";"IGUABA GRANDE";163;60;22;245
2013;"ITABORAI (RJ)";"RJ";"ITABORAI";3035;784;476;4295
2013;"ITAGUAI (RJ)";"RJ";"ITAGUAI";1615;279;308;2202
2013;"ITALVA (RJ)";"RJ";"ITALVA";200;25;29;254
2013;"ITAOCARA (RJ)";"RJ";"ITAOCARA";349;49;33;431
2013;"ITAPERUNA (RJ)";"RJ";"ITAPERUNA";1276;122;115;1513
2013;"ITATIAIA (RJ)";"RJ";"ITATIAIA";156;76;44;276
2013;"JAPERI (RJ)";"RJ";"JAPERI";488;51;54;593
2013;"LAJE DO MURIAE (RJ)";"RJ";"LAJE DO MURIAE";44;7;14;65
2013;"MACAE (RJ)";"RJ";"MACAE";3022;1102;962;5086
2013;"MACUCO (RJ)";"RJ";"MACUCO";163;13;10;186
2013;"MAGE (RJ)";"RJ";"MAGE";1693;400;196;2289
2013;"MANGARATIBA (RJ)";"RJ";"MANGARATIBA";157;153;151;461
2013;"MARICA (RJ)";"RJ";"MARICA";997;340;389;1726
2013;"MENDES (RJ)";"RJ";"MENDES";229;46;39;314
2013;"MESQUITA (RJ)";"RJ";"MESQUITA";746;101;684;1531
2013;"MIGUEL PEREIRA (RJ)";"RJ";"MIGUEL PEREIRA";349;80;33;462
2013;"MIRACEMA (RJ)";"RJ";"MIRACEMA";247;31;31;309
2013;"NATIVIDADE (RJ)";"RJ";"NATIVIDADE";91;18;39;148
2013;"NILOPOLIS (RJ)";"RJ";"NILOPOLIS";655;144;335;1134
2013;"NITEROI (RJ)";"RJ";"NITEROI";2551;1245;2961;6757
2013;"NOVA FRIBURGO (RJ)";"RJ";"NOVA FRIBURGO";3537;259;367;4163
2013;"NOVA IGUACU (RJ)";"RJ";"NOVA IGUACU";5937;1376;1640;8953
2013;"PARACAMBI (RJ)";"RJ";"PARACAMBI";663;86;103;852
2013;"PARAIBA DO SUL (RJ)";"RJ";"PARAIBA DO SUL";589;107;114;810
2013;"PARATI (RJ)";"RJ";"PARATI";188;62;26;276
2013;"PATY DO ALFERES (RJ)";"RJ";"PATY DO ALFERES";480;55;39;574
2013;"PETROPOLIS (RJ)";"RJ";"PETROPOLIS";2998;651;907;4556
2013;"PINHEIRAL (RJ)";"RJ";"PINHEIRAL";200;43;98;341
2013;"PIRAI (RJ)";"RJ";"PIRAI";455;68;67;590
2013;"PORCIUNCULA (RJ)";"RJ";"PORCIUNCULA";81;16;23;120
2013;"PORTO REAL (RJ)";"RJ";"PORTO REAL";383;62;19;464
2013;"QUATIS (RJ)";"RJ";"QUATIS";186;72;30;288
2013;"QUEIMADOS (RJ)";"RJ";"QUEIMADOS";563;194;196;953
2013;"QUISSAMA (RJ)";"RJ";"QUISSAMA";204;31;120;355
2013;"RESENDE (RJ)";"RJ";"RESENDE";1360;283;668;2311
2013;"RIO BONITO (RJ)";"RJ";"RIO BONITO";3508;370;149;4027
2013;"RIO CLARO (RJ)";"RJ";"RIO CLARO";95;17;18;130
2013;"RIO DAS FLORES (RJ)";"RJ";"RIO DAS FLORES";53;23;17;93
2013;"RIO DAS OSTRAS (RJ)";"RJ";"RIO DAS OSTRAS";1002;752;91;1845
2013;"RIO DE JANEIRO (RJ)";"RJ";"RIO DE JANEIRO";39264;17352;17298;73914
2013;"SANTA MARIA MADALENA (RJ)";"RJ";"SANTA MARIA MADALENA";67;19;7;93
2013;"SANTO ANTONIO DE PADUA (RJ)";"RJ";"SANTO ANTONIO DE PADUA";617;100;35;752
2013;"SAO FIDELIS (RJ)";"RJ";"SAO FIDELIS";421;33;58;512
2013;"SAO FRANCISCO DE ITABAPOANA (RJ)";"RJ";"SAO FRANCISCO DE ITABAPOANA";387;85;76;548
2013;"SAO GONCALO (RJ)";"RJ";"SAO GONCALO";4201;1760;3202;9163
2013;"SAO JOAO DA BARRA (RJ)";"RJ";"SAO JOAO DA BARRA";620;100;63;783
2013;"SAO JOAO DE MERITI (RJ)";"RJ";"SAO JOAO DE MERITI";3634;552;1420;5606
2013;"SAO JOSE DE UBA (RJ)";"RJ";"SAO JOSE DE UBA";45;9;7;61
2013;"SAO JOSE DO VALE DO RIO PRETO (RJ)";"RJ";"SAO JOSE DO VALE DO RIO PRETO";665;36;25;726
2013;"SAO PEDRO DA ALDEIA (RJ)";"RJ";"SAO PEDRO DA ALDEIA";871;96;70;1037
2013;"SAO SEBASTIAO DO ALTO (RJ)";"RJ";"SAO SEBASTIAO DO ALTO";105;27;4;136
2013;"SAPUCAIA (RJ)";"RJ";"SAPUCAIA";127;20;18;165
2013;"SAQUAREMA (RJ)";"RJ";"SAQUAREMA";746;141;116;1003
2013;"SEROPEDICA (RJ)";"RJ";"SEROPEDICA";1049;72;240;1361
2013;"SILVA JARDIM (RJ)";"RJ";"SILVA JARDIM";277;55;33;365
2013;"SUMIDOURO (RJ)";"RJ";"SUMIDOURO";296;12;11;319
2013;"TANGUA (RJ)";"RJ";"TANGUA";267;55;179;501
2013;"TERESOPOLIS (RJ)";"RJ";"TERESOPOLIS";2119;298;310;2727
2013;"TRAJANO DE MORAIS (RJ)";"RJ";"TRAJANO DE MORAIS";79;18;14;111
2013;"TRES RIOS (RJ)";"RJ";"TRES RIOS";1003;116;207;1326
2013;"VALENCA (RJ)";"RJ";"VALENCA";358;130;87;575
2013;"VARRE SAI (RJ)";"RJ";"VARRE SAI";67;15;6;88
2013;"VASSOURAS (RJ)";"RJ";"VASSOURAS";516;78;93;687
2013;"VOLTA REDONDA (RJ)";"RJ";"VOLTA REDONDA";2334;384;644;3362
2013;"ACARI (RN)";"RN";"ACARI";96;9;12;117
2013;"AFONSO BEZERRA (RN)";"RN";"AFONSO BEZERRA";29;3;7;39
2013;"AGUA NOVA (RN)";"RN";"AGUA NOVA";6;13;2;21
2013;"ALEXANDRIA (RN)";"RN";"ALEXANDRIA";62;35;12;109
2013;"ALMINO AFONSO (RN)";"RN";"ALMINO AFONSO";19;8;1;28
2013;"ALTO DO RODRIGUES (RN)";"RN";"ALTO DO RODRIGUES";155;18;25;198
2013;"ANGICOS (RN)";"RN";"ANGICOS";115;13;11;139
2013;"ANTONIO MARTINS (RN)";"RN";"ANTONIO MARTINS";18;11;2;31
2013;"APODI (RN)";"RN";"APODI";289;23;35;347
2013;"AREIA BRANCA (RN)";"RN";"AREIA BRANCA";125;52;65;242
2013;"ARES (RN)";"RN";"ARES";53;9;33;95
2013;"ASSU (RN)";"RN";"ASSU";612;58;79;749
2013;"BAIA FORMOSA (RN)";"RN";"BAIA FORMOSA";51;2;18;71
2013;"BARAUNA (RN)";"RN";"BARAUNA";445;27;22;494
2013;"BARCELONA (RN)";"RN";"BARCELONA";26;2;3;31
2013;"BENTO FERNANDES (RN)";"RN";"BENTO FERNANDES";15;5;10;30
2013;"BOA SAUDE (RN)";"RN";"BOA SAUDE";51;4;9;64
2013;"BODO (RN)";"RN";"BODO";7;5;2;14
2013;"BOM JESUS (RN)";"RN";"BOM JESUS";48;2;8;58
2013;"BREJINHO (RN)";"RN";"BREJINHO";80;12;14;106
2013;"CAICARA DO NORTE (RN)";"RN";"CAICARA DO NORTE";14;2;4;20
2013;"CAICARA DO RIO DO VENTO (RN)";"RN";"CAICARA DO RIO DO VENTO";18;4;2;24
2013;"CAICO (RN)";"RN";"CAICO";1691;104;53;1848
2013;"CAMPO GRANDE (RN)";"RN";"CAMPO GRANDE";42;9;7;58
2013;"CAMPO REDONDO (RN)";"RN";"CAMPO REDONDO";46;14;9;69
2013;"CANGUARETAMA (RN)";"RN";"CANGUARETAMA";153;29;70;252
2013;"CARAUBAS (RN)";"RN";"CARAUBAS";151;35;14;200
2013;"CARNAUBA DOS DANTAS (RN)";"RN";"CARNAUBA DOS DANTAS";212;10;9;231
2013;"CARNAUBAIS (RN)";"RN";"CARNAUBAIS";42;19;12;73
2013;"CEARA MIRIM (RN)";"RN";"CEARA MIRIM";314;40;123;477
2013;"CERRO CORA (RN)";"RN";"CERRO CORA";92;9;7;108
2013;"CORONEL EZEQUIEL (RN)";"RN";"CORONEL EZEQUIEL";46;6;4;56
2013;"CORONEL JOAO PESSOA (RN)";"RN";"CORONEL JOAO PESSOA";10;2;3;15
2013;"CRUZETA (RN)";"RN";"CRUZETA";82;15;10;107
2013;"CURRAIS NOVOS (RN)";"RN";"CURRAIS NOVOS";668;53;64;785
2013;"DOUTOR SEVERIANO (RN)";"RN";"DOUTOR SEVERIANO";24;7;9;40
2013;"ENCANTO (RN)";"RN";"ENCANTO";11;8;9;28
2013;"EQUADOR (RN)";"RN";"EQUADOR";113;4;3;120
2013;"ESPIRITO SANTO (RN)";"RN";"ESPIRITO SANTO";23;3;13;39
2013;"EXTREMOZ (RN)";"RN";"EXTREMOZ";56;21;32;109
2013;"FELIPE GUERRA (RN)";"RN";"FELIPE GUERRA";15;8;6;29
2013;"FERNANDO PEDROZA (RN)";"RN";"FERNANDO PEDROZA";23;2;2;27
2013;"FLORANIA (RN)";"RN";"FLORANIA";59;8;5;72
2013;"FRANCISCO DANTAS (RN)";"RN";"FRANCISCO DANTAS";13;4;2;19
2013;"FRUTUOSO GOMES (RN)";"RN";"FRUTUOSO GOMES";19;10;2;31
2013;"GALINHOS (RN)";"RN";"GALINHOS";12;3;3;18
2013;"GOIANINHA (RN)";"RN";"GOIANINHA";168;41;71;280
2013;"GOVERNADOR DIX SEPT ROSADO (RN)";"RN";"GOVERNADOR DIX SEPT ROSADO";141;28;17;186
2013;"GROSSOS (RN)";"RN";"GROSSOS";50;4;12;66
2013;"GUAMARE (RN)";"RN";"GUAMARE";98;24;37;159
2013;"IELMO MARINHO (RN)";"RN";"IELMO MARINHO";47;4;24;75
2013;"IPANGUACU (RN)";"RN";"IPANGUACU";86;28;56;170
2013;"IPUEIRA (RN)";"RN";"IPUEIRA";13;7;6;26
2013;"ITAJA (RN)";"RN";"ITAJA";105;4;6;115
2013;"ITAU (RN)";"RN";"ITAU";29;7;2;38
2013;"JACANA (RN)";"RN";"JACANA";157;46;21;224
2013;"JANDAIRA (RN)";"RN";"JANDAIRA";45;0;13;58
2013;"JANDUIS (RN)";"RN";"JANDUIS";14;3;3;20
2013;"JAPI (RN)";"RN";"JAPI";44;10;6;60
2013;"JARDIM DE ANGICOS (RN)";"RN";"JARDIM DE ANGICOS";7;0;3;10
2013;"JARDIM DE PIRANHAS (RN)";"RN";"JARDIM DE PIRANHAS";83;24;8;115
2013;"JARDIM DO SERIDO (RN)";"RN";"JARDIM DO SERIDO";139;21;51;211
2013;"JOAO CAMARA (RN)";"RN";"JOAO CAMARA";322;18;32;372
2013;"JOAO DIAS (RN)";"RN";"JOAO DIAS";5;1;1;7
2013;"JOSE DA PENHA (RN)";"RN";"JOSE DA PENHA";26;16;2;44
2013;"JUCURUTU (RN)";"RN";"JUCURUTU";133;38;13;184
2013;"JUNDIA (RN)";"RN";"JUNDIA";11;5;9;25
2013;"LAGOA DANTA (RN)";"RN";"LAGOA DANTA";41;10;12;63
2013;"LAGOA DE PEDRAS (RN)";"RN";"LAGOA DE PEDRAS";28;7;13;48
2013;"LAGOA DE VELHOS (RN)";"RN";"LAGOA DE VELHOS";20;2;1;23
2013;"LAGOA NOVA (RN)";"RN";"LAGOA NOVA";93;7;12;112
2013;"LAGOA SALGADA (RN)";"RN";"LAGOA SALGADA";71;5;5;81
2013;"LAJES (RN)";"RN";"LAJES";63;6;10;79
2013;"LAJES PINTADAS (RN)";"RN";"LAJES PINTADAS";20;9;4;33
2013;"LUCRECIA (RN)";"RN";"LUCRECIA";17;8;3;28
2013;"LUIS GOMES (RN)";"RN";"LUIS GOMES";38;39;7;84
2013;"MACAIBA (RN)";"RN";"MACAIBA";767;104;81;952
2013;"MACAU (RN)";"RN";"MACAU";208;36;57;301
2013;"MAJOR SALES (RN)";"RN";"MAJOR SALES";16;13;2;31
2013;"MARCELINO VIEIRA (RN)";"RN";"MARCELINO VIEIRA";18;12;2;32
2013;"MARTINS (RN)";"RN";"MARTINS";43;13;7;63
2013;"MAXARANGUAPE (RN)";"RN";"MAXARANGUAPE";21;6;9;36
2013;"MESSIAS TARGINO (RN)";"RN";"MESSIAS TARGINO";35;9;4;48
2013;"MONTANHAS (RN)";"RN";"MONTANHAS";51;5;18;74
2013;"MONTE ALEGRE (RN)";"RN";"MONTE ALEGRE";103;16;21;140
2013;"MONTE DAS GAMELEIRAS (RN)";"RN";"MONTE DAS GAMELEIRAS";12;3;7;22
2013;"MOSSORO (RN)";"RN";"MOSSORO";3730;303;283;4316
2013;"NATAL (RN)";"RN";"NATAL";6640;1224;2438;10302
2013;"NISIA FLORESTA (RN)";"RN";"NISIA FLORESTA";77;43;42;162
2013;"NOVA CRUZ (RN)";"RN";"NOVA CRUZ";378;37;62;477
2013;"OLHO D AGUA DO BORGES (RN)";"RN";"OLHO D AGUA DO BORGES";19;3;1;23
2013;"OURO BRANCO (RN)";"RN";"OURO BRANCO";41;8;4;53
2013;"PARANA (RN)";"RN";"PARANA";14;10;3;27
2013;"PARAU (RN)";"RN";"PARAU";17;11;2;30
2013;"PARAZINHO (RN)";"RN";"PARAZINHO";28;5;14;47
2013;"PARELHAS (RN)";"RN";"PARELHAS";403;30;40;473
2013;"PARNAMIRIM (RN)";"RN";"PARNAMIRIM";1951;357;375;2683
2013;"PASSA E FICA (RN)";"RN";"PASSA E FICA";128;38;26;192
2013;"PASSAGEM (RN)";"RN";"PASSAGEM";17;6;2;25
2013;"PATU (RN)";"RN";"PATU";96;19;4;119
2013;"PAU DOS FERROS (RN)";"RN";"PAU DOS FERROS";473;54;31;558
2013;"PEDRA GRANDE (RN)";"RN";"PEDRA GRANDE";10;1;6;17
2013;"PEDRA PRETA (RN)";"RN";"PEDRA PRETA";30;2;11;43
2013;"PEDRO AVELINO (RN)";"RN";"PEDRO AVELINO";30;4;5;39
2013;"PEDRO VELHO (RN)";"RN";"PEDRO VELHO";45;6;12;63
2013;"PENDENCIAS (RN)";"RN";"PENDENCIAS";64;14;14;92
2013;"PILOES (RN)";"RN";"PILOES";14;5;2;21
2013;"POCO BRANCO (RN)";"RN";"POCO BRANCO";30;4;7;41
2013;"PORTALEGRE (RN)";"RN";"PORTALEGRE";42;7;6;55
2013;"PORTO DO MANGUE (RN)";"RN";"PORTO DO MANGUE";37;13;8;58
2013;"PUREZA (RN)";"RN";"PUREZA";71;7;20;98
2013;"RAFAEL FERNANDES (RN)";"RN";"RAFAEL FERNANDES";21;5;2;28
2013;"RAFAEL GODEIRO (RN)";"RN";"RAFAEL GODEIRO";7;1;1;9
2013;"RIACHO DA CRUZ (RN)";"RN";"RIACHO DA CRUZ";9;4;1;14
2013;"RIACHO DE SANTANA (RN)";"RN";"RIACHO DE SANTANA";6;9;5;20
2013;"RIACHUELO (RN)";"RN";"RIACHUELO";29;2;5;36
2013;"RIO DO FOGO (RN)";"RN";"RIO DO FOGO";37;6;8;51
2013;"RODOLFO FERNANDES (RN)";"RN";"RODOLFO FERNANDES";18;5;3;26
2013;"RUY BARBOSA (RN)";"RN";"RUY BARBOSA";16;1;3;20
2013;"SANTA CRUZ (RN)";"RN";"SANTA CRUZ";428;32;32;492
2013;"SANTA MARIA (RN)";"RN";"SANTA MARIA";61;5;7;73
2013;"SANTANA DO MATOS (RN)";"RN";"SANTANA DO MATOS";81;16;12;109
2013;"SANTANA DO SERIDO (RN)";"RN";"SANTANA DO SERIDO";23;2;2;27
2013;"SANTO ANTONIO (RN)";"RN";"SANTO ANTONIO";98;46;29;173
2013;"SAO BENTO DO NORTE (RN)";"RN";"SAO BENTO DO NORTE";6;0;6;12
2013;"SAO BENTO DO TRAIRI (RN)";"RN";"SAO BENTO DO TRAIRI";16;2;3;21
2013;"SAO FERNANDO (RN)";"RN";"SAO FERNANDO";15;13;2;30
2013;"SAO FRANCISCO DO OESTE (RN)";"RN";"SAO FRANCISCO DO OESTE";28;4;3;35
2013;"SAO GONCALO DO AMARANTE (RN)";"RN";"SAO GONCALO DO AMARANTE";409;117;245;771
2013;"SAO JOAO DO SABUGI (RN)";"RN";"SAO JOAO DO SABUGI";49;19;2;70
2013;"SAO JOSE DE MIPIBU (RN)";"RN";"SAO JOSE DE MIPIBU";281;36;47;364
2013;"SAO JOSE DO CAMPESTRE (RN)";"RN";"SAO JOSE DO CAMPESTRE";77;3;13;93
2013;"SAO JOSE DO SERIDO (RN)";"RN";"SAO JOSE DO SERIDO";34;7;2;43
2013;"SAO MIGUEL (RN)";"RN";"SAO MIGUEL";182;40;24;246
2013;"SAO MIGUEL DO GOSTOSO (RN)";"RN";"SAO MIGUEL DO GOSTOSO";25;11;11;47
2013;"SAO PAULO DO POTENGI (RN)";"RN";"SAO PAULO DO POTENGI";115;9;17;141
2013;"SAO PEDRO (RN)";"RN";"SAO PEDRO";31;3;5;39
2013;"SAO RAFAEL (RN)";"RN";"SAO RAFAEL";33;12;5;50
2013;"SAO TOME (RN)";"RN";"SAO TOME";59;6;25;90
2013;"SAO VICENTE (RN)";"RN";"SAO VICENTE";46;4;6;56
2013;"SENADOR ELOI DE SOUZA (RN)";"RN";"SENADOR ELOI DE SOUZA";17;3;12;32
2013;"SENADOR GEORGINO AVELINO (RN)";"RN";"SENADOR GEORGINO AVELINO";14;2;3;19
2013;"SERRA CAIADA (RN)";"RN";"SERRA CAIADA";34;6;15;55
2013;"SERRA DE SAO BENTO (RN)";"RN";"SERRA DE SAO BENTO";29;6;3;38
2013;"SERRA DO MEL (RN)";"RN";"SERRA DO MEL";81;11;13;105
2013;"SERRA NEGRA DO NORTE (RN)";"RN";"SERRA NEGRA DO NORTE";76;18;7;101
2013;"SERRINHA (RN)";"RN";"SERRINHA";23;14;8;45
2013;"SERRINHA DOS PINTOS (RN)";"RN";"SERRINHA DOS PINTOS";31;7;2;40
2013;"SEVERIANO MELO (RN)";"RN";"SEVERIANO MELO";30;8;6;44
2013;"SITIO NOVO (RN)";"RN";"SITIO NOVO";16;5;2;23
2013;"TABOLEIRO GRANDE (RN)";"RN";"TABOLEIRO GRANDE";8;6;3;17
2013;"TAIPU (RN)";"RN";"TAIPU";56;4;16;76
2013;"TANGARA (RN)";"RN";"TANGARA";134;7;31;172
2013;"TENENTE ANANIAS (RN)";"RN";"TENENTE ANANIAS";48;19;2;69
2013;"TENENTE LAURENTINO CRUZ (RN)";"RN";"TENENTE LAURENTINO CRUZ";46;6;5;57
2013;"TIBAU (RN)";"RN";"TIBAU";31;10;12;53
2013;"TIBAU DO SUL (RN)";"RN";"TIBAU DO SUL";44;39;14;97
2013;"TIMBAUBA DOS BATISTAS (RN)";"RN";"TIMBAUBA DOS BATISTAS";19;6;3;28
2013;"TOUROS (RN)";"RN";"TOUROS";164;35;40;239
2013;"TRIUNFO POTIGUAR (RN)";"RN";"TRIUNFO POTIGUAR";11;7;3;21
2013;"UMARIZAL (RN)";"RN";"UMARIZAL";54;29;4;87
2013;"UPANEMA (RN)";"RN";"UPANEMA";64;10;13;87
2013;"VARZEA (RN)";"RN";"VARZEA";11;3;9;23
2013;"VENHA VER (RN)";"RN";"VENHA VER";16;8;4;28
2013;"VERA CRUZ (RN)";"RN";"VERA CRUZ";136;6;23;165
2013;"VICOSA (RN)";"RN";"VICOSA";5;2;1;8
2013;"VILA FLOR (RN)";"RN";"VILA FLOR";11;1;3;15
2013;"ALTA FLORESTA D OESTE (RO)";"RO";"ALTA FLORESTA D OESTE";545;16;61;622
2013;"ALTO ALEGRE DOS PARECIS (RO)";"RO";"ALTO ALEGRE DOS PARECIS";133;10;26;169
2013;"ALTO PARAISO (RO)";"RO";"ALTO PARAISO";277;8;54;339
2013;"ALVORADA D OESTE (RO)";"RO";"ALVORADA D OESTE";265;7;63;335
2013;"ARIQUEMES (RO)";"RO";"ARIQUEMES";2109;33;184;2326
2013;"BURITIS (RO)";"RO";"BURITIS";460;7;32;499
2013;"CABIXI (RO)";"RO";"CABIXI";80;3;20;103
2013;"CACAULANDIA (RO)";"RO";"CACAULANDIA";63;3;17;83
2013;"CACOAL (RO)";"RO";"CACOAL";1622;57;286;1965
2013;"CAMPO NOVO DE RONDONIA (RO)";"RO";"CAMPO NOVO DE RONDONIA";71;5;19;95
2013;"CANDEIAS DO JAMARI (RO)";"RO";"CANDEIAS DO JAMARI";172;4;33;209
2013;"CASTANHEIRAS (RO)";"RO";"CASTANHEIRAS";29;2;12;43
2013;"CEREJEIRAS (RO)";"RO";"CEREJEIRAS";339;4;48;391
2013;"CHUPINGUAIA (RO)";"RO";"CHUPINGUAIA";133;6;39;178
2013;"COLORADO DO OESTE (RO)";"RO";"COLORADO DO OESTE";378;10;49;437
2013;"CORUMBIARA (RO)";"RO";"CORUMBIARA";82;6;12;100
2013;"COSTA MARQUES (RO)";"RO";"COSTA MARQUES";106;6;20;132
2013;"CUJUBIM (RO)";"RO";"CUJUBIM";211;6;19;236
2013;"ESPIGAO D OESTE (RO)";"RO";"ESPIGAO D OESTE";556;6;97;659
2013;"GOVERNADOR JORGE TEIXEIRA (RO)";"RO";"GOVERNADOR JORGE TEIXEIRA";59;2;17;78
2013;"GUAJARA MIRIM (RO)";"RO";"GUAJARA MIRIM";885;12;44;941
2013;"ITAPUA DO OESTE (RO)";"RO";"ITAPUA DO OESTE";149;4;49;202
2013;"JARU (RO)";"RO";"JARU";995;21;189;1205
2013;"JI PARANA (RO)";"RO";"JI PARANA";2688;78;601;3367
2013;"MACHADINHO D OESTE (RO)";"RO";"MACHADINHO D OESTE";354;15;55;424
2013;"MINISTRO ANDREAZZA (RO)";"RO";"MINISTRO ANDREAZZA";183;4;18;205
2013;"MIRANTE DA SERRA (RO)";"RO";"MIRANTE DA SERRA";185;4;28;217
2013;"MONTE NEGRO (RO)";"RO";"MONTE NEGRO";278;12;64;354
2013;"NOVA BRASILANDIA D OESTE (RO)";"RO";"NOVA BRASILANDIA D OESTE";241;8;61;310
2013;"NOVA DO MAMORE (RO)";"RO";"NOVA DO MAMORE";254;2;26;282
2013;"NOVA UNIAO (RO)";"RO";"NOVA UNIAO";59;1;24;84
2013;"NOVO HORIZONTE DO OESTE (RO)";"RO";"NOVO HORIZONTE DO OESTE";95;0;17;112
2013;"OURO PRETO DO OESTE (RO)";"RO";"OURO PRETO DO OESTE";753;27;107;887
2013;"PARECIS (RO)";"RO";"PARECIS";33;2;16;51
2013;"PIMENTA BUENO (RO)";"RO";"PIMENTA BUENO";1048;31;78;1157
2013;"PIMENTEIRAS DO OESTE (RO)";"RO";"PIMENTEIRAS DO OESTE";16;1;12;29
2013;"PORTO VELHO (RO)";"RO";"PORTO VELHO";6334;450;1638;8422
2013;"PRESIDENTE MEDICI (RO)";"RO";"PRESIDENTE MEDICI";320;6;41;367
2013;"PRIMAVERA DE RONDONIA (RO)";"RO";"PRIMAVERA DE RONDONIA";36;4;15;55
2013;"RIO CRESPO (RO)";"RO";"RIO CRESPO";48;2;18;68
2013;"ROLIM DE MOURA (RO)";"RO";"ROLIM DE MOURA";1145;34;118;1297
2013;"SANTA LUZIA D OESTE (RO)";"RO";"SANTA LUZIA D OESTE";152;4;46;202
2013;"SAO FELIPE D OESTE (RO)";"RO";"SAO FELIPE D OESTE";74;3;24;101
2013;"SAO FRANCISCO DO GUAPORE (RO)";"RO";"SAO FRANCISCO DO GUAPORE";271;5;62;338
2013;"SAO MIGUEL DO GUAPORE (RO)";"RO";"SAO MIGUEL DO GUAPORE";279;9;62;350
2013;"SERINGUEIRAS (RO)";"RO";"SERINGUEIRAS";194;4;38;236
2013;"TEIXEIROPOLIS (RO)";"RO";"TEIXEIROPOLIS";41;0;13;54
2013;"THEOBROMA (RO)";"RO";"THEOBROMA";85;1;19;105
2013;"URUPA (RO)";"RO";"URUPA";109;3;64;176
2013;"VALE DO ANARI (RO)";"RO";"VALE DO ANARI";84;3;15;102
2013;"VALE DO PARAISO (RO)";"RO";"VALE DO PARAISO";64;0;18;82
2013;"VILHENA (RO)";"RO";"VILHENA";1593;57;188;1838
2013;"ALTO ALEGRE (RR)";"RR";"ALTO ALEGRE";53;5;12;70
2013;"AMAJARI (RR)";"RR";"AMAJARI";20;7;3;30
2013;"BOA VISTA (RR)";"RR";"BOA VISTA";3200;435;678;4313
2013;"BONFIM (RR)";"RR";"BONFIM";15;0;1;16
2013;"CANTA (RR)";"RR";"CANTA";37;7;12;56
2013;"CARACARAI (RR)";"RR";"CARACARAI";108;6;11;125
2013;"CAROEBE (RR)";"RR";"CAROEBE";38;7;34;79
2013;"IRACEMA (RR)";"RR";"IRACEMA";26;14;1;41
2013;"MUCAJAI (RR)";"RR";"MUCAJAI";96;40;37;173
2013;"NORMANDIA (RR)";"RR";"NORMANDIA";13;0;1;14
2013;"PACARAIMA (RR)";"RR";"PACARAIMA";75;3;6;84
2013;"RORAINOPOLIS (RR)";"RR";"RORAINOPOLIS";123;27;21;171
2013;"SAO JOAO DA BALIZA (RR)";"RR";"SAO JOAO DA BALIZA";43;8;4;55
2013;"SAO LUIZ (RR)";"RR";"SAO LUIZ";34;4;4;42
2013;"UIRAMUTA (RR)";"RR";"UIRAMUTA";0;0;0;0
2013;"ACEGUA (RS)";"RS";"ACEGUA";63;19;15;97
2013;"AGUA SANTA (RS)";"RS";"AGUA SANTA";163;12;15;190
2013;"AGUDO (RS)";"RS";"AGUDO";310;15;62;387
2013;"AJURICABA (RS)";"RS";"AJURICABA";402;19;34;455
2013;"ALECRIM (RS)";"RS";"ALECRIM";84;5;29;118
2013;"ALEGRETE (RS)";"RS";"ALEGRETE";994;52;223;1269
2013;"ALEGRIA (RS)";"RS";"ALEGRIA";83;4;22;109
2013;"ALMIRANTE TAMANDARE DO SUL (RS)";"RS";"ALMIRANTE TAMANDARE DO SUL";85;13;3;101
2013;"ALPESTRE (RS)";"RS";"ALPESTRE";140;18;46;204
2013;"ALTO ALEGRE (RS)";"RS";"ALTO ALEGRE";94;7;7;108
2013;"ALTO FELIZ (RS)";"RS";"ALTO FELIZ";94;10;11;115
2013;"ALVORADA (RS)";"RS";"ALVORADA";1746;205;600;2551
2013;"AMARAL FERRADOR (RS)";"RS";"AMARAL FERRADOR";131;12;24;167
2013;"AMETISTA DO SUL (RS)";"RS";"AMETISTA DO SUL";71;5;56;132
2013;"ANDRE DA ROCHA (RS)";"RS";"ANDRE DA ROCHA";52;6;3;61
2013;"ANTA GORDA (RS)";"RS";"ANTA GORDA";250;21;18;289
2013;"ANTONIO PRADO (RS)";"RS";"ANTONIO PRADO";637;18;45;700
2013;"ARAMBARE (RS)";"RS";"ARAMBARE";78;6;12;96
2013;"ARARICA (RS)";"RS";"ARARICA";88;7;13;108
2013;"ARATIBA (RS)";"RS";"ARATIBA";171;31;31;233
2013;"ARROIO DO MEIO (RS)";"RS";"ARROIO DO MEIO";550;42;49;641
2013;"ARROIO DO PADRE (RS)";"RS";"ARROIO DO PADRE";99;5;15;119
2013;"ARROIO DO SAL (RS)";"RS";"ARROIO DO SAL";120;8;13;141
2013;"ARROIO DO TIGRE (RS)";"RS";"ARROIO DO TIGRE";302;28;40;370
2013;"ARROIO DOS RATOS (RS)";"RS";"ARROIO DOS RATOS";223;12;69;304
2013;"ARROIO GRANDE (RS)";"RS";"ARROIO GRANDE";257;17;59;333
2013;"ARVOREZINHA (RS)";"RS";"ARVOREZINHA";474;41;46;561
2013;"AUGUSTO PESTANA (RS)";"RS";"AUGUSTO PESTANA";433;16;32;481
2013;"AUREA (RS)";"RS";"AUREA";154;6;10;170
2013;"BAGE (RS)";"RS";"BAGE";1225;187;348;1760
2013;"BALNEARIO PINHAL (RS)";"RS";"BALNEARIO PINHAL";109;9;24;142
2013;"BARAO (RS)";"RS";"BARAO";197;29;53;279
2013;"BARAO DE COTEGIPE (RS)";"RS";"BARAO DE COTEGIPE";236;16;15;267
2013;"BARAO DO TRIUNFO (RS)";"RS";"BARAO DO TRIUNFO";121;21;43;185
2013;"BARRA DO GUARITA (RS)";"RS";"BARRA DO GUARITA";29;5;8;42
2013;"BARRA DO QUARAI (RS)";"RS";"BARRA DO QUARAI";27;3;14;44
2013;"BARRA DO RIBEIRO (RS)";"RS";"BARRA DO RIBEIRO";194;10;55;259
2013;"BARRA DO RIO AZUL (RS)";"RS";"BARRA DO RIO AZUL";41;10;13;64
2013;"BARRA FUNDA (RS)";"RS";"BARRA FUNDA";177;7;20;204
2013;"BARRACAO (RS)";"RS";"BARRACAO";149;8;21;178
2013;"BARROS CASSAL (RS)";"RS";"BARROS CASSAL";163;23;56;242
2013;"BENJAMIN CONSTANT DO SUL (RS)";"RS";"BENJAMIN CONSTANT DO SUL";26;4;15;45
2013;"BENTO GONCALVES (RS)";"RS";"BENTO GONCALVES";3377;295;328;4000
2013;"BOA VISTA DAS MISSOES (RS)";"RS";"BOA VISTA DAS MISSOES";101;5;17;123
2013;"BOA VISTA DO BURICA (RS)";"RS";"BOA VISTA DO BURICA";230;15;23;268
2013;"BOA VISTA DO CADEADO (RS)";"RS";"BOA VISTA DO CADEADO";111;2;21;134
2013;"BOA VISTA DO INCRA (RS)";"RS";"BOA VISTA DO INCRA";75;3;7;85
2013;"BOA VISTA DO SUL (RS)";"RS";"BOA VISTA DO SUL";323;7;13;343
2013;"BOM JESUS (RS)";"RS";"BOM JESUS";263;38;55;356
2013;"BOM PRINCIPIO (RS)";"RS";"BOM PRINCIPIO";471;34;34;539
2013;"BOM PROGRESSO (RS)";"RS";"BOM PROGRESSO";47;11;7;65
2013;"BOM RETIRO DO SUL (RS)";"RS";"BOM RETIRO DO SUL";199;18;31;248
2013;"BOQUEIRAO DO LEAO (RS)";"RS";"BOQUEIRAO DO LEAO";183;9;18;210
2013;"BOSSOROCA (RS)";"RS";"BOSSOROCA";192;4;24;220
2013;"BOZANO (RS)";"RS";"BOZANO";145;4;8;157
2013;"BRAGA (RS)";"RS";"BRAGA";76;4;17;97
2013;"BROCHIER (RS)";"RS";"BROCHIER";291;15;26;332
2013;"BUTIA (RS)";"RS";"BUTIA";439;27;122;588
2013;"CACAPAVA DO SUL (RS)";"RS";"CACAPAVA DO SUL";624;59;117;800
2013;"CACEQUI (RS)";"RS";"CACEQUI";139;19;26;184
2013;"CACHOEIRA DO SUL (RS)";"RS";"CACHOEIRA DO SUL";1252;100;232;1584
2013;"CACHOEIRINHA (RS)";"RS";"CACHOEIRINHA";2349;238;500;3087
2013;"CACIQUE DOBLE (RS)";"RS";"CACIQUE DOBLE";121;5;14;140
2013;"CAIBATE (RS)";"RS";"CAIBATE";136;11;5;152
2013;"CAICARA (RS)";"RS";"CAICARA";84;8;22;114
2013;"CAMAQUA (RS)";"RS";"CAMAQUA";1326;69;234;1629
2013;"CAMARGO (RS)";"RS";"CAMARGO";173;7;18;198
2013;"CAMBARA DO SUL (RS)";"RS";"CAMBARA DO SUL";268;14;33;315
2013;"CAMPESTRE DA SERRA (RS)";"RS";"CAMPESTRE DA SERRA";159;3;15;177
2013;"CAMPINA DAS MISSOES (RS)";"RS";"CAMPINA DAS MISSOES";155;11;32;198
2013;"CAMPINAS DO SUL (RS)";"RS";"CAMPINAS DO SUL";199;10;25;234
2013;"CAMPO BOM (RS)";"RS";"CAMPO BOM";808;99;92;999
2013;"CAMPO NOVO (RS)";"RS";"CAMPO NOVO";161;15;24;200
2013;"CAMPOS BORGES (RS)";"RS";"CAMPOS BORGES";155;15;18;188
2013;"CANDELARIA (RS)";"RS";"CANDELARIA";432;28;90;550
2013;"CANDIDO GODOI (RS)";"RS";"CANDIDO GODOI";237;13;21;271
2013;"CANDIOTA (RS)";"RS";"CANDIOTA";138;33;49;220
2013;"CANELA (RS)";"RS";"CANELA";552;87;114;753
2013;"CANGUCU (RS)";"RS";"CANGUCU";1089;110;201;1400
2013;"CANOAS (RS)";"RS";"CANOAS";4661;481;1029;6171
2013;"CANUDOS DO VALE (RS)";"RS";"CANUDOS DO VALE";24;18;2;44
2013;"CAPAO BONITO DO SUL (RS)";"RS";"CAPAO BONITO DO SUL";46;2;6;54
2013;"CAPAO DA CANOA (RS)";"RS";"CAPAO DA CANOA";474;66;96;636
2013;"CAPAO DO CIPO (RS)";"RS";"CAPAO DO CIPO";103;9;12;124
2013;"CAPAO DO LEAO (RS)";"RS";"CAPAO DO LEAO";513;15;26;554
2013;"CAPELA DE SANTANA (RS)";"RS";"CAPELA DE SANTANA";205;19;17;241
2013;"CAPITAO (RS)";"RS";"CAPITAO";73;7;9;89
2013;"CAPIVARI DO SUL (RS)";"RS";"CAPIVARI DO SUL";148;14;6;168
2013;"CARAA (RS)";"RS";"CARAA";100;4;20;124
2013;"CARAZINHO (RS)";"RS";"CARAZINHO";1415;87;204;1706
2013;"CARLOS BARBOSA (RS)";"RS";"CARLOS BARBOSA";853;52;123;1028
2013;"CARLOS GOMES (RS)";"RS";"CARLOS GOMES";31;6;7;44
2013;"CASCA (RS)";"RS";"CASCA";415;24;31;470
2013;"CASEIROS (RS)";"RS";"CASEIROS";158;8;16;182
2013;"CATUIPE (RS)";"RS";"CATUIPE";374;7;31;412
2013;"CAXIAS DO SUL (RS)";"RS";"CAXIAS DO SUL";9070;1441;1769;12280
2013;"CENTENARIO (RS)";"RS";"CENTENARIO";90;7;10;107
2013;"CERRITO (RS)";"RS";"CERRITO";213;12;13;238
2013;"CERRO BRANCO (RS)";"RS";"CERRO BRANCO";61;9;16;86
2013;"CERRO GRANDE (RS)";"RS";"CERRO GRANDE";45;2;13;60
2013;"CERRO GRANDE DO SUL (RS)";"RS";"CERRO GRANDE DO SUL";267;21;26;314
2013;"CERRO LARGO (RS)";"RS";"CERRO LARGO";372;11;37;420
2013;"CHAPADA (RS)";"RS";"CHAPADA";351;45;30;426
2013;"CHARQUEADAS (RS)";"RS";"CHARQUEADAS";380;77;117;574
2013;"CHARRUA (RS)";"RS";"CHARRUA";98;4;11;113
2013;"CHIAPETTA (RS)";"RS";"CHIAPETTA";145;9;15;169
2013;"CHUI (RS)";"RS";"CHUI";114;11;8;133
2013;"CHUVISCA (RS)";"RS";"CHUVISCA";125;6;34;165
2013;"CIDREIRA (RS)";"RS";"CIDREIRA";111;10;33;154
2013;"CIRIACO (RS)";"RS";"CIRIACO";151;15;20;186
2013;"COLINAS (RS)";"RS";"COLINAS";71;9;9;89
2013;"COLORADO (RS)";"RS";"COLORADO";216;16;13;245
2013;"CONDOR (RS)";"RS";"CONDOR";259;18;27;304
2013;"CONSTANTINA (RS)";"RS";"CONSTANTINA";353;21;82;456
2013;"COQUEIRO BAIXO (RS)";"RS";"COQUEIRO BAIXO";17;4;5;26
2013;"COQUEIROS DO SUL (RS)";"RS";"COQUEIROS DO SUL";121;6;12;139
2013;"CORONEL BARROS (RS)";"RS";"CORONEL BARROS";108;0;9;117
2013;"CORONEL BICACO (RS)";"RS";"CORONEL BICACO";217;19;23;259
2013;"CORONEL PILAR (RS)";"RS";"CORONEL PILAR";204;8;10;222
2013;"COTIPORA (RS)";"RS";"COTIPORA";229;10;13;252
2013;"COXILHA (RS)";"RS";"COXILHA";116;6;15;137
2013;"CRISSIUMAL (RS)";"RS";"CRISSIUMAL";332;18;48;398
2013;"CRISTAL (RS)";"RS";"CRISTAL";200;10;40;250
2013;"CRISTAL DO SUL (RS)";"RS";"CRISTAL DO SUL";40;9;18;67
2013;"CRUZ ALTA (RS)";"RS";"CRUZ ALTA";1198;95;126;1419
2013;"CRUZALTENSE (RS)";"RS";"CRUZALTENSE";60;7;8;75
2013;"CRUZEIRO DO SUL (RS)";"RS";"CRUZEIRO DO SUL";431;15;19;465
2013;"DAVID CANABARRO (RS)";"RS";"DAVID CANABARRO";169;12;29;210
2013;"DERRUBADAS (RS)";"RS";"DERRUBADAS";84;13;12;109
2013;"DEZESSEIS DE NOVEMBRO (RS)";"RS";"DEZESSEIS DE NOVEMBRO";55;4;8;67
2013;"DILERMANDO DE AGUIAR (RS)";"RS";"DILERMANDO DE AGUIAR";47;1;29;77
2013;"DOIS IRMAOS (RS)";"RS";"DOIS IRMAOS";479;29;117;625
2013;"DOIS IRMAOS DAS MISSOES (RS)";"RS";"DOIS IRMAOS DAS MISSOES";68;10;6;84
2013;"DOIS LAJEADOS (RS)";"RS";"DOIS LAJEADOS";136;3;17;156
2013;"DOM FELICIANO (RS)";"RS";"DOM FELICIANO";246;14;78;338
2013;"DOM PEDRITO (RS)";"RS";"DOM PEDRITO";600;36;45;681
2013;"DOM PEDRO DE ALCANTARA (RS)";"RS";"DOM PEDRO DE ALCANTARA";96;3;6;105
2013;"DONA FRANCISCA (RS)";"RS";"DONA FRANCISCA";51;1;10;62
2013;"DOUTOR MAURICIO CARDOSO (RS)";"RS";"DOUTOR MAURICIO CARDOSO";201;11;16;228
2013;"DOUTOR RICARDO (RS)";"RS";"DOUTOR RICARDO";63;8;6;77
2013;"ELDORADO DO SUL (RS)";"RS";"ELDORADO DO SUL";539;35;55;629
2013;"ENCANTADO (RS)";"RS";"ENCANTADO";747;56;126;929
2013;"ENCRUZILHADA DO SUL (RS)";"RS";"ENCRUZILHADA DO SUL";379;24;176;579
2013;"ENGENHO VELHO (RS)";"RS";"ENGENHO VELHO";35;1;14;50
2013;"ENTRE IJUIS (RS)";"RS";"ENTRE IJUIS";337;11;25;373
2013;"ENTRE RIOS DO SUL (RS)";"RS";"ENTRE RIOS DO SUL";55;13;19;87
2013;"EREBANGO (RS)";"RS";"EREBANGO";116;2;8;126
2013;"ERECHIM (RS)";"RS";"ERECHIM";2125;306;507;2938
2013;"ERNESTINA (RS)";"RS";"ERNESTINA";159;27;21;207
2013;"ERVAL GRANDE (RS)";"RS";"ERVAL GRANDE";118;23;23;164
2013;"ERVAL SECO (RS)";"RS";"ERVAL SECO";153;5;38;196
2013;"ESMERALDA (RS)";"RS";"ESMERALDA";84;2;13;99
2013;"ESPERANCA DO SUL (RS)";"RS";"ESPERANCA DO SUL";48;3;12;63
2013;"ESPUMOSO (RS)";"RS";"ESPUMOSO";716;29;72;817
2013;"ESTACAO (RS)";"RS";"ESTACAO";225;14;13;252
2013;"ESTANCIA VELHA (RS)";"RS";"ESTANCIA VELHA";788;78;120;986
2013;"ESTEIO (RS)";"RS";"ESTEIO";1128;124;282;1534
2013;"ESTRELA (RS)";"RS";"ESTRELA";1119;37;74;1230
2013;"ESTRELA VELHA (RS)";"RS";"ESTRELA VELHA";127;7;16;150
2013;"EUGENIO DE CASTRO (RS)";"RS";"EUGENIO DE CASTRO";98;9;10;117
2013;"FAGUNDES VARELA (RS)";"RS";"FAGUNDES VARELA";117;3;18;138
2013;"FARROUPILHA (RS)";"RS";"FARROUPILHA";2170;248;195;2613
2013;"FAXINAL DO SOTURNO (RS)";"RS";"FAXINAL DO SOTURNO";141;5;13;159
2013;"FAXINALZINHO (RS)";"RS";"FAXINALZINHO";55;9;12;76
2013;"FAZENDA VILANOVA (RS)";"RS";"FAZENDA VILANOVA";151;12;17;180
2013;"FELIZ (RS)";"RS";"FELIZ";458;37;77;572
2013;"FLORES DA CUNHA (RS)";"RS";"FLORES DA CUNHA";1525;71;124;1720
2013;"FLORIANO PEIXOTO (RS)";"RS";"FLORIANO PEIXOTO";71;18;18;107
2013;"FONTOURA XAVIER (RS)";"RS";"FONTOURA XAVIER";213;27;44;284
2013;"FORMIGUEIRO (RS)";"RS";"FORMIGUEIRO";165;3;26;194
2013;"FORQUETINHA (RS)";"RS";"FORQUETINHA";73;4;2;79
2013;"FORTALEZA DOS VALOS (RS)";"RS";"FORTALEZA DOS VALOS";252;6;24;282
2013;"FREDERICO WESTPHALEN (RS)";"RS";"FREDERICO WESTPHALEN";765;37;101;903
2013;"GARIBALDI (RS)";"RS";"GARIBALDI";1412;80;128;1620
2013;"GARRUCHOS (RS)";"RS";"GARRUCHOS";43;9;16;68
2013;"GAURAMA (RS)";"RS";"GAURAMA";209;20;23;252
2013;"GENERAL CAMARA (RS)";"RS";"GENERAL CAMARA";98;8;22;128
2013;"GENTIL (RS)";"RS";"GENTIL";97;9;15;121
2013;"GETULIO VARGAS (RS)";"RS";"GETULIO VARGAS";514;28;35;577
2013;"GIRUA (RS)";"RS";"GIRUA";543;41;53;637
2013;"GLORINHA (RS)";"RS";"GLORINHA";204;31;21;256
2013;"GRAMADO (RS)";"RS";"GRAMADO";701;146;146;993
2013;"GRAMADO DOS LOUREIROS (RS)";"RS";"GRAMADO DOS LOUREIROS";36;2;13;51
2013;"GRAMADO XAVIER (RS)";"RS";"GRAMADO XAVIER";55;5;5;65
2013;"GRAVATAI (RS)";"RS";"GRAVATAI";3483;537;666;4686
2013;"GUABIJU (RS)";"RS";"GUABIJU";46;6;7;59
2013;"GUAIBA (RS)";"RS";"GUAIBA";1014;196;414;1624
2013;"GUAPORE (RS)";"RS";"GUAPORE";482;41;81;604
2013;"GUARANI DAS MISSOES (RS)";"RS";"GUARANI DAS MISSOES";253;6;24;283
2013;"HARMONIA (RS)";"RS";"HARMONIA";232;8;9;249
2013;"HERVAL (RS)";"RS";"HERVAL";119;14;11;144
2013;"HERVEIRAS (RS)";"RS";"HERVEIRAS";60;1;2;63
2013;"HORIZONTINA (RS)";"RS";"HORIZONTINA";375;30;58;463
2013;"HULHA NEGRA (RS)";"RS";"HULHA NEGRA";70;7;32;109
2013;"HUMAITA (RS)";"RS";"HUMAITA";132;7;10;149
2013;"IBARAMA (RS)";"RS";"IBARAMA";106;5;21;132
2013;"IBIACA (RS)";"RS";"IBIACA";270;13;27;310
2013;"IBIRAIARAS (RS)";"RS";"IBIRAIARAS";456;11;28;495
2013;"IBIRAPUITA (RS)";"RS";"IBIRAPUITA";144;12;44;200
2013;"IBIRUBA (RS)";"RS";"IBIRUBA";952;62;87;1101
2013;"IGREJINHA (RS)";"RS";"IGREJINHA";441;36;102;579
2013;"IJUI (RS)";"RS";"IJUI";1926;130;134;2190
2013;"ILOPOLIS (RS)";"RS";"ILOPOLIS";210;6;11;227
2013;"IMBE (RS)";"RS";"IMBE";287;23;59;369
2013;"IMIGRANTE (RS)";"RS";"IMIGRANTE";103;19;18;140
2013;"INDEPENDENCIA (RS)";"RS";"INDEPENDENCIA";236;18;42;296
2013;"INHACORA (RS)";"RS";"INHACORA";67;5;8;80
2013;"IPE (RS)";"RS";"IPE";292;28;24;344
2013;"IPIRANGA DO SUL (RS)";"RS";"IPIRANGA DO SUL";121;9;15;145
2013;"IRAI (RS)";"RS";"IRAI";141;9;26;176
2013;"ITAARA (RS)";"RS";"ITAARA";118;7;17;142
2013;"ITACURUBI (RS)";"RS";"ITACURUBI";38;7;13;58
2013;"ITAPUCA (RS)";"RS";"ITAPUCA";60;4;9;73
2013;"ITAQUI (RS)";"RS";"ITAQUI";663;27;82;772
2013;"ITATI (RS)";"RS";"ITATI";75;6;13;94
2013;"ITATIBA DO SUL (RS)";"RS";"ITATIBA DO SUL";78;14;10;102
2013;"IVORA (RS)";"RS";"IVORA";68;4;6;78
2013;"IVOTI (RS)";"RS";"IVOTI";551;43;112;706
2013;"JABOTICABA (RS)";"RS";"JABOTICABA";75;3;20;98
2013;"JACUIZINHO (RS)";"RS";"JACUIZINHO";58;4;17;79
2013;"JACUTINGA (RS)";"RS";"JACUTINGA";111;9;9;129
2013;"JAGUARAO (RS)";"RS";"JAGUARAO";310;21;52;383
2013;"JAGUARI (RS)";"RS";"JAGUARI";268;20;64;352
2013;"JAQUIRANA (RS)";"RS";"JAQUIRANA";139;9;13;161
2013;"JARI (RS)";"RS";"JARI";71;6;13;90
2013;"JOIA (RS)";"RS";"JOIA";311;16;44;371
2013;"JULIO DE CASTILHOS (RS)";"RS";"JULIO DE CASTILHOS";627;21;66;714
2013;"LAGOA BONITA DO SUL (RS)";"RS";"LAGOA BONITA DO SUL";49;3;16;68
2013;"LAGOA DOS TRES CANTOS (RS)";"RS";"LAGOA DOS TRES CANTOS";99;9;3;111
2013;"LAGOA VERMELHA (RS)";"RS";"LAGOA VERMELHA";705;67;83;855
2013;"LAGOAO (RS)";"RS";"LAGOAO";86;6;40;132
2013;"LAJEADO (RS)";"RS";"LAJEADO";2163;170;265;2598
2013;"LAJEADO DO BUGRE (RS)";"RS";"LAJEADO DO BUGRE";24;3;12;39
2013;"LAVRAS DO SUL (RS)";"RS";"LAVRAS DO SUL";86;11;23;120
2013;"LIBERATO SALZANO (RS)";"RS";"LIBERATO SALZANO";122;9;31;162
2013;"LINDOLFO COLLOR (RS)";"RS";"LINDOLFO COLLOR";126;11;16;153
2013;"LINHA NOVA (RS)";"RS";"LINHA NOVA";75;7;6;88
2013;"MACAMBARA (RS)";"RS";"MACAMBARA";38;2;34;74
2013;"MACHADINHO (RS)";"RS";"MACHADINHO";113;12;26;151
2013;"MAMPITUBA (RS)";"RS";"MAMPITUBA";32;2;13;47
2013;"MANOEL VIANA (RS)";"RS";"MANOEL VIANA";153;6;15;174
2013;"MAQUINE (RS)";"RS";"MAQUINE";241;14;18;273
2013;"MARATA (RS)";"RS";"MARATA";126;11;22;159
2013;"MARAU (RS)";"RS";"MARAU";1127;98;172;1397
2013;"MARCELINO RAMOS (RS)";"RS";"MARCELINO RAMOS";132;19;27;178
2013;"MARIANA PIMENTEL (RS)";"RS";"MARIANA PIMENTEL";137;7;24;168
2013;"MARIANO MORO (RS)";"RS";"MARIANO MORO";71;13;8;92
2013;"MARQUES DE SOUZA (RS)";"RS";"MARQUES DE SOUZA";142;11;42;195
2013;"MATA (RS)";"RS";"MATA";107;7;24;138
2013;"MATO CASTELHANO (RS)";"RS";"MATO CASTELHANO";127;16;23;166
2013;"MATO LEITAO (RS)";"RS";"MATO LEITAO";131;7;10;148
2013;"MATO QUEIMADO (RS)";"RS";"MATO QUEIMADO";79;7;6;92
2013;"MAXIMILIANO DE ALMEIDA (RS)";"RS";"MAXIMILIANO DE ALMEIDA";143;11;125;279
2013;"MINAS DO LEAO (RS)";"RS";"MINAS DO LEAO";111;13;31;155
2013;"MIRAGUAI (RS)";"RS";"MIRAGUAI";117;3;27;147
2013;"MONTAURI (RS)";"RS";"MONTAURI";67;5;6;78
2013;"MONTE ALEGRE DOS CAMPOS (RS)";"RS";"MONTE ALEGRE DOS CAMPOS";83;2;33;118
2013;"MONTE BELO DO SUL (RS)";"RS";"MONTE BELO DO SUL";228;6;23;257
2013;"MONTENEGRO (RS)";"RS";"MONTENEGRO";1317;149;188;1654
2013;"MORMACO (RS)";"RS";"MORMACO";98;5;10;113
2013;"MORRINHOS DO SUL (RS)";"RS";"MORRINHOS DO SUL";145;3;5;153
2013;"MORRO REDONDO (RS)";"RS";"MORRO REDONDO";234;4;19;257
2013;"MORRO REUTER (RS)";"RS";"MORRO REUTER";179;11;21;211
2013;"MOSTARDAS (RS)";"RS";"MOSTARDAS";313;11;60;384
2013;"MUCUM (RS)";"RS";"MUCUM";82;10;16;108
2013;"MUITOS CAPOES (RS)";"RS";"MUITOS CAPOES";87;4;5;96
2013;"MULITERNO (RS)";"RS";"MULITERNO";111;4;8;123
2013;"NAO ME TOQUE (RS)";"RS";"NAO ME TOQUE";581;45;63;689
2013;"NICOLAU VERGUEIRO (RS)";"RS";"NICOLAU VERGUEIRO";94;7;13;114
2013;"NONOAI (RS)";"RS";"NONOAI";235;15;59;309
2013;"NOVA ALVORADA (RS)";"RS";"NOVA ALVORADA";173;7;20;200
2013;"NOVA ARACA (RS)";"RS";"NOVA ARACA";160;18;36;214
2013;"NOVA BASSANO (RS)";"RS";"NOVA BASSANO";524;36;64;624
2013;"NOVA BOA VISTA (RS)";"RS";"NOVA BOA VISTA";72;10;11;93
2013;"NOVA BRESCIA (RS)";"RS";"NOVA BRESCIA";130;14;13;157
2013;"NOVA CANDELARIA (RS)";"RS";"NOVA CANDELARIA";81;6;8;95
2013;"NOVA ESPERANCA DO SUL (RS)";"RS";"NOVA ESPERANCA DO SUL";89;6;29;124
2013;"NOVA HARTZ (RS)";"RS";"NOVA HARTZ";180;25;87;292
2013;"NOVA PADUA (RS)";"RS";"NOVA PADUA";325;3;6;334
2013;"NOVA PALMA (RS)";"RS";"NOVA PALMA";261;12;35;308
2013;"NOVA PETROPOLIS (RS)";"RS";"NOVA PETROPOLIS";551;39;69;659
2013;"NOVA PRATA (RS)";"RS";"NOVA PRATA";653;22;71;746
2013;"NOVA RAMADA (RS)";"RS";"NOVA RAMADA";115;8;10;133
2013;"NOVA ROMA DO SUL (RS)";"RS";"NOVA ROMA DO SUL";295;8;21;324
2013;"NOVA SANTA RITA (RS)";"RS";"NOVA SANTA RITA";885;51;57;993
2013;"NOVO BARREIRO (RS)";"RS";"NOVO BARREIRO";141;8;16;165
2013;"NOVO CABRAIS (RS)";"RS";"NOVO CABRAIS";95;2;9;106
2013;"NOVO HAMBURGO (RS)";"RS";"NOVO HAMBURGO";3223;311;407;3941
2013;"NOVO MACHADO (RS)";"RS";"NOVO MACHADO";171;19;12;202
2013;"NOVO TIRADENTES (RS)";"RS";"NOVO TIRADENTES";37;3;7;47
2013;"NOVO XINGU (RS)";"RS";"NOVO XINGU";40;9;11;60
2013;"OSORIO (RS)";"RS";"OSORIO";991;57;104;1152
2013;"PAIM FILHO (RS)";"RS";"PAIM FILHO";129;4;27;160
2013;"PALMARES DO SUL (RS)";"RS";"PALMARES DO SUL";182;22;34;238
2013;"PALMEIRA DAS MISSOES (RS)";"RS";"PALMEIRA DAS MISSOES";949;22;103;1074
2013;"PALMITINHO (RS)";"RS";"PALMITINHO";192;15;49;256
2013;"PANAMBI (RS)";"RS";"PANAMBI";1026;62;123;1211
2013;"PANTANO GRANDE (RS)";"RS";"PANTANO GRANDE";317;7;30;354
2013;"PARAI (RS)";"RS";"PARAI";561;8;20;589
2013;"PARAISO DO SUL (RS)";"RS";"PARAISO DO SUL";92;6;16;114
2013;"PARECI NOVO (RS)";"RS";"PARECI NOVO";446;9;20;475
2013;"PAROBE (RS)";"RS";"PAROBE";577;68;162;807
2013;"PASSA SETE (RS)";"RS";"PASSA SETE";96;2;31;129
2013;"PASSO DO SOBRADO (RS)";"RS";"PASSO DO SOBRADO";148;7;50;205
2013;"PASSO FUNDO (RS)";"RS";"PASSO FUNDO";3533;240;369;4142
2013;"PAULO BENTO (RS)";"RS";"PAULO BENTO";91;15;8;114
2013;"PAVERAMA (RS)";"RS";"PAVERAMA";208;40;42;290
2013;"PEDRAS ALTAS (RS)";"RS";"PEDRAS ALTAS";20;16;6;42
2013;"PEDRO OSORIO (RS)";"RS";"PEDRO OSORIO";104;7;31;142
2013;"PEJUCARA (RS)";"RS";"PEJUCARA";221;3;18;242
2013;"PELOTAS (RS)";"RS";"PELOTAS";5500;379;1139;7018
2013;"PICADA CAFE (RS)";"RS";"PICADA CAFE";112;22;56;190
2013;"PINHAL (RS)";"RS";"PINHAL";95;2;11;108
2013;"PINHAL DA SERRA (RS)";"RS";"PINHAL DA SERRA";46;10;14;70
2013;"PINHAL GRANDE (RS)";"RS";"PINHAL GRANDE";119;14;26;159
2013;"PINHEIRINHO DO VALE (RS)";"RS";"PINHEIRINHO DO VALE";60;5;21;86
2013;"PINHEIRO MACHADO (RS)";"RS";"PINHEIRO MACHADO";151;12;53;216
2013;"PINTO BANDEIRA (RS)";"RS";"PINTO BANDEIRA";47;6;1;54
2013;"PIRAPO (RS)";"RS";"PIRAPO";45;8;11;64
2013;"PIRATINI (RS)";"RS";"PIRATINI";260;44;117;421
2013;"PLANALTO (RS)";"RS";"PLANALTO";221;7;37;265
2013;"POCO DAS ANTAS (RS)";"RS";"POCO DAS ANTAS";106;9;19;134
2013;"PONTAO (RS)";"RS";"PONTAO";122;3;24;149
2013;"PONTE PRETA (RS)";"RS";"PONTE PRETA";67;7;8;82
2013;"PORTAO (RS)";"RS";"PORTAO";1870;106;113;2089
2013;"PORTO ALEGRE (RS)";"RS";"PORTO ALEGRE";16053;2275;4970;23298
2013;"PORTO LUCENA (RS)";"RS";"PORTO LUCENA";97;12;17;126
2013;"PORTO MAUA (RS)";"RS";"PORTO MAUA";57;4;5;66
2013;"PORTO VERA CRUZ (RS)";"RS";"PORTO VERA CRUZ";16;3;9;28
2013;"PORTO XAVIER (RS)";"RS";"PORTO XAVIER";193;18;38;249
2013;"POUSO NOVO (RS)";"RS";"POUSO NOVO";43;6;6;55
2013;"PRESIDENTE LUCENA (RS)";"RS";"PRESIDENTE LUCENA";167;5;22;194
2013;"PROGRESSO (RS)";"RS";"PROGRESSO";116;13;25;154
2013;"PROTASIO ALVES (RS)";"RS";"PROTASIO ALVES";51;7;9;67
2013;"PUTINGA (RS)";"RS";"PUTINGA";108;12;11;131
2013;"QUARAI (RS)";"RS";"QUARAI";191;20;49;260
2013;"QUATRO IRMAOS (RS)";"RS";"QUATRO IRMAOS";54;11;6;71
2013;"QUEVEDOS (RS)";"RS";"QUEVEDOS";42;6;8;56
2013;"QUINZE DE NOVEMBRO (RS)";"RS";"QUINZE DE NOVEMBRO";199;25;27;251
2013;"REDENTORA (RS)";"RS";"REDENTORA";99;19;21;139
2013;"RELVADO (RS)";"RS";"RELVADO";45;15;3;63
2013;"RESTINGA SECA (RS)";"RS";"RESTINGA SECA";325;15;60;400
2013;"RIO DOS INDIOS (RS)";"RS";"RIO DOS INDIOS";73;5;26;104
2013;"RIO GRANDE (RS)";"RS";"RIO GRANDE";2354;239;794;3387
2013;"RIO PARDO (RS)";"RS";"RIO PARDO";495;52;78;625
2013;"RIOZINHO (RS)";"RS";"RIOZINHO";53;10;28;91
2013;"ROCA SALES (RS)";"RS";"ROCA SALES";167;27;39;233
2013;"RODEIO BONITO (RS)";"RS";"RODEIO BONITO";143;7;29;179
2013;"ROLADOR (RS)";"RS";"ROLADOR";62;3;7;72
2013;"ROLANTE (RS)";"RS";"ROLANTE";270;33;92;395
2013;"RONDA ALTA (RS)";"RS";"RONDA ALTA";295;16;36;347
2013;"RONDINHA (RS)";"RS";"RONDINHA";199;9;20;228
2013;"ROQUE GONZALES (RS)";"RS";"ROQUE GONZALES";143;6;22;171
2013;"ROSARIO DO SUL (RS)";"RS";"ROSARIO DO SUL";511;41;92;644
2013;"SAGRADA FAMILIA (RS)";"RS";"SAGRADA FAMILIA";43;4;7;54
2013;"SALDANHA MARINHO (RS)";"RS";"SALDANHA MARINHO";163;11;5;179
2013;"SALTO DO JACUI (RS)";"RS";"SALTO DO JACUI";226;23;36;285
2013;"SALVADOR DAS MISSOES (RS)";"RS";"SALVADOR DAS MISSOES";119;3;3;125
2013;"SALVADOR DO SUL (RS)";"RS";"SALVADOR DO SUL";299;32;28;359
2013;"SANANDUVA (RS)";"RS";"SANANDUVA";662;27;53;742
2013;"SANTA BARBARA DO SUL (RS)";"RS";"SANTA BARBARA DO SUL";372;16;41;429
2013;"SANTA CECILIA DO SUL (RS)";"RS";"SANTA CECILIA DO SUL";63;5;18;86
2013;"SANTA CLARA DO SUL (RS)";"RS";"SANTA CLARA DO SUL";141;30;13;184
2013;"SANTA CRUZ DO SUL (RS)";"RS";"SANTA CRUZ DO SUL";2281;168;619;3068
2013;"SANTA MARGARIDA DO SUL (RS)";"RS";"SANTA MARGARIDA DO SUL";44;3;3;50
2013;"SANTA MARIA (RS)";"RS";"SANTA MARIA";3595;376;996;4967
2013;"SANTA MARIA DO HERVAL (RS)";"RS";"SANTA MARIA DO HERVAL";232;18;53;303
2013;"SANTA ROSA (RS)";"RS";"SANTA ROSA";1631;104;175;1910
2013;"SANTA TEREZA (RS)";"RS";"SANTA TEREZA";89;6;4;99
2013;"SANTA VITORIA DO PALMAR (RS)";"RS";"SANTA VITORIA DO PALMAR";568;17;63;648
2013;"SANTANA DA BOA VISTA (RS)";"RS";"SANTANA DA BOA VISTA";84;15;41;140
2013;"SANTANA DO LIVRAMENTO (RS)";"RS";"SANTANA DO LIVRAMENTO";786;82;213;1081
2013;"SANTIAGO (RS)";"RS";"SANTIAGO";887;84;102;1073
2013;"SANTO ANGELO (RS)";"RS";"SANTO ANGELO";1331;90;124;1545
2013;"SANTO ANTONIO DA PATRULHA (RS)";"RS";"SANTO ANTONIO DA PATRULHA";965;49;194;1208
2013;"SANTO ANTONIO DAS MISSOES (RS)";"RS";"SANTO ANTONIO DAS MISSOES";200;45;33;278
2013;"SANTO ANTONIO DO PALMA (RS)";"RS";"SANTO ANTONIO DO PALMA";61;3;11;75
2013;"SANTO ANTONIO DO PLANALTO (RS)";"RS";"SANTO ANTONIO DO PLANALTO";99;4;9;112
2013;"SANTO AUGUSTO (RS)";"RS";"SANTO AUGUSTO";536;44;34;614
2013;"SANTO CRISTO (RS)";"RS";"SANTO CRISTO";490;21;48;559
2013;"SANTO EXPEDITO DO SUL (RS)";"RS";"SANTO EXPEDITO DO SUL";96;3;10;109
2013;"SAO BORJA (RS)";"RS";"SAO BORJA";1161;56;105;1322
2013;"SAO DOMINGOS DO SUL (RS)";"RS";"SAO DOMINGOS DO SUL";102;9;10;121
2013;"SAO FRANCISCO DE ASSIS (RS)";"RS";"SAO FRANCISCO DE ASSIS";313;20;94;427
2013;"SAO FRANCISCO DE PAULA (RS)";"RS";"SAO FRANCISCO DE PAULA";522;36;75;633
2013;"SAO GABRIEL (RS)";"RS";"SAO GABRIEL";894;34;124;1052
2013;"SAO JERONIMO (RS)";"RS";"SAO JERONIMO";270;27;117;414
2013;"SAO JOAO DA URTIGA (RS)";"RS";"SAO JOAO DA URTIGA";157;5;22;184
2013;"SAO JOAO DO POLESINE (RS)";"RS";"SAO JOAO DO POLESINE";74;0;7;81
2013;"SAO JORGE (RS)";"RS";"SAO JORGE";144;7;19;170
2013;"SAO JOSE DAS MISSOES (RS)";"RS";"SAO JOSE DAS MISSOES";43;3;9;55
2013;"SAO JOSE DO HERVAL (RS)";"RS";"SAO JOSE DO HERVAL";75;4;15;94
2013;"SAO JOSE DO HORTENCIO (RS)";"RS";"SAO JOSE DO HORTENCIO";192;10;30;232
2013;"SAO JOSE DO INHACORA (RS)";"RS";"SAO JOSE DO INHACORA";48;5;7;60
2013;"SAO JOSE DO NORTE (RS)";"RS";"SAO JOSE DO NORTE";374;11;84;469
2013;"SAO JOSE DO OURO (RS)";"RS";"SAO JOSE DO OURO";314;5;38;357
2013;"SAO JOSE DO SUL (RS)";"RS";"SAO JOSE DO SUL";140;11;11;162
2013;"SAO JOSE DOS AUSENTES (RS)";"RS";"SAO JOSE DOS AUSENTES";111;8;16;135
2013;"SAO LEOPOLDO (RS)";"RS";"SAO LEOPOLDO";2194;280;513;2987
2013;"SAO LOURENCO DO SUL (RS)";"RS";"SAO LOURENCO DO SUL";949;51;149;1149
2013;"SAO LUIZ GONZAGA (RS)";"RS";"SAO LUIZ GONZAGA";629;64;85;778
2013;"SAO MARCOS (RS)";"RS";"SAO MARCOS";761;25;123;909
2013;"SAO MARTINHO (RS)";"RS";"SAO MARTINHO";200;11;21;232
2013;"SAO MARTINHO DA SERRA (RS)";"RS";"SAO MARTINHO DA SERRA";45;4;4;53
2013;"SAO MIGUEL DAS MISSOES (RS)";"RS";"SAO MIGUEL DAS MISSOES";256;21;36;313
2013;"SAO NICOLAU (RS)";"RS";"SAO NICOLAU";73;13;14;100
2013;"SAO PAULO DAS MISSOES (RS)";"RS";"SAO PAULO DAS MISSOES";115;11;32;158
2013;"SAO PEDRO DA SERRA (RS)";"RS";"SAO PEDRO DA SERRA";113;12;12;137
2013;"SAO PEDRO DAS MISSOES (RS)";"RS";"SAO PEDRO DAS MISSOES";38;5;5;48
2013;"SAO PEDRO DO BUTIA (RS)";"RS";"SAO PEDRO DO BUTIA";115;2;11;128
2013;"SAO PEDRO DO SUL (RS)";"RS";"SAO PEDRO DO SUL";303;51;42;396
2013;"SAO SEBASTIAO DO CAI (RS)";"RS";"SAO SEBASTIAO DO CAI";792;28;63;883
2013;"SAO SEPE (RS)";"RS";"SAO SEPE";442;45;107;594
2013;"SAO VALENTIM (RS)";"RS";"SAO VALENTIM";65;15;13;93
2013;"SAO VALENTIM DO SUL (RS)";"RS";"SAO VALENTIM DO SUL";82;4;9;95
2013;"SAO VALERIO DO SUL (RS)";"RS";"SAO VALERIO DO SUL";43;2;9;54
2013;"SAO VENDELINO (RS)";"RS";"SAO VENDELINO";87;13;11;111
2013;"SAO VICENTE DO SUL (RS)";"RS";"SAO VICENTE DO SUL";138;7;50;195
2013;"SAPIRANGA (RS)";"RS";"SAPIRANGA";902;107;167;1176
2013;"SAPUCAIA DO SUL (RS)";"RS";"SAPUCAIA DO SUL";1676;145;125;1946
2013;"SARANDI (RS)";"RS";"SARANDI";608;37;71;716
2013;"SEBERI (RS)";"RS";"SEBERI";292;11;46;349
2013;"SEDE NOVA (RS)";"RS";"SEDE NOVA";89;10;14;113
2013;"SEGREDO (RS)";"RS";"SEGREDO";170;6;49;225
2013;"SELBACH (RS)";"RS";"SELBACH";342;10;25;377
2013;"SENADOR SALGADO FILHO (RS)";"RS";"SENADOR SALGADO FILHO";134;11;9;154
2013;"SENTINELA DO SUL (RS)";"RS";"SENTINELA DO SUL";148;2;15;165
2013;"SERAFINA CORREA (RS)";"RS";"SERAFINA CORREA";356;48;62;466
2013;"SERIO (RS)";"RS";"SERIO";58;6;4;68
2013;"SERTAO (RS)";"RS";"SERTAO";256;15;41;312
2013;"SERTAO SANTANA (RS)";"RS";"SERTAO SANTANA";162;9;24;195
2013;"SETE DE SETEMBRO (RS)";"RS";"SETE DE SETEMBRO";76;4;10;90
2013;"SEVERIANO DE ALMEIDA (RS)";"RS";"SEVERIANO DE ALMEIDA";101;16;16;133
2013;"SILVEIRA MARTINS (RS)";"RS";"SILVEIRA MARTINS";131;2;7;140
2013;"SINIMBU (RS)";"RS";"SINIMBU";136;3;5;144
2013;"SOBRADINHO (RS)";"RS";"SOBRADINHO";317;16;52;385
2013;"SOLEDADE (RS)";"RS";"SOLEDADE";615;37;128;780
2013;"TABAI (RS)";"RS";"TABAI";211;22;13;246
2013;"TAPEJARA (RS)";"RS";"TAPEJARA";796;31;99;926
2013;"TAPERA (RS)";"RS";"TAPERA";388;27;33;448
2013;"TAPES (RS)";"RS";"TAPES";292;21;37;350
2013;"TAQUARA (RS)";"RS";"TAQUARA";808;58;272;1138
2013;"TAQUARI (RS)";"RS";"TAQUARI";466;37;154;657
2013;"TAQUARUCU DO SUL (RS)";"RS";"TAQUARUCU DO SUL";76;2;16;94
2013;"TAVARES (RS)";"RS";"TAVARES";141;4;24;169
2013;"TENENTE PORTELA (RS)";"RS";"TENENTE PORTELA";295;14;53;362
2013;"TERRA DE AREIA (RS)";"RS";"TERRA DE AREIA";324;11;38;373
2013;"TEUTONIA (RS)";"RS";"TEUTONIA";731;34;96;861
2013;"TIO HUGO (RS)";"RS";"TIO HUGO";128;8;10;146
2013;"TIRADENTES DO SUL (RS)";"RS";"TIRADENTES DO SUL";103;6;13;122
2013;"TOROPI (RS)";"RS";"TOROPI";62;3;20;85
2013;"TORRES (RS)";"RS";"TORRES";455;32;76;563
2013;"TRAMANDAI (RS)";"RS";"TRAMANDAI";692;67;139;898
2013;"TRAVESSEIRO (RS)";"RS";"TRAVESSEIRO";47;8;13;68
2013;"TRES ARROIOS (RS)";"RS";"TRES ARROIOS";102;13;5;120
2013;"TRES CACHOEIRAS (RS)";"RS";"TRES CACHOEIRAS";641;11;22;674
2013;"TRES COROAS (RS)";"RS";"TRES COROAS";286;37;75;398
2013;"TRES DE MAIO (RS)";"RS";"TRES DE MAIO";743;47;79;869
2013;"TRES FORQUILHAS (RS)";"RS";"TRES FORQUILHAS";101;5;7;113
2013;"TRES PALMEIRAS (RS)";"RS";"TRES PALMEIRAS";74;6;27;107
2013;"TRES PASSOS (RS)";"RS";"TRES PASSOS";462;27;133;622
2013;"TRINDADE DO SUL (RS)";"RS";"TRINDADE DO SUL";123;14;23;160
2013;"TRIUNFO (RS)";"RS";"TRIUNFO";585;136;278;999
2013;"TUCUNDUVA (RS)";"RS";"TUCUNDUVA";244;14;15;273
2013;"TUNAS (RS)";"RS";"TUNAS";54;7;21;82
2013;"TUPANCI DO SUL (RS)";"RS";"TUPANCI DO SUL";54;3;15;72
2013;"TUPANCIRETA (RS)";"RS";"TUPANCIRETA";559;59;54;672
2013;"TUPANDI (RS)";"RS";"TUPANDI";120;27;33;180
2013;"TUPARENDI (RS)";"RS";"TUPARENDI";274;13;24;311
2013;"TURUCU (RS)";"RS";"TURUCU";96;6;14;116
2013;"UBIRETAMA (RS)";"RS";"UBIRETAMA";87;10;4;101
2013;"UNIAO DA SERRA (RS)";"RS";"UNIAO DA SERRA";65;3;12;80
2013;"UNISTALDA (RS)";"RS";"UNISTALDA";36;14;19;69
2013;"URUGUAIANA (RS)";"RS";"URUGUAIANA";1804;89;177;2070
2013;"VACARIA (RS)";"RS";"VACARIA";1711;152;500;2363
2013;"VALE DO SOL (RS)";"RS";"VALE DO SOL";196;12;43;251
2013;"VALE REAL (RS)";"RS";"VALE REAL";214;12;9;235
2013;"VALE VERDE (RS)";"RS";"VALE VERDE";62;5;8;75
2013;"VANINI (RS)";"RS";"VANINI";101;9;13;123
2013;"VENANCIO AIRES (RS)";"RS";"VENANCIO AIRES";1189;90;189;1468
2013;"VERA CRUZ (RS)";"RS";"VERA CRUZ";436;31;128;595
2013;"VERANOPOLIS (RS)";"RS";"VERANOPOLIS";964;41;63;1068
2013;"VESPASIANO CORREA (RS)";"RS";"VESPASIANO CORREA";107;8;12;127
2013;"VIADUTOS (RS)";"RS";"VIADUTOS";139;12;24;175
2013;"VIAMAO (RS)";"RS";"VIAMAO";2195;323;669;3187
2013;"VICENTE DUTRA (RS)";"RS";"VICENTE DUTRA";55;2;18;75
2013;"VICTOR GRAEFF (RS)";"RS";"VICTOR GRAEFF";175;15;8;198
2013;"VILA FLORES (RS)";"RS";"VILA FLORES";182;12;14;208
2013;"VILA LANGARO (RS)";"RS";"VILA LANGARO";110;8;14;132
2013;"VILA MARIA (RS)";"RS";"VILA MARIA";257;10;42;309
2013;"VILA NOVA DO SUL (RS)";"RS";"VILA NOVA DO SUL";98;9;12;119
2013;"VISTA ALEGRE (RS)";"RS";"VISTA ALEGRE";70;5;11;86
2013;"VISTA ALEGRE DO PRATA (RS)";"RS";"VISTA ALEGRE DO PRATA";44;9;3;56
2013;"VISTA GAUCHA (RS)";"RS";"VISTA GAUCHA";68;2;12;82
2013;"VITORIA DAS MISSOES (RS)";"RS";"VITORIA DAS MISSOES";109;0;14;123
2013;"WESTFALIA (RS)";"RS";"WESTFALIA";139;18;17;174
2013;"XANGRI LA (RS)";"RS";"XANGRI LA";207;17;12;236
2013;"ABDON BATISTA (SC)";"SC";"ABDON BATISTA";77;5;11;93
2013;"ABELARDO LUZ (SC)";"SC";"ABELARDO LUZ";400;18;98;516
2013;"AGROLANDIA (SC)";"SC";"AGROLANDIA";252;19;14;285
2013;"AGRONOMICA (SC)";"SC";"AGRONOMICA";168;5;15;188
2013;"AGUA DOCE (SC)";"SC";"AGUA DOCE";211;26;26;263
2013;"AGUAS DE CHAPECO (SC)";"SC";"AGUAS DE CHAPECO";89;9;25;123
2013;"AGUAS FRIAS (SC)";"SC";"AGUAS FRIAS";58;5;4;67
2013;"AGUAS MORNAS (SC)";"SC";"AGUAS MORNAS";279;7;17;303
2013;"ALFREDO WAGNER (SC)";"SC";"ALFREDO WAGNER";273;23;15;311
2013;"ALTO BELA VISTA (SC)";"SC";"ALTO BELA VISTA";62;8;7;77
2013;"ANCHIETA (SC)";"SC";"ANCHIETA";246;14;18;278
2013;"ANGELINA (SC)";"SC";"ANGELINA";219;18;15;252
2013;"ANITA GARIBALDI (SC)";"SC";"ANITA GARIBALDI";129;11;27;167
2013;"ANITAPOLIS (SC)";"SC";"ANITAPOLIS";105;9;13;127
2013;"ANTONIO CARLOS (SC)";"SC";"ANTONIO CARLOS";604;5;12;621
2013;"APIUNA (SC)";"SC";"APIUNA";189;25;21;235
2013;"ARABUTA (SC)";"SC";"ARABUTA";119;12;34;165
2013;"ARAQUARI (SC)";"SC";"ARAQUARI";656;56;58;770
2013;"ARARANGUA (SC)";"SC";"ARARANGUA";1330;76;180;1586
2013;"ARMAZEM (SC)";"SC";"ARMAZEM";261;15;16;292
2013;"ARROIO TRINTA (SC)";"SC";"ARROIO TRINTA";179;18;14;211
2013;"ARVOREDO (SC)";"SC";"ARVOREDO";41;20;7;68
2013;"ASCURRA (SC)";"SC";"ASCURRA";246;23;28;297
2013;"ATALANTA (SC)";"SC";"ATALANTA";91;1;5;97
2013;"AURORA (SC)";"SC";"AURORA";182;7;13;202
2013;"BALNEARIO ARROIO DO SILVA (SC)";"SC";"BALNEARIO ARROIO DO SILVA";120;5;15;140
2013;"BALNEARIO BARRA DO SUL (SC)";"SC";"BALNEARIO BARRA DO SUL";157;14;7;178
2013;"BALNEARIO CAMBORIU (SC)";"SC";"BALNEARIO CAMBORIU";999;260;304;1563
2013;"BALNEARIO DE PICARRAS (SC)";"SC";"BALNEARIO DE PICARRAS";328;32;37;397
2013;"BALNEARIO GAIVOTA (SC)";"SC";"BALNEARIO GAIVOTA";165;9;20;194
2013;"BALNEARIO RINCAO (SC)";"SC";"BALNEARIO RINCAO";15;3;0;18
2013;"BANDEIRANTE (SC)";"SC";"BANDEIRANTE";47;4;12;63
2013;"BARRA BONITA (SC)";"SC";"BARRA BONITA";35;7;8;50
2013;"BARRA VELHA (SC)";"SC";"BARRA VELHA";478;41;39;558
2013;"BELA VISTA DO TOLDO (SC)";"SC";"BELA VISTA DO TOLDO";90;8;40;138
2013;"BELMONTE (SC)";"SC";"BELMONTE";64;11;7;82
2013;"BENEDITO NOVO (SC)";"SC";"BENEDITO NOVO";304;42;24;370
2013;"BIGUACU (SC)";"SC";"BIGUACU";1122;75;119;1316
2013;"BLUMENAU (SC)";"SC";"BLUMENAU";5381;424;776;6581
2013;"BOCAINA DO SUL (SC)";"SC";"BOCAINA DO SUL";59;3;15;77
2013;"BOM JARDIM DA SERRA (SC)";"SC";"BOM JARDIM DA SERRA";114;11;24;149
2013;"BOM JESUS (SC)";"SC";"BOM JESUS";64;2;7;73
2013;"BOM JESUS DO OESTE (SC)";"SC";"BOM JESUS DO OESTE";60;6;8;74
2013;"BOM RETIRO (SC)";"SC";"BOM RETIRO";187;16;33;236
2013;"BOMBINHAS (SC)";"SC";"BOMBINHAS";150;50;22;222
2013;"BOTUVERA (SC)";"SC";"BOTUVERA";220;6;17;243
2013;"BRACO DO NORTE (SC)";"SC";"BRACO DO NORTE";1154;51;65;1270
2013;"BRACO DO TROMBUDO (SC)";"SC";"BRACO DO TROMBUDO";125;6;4;135
2013;"BRUNOPOLIS (SC)";"SC";"BRUNOPOLIS";91;7;10;108
2013;"BRUSQUE (SC)";"SC";"BRUSQUE";2459;159;181;2799
2013;"CACADOR (SC)";"SC";"CACADOR";2033;119;763;2915
2013;"CAIBI (SC)";"SC";"CAIBI";181;6;24;211
2013;"CALMON (SC)";"SC";"CALMON";37;10;23;70
2013;"CAMBORIU (SC)";"SC";"CAMBORIU";1077;52;32;1161
2013;"CAMPO ALEGRE (SC)";"SC";"CAMPO ALEGRE";424;14;14;452
2013;"CAMPO BELO DO SUL (SC)";"SC";"CAMPO BELO DO SUL";191;12;38;241
2013;"CAMPO ERE (SC)";"SC";"CAMPO ERE";272;13;33;318
2013;"CAMPOS NOVOS (SC)";"SC";"CAMPOS NOVOS";1003;79;103;1185
2013;"CANELINHA (SC)";"SC";"CANELINHA";541;18;8;567
2013;"CANOINHAS (SC)";"SC";"CANOINHAS";1279;56;141;1476
2013;"CAPAO ALTO (SC)";"SC";"CAPAO ALTO";70;7;17;94
2013;"CAPINZAL (SC)";"SC";"CAPINZAL";446;30;54;530
2013;"CAPIVARI DE BAIXO (SC)";"SC";"CAPIVARI DE BAIXO";360;16;26;402
2013;"CATANDUVAS (SC)";"SC";"CATANDUVAS";323;25;49;397
2013;"CAXAMBU DO SUL (SC)";"SC";"CAXAMBU DO SUL";102;3;16;121
2013;"CELSO RAMOS (SC)";"SC";"CELSO RAMOS";62;6;6;74
2013;"CERRO NEGRO (SC)";"SC";"CERRO NEGRO";58;7;20;85
2013;"CHAPADAO DO LAGEADO (SC)";"SC";"CHAPADAO DO LAGEADO";47;5;10;62
2013;"CHAPECO (SC)";"SC";"CHAPECO";4373;299;387;5059
2013;"COCAL DO SUL (SC)";"SC";"COCAL DO SUL";303;18;29;350
2013;"CONCORDIA (SC)";"SC";"CONCORDIA";2434;130;239;2803
2013;"CORDILHEIRA ALTA (SC)";"SC";"CORDILHEIRA ALTA";300;20;8;328
2013;"CORONEL FREITAS (SC)";"SC";"CORONEL FREITAS";250;12;27;289
2013;"CORONEL MARTINS (SC)";"SC";"CORONEL MARTINS";46;7;15;68
2013;"CORREIA PINTO (SC)";"SC";"CORREIA PINTO";377;46;59;482
2013;"CORUPA (SC)";"SC";"CORUPA";391;6;35;432
2013;"CRICIUMA (SC)";"SC";"CRICIUMA";3695;296;426;4417
2013;"CUNHA PORA (SC)";"SC";"CUNHA PORA";406;15;52;473
2013;"CUNHATAI (SC)";"SC";"CUNHATAI";35;3;8;46
2013;"CURITIBANOS (SC)";"SC";"CURITIBANOS";967;75;116;1158
2013;"DESCANSO (SC)";"SC";"DESCANSO";215;14;24;253
2013;"DIONISIO CERQUEIRA (SC)";"SC";"DIONISIO CERQUEIRA";150;21;22;193
2013;"DONA EMMA (SC)";"SC";"DONA EMMA";125;18;11;154
2013;"DOUTOR PEDRINHO (SC)";"SC";"DOUTOR PEDRINHO";134;6;5;145
2013;"ENTRE RIOS (SC)";"SC";"ENTRE RIOS";34;5;22;61
2013;"ERMO (SC)";"SC";"ERMO";79;3;7;89
2013;"ERVAL VELHO (SC)";"SC";"ERVAL VELHO";109;4;24;137
2013;"FAXINAL DOS GUEDES (SC)";"SC";"FAXINAL DOS GUEDES";408;23;32;463
2013;"FLOR DO SERTAO (SC)";"SC";"FLOR DO SERTAO";22;8;16;46
2013;"FLORIANOPOLIS (SC)";"SC";"FLORIANOPOLIS";3504;890;2000;6394
2013;"FORMOSA DO SUL (SC)";"SC";"FORMOSA DO SUL";73;7;10;90
2013;"FORQUILHINHA (SC)";"SC";"FORQUILHINHA";550;17;39;606
2013;"FRAIBURGO (SC)";"SC";"FRAIBURGO";828;45;200;1073
2013;"FREI ROGERIO (SC)";"SC";"FREI ROGERIO";82;11;14;107
2013;"GALVAO (SC)";"SC";"GALVAO";92;4;20;116
2013;"GAROPABA (SC)";"SC";"GAROPABA";253;27;37;317
2013;"GARUVA (SC)";"SC";"GARUVA";516;36;29;581
2013;"GASPAR (SC)";"SC";"GASPAR";1298;69;86;1453
2013;"GOVERNADOR CELSO RAMOS (SC)";"SC";"GOVERNADOR CELSO RAMOS";153;21;16;190
2013;"GRAO PARA (SC)";"SC";"GRAO PARA";265;10;12;287
2013;"GRAVATAL (SC)";"SC";"GRAVATAL";294;14;20;328
2013;"GUABIRUBA (SC)";"SC";"GUABIRUBA";328;15;19;362
2013;"GUARACIABA (SC)";"SC";"GUARACIABA";233;15;41;289
2013;"GUARAMIRIM (SC)";"SC";"GUARAMIRIM";1063;31;24;1118
2013;"GUARUJA DO SUL (SC)";"SC";"GUARUJA DO SUL";164;10;16;190
2013;"GUATAMBU (SC)";"SC";"GUATAMBU";100;11;22;133
2013;"HERVAL D OESTE (SC)";"SC";"HERVAL D OESTE";318;30;62;410
2013;"IBIAM (SC)";"SC";"IBIAM";70;6;13;89
2013;"IBICARE (SC)";"SC";"IBICARE";144;10;10;164
2013;"IBIRAMA (SC)";"SC";"IBIRAMA";481;58;72;611
2013;"ICARA (SC)";"SC";"ICARA";1889;87;126;2102
2013;"ILHOTA (SC)";"SC";"ILHOTA";339;25;23;387
2013;"IMARUI (SC)";"SC";"IMARUI";146;24;33;203
2013;"IMBITUBA (SC)";"SC";"IMBITUBA";629;72;78;779
2013;"IMBUIA (SC)";"SC";"IMBUIA";193;9;23;225
2013;"INDAIAL (SC)";"SC";"INDAIAL";1451;86;125;1662
2013;"IOMERE (SC)";"SC";"IOMERE";163;7;8;178
2013;"IPIRA (SC)";"SC";"IPIRA";121;8;18;147
2013;"IPORA DO OESTE (SC)";"SC";"IPORA DO OESTE";249;20;57;326
2013;"IPUACU (SC)";"SC";"IPUACU";102;11;27;140
2013;"IPUMIRIM (SC)";"SC";"IPUMIRIM";261;39;33;333
2013;"IRACEMINHA (SC)";"SC";"IRACEMINHA";99;5;26;130
2013;"IRANI (SC)";"SC";"IRANI";328;28;50;406
2013;"IRATI (SC)";"SC";"IRATI";28;7;9;44
2013;"IRINEOPOLIS (SC)";"SC";"IRINEOPOLIS";251;8;18;277
2013;"ITA (SC)";"SC";"ITA";96;14;41;151
2013;"ITAIOPOLIS (SC)";"SC";"ITAIOPOLIS";596;29;83;708
2013;"ITAJAI (SC)";"SC";"ITAJAI";4375;296;366;5037
2013;"ITAPEMA (SC)";"SC";"ITAPEMA";563;53;40;656
2013;"ITAPIRANGA (SC)";"SC";"ITAPIRANGA";338;20;57;415
2013;"ITAPOA (SC)";"SC";"ITAPOA";207;12;15;234
2013;"ITUPORANGA (SC)";"SC";"ITUPORANGA";661;35;52;748
2013;"JABORA (SC)";"SC";"JABORA";129;18;24;171
2013;"JACINTO MACHADO (SC)";"SC";"JACINTO MACHADO";410;15;38;463
2013;"JAGUARUNA (SC)";"SC";"JAGUARUNA";471;23;51;545
2013;"JARAGUA DO SUL (SC)";"SC";"JARAGUA DO SUL";2535;219;380;3134
2013;"JARDINOPOLIS (SC)";"SC";"JARDINOPOLIS";18;5;4;27
2013;"JOACABA (SC)";"SC";"JOACABA";854;81;40;975
2013;"JOINVILLE (SC)";"SC";"JOINVILLE";8345;684;877;9906
2013;"JOSE BOITEUX (SC)";"SC";"JOSE BOITEUX";127;28;8;163
2013;"JUPIA (SC)";"SC";"JUPIA";44;4;7;55
2013;"LACERDOPOLIS (SC)";"SC";"LACERDOPOLIS";104;7;6;117
2013;"LAGEADO GRANDE (SC)";"SC";"LAGEADO GRANDE";39;2;6;47
2013;"LAGES (SC)";"SC";"LAGES";3419;249;358;4026
2013;"LAGUNA (SC)";"SC";"LAGUNA";621;110;92;823
2013;"LAURENTINO (SC)";"SC";"LAURENTINO";334;7;4;345
2013;"LAURO MULLER (SC)";"SC";"LAURO MULLER";466;26;49;541
2013;"LEBON REGIS (SC)";"SC";"LEBON REGIS";238;26;51;315
2013;"LEOBERTO LEAL (SC)";"SC";"LEOBERTO LEAL";119;15;7;141
2013;"LINDOIA DO SUL (SC)";"SC";"LINDOIA DO SUL";150;14;45;209
2013;"LONTRAS (SC)";"SC";"LONTRAS";330;22;39;391
2013;"LUIZ ALVES (SC)";"SC";"LUIZ ALVES";451;6;23;480
2013;"LUZERNA (SC)";"SC";"LUZERNA";145;12;23;180
2013;"MACIEIRA (SC)";"SC";"MACIEIRA";74;7;12;93
2013;"MAFRA (SC)";"SC";"MAFRA";1370;92;150;1612
2013;"MAJOR GERCINO (SC)";"SC";"MAJOR GERCINO";124;4;10;138
2013;"MAJOR VIEIRA (SC)";"SC";"MAJOR VIEIRA";213;3;13;229
2013;"MARACAJA (SC)";"SC";"MARACAJA";236;2;15;253
2013;"MARAVILHA (SC)";"SC";"MARAVILHA";771;43;68;882
2013;"MAREMA (SC)";"SC";"MAREMA";60;7;7;74
2013;"MASSARANDUBA (SC)";"SC";"MASSARANDUBA";538;26;35;599
2013;"MATOS COSTA (SC)";"SC";"MATOS COSTA";46;6;13;65
2013;"MELEIRO (SC)";"SC";"MELEIRO";276;4;23;303
2013;"MIRIM DOCE (SC)";"SC";"MIRIM DOCE";61;3;10;74
2013;"MODELO (SC)";"SC";"MODELO";127;8;10;145
2013;"MONDAI (SC)";"SC";"MONDAI";200;12;53;265
2013;"MONTE CARLO (SC)";"SC";"MONTE CARLO";161;15;97;273
2013;"MONTE CASTELO (SC)";"SC";"MONTE CASTELO";166;14;23;203
2013;"MORRO DA FUMACA (SC)";"SC";"MORRO DA FUMACA";822;31;29;882
2013;"MORRO GRANDE (SC)";"SC";"MORRO GRANDE";119;2;8;129
2013;"NAVEGANTES (SC)";"SC";"NAVEGANTES";799;89;64;952
2013;"NOVA ERECHIM (SC)";"SC";"NOVA ERECHIM";118;7;10;135
2013;"NOVA ITABERABA (SC)";"SC";"NOVA ITABERABA";108;4;16;128
2013;"NOVA TRENTO (SC)";"SC";"NOVA TRENTO";291;32;38;361
2013;"NOVA VENEZA (SC)";"SC";"NOVA VENEZA";432;34;38;504
2013;"NOVO HORIZONTE (SC)";"SC";"NOVO HORIZONTE";67;9;14;90
2013;"ORLEANS (SC)";"SC";"ORLEANS";867;26;42;935
2013;"OTACILIO COSTA (SC)";"SC";"OTACILIO COSTA";409;57;46;512
2013;"OURO (SC)";"SC";"OURO";252;28;28;308
2013;"OURO VERDE (SC)";"SC";"OURO VERDE";88;3;12;103
2013;"PAIAL (SC)";"SC";"PAIAL";15;3;19;37
2013;"PAINEL (SC)";"SC";"PAINEL";39;4;10;53
2013;"PALHOCA (SC)";"SC";"PALHOCA";2290;151;393;2834
2013;"PALMA SOLA (SC)";"SC";"PALMA SOLA";200;8;35;243
2013;"PALMEIRA (SC)";"SC";"PALMEIRA";112;5;6;123
2013;"PALMITOS (SC)";"SC";"PALMITOS";367;42;52;461
2013;"PAPANDUVA (SC)";"SC";"PAPANDUVA";537;15;82;634
2013;"PARAISO (SC)";"SC";"PARAISO";83;7;8;98
2013;"PASSO DE TORRES (SC)";"SC";"PASSO DE TORRES";141;8;16;165
2013;"PASSOS MAIA (SC)";"SC";"PASSOS MAIA";114;1;27;142
2013;"PAULO LOPES (SC)";"SC";"PAULO LOPES";239;15;11;265
2013;"PEDRAS GRANDES (SC)";"SC";"PEDRAS GRANDES";243;16;13;272
2013;"PENHA (SC)";"SC";"PENHA";371;27;46;444
2013;"PERITIBA (SC)";"SC";"PERITIBA";87;7;14;108
2013;"PESCARIA BRAVA (SC)";"SC";"PESCARIA BRAVA";9;0;2;11
2013;"PETROLANDIA (SC)";"SC";"PETROLANDIA";166;14;26;206
2013;"PINHALZINHO (SC)";"SC";"PINHALZINHO";463;19;59;541
2013;"PINHEIRO PRETO (SC)";"SC";"PINHEIRO PRETO";272;8;17;297
2013;"PIRATUBA (SC)";"SC";"PIRATUBA";107;12;29;148
2013;"PLANALTO ALEGRE (SC)";"SC";"PLANALTO ALEGRE";61;7;4;72
2013;"POMERODE (SC)";"SC";"POMERODE";662;28;96;786
2013;"PONTE ALTA (SC)";"SC";"PONTE ALTA";131;8;15;154
2013;"PONTE ALTA DO NORTE (SC)";"SC";"PONTE ALTA DO NORTE";87;4;12;103
2013;"PONTE SERRADA (SC)";"SC";"PONTE SERRADA";338;43;92;473
2013;"PORTO BELO (SC)";"SC";"PORTO BELO";253;19;29;301
2013;"PORTO UNIAO (SC)";"SC";"PORTO UNIAO";603;24;42;669
2013;"POUSO REDONDO (SC)";"SC";"POUSO REDONDO";484;23;39;546
2013;"PRAIA GRANDE (SC)";"SC";"PRAIA GRANDE";223;13;23;259
2013;"PRESIDENTE CASTELO BRANCO (SC)";"SC";"PRESIDENTE CASTELO BRANCO";63;7;9;79
2013;"PRESIDENTE GETULIO (SC)";"SC";"PRESIDENTE GETULIO";365;43;65;473
2013;"PRESIDENTE NEREU (SC)";"SC";"PRESIDENTE NEREU";37;10;7;54
2013;"PRINCESA (SC)";"SC";"PRINCESA";63;2;12;77
2013;"QUILOMBO (SC)";"SC";"QUILOMBO";224;29;52;305
2013;"RANCHO QUEIMADO (SC)";"SC";"RANCHO QUEIMADO";136;4;6;146
2013;"RIO DAS ANTAS (SC)";"SC";"RIO DAS ANTAS";193;5;29;227
2013;"RIO DO CAMPO (SC)";"SC";"RIO DO CAMPO";182;11;15;208
2013;"RIO DO OESTE (SC)";"SC";"RIO DO OESTE";212;19;21;252
2013;"RIO DO SUL (SC)";"SC";"RIO DO SUL";1481;86;115;1682
2013;"RIO DOS CEDROS (SC)";"SC";"RIO DOS CEDROS";253;30;28;311
2013;"RIO FORTUNA (SC)";"SC";"RIO FORTUNA";288;8;16;312
2013;"RIO NEGRINHO (SC)";"SC";"RIO NEGRINHO";1049;68;97;1214
2013;"RIO RUFINO (SC)";"SC";"RIO RUFINO";58;7;16;81
2013;"RIQUEZA (SC)";"SC";"RIQUEZA";132;5;27;164
2013;"RODEIO (SC)";"SC";"RODEIO";263;17;19;299
2013;"ROMELANDIA (SC)";"SC";"ROMELANDIA";92;10;28;130
2013;"SALETE (SC)";"SC";"SALETE";175;10;21;206
2013;"SALTINHO (SC)";"SC";"SALTINHO";51;7;14;72
2013;"SALTO VELOSO (SC)";"SC";"SALTO VELOSO";151;4;10;165
2013;"SANGAO (SC)";"SC";"SANGAO";478;13;17;508
2013;"SANTA CECILIA (SC)";"SC";"SANTA CECILIA";433;40;50;523
2013;"SANTA HELENA (SC)";"SC";"SANTA HELENA";59;13;12;84
2013;"SANTA ROSA DE LIMA (SC)";"SC";"SANTA ROSA DE LIMA";106;7;12;125
2013;"SANTA ROSA DO SUL (SC)";"SC";"SANTA ROSA DO SUL";277;13;21;311
2013;"SANTA TEREZINHA (SC)";"SC";"SANTA TEREZINHA";188;18;31;237
2013;"SANTA TEREZINHA DO PROGRESSO (SC)";"SC";"SANTA TEREZINHA DO PROGRESSO";50;5;13;68
2013;"SANTIAGO DO SUL (SC)";"SC";"SANTIAGO DO SUL";58;8;5;71
2013;"SANTO AMARO DA IMPERATRIZ (SC)";"SC";"SANTO AMARO DA IMPERATRIZ";653;36;68;757
2013;"SAO BENTO DO SUL (SC)";"SC";"SAO BENTO DO SUL";1632;130;167;1929
2013;"SAO BERNARDINO (SC)";"SC";"SAO BERNARDINO";44;5;20;69
2013;"SAO BONIFACIO (SC)";"SC";"SAO BONIFACIO";121;7;11;139
2013;"SAO CARLOS (SC)";"SC";"SAO CARLOS";218;23;48;289
2013;"SAO CRISTOVAO DO SUL (SC)";"SC";"SAO CRISTOVAO DO SUL";287;5;15;307
2013;"SAO DOMINGOS (SC)";"SC";"SAO DOMINGOS";318;26;44;388
2013;"SAO FRANCISCO DO SUL (SC)";"SC";"SAO FRANCISCO DO SUL";638;67;104;809
2013;"SAO JOAO BATISTA (SC)";"SC";"SAO JOAO BATISTA";587;30;46;663
2013;"SAO JOAO DO ITAPERIU (SC)";"SC";"SAO JOAO DO ITAPERIU";208;6;7;221
2013;"SAO JOAO DO OESTE (SC)";"SC";"SAO JOAO DO OESTE";165;10;18;193
2013;"SAO JOAO DO SUL (SC)";"SC";"SAO JOAO DO SUL";231;4;15;250
2013;"SAO JOAQUIM (SC)";"SC";"SAO JOAQUIM";897;92;182;1171
2013;"SAO JOSE (SC)";"SC";"SAO JOSE";3752;266;225;4243
2013;"SAO JOSE DO CEDRO (SC)";"SC";"SAO JOSE DO CEDRO";421;19;67;507
2013;"SAO JOSE DO CERRITO (SC)";"SC";"SAO JOSE DO CERRITO";196;10;49;255
2013;"SAO LOURENCO D OESTE (SC)";"SC";"SAO LOURENCO D OESTE";815;56;72;943
2013;"SAO LUDGERO (SC)";"SC";"SAO LUDGERO";551;14;27;592
2013;"SAO MARTINHO (SC)";"SC";"SAO MARTINHO";155;7;8;170
2013;"SAO MIGUEL D OESTE (SC)";"SC";"SAO MIGUEL D OESTE";1051;66;97;1214
2013;"SAO MIGUEL DA BOA VISTA (SC)";"SC";"SAO MIGUEL DA BOA VISTA";21;2;12;35
2013;"SAO PEDRO DE ALCANTARA (SC)";"SC";"SAO PEDRO DE ALCANTARA";135;6;5;146
2013;"SAUDADES (SC)";"SC";"SAUDADES";224;7;28;259
2013;"SCHROEDER (SC)";"SC";"SCHROEDER";216;7;18;241
2013;"SEARA (SC)";"SC";"SEARA";386;49;73;508
2013;"SERRA ALTA (SC)";"SC";"SERRA ALTA";67;8;16;91
2013;"SIDEROPOLIS (SC)";"SC";"SIDEROPOLIS";420;29;72;521
2013;"SOMBRIO (SC)";"SC";"SOMBRIO";705;61;57;823
2013;"SUL BRASIL (SC)";"SC";"SUL BRASIL";55;4;14;73
2013;"TAIO (SC)";"SC";"TAIO";585;26;56;667
2013;"TANGARA (SC)";"SC";"TANGARA";414;14;46;474
2013;"TIGRINHOS (SC)";"SC";"TIGRINHOS";32;2;15;49
2013;"TIJUCAS (SC)";"SC";"TIJUCAS";936;47;48;1031
2013;"TIMBE DO SUL (SC)";"SC";"TIMBE DO SUL";157;15;16;188
2013;"TIMBO (SC)";"SC";"TIMBO";679;47;47;773
2013;"TIMBO GRANDE (SC)";"SC";"TIMBO GRANDE";168;9;22;199
2013;"TRES BARRAS (SC)";"SC";"TRES BARRAS";297;28;60;385
2013;"TREVISO (SC)";"SC";"TREVISO";119;9;6;134
2013;"TREZE DE MAIO (SC)";"SC";"TREZE DE MAIO";403;10;22;435
2013;"TREZE TILIAS (SC)";"SC";"TREZE TILIAS";317;15;33;365
2013;"TROMBUDO CENTRAL (SC)";"SC";"TROMBUDO CENTRAL";215;19;22;256
2013;"TUBARAO (SC)";"SC";"TUBARAO";2400;90;377;2867
2013;"TUNAPOLIS (SC)";"SC";"TUNAPOLIS";99;11;19;129
2013;"TURVO (SC)";"SC";"TURVO";459;19;49;527
2013;"UNIAO DO OESTE (SC)";"SC";"UNIAO DO OESTE";47;2;19;68
2013;"URUBICI (SC)";"SC";"URUBICI";264;16;54;334
2013;"URUPEMA (SC)";"SC";"URUPEMA";76;10;12;98
2013;"URUSSANGA (SC)";"SC";"URUSSANGA";467;38;85;590
2013;"VARGEAO (SC)";"SC";"VARGEAO";135;3;12;150
2013;"VARGEM (SC)";"SC";"VARGEM";67;4;14;85
2013;"VARGEM BONITA (SC)";"SC";"VARGEM BONITA";148;15;23;186
2013;"VIDAL RAMOS (SC)";"SC";"VIDAL RAMOS";172;18;17;207
2013;"VIDEIRA (SC)";"SC";"VIDEIRA";1670;118;147;1935
2013;"VITOR MEIRELES (SC)";"SC";"VITOR MEIRELES";98;19;18;135
2013;"WITMARSUM (SC)";"SC";"WITMARSUM";118;11;16;145
2013;"XANXERE (SC)";"SC";"XANXERE";1293;122;122;1537
2013;"XAVANTINA (SC)";"SC";"XAVANTINA";152;17;5;174
2013;"XAXIM (SC)";"SC";"XAXIM";685;52;135;872
2013;"ZORTEA (SC)";"SC";"ZORTEA";39;9;5;53
2013;"AMPARO DE SAO FRANCISCO (SE)";"SE";"AMPARO DE SAO FRANCISCO";7;10;4;21
2013;"AQUIDABA (SE)";"SE";"AQUIDABA";121;15;54;190
2013;"ARACAJU (SE)";"SE";"ARACAJU";5731;1048;2301;9080
2013;"ARAUA (SE)";"SE";"ARAUA";52;18;19;89
2013;"AREIA BRANCA (SE)";"SE";"AREIA BRANCA";142;12;20;174
2013;"BARRA DOS COQUEIROS (SE)";"SE";"BARRA DOS COQUEIROS";77;25;20;122
2013;"BOQUIM (SE)";"SE";"BOQUIM";201;17;29;247
2013;"BREJO GRANDE (SE)";"SE";"BREJO GRANDE";6;5;8;19
2013;"CAMPO DO BRITO (SE)";"SE";"CAMPO DO BRITO";326;19;74;419
2013;"CANHOBA (SE)";"SE";"CANHOBA";6;4;6;16
2013;"CANINDE DE SAO FRANCISCO (SE)";"SE";"CANINDE DE SAO FRANCISCO";191;77;28;296
2013;"CAPELA (SE)";"SE";"CAPELA";135;35;65;235
2013;"CARIRA (SE)";"SE";"CARIRA";246;34;104;384
2013;"CARMOPOLIS (SE)";"SE";"CARMOPOLIS";100;36;77;213
2013;"CEDRO DE SAO JOAO (SE)";"SE";"CEDRO DE SAO JOAO";20;5;4;29
2013;"CRISTINAPOLIS (SE)";"SE";"CRISTINAPOLIS";70;18;31;119
2013;"CUMBE (SE)";"SE";"CUMBE";35;8;18;61
2013;"DIVINA PASTORA (SE)";"SE";"DIVINA PASTORA";7;5;9;21
2013;"ESTANCIA (SE)";"SE";"ESTANCIA";494;166;242;902
2013;"FEIRA NOVA (SE)";"SE";"FEIRA NOVA";15;10;6;31
2013;"FREI PAULO (SE)";"SE";"FREI PAULO";118;21;36;175
2013;"GARARU (SE)";"SE";"GARARU";42;12;27;81
2013;"GENERAL MAYNARD (SE)";"SE";"GENERAL MAYNARD";9;10;12;31
2013;"GRACCHO CARDOSO (SE)";"SE";"GRACCHO CARDOSO";20;9;6;35
2013;"ILHA DAS FLORES (SE)";"SE";"ILHA DAS FLORES";13;8;9;30
2013;"INDIAROBA (SE)";"SE";"INDIAROBA";37;17;17;71
2013;"ITABAIANA (SE)";"SE";"ITABAIANA";2979;134;157;3270
2013;"ITABAIANINHA (SE)";"SE";"ITABAIANINHA";570;68;61;699
2013;"ITABI (SE)";"SE";"ITABI";19;4;8;31
2013;"ITAPORANGA D AJUDA (SE)";"SE";"ITAPORANGA D AJUDA";265;38;61;364
2013;"JAPARATUBA (SE)";"SE";"JAPARATUBA";46;25;55;126
2013;"JAPOATA (SE)";"SE";"JAPOATA";46;9;30;85
2013;"LAGARTO (SE)";"SE";"LAGARTO";997;138;193;1328
2013;"LARANJEIRAS (SE)";"SE";"LARANJEIRAS";116;48;38;202
2013;"MACAMBIRA (SE)";"SE";"MACAMBIRA";46;5;18;69
2013;"MALHADA DOS BOIS (SE)";"SE";"MALHADA DOS BOIS";10;6;6;22
2013;"MALHADOR (SE)";"SE";"MALHADOR";208;23;48;279
2013;"MARUIM (SE)";"SE";"MARUIM";50;26;38;114
2013;"MOITA BONITA (SE)";"SE";"MOITA BONITA";436;17;16;469
2013;"MONTE ALEGRE DE SERGIPE (SE)";"SE";"MONTE ALEGRE DE SERGIPE";142;25;28;195
2013;"MURIBECA (SE)";"SE";"MURIBECA";66;6;26;98
2013;"NEOPOLIS (SE)";"SE";"NEOPOLIS";47;18;22;87
2013;"NOSSA SENHORA APARECIDA (SE)";"SE";"NOSSA SENHORA APARECIDA";129;23;17;169
2013;"NOSSA SENHORA DA GLORIA (SE)";"SE";"NOSSA SENHORA DA GLORIA";444;49;127;620
2013;"NOSSA SENHORA DAS DORES (SE)";"SE";"NOSSA SENHORA DAS DORES";243;18;79;340
2013;"NOSSA SENHORA DE LOURDES (SE)";"SE";"NOSSA SENHORA DE LOURDES";25;3;9;37
2013;"NOSSA SENHORA DO SOCORRO (SE)";"SE";"NOSSA SENHORA DO SOCORRO";781;120;164;1065
2013;"PACATUBA (SE)";"SE";"PACATUBA";420;7;42;469
2013;"PEDRA MOLE (SE)";"SE";"PEDRA MOLE";5;4;4;13
2013;"PEDRINHAS (SE)";"SE";"PEDRINHAS";56;4;10;70
2013;"PINHAO (SE)";"SE";"PINHAO";32;15;6;53
2013;"PIRAMBU (SE)";"SE";"PIRAMBU";22;4;17;43
2013;"POCO REDONDO (SE)";"SE";"POCO REDONDO";161;46;61;268
2013;"POCO VERDE (SE)";"SE";"POCO VERDE";99;61;156;316
2013;"PORTO DA FOLHA (SE)";"SE";"PORTO DA FOLHA";119;32;32;183
2013;"PROPRIA (SE)";"SE";"PROPRIA";238;32;54;324
2013;"RIACHAO DO DANTAS (SE)";"SE";"RIACHAO DO DANTAS";29;6;18;53
2013;"RIACHUELO (SE)";"SE";"RIACHUELO";39;15;12;66
2013;"RIBEIROPOLIS (SE)";"SE";"RIBEIROPOLIS";275;39;57;371
2013;"ROSARIO DO CATETE (SE)";"SE";"ROSARIO DO CATETE";30;20;15;65
2013;"SALGADO (SE)";"SE";"SALGADO";119;18;110;247
2013;"SANTA LUZIA DO ITANHY (SE)";"SE";"SANTA LUZIA DO ITANHY";18;12;14;44
2013;"SANTA ROSA DE LIMA (SE)";"SE";"SANTA ROSA DE LIMA";19;4;8;31
2013;"SANTANA DO SAO FRANCISCO (SE)";"SE";"SANTANA DO SAO FRANCISCO";11;3;9;23
2013;"SANTO AMARO DAS BROTAS (SE)";"SE";"SANTO AMARO DAS BROTAS";21;7;17;45
2013;"SAO CRISTOVAO (SE)";"SE";"SAO CRISTOVAO";381;98;160;639
2013;"SAO DOMINGOS (SE)";"SE";"SAO DOMINGOS";125;9;26;160
2013;"SAO FRANCISCO (SE)";"SE";"SAO FRANCISCO";15;3;25;43
2013;"SAO MIGUEL DO ALEIXO (SE)";"SE";"SAO MIGUEL DO ALEIXO";40;5;6;51
2013;"SIMAO DIAS (SE)";"SE";"SIMAO DIAS";249;49;222;520
2013;"SIRIRI (SE)";"SE";"SIRIRI";30;9;39;78
2013;"TELHA (SE)";"SE";"TELHA";11;7;4;22
2013;"TOBIAS BARRETO (SE)";"SE";"TOBIAS BARRETO";279;67;168;514
2013;"TOMAR DO GERU (SE)";"SE";"TOMAR DO GERU";46;6;22;74
2013;"UMBAUBA (SE)";"SE";"UMBAUBA";281;33;44;358
2013;"ADAMANTINA (SP)";"SP";"ADAMANTINA";690;57;73;820
2013;"ADOLFO (SP)";"SP";"ADOLFO";78;3;27;108
2013;"AGUAI (SP)";"SP";"AGUAI";846;76;162;1084
2013;"AGUAS DA PRATA (SP)";"SP";"AGUAS DA PRATA";110;17;12;139
2013;"AGUAS DE LINDOIA (SP)";"SP";"AGUAS DE LINDOIA";189;80;64;333
2013;"AGUAS DE SANTA BARBARA (SP)";"SP";"AGUAS DE SANTA BARBARA";104;26;26;156
2013;"AGUAS DE SAO PEDRO (SP)";"SP";"AGUAS DE SAO PEDRO";41;5;4;50
2013;"AGUDOS (SP)";"SP";"AGUDOS";572;107;96;775
2013;"ALAMBARI (SP)";"SP";"ALAMBARI";101;15;6;122
2013;"ALFREDO MARCONDES (SP)";"SP";"ALFREDO MARCONDES";67;9;7;83
2013;"ALTAIR (SP)";"SP";"ALTAIR";64;5;35;104
2013;"ALTINOPOLIS (SP)";"SP";"ALTINOPOLIS";351;51;111;513
2013;"ALTO ALEGRE (SP)";"SP";"ALTO ALEGRE";102;5;47;154
2013;"ALUMINIO (SP)";"SP";"ALUMINIO";228;37;27;292
2013;"ALVARES FLORENCE (SP)";"SP";"ALVARES FLORENCE";52;6;15;73
2013;"ALVARES MACHADO (SP)";"SP";"ALVARES MACHADO";423;33;34;490
2013;"ALVARO DE CARVALHO (SP)";"SP";"ALVARO DE CARVALHO";19;5;25;49
2013;"ALVINLANDIA (SP)";"SP";"ALVINLANDIA";43;4;20;67
2013;"AMERICANA (SP)";"SP";"AMERICANA";3616;582;711;4909
2013;"AMERICO BRASILIENSE (SP)";"SP";"AMERICO BRASILIENSE";670;59;221;950
2013;"AMERICO DE CAMPOS (SP)";"SP";"AMERICO DE CAMPOS";126;9;28;163
2013;"AMPARO (SP)";"SP";"AMPARO";1354;226;129;1709
2013;"ANALANDIA (SP)";"SP";"ANALANDIA";82;14;12;108
2013;"ANDRADINA (SP)";"SP";"ANDRADINA";1245;82;129;1456
2013;"ANGATUBA (SP)";"SP";"ANGATUBA";387;56;103;546
2013;"ANHEMBI (SP)";"SP";"ANHEMBI";81;21;18;120
2013;"ANHUMAS (SP)";"SP";"ANHUMAS";76;7;7;90
2013;"APARECIDA (SP)";"SP";"APARECIDA";841;77;543;1461
2013;"APARECIDA D OESTE (SP)";"SP";"APARECIDA D OESTE";103;12;26;141
2013;"APIAI (SP)";"SP";"APIAI";359;47;67;473
2013;"ARACARIGUAMA (SP)";"SP";"ARACARIGUAMA";633;76;49;758
2013;"ARACATUBA (SP)";"SP";"ARACATUBA";3617;282;747;4646
2013;"ARACOIABA DA SERRA (SP)";"SP";"ARACOIABA DA SERRA";511;113;24;648
2013;"ARAMINA (SP)";"SP";"ARAMINA";51;7;24;82
2013;"ARANDU (SP)";"SP";"ARANDU";56;10;24;90
2013;"ARAPEI (SP)";"SP";"ARAPEI";33;9;13;55
2013;"ARARAQUARA (SP)";"SP";"ARARAQUARA";3640;412;1072;5124
2013;"ARARAS (SP)";"SP";"ARARAS";2323;270;327;2920
2013;"ARCO IRIS (SP)";"SP";"ARCO IRIS";67;3;8;78
2013;"AREALVA (SP)";"SP";"AREALVA";170;7;30;207
2013;"AREIAS (SP)";"SP";"AREIAS";44;7;5;56
2013;"AREIOPOLIS (SP)";"SP";"AREIOPOLIS";118;27;103;248
2013;"ARIRANHA (SP)";"SP";"ARIRANHA";295;27;156;478
2013;"ARTUR NOGUEIRA (SP)";"SP";"ARTUR NOGUEIRA";1024;96;143;1263
2013;"ARUJA (SP)";"SP";"ARUJA";2991;346;358;3695
2013;"ASPASIA (SP)";"SP";"ASPASIA";29;6;4;39
2013;"ASSIS (SP)";"SP";"ASSIS";1837;203;354;2394
2013;"ATIBAIA (SP)";"SP";"ATIBAIA";2517;356;359;3232
2013;"AURIFLAMA (SP)";"SP";"AURIFLAMA";344;30;45;419
2013;"AVAI (SP)";"SP";"AVAI";71;10;18;99
2013;"AVANHANDAVA (SP)";"SP";"AVANHANDAVA";144;9;47;200
2013;"AVARE (SP)";"SP";"AVARE";1298;163;270;1731
2013;"BADY BASSITT (SP)";"SP";"BADY BASSITT";415;48;59;522
2013;"BALBINOS (SP)";"SP";"BALBINOS";21;3;8;32
2013;"BALSAMO (SP)";"SP";"BALSAMO";205;8;26;239
2013;"BANANAL (SP)";"SP";"BANANAL";129;20;32;181
2013;"BARAO DE ANTONINA (SP)";"SP";"BARAO DE ANTONINA";18;3;15;36
2013;"BARBOSA (SP)";"SP";"BARBOSA";126;5;39;170
2013;"BARIRI (SP)";"SP";"BARIRI";806;67;94;967
2013;"BARRA BONITA (SP)";"SP";"BARRA BONITA";1163;93;244;1500
2013;"BARRA DO CHAPEU (SP)";"SP";"BARRA DO CHAPEU";41;4;15;60
2013;"BARRA DO TURVO (SP)";"SP";"BARRA DO TURVO";62;18;43;123
2013;"BARRETOS (SP)";"SP";"BARRETOS";2019;227;538;2784
2013;"BARRINHA (SP)";"SP";"BARRINHA";483;33;174;690
2013;"BARUERI (SP)";"SP";"BARUERI";6411;745;1211;8367
2013;"BASTOS (SP)";"SP";"BASTOS";777;24;82;883
2013;"BATATAIS (SP)";"SP";"BATATAIS";1113;135;169;1417
2013;"BAURU (SP)";"SP";"BAURU";5666;478;1160;7304
2013;"BEBEDOURO (SP)";"SP";"BEBEDOURO";1657;143;276;2076
2013;"BENTO DE ABREU (SP)";"SP";"BENTO DE ABREU";70;11;12;93
2013;"BERNARDINO DE CAMPOS (SP)";"SP";"BERNARDINO DE CAMPOS";326;29;40;395
2013;"BERTIOGA (SP)";"SP";"BERTIOGA";517;60;104;681
2013;"BILAC (SP)";"SP";"BILAC";169;12;23;204
2013;"BIRIGUI (SP)";"SP";"BIRIGUI";1768;102;187;2057
2013;"BIRITIBA MIRIM (SP)";"SP";"BIRITIBA MIRIM";409;30;22;461
2013;"BOA ESPERANCA DO SUL (SP)";"SP";"BOA ESPERANCA DO SUL";347;35;100;482
2013;"BOCAINA (SP)";"SP";"BOCAINA";222;41;36;299
2013;"BOFETE (SP)";"SP";"BOFETE";213;46;50;309
2013;"BOITUVA (SP)";"SP";"BOITUVA";1225;153;149;1527
2013;"BOM JESUS DOS PERDOES (SP)";"SP";"BOM JESUS DOS PERDOES";540;86;74;700
2013;"BOM SUCESSO DE ITARARE (SP)";"SP";"BOM SUCESSO DE ITARARE";70;11;13;94
2013;"BORA (SP)";"SP";"BORA";45;1;6;52
2013;"BORACEIA (SP)";"SP";"BORACEIA";217;11;20;248
2013;"BORBOREMA (SP)";"SP";"BORBOREMA";343;25;77;445
2013;"BOREBI (SP)";"SP";"BOREBI";54;9;8;71
2013;"BOTUCATU (SP)";"SP";"BOTUCATU";1760;296;548;2604
2013;"BRAGANCA PAULISTA (SP)";"SP";"BRAGANCA PAULISTA";2759;383;372;3514
2013;"BRAUNA (SP)";"SP";"BRAUNA";74;7;89;170
2013;"BREJO ALEGRE (SP)";"SP";"BREJO ALEGRE";161;1;18;180
2013;"BRODOWSKI (SP)";"SP";"BRODOWSKI";575;32;38;645
2013;"BROTAS (SP)";"SP";"BROTAS";519;61;185;765
2013;"BURI (SP)";"SP";"BURI";429;32;69;530
2013;"BURITAMA (SP)";"SP";"BURITAMA";345;25;61;431
2013;"BURITIZAL (SP)";"SP";"BURITIZAL";112;16;31;159
2013;"CABRALIA PAULISTA (SP)";"SP";"CABRALIA PAULISTA";131;7;13;151
2013;"CABREUVA (SP)";"SP";"CABREUVA";975;132;71;1178
2013;"CACAPAVA (SP)";"SP";"CACAPAVA";1124;315;176;1615
2013;"CACHOEIRA PAULISTA (SP)";"SP";"CACHOEIRA PAULISTA";382;92;26;500
2013;"CACONDE (SP)";"SP";"CACONDE";237;48;79;364
2013;"CAFELANDIA (SP)";"SP";"CAFELANDIA";291;16;77;384
2013;"CAIABU (SP)";"SP";"CAIABU";41;9;42;92
2013;"CAIEIRAS (SP)";"SP";"CAIEIRAS";1220;258;500;1978
2013;"CAIUA (SP)";"SP";"CAIUA";59;10;21;90
2013;"CAJAMAR (SP)";"SP";"CAJAMAR";1591;213;304;2108
2013;"CAJATI (SP)";"SP";"CAJATI";567;81;85;733
2013;"CAJOBI (SP)";"SP";"CAJOBI";247;7;84;338
2013;"CAJURU (SP)";"SP";"CAJURU";478;26;98;602
2013;"CAMPINA DO MONTE ALEGRE (SP)";"SP";"CAMPINA DO MONTE ALEGRE";70;16;27;113
2013;"CAMPINAS (SP)";"SP";"CAMPINAS";21150;3848;5252;30250
2013;"CAMPO LIMPO PAULISTA (SP)";"SP";"CAMPO LIMPO PAULISTA";628;111;31;770
2013;"CAMPOS DO JORDAO (SP)";"SP";"CAMPOS DO JORDAO";601;168;66;835
2013;"CAMPOS NOVOS PAULISTA (SP)";"SP";"CAMPOS NOVOS PAULISTA";83;6;28;117
2013;"CANANEIA (SP)";"SP";"CANANEIA";98;10;14;122
2013;"CANAS (SP)";"SP";"CANAS";112;8;9;129
2013;"CANDIDO MOTA (SP)";"SP";"CANDIDO MOTA";876;50;62;988
2013;"CANDIDO RODRIGUES (SP)";"SP";"CANDIDO RODRIGUES";114;9;10;133
2013;"CANITAR (SP)";"SP";"CANITAR";47;20;18;85
2013;"CAPAO BONITO (SP)";"SP";"CAPAO BONITO";926;114;190;1230
2013;"CAPELA DO ALTO (SP)";"SP";"CAPELA DO ALTO";491;59;33;583
2013;"CAPIVARI (SP)";"SP";"CAPIVARI";1196;108;233;1537
2013;"CARAGUATATUBA (SP)";"SP";"CARAGUATATUBA";1685;174;122;1981
2013;"CARAPICUIBA (SP)";"SP";"CARAPICUIBA";4040;850;930;5820
2013;"CARDOSO (SP)";"SP";"CARDOSO";177;18;48;243
2013;"CASA BRANCA (SP)";"SP";"CASA BRANCA";582;68;91;741
2013;"CASSIA DOS COQUEIROS (SP)";"SP";"CASSIA DOS COQUEIROS";23;6;13;42
2013;"CASTILHO (SP)";"SP";"CASTILHO";248;39;107;394
2013;"CATANDUVA (SP)";"SP";"CATANDUVA";3040;250;508;3798
2013;"CATIGUA (SP)";"SP";"CATIGUA";95;13;28;136
2013;"CEDRAL (SP)";"SP";"CEDRAL";231;19;17;267
2013;"CERQUEIRA CESAR (SP)";"SP";"CERQUEIRA CESAR";356;50;132;538
2013;"CERQUILHO (SP)";"SP";"CERQUILHO";885;109;94;1088
2013;"CESARIO LANGE (SP)";"SP";"CESARIO LANGE";395;59;48;502
2013;"CHARQUEADA (SP)";"SP";"CHARQUEADA";441;37;94;572
2013;"CHAVANTES (SP)";"SP";"CHAVANTES";142;33;52;227
2013;"CLEMENTINA (SP)";"SP";"CLEMENTINA";246;14;62;322
2013;"COLINA (SP)";"SP";"COLINA";403;35;80;518
2013;"COLOMBIA (SP)";"SP";"COLOMBIA";120;33;67;220
2013;"CONCHAL (SP)";"SP";"CONCHAL";773;52;246;1071
2013;"CONCHAS (SP)";"SP";"CONCHAS";363;39;41;443
2013;"CORDEIROPOLIS (SP)";"SP";"CORDEIROPOLIS";715;73;37;825
2013;"COROADOS (SP)";"SP";"COROADOS";83;4;20;107
2013;"CORONEL MACEDO (SP)";"SP";"CORONEL MACEDO";54;10;23;87
2013;"CORUMBATAI (SP)";"SP";"CORUMBATAI";156;19;13;188
2013;"COSMOPOLIS (SP)";"SP";"COSMOPOLIS";864;274;306;1444
2013;"COSMORAMA (SP)";"SP";"COSMORAMA";217;13;41;271
2013;"COTIA (SP)";"SP";"COTIA";3315;977;770;5062
2013;"CRAVINHOS (SP)";"SP";"CRAVINHOS";979;46;189;1214
2013;"CRISTAIS PAULISTA (SP)";"SP";"CRISTAIS PAULISTA";120;10;26;156
2013;"CRUZALIA (SP)";"SP";"CRUZALIA";73;8;5;86
2013;"CRUZEIRO (SP)";"SP";"CRUZEIRO";748;133;40;921
2013;"CUBATAO (SP)";"SP";"CUBATAO";2915;397;433;3745
2013;"CUNHA (SP)";"SP";"CUNHA";276;52;35;363
2013;"DESCALVADO (SP)";"SP";"DESCALVADO";949;92;192;1233
2013;"DIADEMA (SP)";"SP";"DIADEMA";4550;804;612;5966
2013;"DIRCE REIS (SP)";"SP";"DIRCE REIS";62;6;7;75
2013;"DIVINOLANDIA (SP)";"SP";"DIVINOLANDIA";437;24;39;500
2013;"DOBRADA (SP)";"SP";"DOBRADA";63;12;79;154
2013;"DOIS CORREGOS (SP)";"SP";"DOIS CORREGOS";652;76;131;859
2013;"DOLCINOPOLIS (SP)";"SP";"DOLCINOPOLIS";31;3;7;41
2013;"DOURADO (SP)";"SP";"DOURADO";192;28;51;271
2013;"DRACENA (SP)";"SP";"DRACENA";1069;59;132;1260
2013;"DUARTINA (SP)";"SP";"DUARTINA";264;29;69;362
2013;"DUMONT (SP)";"SP";"DUMONT";303;8;54;365
2013;"ECHAPORA (SP)";"SP";"ECHAPORA";148;1;20;169
2013;"ELDORADO (SP)";"SP";"ELDORADO";240;20;55;315
2013;"ELIAS FAUSTO (SP)";"SP";"ELIAS FAUSTO";360;21;70;451
2013;"ELISIARIO (SP)";"SP";"ELISIARIO";55;5;8;68
2013;"EMBAUBA (SP)";"SP";"EMBAUBA";78;4;28;110
2013;"EMBU (SP)";"SP";"EMBU";2746;664;745;4155
2013;"EMBU GUACU (SP)";"SP";"EMBU GUACU";2426;248;299;2973
2013;"EMILIANOPOLIS (SP)";"SP";"EMILIANOPOLIS";52;3;14;69
2013;"ENGENHEIRO COELHO (SP)";"SP";"ENGENHEIRO COELHO";364;42;151;557
2013;"ESPIRITO SANTO DO PINHAL (SP)";"SP";"ESPIRITO SANTO DO PINHAL";640;114;88;842
2013;"ESPIRITO SANTO DO TURVO (SP)";"SP";"ESPIRITO SANTO DO TURVO";157;24;37;218
2013;"ESTIVA GERBI (SP)";"SP";"ESTIVA GERBI";277;20;27;324
2013;"ESTRELA D OESTE (SP)";"SP";"ESTRELA D OESTE";272;10;25;307
2013;"ESTRELA DO NORTE (SP)";"SP";"ESTRELA DO NORTE";21;3;8;32
2013;"EUCLIDES DA CUNHA PAULISTA (SP)";"SP";"EUCLIDES DA CUNHA PAULISTA";92;6;48;146
2013;"FARTURA (SP)";"SP";"FARTURA";272;22;41;335
2013;"FERNANDO PRESTES (SP)";"SP";"FERNANDO PRESTES";211;9;16;236
2013;"FERNANDOPOLIS (SP)";"SP";"FERNANDOPOLIS";1458;94;190;1742
2013;"FERNAO (SP)";"SP";"FERNAO";28;3;8;39
2013;"FERRAZ DE VASCONCELOS (SP)";"SP";"FERRAZ DE VASCONCELOS";2152;295;344;2791
2013;"FLORA RICA (SP)";"SP";"FLORA RICA";17;1;10;28
2013;"FLOREAL (SP)";"SP";"FLOREAL";59;11;7;77
2013;"FLORIDA PAULISTA (SP)";"SP";"FLORIDA PAULISTA";309;18;115;442
2013;"FLORINEA (SP)";"SP";"FLORINEA";46;6;7;59
2013;"FRANCA (SP)";"SP";"FRANCA";3374;384;611;4369
2013;"FRANCISCO MORATO (SP)";"SP";"FRANCISCO MORATO";599;210;219;1028
2013;"FRANCO DA ROCHA (SP)";"SP";"FRANCO DA ROCHA";920;230;183;1333
2013;"GABRIEL MONTEIRO (SP)";"SP";"GABRIEL MONTEIRO";59;1;12;72
2013;"GALIA (SP)";"SP";"GALIA";140;19;37;196
2013;"GARCA (SP)";"SP";"GARCA";752;71;113;936
2013;"GASTAO VIDIGAL (SP)";"SP";"GASTAO VIDIGAL";57;9;54;120
2013;"GAVIAO PEIXOTO (SP)";"SP";"GAVIAO PEIXOTO";51;13;22;86
2013;"GENERAL SALGADO (SP)";"SP";"GENERAL SALGADO";278;20;106;404
2013;"GETULINA (SP)";"SP";"GETULINA";138;5;66;209
2013;"GLICERIO (SP)";"SP";"GLICERIO";122;4;29;155
2013;"GUAICARA (SP)";"SP";"GUAICARA";117;10;27;154
2013;"GUAIMBE (SP)";"SP";"GUAIMBE";136;1;28;165
2013;"GUAIRA (SP)";"SP";"GUAIRA";1213;79;195;1487
2013;"GUAPIACU (SP)";"SP";"GUAPIACU";430;28;70;528
2013;"GUAPIARA (SP)";"SP";"GUAPIARA";322;41;51;414
2013;"GUARA (SP)";"SP";"GUARA";211;37;165;413
2013;"GUARACAI (SP)";"SP";"GUARACAI";301;27;35;363
2013;"GUARACI (SP)";"SP";"GUARACI";197;20;69;286
2013;"GUARANI D OESTE (SP)";"SP";"GUARANI D OESTE";24;3;5;32
2013;"GUARANTA (SP)";"SP";"GUARANTA";93;6;41;140
2013;"GUARARAPES (SP)";"SP";"GUARARAPES";706;52;134;892
2013;"GUARAREMA (SP)";"SP";"GUARAREMA";535;88;50;673
2013;"GUARATINGUETA (SP)";"SP";"GUARATINGUETA";1206;340;202;1748
2013;"GUAREI (SP)";"SP";"GUAREI";274;27;73;374
2013;"GUARIBA (SP)";"SP";"GUARIBA";875;63;285;1223
2013;"GUARUJA (SP)";"SP";"GUARUJA";2109;401;429;2939
2013;"GUARULHOS (SP)";"SP";"GUARULHOS";21977;4009;3881;29867
2013;"GUATAPARA (SP)";"SP";"GUATAPARA";192;16;49;257
2013;"GUZOLANDIA (SP)";"SP";"GUZOLANDIA";63;3;34;100
2013;"HERCULANDIA (SP)";"SP";"HERCULANDIA";451;5;24;480
2013;"HOLAMBRA (SP)";"SP";"HOLAMBRA";364;38;86;488
2013;"HORTOLANDIA (SP)";"SP";"HORTOLANDIA";1821;409;455;2685
2013;"IACANGA (SP)";"SP";"IACANGA";230;28;37;295
2013;"IACRI (SP)";"SP";"IACRI";131;3;19;153
2013;"IARAS (SP)";"SP";"IARAS";45;16;38;99
2013;"IBATE (SP)";"SP";"IBATE";600;129;206;935
2013;"IBIRA (SP)";"SP";"IBIRA";182;15;52;249
2013;"IBIRAREMA (SP)";"SP";"IBIRAREMA";152;14;26;192
2013;"IBITINGA (SP)";"SP";"IBITINGA";878;88;165;1131
2013;"IBIUNA (SP)";"SP";"IBIUNA";1996;197;125;2318
2013;"ICEM (SP)";"SP";"ICEM";191;8;63;262
2013;"IEPE (SP)";"SP";"IEPE";168;12;26;206
2013;"IGARACU DO TIETE (SP)";"SP";"IGARACU DO TIETE";331;33;86;450
2013;"IGARAPAVA (SP)";"SP";"IGARAPAVA";386;53;112;551
2013;"IGARATA (SP)";"SP";"IGARATA";153;29;13;195
2013;"IGUAPE (SP)";"SP";"IGUAPE";232;56;49;337
2013;"ILHA COMPRIDA (SP)";"SP";"ILHA COMPRIDA";165;22;68;255
2013;"ILHA SOLTEIRA (SP)";"SP";"ILHA SOLTEIRA";260;34;94;388
2013;"ILHABELA (SP)";"SP";"ILHABELA";340;70;54;464
2013;"INDAIATUBA (SP)";"SP";"INDAIATUBA";3180;591;258;4029
2013;"INDIANA (SP)";"SP";"INDIANA";123;9;13;145
2013;"INDIAPORA (SP)";"SP";"INDIAPORA";61;5;21;87
2013;"INUBIA PAULISTA (SP)";"SP";"INUBIA PAULISTA";60;7;11;78
2013;"IPAUSSU (SP)";"SP";"IPAUSSU";204;26;52;282
2013;"IPERO (SP)";"SP";"IPERO";253;35;30;318
2013;"IPEUNA (SP)";"SP";"IPEUNA";187;30;32;249
2013;"IPIGUA (SP)";"SP";"IPIGUA";35;2;9;46
2013;"IPORANGA (SP)";"SP";"IPORANGA";28;11;9;48
2013;"IPUA (SP)";"SP";"IPUA";274;24;85;383
2013;"IRACEMAPOLIS (SP)";"SP";"IRACEMAPOLIS";548;50;114;712
2013;"IRAPUA (SP)";"SP";"IRAPUA";132;7;81;220
2013;"IRAPURU (SP)";"SP";"IRAPURU";107;15;25;147
2013;"ITABERA (SP)";"SP";"ITABERA";272;42;35;349
2013;"ITAI (SP)";"SP";"ITAI";516;74;164;754
2013;"ITAJOBI (SP)";"SP";"ITAJOBI";499;15;45;559
2013;"ITAJU (SP)";"SP";"ITAJU";74;3;19;96
2013;"ITANHAEM (SP)";"SP";"ITANHAEM";838;219;114;1171
2013;"ITAOCA (SP)";"SP";"ITAOCA";26;8;9;43
2013;"ITAPECERICA DA SERRA (SP)";"SP";"ITAPECERICA DA SERRA";2799;677;741;4217
2013;"ITAPETININGA (SP)";"SP";"ITAPETININGA";2739;422;457;3618
2013;"ITAPEVA (SP)";"SP";"ITAPEVA";1874;314;392;2580
2013;"ITAPEVI (SP)";"SP";"ITAPEVI";1903;347;172;2422
2013;"ITAPIRA (SP)";"SP";"ITAPIRA";1656;128;211;1995
2013;"ITAPIRAPUA PAULISTA (SP)";"SP";"ITAPIRAPUA PAULISTA";40;15;13;68
2013;"ITAPOLIS (SP)";"SP";"ITAPOLIS";1246;108;193;1547
2013;"ITAPORANGA (SP)";"SP";"ITAPORANGA";233;22;76;331
2013;"ITAPUI (SP)";"SP";"ITAPUI";363;39;71;473
2013;"ITAPURA (SP)";"SP";"ITAPURA";31;7;14;52
2013;"ITAQUAQUECETUBA (SP)";"SP";"ITAQUAQUECETUBA";3836;448;492;4776
2013;"ITARARE (SP)";"SP";"ITARARE";942;97;271;1310
2013;"ITARIRI (SP)";"SP";"ITARIRI";334;29;22;385
2013;"ITATIBA (SP)";"SP";"ITATIBA";2637;265;382;3284
2013;"ITATINGA (SP)";"SP";"ITATINGA";216;39;101;356
2013;"ITIRAPINA (SP)";"SP";"ITIRAPINA";291;43;57;391
2013;"ITIRAPUA (SP)";"SP";"ITIRAPUA";82;7;19;108
2013;"ITOBI (SP)";"SP";"ITOBI";149;20;76;245
2013;"ITU (SP)";"SP";"ITU";3070;439;645;4154
2013;"ITUPEVA (SP)";"SP";"ITUPEVA";1125;121;114;1360
2013;"ITUVERAVA (SP)";"SP";"ITUVERAVA";643;48;125;816
2013;"JABORANDI (SP)";"SP";"JABORANDI";177;11;45;233
2013;"JABOTICABAL (SP)";"SP";"JABOTICABAL";1882;122;249;2253
2013;"JACAREI (SP)";"SP";"JACAREI";2699;605;362;3666
2013;"JACI (SP)";"SP";"JACI";195;13;28;236
2013;"JACUPIRANGA (SP)";"SP";"JACUPIRANGA";396;47;397;840
2013;"JAGUARIUNA (SP)";"SP";"JAGUARIUNA";1085;96;187;1368
2013;"JALES (SP)";"SP";"JALES";1220;48;74;1342
2013;"JAMBEIRO (SP)";"SP";"JAMBEIRO";114;42;16;172
2013;"JANDIRA (SP)";"SP";"JANDIRA";1196;293;174;1663
2013;"JARDINOPOLIS (SP)";"SP";"JARDINOPOLIS";931;106;125;1162
2013;"JARINU (SP)";"SP";"JARINU";626;60;45;731
2013;"JAU (SP)";"SP";"JAU";2494;301;446;3241
2013;"JERIQUARA (SP)";"SP";"JERIQUARA";50;5;19;74
2013;"JOANOPOLIS (SP)";"SP";"JOANOPOLIS";379;22;18;419
2013;"JOAO RAMALHO (SP)";"SP";"JOAO RAMALHO";31;9;19;59
2013;"JOSE BONIFACIO (SP)";"SP";"JOSE BONIFACIO";853;61;102;1016
2013;"JULIO MESQUITA (SP)";"SP";"JULIO MESQUITA";40;8;31;79
2013;"JUMIRIM (SP)";"SP";"JUMIRIM";103;12;6;121
2013;"JUNDIAI (SP)";"SP";"JUNDIAI";8124;848;1159;10131
2013;"JUNQUEIROPOLIS (SP)";"SP";"JUNQUEIROPOLIS";459;32;197;688
2013;"JUQUIA (SP)";"SP";"JUQUIA";413;32;21;466
2013;"JUQUITIBA (SP)";"SP";"JUQUITIBA";665;94;107;866
2013;"LAGOINHA (SP)";"SP";"LAGOINHA";137;23;20;180
2013;"LARANJAL PAULISTA (SP)";"SP";"LARANJAL PAULISTA";667;52;189;908
2013;"LAVINIA (SP)";"SP";"LAVINIA";72;6;13;91
2013;"LAVRINHAS (SP)";"SP";"LAVRINHAS";87;21;12;120
2013;"LEME (SP)";"SP";"LEME";2531;177;526;3234
2013;"LENCOIS PAULISTA (SP)";"SP";"LENCOIS PAULISTA";1421;177;311;1909
2013;"LIMEIRA (SP)";"SP";"LIMEIRA";4920;878;634;6432
2013;"LINDOIA (SP)";"SP";"LINDOIA";160;24;20;204
2013;"LINS (SP)";"SP";"LINS";1556;120;170;1846
2013;"LORENA (SP)";"SP";"LORENA";905;188;37;1130
2013;"LOURDES (SP)";"SP";"LOURDES";27;5;15;47
2013;"LOUVEIRA (SP)";"SP";"LOUVEIRA";934;146;53;1133
2013;"LUCELIA (SP)";"SP";"LUCELIA";398;34;190;622
2013;"LUCIANOPOLIS (SP)";"SP";"LUCIANOPOLIS";47;9;15;71
2013;"LUIS ANTONIO (SP)";"SP";"LUIS ANTONIO";287;30;159;476
2013;"LUIZIANIA (SP)";"SP";"LUIZIANIA";64;3;25;92
2013;"LUPERCIO (SP)";"SP";"LUPERCIO";54;5;30;89
2013;"LUTECIA (SP)";"SP";"LUTECIA";41;7;10;58
2013;"MACATUBA (SP)";"SP";"MACATUBA";453;31;79;563
2013;"MACAUBAL (SP)";"SP";"MACAUBAL";142;18;24;184
2013;"MACEDONIA (SP)";"SP";"MACEDONIA";47;4;12;63
2013;"MAGDA (SP)";"SP";"MAGDA";105;14;10;129
2013;"MAIRINQUE (SP)";"SP";"MAIRINQUE";606;97;113;816
2013;"MAIRIPORA (SP)";"SP";"MAIRIPORA";2149;306;154;2609
2013;"MANDURI (SP)";"SP";"MANDURI";221;41;76;338
2013;"MARABA PAULISTA (SP)";"SP";"MARABA PAULISTA";34;4;18;56
2013;"MARACAI (SP)";"SP";"MARACAI";319;71;52;442
2013;"MARAPOAMA (SP)";"SP";"MARAPOAMA";140;11;9;160
2013;"MARIAPOLIS (SP)";"SP";"MARIAPOLIS";41;3;26;70
2013;"MARILIA (SP)";"SP";"MARILIA";3228;308;563;4099
2013;"MARINOPOLIS (SP)";"SP";"MARINOPOLIS";78;8;8;94
2013;"MARTINOPOLIS (SP)";"SP";"MARTINOPOLIS";429;43;103;575
2013;"MATAO (SP)";"SP";"MATAO";1604;95;360;2059
2013;"MAUA (SP)";"SP";"MAUA";3765;1089;1208;6062
2013;"MENDONCA (SP)";"SP";"MENDONCA";102;4;26;132
2013;"MERIDIANO (SP)";"SP";"MERIDIANO";160;12;20;192
2013;"MESOPOLIS (SP)";"SP";"MESOPOLIS";13;3;13;29
2013;"MIGUELOPOLIS (SP)";"SP";"MIGUELOPOLIS";319;14;101;434
2013;"MINEIROS DO TIETE (SP)";"SP";"MINEIROS DO TIETE";251;15;43;309
2013;"MIRA ESTRELA (SP)";"SP";"MIRA ESTRELA";38;5;27;70
2013;"MIRACATU (SP)";"SP";"MIRACATU";631;79;37;747
2013;"MIRANDOPOLIS (SP)";"SP";"MIRANDOPOLIS";553;51;158;762
2013;"MIRANTE DO PARANAPANEMA (SP)";"SP";"MIRANTE DO PARANAPANEMA";259;54;80;393
2013;"MIRASSOL (SP)";"SP";"MIRASSOL";1277;52;70;1399
2013;"MIRASSOLANDIA (SP)";"SP";"MIRASSOLANDIA";50;11;10;71
2013;"MOCOCA (SP)";"SP";"MOCOCA";1173;130;327;1630
2013;"MOGI DAS CRUZES (SP)";"SP";"MOGI DAS CRUZES";6234;923;1544;8701
2013;"MOGI GUACU (SP)";"SP";"MOGI GUACU";2469;439;489;3397
2013;"MOGI MIRIM (SP)";"SP";"MOGI MIRIM";1950;204;484;2638
2013;"MOMBUCA (SP)";"SP";"MOMBUCA";89;6;19;114
2013;"MONCOES (SP)";"SP";"MONCOES";74;12;12;98
2013;"MONGAGUA (SP)";"SP";"MONGAGUA";572;98;56;726
2013;"MONTE ALEGRE DO SUL (SP)";"SP";"MONTE ALEGRE DO SUL";225;42;36;303
2013;"MONTE ALTO (SP)";"SP";"MONTE ALTO";1451;77;117;1645
2013;"MONTE APRAZIVEL (SP)";"SP";"MONTE APRAZIVEL";593;49;198;840
2013;"MONTE AZUL PAULISTA (SP)";"SP";"MONTE AZUL PAULISTA";479;38;140;657
2013;"MONTE CASTELO (SP)";"SP";"MONTE CASTELO";77;6;13;96
2013;"MONTE MOR (SP)";"SP";"MONTE MOR";709;87;128;924
2013;"MONTEIRO LOBATO (SP)";"SP";"MONTEIRO LOBATO";199;50;21;270
2013;"MORRO AGUDO (SP)";"SP";"MORRO AGUDO";684;49;168;901
2013;"MORUNGABA (SP)";"SP";"MORUNGABA";378;62;30;470
2013;"MOTUCA (SP)";"SP";"MOTUCA";129;10;31;170
2013;"MUNICIPIO NAO INFORMADO (SP)";"SP";"MUNICIPIO NAO INFORMADO";0;0;0;0
2013;"MURUTINGA DO SUL (SP)";"SP";"MURUTINGA DO SUL";86;8;11;105
2013;"NANTES (SP)";"SP";"NANTES";19;12;18;49
2013;"NARANDIBA (SP)";"SP";"NARANDIBA";84;7;20;111
2013;"NATIVIDADE DA SERRA (SP)";"SP";"NATIVIDADE DA SERRA";88;44;8;140
2013;"NAZARE PAULISTA (SP)";"SP";"NAZARE PAULISTA";675;21;31;727
2013;"NEVES PAULISTA (SP)";"SP";"NEVES PAULISTA";186;11;32;229
2013;"NHANDEARA (SP)";"SP";"NHANDEARA";198;22;42;262
2013;"NIPOA (SP)";"SP";"NIPOA";150;11;31;192
2013;"NOVA ALIANCA (SP)";"SP";"NOVA ALIANCA";135;16;18;169
2013;"NOVA CAMPINA (SP)";"SP";"NOVA CAMPINA";75;16;19;110
2013;"NOVA CANAA PAULISTA (SP)";"SP";"NOVA CANAA PAULISTA";34;5;6;45
2013;"NOVA CASTILHO (SP)";"SP";"NOVA CASTILHO";15;4;6;25
2013;"NOVA EUROPA (SP)";"SP";"NOVA EUROPA";168;10;124;302
2013;"NOVA GRANADA (SP)";"SP";"NOVA GRANADA";339;54;102;495
2013;"NOVA GUATAPORANGA (SP)";"SP";"NOVA GUATAPORANGA";42;5;14;61
2013;"NOVA INDEPENDENCIA (SP)";"SP";"NOVA INDEPENDENCIA";53;11;12;76
2013;"NOVA LUZITANIA (SP)";"SP";"NOVA LUZITANIA";38;2;26;66
2013;"NOVA ODESSA (SP)";"SP";"NOVA ODESSA";882;128;129;1139
2013;"NOVAIS (SP)";"SP";"NOVAIS";97;8;29;134
2013;"NOVO HORIZONTE (SP)";"SP";"NOVO HORIZONTE";1137;29;272;1438
2013;"NUPORANGA (SP)";"SP";"NUPORANGA";214;20;53;287
2013;"OCAUCU (SP)";"SP";"OCAUCU";105;9;18;132
2013;"OLEO (SP)";"SP";"OLEO";31;10;7;48
2013;"OLIMPIA (SP)";"SP";"OLIMPIA";962;120;225;1307
2013;"ONDA VERDE (SP)";"SP";"ONDA VERDE";91;8;23;122
2013;"ORIENTE (SP)";"SP";"ORIENTE";91;8;18;117
2013;"ORINDIUVA (SP)";"SP";"ORINDIUVA";220;12;81;313
2013;"ORLANDIA (SP)";"SP";"ORLANDIA";951;55;280;1286
2013;"OSASCO (SP)";"SP";"OSASCO";10527;2079;2565;15171
2013;"OSCAR BRESSANE (SP)";"SP";"OSCAR BRESSANE";56;6;4;66
2013;"OSVALDO CRUZ (SP)";"SP";"OSVALDO CRUZ";581;31;104;716
2013;"OURINHOS (SP)";"SP";"OURINHOS";2201;151;628;2980
2013;"OURO VERDE (SP)";"SP";"OURO VERDE";129;5;64;198
2013;"OUROESTE (SP)";"SP";"OUROESTE";177;12;37;226
2013;"PACAEMBU (SP)";"SP";"PACAEMBU";196;23;40;259
2013;"PALESTINA (SP)";"SP";"PALESTINA";161;19;48;228
2013;"PALMARES PAULISTA (SP)";"SP";"PALMARES PAULISTA";77;12;105;194
2013;"PALMEIRA D OESTE (SP)";"SP";"PALMEIRA D OESTE";246;7;33;286
2013;"PALMITAL (SP)";"SP";"PALMITAL";641;39;54;734
2013;"PANORAMA (SP)";"SP";"PANORAMA";332;12;21;365
2013;"PARAGUACU PAULISTA (SP)";"SP";"PARAGUACU PAULISTA";845;162;102;1109
2013;"PARAIBUNA (SP)";"SP";"PARAIBUNA";247;74;67;388
2013;"PARAISO (SP)";"SP";"PARAISO";199;15;75;289
2013;"PARANAPANEMA (SP)";"SP";"PARANAPANEMA";575;35;70;680
2013;"PARANAPUA (SP)";"SP";"PARANAPUA";86;9;13;108
2013;"PARAPUA (SP)";"SP";"PARAPUA";306;7;50;363
2013;"PARDINHO (SP)";"SP";"PARDINHO";138;19;32;189
2013;"PARIQUERA ACU (SP)";"SP";"PARIQUERA ACU";426;29;19;474
2013;"PARISI (SP)";"SP";"PARISI";29;7;8;44
2013;"PATROCINIO PAULISTA (SP)";"SP";"PATROCINIO PAULISTA";297;15;59;371
2013;"PAULICEIA (SP)";"SP";"PAULICEIA";294;11;28;333
2013;"PAULINIA (SP)";"SP";"PAULINIA";2009;224;450;2683
2013;"PAULISTANIA (SP)";"SP";"PAULISTANIA";21;6;8;35
2013;"PAULO DE FARIA (SP)";"SP";"PAULO DE FARIA";107;12;43;162
2013;"PEDERNEIRAS (SP)";"SP";"PEDERNEIRAS";1069;108;215;1392
2013;"PEDRA BELA (SP)";"SP";"PEDRA BELA";204;11;17;232
2013;"PEDRANOPOLIS (SP)";"SP";"PEDRANOPOLIS";50;3;14;67
2013;"PEDREGULHO (SP)";"SP";"PEDREGULHO";283;34;117;434
2013;"PEDREIRA (SP)";"SP";"PEDREIRA";770;122;78;970
2013;"PEDRINHAS PAULISTA (SP)";"SP";"PEDRINHAS PAULISTA";155;7;12;174
2013;"PEDRO DE TOLEDO (SP)";"SP";"PEDRO DE TOLEDO";154;24;11;189
2013;"PENAPOLIS (SP)";"SP";"PENAPOLIS";1357;76;261;1694
2013;"PEREIRA BARRETO (SP)";"SP";"PEREIRA BARRETO";376;50;93;519
2013;"PEREIRAS (SP)";"SP";"PEREIRAS";248;13;28;289
2013;"PERUIBE (SP)";"SP";"PERUIBE";642;197;96;935
2013;"PIACATU (SP)";"SP";"PIACATU";92;3;19;114
2013;"PIEDADE (SP)";"SP";"PIEDADE";1402;151;98;1651
2013;"PILAR DO SUL (SP)";"SP";"PILAR DO SUL";1111;72;84;1267
2013;"PINDAMONHANGABA (SP)";"SP";"PINDAMONHANGABA";1972;425;198;2595
2013;"PINDORAMA (SP)";"SP";"PINDORAMA";292;28;53;373
2013;"PINHALZINHO (SP)";"SP";"PINHALZINHO";415;45;13;473
2013;"PIQUEROBI (SP)";"SP";"PIQUEROBI";38;5;9;52
2013;"PIQUETE (SP)";"SP";"PIQUETE";168;43;19;230
2013;"PIRACAIA (SP)";"SP";"PIRACAIA";524;91;36;651
2013;"PIRACICABA (SP)";"SP";"PIRACICABA";7675;921;1451;10047
2013;"PIRAJU (SP)";"SP";"PIRAJU";477;74;75;626
2013;"PIRAJUI (SP)";"SP";"PIRAJUI";324;27;87;438
2013;"PIRANGI (SP)";"SP";"PIRANGI";388;18;71;477
2013;"PIRAPORA DO BOM JESUS (SP)";"SP";"PIRAPORA DO BOM JESUS";228;38;79;345
2013;"PIRAPOZINHO (SP)";"SP";"PIRAPOZINHO";458;40;102;600
2013;"PIRASSUNUNGA (SP)";"SP";"PIRASSUNUNGA";1103;159;248;1510
2013;"PIRATININGA (SP)";"SP";"PIRATININGA";251;25;41;317
2013;"PITANGUEIRAS (SP)";"SP";"PITANGUEIRAS";960;53;272;1285
2013;"PLANALTO (SP)";"SP";"PLANALTO";102;10;46;158
2013;"PLATINA (SP)";"SP";"PLATINA";55;18;13;86
2013;"POA (SP)";"SP";"POA";1092;200;205;1497
2013;"POLONI (SP)";"SP";"POLONI";178;7;52;237
2013;"POMPEIA (SP)";"SP";"POMPEIA";280;18;50;348
2013;"PONGAI (SP)";"SP";"PONGAI";66;6;18;90
2013;"PONTAL (SP)";"SP";"PONTAL";1054;36;533;1623
2013;"PONTALINDA (SP)";"SP";"PONTALINDA";30;8;26;64
2013;"PONTES GESTAL (SP)";"SP";"PONTES GESTAL";112;5;31;148
2013;"POPULINA (SP)";"SP";"POPULINA";51;8;14;73
2013;"PORANGABA (SP)";"SP";"PORANGABA";149;14;17;180
2013;"PORTO FELIZ (SP)";"SP";"PORTO FELIZ";1351;97;190;1638
2013;"PORTO FERREIRA (SP)";"SP";"PORTO FERREIRA";1180;105;156;1441
2013;"POTIM (SP)";"SP";"POTIM";91;58;29;178
2013;"POTIRENDABA (SP)";"SP";"POTIRENDABA";524;20;77;621
2013;"PRACINHA (SP)";"SP";"PRACINHA";13;2;16;31
2013;"PRADOPOLIS (SP)";"SP";"PRADOPOLIS";408;23;241;672
2013;"PRAIA GRANDE (SP)";"SP";"PRAIA GRANDE";2437;348;247;3032
2013;"PRATANIA (SP)";"SP";"PRATANIA";101;17;47;165
2013;"PRESIDENTE ALVES (SP)";"SP";"PRESIDENTE ALVES";61;4;45;110
2013;"PRESIDENTE BERNARDES (SP)";"SP";"PRESIDENTE BERNARDES";238;32;44;314
2013;"PRESIDENTE EPITACIO (SP)";"SP";"PRESIDENTE EPITACIO";535;79;153;767
2013;"PRESIDENTE PRUDENTE (SP)";"SP";"PRESIDENTE PRUDENTE";3920;357;863;5140
2013;"PRESIDENTE VENCESLAU (SP)";"SP";"PRESIDENTE VENCESLAU";692;60;64;816
2013;"PROMISSAO (SP)";"SP";"PROMISSAO";729;108;162;999
2013;"QUADRA (SP)";"SP";"QUADRA";64;9;14;87
2013;"QUATA (SP)";"SP";"QUATA";232;17;66;315
2013;"QUEIROZ (SP)";"SP";"QUEIROZ";22;8;10;40
2013;"QUELUZ (SP)";"SP";"QUELUZ";115;36;7;158
2013;"QUINTANA (SP)";"SP";"QUINTANA";137;10;22;169
2013;"RAFARD (SP)";"SP";"RAFARD";273;19;30;322
2013;"RANCHARIA (SP)";"SP";"RANCHARIA";593;78;95;766
2013;"REDENCAO DA SERRA (SP)";"SP";"REDENCAO DA SERRA";91;23;35;149
2013;"REGENTE FEIJO (SP)";"SP";"REGENTE FEIJO";391;43;35;469
2013;"REGINOPOLIS (SP)";"SP";"REGINOPOLIS";79;7;21;107
2013;"REGISTRO (SP)";"SP";"REGISTRO";1266;93;309;1668
2013;"RESTINGA (SP)";"SP";"RESTINGA";60;12;23;95
2013;"RIBEIRA (SP)";"SP";"RIBEIRA";21;8;7;36
2013;"RIBEIRAO BONITO (SP)";"SP";"RIBEIRAO BONITO";306;42;86;434
2013;"RIBEIRAO BRANCO (SP)";"SP";"RIBEIRAO BRANCO";180;32;50;262
2013;"RIBEIRAO CORRENTE (SP)";"SP";"RIBEIRAO CORRENTE";72;7;37;116
2013;"RIBEIRAO DO SUL (SP)";"SP";"RIBEIRAO DO SUL";140;13;15;168
2013;"RIBEIRAO DOS INDIOS (SP)";"SP";"RIBEIRAO DOS INDIOS";22;3;9;34
2013;"RIBEIRAO GRANDE (SP)";"SP";"RIBEIRAO GRANDE";68;29;17;114
2013;"RIBEIRAO PIRES (SP)";"SP";"RIBEIRAO PIRES";3686;534;463;4683
2013;"RIBEIRAO PRETO (SP)";"SP";"RIBEIRAO PRETO";10808;1017;1853;13678
2013;"RIFAINA (SP)";"SP";"RIFAINA";33;8;13;54
2013;"RINCAO (SP)";"SP";"RINCAO";282;19;50;351
2013;"RINOPOLIS (SP)";"SP";"RINOPOLIS";192;10;47;249
2013;"RIO CLARO (SP)";"SP";"RIO CLARO";3339;360;429;4128
2013;"RIO DAS PEDRAS (SP)";"SP";"RIO DAS PEDRAS";699;88;165;952
2013;"RIO GRANDE DA SERRA (SP)";"SP";"RIO GRANDE DA SERRA";608;192;89;889
2013;"RIOLANDIA (SP)";"SP";"RIOLANDIA";93;12;48;153
2013;"RIVERSUL (SP)";"SP";"RIVERSUL";70;24;29;123
2013;"ROSANA (SP)";"SP";"ROSANA";169;25;61;255
2013;"ROSEIRA (SP)";"SP";"ROSEIRA";131;66;21;218
2013;"RUBIACEA (SP)";"SP";"RUBIACEA";29;3;11;43
2013;"RUBINEIA (SP)";"SP";"RUBINEIA";29;11;10;50
2013;"SABINO (SP)";"SP";"SABINO";63;8;16;87
2013;"SAGRES (SP)";"SP";"SAGRES";22;1;6;29
2013;"SALES (SP)";"SP";"SALES";85;2;30;117
2013;"SALES OLIVEIRA (SP)";"SP";"SALES OLIVEIRA";262;16;49;327
2013;"SALESOPOLIS (SP)";"SP";"SALESOPOLIS";911;92;94;1097
2013;"SALMOURAO (SP)";"SP";"SALMOURAO";34;4;36;74
2013;"SALTINHO (SP)";"SP";"SALTINHO";364;11;12;387
2013;"SALTO (SP)";"SP";"SALTO";2327;269;191;2787
2013;"SALTO DE PIRAPORA (SP)";"SP";"SALTO DE PIRAPORA";693;66;60;819
2013;"SALTO GRANDE (SP)";"SP";"SALTO GRANDE";145;17;30;192
2013;"SANDOVALINA (SP)";"SP";"SANDOVALINA";48;4;17;69
2013;"SANTA ADELIA (SP)";"SP";"SANTA ADELIA";629;32;91;752
2013;"SANTA ALBERTINA (SP)";"SP";"SANTA ALBERTINA";128;7;28;163
2013;"SANTA BARBARA D OESTE (SP)";"SP";"SANTA BARBARA D OESTE";2467;443;308;3218
2013;"SANTA BRANCA (SP)";"SP";"SANTA BRANCA";144;46;34;224
2013;"SANTA CLARA D OESTE (SP)";"SP";"SANTA CLARA D OESTE";25;5;4;34
2013;"SANTA CRUZ DA CONCEICAO (SP)";"SP";"SANTA CRUZ DA CONCEICAO";143;21;15;179
2013;"SANTA CRUZ DA ESPERANCA (SP)";"SP";"SANTA CRUZ DA ESPERANCA";28;1;4;33
2013;"SANTA CRUZ DAS PALMEIRAS (SP)";"SP";"SANTA CRUZ DAS PALMEIRAS";595;51;198;844
2013;"SANTA CRUZ DO RIO PARDO (SP)";"SP";"SANTA CRUZ DO RIO PARDO";1384;105;97;1586
2013;"SANTA ERNESTINA (SP)";"SP";"SANTA ERNESTINA";81;22;65;168
2013;"SANTA FE DO SUL (SP)";"SP";"SANTA FE DO SUL";674;31;39;744
2013;"SANTA GERTRUDES (SP)";"SP";"SANTA GERTRUDES";613;55;28;696
2013;"SANTA ISABEL (SP)";"SP";"SANTA ISABEL";1291;99;121;1511
2013;"SANTA LUCIA (SP)";"SP";"SANTA LUCIA";120;26;46;192
2013;"SANTA MARIA DA SERRA (SP)";"SP";"SANTA MARIA DA SERRA";313;30;25;368
2013;"SANTA MERCEDES (SP)";"SP";"SANTA MERCEDES";63;10;11;84
2013;"SANTA RITA D OESTE (SP)";"SP";"SANTA RITA D OESTE";32;2;7;41
2013;"SANTA RITA DO PASSA QUATRO (SP)";"SP";"SANTA RITA DO PASSA QUATRO";592;66;52;710
2013;"SANTA ROSA DE VITERBO (SP)";"SP";"SANTA ROSA DE VITERBO";444;46;104;594
2013;"SANTA SALETE (SP)";"SP";"SANTA SALETE";41;7;7;55
2013;"SANTANA DA PONTE PENSA (SP)";"SP";"SANTANA DA PONTE PENSA";30;4;5;39
2013;"SANTANA DE PARNAIBA (SP)";"SP";"SANTANA DE PARNAIBA";1913;472;207;2592
2013;"SANTO ANASTACIO (SP)";"SP";"SANTO ANASTACIO";485;35;64;584
2013;"SANTO ANDRE (SP)";"SP";"SANTO ANDRE";10151;1844;1700;13695
2013;"SANTO ANTONIO DA ALEGRIA (SP)";"SP";"SANTO ANTONIO DA ALEGRIA";113;7;30;150
2013;"SANTO ANTONIO DE POSSE (SP)";"SP";"SANTO ANTONIO DE POSSE";818;68;146;1032
2013;"SANTO ANTONIO DO ARACANGUA (SP)";"SP";"SANTO ANTONIO DO ARACANGUA";210;27;89;326
2013;"SANTO ANTONIO DO JARDIM (SP)";"SP";"SANTO ANTONIO DO JARDIM";208;14;14;236
2013;"SANTO ANTONIO DO PINHAL (SP)";"SP";"SANTO ANTONIO DO PINHAL";162;20;9;191
2013;"SANTO EXPEDITO (SP)";"SP";"SANTO EXPEDITO";26;2;12;40
2013;"SANTOPOLIS DO AGUAPEI (SP)";"SP";"SANTOPOLIS DO AGUAPEI";66;2;30;98
2013;"SANTOS (SP)";"SP";"SANTOS";5898;885;675;7458
2013;"SAO BENTO DO SAPUCAI (SP)";"SP";"SAO BENTO DO SAPUCAI";145;47;13;205
2013;"SAO BERNARDO DO CAMPO (SP)";"SP";"SAO BERNARDO DO CAMPO";13042;2487;4106;19635
2013;"SAO CAETANO DO SUL (SP)";"SP";"SAO CAETANO DO SUL";2833;626;673;4132
2013;"SAO CARLOS (SP)";"SP";"SAO CARLOS";3757;449;430;4636
2013;"SAO FRANCISCO (SP)";"SP";"SAO FRANCISCO";43;6;30;79
2013;"SAO JOAO DA BOA VISTA (SP)";"SP";"SAO JOAO DA BOA VISTA";1958;253;101;2312
2013;"SAO JOAO DAS DUAS PONTES (SP)";"SP";"SAO JOAO DAS DUAS PONTES";17;8;5;30
2013;"SAO JOAO DE IRACEMA (SP)";"SP";"SAO JOAO DE IRACEMA";41;6;10;57
2013;"SAO JOAO DO PAU D ALHO (SP)";"SP";"SAO JOAO DO PAU D ALHO";38;4;6;48
2013;"SAO JOAQUIM DA BARRA (SP)";"SP";"SAO JOAQUIM DA BARRA";813;69;181;1063
2013;"SAO JOSE DA BELA VISTA (SP)";"SP";"SAO JOSE DA BELA VISTA";73;12;49;134
2013;"SAO JOSE DO BARREIRO (SP)";"SP";"SAO JOSE DO BARREIRO";43;16;7;66
2013;"SAO JOSE DO RIO PARDO (SP)";"SP";"SAO JOSE DO RIO PARDO";1226;76;141;1443
2013;"SAO JOSE DO RIO PRETO (SP)";"SP";"SAO JOSE DO RIO PRETO";8423;619;1594;10636
2013;"SAO JOSE DOS CAMPOS (SP)";"SP";"SAO JOSE DOS CAMPOS";7128;1877;1625;10630
2013;"SAO LOURENCO DA SERRA (SP)";"SP";"SAO LOURENCO DA SERRA";353;30;29;412
2013;"SAO LUIZ DO PARAITINGA (SP)";"SP";"SAO LUIZ DO PARAITINGA";166;29;31;226
2013;"SAO MANUEL (SP)";"SP";"SAO MANUEL";800;130;233;1163
2013;"SAO MIGUEL ARCANJO (SP)";"SP";"SAO MIGUEL ARCANJO";703;96;71;870
2013;"SAO PAULO (SP)";"SP";"SAO PAULO";116275;33409;41037;190721
2013;"SAO PEDRO (SP)";"SP";"SAO PEDRO";594;96;80;770
2013;"SAO PEDRO DO TURVO (SP)";"SP";"SAO PEDRO DO TURVO";170;17;44;231
2013;"SAO ROQUE (SP)";"SP";"SAO ROQUE";1187;227;213;1627
2013;"SAO SEBASTIAO (SP)";"SP";"SAO SEBASTIAO";636;133;175;944
2013;"SAO SEBASTIAO DA GRAMA (SP)";"SP";"SAO SEBASTIAO DA GRAMA";240;29;31;300
2013;"SAO SIMAO (SP)";"SP";"SAO SIMAO";359;24;45;428
2013;"SAO VICENTE (SP)";"SP";"SAO VICENTE";1888;653;945;3486
2013;"SARAPUI (SP)";"SP";"SARAPUI";168;24;15;207
2013;"SARUTAIA (SP)";"SP";"SARUTAIA";48;8;28;84
2013;"SEBASTIANOPOLIS DO SUL (SP)";"SP";"SEBASTIANOPOLIS DO SUL";263;6;15;284
2013;"SERRA AZUL (SP)";"SP";"SERRA AZUL";161;12;108;281
2013;"SERRA NEGRA (SP)";"SP";"SERRA NEGRA";427;64;25;516
2013;"SERRANA (SP)";"SP";"SERRANA";632;111;224;967
2013;"SERTAOZINHO (SP)";"SP";"SERTAOZINHO";2730;169;552;3451
2013;"SETE BARRAS (SP)";"SP";"SETE BARRAS";224;16;34;274
2013;"SEVERINIA (SP)";"SP";"SEVERINIA";323;22;221;566
2013;"SILVEIRAS (SP)";"SP";"SILVEIRAS";94;23;6;123
2013;"SOCORRO (SP)";"SP";"SOCORRO";902;143;50;1095
2013;"SOROCABA (SP)";"SP";"SOROCABA";7955;1365;1634;10954
2013;"SUD MENNUCCI (SP)";"SP";"SUD MENNUCCI";129;13;51;193
2013;"SUMARE (SP)";"SP";"SUMARE";2631;596;606;3833
2013;"SUZANAPOLIS (SP)";"SP";"SUZANAPOLIS";77;10;17;104
2013;"SUZANO (SP)";"SP";"SUZANO";3016;791;739;4546
2013;"TABAPUA (SP)";"SP";"TABAPUA";169;16;56;241
2013;"TABATINGA (SP)";"SP";"TABATINGA";342;22;158;522
2013;"TABOAO DA SERRA (SP)";"SP";"TABOAO DA SERRA";2902;960;660;4522
2013;"TACIBA (SP)";"SP";"TACIBA";89;13;23;125
2013;"TAGUAI (SP)";"SP";"TAGUAI";180;12;30;222
2013;"TAIACU (SP)";"SP";"TAIACU";153;7;24;184
2013;"TAIUVA (SP)";"SP";"TAIUVA";172;11;26;209
2013;"TAMBAU (SP)";"SP";"TAMBAU";553;46;62;661
2013;"TANABI (SP)";"SP";"TANABI";521;53;112;686
2013;"TAPIRAI (SP)";"SP";"TAPIRAI";183;14;13;210
2013;"TAPIRATIBA (SP)";"SP";"TAPIRATIBA";390;19;73;482
2013;"TAQUARAL (SP)";"SP";"TAQUARAL";64;9;20;93
2013;"TAQUARITINGA (SP)";"SP";"TAQUARITINGA";1501;95;336;1932
2013;"TAQUARITUBA (SP)";"SP";"TAQUARITUBA";685;61;89;835
2013;"TAQUARIVAI (SP)";"SP";"TAQUARIVAI";58;13;15;86
2013;"TARABAI (SP)";"SP";"TARABAI";107;7;27;141
2013;"TARUMA (SP)";"SP";"TARUMA";339;24;166;529
2013;"TATUI (SP)";"SP";"TATUI";2183;189;774;3146
2013;"TAUBATE (SP)";"SP";"TAUBATE";3284;846;822;4952
2013;"TEJUPA (SP)";"SP";"TEJUPA";58;21;9;88
2013;"TEODORO SAMPAIO (SP)";"SP";"TEODORO SAMPAIO";288;39;337;664
2013;"TERRA ROXA (SP)";"SP";"TERRA ROXA";171;17;67;255
2013;"TIETE (SP)";"SP";"TIETE";1245;64;180;1489
2013;"TIMBURI (SP)";"SP";"TIMBURI";27;7;5;39
2013;"TORRE DE PEDRA (SP)";"SP";"TORRE DE PEDRA";42;7;8;57
2013;"TORRINHA (SP)";"SP";"TORRINHA";417;20;49;486
2013;"TRABIJU (SP)";"SP";"TRABIJU";42;14;9;65
2013;"TREMEMBE (SP)";"SP";"TREMEMBE";438;69;15;522
2013;"TRES FRONTEIRAS (SP)";"SP";"TRES FRONTEIRAS";63;11;11;85
2013;"TUIUTI (SP)";"SP";"TUIUTI";112;26;13;151
2013;"TUPA (SP)";"SP";"TUPA";1501;62;237;1800
2013;"TUPI PAULISTA (SP)";"SP";"TUPI PAULISTA";323;23;30;376
2013;"TURIUBA (SP)";"SP";"TURIUBA";22;2;12;36
2013;"TURMALINA (SP)";"SP";"TURMALINA";23;2;13;38
2013;"UBARANA (SP)";"SP";"UBARANA";123;5;38;166
2013;"UBATUBA (SP)";"SP";"UBATUBA";694;105;76;875
2013;"UBIRAJARA (SP)";"SP";"UBIRAJARA";92;7;32;131
2013;"UCHOA (SP)";"SP";"UCHOA";165;12;44;221
2013;"UNIAO PAULISTA (SP)";"SP";"UNIAO PAULISTA";50;7;8;65
2013;"URANIA (SP)";"SP";"URANIA";152;17;33;202
2013;"URU (SP)";"SP";"URU";9;10;9;28
2013;"URUPES (SP)";"SP";"URUPES";362;22;52;436
2013;"VALENTIM GENTIL (SP)";"SP";"VALENTIM GENTIL";295;20;32;347
2013;"VALINHOS (SP)";"SP";"VALINHOS";2149;509;1999;4657
2013;"VALPARAISO (SP)";"SP";"VALPARAISO";459;32;159;650
2013;"VARGEM (SP)";"SP";"VARGEM";315;24;23;362
2013;"VARGEM GRANDE DO SUL (SP)";"SP";"VARGEM GRANDE DO SUL";1164;91;216;1471
2013;"VARGEM GRANDE PAULISTA (SP)";"SP";"VARGEM GRANDE PAULISTA";996;115;83;1194
2013;"VARZEA PAULISTA (SP)";"SP";"VARZEA PAULISTA";1195;387;284;1866
2013;"VERA CRUZ (SP)";"SP";"VERA CRUZ";141;23;30;194
2013;"VINHEDO (SP)";"SP";"VINHEDO";1583;178;145;1906
2013;"VIRADOURO (SP)";"SP";"VIRADOURO";361;23;77;461
2013;"VISTA ALEGRE DO ALTO (SP)";"SP";"VISTA ALEGRE DO ALTO";402;34;127;563
2013;"VITORIA BRASIL (SP)";"SP";"VITORIA BRASIL";24;3;9;36
2013;"VOTORANTIM (SP)";"SP";"VOTORANTIM";1304;323;313;1940
2013;"VOTUPORANGA (SP)";"SP";"VOTUPORANGA";2060;135;253;2448
2013;"ZACARIAS (SP)";"SP";"ZACARIAS";50;7;17;74
2013;"ABREULANDIA (TO)";"TO";"ABREULANDIA";17;1;2;20
2013;"AGUIARNOPOLIS (TO)";"TO";"AGUIARNOPOLIS";60;2;9;71
2013;"ALIANCA DO TOCANTINS (TO)";"TO";"ALIANCA DO TOCANTINS";71;8;12;91
2013;"ALMAS (TO)";"TO";"ALMAS";63;0;9;72
2013;"ALVORADA (TO)";"TO";"ALVORADA";174;1;13;188
2013;"ANANAS (TO)";"TO";"ANANAS";69;2;26;97
2013;"ANGICO (TO)";"TO";"ANGICO";16;4;7;27
2013;"APARECIDA DO RIO NEGRO (TO)";"TO";"APARECIDA DO RIO NEGRO";58;12;2;72
2013;"ARAGOMINAS (TO)";"TO";"ARAGOMINAS";67;2;14;83
2013;"ARAGUACEMA (TO)";"TO";"ARAGUACEMA";25;2;9;36
2013;"ARAGUACU (TO)";"TO";"ARAGUACU";95;9;12;116
2013;"ARAGUAINA (TO)";"TO";"ARAGUAINA";3675;156;586;4417
2013;"ARAGUANA (TO)";"TO";"ARAGUANA";111;5;31;147
2013;"ARAGUATINS (TO)";"TO";"ARAGUATINS";320;46;67;433
2013;"ARAPOEMA (TO)";"TO";"ARAPOEMA";44;5;13;62
2013;"ARRAIAS (TO)";"TO";"ARRAIAS";51;1;8;60
2013;"AUGUSTINOPOLIS (TO)";"TO";"AUGUSTINOPOLIS";191;34;27;252
2013;"AURORA DO TOCANTINS (TO)";"TO";"AURORA DO TOCANTINS";10;0;5;15
2013;"AXIXA DO TOCANTINS (TO)";"TO";"AXIXA DO TOCANTINS";48;19;8;75
2013;"BABACULANDIA (TO)";"TO";"BABACULANDIA";331;14;20;365
2013;"BANDEIRANTES DO TOCANTINS (TO)";"TO";"BANDEIRANTES DO TOCANTINS";23;3;4;30
2013;"BARRA DO OURO (TO)";"TO";"BARRA DO OURO";13;2;0;15
2013;"BARROLANDIA (TO)";"TO";"BARROLANDIA";48;3;6;57
2013;"BERNARDO SAYAO (TO)";"TO";"BERNARDO SAYAO";30;1;7;38
2013;"BOM JESUS DO TOCANTINS (TO)";"TO";"BOM JESUS DO TOCANTINS";6;1;3;10
2013;"BRASILANDIA DO TOCANTINS (TO)";"TO";"BRASILANDIA DO TOCANTINS";16;3;2;21
2013;"BREJINHO DE NAZARE (TO)";"TO";"BREJINHO DE NAZARE";46;1;18;65
2013;"BURITI DO TOCANTINS (TO)";"TO";"BURITI DO TOCANTINS";46;13;4;63
2013;"CACHOEIRINHA (TO)";"TO";"CACHOEIRINHA";5;0;2;7
2013;"CAMPOS LINDOS (TO)";"TO";"CAMPOS LINDOS";64;0;7;71
2013;"CARIRI DO TOCANTINS (TO)";"TO";"CARIRI DO TOCANTINS";32;5;10;47
2013;"CARMOLANDIA (TO)";"TO";"CARMOLANDIA";285;20;121;426
2013;"CARRASCO BONITO (TO)";"TO";"CARRASCO BONITO";4;4;3;11
2013;"CASEARA (TO)";"TO";"CASEARA";24;2;5;31
2013;"CENTENARIO (TO)";"TO";"CENTENARIO";2;0;2;4
2013;"CHAPADA DA NATIVIDADE (TO)";"TO";"CHAPADA DA NATIVIDADE";13;1;7;21
2013;"CHAPADA DE AREIA (TO)";"TO";"CHAPADA DE AREIA";3;1;1;5
2013;"COLINAS DO TOCANTINS (TO)";"TO";"COLINAS DO TOCANTINS";514;13;61;588
2013;"COLMEIA (TO)";"TO";"COLMEIA";122;7;18;147
2013;"COMBINADO (TO)";"TO";"COMBINADO";16;1;11;28
2013;"CONCEICAO DO TOCANTINS (TO)";"TO";"CONCEICAO DO TOCANTINS";15;2;2;19
2013;"COUTO DE MAGALHAES (TO)";"TO";"COUTO DE MAGALHAES";16;6;11;33
2013;"CRISTALANDIA (TO)";"TO";"CRISTALANDIA";100;1;6;107
2013;"CRIXAS DO TOCANTINS (TO)";"TO";"CRIXAS DO TOCANTINS";9;1;1;11
2013;"DARCINOPOLIS (TO)";"TO";"DARCINOPOLIS";84;8;10;102
2013;"DIANOPOLIS (TO)";"TO";"DIANOPOLIS";177;19;46;242
2013;"DIVINOPOLIS DO TOCANTINS (TO)";"TO";"DIVINOPOLIS DO TOCANTINS";71;3;6;80
2013;"DOIS IRMAOS DO TOCANTINS (TO)";"TO";"DOIS IRMAOS DO TOCANTINS";35;6;8;49
2013;"DUERE (TO)";"TO";"DUERE";37;3;5;45
2013;"ESPERANTINA (TO)";"TO";"ESPERANTINA";19;11;9;39
2013;"FATIMA (TO)";"TO";"FATIMA";44;2;6;52
2013;"FIGUEIROPOLIS (TO)";"TO";"FIGUEIROPOLIS";61;3;7;71
2013;"FILADELFIA (TO)";"TO";"FILADELFIA";54;10;8;72
2013;"FORMOSO DO ARAGUAIA (TO)";"TO";"FORMOSO DO ARAGUAIA";231;10;25;266
2013;"FORTALEZA DO TABOCAO (TO)";"TO";"FORTALEZA DO TABOCAO";29;3;4;36
2013;"GOIANORTE (TO)";"TO";"GOIANORTE";44;6;12;62
2013;"GOIATINS (TO)";"TO";"GOIATINS";57;5;9;71
2013;"GUARAI (TO)";"TO";"GUARAI";382;16;37;435
2013;"GURUPI (TO)";"TO";"GURUPI";1609;41;237;1887
2013;"IPUEIRAS (TO)";"TO";"IPUEIRAS";6;0;2;8
2013;"ITACAJA (TO)";"TO";"ITACAJA";38;2;3;43
2013;"ITAGUATINS (TO)";"TO";"ITAGUATINS";40;4;17;61
2013;"ITAPIRATINS (TO)";"TO";"ITAPIRATINS";21;2;9;32
2013;"ITAPORA DO TOCANTINS (TO)";"TO";"ITAPORA DO TOCANTINS";17;3;7;27
2013;"JAU DO TOCANTINS (TO)";"TO";"JAU DO TOCANTINS";17;1;8;26
2013;"JUARINA (TO)";"TO";"JUARINA";13;3;5;21
2013;"LAGOA DA CONFUSAO (TO)";"TO";"LAGOA DA CONFUSAO";121;4;11;136
2013;"LAGOA DO TOCANTINS (TO)";"TO";"LAGOA DO TOCANTINS";8;0;8;16
2013;"LAJEADO (TO)";"TO";"LAJEADO";26;2;10;38
2013;"LAVANDEIRA (TO)";"TO";"LAVANDEIRA";2;0;0;2
2013;"LIZARDA (TO)";"TO";"LIZARDA";14;1;1;16
2013;"LUZINOPOLIS (TO)";"TO";"LUZINOPOLIS";12;2;0;14
2013;"MARIANOPOLIS DO TOCANTINS (TO)";"TO";"MARIANOPOLIS DO TOCANTINS";39;0;4;43
2013;"MATEIROS (TO)";"TO";"MATEIROS";25;0;4;29
2013;"MAURILANDIA DO TOCANTINS (TO)";"TO";"MAURILANDIA DO TOCANTINS";9;8;3;20
2013;"MIRACEMA DO TOCANTINS (TO)";"TO";"MIRACEMA DO TOCANTINS";187;21;35;243
2013;"MIRANORTE (TO)";"TO";"MIRANORTE";228;12;18;258
2013;"MONTE DO CARMO (TO)";"TO";"MONTE DO CARMO";24;3;5;32
2013;"MONTE SANTO DO TOCANTINS (TO)";"TO";"MONTE SANTO DO TOCANTINS";18;3;3;24
2013;"MURICILANDIA (TO)";"TO";"MURICILANDIA";10;1;3;14
2013;"NATIVIDADE (TO)";"TO";"NATIVIDADE";79;4;7;90
2013;"NAZARE (TO)";"TO";"NAZARE";20;4;6;30
2013;"NOVA OLINDA (TO)";"TO";"NOVA OLINDA";97;4;24;125
2013;"NOVA ROSALANDIA (TO)";"TO";"NOVA ROSALANDIA";20;2;2;24
2013;"NOVO ACORDO (TO)";"TO";"NOVO ACORDO";25;0;4;29
2013;"NOVO ALEGRE (TO)";"TO";"NOVO ALEGRE";7;2;5;14
2013;"NOVO JARDIM (TO)";"TO";"NOVO JARDIM";17;0;3;20
2013;"OLIVEIRA DE FATIMA (TO)";"TO";"OLIVEIRA DE FATIMA";10;1;4;15
2013;"PALMAS (TO)";"TO";"PALMAS";4641;297;1627;6565
2013;"PALMEIRANTE (TO)";"TO";"PALMEIRANTE";15;4;2;21
2013;"PALMEIRAS DO TOCANTINS (TO)";"TO";"PALMEIRAS DO TOCANTINS";35;7;7;49
2013;"PALMEIROPOLIS (TO)";"TO";"PALMEIROPOLIS";105;3;17;125
2013;"PARAISO DO TOCANTINS (TO)";"TO";"PARAISO DO TOCANTINS";1218;31;121;1370
2013;"PARANA (TO)";"TO";"PARANA";33;4;2;39
2013;"PAU D ARCO (TO)";"TO";"PAU D ARCO";20;1;7;28
2013;"PEDRO AFONSO (TO)";"TO";"PEDRO AFONSO";207;7;60;274
2013;"PEIXE (TO)";"TO";"PEIXE";71;11;41;123
2013;"PEQUIZEIRO (TO)";"TO";"PEQUIZEIRO";34;1;11;46
2013;"PINDORAMA DO TOCANTINS (TO)";"TO";"PINDORAMA DO TOCANTINS";20;0;6;26
2013;"PIRAQUE (TO)";"TO";"PIRAQUE";3;0;7;10
2013;"PIUM (TO)";"TO";"PIUM";43;3;12;58
2013;"PONTE ALTA DO BOM JESUS (TO)";"TO";"PONTE ALTA DO BOM JESUS";13;3;3;19
2013;"PONTE ALTA DO TOCANTINS (TO)";"TO";"PONTE ALTA DO TOCANTINS";25;2;6;33
2013;"PORTO ALEGRE DO TOCANTINS (TO)";"TO";"PORTO ALEGRE DO TOCANTINS";9;0;5;14
2013;"PORTO NACIONAL (TO)";"TO";"PORTO NACIONAL";688;53;101;842
2013;"PRAIA NORTE (TO)";"TO";"PRAIA NORTE";8;5;4;17
2013;"PRESIDENTE KENNEDY (TO)";"TO";"PRESIDENTE KENNEDY";39;1;3;43
2013;"PUGMIL (TO)";"TO";"PUGMIL";22;2;1;25
2013;"RECURSOLANDIA (TO)";"TO";"RECURSOLANDIA";12;0;1;13
2013;"RIACHINHO (TO)";"TO";"RIACHINHO";148;15;93;256
2013;"RIO DA CONCEICAO (TO)";"TO";"RIO DA CONCEICAO";7;1;2;10
2013;"RIO DOS BOIS (TO)";"TO";"RIO DOS BOIS";9;0;4;13
2013;"RIO SONO (TO)";"TO";"RIO SONO";21;1;6;28
2013;"SAMPAIO (TO)";"TO";"SAMPAIO";65;2;4;71
2013;"SANDOLANDIA (TO)";"TO";"SANDOLANDIA";15;8;1;24
2013;"SANTA FE DO ARAGUAIA (TO)";"TO";"SANTA FE DO ARAGUAIA";57;10;17;84
2013;"SANTA MARIA DO TOCANTINS (TO)";"TO";"SANTA MARIA DO TOCANTINS";14;5;2;21
2013;"SANTA RITA DO TOCANTINS (TO)";"TO";"SANTA RITA DO TOCANTINS";12;2;3;17
2013;"SANTA ROSA DO TOCANTINS (TO)";"TO";"SANTA ROSA DO TOCANTINS";37;0;3;40
2013;"SANTA TEREZA DO TOCANTINS (TO)";"TO";"SANTA TEREZA DO TOCANTINS";22;1;4;27
2013;"SANTA TEREZINHA DO TOCANTINS (TO)";"TO";"SANTA TEREZINHA DO TOCANTINS";13;3;4;20
2013;"SAO BENTO DO TOCANTINS (TO)";"TO";"SAO BENTO DO TOCANTINS";22;3;11;36
2013;"SAO FELIX DO TOCANTINS (TO)";"TO";"SAO FELIX DO TOCANTINS";6;0;0;6
2013;"SAO MIGUEL DO TOCANTINS (TO)";"TO";"SAO MIGUEL DO TOCANTINS";115;16;47;178
2013;"SAO SALVADOR DO TOCANTINS (TO)";"TO";"SAO SALVADOR DO TOCANTINS";22;4;4;30
2013;"SAO SEBASTIAO DO TOCANTINS (TO)";"TO";"SAO SEBASTIAO DO TOCANTINS";14;2;2;18
2013;"SAO VALERIO DA NATIVIDADE (TO)";"TO";"SAO VALERIO DA NATIVIDADE";46;1;7;54
2013;"SILVANOPOLIS (TO)";"TO";"SILVANOPOLIS";38;1;5;44
2013;"SITIO NOVO DO TOCANTINS (TO)";"TO";"SITIO NOVO DO TOCANTINS";46;6;15;67
2013;"SUCUPIRA (TO)";"TO";"SUCUPIRA";11;0;5;16
2013;"TAGUATINGA (TO)";"TO";"TAGUATINGA";89;9;23;121
2013;"TAIPAS DO TOCANTINS (TO)";"TO";"TAIPAS DO TOCANTINS";7;0;1;8
2013;"TALISMA (TO)";"TO";"TALISMA";16;6;1;23
2013;"TOCANTINIA (TO)";"TO";"TOCANTINIA";26;1;7;34
2013;"TOCANTINOPOLIS (TO)";"TO";"TOCANTINOPOLIS";1308;252;348;1908
2013;"TUPIRAMA (TO)";"TO";"TUPIRAMA";17;3;3;23
2013;"TUPIRATINS (TO)";"TO";"TUPIRATINS";10;1;4;15
2013;"WANDERLANDIA (TO)";"TO";"WANDERLANDIA";78;4;8;90
2013;"XAMBIOA (TO)";"TO";"XAMBIOA";122;7;20;149
