"ano";"chave";"UF";"MUNICIPIO";"CAMINHAO";"MICRO_ONIBUS";"ONIBUS";"total"
2006;"ACRELANDIA (AC)";"AC";"ACRELANDIA";69;1;11;81
2006;"ASSIS BRASIL (AC)";"AC";"ASSIS BRASIL";11;0;1;12
2006;"BRASILEIA (AC)";"AC";"BRASILEIA";100;0;3;103
2006;"BUJARI (AC)";"AC";"BUJARI";37;3;2;42
2006;"CAPIXABA (AC)";"AC";"CAPIXABA";23;1;3;27
2006;"CRUZEIRO DO SUL (AC)";"AC";"CRUZEIRO DO SUL";273;23;22;318
2006;"EPITACIOLANDIA (AC)";"AC";"EPITACIOLANDIA";85;1;7;93
2006;"FEIJO (AC)";"AC";"FEIJO";31;1;0;32
2006;"MANCIO LIMA (AC)";"AC";"MANCIO LIMA";23;1;4;28
2006;"MANOEL URBANO (AC)";"AC";"MANOEL URBANO";5;0;0;5
2006;"PLACIDO DE CASTRO (AC)";"AC";"PLACIDO DE CASTRO";56;1;1;58
2006;"PORTO ACRE (AC)";"AC";"PORTO ACRE";55;3;15;73
2006;"RIO BRANCO (AC)";"AC";"RIO BRANCO";2602;86;362;3050
2006;"RODRIGUES ALVES (AC)";"AC";"RODRIGUES ALVES";2;0;0;2
2006;"SANTA ROSA (AC)";"AC";"SANTA ROSA";0;0;0;0
2006;"SENA MADUREIRA (AC)";"AC";"SENA MADUREIRA";49;1;1;51
2006;"SENADOR GUIOMARD (AC)";"AC";"SENADOR GUIOMARD";140;0;7;147
2006;"TARAUACA (AC)";"AC";"TARAUACA";40;0;0;40
2006;"XAPURI (AC)";"AC";"XAPURI";26;0;0;26
2006;"AGUA BRANCA (AL)";"AL";"AGUA BRANCA";30;8;1;39
2006;"ANADIA (AL)";"AL";"ANADIA";20;37;8;65
2006;"ARAPIRACA (AL)";"AL";"ARAPIRACA";2034;259;213;2506
2006;"ATALAIA (AL)";"AL";"ATALAIA";193;36;63;292
2006;"BARRA DE SANTO ANTONIO (AL)";"AL";"BARRA DE SANTO ANTONIO";24;7;8;39
2006;"BARRA DE SAO MIGUEL (AL)";"AL";"BARRA DE SAO MIGUEL";16;3;4;23
2006;"BATALHA (AL)";"AL";"BATALHA";55;10;2;67
2006;"BELEM (AL)";"AL";"BELEM";6;12;2;20
2006;"BELO MONTE (AL)";"AL";"BELO MONTE";15;1;0;16
2006;"BOCA DA MATA (AL)";"AL";"BOCA DA MATA";187;48;66;301
2006;"BRANQUINHA (AL)";"AL";"BRANQUINHA";8;16;8;32
2006;"CACIMBINHAS (AL)";"AL";"CACIMBINHAS";23;9;4;36
2006;"CAJUEIRO (AL)";"AL";"CAJUEIRO";93;7;35;135
2006;"CAMPESTRE (AL)";"AL";"CAMPESTRE";3;17;6;26
2006;"CAMPO ALEGRE (AL)";"AL";"CAMPO ALEGRE";124;75;92;291
2006;"CAMPO GRANDE (AL)";"AL";"CAMPO GRANDE";27;7;1;35
2006;"CANAPI (AL)";"AL";"CANAPI";18;14;3;35
2006;"CAPELA (AL)";"AL";"CAPELA";59;5;13;77
2006;"CARNEIROS (AL)";"AL";"CARNEIROS";19;2;0;21
2006;"CHA PRETA (AL)";"AL";"CHA PRETA";18;3;1;22
2006;"COITE DO NOIA (AL)";"AL";"COITE DO NOIA";16;2;9;27
2006;"COLONIA LEOPOLDINA (AL)";"AL";"COLONIA LEOPOLDINA";26;12;8;46
2006;"COQUEIRO SECO (AL)";"AL";"COQUEIRO SECO";3;1;2;6
2006;"CORURIPE (AL)";"AL";"CORURIPE";255;19;106;380
2006;"CRAIBAS (AL)";"AL";"CRAIBAS";47;18;13;78
2006;"DELMIRO GOUVEIA (AL)";"AL";"DELMIRO GOUVEIA";334;216;23;573
2006;"DOIS RIACHOS (AL)";"AL";"DOIS RIACHOS";36;4;2;42
2006;"ESTRELA DE ALAGOAS (AL)";"AL";"ESTRELA DE ALAGOAS";18;28;11;57
2006;"FEIRA GRANDE (AL)";"AL";"FEIRA GRANDE";22;0;16;38
2006;"FELIZ DESERTO (AL)";"AL";"FELIZ DESERTO";4;6;1;11
2006;"FLEXEIRAS (AL)";"AL";"FLEXEIRAS";15;13;22;50
2006;"GIRAU DO PONCIANO (AL)";"AL";"GIRAU DO PONCIANO";60;16;23;99
2006;"IBATEGUARA (AL)";"AL";"IBATEGUARA";18;30;5;53
2006;"IGACI (AL)";"AL";"IGACI";42;29;14;85
2006;"IGREJA NOVA (AL)";"AL";"IGREJA NOVA";54;9;35;98
2006;"INHAPI (AL)";"AL";"INHAPI";24;3;1;28
2006;"JACARE DOS HOMENS (AL)";"AL";"JACARE DOS HOMENS";31;2;2;35
2006;"JACUIPE (AL)";"AL";"JACUIPE";2;4;3;9
2006;"JAPARATINGA (AL)";"AL";"JAPARATINGA";11;12;3;26
2006;"JARAMATAIA (AL)";"AL";"JARAMATAIA";8;4;2;14
2006;"JEQUIA DA PRAIA (AL)";"AL";"JEQUIA DA PRAIA";4;8;8;20
2006;"JOAQUIM GOMES (AL)";"AL";"JOAQUIM GOMES";56;22;15;93
2006;"JUNDIA (AL)";"AL";"JUNDIA";4;2;7;13
2006;"JUNQUEIRO (AL)";"AL";"JUNQUEIRO";103;15;55;173
2006;"LAGOA DA CANOA (AL)";"AL";"LAGOA DA CANOA";34;11;12;57
2006;"LIMOEIRO DE ANADIA (AL)";"AL";"LIMOEIRO DE ANADIA";36;6;19;61
2006;"MACEIO (AL)";"AL";"MACEIO";4026;590;1312;5928
2006;"MAJOR ISIDORO (AL)";"AL";"MAJOR ISIDORO";34;18;4;56
2006;"MAR VERMELHO (AL)";"AL";"MAR VERMELHO";5;1;4;10
2006;"MARAGOGI (AL)";"AL";"MARAGOGI";15;55;9;79
2006;"MARAVILHA (AL)";"AL";"MARAVILHA";25;6;3;34
2006;"MARECHAL DEODORO (AL)";"AL";"MARECHAL DEODORO";145;69;47;261
2006;"MARIBONDO (AL)";"AL";"MARIBONDO";25;18;7;50
2006;"MATA GRANDE (AL)";"AL";"MATA GRANDE";37;15;1;53
2006;"MATRIZ DE CAMARAGIBE (AL)";"AL";"MATRIZ DE CAMARAGIBE";87;29;54;170
2006;"MESSIAS (AL)";"AL";"MESSIAS";45;16;39;100
2006;"MINADOR DO NEGRAO (AL)";"AL";"MINADOR DO NEGRAO";16;6;2;24
2006;"MONTEIROPOLIS (AL)";"AL";"MONTEIROPOLIS";6;2;1;9
2006;"MURICI (AL)";"AL";"MURICI";95;23;33;151
2006;"NOVO LINO (AL)";"AL";"NOVO LINO";44;24;14;82
2006;"OLHO D AGUA DAS FLORES (AL)";"AL";"OLHO D AGUA DAS FLORES";132;21;3;156
2006;"OLHO D AGUA DO CASADO (AL)";"AL";"OLHO D AGUA DO CASADO";15;10;1;26
2006;"OLHO D AGUA GRANDE (AL)";"AL";"OLHO D AGUA GRANDE";6;1;6;13
2006;"OLIVENCA (AL)";"AL";"OLIVENCA";13;4;3;20
2006;"OURO BRANCO (AL)";"AL";"OURO BRANCO";23;20;13;56
2006;"PALESTINA (AL)";"AL";"PALESTINA";3;4;2;9
2006;"PALMEIRA DOS INDIOS (AL)";"AL";"PALMEIRA DOS INDIOS";396;76;24;496
2006;"PAO DE ACUCAR (AL)";"AL";"PAO DE ACUCAR";42;6;4;52
2006;"PARICONHA (AL)";"AL";"PARICONHA";9;5;3;17
2006;"PARIPUEIRA (AL)";"AL";"PARIPUEIRA";29;3;7;39
2006;"PASSO DE CAMARAGIBE (AL)";"AL";"PASSO DE CAMARAGIBE";22;1;6;29
2006;"PAULO JACINTO (AL)";"AL";"PAULO JACINTO";9;4;3;16
2006;"PENEDO (AL)";"AL";"PENEDO";221;52;105;378
2006;"PIACABUCU (AL)";"AL";"PIACABUCU";15;13;6;34
2006;"PILAR (AL)";"AL";"PILAR";117;32;49;198
2006;"PINDOBA (AL)";"AL";"PINDOBA";10;1;1;12
2006;"PIRANHAS (AL)";"AL";"PIRANHAS";28;20;5;53
2006;"POCO DAS TRINCHEIRAS (AL)";"AL";"POCO DAS TRINCHEIRAS";31;8;10;49
2006;"PORTO CALVO (AL)";"AL";"PORTO CALVO";122;45;21;188
2006;"PORTO DE PEDRAS (AL)";"AL";"PORTO DE PEDRAS";6;6;2;14
2006;"PORTO REAL DO COLEGIO (AL)";"AL";"PORTO REAL DO COLEGIO";9;11;6;26
2006;"QUEBRANGULO (AL)";"AL";"QUEBRANGULO";13;2;3;18
2006;"RIO LARGO (AL)";"AL";"RIO LARGO";264;80;98;442
2006;"ROTEIRO (AL)";"AL";"ROTEIRO";16;10;4;30
2006;"SANTA LUZIA DO NORTE (AL)";"AL";"SANTA LUZIA DO NORTE";4;3;53;60
2006;"SANTANA DO IPANEMA (AL)";"AL";"SANTANA DO IPANEMA";244;50;13;307
2006;"SANTANA DO MUNDAU (AL)";"AL";"SANTANA DO MUNDAU";30;7;0;37
2006;"SAO BRAS (AL)";"AL";"SAO BRAS";1;1;2;4
2006;"SAO JOSE DA LAJE (AL)";"AL";"SAO JOSE DA LAJE";70;44;15;129
2006;"SAO JOSE DA TAPERA (AL)";"AL";"SAO JOSE DA TAPERA";54;6;7;67
2006;"SAO LUIS DO QUITUNDE (AL)";"AL";"SAO LUIS DO QUITUNDE";194;11;60;265
2006;"SAO MIGUEL DOS CAMPOS (AL)";"AL";"SAO MIGUEL DOS CAMPOS";429;99;130;658
2006;"SAO MIGUEL DOS MILAGRES (AL)";"AL";"SAO MIGUEL DOS MILAGRES";12;1;2;15
2006;"SAO SEBASTIAO (AL)";"AL";"SAO SEBASTIAO";75;23;63;161
2006;"SATUBA (AL)";"AL";"SATUBA";32;12;8;52
2006;"SENADOR RUI PALMEIRA (AL)";"AL";"SENADOR RUI PALMEIRA";16;4;7;27
2006;"TANQUE D ARCA (AL)";"AL";"TANQUE D ARCA";5;7;3;15
2006;"TAQUARANA (AL)";"AL";"TAQUARANA";28;18;13;59
2006;"TEOTONIO VILELA (AL)";"AL";"TEOTONIO VILELA";128;57;112;297
2006;"TRAIPU (AL)";"AL";"TRAIPU";32;5;5;42
2006;"UNIAO DOS PALMARES (AL)";"AL";"UNIAO DOS PALMARES";378;130;69;577
2006;"VICOSA (AL)";"AL";"VICOSA";96;13;17;126
2006;"ALVARAES (AM)";"AM";"ALVARAES";1;0;1;2
2006;"AMATURA (AM)";"AM";"AMATURA";1;0;0;1
2006;"ANAMA (AM)";"AM";"ANAMA";0;0;0;0
2006;"ANORI (AM)";"AM";"ANORI";1;0;0;1
2006;"APUI (AM)";"AM";"APUI";20;1;3;24
2006;"ATALAIA DO NORTE (AM)";"AM";"ATALAIA DO NORTE";1;0;0;1
2006;"AUTAZES (AM)";"AM";"AUTAZES";6;1;3;10
2006;"BARCELOS (AM)";"AM";"BARCELOS";3;1;0;4
2006;"BARREIRINHA (AM)";"AM";"BARREIRINHA";0;0;0;0
2006;"BENJAMIN CONSTANT (AM)";"AM";"BENJAMIN CONSTANT";2;1;1;4
2006;"BERURI (AM)";"AM";"BERURI";0;0;0;0
2006;"BOA VISTA DO RAMOS (AM)";"AM";"BOA VISTA DO RAMOS";1;0;0;1
2006;"BOCA DO ACRE (AM)";"AM";"BOCA DO ACRE";16;2;0;18
2006;"BORBA (AM)";"AM";"BORBA";2;0;0;2
2006;"CAAPIRANGA (AM)";"AM";"CAAPIRANGA";4;1;1;6
2006;"CANUTAMA (AM)";"AM";"CANUTAMA";0;0;0;0
2006;"CARAUARI (AM)";"AM";"CARAUARI";9;1;0;10
2006;"CAREIRO (AM)";"AM";"CAREIRO";21;5;29;55
2006;"CAREIRO DA VARZEA (AM)";"AM";"CAREIRO DA VARZEA";8;6;9;23
2006;"COARI (AM)";"AM";"COARI";57;3;2;62
2006;"CODAJAS (AM)";"AM";"CODAJAS";2;0;0;2
2006;"EIRUNEPE (AM)";"AM";"EIRUNEPE";11;0;0;11
2006;"ENVIRA (AM)";"AM";"ENVIRA";6;0;1;7
2006;"FONTE BOA (AM)";"AM";"FONTE BOA";11;0;0;11
2006;"GUAJARA (AM)";"AM";"GUAJARA";0;0;0;0
2006;"HUMAITA (AM)";"AM";"HUMAITA";67;1;7;75
2006;"IPIXUNA (AM)";"AM";"IPIXUNA";1;0;0;1
2006;"IRANDUBA (AM)";"AM";"IRANDUBA";83;5;24;112
2006;"ITACOATIARA (AM)";"AM";"ITACOATIARA";208;15;67;290
2006;"ITAMARATI (AM)";"AM";"ITAMARATI";2;0;0;2
2006;"ITAPIRANGA (AM)";"AM";"ITAPIRANGA";1;0;0;1
2006;"JAPURA (AM)";"AM";"JAPURA";3;0;0;3
2006;"JURUA (AM)";"AM";"JURUA";4;0;0;4
2006;"JUTAI (AM)";"AM";"JUTAI";1;0;0;1
2006;"LABREA (AM)";"AM";"LABREA";10;0;1;11
2006;"MANACAPURU (AM)";"AM";"MANACAPURU";136;15;60;211
2006;"MANAQUIRI (AM)";"AM";"MANAQUIRI";2;0;0;2
2006;"MANAUS (AM)";"AM";"MANAUS";11274;1769;4529;17572
2006;"MANICORE (AM)";"AM";"MANICORE";6;1;3;10
2006;"MARAA (AM)";"AM";"MARAA";0;0;0;0
2006;"MAUES (AM)";"AM";"MAUES";22;0;2;24
2006;"NHAMUNDA (AM)";"AM";"NHAMUNDA";3;0;0;3
2006;"NOVA OLINDA DO NORTE (AM)";"AM";"NOVA OLINDA DO NORTE";5;1;2;8
2006;"NOVO AIRAO (AM)";"AM";"NOVO AIRAO";8;0;2;10
2006;"NOVO ARIPUANA (AM)";"AM";"NOVO ARIPUANA";6;0;4;10
2006;"PARINTINS (AM)";"AM";"PARINTINS";85;2;7;94
2006;"PAUINI (AM)";"AM";"PAUINI";2;1;0;3
2006;"PRESIDENTE FIGUEIREDO (AM)";"AM";"PRESIDENTE FIGUEIREDO";130;18;29;177
2006;"RIO PRETO DA EVA (AM)";"AM";"RIO PRETO DA EVA";37;5;18;60
2006;"SANTA ISABEL DO RIO NEGRO (AM)";"AM";"SANTA ISABEL DO RIO NEGRO";5;2;3;10
2006;"SANTO ANTONIO DO ICA (AM)";"AM";"SANTO ANTONIO DO ICA";5;0;0;5
2006;"SAO GABRIEL DA CACHOEIRA (AM)";"AM";"SAO GABRIEL DA CACHOEIRA";56;7;8;71
2006;"SAO PAULO DE OLIVENCA (AM)";"AM";"SAO PAULO DE OLIVENCA";2;0;0;2
2006;"SAO SEBASTIAO DO UATUMA (AM)";"AM";"SAO SEBASTIAO DO UATUMA";1;0;0;1
2006;"SILVES (AM)";"AM";"SILVES";5;2;0;7
2006;"TABATINGA (AM)";"AM";"TABATINGA";28;2;0;30
2006;"TAPAUA (AM)";"AM";"TAPAUA";1;0;1;2
2006;"TEFE (AM)";"AM";"TEFE";29;5;1;35
2006;"TONANTINS (AM)";"AM";"TONANTINS";0;1;0;1
2006;"UARINI (AM)";"AM";"UARINI";1;0;0;1
2006;"URUCARA (AM)";"AM";"URUCARA";4;1;1;6
2006;"URUCURITUBA (AM)";"AM";"URUCURITUBA";2;0;0;2
2006;"AMAPA (AP)";"AP";"AMAPA";6;1;0;7
2006;"AMAPARI (AP)";"AP";"AMAPARI";5;0;1;6
2006;"CALCOENE (AP)";"AP";"CALCOENE";1;0;1;2
2006;"CUTIAS (AP)";"AP";"CUTIAS";1;0;0;1
2006;"FERREIRA GOMES (AP)";"AP";"FERREIRA GOMES";1;0;0;1
2006;"ITAUBAL (AP)";"AP";"ITAUBAL";1;0;2;3
2006;"LARANJAL DO JARI (AP)";"AP";"LARANJAL DO JARI";44;4;5;53
2006;"MACAPA (AP)";"AP";"MACAPA";1885;157;410;2452
2006;"MAZAGAO (AP)";"AP";"MAZAGAO";32;1;6;39
2006;"OIAPOQUE (AP)";"AP";"OIAPOQUE";41;3;2;46
2006;"PORTO GRANDE (AP)";"AP";"PORTO GRANDE";15;1;6;22
2006;"PRACUUBA (AP)";"AP";"PRACUUBA";2;0;0;2
2006;"SANTANA (AP)";"AP";"SANTANA";395;20;32;447
2006;"SERRA DO NAVIO (AP)";"AP";"SERRA DO NAVIO";0;1;0;1
2006;"TARTARUGALZINHO (AP)";"AP";"TARTARUGALZINHO";6;0;0;6
2006;"VITORIA DO JARI (AP)";"AP";"VITORIA DO JARI";0;0;1;1
2006;"ABAIRA (BA)";"BA";"ABAIRA";38;6;12;56
2006;"ABARE (BA)";"BA";"ABARE";23;3;13;39
2006;"ACAJUTIBA (BA)";"BA";"ACAJUTIBA";30;6;10;46
2006;"ADUSTINA (BA)";"BA";"ADUSTINA";9;5;1;15
2006;"AGUA FRIA (BA)";"BA";"AGUA FRIA";8;6;15;29
2006;"AIQUARA (BA)";"BA";"AIQUARA";6;2;1;9
2006;"ALAGOINHAS (BA)";"BA";"ALAGOINHAS";849;112;276;1237
2006;"ALCOBACA (BA)";"BA";"ALCOBACA";20;0;4;24
2006;"ALMADINA (BA)";"BA";"ALMADINA";10;1;2;13
2006;"AMARGOSA (BA)";"BA";"AMARGOSA";181;25;38;244
2006;"AMELIA RODRIGUES (BA)";"BA";"AMELIA RODRIGUES";118;27;20;165
2006;"AMERICA DOURADA (BA)";"BA";"AMERICA DOURADA";17;5;2;24
2006;"ANAGE (BA)";"BA";"ANAGE";39;15;22;76
2006;"ANDARAI (BA)";"BA";"ANDARAI";13;4;3;20
2006;"ANDORINHA (BA)";"BA";"ANDORINHA";41;4;22;67
2006;"ANGICAL (BA)";"BA";"ANGICAL";15;6;11;32
2006;"ANGUERA (BA)";"BA";"ANGUERA";11;3;7;21
2006;"ANTAS (BA)";"BA";"ANTAS";19;5;6;30
2006;"ANTONIO CARDOSO (BA)";"BA";"ANTONIO CARDOSO";0;18;6;24
2006;"ANTONIO GONCALVES (BA)";"BA";"ANTONIO GONCALVES";14;4;6;24
2006;"APORA (BA)";"BA";"APORA";18;10;10;38
2006;"APUAREMA (BA)";"BA";"APUAREMA";19;3;6;28
2006;"ARACAS (BA)";"BA";"ARACAS";39;15;21;75
2006;"ARACATU (BA)";"BA";"ARACATU";41;7;12;60
2006;"ARACI (BA)";"BA";"ARACI";104;5;36;145
2006;"ARAMARI (BA)";"BA";"ARAMARI";13;3;2;18
2006;"ARATACA (BA)";"BA";"ARATACA";12;0;1;13
2006;"ARATUIPE (BA)";"BA";"ARATUIPE";20;0;9;29
2006;"AURELINO LEAL (BA)";"BA";"AURELINO LEAL";35;3;6;44
2006;"BAIANOPOLIS (BA)";"BA";"BAIANOPOLIS";34;4;13;51
2006;"BAIXA GRANDE (BA)";"BA";"BAIXA GRANDE";46;14;23;83
2006;"BANZAE (BA)";"BA";"BANZAE";13;3;17;33
2006;"BARRA (BA)";"BA";"BARRA";27;5;12;44
2006;"BARRA DA ESTIVA (BA)";"BA";"BARRA DA ESTIVA";126;12;29;167
2006;"BARRA DO CHOCA (BA)";"BA";"BARRA DO CHOCA";77;47;15;139
2006;"BARRA DO MENDES (BA)";"BA";"BARRA DO MENDES";38;7;4;49
2006;"BARRA DO ROCHA (BA)";"BA";"BARRA DO ROCHA";6;2;0;8
2006;"BARREIRAS (BA)";"BA";"BARREIRAS";1661;67;217;1945
2006;"BARRO ALTO (BA)";"BA";"BARRO ALTO";30;4;6;40
2006;"BARRO PRETO (BA)";"BA";"BARRO PRETO";14;1;6;21
2006;"BARROCAS (BA)";"BA";"BARROCAS";55;2;7;64
2006;"BELMONTE (BA)";"BA";"BELMONTE";32;1;4;37
2006;"BELO CAMPO (BA)";"BA";"BELO CAMPO";44;5;14;63
2006;"BIRITINGA (BA)";"BA";"BIRITINGA";15;4;16;35
2006;"BOA NOVA (BA)";"BA";"BOA NOVA";18;8;15;41
2006;"BOA VISTA DO TUPIM (BA)";"BA";"BOA VISTA DO TUPIM";41;4;6;51
2006;"BOM JESUS DA LAPA (BA)";"BA";"BOM JESUS DA LAPA";304;23;62;389
2006;"BOM JESUS DA SERRA (BA)";"BA";"BOM JESUS DA SERRA";11;14;11;36
2006;"BONINAL (BA)";"BA";"BONINAL";50;9;16;75
2006;"BONITO (BA)";"BA";"BONITO";28;1;4;33
2006;"BOQUIRA (BA)";"BA";"BOQUIRA";60;5;30;95
2006;"BOTUPORA (BA)";"BA";"BOTUPORA";20;3;16;39
2006;"BREJOES (BA)";"BA";"BREJOES";55;2;20;77
2006;"BREJOLANDIA (BA)";"BA";"BREJOLANDIA";17;4;9;30
2006;"BROTAS DE MACAUBAS (BA)";"BA";"BROTAS DE MACAUBAS";12;6;8;26
2006;"BRUMADO (BA)";"BA";"BRUMADO";803;102;151;1056
2006;"BUERAREMA (BA)";"BA";"BUERAREMA";94;3;16;113
2006;"BURITIRAMA (BA)";"BA";"BURITIRAMA";8;1;12;21
2006;"CAATIBA (BA)";"BA";"CAATIBA";5;2;0;7
2006;"CABACEIRAS DO PARAGUACU (BA)";"BA";"CABACEIRAS DO PARAGUACU";29;4;17;50
2006;"CACHOEIRA (BA)";"BA";"CACHOEIRA";65;55;50;170
2006;"CACULE (BA)";"BA";"CACULE";194;11;21;226
2006;"CAEM (BA)";"BA";"CAEM";13;3;8;24
2006;"CAETANOS (BA)";"BA";"CAETANOS";23;5;7;35
2006;"CAETITE (BA)";"BA";"CAETITE";360;30;39;429
2006;"CAFARNAUM (BA)";"BA";"CAFARNAUM";30;1;8;39
2006;"CAIRU (BA)";"BA";"CAIRU";6;4;2;12
2006;"CALDEIRAO GRANDE (BA)";"BA";"CALDEIRAO GRANDE";19;1;6;26
2006;"CAMACAN (BA)";"BA";"CAMACAN";183;15;30;228
2006;"CAMACARI (BA)";"BA";"CAMACARI";1160;220;635;2015
2006;"CAMAMU (BA)";"BA";"CAMAMU";81;16;15;112
2006;"CAMPO ALEGRE DE LOURDES (BA)";"BA";"CAMPO ALEGRE DE LOURDES";31;3;0;34
2006;"CAMPO FORMOSO (BA)";"BA";"CAMPO FORMOSO";142;11;56;209
2006;"CANAPOLIS (BA)";"BA";"CANAPOLIS";8;7;13;28
2006;"CANARANA (BA)";"BA";"CANARANA";81;5;5;91
2006;"CANAVIEIRAS (BA)";"BA";"CANAVIEIRAS";56;6;12;74
2006;"CANDEAL (BA)";"BA";"CANDEAL";16;12;1;29
2006;"CANDEIAS (BA)";"BA";"CANDEIAS";476;140;193;809
2006;"CANDIBA (BA)";"BA";"CANDIBA";36;1;15;52
2006;"CANDIDO SALES (BA)";"BA";"CANDIDO SALES";278;14;26;318
2006;"CANSANCAO (BA)";"BA";"CANSANCAO";92;10;21;123
2006;"CANUDOS (BA)";"BA";"CANUDOS";25;3;16;44
2006;"CAPELA DO ALTO ALEGRE (BA)";"BA";"CAPELA DO ALTO ALEGRE";35;8;18;61
2006;"CAPIM GROSSO (BA)";"BA";"CAPIM GROSSO";364;20;33;417
2006;"CARAIBAS (BA)";"BA";"CARAIBAS";21;10;8;39
2006;"CARAVELAS (BA)";"BA";"CARAVELAS";17;6;28;51
2006;"CARDEAL DA SILVA (BA)";"BA";"CARDEAL DA SILVA";13;5;2;20
2006;"CARINHANHA (BA)";"BA";"CARINHANHA";92;4;20;116
2006;"CASA NOVA (BA)";"BA";"CASA NOVA";202;108;88;398
2006;"CASTRO ALVES (BA)";"BA";"CASTRO ALVES";103;6;27;136
2006;"CATOLANDIA (BA)";"BA";"CATOLANDIA";3;2;2;7
2006;"CATU (BA)";"BA";"CATU";270;77;63;410
2006;"CATURAMA (BA)";"BA";"CATURAMA";10;1;8;19
2006;"CENTRAL (BA)";"BA";"CENTRAL";59;5;6;70
2006;"CHORROCHO (BA)";"BA";"CHORROCHO";8;1;3;12
2006;"CICERO DANTAS (BA)";"BA";"CICERO DANTAS";65;8;21;94
2006;"CIPO (BA)";"BA";"CIPO";35;2;0;37
2006;"COARACI (BA)";"BA";"COARACI";70;2;12;84
2006;"COCOS (BA)";"BA";"COCOS";47;2;18;67
2006;"CONCEICAO DA FEIRA (BA)";"BA";"CONCEICAO DA FEIRA";174;57;11;242
2006;"CONCEICAO DO ALMEIDA (BA)";"BA";"CONCEICAO DO ALMEIDA";71;15;10;96
2006;"CONCEICAO DO COITE (BA)";"BA";"CONCEICAO DO COITE";312;38;58;408
2006;"CONCEICAO DO JACUIPE (BA)";"BA";"CONCEICAO DO JACUIPE";135;86;7;228
2006;"CONDE (BA)";"BA";"CONDE";36;7;4;47
2006;"CONDEUBA (BA)";"BA";"CONDEUBA";80;18;29;127
2006;"CONTENDAS DO SINCORA (BA)";"BA";"CONTENDAS DO SINCORA";6;4;3;13
2006;"CORACAO DE MARIA (BA)";"BA";"CORACAO DE MARIA";77;12;30;119
2006;"CORDEIROS (BA)";"BA";"CORDEIROS";20;6;9;35
2006;"CORIBE (BA)";"BA";"CORIBE";27;10;12;49
2006;"CORONEL JOAO SA (BA)";"BA";"CORONEL JOAO SA";14;1;21;36
2006;"CORRENTINA (BA)";"BA";"CORRENTINA";81;8;37;126
2006;"COTEGIPE (BA)";"BA";"COTEGIPE";17;6;7;30
2006;"CRAVOLANDIA (BA)";"BA";"CRAVOLANDIA";13;2;3;18
2006;"CRISOPOLIS (BA)";"BA";"CRISOPOLIS";44;5;13;62
2006;"CRISTOPOLIS (BA)";"BA";"CRISTOPOLIS";35;2;14;51
2006;"CRUZ DAS ALMAS (BA)";"BA";"CRUZ DAS ALMAS";684;117;39;840
2006;"CURACA (BA)";"BA";"CURACA";36;18;19;73
2006;"DARIO MEIRA (BA)";"BA";"DARIO MEIRA";10;4;5;19
2006;"DIAS D AVILA (BA)";"BA";"DIAS D AVILA";445;42;272;759
2006;"DOM BASILIO (BA)";"BA";"DOM BASILIO";157;3;13;173
2006;"DOM MACEDO COSTA (BA)";"BA";"DOM MACEDO COSTA";10;3;4;17
2006;"ELISIO MEDRADO (BA)";"BA";"ELISIO MEDRADO";13;5;8;26
2006;"ENCRUZILHADA (BA)";"BA";"ENCRUZILHADA";55;15;13;83
2006;"ENTRE RIOS (BA)";"BA";"ENTRE RIOS";146;39;49;234
2006;"ERICO CARDOSO (BA)";"BA";"ERICO CARDOSO";23;2;9;34
2006;"ESPLANADA (BA)";"BA";"ESPLANADA";83;22;35;140
2006;"EUCLIDES DA CUNHA (BA)";"BA";"EUCLIDES DA CUNHA";181;12;85;278
2006;"EUNAPOLIS (BA)";"BA";"EUNAPOLIS";908;37;211;1156
2006;"FATIMA (BA)";"BA";"FATIMA";10;3;6;19
2006;"FEIRA DA MATA (BA)";"BA";"FEIRA DA MATA";15;4;5;24
2006;"FEIRA DE SANTANA (BA)";"BA";"FEIRA DE SANTANA";5716;575;803;7094
2006;"FILADELFIA (BA)";"BA";"FILADELFIA";59;4;10;73
2006;"FIRMINO ALVES (BA)";"BA";"FIRMINO ALVES";7;0;1;8
2006;"FLORESTA AZUL (BA)";"BA";"FLORESTA AZUL";18;1;0;19
2006;"FORMOSA DO RIO PRETO (BA)";"BA";"FORMOSA DO RIO PRETO";53;1;7;61
2006;"GANDU (BA)";"BA";"GANDU";197;9;15;221
2006;"GAVIAO (BA)";"BA";"GAVIAO";12;3;3;18
2006;"GENTIO DO OURO (BA)";"BA";"GENTIO DO OURO";7;2;1;10
2006;"GLORIA (BA)";"BA";"GLORIA";39;17;25;81
2006;"GONGOGI (BA)";"BA";"GONGOGI";7;1;1;9
2006;"GOVERNADOR MANGABEIRA (BA)";"BA";"GOVERNADOR MANGABEIRA";119;18;26;163
2006;"GUAJERU (BA)";"BA";"GUAJERU";10;15;7;32
2006;"GUANAMBI (BA)";"BA";"GUANAMBI";898;47;114;1059
2006;"GUARATINGA (BA)";"BA";"GUARATINGA";43;4;18;65
2006;"HELIOPOLIS (BA)";"BA";"HELIOPOLIS";17;2;2;21
2006;"IACU (BA)";"BA";"IACU";86;6;12;104
2006;"IBIASSUCE (BA)";"BA";"IBIASSUCE";44;11;4;59
2006;"IBICARAI (BA)";"BA";"IBICARAI";106;8;15;129
2006;"IBICOARA (BA)";"BA";"IBICOARA";114;10;33;157
2006;"IBICUI (BA)";"BA";"IBICUI";28;4;6;38
2006;"IBIPEBA (BA)";"BA";"IBIPEBA";29;5;3;37
2006;"IBIPITANGA (BA)";"BA";"IBIPITANGA";42;10;24;76
2006;"IBIQUERA (BA)";"BA";"IBIQUERA";4;1;0;5
2006;"IBIRAPITANGA (BA)";"BA";"IBIRAPITANGA";34;1;4;39
2006;"IBIRAPUA (BA)";"BA";"IBIRAPUA";20;3;3;26
2006;"IBIRATAIA (BA)";"BA";"IBIRATAIA";72;18;4;94
2006;"IBITIARA (BA)";"BA";"IBITIARA";56;14;16;86
2006;"IBITITA (BA)";"BA";"IBITITA";29;1;6;36
2006;"IBOTIRAMA (BA)";"BA";"IBOTIRAMA";138;22;16;176
2006;"ICHU (BA)";"BA";"ICHU";13;6;5;24
2006;"IGAPORA (BA)";"BA";"IGAPORA";79;10;11;100
2006;"IGRAPIUNA (BA)";"BA";"IGRAPIUNA";24;6;14;44
2006;"IGUAI (BA)";"BA";"IGUAI";44;14;22;80
2006;"ILHEUS (BA)";"BA";"ILHEUS";447;91;236;774
2006;"INHAMBUPE (BA)";"BA";"INHAMBUPE";103;52;46;201
2006;"IPECAETA (BA)";"BA";"IPECAETA";3;5;30;38
2006;"IPIAU (BA)";"BA";"IPIAU";283;17;14;314
2006;"IPIRA (BA)";"BA";"IPIRA";274;22;56;352
2006;"IPUPIARA (BA)";"BA";"IPUPIARA";26;8;1;35
2006;"IRAJUBA (BA)";"BA";"IRAJUBA";18;4;13;35
2006;"IRAMAIA (BA)";"BA";"IRAMAIA";16;1;5;22
2006;"IRAQUARA (BA)";"BA";"IRAQUARA";81;6;11;98
2006;"IRARA (BA)";"BA";"IRARA";84;24;38;146
2006;"IRECE (BA)";"BA";"IRECE";515;25;35;575
2006;"ITABELA (BA)";"BA";"ITABELA";190;2;34;226
2006;"ITABERABA (BA)";"BA";"ITABERABA";326;34;35;395
2006;"ITABUNA (BA)";"BA";"ITABUNA";1322;46;536;1904
2006;"ITACARE (BA)";"BA";"ITACARE";6;12;2;20
2006;"ITAETE (BA)";"BA";"ITAETE";47;4;10;61
2006;"ITAGI (BA)";"BA";"ITAGI";21;2;2;25
2006;"ITAGIBA (BA)";"BA";"ITAGIBA";17;8;6;31
2006;"ITAGIMIRIM (BA)";"BA";"ITAGIMIRIM";37;1;3;41
2006;"ITAGUACU DA BAHIA (BA)";"BA";"ITAGUACU DA BAHIA";16;0;6;22
2006;"ITAJU DO COLONIA (BA)";"BA";"ITAJU DO COLONIA";8;0;4;12
2006;"ITAJUIPE (BA)";"BA";"ITAJUIPE";59;2;10;71
2006;"ITAMARAJU (BA)";"BA";"ITAMARAJU";307;10;99;416
2006;"ITAMARI (BA)";"BA";"ITAMARI";31;1;0;32
2006;"ITAMBE (BA)";"BA";"ITAMBE";44;9;5;58
2006;"ITANAGRA (BA)";"BA";"ITANAGRA";12;0;0;12
2006;"ITANHEM (BA)";"BA";"ITANHEM";29;3;11;43
2006;"ITAPARICA (BA)";"BA";"ITAPARICA";17;22;21;60
2006;"ITAPE (BA)";"BA";"ITAPE";13;0;0;13
2006;"ITAPEBI (BA)";"BA";"ITAPEBI";40;1;3;44
2006;"ITAPETINGA (BA)";"BA";"ITAPETINGA";427;31;62;520
2006;"ITAPICURU (BA)";"BA";"ITAPICURU";18;11;24;53
2006;"ITAPITANGA (BA)";"BA";"ITAPITANGA";9;2;0;11
2006;"ITAQUARA (BA)";"BA";"ITAQUARA";24;1;0;25
2006;"ITARANTIM (BA)";"BA";"ITARANTIM";54;2;2;58
2006;"ITATIM (BA)";"BA";"ITATIM";90;8;16;114
2006;"ITIRUCU (BA)";"BA";"ITIRUCU";95;3;6;104
2006;"ITIUBA (BA)";"BA";"ITIUBA";45;15;38;98
2006;"ITORORO (BA)";"BA";"ITORORO";79;7;12;98
2006;"ITUACU (BA)";"BA";"ITUACU";91;4;6;101
2006;"ITUBERA (BA)";"BA";"ITUBERA";110;10;15;135
2006;"IUIU (BA)";"BA";"IUIU";20;3;1;24
2006;"JABORANDI (BA)";"BA";"JABORANDI";31;1;14;46
2006;"JACARACI (BA)";"BA";"JACARACI";25;7;17;49
2006;"JACOBINA (BA)";"BA";"JACOBINA";564;50;122;736
2006;"JAGUAQUARA (BA)";"BA";"JAGUAQUARA";376;6;40;422
2006;"JAGUARARI (BA)";"BA";"JAGUARARI";115;29;43;187
2006;"JAGUARIPE (BA)";"BA";"JAGUARIPE";30;5;9;44
2006;"JANDAIRA (BA)";"BA";"JANDAIRA";14;0;5;19
2006;"JEQUIE (BA)";"BA";"JEQUIE";1154;46;240;1440
2006;"JEREMOABO (BA)";"BA";"JEREMOABO";80;13;22;115
2006;"JIQUIRICA (BA)";"BA";"JIQUIRICA";25;10;13;48
2006;"JITAUNA (BA)";"BA";"JITAUNA";24;5;3;32
2006;"JOAO DOURADO (BA)";"BA";"JOAO DOURADO";61;6;9;76
2006;"JUAZEIRO (BA)";"BA";"JUAZEIRO";2138;407;552;3097
2006;"JUCURUCU (BA)";"BA";"JUCURUCU";11;0;2;13
2006;"JUSSARA (BA)";"BA";"JUSSARA";32;5;13;50
2006;"JUSSARI (BA)";"BA";"JUSSARI";10;1;1;12
2006;"JUSSIAPE (BA)";"BA";"JUSSIAPE";38;6;3;47
2006;"LAFAIETE COUTINHO (BA)";"BA";"LAFAIETE COUTINHO";7;0;3;10
2006;"LAGEDO DO TABOCAL (BA)";"BA";"LAGEDO DO TABOCAL";18;1;6;25
2006;"LAGOA REAL (BA)";"BA";"LAGOA REAL";21;2;9;32
2006;"LAJE (BA)";"BA";"LAJE";89;18;20;127
2006;"LAJEDAO (BA)";"BA";"LAJEDAO";6;0;6;12
2006;"LAJEDINHO (BA)";"BA";"LAJEDINHO";7;2;1;10
2006;"LAMARAO (BA)";"BA";"LAMARAO";2;1;1;4
2006;"LAPAO (BA)";"BA";"LAPAO";69;7;22;98
2006;"LAURO DE FREITAS (BA)";"BA";"LAURO DE FREITAS";1410;300;258;1968
2006;"LENCOIS (BA)";"BA";"LENCOIS";9;8;1;18
2006;"LICINIO DE ALMEIDA (BA)";"BA";"LICINIO DE ALMEIDA";82;8;10;100
2006;"LIVRAMENTO DO BRUMADO (BA)";"BA";"LIVRAMENTO DO BRUMADO";249;35;47;331
2006;"LUIZ EDUARDO MAGALHAES (BA)";"BA";"LUIZ EDUARDO MAGALHAES";616;22;35;673
2006;"MACAJUBA (BA)";"BA";"MACAJUBA";11;10;20;41
2006;"MACAUBAS (BA)";"BA";"MACAUBAS";139;12;208;359
2006;"MACURURE (BA)";"BA";"MACURURE";6;2;2;10
2006;"MADRE DE DEUS (BA)";"BA";"MADRE DE DEUS";59;10;20;89
2006;"MAETINGA (BA)";"BA";"MAETINGA";15;4;7;26
2006;"MAIQUINIQUE (BA)";"BA";"MAIQUINIQUE";30;4;6;40
2006;"MAIRI (BA)";"BA";"MAIRI";40;9;25;74
2006;"MALHADA (BA)";"BA";"MALHADA";16;3;6;25
2006;"MALHADA DAS PEDRAS (BA)";"BA";"MALHADA DAS PEDRAS";44;15;12;71
2006;"MANOEL VITORINO (BA)";"BA";"MANOEL VITORINO";34;5;5;44
2006;"MANSIDAO (BA)";"BA";"MANSIDAO";3;0;0;3
2006;"MARACANI (BA)";"BA";"MARACANI";62;4;9;75
2006;"MARACAS (BA)";"BA";"MARACAS";138;8;28;174
2006;"MARAGOGIPE (BA)";"BA";"MARAGOGIPE";100;11;19;130
2006;"MARAU (BA)";"BA";"MARAU";4;0;0;4
2006;"MARCIONILIO SOUZA (BA)";"BA";"MARCIONILIO SOUZA";14;4;9;27
2006;"MASCOTE (BA)";"BA";"MASCOTE";31;2;4;37
2006;"MATA DE SAO JOAO (BA)";"BA";"MATA DE SAO JOAO";139;30;32;201
2006;"MATINA (BA)";"BA";"MATINA";10;1;7;18
2006;"MEDEIROS NETO (BA)";"BA";"MEDEIROS NETO";59;8;10;77
2006;"MIGUEL CALMON (BA)";"BA";"MIGUEL CALMON";81;4;22;107
2006;"MILAGRES (BA)";"BA";"MILAGRES";106;5;10;121
2006;"MIRANGABA (BA)";"BA";"MIRANGABA";26;6;12;44
2006;"MIRANTE (BA)";"BA";"MIRANTE";21;9;10;40
2006;"MONTE SANTO (BA)";"BA";"MONTE SANTO";81;8;54;143
2006;"MORPARA (BA)";"BA";"MORPARA";5;3;1;9
2006;"MORRO DO CHAPEU (BA)";"BA";"MORRO DO CHAPEU";77;16;12;105
2006;"MORTUGABA (BA)";"BA";"MORTUGABA";38;5;7;50
2006;"MUCUGE (BA)";"BA";"MUCUGE";58;4;20;82
2006;"MUCURI (BA)";"BA";"MUCURI";57;12;29;98
2006;"MULUNGU DO MORRO (BA)";"BA";"MULUNGU DO MORRO";24;0;1;25
2006;"MUNDO NOVO (BA)";"BA";"MUNDO NOVO";46;6;20;72
2006;"MUNIZ FERREIRA (BA)";"BA";"MUNIZ FERREIRA";47;53;6;106
2006;"MUQUEM DO SAO FRANCISCO (BA)";"BA";"MUQUEM DO SAO FRANCISCO";9;6;8;23
2006;"MURITIBA (BA)";"BA";"MURITIBA";274;26;17;317
2006;"MUTUIPE (BA)";"BA";"MUTUIPE";82;37;21;140
2006;"NAZARE (BA)";"BA";"NAZARE";165;30;19;214
2006;"NILO PECANHA (BA)";"BA";"NILO PECANHA";24;10;7;41
2006;"NORDESTINA (BA)";"BA";"NORDESTINA";19;3;11;33
2006;"NOVA CANAA (BA)";"BA";"NOVA CANAA";34;2;8;44
2006;"NOVA FATIMA (BA)";"BA";"NOVA FATIMA";36;1;4;41
2006;"NOVA IBIA (BA)";"BA";"NOVA IBIA";15;0;4;19
2006;"NOVA ITARANA (BA)";"BA";"NOVA ITARANA";17;3;4;24
2006;"NOVA REDENCAO (BA)";"BA";"NOVA REDENCAO";9;4;2;15
2006;"NOVA SOURE (BA)";"BA";"NOVA SOURE";32;3;10;45
2006;"NOVA VICOSA (BA)";"BA";"NOVA VICOSA";62;12;28;102
2006;"NOVO HORIZONTE (BA)";"BA";"NOVO HORIZONTE";22;3;6;31
2006;"NOVO TRIUNFO (BA)";"BA";"NOVO TRIUNFO";2;1;1;4
2006;"OLINDINA (BA)";"BA";"OLINDINA";69;16;30;115
2006;"OLIVEIRA DOS BREJINHOS (BA)";"BA";"OLIVEIRA DOS BREJINHOS";41;15;13;69
2006;"OURICANGAS (BA)";"BA";"OURICANGAS";19;9;12;40
2006;"OUROLANDIA (BA)";"BA";"OUROLANDIA";28;8;3;39
2006;"PALMAS DE MONTE ALTO (BA)";"BA";"PALMAS DE MONTE ALTO";37;5;15;57
2006;"PALMEIRAS (BA)";"BA";"PALMEIRAS";21;8;2;31
2006;"PARAMIRIM (BA)";"BA";"PARAMIRIM";113;3;42;158
2006;"PARATINGA (BA)";"BA";"PARATINGA";28;14;27;69
2006;"PARIPIRANGA (BA)";"BA";"PARIPIRANGA";62;3;21;86
2006;"PAU BRASIL (BA)";"BA";"PAU BRASIL";25;3;8;36
2006;"PAULO AFONSO (BA)";"BA";"PAULO AFONSO";686;173;202;1061
2006;"PE DE SERRA (BA)";"BA";"PE DE SERRA";17;2;8;27
2006;"PEDRAO (BA)";"BA";"PEDRAO";13;7;4;24
2006;"PEDRO ALEXANDRE (BA)";"BA";"PEDRO ALEXANDRE";1;1;1;3
2006;"PIATA (BA)";"BA";"PIATA";71;14;20;105
2006;"PILAO ARCADO (BA)";"BA";"PILAO ARCADO";24;13;1;38
2006;"PINDAI (BA)";"BA";"PINDAI";24;7;14;45
2006;"PINDOBACU (BA)";"BA";"PINDOBACU";28;12;16;56
2006;"PINTADAS (BA)";"BA";"PINTADAS";32;7;23;62
2006;"PIRAI DO NORTE (BA)";"BA";"PIRAI DO NORTE";8;1;0;9
2006;"PIRIPA (BA)";"BA";"PIRIPA";48;15;14;77
2006;"PIRITIBA (BA)";"BA";"PIRITIBA";33;9;12;54
2006;"PLANALTINO (BA)";"BA";"PLANALTINO";8;0;6;14
2006;"PLANALTO (BA)";"BA";"PLANALTO";84;7;32;123
2006;"POCOES (BA)";"BA";"POCOES";230;69;47;346
2006;"POJUCA (BA)";"BA";"POJUCA";241;36;59;336
2006;"PONTO NOVO (BA)";"BA";"PONTO NOVO";42;1;13;56
2006;"PORTO SEGURO (BA)";"BA";"PORTO SEGURO";467;130;472;1069
2006;"POTIRIGUA (BA)";"BA";"POTIRIGUA";21;3;4;28
2006;"PRADO (BA)";"BA";"PRADO";33;10;14;57
2006;"PRESIDENTE DUTRA (BA)";"BA";"PRESIDENTE DUTRA";36;3;3;42
2006;"PRESIDENTE JANIO QUADROS (BA)";"BA";"PRESIDENTE JANIO QUADROS";15;8;5;28
2006;"PRESIDENTE TANCREDO NEVES (BA)";"BA";"PRESIDENTE TANCREDO NEVES";45;20;6;71
2006;"QUEIMADAS (BA)";"BA";"QUEIMADAS";62;7;57;126
2006;"QUIJINGUE (BA)";"BA";"QUIJINGUE";34;7;35;76
2006;"QUIXABEIRA (BA)";"BA";"QUIXABEIRA";21;2;8;31
2006;"RAFAEL JAMBEIRO (BA)";"BA";"RAFAEL JAMBEIRO";32;12;28;72
2006;"REMANSO (BA)";"BA";"REMANSO";137;19;8;164
2006;"RETIROLANDIA (BA)";"BA";"RETIROLANDIA";37;2;6;45
2006;"RIACHAO DAS NEVES (BA)";"BA";"RIACHAO DAS NEVES";24;11;8;43
2006;"RIACHAO DO JACUIPE (BA)";"BA";"RIACHAO DO JACUIPE";165;15;25;205
2006;"RIACHO DE SANTANA (BA)";"BA";"RIACHO DE SANTANA";142;14;31;187
2006;"RIBEIRA DO AMPARO (BA)";"BA";"RIBEIRA DO AMPARO";8;6;18;32
2006;"RIBEIRA DO POMBAL (BA)";"BA";"RIBEIRA DO POMBAL";198;31;82;311
2006;"RIBEIRAO DO LARGO (BA)";"BA";"RIBEIRAO DO LARGO";14;8;4;26
2006;"RIO DE CONTAS (BA)";"BA";"RIO DE CONTAS";55;10;14;79
2006;"RIO DO ANTONIO (BA)";"BA";"RIO DO ANTONIO";34;10;3;47
2006;"RIO DO PIRES (BA)";"BA";"RIO DO PIRES";32;6;9;47
2006;"RIO REAL (BA)";"BA";"RIO REAL";109;6;34;149
2006;"RODELAS (BA)";"BA";"RODELAS";9;3;1;13
2006;"RUY BARBOSA (BA)";"BA";"RUY BARBOSA";79;13;14;106
2006;"SALINAS DA MARGARIDA (BA)";"BA";"SALINAS DA MARGARIDA";15;0;3;18
2006;"SALVADOR (BA)";"BA";"SALVADOR";11300;2713;5755;19768
2006;"SANTA BARBARA (BA)";"BA";"SANTA BARBARA";24;4;20;48
2006;"SANTA BRIGIDA (BA)";"BA";"SANTA BRIGIDA";10;9;10;29
2006;"SANTA CRUZ CABRALIA (BA)";"BA";"SANTA CRUZ CABRALIA";44;12;11;67
2006;"SANTA CRUZ DA VITORIA (BA)";"BA";"SANTA CRUZ DA VITORIA";8;2;1;11
2006;"SANTA INES (BA)";"BA";"SANTA INES";40;4;3;47
2006;"SANTA LUZIA (BA)";"BA";"SANTA LUZIA";23;2;2;27
2006;"SANTA MARIA DA VITORIA (BA)";"BA";"SANTA MARIA DA VITORIA";227;22;29;278
2006;"SANTA RITA DE CASSIA (BA)";"BA";"SANTA RITA DE CASSIA";44;4;7;55
2006;"SANTA TERESINHA (BA)";"BA";"SANTA TERESINHA";22;1;10;33
2006;"SANTALUZ (BA)";"BA";"SANTALUZ";128;7;18;153
2006;"SANTANA (BA)";"BA";"SANTANA";109;8;42;159
2006;"SANTANOPOLIS (BA)";"BA";"SANTANOPOLIS";13;7;6;26
2006;"SANTO AMARO (BA)";"BA";"SANTO AMARO";158;69;252;479
2006;"SANTO ANTONIO DE JESUS (BA)";"BA";"SANTO ANTONIO DE JESUS";1638;94;117;1849
2006;"SANTO ESTEVAO (BA)";"BA";"SANTO ESTEVAO";157;60;26;243
2006;"SAO DESIDERIO (BA)";"BA";"SAO DESIDERIO";132;5;21;158
2006;"SAO DOMINGOS (BA)";"BA";"SAO DOMINGOS";24;0;5;29
2006;"SAO FELIPE (BA)";"BA";"SAO FELIPE";129;20;19;168
2006;"SAO FELIX (BA)";"BA";"SAO FELIX";40;14;11;65
2006;"SAO FELIX DO CORIBE (BA)";"BA";"SAO FELIX DO CORIBE";81;8;12;101
2006;"SAO FRANCISCO DO CONDE (BA)";"BA";"SAO FRANCISCO DO CONDE";73;31;47;151
2006;"SAO GABRIEL (BA)";"BA";"SAO GABRIEL";24;5;4;33
2006;"SAO GONCALO DOS CAMPOS (BA)";"BA";"SAO GONCALO DOS CAMPOS";52;106;24;182
2006;"SAO JOSE DA VITORIA (BA)";"BA";"SAO JOSE DA VITORIA";5;0;3;8
2006;"SAO JOSE DO JACUIPE (BA)";"BA";"SAO JOSE DO JACUIPE";48;4;5;57
2006;"SAO MIGUEL DAS MATAS (BA)";"BA";"SAO MIGUEL DAS MATAS";30;3;2;35
2006;"SAO SEBASTIAO DO PASSE (BA)";"BA";"SAO SEBASTIAO DO PASSE";132;52;93;277
2006;"SAPEACU (BA)";"BA";"SAPEACU";71;37;18;126
2006;"SATIRO DIAS (BA)";"BA";"SATIRO DIAS";10;8;5;23
2006;"SAUBARA (BA)";"BA";"SAUBARA";12;8;1;21
2006;"SAUDE (BA)";"BA";"SAUDE";21;7;6;34
2006;"SEABRA (BA)";"BA";"SEABRA";219;47;70;336
2006;"SEBASTIAO LARANJEIRAS (BA)";"BA";"SEBASTIAO LARANJEIRAS";6;3;13;22
2006;"SENHOR DO BONFIM (BA)";"BA";"SENHOR DO BONFIM";443;70;130;643
2006;"SENTO SE (BA)";"BA";"SENTO SE";40;3;13;56
2006;"SERRA DO RAMALHO (BA)";"BA";"SERRA DO RAMALHO";24;17;12;53
2006;"SERRA DOURADA (BA)";"BA";"SERRA DOURADA";26;5;15;46
2006;"SERRA PRETA (BA)";"BA";"SERRA PRETA";21;9;30;60
2006;"SERRINHA (BA)";"BA";"SERRINHA";418;44;119;581
2006;"SERROLANDIA (BA)";"BA";"SERROLANDIA";29;15;11;55
2006;"SIMOES FILHO (BA)";"BA";"SIMOES FILHO";1586;239;479;2304
2006;"SITIO DO MATO (BA)";"BA";"SITIO DO MATO";17;5;11;33
2006;"SITIO DO QUINTO (BA)";"BA";"SITIO DO QUINTO";7;2;6;15
2006;"SOBRADINHO (BA)";"BA";"SOBRADINHO";62;10;13;85
2006;"SOUTO SOARES (BA)";"BA";"SOUTO SOARES";52;0;16;68
2006;"TABOCAS DO BREJO VELHO (BA)";"BA";"TABOCAS DO BREJO VELHO";11;1;7;19
2006;"TANHACU (BA)";"BA";"TANHACU";87;13;14;114
2006;"TANQUE NOVO (BA)";"BA";"TANQUE NOVO";185;5;22;212
2006;"TANQUINHO (BA)";"BA";"TANQUINHO";16;7;6;29
2006;"TAPEROA (BA)";"BA";"TAPEROA";74;18;8;100
2006;"TAPIRAMUTA (BA)";"BA";"TAPIRAMUTA";26;4;2;32
2006;"TEIXEIRA DE FREITAS (BA)";"BA";"TEIXEIRA DE FREITAS";859;43;212;1114
2006;"TEODORO SAMPAIO (BA)";"BA";"TEODORO SAMPAIO";8;4;7;19
2006;"TEOFILANDIA (BA)";"BA";"TEOFILANDIA";78;8;13;99
2006;"TEOLANDIA (BA)";"BA";"TEOLANDIA";82;7;5;94
2006;"TERRA NOVA (BA)";"BA";"TERRA NOVA";7;3;14;24
2006;"TREMEDAL (BA)";"BA";"TREMEDAL";20;4;9;33
2006;"TUCANO (BA)";"BA";"TUCANO";182;19;70;271
2006;"UAUA (BA)";"BA";"UAUA";65;4;12;81
2006;"UBAIRA (BA)";"BA";"UBAIRA";62;7;25;94
2006;"UBAITABA (BA)";"BA";"UBAITABA";127;5;10;142
2006;"UBATA (BA)";"BA";"UBATA";166;11;6;183
2006;"UIBAI (BA)";"BA";"UIBAI";32;1;0;33
2006;"UMBURANAS (BA)";"BA";"UMBURANAS";14;6;9;29
2006;"UNA (BA)";"BA";"UNA";34;3;12;49
2006;"URANDI (BA)";"BA";"URANDI";59;5;16;80
2006;"URUCUCA (BA)";"BA";"URUCUCA";71;2;4;77
2006;"UTINGA (BA)";"BA";"UTINGA";37;5;6;48
2006;"VALENCA (BA)";"BA";"VALENCA";460;63;52;575
2006;"VALENTE (BA)";"BA";"VALENTE";88;8;18;114
2006;"VARZEA DA ROCA (BA)";"BA";"VARZEA DA ROCA";30;7;9;46
2006;"VARZEA DO POCO (BA)";"BA";"VARZEA DO POCO";39;9;8;56
2006;"VARZEA NOVA (BA)";"BA";"VARZEA NOVA";44;3;10;57
2006;"VARZEDO (BA)";"BA";"VARZEDO";39;5;5;49
2006;"VERA CRUZ (BA)";"BA";"VERA CRUZ";100;104;22;226
2006;"VEREDA (BA)";"BA";"VEREDA";7;1;1;9
2006;"VITORIA DA CONQUISTA (BA)";"BA";"VITORIA DA CONQUISTA";2525;255;907;3687
2006;"WAGNER (BA)";"BA";"WAGNER";13;1;5;19
2006;"WANDERLEY (BA)";"BA";"WANDERLEY";29;2;12;43
2006;"WENCESLAU GUIMARAES (BA)";"BA";"WENCESLAU GUIMARAES";69;5;7;81
2006;"XIQUE XIQUE (BA)";"BA";"XIQUE XIQUE";78;6;8;92
2006;"ABAIARA (CE)";"CE";"ABAIARA";7;12;3;22
2006;"ACARAPE (CE)";"CE";"ACARAPE";68;17;30;115
2006;"ACARAU (CE)";"CE";"ACARAU";124;9;30;163
2006;"ACOPIARA (CE)";"CE";"ACOPIARA";187;10;17;214
2006;"AIUABA (CE)";"CE";"AIUABA";9;1;0;10
2006;"ALCANTARAS (CE)";"CE";"ALCANTARAS";29;1;3;33
2006;"ALTANEIRA (CE)";"CE";"ALTANEIRA";12;5;1;18
2006;"ALTO SANTO (CE)";"CE";"ALTO SANTO";89;5;10;104
2006;"AMONTADA (CE)";"CE";"AMONTADA";106;7;6;119
2006;"ANTONINA DO NORTE (CE)";"CE";"ANTONINA DO NORTE";25;1;0;26
2006;"APUIARES (CE)";"CE";"APUIARES";48;8;0;56
2006;"AQUIRAZ (CE)";"CE";"AQUIRAZ";298;66;32;396
2006;"ARACATI (CE)";"CE";"ARACATI";321;35;58;414
2006;"ARACOIABA (CE)";"CE";"ARACOIABA";70;7;8;85
2006;"ARARENDA (CE)";"CE";"ARARENDA";14;3;1;18
2006;"ARARIPE (CE)";"CE";"ARARIPE";42;24;8;74
2006;"ARATUBA (CE)";"CE";"ARATUBA";37;3;5;45
2006;"ARNEIROZ (CE)";"CE";"ARNEIROZ";20;2;0;22
2006;"ASSARE (CE)";"CE";"ASSARE";55;9;0;64
2006;"AURORA (CE)";"CE";"AURORA";52;15;4;71
2006;"BAIXIO (CE)";"CE";"BAIXIO";3;5;2;10
2006;"BANABUIU (CE)";"CE";"BANABUIU";56;7;9;72
2006;"BARBALHA (CE)";"CE";"BARBALHA";162;21;39;222
2006;"BARREIRA (CE)";"CE";"BARREIRA";75;4;6;85
2006;"BARRO (CE)";"CE";"BARRO";35;15;9;59
2006;"BARROQUINHA (CE)";"CE";"BARROQUINHA";12;3;0;15
2006;"BATURITE (CE)";"CE";"BATURITE";144;22;21;187
2006;"BEBERIBE (CE)";"CE";"BEBERIBE";105;33;27;165
2006;"BELA CRUZ (CE)";"CE";"BELA CRUZ";56;6;6;68
2006;"BOA VIAGEM (CE)";"CE";"BOA VIAGEM";286;11;25;322
2006;"BREJO SANTO (CE)";"CE";"BREJO SANTO";196;40;22;258
2006;"CAMOCIM (CE)";"CE";"CAMOCIM";98;19;10;127
2006;"CAMPOS SALES (CE)";"CE";"CAMPOS SALES";143;18;20;181
2006;"CANINDE (CE)";"CE";"CANINDE";331;13;56;400
2006;"CAPISTRANO (CE)";"CE";"CAPISTRANO";30;4;10;44
2006;"CARIDADE (CE)";"CE";"CARIDADE";37;4;6;47
2006;"CARIRE (CE)";"CE";"CARIRE";27;6;3;36
2006;"CARIRIACU (CE)";"CE";"CARIRIACU";38;5;4;47
2006;"CARIUS (CE)";"CE";"CARIUS";34;11;1;46
2006;"CARNAUBAL (CE)";"CE";"CARNAUBAL";49;17;5;71
2006;"CASCAVEL (CE)";"CE";"CASCAVEL";295;27;51;373
2006;"CATARINA (CE)";"CE";"CATARINA";31;4;0;35
2006;"CATUNDA (CE)";"CE";"CATUNDA";16;6;2;24
2006;"CAUCAIA (CE)";"CE";"CAUCAIA";802;71;296;1169
2006;"CEDRO (CE)";"CE";"CEDRO";69;14;20;103
2006;"CHAVAL (CE)";"CE";"CHAVAL";23;4;3;30
2006;"CHORO (CE)";"CE";"CHORO";22;6;8;36
2006;"CHOROZINHO (CE)";"CE";"CHOROZINHO";66;5;29;100
2006;"COREAU (CE)";"CE";"COREAU";61;8;9;78
2006;"CRATEUS (CE)";"CE";"CRATEUS";194;9;26;229
2006;"CRATO (CE)";"CE";"CRATO";609;38;59;706
2006;"CROATA (CE)";"CE";"CROATA";33;5;2;40
2006;"CRUZ (CE)";"CE";"CRUZ";81;21;32;134
2006;"DEPUTADO IRAPUAN PINHEIRO (CE)";"CE";"DEPUTADO IRAPUAN PINHEIRO";15;4;2;21
2006;"ERERE (CE)";"CE";"ERERE";2;2;0;4
2006;"EUSEBIO (CE)";"CE";"EUSEBIO";605;10;44;659
2006;"FARIAS BRITO (CE)";"CE";"FARIAS BRITO";49;27;3;79
2006;"FORQUILHA (CE)";"CE";"FORQUILHA";68;17;13;98
2006;"FORTALEZA (CE)";"CE";"FORTALEZA";16080;2078;4628;22786
2006;"FORTIM (CE)";"CE";"FORTIM";16;22;5;43
2006;"FRECHEIRINHA (CE)";"CE";"FRECHEIRINHA";50;9;16;75
2006;"GENERAL SAMPAIO (CE)";"CE";"GENERAL SAMPAIO";19;1;1;21
2006;"GRACA (CE)";"CE";"GRACA";13;5;4;22
2006;"GRANJA (CE)";"CE";"GRANJA";118;18;11;147
2006;"GRANJEIRO (CE)";"CE";"GRANJEIRO";3;1;0;4
2006;"GROAIRAS (CE)";"CE";"GROAIRAS";39;19;5;63
2006;"GUAIUBA (CE)";"CE";"GUAIUBA";41;21;6;68
2006;"GUARACIABA DO NORTE (CE)";"CE";"GUARACIABA DO NORTE";212;3;13;228
2006;"GUARAMIRANGA (CE)";"CE";"GUARAMIRANGA";17;1;1;19
2006;"HIDROLANDIA (CE)";"CE";"HIDROLANDIA";87;13;7;107
2006;"HORIZONTE (CE)";"CE";"HORIZONTE";241;34;51;326
2006;"IBARETAMA (CE)";"CE";"IBARETAMA";32;5;13;50
2006;"IBIAPINA (CE)";"CE";"IBIAPINA";95;6;11;112
2006;"IBICUITINGA (CE)";"CE";"IBICUITINGA";36;1;7;44
2006;"ICAPUI (CE)";"CE";"ICAPUI";55;16;28;99
2006;"ICO (CE)";"CE";"ICO";199;42;36;277
2006;"IGUATU (CE)";"CE";"IGUATU";633;47;70;750
2006;"INDEPENDENCIA (CE)";"CE";"INDEPENDENCIA";125;3;9;137
2006;"IPAPORANGA (CE)";"CE";"IPAPORANGA";13;0;0;13
2006;"IPAUMIRIM (CE)";"CE";"IPAUMIRIM";136;15;17;168
2006;"IPU (CE)";"CE";"IPU";230;23;21;274
2006;"IPUEIRAS (CE)";"CE";"IPUEIRAS";49;5;2;56
2006;"IRACEMA (CE)";"CE";"IRACEMA";53;6;4;63
2006;"IRAUCUBA (CE)";"CE";"IRAUCUBA";66;8;7;81
2006;"ITAICABA (CE)";"CE";"ITAICABA";25;4;5;34
2006;"ITAITINGA (CE)";"CE";"ITAITINGA";132;30;13;175
2006;"ITAPAGE (CE)";"CE";"ITAPAGE";192;17;10;219
2006;"ITAPIPOCA (CE)";"CE";"ITAPIPOCA";452;25;14;491
2006;"ITAPIUNA (CE)";"CE";"ITAPIUNA";41;6;12;59
2006;"ITAREMA (CE)";"CE";"ITAREMA";79;13;17;109
2006;"ITATIRA (CE)";"CE";"ITATIRA";65;3;4;72
2006;"JAGUARETAMA (CE)";"CE";"JAGUARETAMA";60;3;3;66
2006;"JAGUARIBARA (CE)";"CE";"JAGUARIBARA";47;6;6;59
2006;"JAGUARIBE (CE)";"CE";"JAGUARIBE";227;17;19;263
2006;"JAGUARUANA (CE)";"CE";"JAGUARUANA";146;7;5;158
2006;"JARDIM (CE)";"CE";"JARDIM";42;19;7;68
2006;"JATI (CE)";"CE";"JATI";6;3;0;9
2006;"JIJOCA DE JERICOACOARA (CE)";"CE";"JIJOCA DE JERICOACOARA";34;6;3;43
2006;"JUAZEIRO DO NORTE (CE)";"CE";"JUAZEIRO DO NORTE";1120;101;177;1398
2006;"JUCAS (CE)";"CE";"JUCAS";30;3;12;45
2006;"LAVRAS DA MANGABEIRA (CE)";"CE";"LAVRAS DA MANGABEIRA";43;6;12;61
2006;"LIMOEIRO DO NORTE (CE)";"CE";"LIMOEIRO DO NORTE";496;16;72;584
2006;"MADALENA (CE)";"CE";"MADALENA";56;3;9;68
2006;"MARACANAU (CE)";"CE";"MARACANAU";745;121;150;1016
2006;"MARANGUAPE (CE)";"CE";"MARANGUAPE";408;34;96;538
2006;"MARCO (CE)";"CE";"MARCO";124;2;8;134
2006;"MARTINOPOLE (CE)";"CE";"MARTINOPOLE";11;4;1;16
2006;"MASSAPE (CE)";"CE";"MASSAPE";54;6;24;84
2006;"MAURITI (CE)";"CE";"MAURITI";42;15;5;62
2006;"MERUOCA (CE)";"CE";"MERUOCA";23;1;4;28
2006;"MILAGRES (CE)";"CE";"MILAGRES";58;18;8;84
2006;"MILHA (CE)";"CE";"MILHA";37;0;10;47
2006;"MIRAIMA (CE)";"CE";"MIRAIMA";26;2;2;30
2006;"MISSAO VELHA (CE)";"CE";"MISSAO VELHA";67;20;6;93
2006;"MOMBACA (CE)";"CE";"MOMBACA";140;5;3;148
2006;"MONSENHOR TABOSA (CE)";"CE";"MONSENHOR TABOSA";36;3;1;40
2006;"MORADA NOVA (CE)";"CE";"MORADA NOVA";295;29;44;368
2006;"MORAUJO (CE)";"CE";"MORAUJO";10;2;4;16
2006;"MORRINHOS (CE)";"CE";"MORRINHOS";35;6;5;46
2006;"MUCAMBO (CE)";"CE";"MUCAMBO";22;12;4;38
2006;"MULUNGU (CE)";"CE";"MULUNGU";38;4;1;43
2006;"NOVA OLINDA (CE)";"CE";"NOVA OLINDA";58;17;2;77
2006;"NOVA RUSSAS (CE)";"CE";"NOVA RUSSAS";143;7;6;156
2006;"NOVO ORIENTE (CE)";"CE";"NOVO ORIENTE";41;1;5;47
2006;"OCARA (CE)";"CE";"OCARA";72;17;11;100
2006;"OROS (CE)";"CE";"OROS";71;10;12;93
2006;"PACAJUS (CE)";"CE";"PACAJUS";401;38;34;473
2006;"PACATUBA (CE)";"CE";"PACATUBA";93;50;5;148
2006;"PACOTI (CE)";"CE";"PACOTI";65;4;6;75
2006;"PACUJA (CE)";"CE";"PACUJA";27;4;12;43
2006;"PALHANO (CE)";"CE";"PALHANO";37;7;8;52
2006;"PALMACIA (CE)";"CE";"PALMACIA";37;12;9;58
2006;"PARACURU (CE)";"CE";"PARACURU";130;9;9;148
2006;"PARAIPABA (CE)";"CE";"PARAIPABA";108;6;11;125
2006;"PARAMBU (CE)";"CE";"PARAMBU";125;3;1;129
2006;"PARAMOTI (CE)";"CE";"PARAMOTI";30;2;2;34
2006;"PEDRA BRANCA (CE)";"CE";"PEDRA BRANCA";144;11;6;161
2006;"PENAFORTE (CE)";"CE";"PENAFORTE";13;6;13;32
2006;"PENTECOSTE (CE)";"CE";"PENTECOSTE";147;5;5;157
2006;"PEREIRO (CE)";"CE";"PEREIRO";71;11;6;88
2006;"PINDORETAMA (CE)";"CE";"PINDORETAMA";88;9;3;100
2006;"PIQUET CARNEIRO (CE)";"CE";"PIQUET CARNEIRO";19;2;4;25
2006;"PIRES FERREIRA (CE)";"CE";"PIRES FERREIRA";11;2;1;14
2006;"PORANGA (CE)";"CE";"PORANGA";7;2;0;9
2006;"PORTEIRAS (CE)";"CE";"PORTEIRAS";16;14;5;35
2006;"POTENGI (CE)";"CE";"POTENGI";14;2;0;16
2006;"POTIRETAMA (CE)";"CE";"POTIRETAMA";19;1;5;25
2006;"QUITERIANOPOLIS (CE)";"CE";"QUITERIANOPOLIS";22;5;2;29
2006;"QUIXADA (CE)";"CE";"QUIXADA";429;37;50;516
2006;"QUIXELO (CE)";"CE";"QUIXELO";25;5;13;43
2006;"QUIXERAMOBIM (CE)";"CE";"QUIXERAMOBIM";282;35;55;372
2006;"QUIXERE (CE)";"CE";"QUIXERE";119;9;31;159
2006;"REDENCAO (CE)";"CE";"REDENCAO";144;17;20;181
2006;"RERIUTABA (CE)";"CE";"RERIUTABA";51;14;15;80
2006;"RUSSAS (CE)";"CE";"RUSSAS";483;20;53;556
2006;"SABOEIRO (CE)";"CE";"SABOEIRO";24;3;3;30
2006;"SALITRE (CE)";"CE";"SALITRE";26;2;14;42
2006;"SANTA QUITERIA (CE)";"CE";"SANTA QUITERIA";170;15;7;192
2006;"SANTANA DO ACARAU (CE)";"CE";"SANTANA DO ACARAU";81;13;11;105
2006;"SANTANA DO CARIRI (CE)";"CE";"SANTANA DO CARIRI";40;9;2;51
2006;"SAO BENEDITO (CE)";"CE";"SAO BENEDITO";302;49;31;382
2006;"SAO GONCALO DO AMARANTE (CE)";"CE";"SAO GONCALO DO AMARANTE";135;23;16;174
2006;"SAO JOAO DO JAGUARIBE (CE)";"CE";"SAO JOAO DO JAGUARIBE";36;6;7;49
2006;"SAO LUIS DO CURU (CE)";"CE";"SAO LUIS DO CURU";43;5;8;56
2006;"SENADOR POMPEU (CE)";"CE";"SENADOR POMPEU";107;5;18;130
2006;"SENADOR SA (CE)";"CE";"SENADOR SA";19;0;3;22
2006;"SOBRAL (CE)";"CE";"SOBRAL";1111;130;154;1395
2006;"SOLONOPOLE (CE)";"CE";"SOLONOPOLE";48;2;7;57
2006;"TABULEIRO DO NORTE (CE)";"CE";"TABULEIRO DO NORTE";243;27;30;300
2006;"TAMBORIL (CE)";"CE";"TAMBORIL";44;6;10;60
2006;"TARRAFAS (CE)";"CE";"TARRAFAS";13;4;2;19
2006;"TAUA (CE)";"CE";"TAUA";265;11;22;298
2006;"TEJUCUOCA (CE)";"CE";"TEJUCUOCA";52;2;4;58
2006;"TIANGUA (CE)";"CE";"TIANGUA";821;48;53;922
2006;"TRAIRI (CE)";"CE";"TRAIRI";126;6;13;145
2006;"TURURU (CE)";"CE";"TURURU";29;0;3;32
2006;"UBAJARA (CE)";"CE";"UBAJARA";157;12;14;183
2006;"UMARI (CE)";"CE";"UMARI";4;1;2;7
2006;"UMIRIM (CE)";"CE";"UMIRIM";37;35;8;80
2006;"URUBURETAMA (CE)";"CE";"URUBURETAMA";54;4;5;63
2006;"URUOCA (CE)";"CE";"URUOCA";27;5;7;39
2006;"VARJOTA (CE)";"CE";"VARJOTA";74;18;5;97
2006;"VARZEA ALEGRE (CE)";"CE";"VARZEA ALEGRE";140;17;25;182
2006;"VICOSA DO CEARA (CE)";"CE";"VICOSA DO CEARA";212;12;10;234
2006;"BRASILIA (DF)";"DF";"BRASILIA";15762;5383;6075;27220
2006;"AFONSO CLAUDIO (ES)";"ES";"AFONSO CLAUDIO";404;19;96;519
2006;"AGUA DOCE DO NORTE (ES)";"ES";"AGUA DOCE DO NORTE";68;4;17;89
2006;"AGUIA BRANCA (ES)";"ES";"AGUIA BRANCA";96;3;20;119
2006;"ALEGRE (ES)";"ES";"ALEGRE";146;13;11;170
2006;"ALFREDO CHAVES (ES)";"ES";"ALFREDO CHAVES";346;16;23;385
2006;"ALTO RIO NOVO (ES)";"ES";"ALTO RIO NOVO";73;10;10;93
2006;"ANCHIETA (ES)";"ES";"ANCHIETA";172;38;25;235
2006;"APIACA (ES)";"ES";"APIACA";49;7;2;58
2006;"ARACRUZ (ES)";"ES";"ARACRUZ";856;100;310;1266
2006;"ATILIO VIVACQUA (ES)";"ES";"ATILIO VIVACQUA";137;8;13;158
2006;"BAIXO GUANDU (ES)";"ES";"BAIXO GUANDU";452;16;82;550
2006;"BARRA DE SAO FRANCISCO (ES)";"ES";"BARRA DE SAO FRANCISCO";368;9;66;443
2006;"BOA ESPERANCA (ES)";"ES";"BOA ESPERANCA";159;5;26;190
2006;"BOM JESUS DO NORTE (ES)";"ES";"BOM JESUS DO NORTE";157;19;18;194
2006;"BREJETUBA (ES)";"ES";"BREJETUBA";124;5;21;150
2006;"CACHOEIRO DE ITAPEMIRIM (ES)";"ES";"CACHOEIRO DE ITAPEMIRIM";4203;147;2008;6358
2006;"CARIACICA (ES)";"ES";"CARIACICA";3925;362;1433;5720
2006;"CASTELO (ES)";"ES";"CASTELO";1066;35;51;1152
2006;"COLATINA (ES)";"ES";"COLATINA";1902;62;386;2350
2006;"CONCEICAO DA BARRA (ES)";"ES";"CONCEICAO DA BARRA";162;9;84;255
2006;"CONCEICAO DO CASTELO (ES)";"ES";"CONCEICAO DO CASTELO";161;13;38;212
2006;"DIVINO DE SAO LOURENCO (ES)";"ES";"DIVINO DE SAO LOURENCO";34;3;4;41
2006;"DOMINGOS MARTINS (ES)";"ES";"DOMINGOS MARTINS";706;51;52;809
2006;"DORES DO RIO PRETO (ES)";"ES";"DORES DO RIO PRETO";97;2;9;108
2006;"ECOPORANGA (ES)";"ES";"ECOPORANGA";109;13;49;171
2006;"FUNDAO (ES)";"ES";"FUNDAO";232;19;32;283
2006;"GOVERNADOR LINDENBERG (ES)";"ES";"GOVERNADOR LINDENBERG";130;6;1;137
2006;"GUACUI (ES)";"ES";"GUACUI";280;30;29;339
2006;"GUARAPARI (ES)";"ES";"GUARAPARI";770;125;145;1040
2006;"IBATIBA (ES)";"ES";"IBATIBA";225;17;24;266
2006;"IBIRACU (ES)";"ES";"IBIRACU";348;24;33;405
2006;"IBITIRAMA (ES)";"ES";"IBITIRAMA";62;3;6;71
2006;"ICONHA (ES)";"ES";"ICONHA";695;18;25;738
2006;"IRUPI (ES)";"ES";"IRUPI";103;13;13;129
2006;"ITAGUACU (ES)";"ES";"ITAGUACU";186;5;44;235
2006;"ITAPEMIRIM (ES)";"ES";"ITAPEMIRIM";325;23;41;389
2006;"ITARANA (ES)";"ES";"ITARANA";236;19;30;285
2006;"IUNA (ES)";"ES";"IUNA";293;17;60;370
2006;"JAGUARE (ES)";"ES";"JAGUARE";317;7;53;377
2006;"JERONIMO MONTEIRO (ES)";"ES";"JERONIMO MONTEIRO";57;6;9;72
2006;"JOAO NEIVA (ES)";"ES";"JOAO NEIVA";255;12;25;292
2006;"LARANJA DA TERRA (ES)";"ES";"LARANJA DA TERRA";210;5;21;236
2006;"LINHARES (ES)";"ES";"LINHARES";2261;54;261;2576
2006;"MANTENOPOLIS (ES)";"ES";"MANTENOPOLIS";92;6;16;114
2006;"MARATAIZES (ES)";"ES";"MARATAIZES";514;23;37;574
2006;"MARECHAL FLORIANO (ES)";"ES";"MARECHAL FLORIANO";500;14;9;523
2006;"MARILANDIA (ES)";"ES";"MARILANDIA";267;8;19;294
2006;"MIMOSO DO SUL (ES)";"ES";"MIMOSO DO SUL";175;10;33;218
2006;"MONTANHA (ES)";"ES";"MONTANHA";136;10;20;166
2006;"MUCURICI (ES)";"ES";"MUCURICI";54;7;19;80
2006;"MUNIZ FREIRE (ES)";"ES";"MUNIZ FREIRE";118;17;27;162
2006;"MUQUI (ES)";"ES";"MUQUI";102;12;16;130
2006;"NOVA VENECIA (ES)";"ES";"NOVA VENECIA";647;21;120;788
2006;"PANCAS (ES)";"ES";"PANCAS";186;11;3;200
2006;"PEDRO CANARIO (ES)";"ES";"PEDRO CANARIO";312;20;166;498
2006;"PINHEIROS (ES)";"ES";"PINHEIROS";205;13;79;297
2006;"PIUMA (ES)";"ES";"PIUMA";147;32;11;190
2006;"PONTO BELO (ES)";"ES";"PONTO BELO";31;5;12;48
2006;"PRESIDENTE KENNEDY (ES)";"ES";"PRESIDENTE KENNEDY";224;25;17;266
2006;"RIO BANANAL (ES)";"ES";"RIO BANANAL";391;10;28;429
2006;"RIO NOVO DO SUL (ES)";"ES";"RIO NOVO DO SUL";227;4;18;249
2006;"SANTA LEOPOLDINA (ES)";"ES";"SANTA LEOPOLDINA";225;16;18;259
2006;"SANTA MARIA DE JETIBA (ES)";"ES";"SANTA MARIA DE JETIBA";1249;38;36;1323
2006;"SANTA TERESA (ES)";"ES";"SANTA TERESA";540;20;48;608
2006;"SAO DOMINGOS DO NORTE (ES)";"ES";"SAO DOMINGOS DO NORTE";141;1;15;157
2006;"SAO GABRIEL DA PALHA (ES)";"ES";"SAO GABRIEL DA PALHA";447;9;60;516
2006;"SAO JOSE DO CALCADO (ES)";"ES";"SAO JOSE DO CALCADO";61;3;12;76
2006;"SAO MATEUS (ES)";"ES";"SAO MATEUS";771;78;234;1083
2006;"SAO ROQUE DO CANAA (ES)";"ES";"SAO ROQUE DO CANAA";223;10;10;243
2006;"SERRA (ES)";"ES";"SERRA";5528;275;1462;7265
2006;"SOORETAMA (ES)";"ES";"SOORETAMA";200;2;40;242
2006;"VARGEM ALTA (ES)";"ES";"VARGEM ALTA";317;8;41;366
2006;"VENDA NOVA DO IMIGRANTE (ES)";"ES";"VENDA NOVA DO IMIGRANTE";569;9;85;663
2006;"VIANA (ES)";"ES";"VIANA";743;37;195;975
2006;"VILA PAVAO (ES)";"ES";"VILA PAVAO";97;3;12;112
2006;"VILA VALERIO (ES)";"ES";"VILA VALERIO";224;3;18;245
2006;"VILA VELHA (ES)";"ES";"VILA VELHA";3189;569;666;4424
2006;"VITORIA (ES)";"ES";"VITORIA";2841;726;914;4481
2006;"ABADIA DE GOIAS (GO)";"GO";"ABADIA DE GOIAS";36;1;3;40
2006;"ABADIANIA (GO)";"GO";"ABADIANIA";171;15;13;199
2006;"ACREUNA (GO)";"GO";"ACREUNA";324;3;50;377
2006;"ADELANDIA (GO)";"GO";"ADELANDIA";17;0;2;19
2006;"AGUA FRIA DE GOIAS (GO)";"GO";"AGUA FRIA DE GOIAS";27;6;7;40
2006;"AGUA LIMPA (GO)";"GO";"AGUA LIMPA";13;6;1;20
2006;"AGUAS LINDAS DE GOIAS (GO)";"GO";"AGUAS LINDAS DE GOIAS";296;89;210;595
2006;"ALEXANIA (GO)";"GO";"ALEXANIA";292;19;15;326
2006;"ALOANDIA (GO)";"GO";"ALOANDIA";23;5;2;30
2006;"ALTO HORIZONTE (GO)";"GO";"ALTO HORIZONTE";11;2;5;18
2006;"ALTO PARAISO DE GOIAS (GO)";"GO";"ALTO PARAISO DE GOIAS";36;6;6;48
2006;"ALVORADA DO NORTE (GO)";"GO";"ALVORADA DO NORTE";99;4;3;106
2006;"AMARALINA (GO)";"GO";"AMARALINA";5;0;6;11
2006;"AMERICANO DO BRASIL (GO)";"GO";"AMERICANO DO BRASIL";35;3;9;47
2006;"AMORINOPOLIS (GO)";"GO";"AMORINOPOLIS";14;0;7;21
2006;"ANAPOLIS (GO)";"GO";"ANAPOLIS";7355;192;1047;8594
2006;"ANHANGUERA (GO)";"GO";"ANHANGUERA";8;2;1;11
2006;"ANICUNS (GO)";"GO";"ANICUNS";236;12;51;299
2006;"APARECIDA DE GOIANIA (GO)";"GO";"APARECIDA DE GOIANIA";2940;137;398;3475
2006;"APARECIDA DO RIO DOCE (GO)";"GO";"APARECIDA DO RIO DOCE";48;2;6;56
2006;"APORE (GO)";"GO";"APORE";39;4;5;48
2006;"ARACU (GO)";"GO";"ARACU";15;2;3;20
2006;"ARAGARCAS (GO)";"GO";"ARAGARCAS";547;5;26;578
2006;"ARAGOIANIA (GO)";"GO";"ARAGOIANIA";39;0;4;43
2006;"ARAGUAPAZ (GO)";"GO";"ARAGUAPAZ";73;0;5;78
2006;"ARENOPOLIS (GO)";"GO";"ARENOPOLIS";9;3;3;15
2006;"ARUANA (GO)";"GO";"ARUANA";15;2;6;23
2006;"AURILANDIA (GO)";"GO";"AURILANDIA";17;3;1;21
2006;"AVELINOPOLIS (GO)";"GO";"AVELINOPOLIS";22;1;0;23
2006;"BALIZA (GO)";"GO";"BALIZA";3;1;2;6
2006;"BARRO ALTO (GO)";"GO";"BARRO ALTO";65;3;12;80
2006;"BELA VISTA DE GOIAS (GO)";"GO";"BELA VISTA DE GOIAS";214;6;28;248
2006;"BOM JARDIM DE GOIAS (GO)";"GO";"BOM JARDIM DE GOIAS";66;5;8;79
2006;"BOM JESUS DE GOIAS (GO)";"GO";"BOM JESUS DE GOIAS";336;10;51;397
2006;"BONFINOPOLIS (GO)";"GO";"BONFINOPOLIS";32;2;9;43
2006;"BONOPOLIS (GO)";"GO";"BONOPOLIS";9;1;2;12
2006;"BRAZABRANTES (GO)";"GO";"BRAZABRANTES";24;3;2;29
2006;"BRITANIA (GO)";"GO";"BRITANIA";51;1;6;58
2006;"BURITI ALEGRE (GO)";"GO";"BURITI ALEGRE";147;6;1;154
2006;"BURITI DE GOIAS (GO)";"GO";"BURITI DE GOIAS";11;6;1;18
2006;"BURITINOPOLIS (GO)";"GO";"BURITINOPOLIS";12;1;3;16
2006;"CABECEIRAS (GO)";"GO";"CABECEIRAS";48;2;15;65
2006;"CACHOEIRA ALTA (GO)";"GO";"CACHOEIRA ALTA";107;7;14;128
2006;"CACHOEIRA DE GOIAS (GO)";"GO";"CACHOEIRA DE GOIAS";4;1;0;5
2006;"CACHOEIRA DOURADA (GO)";"GO";"CACHOEIRA DOURADA";70;6;15;91
2006;"CACU (GO)";"GO";"CACU";154;3;17;174
2006;"CAIAPONIA (GO)";"GO";"CAIAPONIA";104;2;6;112
2006;"CALDAS NOVAS (GO)";"GO";"CALDAS NOVAS";480;37;65;582
2006;"CALDAZINHA (GO)";"GO";"CALDAZINHA";22;1;2;25
2006;"CAMPESTRE DE GOIAS (GO)";"GO";"CAMPESTRE DE GOIAS";20;2;2;24
2006;"CAMPINACU (GO)";"GO";"CAMPINACU";5;2;2;9
2006;"CAMPINORTE (GO)";"GO";"CAMPINORTE";96;1;9;106
2006;"CAMPO ALEGRE DE GOIAS (GO)";"GO";"CAMPO ALEGRE DE GOIAS";85;4;10;99
2006;"CAMPO LIMPO DE GOIAS (GO)";"GO";"CAMPO LIMPO DE GOIAS";50;0;3;53
2006;"CAMPOS BELOS (GO)";"GO";"CAMPOS BELOS";138;2;22;162
2006;"CAMPOS VERDES (GO)";"GO";"CAMPOS VERDES";27;4;2;33
2006;"CARMO DO RIO VERDE (GO)";"GO";"CARMO DO RIO VERDE";55;2;30;87
2006;"CASTELANDIA (GO)";"GO";"CASTELANDIA";35;2;7;44
2006;"CATALAO (GO)";"GO";"CATALAO";1318;55;184;1557
2006;"CATURAI (GO)";"GO";"CATURAI";24;1;5;30
2006;"CAVALCANTE (GO)";"GO";"CAVALCANTE";17;1;3;21
2006;"CERES (GO)";"GO";"CERES";435;13;24;472
2006;"CEZARINA (GO)";"GO";"CEZARINA";78;2;7;87
2006;"CHAPADAO DO CEU (GO)";"GO";"CHAPADAO DO CEU";108;4;7;119
2006;"CIDADE OCIDENTAL (GO)";"GO";"CIDADE OCIDENTAL";70;27;53;150
2006;"COCALZINHO DE GOIAS (GO)";"GO";"COCALZINHO DE GOIAS";108;13;16;137
2006;"COLINAS DO SUL (GO)";"GO";"COLINAS DO SUL";7;2;2;11
2006;"CORREGO DO OURO (GO)";"GO";"CORREGO DO OURO";13;0;1;14
2006;"CORUMBA DE GOIAS (GO)";"GO";"CORUMBA DE GOIAS";65;6;11;82
2006;"CORUMBAIBA (GO)";"GO";"CORUMBAIBA";95;3;8;106
2006;"CRISTALINA (GO)";"GO";"CRISTALINA";643;21;113;777
2006;"CRISTIANOPOLIS (GO)";"GO";"CRISTIANOPOLIS";25;5;1;31
2006;"CRIXAS (GO)";"GO";"CRIXAS";58;9;12;79
2006;"CROMINIA (GO)";"GO";"CROMINIA";29;1;2;32
2006;"CUMARI (GO)";"GO";"CUMARI";15;2;0;17
2006;"DAMIANOPOLIS (GO)";"GO";"DAMIANOPOLIS";4;0;3;7
2006;"DAMOLANDIA (GO)";"GO";"DAMOLANDIA";25;3;3;31
2006;"DAVINOPOLIS (GO)";"GO";"DAVINOPOLIS";25;3;5;33
2006;"DIORAMA (GO)";"GO";"DIORAMA";7;3;4;14
2006;"DIVINOPOLIS DE GOIAS (GO)";"GO";"DIVINOPOLIS DE GOIAS";15;0;5;20
2006;"DOVERLANDIA (GO)";"GO";"DOVERLANDIA";74;3;22;99
2006;"EDEALINA (GO)";"GO";"EDEALINA";46;1;4;51
2006;"EDEIA (GO)";"GO";"EDEIA";132;1;7;140
2006;"ESTRELA DO NORTE (GO)";"GO";"ESTRELA DO NORTE";19;3;1;23
2006;"FAINA (GO)";"GO";"FAINA";28;1;5;34
2006;"FAZENDA NOVA (GO)";"GO";"FAZENDA NOVA";29;3;7;39
2006;"FIRMINOPOLIS (GO)";"GO";"FIRMINOPOLIS";60;1;3;64
2006;"FLORES DE GOIAS (GO)";"GO";"FLORES DE GOIAS";22;4;4;30
2006;"FORMOSA (GO)";"GO";"FORMOSA";1931;65;406;2402
2006;"FORMOSO (GO)";"GO";"FORMOSO";34;1;4;39
2006;"GAMELEIRA DE GOIAS (GO)";"GO";"GAMELEIRA DE GOIAS";14;6;7;27
2006;"GOIANAPOLIS (GO)";"GO";"GOIANAPOLIS";139;4;7;150
2006;"GOIANDIRA (GO)";"GO";"GOIANDIRA";35;2;4;41
2006;"GOIANESIA (GO)";"GO";"GOIANESIA";703;16;123;842
2006;"GOIANIA (GO)";"GO";"GOIANIA";20523;1584;5204;27311
2006;"GOIANIRA (GO)";"GO";"GOIANIRA";142;1;54;197
2006;"GOIAS (GO)";"GO";"GOIAS";161;7;25;193
2006;"GOIATUBA (GO)";"GO";"GOIATUBA";479;16;48;543
2006;"GOUVELANDIA (GO)";"GO";"GOUVELANDIA";44;4;8;56
2006;"GUAPO (GO)";"GO";"GUAPO";100;7;3;110
2006;"GUARAITA (GO)";"GO";"GUARAITA";10;0;0;10
2006;"GUARANI DE GOIAS (GO)";"GO";"GUARANI DE GOIAS";4;1;7;12
2006;"GUARINOS (GO)";"GO";"GUARINOS";4;3;2;9
2006;"HEITORAI (GO)";"GO";"HEITORAI";13;1;2;16
2006;"HIDROLANDIA (GO)";"GO";"HIDROLANDIA";138;11;9;158
2006;"HIDROLINA (GO)";"GO";"HIDROLINA";13;0;4;17
2006;"IACIARA (GO)";"GO";"IACIARA";108;3;12;123
2006;"INACIOLANDIA (GO)";"GO";"INACIOLANDIA";51;6;5;62
2006;"INDIARA (GO)";"GO";"INDIARA";133;9;16;158
2006;"INHUMAS (GO)";"GO";"INHUMAS";800;15;116;931
2006;"IPAMERI (GO)";"GO";"IPAMERI";203;15;53;271
2006;"IPIRANGA DE GOIAS (GO)";"GO";"IPIRANGA DE GOIAS";6;4;6;16
2006;"IPORA (GO)";"GO";"IPORA";313;13;34;360
2006;"ISRAELANDIA (GO)";"GO";"ISRAELANDIA";6;0;4;10
2006;"ITABERAI (GO)";"GO";"ITABERAI";453;13;35;501
2006;"ITAGUARI (GO)";"GO";"ITAGUARI";39;5;5;49
2006;"ITAGUARU (GO)";"GO";"ITAGUARU";49;5;6;60
2006;"ITAJA (GO)";"GO";"ITAJA";58;3;8;69
2006;"ITAPACI (GO)";"GO";"ITAPACI";147;9;41;197
2006;"ITAPIRAPUA (GO)";"GO";"ITAPIRAPUA";44;0;7;51
2006;"ITAPURANGA (GO)";"GO";"ITAPURANGA";225;11;30;266
2006;"ITARUMA (GO)";"GO";"ITARUMA";64;3;4;71
2006;"ITAUCU (GO)";"GO";"ITAUCU";62;2;11;75
2006;"ITUMBIARA (GO)";"GO";"ITUMBIARA";1736;117;124;1977
2006;"IVOLANDIA (GO)";"GO";"IVOLANDIA";6;2;3;11
2006;"JANDAIA (GO)";"GO";"JANDAIA";49;3;9;61
2006;"JARAGUA (GO)";"GO";"JARAGUA";231;15;26;272
2006;"JATAI (GO)";"GO";"JATAI";1486;39;114;1639
2006;"JAUPACI (GO)";"GO";"JAUPACI";15;3;5;23
2006;"JESUPOLIS (GO)";"GO";"JESUPOLIS";12;1;4;17
2006;"JOVIANIA (GO)";"GO";"JOVIANIA";118;4;6;128
2006;"JUSSARA (GO)";"GO";"JUSSARA";261;6;11;278
2006;"LAGOA SANTA (GO)";"GO";"LAGOA SANTA";6;3;3;12
2006;"LEOPOLDO DE BULHOES (GO)";"GO";"LEOPOLDO DE BULHOES";66;5;5;76
2006;"LUZIANIA (GO)";"GO";"LUZIANIA";1821;85;337;2243
2006;"MAIRIPOTABA (GO)";"GO";"MAIRIPOTABA";15;0;3;18
2006;"MAMBAI (GO)";"GO";"MAMBAI";45;2;6;53
2006;"MARA ROSA (GO)";"GO";"MARA ROSA";68;0;8;76
2006;"MARZAGAO (GO)";"GO";"MARZAGAO";22;2;1;25
2006;"MATRINCHA (GO)";"GO";"MATRINCHA";25;4;6;35
2006;"MAURILANDIA (GO)";"GO";"MAURILANDIA";239;5;62;306
2006;"MIMOSO DE GOIAS (GO)";"GO";"MIMOSO DE GOIAS";2;0;2;4
2006;"MINACU (GO)";"GO";"MINACU";229;19;23;271
2006;"MINEIROS (GO)";"GO";"MINEIROS";982;17;56;1055
2006;"MOIPORA (GO)";"GO";"MOIPORA";6;1;0;7
2006;"MONTE ALEGRE DE GOIAS (GO)";"GO";"MONTE ALEGRE DE GOIAS";13;0;4;17
2006;"MONTES CLAROS DE GOIAS (GO)";"GO";"MONTES CLAROS DE GOIAS";44;1;6;51
2006;"MONTIVIDIU (GO)";"GO";"MONTIVIDIU";194;0;30;224
2006;"MONTIVIDIU DO NORTE (GO)";"GO";"MONTIVIDIU DO NORTE";10;2;9;21
2006;"MORRINHOS (GO)";"GO";"MORRINHOS";518;20;55;593
2006;"MORRO AGUDO DE GOIAS (GO)";"GO";"MORRO AGUDO DE GOIAS";9;1;2;12
2006;"MOSSAMEDES (GO)";"GO";"MOSSAMEDES";21;3;1;25
2006;"MOZARLANDIA (GO)";"GO";"MOZARLANDIA";99;1;15;115
2006;"MUNDO NOVO (GO)";"GO";"MUNDO NOVO";16;3;6;25
2006;"MUTUNOPOLIS (GO)";"GO";"MUTUNOPOLIS";18;2;3;23
2006;"NAZARIO (GO)";"GO";"NAZARIO";95;2;8;105
2006;"NEROPOLIS (GO)";"GO";"NEROPOLIS";284;16;20;320
2006;"NIQUELANDIA (GO)";"GO";"NIQUELANDIA";407;28;88;523
2006;"NOVA AMERICA (GO)";"GO";"NOVA AMERICA";12;1;3;16
2006;"NOVA AURORA (GO)";"GO";"NOVA AURORA";15;3;1;19
2006;"NOVA CRIXAS (GO)";"GO";"NOVA CRIXAS";53;3;16;72
2006;"NOVA GLORIA (GO)";"GO";"NOVA GLORIA";58;3;13;74
2006;"NOVA IGUACU DE GOIAS (GO)";"GO";"NOVA IGUACU DE GOIAS";10;1;4;15
2006;"NOVA ROMA (GO)";"GO";"NOVA ROMA";2;2;1;5
2006;"NOVA VENEZA (GO)";"GO";"NOVA VENEZA";187;3;12;202
2006;"NOVO BRASIL (GO)";"GO";"NOVO BRASIL";12;1;1;14
2006;"NOVO GAMA (GO)";"GO";"NOVO GAMA";225;40;84;349
2006;"NOVO PLANALTO (GO)";"GO";"NOVO PLANALTO";24;2;1;27
2006;"ORIZONA (GO)";"GO";"ORIZONA";132;10;29;171
2006;"OURO VERDE DE GOIAS (GO)";"GO";"OURO VERDE DE GOIAS";66;0;8;74
2006;"OUVIDOR (GO)";"GO";"OUVIDOR";64;4;9;77
2006;"PADRE BERNARDO (GO)";"GO";"PADRE BERNARDO";227;9;33;269
2006;"PALESTINA DE GOIAS (GO)";"GO";"PALESTINA DE GOIAS";16;6;3;25
2006;"PALMEIRAS DE GOIAS (GO)";"GO";"PALMEIRAS DE GOIAS";213;6;31;250
2006;"PALMELO (GO)";"GO";"PALMELO";12;2;1;15
2006;"PALMINOPOLIS (GO)";"GO";"PALMINOPOLIS";16;1;2;19
2006;"PANAMA (GO)";"GO";"PANAMA";21;0;4;25
2006;"PARANAIGUARA (GO)";"GO";"PARANAIGUARA";79;5;5;89
2006;"PARAUNA (GO)";"GO";"PARAUNA";105;8;19;132
2006;"PEROLANDIA (GO)";"GO";"PEROLANDIA";18;0;8;26
2006;"PETROLINA DE GOIAS (GO)";"GO";"PETROLINA DE GOIAS";95;2;13;110
2006;"PILAR DE GOIAS (GO)";"GO";"PILAR DE GOIAS";6;2;2;10
2006;"PIRACANJUBA (GO)";"GO";"PIRACANJUBA";245;13;23;281
2006;"PIRANHAS (GO)";"GO";"PIRANHAS";149;5;20;174
2006;"PIRENOPOLIS (GO)";"GO";"PIRENOPOLIS";198;9;22;229
2006;"PIRES DO RIO (GO)";"GO";"PIRES DO RIO";368;13;25;406
2006;"PLANALTINA (GO)";"GO";"PLANALTINA";264;20;275;559
2006;"PONTALINA (GO)";"GO";"PONTALINA";178;7;21;206
2006;"PORANGATU (GO)";"GO";"PORANGATU";424;11;36;471
2006;"PORTEIRAO (GO)";"GO";"PORTEIRAO";64;3;11;78
2006;"PORTELANDIA (GO)";"GO";"PORTELANDIA";38;14;1;53
2006;"POSSE (GO)";"GO";"POSSE";383;23;51;457
2006;"PROFESSOR JAMIL (GO)";"GO";"PROFESSOR JAMIL";27;1;4;32
2006;"QUIRINOPOLIS (GO)";"GO";"QUIRINOPOLIS";654;6;21;681
2006;"RIALMA (GO)";"GO";"RIALMA";271;11;20;302
2006;"RIANAPOLIS (GO)";"GO";"RIANAPOLIS";72;2;4;78
2006;"RIO QUENTE (GO)";"GO";"RIO QUENTE";27;9;10;46
2006;"RIO VERDE (GO)";"GO";"RIO VERDE";2403;117;281;2801
2006;"RUBIATABA (GO)";"GO";"RUBIATABA";186;7;32;225
2006;"SANCLERLANDIA (GO)";"GO";"SANCLERLANDIA";58;5;5;68
2006;"SANTA BARBARA DE GOIAS (GO)";"GO";"SANTA BARBARA DE GOIAS";66;2;5;73
2006;"SANTA CRUZ DE GOIAS (GO)";"GO";"SANTA CRUZ DE GOIAS";5;1;2;8
2006;"SANTA FE DE GOIAS (GO)";"GO";"SANTA FE DE GOIAS";30;0;3;33
2006;"SANTA HELENA DE GOIAS (GO)";"GO";"SANTA HELENA DE GOIAS";616;17;116;749
2006;"SANTA ISABEL (GO)";"GO";"SANTA ISABEL";7;2;1;10
2006;"SANTA RITA DO ARAGUAIA (GO)";"GO";"SANTA RITA DO ARAGUAIA";113;4;2;119
2006;"SANTA RITA DO NOVO DESTINO (GO)";"GO";"SANTA RITA DO NOVO DESTINO";11;1;10;22
2006;"SANTA ROSA DE GOIAS (GO)";"GO";"SANTA ROSA DE GOIAS";17;3;2;22
2006;"SANTA TEREZA DE GOIAS (GO)";"GO";"SANTA TEREZA DE GOIAS";29;1;3;33
2006;"SANTA TEREZINHA DE GOIAS (GO)";"GO";"SANTA TEREZINHA DE GOIAS";57;4;16;77
2006;"SANTO ANTONIO DA BARRA (GO)";"GO";"SANTO ANTONIO DA BARRA";26;1;8;35
2006;"SANTO ANTONIO DE GOIAS (GO)";"GO";"SANTO ANTONIO DE GOIAS";36;3;11;50
2006;"SANTO ANTONIO DO DESCOBERTO (GO)";"GO";"SANTO ANTONIO DO DESCOBERTO";223;18;165;406
2006;"SAO DOMINGOS (GO)";"GO";"SAO DOMINGOS";28;4;7;39
2006;"SAO FRANCISCO DE GOIAS (GO)";"GO";"SAO FRANCISCO DE GOIAS";29;3;5;37
2006;"SAO JOAO D ALIANCA (GO)";"GO";"SAO JOAO D ALIANCA";88;3;8;99
2006;"SAO JOAO DA PARAUNA (GO)";"GO";"SAO JOAO DA PARAUNA";10;1;3;14
2006;"SAO LUIS DE MONTES BELOS (GO)";"GO";"SAO LUIS DE MONTES BELOS";280;12;42;334
2006;"SAO LUIZ DO NORTE (GO)";"GO";"SAO LUIZ DO NORTE";17;2;6;25
2006;"SAO MIGUEL DO ARAGUAIA (GO)";"GO";"SAO MIGUEL DO ARAGUAIA";224;4;28;256
2006;"SAO MIGUEL DO PASSA QUATRO (GO)";"GO";"SAO MIGUEL DO PASSA QUATRO";20;1;3;24
2006;"SAO PATRICIO (GO)";"GO";"SAO PATRICIO";5;0;3;8
2006;"SAO SIMAO (GO)";"GO";"SAO SIMAO";108;10;18;136
2006;"SENADOR CANEDO (GO)";"GO";"SENADOR CANEDO";365;11;24;400
2006;"SERRANOPOLIS (GO)";"GO";"SERRANOPOLIS";88;3;12;103
2006;"SILVANIA (GO)";"GO";"SILVANIA";217;3;26;246
2006;"SIMOLANDIA (GO)";"GO";"SIMOLANDIA";65;1;3;69
2006;"SITIO D ABADIA (GO)";"GO";"SITIO D ABADIA";4;0;3;7
2006;"TAQUARAL DE GOIAS (GO)";"GO";"TAQUARAL DE GOIAS";12;3;4;19
2006;"TERESINA DE GOIAS (GO)";"GO";"TERESINA DE GOIAS";7;1;1;9
2006;"TEREZOPOLIS DE GOIAS (GO)";"GO";"TEREZOPOLIS DE GOIAS";44;3;12;59
2006;"TRES RANCHOS (GO)";"GO";"TRES RANCHOS";28;6;2;36
2006;"TRINDADE (GO)";"GO";"TRINDADE";635;23;80;738
2006;"TROMBAS (GO)";"GO";"TROMBAS";23;3;4;30
2006;"TURVANIA (GO)";"GO";"TURVANIA";47;3;4;54
2006;"TURVELANDIA (GO)";"GO";"TURVELANDIA";33;1;14;48
2006;"UIRAPURU (GO)";"GO";"UIRAPURU";6;3;2;11
2006;"URUACU (GO)";"GO";"URUACU";339;11;41;391
2006;"URUANA (GO)";"GO";"URUANA";190;3;4;197
2006;"URUTAI (GO)";"GO";"URUTAI";14;1;5;20
2006;"VALPARAISO DE GOIAS (GO)";"GO";"VALPARAISO DE GOIAS";329;158;95;582
2006;"VARJAO (GO)";"GO";"VARJAO";28;0;5;33
2006;"VIANOPOLIS (GO)";"GO";"VIANOPOLIS";269;13;13;295
2006;"VICENTINOPOLIS (GO)";"GO";"VICENTINOPOLIS";112;3;15;130
2006;"VILA BOA (GO)";"GO";"VILA BOA";9;2;1;12
2006;"VILA PROPICIO (GO)";"GO";"VILA PROPICIO";6;3;10;19
2006;"ACAILANDIA (MA)";"MA";"ACAILANDIA";667;35;87;789
2006;"AFONSO CUNHA (MA)";"MA";"AFONSO CUNHA";1;1;0;2
2006;"AGUA DOCE DO MARANHAO (MA)";"MA";"AGUA DOCE DO MARANHAO";1;1;0;2
2006;"ALCANTARA (MA)";"MA";"ALCANTARA";19;5;7;31
2006;"ALDEIAS ALTAS (MA)";"MA";"ALDEIAS ALTAS";26;3;2;31
2006;"ALTAMIRA DO MARANHAO (MA)";"MA";"ALTAMIRA DO MARANHAO";15;3;1;19
2006;"ALTO ALEGRE DO MARANHAO (MA)";"MA";"ALTO ALEGRE DO MARANHAO";23;12;0;35
2006;"ALTO ALEGRE DO PINDARE (MA)";"MA";"ALTO ALEGRE DO PINDARE";14;4;2;20
2006;"ALTO PARNAIBA (MA)";"MA";"ALTO PARNAIBA";23;1;2;26
2006;"AMAPA DO MARANHAO (MA)";"MA";"AMAPA DO MARANHAO";5;0;1;6
2006;"AMARANTE DO MARANHAO (MA)";"MA";"AMARANTE DO MARANHAO";42;1;4;47
2006;"ANAJATUBA (MA)";"MA";"ANAJATUBA";16;2;3;21
2006;"ANAPURUS (MA)";"MA";"ANAPURUS";19;1;2;22
2006;"APICUM ACU (MA)";"MA";"APICUM ACU";3;2;0;5
2006;"ARAGUANA (MA)";"MA";"ARAGUANA";2;0;1;3
2006;"ARAIOSES (MA)";"MA";"ARAIOSES";11;3;7;21
2006;"ARAME (MA)";"MA";"ARAME";67;4;0;71
2006;"ARARI (MA)";"MA";"ARARI";49;6;3;58
2006;"AXIXA (MA)";"MA";"AXIXA";6;4;2;12
2006;"BACABAL (MA)";"MA";"BACABAL";497;57;39;593
2006;"BACABEIRA (MA)";"MA";"BACABEIRA";37;1;2;40
2006;"BACURI (MA)";"MA";"BACURI";5;2;2;9
2006;"BACURITUBA (MA)";"MA";"BACURITUBA";2;0;0;2
2006;"BALSAS (MA)";"MA";"BALSAS";773;25;38;836
2006;"BARAO DE GRAJAU (MA)";"MA";"BARAO DE GRAJAU";15;1;2;18
2006;"BARRA DO CORDA (MA)";"MA";"BARRA DO CORDA";288;7;7;302
2006;"BARREIRINHAS (MA)";"MA";"BARREIRINHAS";26;7;11;44
2006;"BELA VISTA DO MARANHAO (MA)";"MA";"BELA VISTA DO MARANHAO";16;1;0;17
2006;"BELAGUA (MA)";"MA";"BELAGUA";4;3;2;9
2006;"BENEDITO LEITE (MA)";"MA";"BENEDITO LEITE";0;0;0;0
2006;"BEQUIMAO (MA)";"MA";"BEQUIMAO";41;4;5;50
2006;"BERNARDO DO MEARIM (MA)";"MA";"BERNARDO DO MEARIM";10;2;0;12
2006;"BOA VISTA DO GURUPI (MA)";"MA";"BOA VISTA DO GURUPI";2;1;1;4
2006;"BOM JARDIM (MA)";"MA";"BOM JARDIM";49;5;3;57
2006;"BOM JESUS DAS SELVAS (MA)";"MA";"BOM JESUS DAS SELVAS";50;4;2;56
2006;"BOM LUGAR (MA)";"MA";"BOM LUGAR";15;4;6;25
2006;"BREJO (MA)";"MA";"BREJO";29;9;4;42
2006;"BREJO DE AREIA (MA)";"MA";"BREJO DE AREIA";19;3;1;23
2006;"BURITI (MA)";"MA";"BURITI";7;2;6;15
2006;"BURITI BRAVO (MA)";"MA";"BURITI BRAVO";19;0;0;19
2006;"BURITICUPU (MA)";"MA";"BURITICUPU";171;15;5;191
2006;"BURITIRANA (MA)";"MA";"BURITIRANA";6;0;0;6
2006;"CACHOEIRA GRANDE (MA)";"MA";"CACHOEIRA GRANDE";3;2;0;5
2006;"CAJAPIO (MA)";"MA";"CAJAPIO";5;0;2;7
2006;"CAJARI (MA)";"MA";"CAJARI";0;0;0;0
2006;"CAMPESTRE DO MARANHAO (MA)";"MA";"CAMPESTRE DO MARANHAO";6;3;0;9
2006;"CANDIDO MENDES (MA)";"MA";"CANDIDO MENDES";6;2;0;8
2006;"CANTANHEDE (MA)";"MA";"CANTANHEDE";12;2;0;14
2006;"CAPINZAL DO NORTE (MA)";"MA";"CAPINZAL DO NORTE";15;10;1;26
2006;"CAROLINA (MA)";"MA";"CAROLINA";36;3;2;41
2006;"CARUTAPERA (MA)";"MA";"CARUTAPERA";12;3;5;20
2006;"CAXIAS (MA)";"MA";"CAXIAS";410;29;52;491
2006;"CEDRAL (MA)";"MA";"CEDRAL";3;0;3;6
2006;"CENTRAL DO MARANHAO (MA)";"MA";"CENTRAL DO MARANHAO";4;0;0;4
2006;"CENTRO DO GUILHERME (MA)";"MA";"CENTRO DO GUILHERME";4;0;0;4
2006;"CENTRO NOVO DO MARANHAO (MA)";"MA";"CENTRO NOVO DO MARANHAO";8;0;3;11
2006;"CHAPADINHA (MA)";"MA";"CHAPADINHA";170;23;6;199
2006;"CIDELANDIA (MA)";"MA";"CIDELANDIA";29;4;4;37
2006;"CODO (MA)";"MA";"CODO";362;10;10;382
2006;"COELHO NETO (MA)";"MA";"COELHO NETO";57;5;7;69
2006;"COLINAS (MA)";"MA";"COLINAS";65;7;5;77
2006;"CONCEICAO DO LAGO ACU (MA)";"MA";"CONCEICAO DO LAGO ACU";5;2;0;7
2006;"COROATA (MA)";"MA";"COROATA";106;21;7;134
2006;"CURURUPU (MA)";"MA";"CURURUPU";13;3;6;22
2006;"DAVINOPOLIS (MA)";"MA";"DAVINOPOLIS";8;0;0;8
2006;"DOM PEDRO (MA)";"MA";"DOM PEDRO";172;5;16;193
2006;"DUQUE BACELAR (MA)";"MA";"DUQUE BACELAR";0;2;2;4
2006;"ESPERANTINOPOLIS (MA)";"MA";"ESPERANTINOPOLIS";34;6;0;40
2006;"ESTREITO (MA)";"MA";"ESTREITO";22;5;1;28
2006;"FEIRA NOVA DO MARANHAO (MA)";"MA";"FEIRA NOVA DO MARANHAO";0;1;0;1
2006;"FERNANDO FALCAO (MA)";"MA";"FERNANDO FALCAO";11;1;2;14
2006;"FORMOSA DA SERRA NEGRA (MA)";"MA";"FORMOSA DA SERRA NEGRA";10;0;0;10
2006;"FORTALEZA DOS NOGUEIRAS (MA)";"MA";"FORTALEZA DOS NOGUEIRAS";21;1;3;25
2006;"FORTUNA (MA)";"MA";"FORTUNA";14;1;0;15
2006;"GODOFREDO VIANA (MA)";"MA";"GODOFREDO VIANA";3;3;2;8
2006;"GONCALVES DIAS (MA)";"MA";"GONCALVES DIAS";13;2;2;17
2006;"GOVERNADOR ARCHER (MA)";"MA";"GOVERNADOR ARCHER";9;4;2;15
2006;"GOVERNADOR EDISON LOBAO (MA)";"MA";"GOVERNADOR EDISON LOBAO";12;1;2;15
2006;"GOVERNADOR EUGENIO BARROS (MA)";"MA";"GOVERNADOR EUGENIO BARROS";15;4;3;22
2006;"GOVERNADOR LUIZ ROCHA (MA)";"MA";"GOVERNADOR LUIZ ROCHA";6;1;1;8
2006;"GOVERNADOR NEWTON BELLO (MA)";"MA";"GOVERNADOR NEWTON BELLO";11;0;1;12
2006;"GOVERNADOR NUNES FREIRE (MA)";"MA";"GOVERNADOR NUNES FREIRE";23;4;0;27
2006;"GRACA ARANHA (MA)";"MA";"GRACA ARANHA";10;4;2;16
2006;"GRAJAU (MA)";"MA";"GRAJAU";209;5;8;222
2006;"GUIMARAES (MA)";"MA";"GUIMARAES";6;2;1;9
2006;"HUMBERTO DE CAMPOS (MA)";"MA";"HUMBERTO DE CAMPOS";8;5;1;14
2006;"ICATU (MA)";"MA";"ICATU";6;3;3;12
2006;"IGARAPE DO MEIO (MA)";"MA";"IGARAPE DO MEIO";8;1;5;14
2006;"IGARAPE GRANDE (MA)";"MA";"IGARAPE GRANDE";36;10;4;50
2006;"IMPERATRIZ (MA)";"MA";"IMPERATRIZ";1710;72;168;1950
2006;"ITAIPAVA DO GRAJAU (MA)";"MA";"ITAIPAVA DO GRAJAU";9;1;0;10
2006;"ITAPECURU MIRIM (MA)";"MA";"ITAPECURU MIRIM";159;12;19;190
2006;"ITINGA DO MARANHAO (MA)";"MA";"ITINGA DO MARANHAO";69;2;1;72
2006;"JATOBA (MA)";"MA";"JATOBA";1;2;0;3
2006;"JENIPAPO DOS VIEIRAS (MA)";"MA";"JENIPAPO DOS VIEIRAS";20;0;1;21
2006;"JOAO LISBOA (MA)";"MA";"JOAO LISBOA";47;1;3;51
2006;"JOSELANDIA (MA)";"MA";"JOSELANDIA";27;5;3;35
2006;"JUNCO DO MARANHAO (MA)";"MA";"JUNCO DO MARANHAO";5;10;0;15
2006;"LAGO DA PEDRA (MA)";"MA";"LAGO DA PEDRA";143;20;4;167
2006;"LAGO DO JUNCO (MA)";"MA";"LAGO DO JUNCO";8;1;3;12
2006;"LAGO DOS RODRIGUES (MA)";"MA";"LAGO DOS RODRIGUES";24;2;2;28
2006;"LAGO VERDE (MA)";"MA";"LAGO VERDE";13;1;3;17
2006;"LAGOA DO MATO (MA)";"MA";"LAGOA DO MATO";3;0;1;4
2006;"LAGOA GRANDE DO MARANHAO (MA)";"MA";"LAGOA GRANDE DO MARANHAO";14;1;0;15
2006;"LAJEADO NOVO (MA)";"MA";"LAJEADO NOVO";6;1;0;7
2006;"LIMA CAMPOS (MA)";"MA";"LIMA CAMPOS";36;4;2;42
2006;"LORETO (MA)";"MA";"LORETO";2;1;1;4
2006;"LUIS DOMINGUES (MA)";"MA";"LUIS DOMINGUES";0;1;1;2
2006;"MAGALHAES DE ALMEIDA (MA)";"MA";"MAGALHAES DE ALMEIDA";5;3;1;9
2006;"MARACACUME (MA)";"MA";"MARACACUME";30;21;1;52
2006;"MARAJA DO SENA (MA)";"MA";"MARAJA DO SENA";3;0;0;3
2006;"MARANHAOZINHO (MA)";"MA";"MARANHAOZINHO";8;1;1;10
2006;"MATA ROMA (MA)";"MA";"MATA ROMA";24;1;4;29
2006;"MATINHA (MA)";"MA";"MATINHA";17;6;0;23
2006;"MATOES (MA)";"MA";"MATOES";8;1;2;11
2006;"MATOES DO NORTE (MA)";"MA";"MATOES DO NORTE";5;3;1;9
2006;"MILAGRES DO MARANHAO (MA)";"MA";"MILAGRES DO MARANHAO";3;2;2;7
2006;"MIRADOR (MA)";"MA";"MIRADOR";9;0;1;10
2006;"MIRANDA DO NORTE (MA)";"MA";"MIRANDA DO NORTE";57;2;2;61
2006;"MIRINZAL (MA)";"MA";"MIRINZAL";20;1;4;25
2006;"MONCAO (MA)";"MA";"MONCAO";8;4;3;15
2006;"MONTES ALTOS (MA)";"MA";"MONTES ALTOS";18;0;1;19
2006;"MORROS (MA)";"MA";"MORROS";4;3;2;9
2006;"NINA RODRIGUES (MA)";"MA";"NINA RODRIGUES";5;2;1;8
2006;"NOVA COLINAS (MA)";"MA";"NOVA COLINAS";3;0;1;4
2006;"NOVA IORQUE (MA)";"MA";"NOVA IORQUE";5;0;0;5
2006;"NOVA OLINDA DO MARANHAO (MA)";"MA";"NOVA OLINDA DO MARANHAO";17;14;1;32
2006;"OLHO D AGUA DAS CUNHAS (MA)";"MA";"OLHO D AGUA DAS CUNHAS";47;7;5;59
2006;"OLINDA NOVA DO MARANHAO (MA)";"MA";"OLINDA NOVA DO MARANHAO";7;2;0;9
2006;"PACO DO LUMIAR (MA)";"MA";"PACO DO LUMIAR";213;80;61;354
2006;"PALMEIRANDIA (MA)";"MA";"PALMEIRANDIA";4;1;4;9
2006;"PARAIBANO (MA)";"MA";"PARAIBANO";18;3;1;22
2006;"PARNARAMA (MA)";"MA";"PARNARAMA";12;1;0;13
2006;"PASSAGEM FRANCA (MA)";"MA";"PASSAGEM FRANCA";14;1;1;16
2006;"PASTOS BONS (MA)";"MA";"PASTOS BONS";28;3;1;32
2006;"PAULINO NEVES (MA)";"MA";"PAULINO NEVES";0;0;0;0
2006;"PAULO RAMOS (MA)";"MA";"PAULO RAMOS";39;3;0;42
2006;"PEDREIRAS (MA)";"MA";"PEDREIRAS";217;30;23;270
2006;"PEDRO DO ROSARIO (MA)";"MA";"PEDRO DO ROSARIO";10;1;1;12
2006;"PENALVA (MA)";"MA";"PENALVA";7;3;2;12
2006;"PERI MIRIM (MA)";"MA";"PERI MIRIM";11;5;5;21
2006;"PERITORO (MA)";"MA";"PERITORO";22;27;3;52
2006;"PINDARE MIRIM (MA)";"MA";"PINDARE MIRIM";58;3;13;74
2006;"PINHEIRO (MA)";"MA";"PINHEIRO";238;12;37;287
2006;"PIO XII (MA)";"MA";"PIO XII";61;3;1;65
2006;"PIRAPEMAS (MA)";"MA";"PIRAPEMAS";10;4;1;15
2006;"POCAO DE PEDRAS (MA)";"MA";"POCAO DE PEDRAS";36;6;3;45
2006;"PORTO FRANCO (MA)";"MA";"PORTO FRANCO";21;0;3;24
2006;"PORTO RICO DO MARANHAO (MA)";"MA";"PORTO RICO DO MARANHAO";2;0;1;3
2006;"PRESIDENTE DUTRA (MA)";"MA";"PRESIDENTE DUTRA";178;11;5;194
2006;"PRESIDENTE JUSCELINO (MA)";"MA";"PRESIDENTE JUSCELINO";4;1;2;7
2006;"PRESIDENTE MEDICI (MA)";"MA";"PRESIDENTE MEDICI";5;7;0;12
2006;"PRESIDENTE SARNEY (MA)";"MA";"PRESIDENTE SARNEY";1;0;1;2
2006;"PRESIDENTE VARGAS (MA)";"MA";"PRESIDENTE VARGAS";12;4;0;16
2006;"PRIMEIRA CRUZ (MA)";"MA";"PRIMEIRA CRUZ";0;1;0;1
2006;"RAPOSA (MA)";"MA";"RAPOSA";30;0;22;52
2006;"RIACHAO (MA)";"MA";"RIACHAO";19;1;3;23
2006;"RIBAMAR FIQUENE (MA)";"MA";"RIBAMAR FIQUENE";9;1;1;11
2006;"ROSARIO (MA)";"MA";"ROSARIO";115;9;18;142
2006;"SAMBAIBA (MA)";"MA";"SAMBAIBA";7;0;0;7
2006;"SANTA FILOMENA DO MARANHAO (MA)";"MA";"SANTA FILOMENA DO MARANHAO";3;2;0;5
2006;"SANTA HELENA (MA)";"MA";"SANTA HELENA";38;3;2;43
2006;"SANTA INES (MA)";"MA";"SANTA INES";375;84;60;519
2006;"SANTA LUZIA (MA)";"MA";"SANTA LUZIA";147;53;8;208
2006;"SANTA LUZIA DO PARUA (MA)";"MA";"SANTA LUZIA DO PARUA";59;6;2;67
2006;"SANTA QUITERIA DO MARANHAO (MA)";"MA";"SANTA QUITERIA DO MARANHAO";16;0;3;19
2006;"SANTA RITA (MA)";"MA";"SANTA RITA";64;6;2;72
2006;"SANTANA DO MARANHAO (MA)";"MA";"SANTANA DO MARANHAO";5;1;3;9
2006;"SANTO AMARO DO MARANHAO (MA)";"MA";"SANTO AMARO DO MARANHAO";1;3;0;4
2006;"SANTO ANTONIO DOS LOPES (MA)";"MA";"SANTO ANTONIO DOS LOPES";42;5;0;47
2006;"SAO BENEDITO DO RIO PRETO (MA)";"MA";"SAO BENEDITO DO RIO PRETO";7;9;1;17
2006;"SAO BENTO (MA)";"MA";"SAO BENTO";49;8;6;63
2006;"SAO BERNARDO (MA)";"MA";"SAO BERNARDO";36;0;6;42
2006;"SAO DOMINGOS DO AZEITAO (MA)";"MA";"SAO DOMINGOS DO AZEITAO";10;0;1;11
2006;"SAO DOMINGOS DO MARANHAO (MA)";"MA";"SAO DOMINGOS DO MARANHAO";78;3;1;82
2006;"SAO FELIX DE BALSAS (MA)";"MA";"SAO FELIX DE BALSAS";1;0;0;1
2006;"SAO FRANCISCO DO BREJAO (MA)";"MA";"SAO FRANCISCO DO BREJAO";28;1;2;31
2006;"SAO FRANCISCO DO MARANHAO (MA)";"MA";"SAO FRANCISCO DO MARANHAO";2;0;0;2
2006;"SAO JOAO BATISTA (MA)";"MA";"SAO JOAO BATISTA";19;4;3;26
2006;"SAO JOAO DO CARU (MA)";"MA";"SAO JOAO DO CARU";7;1;0;8
2006;"SAO JOAO DO PARAISO (MA)";"MA";"SAO JOAO DO PARAISO";2;0;1;3
2006;"SAO JOAO DO SOTER (MA)";"MA";"SAO JOAO DO SOTER";6;1;0;7
2006;"SAO JOAO DOS PATOS (MA)";"MA";"SAO JOAO DOS PATOS";79;1;2;82
2006;"SAO JOSE DE RIBAMAR (MA)";"MA";"SAO JOSE DE RIBAMAR";303;94;39;436
2006;"SAO JOSE DOS BASILIOS (MA)";"MA";"SAO JOSE DOS BASILIOS";5;1;2;8
2006;"SAO LUIS (MA)";"MA";"SAO LUIS";4866;850;2281;7997
2006;"SAO LUIS GONZAGA DO MARANHAO (MA)";"MA";"SAO LUIS GONZAGA DO MARANHAO";17;4;2;23
2006;"SAO MATEUS DO MARANHAO (MA)";"MA";"SAO MATEUS DO MARANHAO";61;33;12;106
2006;"SAO PEDRO DA AGUA BRANCA (MA)";"MA";"SAO PEDRO DA AGUA BRANCA";9;0;0;9
2006;"SAO PEDRO DOS CRENTES (MA)";"MA";"SAO PEDRO DOS CRENTES";3;1;0;4
2006;"SAO RAIMUNDO DAS MANGABEIRAS (MA)";"MA";"SAO RAIMUNDO DAS MANGABEIRAS";40;1;25;66
2006;"SAO RAIMUNDO DO DOCA BEZERRA (MA)";"MA";"SAO RAIMUNDO DO DOCA BEZERRA";12;0;0;12
2006;"SAO ROBERTO (MA)";"MA";"SAO ROBERTO";2;2;0;4
2006;"SAO VICENTE FERRER (MA)";"MA";"SAO VICENTE FERRER";16;1;3;20
2006;"SATUBINHA (MA)";"MA";"SATUBINHA";10;2;0;12
2006;"SENADOR ALEXANDRE COSTA (MA)";"MA";"SENADOR ALEXANDRE COSTA";13;2;1;16
2006;"SENADOR LA ROCQUE (MA)";"MA";"SENADOR LA ROCQUE";24;0;1;25
2006;"SERRANO DO MARANHAO (MA)";"MA";"SERRANO DO MARANHAO";0;0;1;1
2006;"SITIO NOVO (MA)";"MA";"SITIO NOVO";14;0;1;15
2006;"SUCUPIRA DO NORTE (MA)";"MA";"SUCUPIRA DO NORTE";10;1;1;12
2006;"SUCUPIRA DO RIACHAO (MA)";"MA";"SUCUPIRA DO RIACHAO";2;1;1;4
2006;"TASSO FRAGOSO (MA)";"MA";"TASSO FRAGOSO";17;1;1;19
2006;"TIMBIRAS (MA)";"MA";"TIMBIRAS";17;6;0;23
2006;"TIMON (MA)";"MA";"TIMON";320;24;23;367
2006;"TRIZIDELA DO VALE (MA)";"MA";"TRIZIDELA DO VALE";66;8;3;77
2006;"TUFILANDIA (MA)";"MA";"TUFILANDIA";3;4;0;7
2006;"TUNTUM (MA)";"MA";"TUNTUM";55;4;3;62
2006;"TURIACU (MA)";"MA";"TURIACU";10;1;4;15
2006;"TURILANDIA (MA)";"MA";"TURILANDIA";5;3;1;9
2006;"TUTOIA (MA)";"MA";"TUTOIA";12;2;4;18
2006;"URBANO SANTOS (MA)";"MA";"URBANO SANTOS";22;3;2;27
2006;"VARGEM GRANDE (MA)";"MA";"VARGEM GRANDE";58;2;2;62
2006;"VIANA (MA)";"MA";"VIANA";86;4;3;93
2006;"VILA NOVA DOS MARTIRIOS (MA)";"MA";"VILA NOVA DOS MARTIRIOS";4;1;0;5
2006;"VITORIA DO MEARIM (MA)";"MA";"VITORIA DO MEARIM";36;3;3;42
2006;"VITORINO FREIRE (MA)";"MA";"VITORINO FREIRE";88;8;5;101
2006;"ZE DOCA (MA)";"MA";"ZE DOCA";103;13;7;123
2006;"ABADIA DOS DOURADOS (MG)";"MG";"ABADIA DOS DOURADOS";76;21;5;102
2006;"ABAETE (MG)";"MG";"ABAETE";368;14;120;502
2006;"ABRE CAMPO (MG)";"MG";"ABRE CAMPO";101;8;30;139
2006;"ACAIACA (MG)";"MG";"ACAIACA";15;3;6;24
2006;"ACUCENA (MG)";"MG";"ACUCENA";24;3;20;47
2006;"AGUA BOA (MG)";"MG";"AGUA BOA";46;1;16;63
2006;"AGUA COMPRIDA (MG)";"MG";"AGUA COMPRIDA";33;7;6;46
2006;"AGUANIL (MG)";"MG";"AGUANIL";28;3;6;37
2006;"AGUAS FORMOSAS (MG)";"MG";"AGUAS FORMOSAS";53;10;9;72
2006;"AGUAS VERMELHAS (MG)";"MG";"AGUAS VERMELHAS";56;4;9;69
2006;"AIMORES (MG)";"MG";"AIMORES";157;7;20;184
2006;"AIURUOCA (MG)";"MG";"AIURUOCA";70;7;8;85
2006;"ALAGOA (MG)";"MG";"ALAGOA";13;0;8;21
2006;"ALBERTINA (MG)";"MG";"ALBERTINA";33;5;5;43
2006;"ALEM PARAIBA (MG)";"MG";"ALEM PARAIBA";1090;59;58;1207
2006;"ALFENAS (MG)";"MG";"ALFENAS";862;54;206;1122
2006;"ALFREDO VASCONCELOS (MG)";"MG";"ALFREDO VASCONCELOS";114;5;15;134
2006;"ALMENARA (MG)";"MG";"ALMENARA";156;19;58;233
2006;"ALPERCATA (MG)";"MG";"ALPERCATA";46;1;4;51
2006;"ALPINOPOLIS (MG)";"MG";"ALPINOPOLIS";347;13;23;383
2006;"ALTEROSA (MG)";"MG";"ALTEROSA";176;14;24;214
2006;"ALTO CAPARAO (MG)";"MG";"ALTO CAPARAO";40;4;3;47
2006;"ALTO JEQUITIBA (MG)";"MG";"ALTO JEQUITIBA";54;5;8;67
2006;"ALTO RIO DOCE (MG)";"MG";"ALTO RIO DOCE";78;5;15;98
2006;"ALVARENGA (MG)";"MG";"ALVARENGA";20;1;8;29
2006;"ALVINOPOLIS (MG)";"MG";"ALVINOPOLIS";122;13;20;155
2006;"ALVORADA DE MINAS (MG)";"MG";"ALVORADA DE MINAS";4;1;6;11
2006;"AMPARO DA SERRA (MG)";"MG";"AMPARO DA SERRA";26;2;14;42
2006;"ANDRADAS (MG)";"MG";"ANDRADAS";883;49;56;988
2006;"ANDRELANDIA (MG)";"MG";"ANDRELANDIA";106;9;6;121
2006;"ANGELANDIA (MG)";"MG";"ANGELANDIA";41;1;11;53
2006;"ANTONIO CARLOS (MG)";"MG";"ANTONIO CARLOS";118;6;13;137
2006;"ANTONIO DIAS (MG)";"MG";"ANTONIO DIAS";60;7;38;105
2006;"ANTONIO PRADO DE MINAS (MG)";"MG";"ANTONIO PRADO DE MINAS";11;0;4;15
2006;"ARACAI (MG)";"MG";"ARACAI";11;3;3;17
2006;"ARACITABA (MG)";"MG";"ARACITABA";9;3;1;13
2006;"ARACUAI (MG)";"MG";"ARACUAI";141;9;47;197
2006;"ARAGUARI (MG)";"MG";"ARAGUARI";1702;216;145;2063
2006;"ARANTINA (MG)";"MG";"ARANTINA";19;1;3;23
2006;"ARAPONGA (MG)";"MG";"ARAPONGA";37;2;7;46
2006;"ARAPORA (MG)";"MG";"ARAPORA";139;11;63;213
2006;"ARAPUA (MG)";"MG";"ARAPUA";32;2;11;45
2006;"ARAUJOS (MG)";"MG";"ARAUJOS";87;5;5;97
2006;"ARAXA (MG)";"MG";"ARAXA";1290;100;219;1609
2006;"ARCEBURGO (MG)";"MG";"ARCEBURGO";87;14;25;126
2006;"ARCOS (MG)";"MG";"ARCOS";794;47;168;1009
2006;"AREADO (MG)";"MG";"AREADO";167;10;59;236
2006;"ARGIRITA (MG)";"MG";"ARGIRITA";17;3;2;22
2006;"ARICANDUVA (MG)";"MG";"ARICANDUVA";8;0;7;15
2006;"ARINOS (MG)";"MG";"ARINOS";112;8;35;155
2006;"ASTOLFO DUTRA (MG)";"MG";"ASTOLFO DUTRA";169;6;15;190
2006;"ATALEIA (MG)";"MG";"ATALEIA";54;11;18;83
2006;"AUGUSTO DE LIMA (MG)";"MG";"AUGUSTO DE LIMA";23;1;11;35
2006;"BAEPENDI (MG)";"MG";"BAEPENDI";291;25;17;333
2006;"BALDIM (MG)";"MG";"BALDIM";88;4;6;98
2006;"BAMBUI (MG)";"MG";"BAMBUI";336;13;72;421
2006;"BANDEIRA (MG)";"MG";"BANDEIRA";1;2;1;4
2006;"BANDEIRA DO SUL (MG)";"MG";"BANDEIRA DO SUL";116;16;6;138
2006;"BARAO DE COCAIS (MG)";"MG";"BARAO DE COCAIS";310;36;44;390
2006;"BARAO DE MONTE ALTO (MG)";"MG";"BARAO DE MONTE ALTO";14;2;4;20
2006;"BARBACENA (MG)";"MG";"BARBACENA";1225;189;162;1576
2006;"BARRA LONGA (MG)";"MG";"BARRA LONGA";40;3;5;48
2006;"BARROSO (MG)";"MG";"BARROSO";299;16;15;330
2006;"BELA VISTA DE MINAS (MG)";"MG";"BELA VISTA DE MINAS";105;9;8;122
2006;"BELMIRO BRAGA (MG)";"MG";"BELMIRO BRAGA";34;6;2;42
2006;"BELO HORIZONTE (MG)";"MG";"BELO HORIZONTE";25087;4042;6730;35859
2006;"BELO ORIENTE (MG)";"MG";"BELO ORIENTE";220;11;61;292
2006;"BELO VALE (MG)";"MG";"BELO VALE";75;6;16;97
2006;"BERILO (MG)";"MG";"BERILO";44;4;23;71
2006;"BERIZAL (MG)";"MG";"BERIZAL";14;2;5;21
2006;"BERTOPOLIS (MG)";"MG";"BERTOPOLIS";7;1;1;9
2006;"BETIM (MG)";"MG";"BETIM";2855;370;714;3939
2006;"BIAS FORTES (MG)";"MG";"BIAS FORTES";19;1;3;23
2006;"BICAS (MG)";"MG";"BICAS";180;19;20;219
2006;"BIQUINHAS (MG)";"MG";"BIQUINHAS";28;7;2;37
2006;"BOA ESPERANCA (MG)";"MG";"BOA ESPERANCA";483;22;107;612
2006;"BOCAINA DE MINAS (MG)";"MG";"BOCAINA DE MINAS";42;6;5;53
2006;"BOCAIUVA (MG)";"MG";"BOCAIUVA";289;21;85;395
2006;"BOM DESPACHO (MG)";"MG";"BOM DESPACHO";821;34;201;1056
2006;"BOM JARDIM DE MINAS (MG)";"MG";"BOM JARDIM DE MINAS";70;5;7;82
2006;"BOM JESUS DA PENHA (MG)";"MG";"BOM JESUS DA PENHA";84;4;6;94
2006;"BOM JESUS DO AMPARO (MG)";"MG";"BOM JESUS DO AMPARO";42;4;6;52
2006;"BOM JESUS DO GALHO (MG)";"MG";"BOM JESUS DO GALHO";67;4;9;80
2006;"BOM REPOUSO (MG)";"MG";"BOM REPOUSO";142;9;4;155
2006;"BOM SUCESSO (MG)";"MG";"BOM SUCESSO";200;11;29;240
2006;"BONFIM (MG)";"MG";"BONFIM";85;11;12;108
2006;"BONFINOPOLIS DE MINAS (MG)";"MG";"BONFINOPOLIS DE MINAS";69;0;18;87
2006;"BONITO DE MINAS (MG)";"MG";"BONITO DE MINAS";15;2;12;29
2006;"BORDA DA MATA (MG)";"MG";"BORDA DA MATA";226;13;53;292
2006;"BOTELHOS (MG)";"MG";"BOTELHOS";208;23;22;253
2006;"BOTUMIRIM (MG)";"MG";"BOTUMIRIM";12;1;5;18
2006;"BRAS PIRES (MG)";"MG";"BRAS PIRES";26;3;7;36
2006;"BRASILANDIA DE MINAS (MG)";"MG";"BRASILANDIA DE MINAS";165;5;60;230
2006;"BRASILIA DE MINAS (MG)";"MG";"BRASILIA DE MINAS";131;7;58;196
2006;"BRASOPOLIS (MG)";"MG";"BRASOPOLIS";164;17;21;202
2006;"BRAUNAS (MG)";"MG";"BRAUNAS";6;4;10;20
2006;"BRUMADINHO (MG)";"MG";"BRUMADINHO";637;73;145;855
2006;"BUENO BRANDAO (MG)";"MG";"BUENO BRANDAO";127;14;19;160
2006;"BUENOPOLIS (MG)";"MG";"BUENOPOLIS";74;2;19;95
2006;"BUGRE (MG)";"MG";"BUGRE";21;1;3;25
2006;"BURITIS (MG)";"MG";"BURITIS";218;2;71;291
2006;"BURITIZEIRO (MG)";"MG";"BURITIZEIRO";149;1;48;198
2006;"CABECEIRA GRANDE (MG)";"MG";"CABECEIRA GRANDE";20;3;9;32
2006;"CABO VERDE (MG)";"MG";"CABO VERDE";164;9;20;193
2006;"CACHOEIRA DA PRATA (MG)";"MG";"CACHOEIRA DA PRATA";38;4;2;44
2006;"CACHOEIRA DE MINAS (MG)";"MG";"CACHOEIRA DE MINAS";97;16;11;124
2006;"CACHOEIRA DE PAJEU (MG)";"MG";"CACHOEIRA DE PAJEU";27;7;12;46
2006;"CACHOEIRA DOURADA (MG)";"MG";"CACHOEIRA DOURADA";12;6;2;20
2006;"CAETANOPOLIS (MG)";"MG";"CAETANOPOLIS";85;9;29;123
2006;"CAETE (MG)";"MG";"CAETE";399;50;66;515
2006;"CAIANA (MG)";"MG";"CAIANA";24;4;6;34
2006;"CAJURI (MG)";"MG";"CAJURI";35;3;6;44
2006;"CALDAS (MG)";"MG";"CALDAS";202;8;23;233
2006;"CAMACHO (MG)";"MG";"CAMACHO";51;2;5;58
2006;"CAMANDUCAIA (MG)";"MG";"CAMANDUCAIA";399;23;31;453
2006;"CAMBUI (MG)";"MG";"CAMBUI";398;22;78;498
2006;"CAMBUQUIRA (MG)";"MG";"CAMBUQUIRA";99;13;6;118
2006;"CAMPANARIO (MG)";"MG";"CAMPANARIO";12;5;4;21
2006;"CAMPANHA (MG)";"MG";"CAMPANHA";179;9;18;206
2006;"CAMPESTRE (MG)";"MG";"CAMPESTRE";377;18;32;427
2006;"CAMPINA VERDE (MG)";"MG";"CAMPINA VERDE";239;12;30;281
2006;"CAMPO AZUL (MG)";"MG";"CAMPO AZUL";2;0;3;5
2006;"CAMPO BELO (MG)";"MG";"CAMPO BELO";931;41;107;1079
2006;"CAMPO DO MEIO (MG)";"MG";"CAMPO DO MEIO";94;12;50;156
2006;"CAMPO FLORIDO (MG)";"MG";"CAMPO FLORIDO";86;15;38;139
2006;"CAMPOS ALTOS (MG)";"MG";"CAMPOS ALTOS";266;13;43;322
2006;"CAMPOS GERAIS (MG)";"MG";"CAMPOS GERAIS";239;10;44;293
2006;"CANA VERDE (MG)";"MG";"CANA VERDE";45;5;4;54
2006;"CANAA (MG)";"MG";"CANAA";48;2;8;58
2006;"CANAPOLIS (MG)";"MG";"CANAPOLIS";167;8;91;266
2006;"CANDEIAS (MG)";"MG";"CANDEIAS";207;9;22;238
2006;"CANTAGALO (MG)";"MG";"CANTAGALO";10;1;5;16
2006;"CAPARAO (MG)";"MG";"CAPARAO";40;2;3;45
2006;"CAPELA NOVA (MG)";"MG";"CAPELA NOVA";12;9;3;24
2006;"CAPELINHA (MG)";"MG";"CAPELINHA";480;17;112;609
2006;"CAPETINGA (MG)";"MG";"CAPETINGA";146;7;28;181
2006;"CAPIM BRANCO (MG)";"MG";"CAPIM BRANCO";47;6;14;67
2006;"CAPINOPOLIS (MG)";"MG";"CAPINOPOLIS";221;17;50;288
2006;"CAPITAO ANDRADE (MG)";"MG";"CAPITAO ANDRADE";17;1;2;20
2006;"CAPITAO ENEAS (MG)";"MG";"CAPITAO ENEAS";44;1;16;61
2006;"CAPITOLIO (MG)";"MG";"CAPITOLIO";127;12;12;151
2006;"CAPUTIRA (MG)";"MG";"CAPUTIRA";69;2;14;85
2006;"CARAI (MG)";"MG";"CARAI";39;23;25;87
2006;"CARANAIBA (MG)";"MG";"CARANAIBA";14;4;8;26
2006;"CARANDAI (MG)";"MG";"CARANDAI";388;18;70;476
2006;"CARANGOLA (MG)";"MG";"CARANGOLA";306;22;36;364
2006;"CARATINGA (MG)";"MG";"CARATINGA";946;32;1008;1986
2006;"CARBONITA (MG)";"MG";"CARBONITA";147;6;34;187
2006;"CAREACU (MG)";"MG";"CAREACU";65;6;3;74
2006;"CARLOS CHAGAS (MG)";"MG";"CARLOS CHAGAS";109;23;28;160
2006;"CARMESIA (MG)";"MG";"CARMESIA";45;1;913;959
2006;"CARMO DA CACHOEIRA (MG)";"MG";"CARMO DA CACHOEIRA";132;14;35;181
2006;"CARMO DA MATA (MG)";"MG";"CARMO DA MATA";100;11;29;140
2006;"CARMO DE MINAS (MG)";"MG";"CARMO DE MINAS";112;15;13;140
2006;"CARMO DO CAJURU (MG)";"MG";"CARMO DO CAJURU";241;16;52;309
2006;"CARMO DO PARANAIBA (MG)";"MG";"CARMO DO PARANAIBA";478;22;83;583
2006;"CARMO DO RIO CLARO (MG)";"MG";"CARMO DO RIO CLARO";242;12;53;307
2006;"CARMOPOLIS DE MINAS (MG)";"MG";"CARMOPOLIS DE MINAS";419;11;24;454
2006;"CARNEIRINHO (MG)";"MG";"CARNEIRINHO";127;22;47;196
2006;"CARRANCAS (MG)";"MG";"CARRANCAS";33;5;10;48
2006;"CARVALHOPOLIS (MG)";"MG";"CARVALHOPOLIS";32;9;4;45
2006;"CARVALHOS (MG)";"MG";"CARVALHOS";36;6;4;46
2006;"CASA GRANDE (MG)";"MG";"CASA GRANDE";21;1;1;23
2006;"CASCALHO RICO (MG)";"MG";"CASCALHO RICO";46;14;5;65
2006;"CASSIA (MG)";"MG";"CASSIA";340;14;24;378
2006;"CATAGUASES (MG)";"MG";"CATAGUASES";598;49;125;772
2006;"CATAS ALTAS (MG)";"MG";"CATAS ALTAS";84;8;6;98
2006;"CATAS ALTAS DA NORUEGA (MG)";"MG";"CATAS ALTAS DA NORUEGA";30;0;6;36
2006;"CATUJI (MG)";"MG";"CATUJI";26;6;7;39
2006;"CATUTI (MG)";"MG";"CATUTI";10;5;11;26
2006;"CAXAMBU (MG)";"MG";"CAXAMBU";187;21;15;223
2006;"CEDRO DO ABAETE (MG)";"MG";"CEDRO DO ABAETE";9;1;1;11
2006;"CENTRAL DE MINAS (MG)";"MG";"CENTRAL DE MINAS";61;5;8;74
2006;"CENTRALINA (MG)";"MG";"CENTRALINA";87;1;13;101
2006;"CHACARA (MG)";"MG";"CHACARA";20;5;2;27
2006;"CHALE (MG)";"MG";"CHALE";32;4;6;42
2006;"CHAPADA DO NORTE (MG)";"MG";"CHAPADA DO NORTE";23;6;13;42
2006;"CHAPADA GAUCHA (MG)";"MG";"CHAPADA GAUCHA";49;3;5;57
2006;"CHIADOR (MG)";"MG";"CHIADOR";28;4;3;35
2006;"CIPOTANEA (MG)";"MG";"CIPOTANEA";27;2;5;34
2006;"CLARAVAL (MG)";"MG";"CLARAVAL";169;5;27;201
2006;"CLARO DOS POCOES (MG)";"MG";"CLARO DOS POCOES";22;0;14;36
2006;"CLAUDIO (MG)";"MG";"CLAUDIO";574;20;36;630
2006;"COIMBRA (MG)";"MG";"COIMBRA";72;2;7;81
2006;"COLUNA (MG)";"MG";"COLUNA";24;1;9;34
2006;"COMENDADOR GOMES (MG)";"MG";"COMENDADOR GOMES";28;3;3;34
2006;"COMERCINHO (MG)";"MG";"COMERCINHO";18;2;9;29
2006;"CONCEICAO DA APARECIDA (MG)";"MG";"CONCEICAO DA APARECIDA";102;3;7;112
2006;"CONCEICAO DA BARRA DE MINAS (MG)";"MG";"CONCEICAO DA BARRA DE MINAS";29;5;3;37
2006;"CONCEICAO DAS ALAGOAS (MG)";"MG";"CONCEICAO DAS ALAGOAS";368;11;66;445
2006;"CONCEICAO DAS PEDRAS (MG)";"MG";"CONCEICAO DAS PEDRAS";18;6;1;25
2006;"CONCEICAO DE IPANEMA (MG)";"MG";"CONCEICAO DE IPANEMA";18;5;2;25
2006;"CONCEICAO DO MATO DENTRO (MG)";"MG";"CONCEICAO DO MATO DENTRO";73;6;68;147
2006;"CONCEICAO DO PARA (MG)";"MG";"CONCEICAO DO PARA";51;7;14;72
2006;"CONCEICAO DO RIO VERDE (MG)";"MG";"CONCEICAO DO RIO VERDE";176;24;14;214
2006;"CONCEICAO DOS OUROS (MG)";"MG";"CONCEICAO DOS OUROS";193;18;5;216
2006;"CONEGO MARINHO (MG)";"MG";"CONEGO MARINHO";6;2;5;13
2006;"CONFINS (MG)";"MG";"CONFINS";70;13;6;89
2006;"CONGONHAL (MG)";"MG";"CONGONHAL";173;4;11;188
2006;"CONGONHAS (MG)";"MG";"CONGONHAS";569;72;57;698
2006;"CONGONHAS DO NORTE (MG)";"MG";"CONGONHAS DO NORTE";20;2;3;25
2006;"CONQUISTA (MG)";"MG";"CONQUISTA";137;12;24;173
2006;"CONSELHEIRO LAFAIETE (MG)";"MG";"CONSELHEIRO LAFAIETE";949;158;377;1484
2006;"CONSELHEIRO PENA (MG)";"MG";"CONSELHEIRO PENA";165;3;41;209
2006;"CONSOLACAO (MG)";"MG";"CONSOLACAO";10;4;0;14
2006;"CONTAGEM (MG)";"MG";"CONTAGEM";9226;854;1782;11862
2006;"COQUEIRAL (MG)";"MG";"COQUEIRAL";75;7;9;91
2006;"CORACAO DE JESUS (MG)";"MG";"CORACAO DE JESUS";112;2;68;182
2006;"CORDISBURGO (MG)";"MG";"CORDISBURGO";64;5;6;75
2006;"CORDISLANDIA (MG)";"MG";"CORDISLANDIA";47;2;2;51
2006;"CORINTO (MG)";"MG";"CORINTO";212;3;49;264
2006;"COROACI (MG)";"MG";"COROACI";27;4;8;39
2006;"COROMANDEL (MG)";"MG";"COROMANDEL";453;25;76;554
2006;"CORONEL FABRICIANO (MG)";"MG";"CORONEL FABRICIANO";823;106;373;1302
2006;"CORONEL MURTA (MG)";"MG";"CORONEL MURTA";11;0;7;18
2006;"CORONEL PACHECO (MG)";"MG";"CORONEL PACHECO";30;4;6;40
2006;"CORONEL XAVIER CHAVES (MG)";"MG";"CORONEL XAVIER CHAVES";69;2;2;73
2006;"CORREGO DANTA (MG)";"MG";"CORREGO DANTA";23;3;8;34
2006;"CORREGO DO BOM JESUS (MG)";"MG";"CORREGO DO BOM JESUS";27;4;7;38
2006;"CORREGO FUNDO (MG)";"MG";"CORREGO FUNDO";280;9;13;302
2006;"CORREGO NOVO (MG)";"MG";"CORREGO NOVO";9;3;6;18
2006;"COUTO DE MAGALHAES DE MINAS (MG)";"MG";"COUTO DE MAGALHAES DE MINAS";38;0;8;46
2006;"CRISOLITA (MG)";"MG";"CRISOLITA";7;3;11;21
2006;"CRISTAIS (MG)";"MG";"CRISTAIS";103;5;9;117
2006;"CRISTALIA (MG)";"MG";"CRISTALIA";6;1;13;20
2006;"CRISTIANO OTONI (MG)";"MG";"CRISTIANO OTONI";69;6;7;82
2006;"CRISTINA (MG)";"MG";"CRISTINA";71;17;8;96
2006;"CRUCILANDIA (MG)";"MG";"CRUCILANDIA";101;2;6;109
2006;"CRUZEIRO DA FORTALEZA (MG)";"MG";"CRUZEIRO DA FORTALEZA";49;5;7;61
2006;"CRUZILIA (MG)";"MG";"CRUZILIA";246;13;16;275
2006;"CUPARAQUE (MG)";"MG";"CUPARAQUE";25;4;3;32
2006;"CURRAL DE DENTRO (MG)";"MG";"CURRAL DE DENTRO";32;5;4;41
2006;"CURVELO (MG)";"MG";"CURVELO";872;24;970;1866
2006;"DATAS (MG)";"MG";"DATAS";18;2;9;29
2006;"DELFIM MOREIRA (MG)";"MG";"DELFIM MOREIRA";70;2;14;86
2006;"DELFINOPOLIS (MG)";"MG";"DELFINOPOLIS";65;10;8;83
2006;"DELTA (MG)";"MG";"DELTA";359;18;103;480
2006;"DESCOBERTO (MG)";"MG";"DESCOBERTO";25;4;1;30
2006;"DESTERRO DE ENTRE RIOS (MG)";"MG";"DESTERRO DE ENTRE RIOS";80;4;17;101
2006;"DESTERRO DO MELO (MG)";"MG";"DESTERRO DO MELO";21;2;7;30
2006;"DIAMANTINA (MG)";"MG";"DIAMANTINA";251;41;235;527
2006;"DIOGO DE VASCONCELOS (MG)";"MG";"DIOGO DE VASCONCELOS";15;2;6;23
2006;"DIONISIO (MG)";"MG";"DIONISIO";35;3;11;49
2006;"DIVINESIA (MG)";"MG";"DIVINESIA";39;5;4;48
2006;"DIVINO (MG)";"MG";"DIVINO";192;9;29;230
2006;"DIVINO DAS LARANJEIRAS (MG)";"MG";"DIVINO DAS LARANJEIRAS";24;0;4;28
2006;"DIVINOLANDIA DE MINAS (MG)";"MG";"DIVINOLANDIA DE MINAS";36;5;15;56
2006;"DIVINOPOLIS (MG)";"MG";"DIVINOPOLIS";2766;167;620;3553
2006;"DIVISA ALEGRE (MG)";"MG";"DIVISA ALEGRE";26;2;5;33
2006;"DIVISA NOVA (MG)";"MG";"DIVISA NOVA";42;7;11;60
2006;"DIVISOPOLIS (MG)";"MG";"DIVISOPOLIS";10;7;4;21
2006;"DOM BOSCO (MG)";"MG";"DOM BOSCO";16;2;9;27
2006;"DOM CAVATI (MG)";"MG";"DOM CAVATI";89;3;5;97
2006;"DOM JOAQUIM (MG)";"MG";"DOM JOAQUIM";4;2;4;10
2006;"DOM SILVERIO (MG)";"MG";"DOM SILVERIO";41;6;4;51
2006;"DOM VICOSO (MG)";"MG";"DOM VICOSO";17;9;4;30
2006;"DONA EUZEBIA (MG)";"MG";"DONA EUZEBIA";237;4;2;243
2006;"DORES DE CAMPOS (MG)";"MG";"DORES DE CAMPOS";56;5;19;80
2006;"DORES DE GUANHAES (MG)";"MG";"DORES DE GUANHAES";33;0;14;47
2006;"DORES DO INDAIA (MG)";"MG";"DORES DO INDAIA";178;17;14;209
2006;"DORES DO TURVO (MG)";"MG";"DORES DO TURVO";26;3;14;43
2006;"DORESOPOLIS (MG)";"MG";"DORESOPOLIS";10;6;1;17
2006;"DOURADOQUARA (MG)";"MG";"DOURADOQUARA";27;6;1;34
2006;"DURANDE (MG)";"MG";"DURANDE";66;2;10;78
2006;"ELOI MENDES (MG)";"MG";"ELOI MENDES";424;31;25;480
2006;"ENGENHEIRO CALDAS (MG)";"MG";"ENGENHEIRO CALDAS";93;4;4;101
2006;"ENGENHEIRO NAVARRO (MG)";"MG";"ENGENHEIRO NAVARRO";31;0;13;44
2006;"ENTRE FOLHAS (MG)";"MG";"ENTRE FOLHAS";51;2;2;55
2006;"ENTRE RIOS DE MINAS (MG)";"MG";"ENTRE RIOS DE MINAS";200;12;40;252
2006;"ERVALIA (MG)";"MG";"ERVALIA";235;4;19;258
2006;"ESMERALDAS (MG)";"MG";"ESMERALDAS";294;23;137;454
2006;"ESPERA FELIZ (MG)";"MG";"ESPERA FELIZ";238;23;27;288
2006;"ESPINOSA (MG)";"MG";"ESPINOSA";261;6;33;300
2006;"ESPIRITO SANTO DO DOURADO (MG)";"MG";"ESPIRITO SANTO DO DOURADO";59;1;4;64
2006;"ESTIVA (MG)";"MG";"ESTIVA";215;9;13;237
2006;"ESTRELA DALVA (MG)";"MG";"ESTRELA DALVA";18;3;0;21
2006;"ESTRELA DO INDAIA (MG)";"MG";"ESTRELA DO INDAIA";31;2;2;35
2006;"ESTRELA DO SUL (MG)";"MG";"ESTRELA DO SUL";72;3;13;88
2006;"EUGENOPOLIS (MG)";"MG";"EUGENOPOLIS";52;10;18;80
2006;"EWBANK DA CAMARA (MG)";"MG";"EWBANK DA CAMARA";32;1;3;36
2006;"EXTREMA (MG)";"MG";"EXTREMA";355;45;42;442
2006;"FAMA (MG)";"MG";"FAMA";11;7;1;19
2006;"FARIA LEMOS (MG)";"MG";"FARIA LEMOS";18;5;0;23
2006;"FELICIO DOS SANTOS (MG)";"MG";"FELICIO DOS SANTOS";12;4;10;26
2006;"FELISBURGO (MG)";"MG";"FELISBURGO";8;3;5;16
2006;"FELIXLANDIA (MG)";"MG";"FELIXLANDIA";162;5;36;203
2006;"FERNANDES TOURINHO (MG)";"MG";"FERNANDES TOURINHO";7;6;5;18
2006;"FERROS (MG)";"MG";"FERROS";73;4;28;105
2006;"FERVEDOURO (MG)";"MG";"FERVEDOURO";76;4;6;86
2006;"FLORESTAL (MG)";"MG";"FLORESTAL";44;6;12;62
2006;"FORMIGA (MG)";"MG";"FORMIGA";1232;81;177;1490
2006;"FORMOSO (MG)";"MG";"FORMOSO";20;0;18;38
2006;"FORTALEZA DE MINAS (MG)";"MG";"FORTALEZA DE MINAS";48;12;5;65
2006;"FORTUNA DE MINAS (MG)";"MG";"FORTUNA DE MINAS";21;2;6;29
2006;"FRANCISCO BADARO (MG)";"MG";"FRANCISCO BADARO";23;2;12;37
2006;"FRANCISCO DUMONT (MG)";"MG";"FRANCISCO DUMONT";38;1;15;54
2006;"FRANCISCO SA (MG)";"MG";"FRANCISCO SA";93;5;44;142
2006;"FRANCISCOPOLIS (MG)";"MG";"FRANCISCOPOLIS";10;1;5;16
2006;"FREI GASPAR (MG)";"MG";"FREI GASPAR";11;4;5;20
2006;"FREI INOCENCIO (MG)";"MG";"FREI INOCENCIO";85;9;15;109
2006;"FREI LAGONEGRO (MG)";"MG";"FREI LAGONEGRO";2;3;4;9
2006;"FRONTEIRA (MG)";"MG";"FRONTEIRA";209;19;55;283
2006;"FRONTEIRA DOS VALES (MG)";"MG";"FRONTEIRA DOS VALES";6;2;0;8
2006;"FRUTA DE LEITE (MG)";"MG";"FRUTA DE LEITE";19;1;16;36
2006;"FRUTAL (MG)";"MG";"FRUTAL";1210;91;121;1422
2006;"FUNILANDIA (MG)";"MG";"FUNILANDIA";25;3;6;34
2006;"GALILEIA (MG)";"MG";"GALILEIA";57;2;7;66
2006;"GAMELEIRAS (MG)";"MG";"GAMELEIRAS";21;1;8;30
2006;"GLAUCILANDIA (MG)";"MG";"GLAUCILANDIA";1;1;3;5
2006;"GOIABEIRA (MG)";"MG";"GOIABEIRA";18;4;3;25
2006;"GOIANA (MG)";"MG";"GOIANA";14;2;4;20
2006;"GONCALVES (MG)";"MG";"GONCALVES";69;10;5;84
2006;"GONZAGA (MG)";"MG";"GONZAGA";21;5;8;34
2006;"GOUVEA (MG)";"MG";"GOUVEA";112;5;19;136
2006;"GOVERNADOR VALADARES (MG)";"MG";"GOVERNADOR VALADARES";2689;183;309;3181
2006;"GRAO MOGOL (MG)";"MG";"GRAO MOGOL";34;1;52;87
2006;"GRUPIARA (MG)";"MG";"GRUPIARA";9;0;1;10
2006;"GUANHAES (MG)";"MG";"GUANHAES";311;20;68;399
2006;"GUAPE (MG)";"MG";"GUAPE";124;8;34;166
2006;"GUARACIABA (MG)";"MG";"GUARACIABA";43;6;18;67
2006;"GUARACIAMA (MG)";"MG";"GUARACIAMA";19;4;15;38
2006;"GUARANESIA (MG)";"MG";"GUARANESIA";292;20;55;367
2006;"GUARANI (MG)";"MG";"GUARANI";89;8;7;104
2006;"GUARARA (MG)";"MG";"GUARARA";42;8;1;51
2006;"GUARDA MOR (MG)";"MG";"GUARDA MOR";68;10;10;88
2006;"GUAXUPE (MG)";"MG";"GUAXUPE";708;44;148;900
2006;"GUIDOVAL (MG)";"MG";"GUIDOVAL";94;0;3;97
2006;"GUIMARANIA (MG)";"MG";"GUIMARANIA";110;4;14;128
2006;"GUIRICEMA (MG)";"MG";"GUIRICEMA";162;5;15;182
2006;"GURINHATA (MG)";"MG";"GURINHATA";74;7;18;99
2006;"HELIODORA (MG)";"MG";"HELIODORA";53;5;7;65
2006;"IAPU (MG)";"MG";"IAPU";95;9;13;117
2006;"IBERTIOGA (MG)";"MG";"IBERTIOGA";31;5;2;38
2006;"IBIA (MG)";"MG";"IBIA";311;16;71;398
2006;"IBIAI (MG)";"MG";"IBIAI";38;2;4;44
2006;"IBIRACATU (MG)";"MG";"IBIRACATU";6;2;6;14
2006;"IBIRACI (MG)";"MG";"IBIRACI";323;22;23;368
2006;"IBIRITE (MG)";"MG";"IBIRITE";857;100;196;1153
2006;"IBITIURA DE MINAS (MG)";"MG";"IBITIURA DE MINAS";62;1;3;66
2006;"IBITURUNA (MG)";"MG";"IBITURUNA";26;4;1;31
2006;"ICARAI DE MINAS (MG)";"MG";"ICARAI DE MINAS";14;2;1;17
2006;"IGARAPE (MG)";"MG";"IGARAPE";486;34;94;614
2006;"IGARATINGA (MG)";"MG";"IGARATINGA";286;4;12;302
2006;"IGUATAMA (MG)";"MG";"IGUATAMA";104;3;13;120
2006;"IJACI (MG)";"MG";"IJACI";79;2;9;90
2006;"ILICINEA (MG)";"MG";"ILICINEA";151;3;25;179
2006;"IMBE DE MINAS (MG)";"MG";"IMBE DE MINAS";23;1;5;29
2006;"INCONFIDENTES (MG)";"MG";"INCONFIDENTES";61;11;10;82
2006;"INDAIABIRA (MG)";"MG";"INDAIABIRA";25;4;13;42
2006;"INDIANOPOLIS (MG)";"MG";"INDIANOPOLIS";43;25;11;79
2006;"INGAI (MG)";"MG";"INGAI";16;6;4;26
2006;"INHAPIM (MG)";"MG";"INHAPIM";222;10;34;266
2006;"INHAUMA (MG)";"MG";"INHAUMA";58;2;11;71
2006;"INIMUTABA (MG)";"MG";"INIMUTABA";25;2;3;30
2006;"IPABA (MG)";"MG";"IPABA";53;11;17;81
2006;"IPANEMA (MG)";"MG";"IPANEMA";131;11;19;161
2006;"IPATINGA (MG)";"MG";"IPATINGA";2289;357;422;3068
2006;"IPIACU (MG)";"MG";"IPIACU";38;1;4;43
2006;"IPUIUNA (MG)";"MG";"IPUIUNA";292;14;9;315
2006;"IRAI DE MINAS (MG)";"MG";"IRAI DE MINAS";140;12;17;169
2006;"ITABIRA (MG)";"MG";"ITABIRA";1053;186;306;1545
2006;"ITABIRINHA DE MANTENA (MG)";"MG";"ITABIRINHA DE MANTENA";101;0;24;125
2006;"ITABIRITO (MG)";"MG";"ITABIRITO";633;86;184;903
2006;"ITACAMBIRA (MG)";"MG";"ITACAMBIRA";9;0;5;14
2006;"ITACARAMBI (MG)";"MG";"ITACARAMBI";61;4;25;90
2006;"ITAGUARA (MG)";"MG";"ITAGUARA";283;5;30;318
2006;"ITAIPE (MG)";"MG";"ITAIPE";37;2;17;56
2006;"ITAJUBA (MG)";"MG";"ITAJUBA";750;71;95;916
2006;"ITAMARANDIBA (MG)";"MG";"ITAMARANDIBA";458;15;64;537
2006;"ITAMARATI DE MINAS (MG)";"MG";"ITAMARATI DE MINAS";64;5;8;77
2006;"ITAMBACURI (MG)";"MG";"ITAMBACURI";140;8;24;172
2006;"ITAMBE DO MATO DENTRO (MG)";"MG";"ITAMBE DO MATO DENTRO";12;2;2;16
2006;"ITAMOGI (MG)";"MG";"ITAMOGI";159;12;16;187
2006;"ITAMONTE (MG)";"MG";"ITAMONTE";259;21;22;302
2006;"ITANHANDU (MG)";"MG";"ITANHANDU";243;19;14;276
2006;"ITANHOMI (MG)";"MG";"ITANHOMI";82;5;13;100
2006;"ITAOBIM (MG)";"MG";"ITAOBIM";175;16;25;216
2006;"ITAPAGIPE (MG)";"MG";"ITAPAGIPE";191;6;21;218
2006;"ITAPECERICA (MG)";"MG";"ITAPECERICA";252;17;46;315
2006;"ITAPEVA (MG)";"MG";"ITAPEVA";197;6;8;211
2006;"ITATIAIUCU (MG)";"MG";"ITATIAIUCU";224;5;18;247
2006;"ITAU DE MINAS (MG)";"MG";"ITAU DE MINAS";248;13;33;294
2006;"ITAUNA (MG)";"MG";"ITAUNA";1133;120;200;1453
2006;"ITAVERAVA (MG)";"MG";"ITAVERAVA";30;0;8;38
2006;"ITINGA (MG)";"MG";"ITINGA";39;4;18;61
2006;"ITUETA (MG)";"MG";"ITUETA";38;1;10;49
2006;"ITUIUTABA (MG)";"MG";"ITUIUTABA";1077;101;177;1355
2006;"ITUMIRIM (MG)";"MG";"ITUMIRIM";46;7;4;57
2006;"ITURAMA (MG)";"MG";"ITURAMA";591;30;156;777
2006;"ITUTINGA (MG)";"MG";"ITUTINGA";53;16;0;69
2006;"JABOTICATUBAS (MG)";"MG";"JABOTICATUBAS";128;7;34;169
2006;"JACINTO (MG)";"MG";"JACINTO";14;4;13;31
2006;"JACUI (MG)";"MG";"JACUI";103;12;12;127
2006;"JACUTINGA (MG)";"MG";"JACUTINGA";264;33;39;336
2006;"JAGUARACU (MG)";"MG";"JAGUARACU";29;2;3;34
2006;"JAIBA (MG)";"MG";"JAIBA";201;6;41;248
2006;"JAMPRUCA (MG)";"MG";"JAMPRUCA";8;2;14;24
2006;"JANAUBA (MG)";"MG";"JANAUBA";559;8;73;640
2006;"JANUARIA (MG)";"MG";"JANUARIA";231;12;52;295
2006;"JAPARAIBA (MG)";"MG";"JAPARAIBA";36;1;14;51
2006;"JAPONVAR (MG)";"MG";"JAPONVAR";7;1;9;17
2006;"JECEABA (MG)";"MG";"JECEABA";37;11;4;52
2006;"JENIPAPO DE MINAS (MG)";"MG";"JENIPAPO DE MINAS";14;2;8;24
2006;"JEQUERI (MG)";"MG";"JEQUERI";54;7;25;86
2006;"JEQUITAI (MG)";"MG";"JEQUITAI";56;3;7;66
2006;"JEQUITIBA (MG)";"MG";"JEQUITIBA";42;3;20;65
2006;"JEQUITINHONHA (MG)";"MG";"JEQUITINHONHA";52;8;13;73
2006;"JESUANIA (MG)";"MG";"JESUANIA";58;8;6;72
2006;"JOAIMA (MG)";"MG";"JOAIMA";52;6;17;75
2006;"JOANESIA (MG)";"MG";"JOANESIA";10;2;8;20
2006;"JOAO MONLEVADE (MG)";"MG";"JOAO MONLEVADE";852;75;174;1101
2006;"JOAO PINHEIRO (MG)";"MG";"JOAO PINHEIRO";650;10;148;808
2006;"JOAQUIM FELICIO (MG)";"MG";"JOAQUIM FELICIO";26;0;7;33
2006;"JORDANIA (MG)";"MG";"JORDANIA";12;8;8;28
2006;"JOSE GONCALVES DE MINAS (MG)";"MG";"JOSE GONCALVES DE MINAS";23;4;5;32
2006;"JOSE RAYDAN (MG)";"MG";"JOSE RAYDAN";15;1;7;23
2006;"JOSENOPOLIS (MG)";"MG";"JOSENOPOLIS";16;2;2;20
2006;"JUATUBA (MG)";"MG";"JUATUBA";147;18;144;309
2006;"JUIZ DE FORA (MG)";"MG";"JUIZ DE FORA";4065;413;1171;5649
2006;"JURAMENTO (MG)";"MG";"JURAMENTO";13;2;12;27
2006;"JURUAIA (MG)";"MG";"JURUAIA";51;7;10;68
2006;"JUVENILIA (MG)";"MG";"JUVENILIA";9;3;6;18
2006;"LADAINHA (MG)";"MG";"LADAINHA";33;7;14;54
2006;"LAGAMAR (MG)";"MG";"LAGAMAR";64;12;15;91
2006;"LAGOA DA PRATA (MG)";"MG";"LAGOA DA PRATA";571;27;144;742
2006;"LAGOA DOS PATOS (MG)";"MG";"LAGOA DOS PATOS";26;1;6;33
2006;"LAGOA DOURADA (MG)";"MG";"LAGOA DOURADA";257;8;31;296
2006;"LAGOA FORMOSA (MG)";"MG";"LAGOA FORMOSA";203;12;60;275
2006;"LAGOA GRANDE (MG)";"MG";"LAGOA GRANDE";81;1;39;121
2006;"LAGOA SANTA (MG)";"MG";"LAGOA SANTA";533;62;78;673
2006;"LAJINHA (MG)";"MG";"LAJINHA";172;7;25;204
2006;"LAMBARI (MG)";"MG";"LAMBARI";240;25;18;283
2006;"LAMIM (MG)";"MG";"LAMIM";34;2;3;39
2006;"LARANJAL (MG)";"MG";"LARANJAL";131;5;1;137
2006;"LASSANCE (MG)";"MG";"LASSANCE";34;2;5;41
2006;"LAVRAS (MG)";"MG";"LAVRAS";877;108;162;1147
2006;"LEANDRO FERREIRA (MG)";"MG";"LEANDRO FERREIRA";34;2;3;39
2006;"LEME DO PRADO (MG)";"MG";"LEME DO PRADO";24;3;13;40
2006;"LEOPOLDINA (MG)";"MG";"LEOPOLDINA";564;42;55;661
2006;"LIBERDADE (MG)";"MG";"LIBERDADE";61;8;5;74
2006;"LIMA DUARTE (MG)";"MG";"LIMA DUARTE";151;8;36;195
2006;"LIMEIRA DO OESTE (MG)";"MG";"LIMEIRA DO OESTE";88;8;36;132
2006;"LONTRA (MG)";"MG";"LONTRA";9;2;5;16
2006;"LUISBURGO (MG)";"MG";"LUISBURGO";18;1;18;37
2006;"LUISLANDIA (MG)";"MG";"LUISLANDIA";6;3;2;11
2006;"LUMINARIAS (MG)";"MG";"LUMINARIAS";78;5;24;107
2006;"LUZ (MG)";"MG";"LUZ";252;42;20;314
2006;"MACHACALIS (MG)";"MG";"MACHACALIS";21;1;5;27
2006;"MACHADO (MG)";"MG";"MACHADO";578;54;73;705
2006;"MADRE DE DEUS DE MINAS (MG)";"MG";"MADRE DE DEUS DE MINAS";53;4;3;60
2006;"MALACACHETA (MG)";"MG";"MALACACHETA";80;1;32;113
2006;"MAMONAS (MG)";"MG";"MAMONAS";55;2;6;63
2006;"MANGA (MG)";"MG";"MANGA";80;3;27;110
2006;"MANHUACU (MG)";"MG";"MANHUACU";1127;51;106;1284
2006;"MANHUMIRIM (MG)";"MG";"MANHUMIRIM";254;23;28;305
2006;"MANTENA (MG)";"MG";"MANTENA";534;22;68;624
2006;"MAR DE ESPANHA (MG)";"MG";"MAR DE ESPANHA";119;11;11;141
2006;"MARAVILHAS (MG)";"MG";"MARAVILHAS";134;5;5;144
2006;"MARIA DA FE (MG)";"MG";"MARIA DA FE";211;10;24;245
2006;"MARIANA (MG)";"MG";"MARIANA";369;87;173;629
2006;"MARILAC (MG)";"MG";"MARILAC";9;4;2;15
2006;"MARIO CAMPOS (MG)";"MG";"MARIO CAMPOS";148;6;10;164
2006;"MARIPA DE MINAS (MG)";"MG";"MARIPA DE MINAS";29;5;2;36
2006;"MARLIERIA (MG)";"MG";"MARLIERIA";25;4;4;33
2006;"MARMELOPOLIS (MG)";"MG";"MARMELOPOLIS";18;6;6;30
2006;"MARTINHO CAMPOS (MG)";"MG";"MARTINHO CAMPOS";319;13;57;389
2006;"MARTINS SOARES (MG)";"MG";"MARTINS SOARES";43;2;11;56
2006;"MATA VERDE (MG)";"MG";"MATA VERDE";14;6;3;23
2006;"MATERLANDIA (MG)";"MG";"MATERLANDIA";12;2;6;20
2006;"MATEUS LEME (MG)";"MG";"MATEUS LEME";317;35;65;417
2006;"MATHIAS LOBATO (MG)";"MG";"MATHIAS LOBATO";36;2;4;42
2006;"MATIAS BARBOSA (MG)";"MG";"MATIAS BARBOSA";319;12;30;361
2006;"MATIAS CARDOSO (MG)";"MG";"MATIAS CARDOSO";10;2;8;20
2006;"MATIPO (MG)";"MG";"MATIPO";196;21;17;234
2006;"MATO VERDE (MG)";"MG";"MATO VERDE";106;4;21;131
2006;"MATOZINHOS (MG)";"MG";"MATOZINHOS";247;46;71;364
2006;"MATUTINA (MG)";"MG";"MATUTINA";69;9;4;82
2006;"MEDEIROS (MG)";"MG";"MEDEIROS";24;9;2;35
2006;"MEDINA (MG)";"MG";"MEDINA";99;23;26;148
2006;"MENDES PIMENTEL (MG)";"MG";"MENDES PIMENTEL";24;1;9;34
2006;"MERCES (MG)";"MG";"MERCES";100;4;9;113
2006;"MESQUITA (MG)";"MG";"MESQUITA";14;3;3;20
2006;"MINAS NOVAS (MG)";"MG";"MINAS NOVAS";72;14;59;145
2006;"MINDURI (MG)";"MG";"MINDURI";44;6;4;54
2006;"MIRABELA (MG)";"MG";"MIRABELA";60;4;19;83
2006;"MIRADOURO (MG)";"MG";"MIRADOURO";90;2;23;115
2006;"MIRAI (MG)";"MG";"MIRAI";112;11;16;139
2006;"MIRAVANIA (MG)";"MG";"MIRAVANIA";9;1;6;16
2006;"MOEDA (MG)";"MG";"MOEDA";54;3;12;69
2006;"MOEMA (MG)";"MG";"MOEMA";111;8;104;223
2006;"MONJOLOS (MG)";"MG";"MONJOLOS";5;1;6;12
2006;"MONSENHOR PAULO (MG)";"MG";"MONSENHOR PAULO";128;10;5;143
2006;"MONTALVANIA (MG)";"MG";"MONTALVANIA";77;3;35;115
2006;"MONTE ALEGRE DE MINAS (MG)";"MG";"MONTE ALEGRE DE MINAS";416;10;27;453
2006;"MONTE AZUL (MG)";"MG";"MONTE AZUL";139;6;31;176
2006;"MONTE BELO (MG)";"MG";"MONTE BELO";212;17;36;265
2006;"MONTE CARMELO (MG)";"MG";"MONTE CARMELO";1045;46;97;1188
2006;"MONTE FORMOSO (MG)";"MG";"MONTE FORMOSO";7;3;8;18
2006;"MONTE SANTO DE MINAS (MG)";"MG";"MONTE SANTO DE MINAS";356;13;69;438
2006;"MONTE SIAO (MG)";"MG";"MONTE SIAO";181;30;34;245
2006;"MONTES CLAROS (MG)";"MG";"MONTES CLAROS";3449;152;853;4454
2006;"MONTEZUMA (MG)";"MG";"MONTEZUMA";19;5;15;39
2006;"MORADA NOVA DE MINAS (MG)";"MG";"MORADA NOVA DE MINAS";83;16;15;114
2006;"MORRO DA GARCA (MG)";"MG";"MORRO DA GARCA";42;2;16;60
2006;"MORRO DO PILAR (MG)";"MG";"MORRO DO PILAR";25;5;1;31
2006;"MUNHOZ (MG)";"MG";"MUNHOZ";69;5;8;82
2006;"MURIAE (MG)";"MG";"MURIAE";1064;58;136;1258
2006;"MUTUM (MG)";"MG";"MUTUM";124;14;29;167
2006;"MUZAMBINHO (MG)";"MG";"MUZAMBINHO";263;34;28;325
2006;"NACIP RAYDAN (MG)";"MG";"NACIP RAYDAN";4;0;3;7
2006;"NANUQUE (MG)";"MG";"NANUQUE";510;38;142;690
2006;"NAQUE (MG)";"MG";"NAQUE";22;2;18;42
2006;"NATALANDIA (MG)";"MG";"NATALANDIA";13;2;11;26
2006;"NATERCIA (MG)";"MG";"NATERCIA";67;4;12;83
2006;"NAZARENO (MG)";"MG";"NAZARENO";136;9;17;162
2006;"NEPOMUCENO (MG)";"MG";"NEPOMUCENO";355;13;43;411
2006;"NINHEIRA (MG)";"MG";"NINHEIRA";17;2;19;38
2006;"NOVA BELEM (MG)";"MG";"NOVA BELEM";27;1;7;35
2006;"NOVA ERA (MG)";"MG";"NOVA ERA";149;15;72;236
2006;"NOVA LIMA (MG)";"MG";"NOVA LIMA";734;193;119;1046
2006;"NOVA MODICA (MG)";"MG";"NOVA MODICA";13;2;12;27
2006;"NOVA PONTE (MG)";"MG";"NOVA PONTE";144;35;53;232
2006;"NOVA PORTEIRINHA (MG)";"MG";"NOVA PORTEIRINHA";22;2;12;36
2006;"NOVA RESENDE (MG)";"MG";"NOVA RESENDE";264;10;21;295
2006;"NOVA SERRANA (MG)";"MG";"NOVA SERRANA";302;29;41;372
2006;"NOVA UNIAO (MG)";"MG";"NOVA UNIAO";97;6;12;115
2006;"NOVO CRUZEIRO (MG)";"MG";"NOVO CRUZEIRO";85;19;64;168
2006;"NOVO ORIENTE DE MINAS (MG)";"MG";"NOVO ORIENTE DE MINAS";22;5;12;39
2006;"NOVORIZONTE (MG)";"MG";"NOVORIZONTE";34;0;9;43
2006;"OLARIA (MG)";"MG";"OLARIA";9;5;3;17
2006;"OLHOS D AGUA (MG)";"MG";"OLHOS D AGUA";30;6;21;57
2006;"OLIMPIO NORONHA (MG)";"MG";"OLIMPIO NORONHA";22;8;5;35
2006;"OLIVEIRA (MG)";"MG";"OLIVEIRA";631;26;57;714
2006;"OLIVEIRA FORTES (MG)";"MG";"OLIVEIRA FORTES";16;5;2;23
2006;"ONCA DE PITANGUI (MG)";"MG";"ONCA DE PITANGUI";21;4;7;32
2006;"ORATORIOS (MG)";"MG";"ORATORIOS";36;1;13;50
2006;"ORIZANIA (MG)";"MG";"ORIZANIA";38;6;7;51
2006;"OURO BRANCO (MG)";"MG";"OURO BRANCO";347;54;158;559
2006;"OURO FINO (MG)";"MG";"OURO FINO";410;28;71;509
2006;"OURO PRETO (MG)";"MG";"OURO PRETO";762;120;281;1163
2006;"OURO VERDE DE MINAS (MG)";"MG";"OURO VERDE DE MINAS";13;2;3;18
2006;"PADRE CARVALHO (MG)";"MG";"PADRE CARVALHO";7;1;12;20
2006;"PADRE PARAISO (MG)";"MG";"PADRE PARAISO";79;54;44;177
2006;"PAI PEDRO (MG)";"MG";"PAI PEDRO";12;5;18;35
2006;"PAINEIRAS (MG)";"MG";"PAINEIRAS";77;9;13;99
2006;"PAINS (MG)";"MG";"PAINS";184;11;19;214
2006;"PAIVA (MG)";"MG";"PAIVA";11;3;2;16
2006;"PALMA (MG)";"MG";"PALMA";67;2;4;73
2006;"PALMOPOLIS (MG)";"MG";"PALMOPOLIS";14;3;6;23
2006;"PAPAGAIOS (MG)";"MG";"PAPAGAIOS";478;7;43;528
2006;"PARA DE MINAS (MG)";"MG";"PARA DE MINAS";1540;94;170;1804
2006;"PARACATU (MG)";"MG";"PARACATU";991;35;202;1228
2006;"PARAGUACU (MG)";"MG";"PARAGUACU";248;27;23;298
2006;"PARAISOPOLIS (MG)";"MG";"PARAISOPOLIS";312;26;22;360
2006;"PARAOPEBA (MG)";"MG";"PARAOPEBA";360;16;46;422
2006;"PASSA QUATRO (MG)";"MG";"PASSA QUATRO";269;16;23;308
2006;"PASSA TEMPO (MG)";"MG";"PASSA TEMPO";118;14;12;144
2006;"PASSA VINTE (MG)";"MG";"PASSA VINTE";12;7;6;25
2006;"PASSABEM (MG)";"MG";"PASSABEM";4;2;2;8
2006;"PASSOS (MG)";"MG";"PASSOS";1531;91;280;1902
2006;"PATIS (MG)";"MG";"PATIS";3;1;5;9
2006;"PATOS DE MINAS (MG)";"MG";"PATOS DE MINAS";2139;85;835;3059
2006;"PATROCINIO (MG)";"MG";"PATROCINIO";1283;54;394;1731
2006;"PATROCINIO DO MURIAE (MG)";"MG";"PATROCINIO DO MURIAE";53;1;2;56
2006;"PAULA CANDIDO (MG)";"MG";"PAULA CANDIDO";41;7;12;60
2006;"PAULISTAS (MG)";"MG";"PAULISTAS";13;1;8;22
2006;"PAVAO (MG)";"MG";"PAVAO";31;9;6;46
2006;"PECANHA (MG)";"MG";"PECANHA";110;4;41;155
2006;"PEDRA AZUL (MG)";"MG";"PEDRA AZUL";120;12;45;177
2006;"PEDRA BONITA (MG)";"MG";"PEDRA BONITA";17;5;7;29
2006;"PEDRA DO ANTA (MG)";"MG";"PEDRA DO ANTA";11;0;12;23
2006;"PEDRA DO INDAIA (MG)";"MG";"PEDRA DO INDAIA";51;3;4;58
2006;"PEDRA DOURADA (MG)";"MG";"PEDRA DOURADA";8;2;2;12
2006;"PEDRALVA (MG)";"MG";"PEDRALVA";117;9;17;143
2006;"PEDRAS DE MARIA DA CRUZ (MG)";"MG";"PEDRAS DE MARIA DA CRUZ";10;3;21;34
2006;"PEDRINOPOLIS (MG)";"MG";"PEDRINOPOLIS";53;9;6;68
2006;"PEDRO LEOPOLDO (MG)";"MG";"PEDRO LEOPOLDO";734;81;166;981
2006;"PEDRO TEIXEIRA (MG)";"MG";"PEDRO TEIXEIRA";18;3;1;22
2006;"PEQUERI (MG)";"MG";"PEQUERI";57;7;4;68
2006;"PEQUI (MG)";"MG";"PEQUI";38;7;6;51
2006;"PERDIGAO (MG)";"MG";"PERDIGAO";88;11;3;102
2006;"PERDIZES (MG)";"MG";"PERDIZES";227;25;24;276
2006;"PERDOES (MG)";"MG";"PERDOES";398;20;44;462
2006;"PERIQUITO (MG)";"MG";"PERIQUITO";23;4;20;47
2006;"PESCADOR (MG)";"MG";"PESCADOR";12;4;3;19
2006;"PIAU (MG)";"MG";"PIAU";34;5;7;46
2006;"PIEDADE DE CARATINGA (MG)";"MG";"PIEDADE DE CARATINGA";93;5;6;104
2006;"PIEDADE DE PONTE NOVA (MG)";"MG";"PIEDADE DE PONTE NOVA";29;1;13;43
2006;"PIEDADE DO RIO GRANDE (MG)";"MG";"PIEDADE DO RIO GRANDE";40;1;9;50
2006;"PIEDADE DOS GERAIS (MG)";"MG";"PIEDADE DOS GERAIS";56;2;10;68
2006;"PIMENTA (MG)";"MG";"PIMENTA";181;6;16;203
2006;"PINGO D AGUA (MG)";"MG";"PINGO D AGUA";10;3;5;18
2006;"PINTOPOLIS (MG)";"MG";"PINTOPOLIS";9;0;2;11
2006;"PIRACEMA (MG)";"MG";"PIRACEMA";60;5;11;76
2006;"PIRAJUBA (MG)";"MG";"PIRAJUBA";100;10;6;116
2006;"PIRANGA (MG)";"MG";"PIRANGA";103;11;32;146
2006;"PIRANGUCU (MG)";"MG";"PIRANGUCU";31;13;32;76
2006;"PIRANGUINHO (MG)";"MG";"PIRANGUINHO";98;6;7;111
2006;"PIRAPETINGA (MG)";"MG";"PIRAPETINGA";271;15;18;304
2006;"PIRAPORA (MG)";"MG";"PIRAPORA";408;19;97;524
2006;"PIRAUBA (MG)";"MG";"PIRAUBA";99;10;8;117
2006;"PITANGUI (MG)";"MG";"PITANGUI";492;32;58;582
2006;"PIUI (MG)";"MG";"PIUI";528;25;46;599
2006;"PLANURA (MG)";"MG";"PLANURA";141;5;33;179
2006;"POCO FUNDO (MG)";"MG";"POCO FUNDO";204;32;13;249
2006;"POCOS DE CALDAS (MG)";"MG";"POCOS DE CALDAS";2377;330;324;3031
2006;"POCRANE (MG)";"MG";"POCRANE";53;4;8;65
2006;"POMPEU (MG)";"MG";"POMPEU";353;17;70;440
2006;"PONTE NOVA (MG)";"MG";"PONTE NOVA";768;23;103;894
2006;"PONTO CHIQUE (MG)";"MG";"PONTO CHIQUE";3;0;8;11
2006;"PONTO DOS VOLANTES (MG)";"MG";"PONTO DOS VOLANTES";13;5;19;37
2006;"PORTEIRINHA (MG)";"MG";"PORTEIRINHA";228;4;109;341
2006;"PORTO FIRME (MG)";"MG";"PORTO FIRME";38;2;9;49
2006;"POTE (MG)";"MG";"POTE";44;5;11;60
2006;"POUSO ALEGRE (MG)";"MG";"POUSO ALEGRE";1796;126;394;2316
2006;"POUSO ALTO (MG)";"MG";"POUSO ALTO";74;13;4;91
2006;"PRADOS (MG)";"MG";"PRADOS";59;5;5;69
2006;"PRATA (MG)";"MG";"PRATA";321;59;59;439
2006;"PRATAPOLIS (MG)";"MG";"PRATAPOLIS";164;14;12;190
2006;"PRATINHA (MG)";"MG";"PRATINHA";42;5;3;50
2006;"PRESIDENTE BERNARDES (MG)";"MG";"PRESIDENTE BERNARDES";17;1;8;26
2006;"PRESIDENTE JUSCELINO (MG)";"MG";"PRESIDENTE JUSCELINO";26;2;10;38
2006;"PRESIDENTE KUBITSCHEK (MG)";"MG";"PRESIDENTE KUBITSCHEK";10;4;4;18
2006;"PRESIDENTE OLEGARIO (MG)";"MG";"PRESIDENTE OLEGARIO";178;12;79;269
2006;"PRUDENTE DE MORAIS (MG)";"MG";"PRUDENTE DE MORAIS";103;6;9;118
2006;"QUARTEL GERAL (MG)";"MG";"QUARTEL GERAL";34;7;2;43
2006;"QUELUZITA (MG)";"MG";"QUELUZITA";21;4;2;27
2006;"RAPOSOS (MG)";"MG";"RAPOSOS";49;20;14;83
2006;"RAUL SOARES (MG)";"MG";"RAUL SOARES";136;20;21;177
2006;"RECREIO (MG)";"MG";"RECREIO";138;6;16;160
2006;"REDUTO (MG)";"MG";"REDUTO";39;2;2;43
2006;"RESENDE COSTA (MG)";"MG";"RESENDE COSTA";119;6;9;134
2006;"RESPLENDOR (MG)";"MG";"RESPLENDOR";164;12;27;203
2006;"RESSAQUINHA (MG)";"MG";"RESSAQUINHA";91;2;8;101
2006;"RIACHINHO (MG)";"MG";"RIACHINHO";43;1;15;59
2006;"RIACHO DOS MACHADOS (MG)";"MG";"RIACHO DOS MACHADOS";48;3;31;82
2006;"RIBEIRAO DAS NEVES (MG)";"MG";"RIBEIRAO DAS NEVES";1965;223;490;2678
2006;"RIBEIRAO VERMELHO (MG)";"MG";"RIBEIRAO VERMELHO";21;5;2;28
2006;"RIO ACIMA (MG)";"MG";"RIO ACIMA";97;11;12;120
2006;"RIO CASCA (MG)";"MG";"RIO CASCA";188;8;44;240
2006;"RIO DO PRADO (MG)";"MG";"RIO DO PRADO";7;4;5;16
2006;"RIO DOCE (MG)";"MG";"RIO DOCE";19;2;5;26
2006;"RIO ESPERA (MG)";"MG";"RIO ESPERA";17;0;4;21
2006;"RIO MANSO (MG)";"MG";"RIO MANSO";88;2;10;100
2006;"RIO NOVO (MG)";"MG";"RIO NOVO";92;6;16;114
2006;"RIO PARANAIBA (MG)";"MG";"RIO PARANAIBA";118;8;39;165
2006;"RIO PARDO DE MINAS (MG)";"MG";"RIO PARDO DE MINAS";149;5;86;240
2006;"RIO PIRACICABA (MG)";"MG";"RIO PIRACICABA";157;13;21;191
2006;"RIO POMBA (MG)";"MG";"RIO POMBA";173;16;25;214
2006;"RIO PRETO (MG)";"MG";"RIO PRETO";182;80;31;293
2006;"RIO VERMELHO (MG)";"MG";"RIO VERMELHO";49;13;31;93
2006;"RITAPOLIS (MG)";"MG";"RITAPOLIS";23;2;6;31
2006;"ROCHEDO DE MINAS (MG)";"MG";"ROCHEDO DE MINAS";19;3;2;24
2006;"RODEIRO (MG)";"MG";"RODEIRO";119;4;8;131
2006;"ROMARIA (MG)";"MG";"ROMARIA";36;6;4;46
2006;"ROSARIO DA LIMEIRA (MG)";"MG";"ROSARIO DA LIMEIRA";38;6;15;59
2006;"RUBELITA (MG)";"MG";"RUBELITA";11;2;8;21
2006;"RUBIM (MG)";"MG";"RUBIM";15;4;17;36
2006;"SABARA (MG)";"MG";"SABARA";454;128;246;828
2006;"SABINOPOLIS (MG)";"MG";"SABINOPOLIS";86;13;26;125
2006;"SACRAMENTO (MG)";"MG";"SACRAMENTO";405;37;41;483
2006;"SALINAS (MG)";"MG";"SALINAS";269;24;86;379
2006;"SALTO DA DIVISA (MG)";"MG";"SALTO DA DIVISA";4;3;5;12
2006;"SANTA BARBARA (MG)";"MG";"SANTA BARBARA";309;36;134;479
2006;"SANTA BARBARA DO LESTE (MG)";"MG";"SANTA BARBARA DO LESTE";130;6;4;140
2006;"SANTA BARBARA DO MONTE VERDE (MG)";"MG";"SANTA BARBARA DO MONTE VERDE";318;66;62;446
2006;"SANTA BARBARA DO TUGURIO (MG)";"MG";"SANTA BARBARA DO TUGURIO";36;2;5;43
2006;"SANTA CRUZ DE MINAS (MG)";"MG";"SANTA CRUZ DE MINAS";38;3;2;43
2006;"SANTA CRUZ DE SALINAS (MG)";"MG";"SANTA CRUZ DE SALINAS";9;0;19;28
2006;"SANTA CRUZ DO ESCALVADO (MG)";"MG";"SANTA CRUZ DO ESCALVADO";22;2;7;31
2006;"SANTA EFIGENIA DE MINAS (MG)";"MG";"SANTA EFIGENIA DE MINAS";15;3;3;21
2006;"SANTA FE DE MINAS (MG)";"MG";"SANTA FE DE MINAS";5;1;3;9
2006;"SANTA HELENA DE MINAS (MG)";"MG";"SANTA HELENA DE MINAS";9;1;4;14
2006;"SANTA JULIANA (MG)";"MG";"SANTA JULIANA";245;20;31;296
2006;"SANTA LUZIA (MG)";"MG";"SANTA LUZIA";1111;105;459;1675
2006;"SANTA MARGARIDA (MG)";"MG";"SANTA MARGARIDA";157;10;14;181
2006;"SANTA MARIA DE ITABIRA (MG)";"MG";"SANTA MARIA DE ITABIRA";75;8;26;109
2006;"SANTA MARIA DO SALTO (MG)";"MG";"SANTA MARIA DO SALTO";8;3;3;14
2006;"SANTA MARIA DO SUACUI (MG)";"MG";"SANTA MARIA DO SUACUI";55;0;24;79
2006;"SANTA RITA DE CALDAS (MG)";"MG";"SANTA RITA DE CALDAS";217;8;8;233
2006;"SANTA RITA DE JACUTINGA (MG)";"MG";"SANTA RITA DE JACUTINGA";42;3;3;48
2006;"SANTA RITA DE MINAS (MG)";"MG";"SANTA RITA DE MINAS";103;4;6;113
2006;"SANTA RITA DO IBITIPOCA (MG)";"MG";"SANTA RITA DO IBITIPOCA";33;2;1;36
2006;"SANTA RITA DO ITUETO (MG)";"MG";"SANTA RITA DO ITUETO";60;4;10;74
2006;"SANTA RITA DO SAPUCAI (MG)";"MG";"SANTA RITA DO SAPUCAI";314;33;56;403
2006;"SANTA ROSA DA SERRA (MG)";"MG";"SANTA ROSA DA SERRA";28;4;5;37
2006;"SANTA VITORIA (MG)";"MG";"SANTA VITORIA";221;7;18;246
2006;"SANTANA DA VARGEM (MG)";"MG";"SANTANA DA VARGEM";56;5;13;74
2006;"SANTANA DE CATAGUASES (MG)";"MG";"SANTANA DE CATAGUASES";36;7;4;47
2006;"SANTANA DE PIRAPAMA (MG)";"MG";"SANTANA DE PIRAPAMA";50;4;19;73
2006;"SANTANA DO DESERTO (MG)";"MG";"SANTANA DO DESERTO";47;2;5;54
2006;"SANTANA DO GARAMBEU (MG)";"MG";"SANTANA DO GARAMBEU";9;0;3;12
2006;"SANTANA DO JACARE (MG)";"MG";"SANTANA DO JACARE";32;5;3;40
2006;"SANTANA DO MANHUACU (MG)";"MG";"SANTANA DO MANHUACU";93;4;9;106
2006;"SANTANA DO PARAISO (MG)";"MG";"SANTANA DO PARAISO";75;6;21;102
2006;"SANTANA DO RIACHO (MG)";"MG";"SANTANA DO RIACHO";7;4;8;19
2006;"SANTANA DOS MONTES (MG)";"MG";"SANTANA DOS MONTES";25;4;9;38
2006;"SANTO ANTONIO DO AMPARO (MG)";"MG";"SANTO ANTONIO DO AMPARO";196;12;13;221
2006;"SANTO ANTONIO DO AVENTUREIRO (MG)";"MG";"SANTO ANTONIO DO AVENTUREIRO";46;3;4;53
2006;"SANTO ANTONIO DO GRAMA (MG)";"MG";"SANTO ANTONIO DO GRAMA";37;1;5;43
2006;"SANTO ANTONIO DO ITAMBE (MG)";"MG";"SANTO ANTONIO DO ITAMBE";10;2;7;19
2006;"SANTO ANTONIO DO JACINTO (MG)";"MG";"SANTO ANTONIO DO JACINTO";23;6;20;49
2006;"SANTO ANTONIO DO MONTE (MG)";"MG";"SANTO ANTONIO DO MONTE";377;22;82;481
2006;"SANTO ANTONIO DO RETIRO (MG)";"MG";"SANTO ANTONIO DO RETIRO";21;3;13;37
2006;"SANTO ANTONIO DO RIO ABAIXO (MG)";"MG";"SANTO ANTONIO DO RIO ABAIXO";9;4;3;16
2006;"SANTO HIPOLITO (MG)";"MG";"SANTO HIPOLITO";19;0;2;21
2006;"SANTOS DUMONT (MG)";"MG";"SANTOS DUMONT";351;29;85;465
2006;"SAO BENTO ABADE (MG)";"MG";"SAO BENTO ABADE";33;4;4;41
2006;"SAO BRAS DO SUACUI (MG)";"MG";"SAO BRAS DO SUACUI";24;2;4;30
2006;"SAO DOMINGOS DAS DORES (MG)";"MG";"SAO DOMINGOS DAS DORES";67;1;3;71
2006;"SAO DOMINGOS DO PRATA (MG)";"MG";"SAO DOMINGOS DO PRATA";159;7;40;206
2006;"SAO FELIX DE MINAS (MG)";"MG";"SAO FELIX DE MINAS";13;1;5;19
2006;"SAO FRANCISCO (MG)";"MG";"SAO FRANCISCO";158;3;63;224
2006;"SAO FRANCISCO DE PAULA (MG)";"MG";"SAO FRANCISCO DE PAULA";60;3;15;78
2006;"SAO FRANCISCO DE SALES (MG)";"MG";"SAO FRANCISCO DE SALES";61;4;17;82
2006;"SAO FRANCISCO DO GLORIA (MG)";"MG";"SAO FRANCISCO DO GLORIA";39;4;3;46
2006;"SAO GERALDO (MG)";"MG";"SAO GERALDO";95;6;4;105
2006;"SAO GERALDO DA PIEDADE (MG)";"MG";"SAO GERALDO DA PIEDADE";12;2;4;18
2006;"SAO GERALDO DO BAIXIO (MG)";"MG";"SAO GERALDO DO BAIXIO";12;3;5;20
2006;"SAO GONCALO DO ABAETE (MG)";"MG";"SAO GONCALO DO ABAETE";81;5;13;99
2006;"SAO GONCALO DO PARA (MG)";"MG";"SAO GONCALO DO PARA";132;6;9;147
2006;"SAO GONCALO DO RIO ABAIXO (MG)";"MG";"SAO GONCALO DO RIO ABAIXO";67;16;17;100
2006;"SAO GONCALO DO RIO PRETO (MG)";"MG";"SAO GONCALO DO RIO PRETO";17;4;4;25
2006;"SAO GONCALO DO SAPUCAI (MG)";"MG";"SAO GONCALO DO SAPUCAI";355;18;50;423
2006;"SAO GOTARDO (MG)";"MG";"SAO GOTARDO";673;31;111;815
2006;"SAO JOAO BATISTA DO GLORIA (MG)";"MG";"SAO JOAO BATISTA DO GLORIA";64;8;8;80
2006;"SAO JOAO DA LAGOA (MG)";"MG";"SAO JOAO DA LAGOA";28;1;8;37
2006;"SAO JOAO DA MATA (MG)";"MG";"SAO JOAO DA MATA";31;6;0;37
2006;"SAO JOAO DA PONTE (MG)";"MG";"SAO JOAO DA PONTE";38;3;30;71
2006;"SAO JOAO DAS MISSOES (MG)";"MG";"SAO JOAO DAS MISSOES";10;3;9;22
2006;"SAO JOAO DEL REI (MG)";"MG";"SAO JOAO DEL REI";865;83;165;1113
2006;"SAO JOAO DO MANHUACU (MG)";"MG";"SAO JOAO DO MANHUACU";104;4;16;124
2006;"SAO JOAO DO MANTENINHA (MG)";"MG";"SAO JOAO DO MANTENINHA";51;4;4;59
2006;"SAO JOAO DO ORIENTE (MG)";"MG";"SAO JOAO DO ORIENTE";73;5;4;82
2006;"SAO JOAO DO PACUI (MG)";"MG";"SAO JOAO DO PACUI";1;0;2;3
2006;"SAO JOAO DO PARAISO (MG)";"MG";"SAO JOAO DO PARAISO";105;4;48;157
2006;"SAO JOAO EVANGELISTA (MG)";"MG";"SAO JOAO EVANGELISTA";80;4;23;107
2006;"SAO JOAO NEPOMUCENO (MG)";"MG";"SAO JOAO NEPOMUCENO";234;16;33;283
2006;"SAO JOAQUIM DE BICAS (MG)";"MG";"SAO JOAQUIM DE BICAS";209;32;34;275
2006;"SAO JOSE DA BARRA (MG)";"MG";"SAO JOSE DA BARRA";72;3;25;100
2006;"SAO JOSE DA LAPA (MG)";"MG";"SAO JOSE DA LAPA";173;21;24;218
2006;"SAO JOSE DA SAFIRA (MG)";"MG";"SAO JOSE DA SAFIRA";1;1;1;3
2006;"SAO JOSE DA VARGINHA (MG)";"MG";"SAO JOSE DA VARGINHA";37;1;6;44
2006;"SAO JOSE DO ALEGRE (MG)";"MG";"SAO JOSE DO ALEGRE";33;5;3;41
2006;"SAO JOSE DO DIVINO (MG)";"MG";"SAO JOSE DO DIVINO";11;2;8;21
2006;"SAO JOSE DO GOIABAL (MG)";"MG";"SAO JOSE DO GOIABAL";38;7;40;85
2006;"SAO JOSE DO JACURI (MG)";"MG";"SAO JOSE DO JACURI";9;3;5;17
2006;"SAO JOSE DO MANTIMENTO (MG)";"MG";"SAO JOSE DO MANTIMENTO";15;1;2;18
2006;"SAO LOURENCO (MG)";"MG";"SAO LOURENCO";380;43;22;445
2006;"SAO MIGUEL DO ANTA (MG)";"MG";"SAO MIGUEL DO ANTA";68;2;5;75
2006;"SAO PEDRO DA UNIAO (MG)";"MG";"SAO PEDRO DA UNIAO";84;10;7;101
2006;"SAO PEDRO DO SUACUI (MG)";"MG";"SAO PEDRO DO SUACUI";13;2;6;21
2006;"SAO PEDRO DOS FERROS (MG)";"MG";"SAO PEDRO DOS FERROS";107;2;25;134
2006;"SAO ROMAO (MG)";"MG";"SAO ROMAO";19;1;11;31
2006;"SAO ROQUE DE MINAS (MG)";"MG";"SAO ROQUE DE MINAS";89;3;5;97
2006;"SAO SEBASTIAO DA BELA VISTA (MG)";"MG";"SAO SEBASTIAO DA BELA VISTA";27;3;8;38
2006;"SAO SEBASTIAO DA VARGEM ALEGRE (MG)";"MG";"SAO SEBASTIAO DA VARGEM ALEGRE";14;3;4;21
2006;"SAO SEBASTIAO DO ANTA (MG)";"MG";"SAO SEBASTIAO DO ANTA";29;2;3;34
2006;"SAO SEBASTIAO DO MARANHAO (MG)";"MG";"SAO SEBASTIAO DO MARANHAO";22;4;11;37
2006;"SAO SEBASTIAO DO OESTE (MG)";"MG";"SAO SEBASTIAO DO OESTE";76;6;11;93
2006;"SAO SEBASTIAO DO PARAISO (MG)";"MG";"SAO SEBASTIAO DO PARAISO";1187;53;113;1353
2006;"SAO SEBASTIAO DO RIO PRETO (MG)";"MG";"SAO SEBASTIAO DO RIO PRETO";7;2;2;11
2006;"SAO SEBASTIAO DO RIO VERDE (MG)";"MG";"SAO SEBASTIAO DO RIO VERDE";8;2;3;13
2006;"SAO TIAGO (MG)";"MG";"SAO TIAGO";90;8;11;109
2006;"SAO TOMAS DE AQUINO (MG)";"MG";"SAO TOMAS DE AQUINO";61;13;7;81
2006;"SAO TOME DAS LETRAS (MG)";"MG";"SAO TOME DAS LETRAS";87;7;11;105
2006;"SAO VICENTE DE MINAS (MG)";"MG";"SAO VICENTE DE MINAS";57;9;1;67
2006;"SAPUCAI MIRIM (MG)";"MG";"SAPUCAI MIRIM";146;21;12;179
2006;"SARDOA (MG)";"MG";"SARDOA";25;3;6;34
2006;"SARZEDO (MG)";"MG";"SARZEDO";238;16;23;277
2006;"SEM PEIXE (MG)";"MG";"SEM PEIXE";4;4;3;11
2006;"SENADOR AMARAL (MG)";"MG";"SENADOR AMARAL";80;8;5;93
2006;"SENADOR CORTES (MG)";"MG";"SENADOR CORTES";10;3;3;16
2006;"SENADOR FIRMINO (MG)";"MG";"SENADOR FIRMINO";59;5;7;71
2006;"SENADOR JOSE BENTO (MG)";"MG";"SENADOR JOSE BENTO";13;1;6;20
2006;"SENADOR MODESTINO GONCALVES (MG)";"MG";"SENADOR MODESTINO GONCALVES";18;5;4;27
2006;"SENHORA DE OLIVEIRA (MG)";"MG";"SENHORA DE OLIVEIRA";51;3;7;61
2006;"SENHORA DO PORTO (MG)";"MG";"SENHORA DO PORTO";16;2;9;27
2006;"SENHORA DOS REMEDIOS (MG)";"MG";"SENHORA DOS REMEDIOS";52;6;11;69
2006;"SERICITA (MG)";"MG";"SERICITA";47;2;4;53
2006;"SERITINGA (MG)";"MG";"SERITINGA";18;1;2;21
2006;"SERRA AZUL DE MINAS (MG)";"MG";"SERRA AZUL DE MINAS";10;1;5;16
2006;"SERRA DA SAUDADE (MG)";"MG";"SERRA DA SAUDADE";4;3;0;7
2006;"SERRA DO SALITRE (MG)";"MG";"SERRA DO SALITRE";166;2;48;216
2006;"SERRA DOS AIMORES (MG)";"MG";"SERRA DOS AIMORES";47;2;14;63
2006;"SERRANIA (MG)";"MG";"SERRANIA";97;9;7;113
2006;"SERRANOPOLIS DE MINAS (MG)";"MG";"SERRANOPOLIS DE MINAS";5;2;10;17
2006;"SERRANOS (MG)";"MG";"SERRANOS";10;2;1;13
2006;"SERRO (MG)";"MG";"SERRO";124;11;35;170
2006;"SETE LAGOAS (MG)";"MG";"SETE LAGOAS";2411;273;373;3057
2006;"SETUBINHA (MG)";"MG";"SETUBINHA";13;2;13;28
2006;"SILVEIRANIA (MG)";"MG";"SILVEIRANIA";6;2;5;13
2006;"SILVIANOPOLIS (MG)";"MG";"SILVIANOPOLIS";68;10;8;86
2006;"SIMAO PEREIRA (MG)";"MG";"SIMAO PEREIRA";38;5;2;45
2006;"SIMONESIA (MG)";"MG";"SIMONESIA";141;7;24;172
2006;"SOBRALIA (MG)";"MG";"SOBRALIA";23;2;6;31
2006;"SOLEDADE DE MINAS (MG)";"MG";"SOLEDADE DE MINAS";30;6;0;36
2006;"TABULEIRO (MG)";"MG";"TABULEIRO";50;4;4;58
2006;"TAIOBEIRAS (MG)";"MG";"TAIOBEIRAS";460;15;75;550
2006;"TAPARUBA (MG)";"MG";"TAPARUBA";17;2;5;24
2006;"TAPIRA (MG)";"MG";"TAPIRA";33;5;12;50
2006;"TAPIRAI (MG)";"MG";"TAPIRAI";9;3;2;14
2006;"TAQUARACU DE MINAS (MG)";"MG";"TAQUARACU DE MINAS";51;5;8;64
2006;"TARUMIRIM (MG)";"MG";"TARUMIRIM";102;7;20;129
2006;"TEIXEIRAS (MG)";"MG";"TEIXEIRAS";109;6;13;128
2006;"TEOFILO OTONI (MG)";"MG";"TEOFILO OTONI";1084;108;111;1303
2006;"TIMOTEO (MG)";"MG";"TIMOTEO";775;128;100;1003
2006;"TIRADENTES (MG)";"MG";"TIRADENTES";59;6;6;71
2006;"TIROS (MG)";"MG";"TIROS";128;12;7;147
2006;"TOCANTINS (MG)";"MG";"TOCANTINS";177;3;6;186
2006;"TOCOS DO MOJI (MG)";"MG";"TOCOS DO MOJI";32;6;6;44
2006;"TOLEDO (MG)";"MG";"TOLEDO";42;2;7;51
2006;"TOMBOS (MG)";"MG";"TOMBOS";95;12;15;122
2006;"TRES CORACOES (MG)";"MG";"TRES CORACOES";778;69;118;965
2006;"TRES MARIAS (MG)";"MG";"TRES MARIAS";268;26;62;356
2006;"TRES PONTAS (MG)";"MG";"TRES PONTAS";699;40;117;856
2006;"TUMIRITINGA (MG)";"MG";"TUMIRITINGA";23;3;2;28
2006;"TUPACIGUARA (MG)";"MG";"TUPACIGUARA";368;41;45;454
2006;"TURMALINA (MG)";"MG";"TURMALINA";215;13;46;274
2006;"TURVOLANDIA (MG)";"MG";"TURVOLANDIA";75;14;3;92
2006;"UBA (MG)";"MG";"UBA";1314;47;87;1448
2006;"UBAI (MG)";"MG";"UBAI";16;2;13;31
2006;"UBAPORANGA (MG)";"MG";"UBAPORANGA";104;3;13;120
2006;"UBERABA (MG)";"MG";"UBERABA";3271;525;559;4355
2006;"UBERLANDIA (MG)";"MG";"UBERLANDIA";8345;718;1046;10109
2006;"UMBURATIBA (MG)";"MG";"UMBURATIBA";9;1;1;11
2006;"UNAI (MG)";"MG";"UNAI";1110;44;260;1414
2006;"UNIAO DE MINAS (MG)";"MG";"UNIAO DE MINAS";38;3;19;60
2006;"URUANA DE MINAS (MG)";"MG";"URUANA DE MINAS";10;1;8;19
2006;"URUCANIA (MG)";"MG";"URUCANIA";121;4;27;152
2006;"URUCUIA (MG)";"MG";"URUCUIA";36;1;13;50
2006;"VARGEM ALEGRE (MG)";"MG";"VARGEM ALEGRE";48;7;7;62
2006;"VARGEM BONITA (MG)";"MG";"VARGEM BONITA";14;4;3;21
2006;"VARGEM GRANDE DO RIO PARDO (MG)";"MG";"VARGEM GRANDE DO RIO PARDO";26;2;7;35
2006;"VARGINHA (MG)";"MG";"VARGINHA";1585;73;201;1859
2006;"VARJAO DE MINAS (MG)";"MG";"VARJAO DE MINAS";76;4;30;110
2006;"VARZEA DA PALMA (MG)";"MG";"VARZEA DA PALMA";371;10;56;437
2006;"VARZELANDIA (MG)";"MG";"VARZELANDIA";37;4;21;62
2006;"VAZANTE (MG)";"MG";"VAZANTE";262;24;73;359
2006;"VERDELANDIA (MG)";"MG";"VERDELANDIA";10;2;4;16
2006;"VEREDINHA (MG)";"MG";"VEREDINHA";24;0;14;38
2006;"VERISSIMO (MG)";"MG";"VERISSIMO";30;21;3;54
2006;"VERMELHO NOVO (MG)";"MG";"VERMELHO NOVO";42;1;16;59
2006;"VESPASIANO (MG)";"MG";"VESPASIANO";423;64;107;594
2006;"VICOSA (MG)";"MG";"VICOSA";520;76;141;737
2006;"VIEIRAS (MG)";"MG";"VIEIRAS";21;4;3;28
2006;"VIRGEM DA LAPA (MG)";"MG";"VIRGEM DA LAPA";42;6;16;64
2006;"VIRGINIA (MG)";"MG";"VIRGINIA";87;10;4;101
2006;"VIRGINOPOLIS (MG)";"MG";"VIRGINOPOLIS";77;6;8;91
2006;"VIRGOLANDIA (MG)";"MG";"VIRGOLANDIA";11;3;5;19
2006;"VISCONDE DO RIO BRANCO (MG)";"MG";"VISCONDE DO RIO BRANCO";708;26;61;795
2006;"VOLTA GRANDE (MG)";"MG";"VOLTA GRANDE";31;5;6;42
2006;"WENCESLAU BRAZ (MG)";"MG";"WENCESLAU BRAZ";41;4;4;49
2006;"AGUA CLARA (MS)";"MS";"AGUA CLARA";328;6;41;375
2006;"ALCINOPOLIS (MS)";"MS";"ALCINOPOLIS";60;5;11;76
2006;"AMAMBAI (MS)";"MS";"AMAMBAI";563;8;30;601
2006;"ANASTACIO (MS)";"MS";"ANASTACIO";261;11;15;287
2006;"ANAURILANDIA (MS)";"MS";"ANAURILANDIA";74;10;29;113
2006;"ANGELICA (MS)";"MS";"ANGELICA";116;3;25;144
2006;"ANTONIO JOAO (MS)";"MS";"ANTONIO JOAO";88;0;10;98
2006;"APARECIDA DO TABOADO (MS)";"MS";"APARECIDA DO TABOADO";290;16;44;350
2006;"AQUIDAUANA (MS)";"MS";"AQUIDAUANA";264;18;44;326
2006;"ARAL MOREIRA (MS)";"MS";"ARAL MOREIRA";134;7;13;154
2006;"BANDEIRANTES (MS)";"MS";"BANDEIRANTES";94;4;10;108
2006;"BATAGUASSU (MS)";"MS";"BATAGUASSU";476;15;102;593
2006;"BATAYPORA (MS)";"MS";"BATAYPORA";132;3;25;160
2006;"BELA VISTA (MS)";"MS";"BELA VISTA";159;18;24;201
2006;"BODOQUENA (MS)";"MS";"BODOQUENA";63;7;21;91
2006;"BONITO (MS)";"MS";"BONITO";193;33;39;265
2006;"BRASILANDIA (MS)";"MS";"BRASILANDIA";174;11;54;239
2006;"CAARAPO (MS)";"MS";"CAARAPO";373;10;54;437
2006;"CAMAPUA (MS)";"MS";"CAMAPUA";279;21;18;318
2006;"CAMPO GRANDE (MS)";"MS";"CAMPO GRANDE";9989;573;1368;11930
2006;"CARACOL (MS)";"MS";"CARACOL";23;8;6;37
2006;"CASSILANDIA (MS)";"MS";"CASSILANDIA";426;11;26;463
2006;"CHAPADAO DO SUL (MS)";"MS";"CHAPADAO DO SUL";504;8;40;552
2006;"CORGUINHO (MS)";"MS";"CORGUINHO";45;4;13;62
2006;"CORONEL SAPUCAIA (MS)";"MS";"CORONEL SAPUCAIA";194;1;12;207
2006;"CORUMBA (MS)";"MS";"CORUMBA";595;37;124;756
2006;"COSTA RICA (MS)";"MS";"COSTA RICA";367;6;33;406
2006;"COXIM (MS)";"MS";"COXIM";447;10;45;502
2006;"DEODAPOLIS (MS)";"MS";"DEODAPOLIS";185;8;37;230
2006;"DOIS IRMAOS DO BURITI (MS)";"MS";"DOIS IRMAOS DO BURITI";68;12;20;100
2006;"DOURADINA (MS)";"MS";"DOURADINA";170;1;9;180
2006;"DOURADOS (MS)";"MS";"DOURADOS";3067;126;228;3421
2006;"ELDORADO (MS)";"MS";"ELDORADO";215;4;15;234
2006;"FATIMA DO SUL (MS)";"MS";"FATIMA DO SUL";366;4;19;389
2006;"FIGUEIRAO (MS)";"MS";"FIGUEIRAO";12;9;3;24
2006;"GLORIA DE DOURADOS (MS)";"MS";"GLORIA DE DOURADOS";169;1;22;192
2006;"GUIA LOPES DA LAGUNA (MS)";"MS";"GUIA LOPES DA LAGUNA";111;11;22;144
2006;"IGUATEMI (MS)";"MS";"IGUATEMI";204;3;31;238
2006;"INOCENCIA (MS)";"MS";"INOCENCIA";135;1;17;153
2006;"ITAPORA (MS)";"MS";"ITAPORA";311;8;34;353
2006;"ITAQUIRAI (MS)";"MS";"ITAQUIRAI";147;3;51;201
2006;"IVINHEMA (MS)";"MS";"IVINHEMA";406;5;155;566
2006;"JAPORA (MS)";"MS";"JAPORA";8;3;8;19
2006;"JARAGUARI (MS)";"MS";"JARAGUARI";63;2;17;82
2006;"JARDIM (MS)";"MS";"JARDIM";354;16;22;392
2006;"JATEI (MS)";"MS";"JATEI";25;4;14;43
2006;"JUTI (MS)";"MS";"JUTI";38;3;12;53
2006;"LADARIO (MS)";"MS";"LADARIO";148;17;59;224
2006;"LAGUNA CARAPA (MS)";"MS";"LAGUNA CARAPA";129;1;19;149
2006;"MARACAJU (MS)";"MS";"MARACAJU";669;11;84;764
2006;"MIRANDA (MS)";"MS";"MIRANDA";236;13;38;287
2006;"MUNDO NOVO (MS)";"MS";"MUNDO NOVO";197;13;28;238
2006;"NAVIRAI (MS)";"MS";"NAVIRAI";671;12;120;803
2006;"NIOAQUE (MS)";"MS";"NIOAQUE";95;12;34;141
2006;"NOVA ALVORADA DO SUL (MS)";"MS";"NOVA ALVORADA DO SUL";224;10;62;296
2006;"NOVA ANDRADINA (MS)";"MS";"NOVA ANDRADINA";832;15;129;976
2006;"NOVO HORIZONTE DO SUL (MS)";"MS";"NOVO HORIZONTE DO SUL";54;1;14;69
2006;"PARANAIBA (MS)";"MS";"PARANAIBA";678;9;57;744
2006;"PARANHOS (MS)";"MS";"PARANHOS";67;4;15;86
2006;"PEDRO GOMES (MS)";"MS";"PEDRO GOMES";78;5;10;93
2006;"PONTA PORA (MS)";"MS";"PONTA PORA";1303;31;125;1459
2006;"PORTO MURTINHO (MS)";"MS";"PORTO MURTINHO";40;6;15;61
2006;"RIBAS DO RIO PARDO (MS)";"MS";"RIBAS DO RIO PARDO";447;15;33;495
2006;"RIO BRILHANTE (MS)";"MS";"RIO BRILHANTE";456;16;111;583
2006;"RIO NEGRO (MS)";"MS";"RIO NEGRO";44;4;7;55
2006;"RIO VERDE DE MATO GROSSO (MS)";"MS";"RIO VERDE DE MATO GROSSO";242;10;12;264
2006;"ROCHEDO (MS)";"MS";"ROCHEDO";33;4;7;44
2006;"SANTA RITA DO PARDO (MS)";"MS";"SANTA RITA DO PARDO";98;10;25;133
2006;"SAO GABRIEL DO OESTE (MS)";"MS";"SAO GABRIEL DO OESTE";668;15;32;715
2006;"SELVIRIA (MS)";"MS";"SELVIRIA";74;4;13;91
2006;"SETE QUEDAS (MS)";"MS";"SETE QUEDAS";193;6;17;216
2006;"SIDROLANDIA (MS)";"MS";"SIDROLANDIA";468;28;119;615
2006;"SONORA (MS)";"MS";"SONORA";188;7;69;264
2006;"TACURU (MS)";"MS";"TACURU";93;1;11;105
2006;"TAQUARUSSU (MS)";"MS";"TAQUARUSSU";40;2;10;52
2006;"TERENOS (MS)";"MS";"TERENOS";227;10;21;258
2006;"TRES LAGOAS (MS)";"MS";"TRES LAGOAS";1301;40;261;1602
2006;"VICENTINA (MS)";"MS";"VICENTINA";81;5;53;139
2006;"ACORIZAL (MT)";"MT";"ACORIZAL";11;1;3;15
2006;"AGUA BOA (MT)";"MT";"AGUA BOA";358;6;18;382
2006;"ALTA FLORESTA (MT)";"MT";"ALTA FLORESTA";965;7;62;1034
2006;"ALTO ARAGUAIA (MT)";"MT";"ALTO ARAGUAIA";81;4;14;99
2006;"ALTO BOA VISTA (MT)";"MT";"ALTO BOA VISTA";14;0;2;16
2006;"ALTO GARCAS (MT)";"MT";"ALTO GARCAS";240;3;25;268
2006;"ALTO PARAGUAI (MT)";"MT";"ALTO PARAGUAI";19;6;1;26
2006;"ALTO TAQUARI (MT)";"MT";"ALTO TAQUARI";112;4;7;123
2006;"APIACAS (MT)";"MT";"APIACAS";78;2;2;82
2006;"ARAGUAIANA (MT)";"MT";"ARAGUAIANA";9;0;1;10
2006;"ARAGUAINHA (MT)";"MT";"ARAGUAINHA";7;2;0;9
2006;"ARAPUTANGA (MT)";"MT";"ARAPUTANGA";221;6;17;244
2006;"ARENAPOLIS (MT)";"MT";"ARENAPOLIS";166;8;36;210
2006;"ARIPUANA (MT)";"MT";"ARIPUANA";227;5;14;246
2006;"BARAO DE MELGACO (MT)";"MT";"BARAO DE MELGACO";7;0;2;9
2006;"BARRA DO BUGRES (MT)";"MT";"BARRA DO BUGRES";419;10;112;541
2006;"BARRA DO GARCAS (MT)";"MT";"BARRA DO GARCAS";736;19;156;911
2006;"BOM JESUS DO ARAGUAIA (MT)";"MT";"BOM JESUS DO ARAGUAIA";11;0;3;14
2006;"BRASNORTE (MT)";"MT";"BRASNORTE";193;3;14;210
2006;"CACERES (MT)";"MT";"CACERES";702;39;211;952
2006;"CAMPINAPOLIS (MT)";"MT";"CAMPINAPOLIS";52;1;12;65
2006;"CAMPO NOVO DO PARECIS (MT)";"MT";"CAMPO NOVO DO PARECIS";556;13;43;612
2006;"CAMPO VERDE (MT)";"MT";"CAMPO VERDE";582;19;56;657
2006;"CAMPOS DE JULIO (MT)";"MT";"CAMPOS DE JULIO";119;5;9;133
2006;"CANABRAVA DO NORTE (MT)";"MT";"CANABRAVA DO NORTE";6;0;2;8
2006;"CANARANA (MT)";"MT";"CANARANA";394;1;26;421
2006;"CARLINDA (MT)";"MT";"CARLINDA";104;0;14;118
2006;"CASTANHEIRA (MT)";"MT";"CASTANHEIRA";74;2;10;86
2006;"CHAPADA DOS GUIMARAES (MT)";"MT";"CHAPADA DOS GUIMARAES";158;13;33;204
2006;"CLAUDIA (MT)";"MT";"CLAUDIA";358;4;12;374
2006;"COCALINHO (MT)";"MT";"COCALINHO";13;1;7;21
2006;"COLIDER (MT)";"MT";"COLIDER";654;16;59;729
2006;"COLNIZA (MT)";"MT";"COLNIZA";123;1;1;125
2006;"COMODORO (MT)";"MT";"COMODORO";311;7;46;364
2006;"CONFRESA (MT)";"MT";"CONFRESA";72;3;16;91
2006;"CONQUISTA D OESTE (MT)";"MT";"CONQUISTA D OESTE";27;1;8;36
2006;"COTRIGUACU (MT)";"MT";"COTRIGUACU";84;1;22;107
2006;"CUIABA (MT)";"MT";"CUIABA";6053;597;1502;8152
2006;"CURVELANDIA (MT)";"MT";"CURVELANDIA";42;0;10;52
2006;"DENISE (MT)";"MT";"DENISE";55;3;23;81
2006;"DIAMANTINO (MT)";"MT";"DIAMANTINO";388;16;49;453
2006;"DOM AQUINO (MT)";"MT";"DOM AQUINO";91;6;15;112
2006;"FELIZ NATAL (MT)";"MT";"FELIZ NATAL";158;4;11;173
2006;"FIGUEIROPOLIS D OESTE (MT)";"MT";"FIGUEIROPOLIS D OESTE";52;2;7;61
2006;"GAUCHA DO NORTE (MT)";"MT";"GAUCHA DO NORTE";35;4;3;42
2006;"GENERAL CARNEIRO (MT)";"MT";"GENERAL CARNEIRO";17;2;3;22
2006;"GLORIA D OESTE (MT)";"MT";"GLORIA D OESTE";30;4;6;40
2006;"GUARANTA DO NORTE (MT)";"MT";"GUARANTA DO NORTE";726;6;26;758
2006;"GUIRATINGA (MT)";"MT";"GUIRATINGA";111;4;5;120
2006;"INDIAVAI (MT)";"MT";"INDIAVAI";17;1;6;24
2006;"IPIRANGA DO NORTE (MT)";"MT";"IPIRANGA DO NORTE";18;0;1;19
2006;"ITANHANGA (MT)";"MT";"ITANHANGA";26;1;2;29
2006;"ITAUBA (MT)";"MT";"ITAUBA";91;5;5;101
2006;"ITIQUIRA (MT)";"MT";"ITIQUIRA";56;6;16;78
2006;"JACIARA (MT)";"MT";"JACIARA";436;23;86;545
2006;"JANGADA (MT)";"MT";"JANGADA";38;5;12;55
2006;"JAURU (MT)";"MT";"JAURU";135;2;25;162
2006;"JUARA (MT)";"MT";"JUARA";556;11;27;594
2006;"JUINA (MT)";"MT";"JUINA";665;5;38;708
2006;"JURUENA (MT)";"MT";"JURUENA";103;1;8;112
2006;"JUSCIMEIRA (MT)";"MT";"JUSCIMEIRA";84;3;33;120
2006;"LAMBARI D OESTE (MT)";"MT";"LAMBARI D OESTE";49;0;19;68
2006;"LUCAS DO RIO VERDE (MT)";"MT";"LUCAS DO RIO VERDE";990;23;62;1075
2006;"LUCIARA (MT)";"MT";"LUCIARA";7;0;2;9
2006;"MARCELANDIA (MT)";"MT";"MARCELANDIA";303;6;10;319
2006;"MATUPA (MT)";"MT";"MATUPA";290;4;20;314
2006;"MIRASSOL D OESTE (MT)";"MT";"MIRASSOL D OESTE";561;6;48;615
2006;"NOBRES (MT)";"MT";"NOBRES";198;6;35;239
2006;"NORTELANDIA (MT)";"MT";"NORTELANDIA";78;4;15;97
2006;"NOSSA SENHORA DO LIVRAMENTO (MT)";"MT";"NOSSA SENHORA DO LIVRAMENTO";39;3;22;64
2006;"NOVA BANDEIRANTES (MT)";"MT";"NOVA BANDEIRANTES";75;1;13;89
2006;"NOVA BRASILANDIA (MT)";"MT";"NOVA BRASILANDIA";26;1;9;36
2006;"NOVA CANAA DO NORTE (MT)";"MT";"NOVA CANAA DO NORTE";157;1;22;180
2006;"NOVA GUARITA (MT)";"MT";"NOVA GUARITA";64;2;9;75
2006;"NOVA LACERDA (MT)";"MT";"NOVA LACERDA";37;1;13;51
2006;"NOVA MARILANDIA (MT)";"MT";"NOVA MARILANDIA";21;3;5;29
2006;"NOVA MARINGA (MT)";"MT";"NOVA MARINGA";59;0;7;66
2006;"NOVA MONTE VERDE (MT)";"MT";"NOVA MONTE VERDE";65;2;1;68
2006;"NOVA MUTUM (MT)";"MT";"NOVA MUTUM";567;6;28;601
2006;"NOVA NAZARE (MT)";"MT";"NOVA NAZARE";5;2;3;10
2006;"NOVA OLIMPIA (MT)";"MT";"NOVA OLIMPIA";199;13;70;282
2006;"NOVA SANTA HELENA (MT)";"MT";"NOVA SANTA HELENA";41;1;7;49
2006;"NOVA UBIRATA (MT)";"MT";"NOVA UBIRATA";81;5;6;92
2006;"NOVA XAVANTINA (MT)";"MT";"NOVA XAVANTINA";236;6;24;266
2006;"NOVO HORIZONTE DO NORTE (MT)";"MT";"NOVO HORIZONTE DO NORTE";30;0;9;39
2006;"NOVO MUNDO (MT)";"MT";"NOVO MUNDO";68;2;6;76
2006;"NOVO SANTO ANTONIO (MT)";"MT";"NOVO SANTO ANTONIO";2;0;2;4
2006;"NOVO SAO JOAQUIM (MT)";"MT";"NOVO SAO JOAQUIM";39;0;8;47
2006;"PARANAITA (MT)";"MT";"PARANAITA";148;2;14;164
2006;"PARANATINGA (MT)";"MT";"PARANATINGA";303;4;27;334
2006;"PEDRA PRETA (MT)";"MT";"PEDRA PRETA";223;12;23;258
2006;"PEIXOTO DE AZEVEDO (MT)";"MT";"PEIXOTO DE AZEVEDO";227;8;35;270
2006;"PLANALTO DA SERRA (MT)";"MT";"PLANALTO DA SERRA";8;1;3;12
2006;"POCONE (MT)";"MT";"POCONE";262;11;20;293
2006;"PONTAL DO ARAGUAIA (MT)";"MT";"PONTAL DO ARAGUAIA";10;0;1;11
2006;"PONTE BRANCA (MT)";"MT";"PONTE BRANCA";5;1;0;6
2006;"PONTES E LACERDA (MT)";"MT";"PONTES E LACERDA";696;16;61;773
2006;"PORTO ALEGRE DO NORTE (MT)";"MT";"PORTO ALEGRE DO NORTE";24;3;20;47
2006;"PORTO DOS GAUCHOS (MT)";"MT";"PORTO DOS GAUCHOS";80;3;7;90
2006;"PORTO ESPERIDIAO (MT)";"MT";"PORTO ESPERIDIAO";71;2;28;101
2006;"PORTO ESTRELA (MT)";"MT";"PORTO ESTRELA";12;2;3;17
2006;"POXOREO (MT)";"MT";"POXOREO";78;8;22;108
2006;"PRIMAVERA DO LESTE (MT)";"MT";"PRIMAVERA DO LESTE";1289;39;69;1397
2006;"QUERENCIA (MT)";"MT";"QUERENCIA";168;0;11;179
2006;"RESERVA DO CABACAL (MT)";"MT";"RESERVA DO CABACAL";18;1;5;24
2006;"RIBEIRAO CASCALHEIRA (MT)";"MT";"RIBEIRAO CASCALHEIRA";54;1;4;59
2006;"RIBEIRAOZINHO (MT)";"MT";"RIBEIRAOZINHO";5;1;6;12
2006;"RIO BRANCO (MT)";"MT";"RIO BRANCO";81;6;10;97
2006;"RONDOLANDIA (MT)";"MT";"RONDOLANDIA";5;0;4;9
2006;"RONDONOPOLIS (MT)";"MT";"RONDONOPOLIS";3008;111;289;3408
2006;"ROSARIO OESTE (MT)";"MT";"ROSARIO OESTE";106;7;15;128
2006;"SALTO DO CEU (MT)";"MT";"SALTO DO CEU";29;1;6;36
2006;"SANTA CARMEN (MT)";"MT";"SANTA CARMEN";122;4;6;132
2006;"SANTA CRUZ DO XINGU (MT)";"MT";"SANTA CRUZ DO XINGU";3;0;2;5
2006;"SANTA RITA DO TRIVELATO (MT)";"MT";"SANTA RITA DO TRIVELATO";28;1;2;31
2006;"SANTA TEREZINHA (MT)";"MT";"SANTA TEREZINHA";6;1;6;13
2006;"SANTO AFONSO (MT)";"MT";"SANTO AFONSO";23;2;4;29
2006;"SANTO ANTONIO DO LESTE (MT)";"MT";"SANTO ANTONIO DO LESTE";60;1;12;73
2006;"SANTO ANTONIO DO LEVERGER (MT)";"MT";"SANTO ANTONIO DO LEVERGER";43;8;11;62
2006;"SAO FELIX DO ARAGUAIA (MT)";"MT";"SAO FELIX DO ARAGUAIA";29;2;16;47
2006;"SAO JOSE DO POVO (MT)";"MT";"SAO JOSE DO POVO";16;1;6;23
2006;"SAO JOSE DO RIO CLARO (MT)";"MT";"SAO JOSE DO RIO CLARO";228;7;30;265
2006;"SAO JOSE DO XINGU (MT)";"MT";"SAO JOSE DO XINGU";5;0;4;9
2006;"SAO JOSE DOS QUATRO MARCOS (MT)";"MT";"SAO JOSE DOS QUATRO MARCOS";367;6;38;411
2006;"SAO PEDRO DA CIPA (MT)";"MT";"SAO PEDRO DA CIPA";19;3;17;39
2006;"SAPEZAL (MT)";"MT";"SAPEZAL";308;2;17;327
2006;"SERRA NOVA DOURADA (MT)";"MT";"SERRA NOVA DOURADA";3;0;1;4
2006;"SINOP (MT)";"MT";"SINOP";2445;31;123;2599
2006;"SORRISO (MT)";"MT";"SORRISO";1633;31;90;1754
2006;"TABAPORA (MT)";"MT";"TABAPORA";75;3;13;91
2006;"TANGARA DA SERRA (MT)";"MT";"TANGARA DA SERRA";1645;63;147;1855
2006;"TAPURAH (MT)";"MT";"TAPURAH";241;8;12;261
2006;"TERRA NOVA DO NORTE (MT)";"MT";"TERRA NOVA DO NORTE";220;4;18;242
2006;"TESOURO (MT)";"MT";"TESOURO";7;0;3;10
2006;"TORIXOREU (MT)";"MT";"TORIXOREU";11;0;3;14
2006;"UNIAO DO SUL (MT)";"MT";"UNIAO DO SUL";75;0;3;78
2006;"VALE DE SAO DOMINGOS (MT)";"MT";"VALE DE SAO DOMINGOS";15;1;6;22
2006;"VARZEA GRANDE (MT)";"MT";"VARZEA GRANDE";3347;182;306;3835
2006;"VERA (MT)";"MT";"VERA";241;4;12;257
2006;"VILA BELA DA SANTISSIMA TRINDA (MT)";"MT";"VILA BELA DA SANTISSIMA TRINDA";66;2;16;84
2006;"VILA RICA (MT)";"MT";"VILA RICA";151;4;13;168
2006;"ABAETETUBA (PA)";"PA";"ABAETETUBA";185;10;117;312
2006;"ABEL FIGUEIREDO (PA)";"PA";"ABEL FIGUEIREDO";18;5;3;26
2006;"ACARA (PA)";"PA";"ACARA";46;4;12;62
2006;"AFUA (PA)";"PA";"AFUA";1;0;0;1
2006;"AGUA AZUL DO NORTE (PA)";"PA";"AGUA AZUL DO NORTE";24;2;5;31
2006;"ALENQUER (PA)";"PA";"ALENQUER";92;2;27;121
2006;"ALMEIRIM (PA)";"PA";"ALMEIRIM";173;7;63;243
2006;"ALTAMIRA (PA)";"PA";"ALTAMIRA";694;79;38;811
2006;"ANAJAS (PA)";"PA";"ANAJAS";0;0;0;0
2006;"ANANINDEUA (PA)";"PA";"ANANINDEUA";2750;207;899;3856
2006;"ANAPU (PA)";"PA";"ANAPU";30;8;2;40
2006;"AUGUSTO CORREA (PA)";"PA";"AUGUSTO CORREA";21;3;29;53
2006;"AURORA DO PARA (PA)";"PA";"AURORA DO PARA";33;0;36;69
2006;"AVEIRO (PA)";"PA";"AVEIRO";0;0;0;0
2006;"BAGRE (PA)";"PA";"BAGRE";1;0;0;1
2006;"BAIAO (PA)";"PA";"BAIAO";19;0;2;21
2006;"BANNACH (PA)";"PA";"BANNACH";10;0;0;10
2006;"BARCARENA (PA)";"PA";"BARCARENA";468;130;375;973
2006;"BELEM (PA)";"PA";"BELEM";6323;819;2154;9296
2006;"BELTERRA (PA)";"PA";"BELTERRA";21;0;10;31
2006;"BENEVIDES (PA)";"PA";"BENEVIDES";285;11;66;362
2006;"BOM JESUS DO TOCANTINS (PA)";"PA";"BOM JESUS DO TOCANTINS";40;13;3;56
2006;"BONITO (PA)";"PA";"BONITO";21;0;20;41
2006;"BRAGANCA (PA)";"PA";"BRAGANCA";285;25;110;420
2006;"BRASIL NOVO (PA)";"PA";"BRASIL NOVO";70;22;4;96
2006;"BREJO GRANDE DO ARAGUAIA (PA)";"PA";"BREJO GRANDE DO ARAGUAIA";7;7;5;19
2006;"BREU BRANCO (PA)";"PA";"BREU BRANCO";194;15;37;246
2006;"BREVES (PA)";"PA";"BREVES";15;0;4;19
2006;"BUJARU (PA)";"PA";"BUJARU";24;2;4;30
2006;"CACHOEIRA DO ARARI (PA)";"PA";"CACHOEIRA DO ARARI";3;1;4;8
2006;"CACHOEIRA DO PIRIA (PA)";"PA";"CACHOEIRA DO PIRIA";15;2;10;27
2006;"CAMETA (PA)";"PA";"CAMETA";59;2;21;82
2006;"CANAA DOS CARAJAS (PA)";"PA";"CANAA DOS CARAJAS";134;30;30;194
2006;"CAPANEMA (PA)";"PA";"CAPANEMA";493;14;80;587
2006;"CAPITAO POCO (PA)";"PA";"CAPITAO POCO";234;12;40;286
2006;"CASTANHAL (PA)";"PA";"CASTANHAL";1724;104;246;2074
2006;"CHAVES (PA)";"PA";"CHAVES";0;0;0;0
2006;"COLARES (PA)";"PA";"COLARES";4;0;3;7
2006;"CONCEICAO DO ARAGUAIA (PA)";"PA";"CONCEICAO DO ARAGUAIA";254;20;55;329
2006;"CONCORDIA DO PARA (PA)";"PA";"CONCORDIA DO PARA";77;0;15;92
2006;"CUMARU DO NORTE (PA)";"PA";"CUMARU DO NORTE";9;0;4;13
2006;"CURIONOPOLIS (PA)";"PA";"CURIONOPOLIS";43;63;1;107
2006;"CURRALINHO (PA)";"PA";"CURRALINHO";1;0;0;1
2006;"CURUA (PA)";"PA";"CURUA";0;0;0;0
2006;"CURUCA (PA)";"PA";"CURUCA";37;2;8;47
2006;"DOM ELISEU (PA)";"PA";"DOM ELISEU";392;27;11;430
2006;"ELDORADO DOS CARAJAS (PA)";"PA";"ELDORADO DOS CARAJAS";73;11;3;87
2006;"FARO (PA)";"PA";"FARO";2;1;0;3
2006;"FLORESTA DO ARAGUAIA (PA)";"PA";"FLORESTA DO ARAGUAIA";54;0;1;55
2006;"GARRAFAO DO NORTE (PA)";"PA";"GARRAFAO DO NORTE";50;3;6;59
2006;"GOIANESIA DO PARA (PA)";"PA";"GOIANESIA DO PARA";200;8;17;225
2006;"GURUPA (PA)";"PA";"GURUPA";2;0;0;2
2006;"IGARAPE ACU (PA)";"PA";"IGARAPE ACU";96;41;41;178
2006;"IGARAPE MIRI (PA)";"PA";"IGARAPE MIRI";46;7;14;67
2006;"INHANGAPI (PA)";"PA";"INHANGAPI";16;0;21;37
2006;"IPIXUNA DO PARA (PA)";"PA";"IPIXUNA DO PARA";55;2;10;67
2006;"IRITUIA (PA)";"PA";"IRITUIA";42;1;22;65
2006;"ITAITUBA (PA)";"PA";"ITAITUBA";490;30;37;557
2006;"ITUPIRANGA (PA)";"PA";"ITUPIRANGA";85;53;11;149
2006;"JACAREACANGA (PA)";"PA";"JACAREACANGA";6;0;0;6
2006;"JACUNDA (PA)";"PA";"JACUNDA";446;13;27;486
2006;"JURUTI (PA)";"PA";"JURUTI";11;2;0;13
2006;"LIMOEIRO DO AJURU (PA)";"PA";"LIMOEIRO DO AJURU";0;0;0;0
2006;"MAE DO RIO (PA)";"PA";"MAE DO RIO";241;7;38;286
2006;"MAGALHAES BARATA (PA)";"PA";"MAGALHAES BARATA";9;1;4;14
2006;"MARABA (PA)";"PA";"MARABA";2116;142;294;2552
2006;"MARACANA (PA)";"PA";"MARACANA";11;8;10;29
2006;"MARAPANIM (PA)";"PA";"MARAPANIM";19;8;11;38
2006;"MARITUBA (PA)";"PA";"MARITUBA";427;37;136;600
2006;"MEDICILANDIA (PA)";"PA";"MEDICILANDIA";115;8;9;132
2006;"MELGACO (PA)";"PA";"MELGACO";1;0;0;1
2006;"MOCAJUBA (PA)";"PA";"MOCAJUBA";10;1;6;17
2006;"MOJU (PA)";"PA";"MOJU";100;6;69;175
2006;"MONTE ALEGRE (PA)";"PA";"MONTE ALEGRE";158;1;75;234
2006;"MUANA (PA)";"PA";"MUANA";0;1;0;1
2006;"NOVA ESPERANCA DO PIRIA (PA)";"PA";"NOVA ESPERANCA DO PIRIA";30;2;7;39
2006;"NOVA IPIXUNA (PA)";"PA";"NOVA IPIXUNA";99;4;16;119
2006;"NOVA TIMBOTEUA (PA)";"PA";"NOVA TIMBOTEUA";34;5;9;48
2006;"NOVO PROGRESSO (PA)";"PA";"NOVO PROGRESSO";46;2;1;49
2006;"NOVO REPARTIMENTO (PA)";"PA";"NOVO REPARTIMENTO";216;13;16;245
2006;"OBIDOS (PA)";"PA";"OBIDOS";117;0;22;139
2006;"OEIRAS DO PARA (PA)";"PA";"OEIRAS DO PARA";4;1;0;5
2006;"ORIXIMINA (PA)";"PA";"ORIXIMINA";183;6;13;202
2006;"OUREM (PA)";"PA";"OUREM";49;1;11;61
2006;"OURILANDIA DO NORTE (PA)";"PA";"OURILANDIA DO NORTE";62;2;5;69
2006;"PACAJA (PA)";"PA";"PACAJA";60;5;3;68
2006;"PALESTINA DO PARA (PA)";"PA";"PALESTINA DO PARA";14;2;1;17
2006;"PARAGOMINAS (PA)";"PA";"PARAGOMINAS";873;12;65;950
2006;"PARAUAPEBAS (PA)";"PA";"PARAUAPEBAS";686;329;88;1103
2006;"PAU D ARCO (PA)";"PA";"PAU D ARCO";8;4;0;12
2006;"PEIXE BOI (PA)";"PA";"PEIXE BOI";15;0;11;26
2006;"PICARRA (PA)";"PA";"PICARRA";9;1;3;13
2006;"PLACAS (PA)";"PA";"PLACAS";21;1;1;23
2006;"PONTA DE PEDRAS (PA)";"PA";"PONTA DE PEDRAS";1;0;0;1
2006;"PORTEL (PA)";"PA";"PORTEL";11;0;0;11
2006;"PORTO DE MOZ (PA)";"PA";"PORTO DE MOZ";9;0;0;9
2006;"PRAINHA (PA)";"PA";"PRAINHA";11;0;1;12
2006;"PRIMAVERA (PA)";"PA";"PRIMAVERA";11;1;5;17
2006;"QUATIPURU (PA)";"PA";"QUATIPURU";3;1;11;15
2006;"REDENCAO (PA)";"PA";"REDENCAO";623;41;55;719
2006;"RIO MARIA (PA)";"PA";"RIO MARIA";140;35;10;185
2006;"RONDON DO PARA (PA)";"PA";"RONDON DO PARA";350;32;9;391
2006;"RUROPOLIS (PA)";"PA";"RUROPOLIS";94;2;8;104
2006;"SALINOPOLIS (PA)";"PA";"SALINOPOLIS";87;16;27;130
2006;"SALVATERRA (PA)";"PA";"SALVATERRA";14;11;9;34
2006;"SANTA BARBARA DO PARA (PA)";"PA";"SANTA BARBARA DO PARA";29;10;14;53
2006;"SANTA CRUZ DO ARARI (PA)";"PA";"SANTA CRUZ DO ARARI";1;0;0;1
2006;"SANTA ISABEL DO PARA (PA)";"PA";"SANTA ISABEL DO PARA";389;16;78;483
2006;"SANTA LUZIA DO PARA (PA)";"PA";"SANTA LUZIA DO PARA";73;3;29;105
2006;"SANTA MARIA DAS BARREIRAS (PA)";"PA";"SANTA MARIA DAS BARREIRAS";12;0;2;14
2006;"SANTA MARIA DO PARA (PA)";"PA";"SANTA MARIA DO PARA";158;24;32;214
2006;"SANTANA DO ARAGUAIA (PA)";"PA";"SANTANA DO ARAGUAIA";89;8;9;106
2006;"SANTAREM (PA)";"PA";"SANTAREM";1669;54;395;2118
2006;"SANTAREM NOVO (PA)";"PA";"SANTAREM NOVO";6;1;7;14
2006;"SANTO ANTONIO DO TAUA (PA)";"PA";"SANTO ANTONIO DO TAUA";67;6;55;128
2006;"SAO CAETANO DE ODIVELAS (PA)";"PA";"SAO CAETANO DE ODIVELAS";12;0;1;13
2006;"SAO DOMINGOS DO ARAGUAIA (PA)";"PA";"SAO DOMINGOS DO ARAGUAIA";76;18;15;109
2006;"SAO DOMINGOS DO CAPIM (PA)";"PA";"SAO DOMINGOS DO CAPIM";32;1;10;43
2006;"SAO FELIX DO XINGU (PA)";"PA";"SAO FELIX DO XINGU";78;2;7;87
2006;"SAO FRANCISCO DO PARA (PA)";"PA";"SAO FRANCISCO DO PARA";16;27;18;61
2006;"SAO GERALDO DO ARAGUAIA (PA)";"PA";"SAO GERALDO DO ARAGUAIA";69;6;8;83
2006;"SAO JOAO DA PONTA (PA)";"PA";"SAO JOAO DA PONTA";2;2;5;9
2006;"SAO JOAO DE PIRABAS (PA)";"PA";"SAO JOAO DE PIRABAS";17;5;6;28
2006;"SAO JOAO DO ARAGUAIA (PA)";"PA";"SAO JOAO DO ARAGUAIA";9;11;9;29
2006;"SAO MIGUEL DO GUAMA (PA)";"PA";"SAO MIGUEL DO GUAMA";278;15;51;344
2006;"SAO SEBASTIAO DA BOA VISTA (PA)";"PA";"SAO SEBASTIAO DA BOA VISTA";0;0;0;0
2006;"SAPUCAIA (PA)";"PA";"SAPUCAIA";17;4;1;22
2006;"SENADOR JOSE PORFIRIO (PA)";"PA";"SENADOR JOSE PORFIRIO";10;0;0;10
2006;"SOURE (PA)";"PA";"SOURE";20;1;7;28
2006;"TAILANDIA (PA)";"PA";"TAILANDIA";385;17;29;431
2006;"TERRA ALTA (PA)";"PA";"TERRA ALTA";10;11;10;31
2006;"TERRA SANTA (PA)";"PA";"TERRA SANTA";6;1;1;8
2006;"TOME ACU (PA)";"PA";"TOME ACU";287;8;52;347
2006;"TRACUATEUA (PA)";"PA";"TRACUATEUA";14;2;20;36
2006;"TRAIRAO (PA)";"PA";"TRAIRAO";54;0;0;54
2006;"TUCUMA (PA)";"PA";"TUCUMA";237;8;22;267
2006;"TUCURUI (PA)";"PA";"TUCURUI";533;62;109;704
2006;"ULIANOPOLIS (PA)";"PA";"ULIANOPOLIS";129;16;12;157
2006;"URUARA (PA)";"PA";"URUARA";284;5;11;300
2006;"VIGIA (PA)";"PA";"VIGIA";80;2;47;129
2006;"VISEU (PA)";"PA";"VISEU";34;3;16;53
2006;"VITORIA DO XINGU (PA)";"PA";"VITORIA DO XINGU";7;14;4;25
2006;"XINGUARA (PA)";"PA";"XINGUARA";456;18;72;546
2006;"AGUA BRANCA (PB)";"PB";"AGUA BRANCA";7;2;2;11
2006;"AGUIAR (PB)";"PB";"AGUIAR";4;1;2;7
2006;"ALAGOA GRANDE (PB)";"PB";"ALAGOA GRANDE";73;14;18;105
2006;"ALAGOA NOVA (PB)";"PB";"ALAGOA NOVA";65;33;8;106
2006;"ALAGOINHA (PB)";"PB";"ALAGOINHA";37;5;11;53
2006;"ALCANTIL (PB)";"PB";"ALCANTIL";25;4;3;32
2006;"ALGODAO DE JANDAIRA (PB)";"PB";"ALGODAO DE JANDAIRA";11;0;2;13
2006;"ALHANDRA (PB)";"PB";"ALHANDRA";62;13;10;85
2006;"AMPARO (PB)";"PB";"AMPARO";2;1;3;6
2006;"APARECIDA (PB)";"PB";"APARECIDA";24;2;3;29
2006;"ARACAGI (PB)";"PB";"ARACAGI";39;0;23;62
2006;"ARARA (PB)";"PB";"ARARA";30;3;12;45
2006;"ARARUNA (PB)";"PB";"ARARUNA";57;12;13;82
2006;"AREIA (PB)";"PB";"AREIA";93;9;10;112
2006;"AREIA DE BARAUNAS (PB)";"PB";"AREIA DE BARAUNAS";3;1;1;5
2006;"AREIAL (PB)";"PB";"AREIAL";12;3;3;18
2006;"AROEIRAS (PB)";"PB";"AROEIRAS";18;2;5;25
2006;"ASSUNCAO (PB)";"PB";"ASSUNCAO";8;2;2;12
2006;"BAIA DA TRAICAO (PB)";"PB";"BAIA DA TRAICAO";6;2;5;13
2006;"BANANEIRAS (PB)";"PB";"BANANEIRAS";46;5;20;71
2006;"BARAUNA (PB)";"PB";"BARAUNA";9;0;2;11
2006;"BARRA DE SANTA ROSA (PB)";"PB";"BARRA DE SANTA ROSA";34;2;9;45
2006;"BARRA DE SANTANA (PB)";"PB";"BARRA DE SANTANA";42;1;3;46
2006;"BARRA DE SAO MIGUEL (PB)";"PB";"BARRA DE SAO MIGUEL";0;0;2;2
2006;"BAYEUX (PB)";"PB";"BAYEUX";352;18;117;487
2006;"BELEM (PB)";"PB";"BELEM";82;7;8;97
2006;"BELEM DO BREJO DO CRUZ (PB)";"PB";"BELEM DO BREJO DO CRUZ";5;10;1;16
2006;"BERNARDINO BATISTA (PB)";"PB";"BERNARDINO BATISTA";1;0;1;2
2006;"BOA VENTURA (PB)";"PB";"BOA VENTURA";4;0;0;4
2006;"BOA VISTA (PB)";"PB";"BOA VISTA";70;4;9;83
2006;"BOM JESUS (PB)";"PB";"BOM JESUS";4;2;0;6
2006;"BOM SUCESSO (PB)";"PB";"BOM SUCESSO";5;1;3;9
2006;"BONITO DE SANTA FE (PB)";"PB";"BONITO DE SANTA FE";21;2;0;23
2006;"BOQUEIRAO (PB)";"PB";"BOQUEIRAO";125;1;10;136
2006;"BORBOREMA (PB)";"PB";"BORBOREMA";15;3;0;18
2006;"BREJO DO CRUZ (PB)";"PB";"BREJO DO CRUZ";40;7;2;49
2006;"BREJO DOS SANTOS (PB)";"PB";"BREJO DOS SANTOS";13;2;0;15
2006;"CAAPORA (PB)";"PB";"CAAPORA";15;7;2;24
2006;"CABACEIRAS (PB)";"PB";"CABACEIRAS";15;5;11;31
2006;"CABEDELO (PB)";"PB";"CABEDELO";223;14;15;252
2006;"CACHOEIRA DOS INDIOS (PB)";"PB";"CACHOEIRA DOS INDIOS";10;0;2;12
2006;"CACIMBA DE AREIA (PB)";"PB";"CACIMBA DE AREIA";6;0;3;9
2006;"CACIMBA DE DENTRO (PB)";"PB";"CACIMBA DE DENTRO";31;4;27;62
2006;"CACIMBAS (PB)";"PB";"CACIMBAS";4;1;2;7
2006;"CAICARA (PB)";"PB";"CAICARA";14;1;4;19
2006;"CAJAZEIRAS (PB)";"PB";"CAJAZEIRAS";412;15;35;462
2006;"CAJAZEIRINHAS (PB)";"PB";"CAJAZEIRINHAS";3;2;0;5
2006;"CALDAS BRANDAO (PB)";"PB";"CALDAS BRANDAO";7;1;2;10
2006;"CAMALAU (PB)";"PB";"CAMALAU";13;3;4;20
2006;"CAMPINA GRANDE (PB)";"PB";"CAMPINA GRANDE";3623;179;610;4412
2006;"CAPIM (PB)";"PB";"CAPIM";9;0;2;11
2006;"CARAUBAS (PB)";"PB";"CARAUBAS";4;1;0;5
2006;"CARRAPATEIRA (PB)";"PB";"CARRAPATEIRA";0;2;0;2
2006;"CASSERENGUE (PB)";"PB";"CASSERENGUE";14;0;8;22
2006;"CATINGUEIRA (PB)";"PB";"CATINGUEIRA";8;1;1;10
2006;"CATOLE DO ROCHA (PB)";"PB";"CATOLE DO ROCHA";208;15;10;233
2006;"CATURITE (PB)";"PB";"CATURITE";51;3;6;60
2006;"CONCEICAO (PB)";"PB";"CONCEICAO";61;9;6;76
2006;"CONDADO (PB)";"PB";"CONDADO";14;3;2;19
2006;"CONDE (PB)";"PB";"CONDE";44;5;6;55
2006;"CONGO (PB)";"PB";"CONGO";10;1;2;13
2006;"COREMAS (PB)";"PB";"COREMAS";24;4;4;32
2006;"COXIXOLA (PB)";"PB";"COXIXOLA";1;2;0;3
2006;"CRUZ DO ESPIRITO SANTO (PB)";"PB";"CRUZ DO ESPIRITO SANTO";15;4;6;25
2006;"CUBATI (PB)";"PB";"CUBATI";11;1;0;12
2006;"CUITE (PB)";"PB";"CUITE";64;2;6;72
2006;"CUITE DE MAMANGUAPE (PB)";"PB";"CUITE DE MAMANGUAPE";9;4;12;25
2006;"CUITEGI (PB)";"PB";"CUITEGI";6;0;1;7
2006;"CURRAL DE CIMA (PB)";"PB";"CURRAL DE CIMA";11;2;8;21
2006;"CURRAL VELHO (PB)";"PB";"CURRAL VELHO";4;1;2;7
2006;"DAMIAO (PB)";"PB";"DAMIAO";11;3;4;18
2006;"DESTERRO (PB)";"PB";"DESTERRO";21;2;2;25
2006;"DIAMANTE (PB)";"PB";"DIAMANTE";7;1;0;8
2006;"DONA INES (PB)";"PB";"DONA INES";14;2;9;25
2006;"DUAS ESTRADAS (PB)";"PB";"DUAS ESTRADAS";5;3;2;10
2006;"EMAS (PB)";"PB";"EMAS";2;1;2;5
2006;"ESPERANCA (PB)";"PB";"ESPERANCA";287;11;59;357
2006;"FAGUNDES (PB)";"PB";"FAGUNDES";26;2;9;37
2006;"FREI MARTINHO (PB)";"PB";"FREI MARTINHO";6;0;2;8
2006;"GADO BRAVO (PB)";"PB";"GADO BRAVO";22;3;3;28
2006;"GUARABIRA (PB)";"PB";"GUARABIRA";355;25;115;495
2006;"GURINHEM (PB)";"PB";"GURINHEM";23;3;14;40
2006;"GURJAO (PB)";"PB";"GURJAO";5;3;1;9
2006;"IBIARA (PB)";"PB";"IBIARA";4;2;1;7
2006;"IGARACY (PB)";"PB";"IGARACY";10;5;2;17
2006;"IMACULADA (PB)";"PB";"IMACULADA";8;2;1;11
2006;"INGA (PB)";"PB";"INGA";95;6;18;119
2006;"ITABAIANA (PB)";"PB";"ITABAIANA";162;7;26;195
2006;"ITAPORANGA (PB)";"PB";"ITAPORANGA";66;21;9;96
2006;"ITAPOROROCA (PB)";"PB";"ITAPOROROCA";56;3;10;69
2006;"ITATUBA (PB)";"PB";"ITATUBA";20;1;2;23
2006;"JACARAU (PB)";"PB";"JACARAU";32;1;8;41
2006;"JERICO (PB)";"PB";"JERICO";20;1;0;21
2006;"JOAO PESSOA (PB)";"PB";"JOAO PESSOA";3553;517;915;4985
2006;"JUAREZ TAVORA (PB)";"PB";"JUAREZ TAVORA";16;3;8;27
2006;"JUAZEIRINHO (PB)";"PB";"JUAZEIRINHO";45;9;3;57
2006;"JUNCO DO SERIDO (PB)";"PB";"JUNCO DO SERIDO";30;1;4;35
2006;"JURIPIRANGA (PB)";"PB";"JURIPIRANGA";24;2;13;39
2006;"JURU (PB)";"PB";"JURU";9;8;0;17
2006;"LAGOA (PB)";"PB";"LAGOA";11;2;3;16
2006;"LAGOA DE DENTRO (PB)";"PB";"LAGOA DE DENTRO";18;0;5;23
2006;"LAGOA SECA (PB)";"PB";"LAGOA SECA";102;19;9;130
2006;"LASTRO (PB)";"PB";"LASTRO";8;1;0;9
2006;"LIVRAMENTO (PB)";"PB";"LIVRAMENTO";24;2;1;27
2006;"LOGRADOURO (PB)";"PB";"LOGRADOURO";0;1;4;5
2006;"LUCENA (PB)";"PB";"LUCENA";13;2;7;22
2006;"MAE D AGUA (PB)";"PB";"MAE D AGUA";1;1;3;5
2006;"MALTA (PB)";"PB";"MALTA";2;2;2;6
2006;"MAMANGUAPE (PB)";"PB";"MAMANGUAPE";272;6;52;330
2006;"MANAIRA (PB)";"PB";"MANAIRA";6;1;1;8
2006;"MARCACAO (PB)";"PB";"MARCACAO";0;3;3;6
2006;"MARI (PB)";"PB";"MARI";60;6;28;94
2006;"MARIZOPOLIS (PB)";"PB";"MARIZOPOLIS";17;4;0;21
2006;"MASSARANDUBA (PB)";"PB";"MASSARANDUBA";14;4;5;23
2006;"MATARACA (PB)";"PB";"MATARACA";20;2;9;31
2006;"MATINHAS (PB)";"PB";"MATINHAS";6;0;0;6
2006;"MATO GROSSO (PB)";"PB";"MATO GROSSO";8;1;1;10
2006;"MATUREIA (PB)";"PB";"MATUREIA";11;5;1;17
2006;"MOGEIRO (PB)";"PB";"MOGEIRO";18;2;4;24
2006;"MONTADAS (PB)";"PB";"MONTADAS";11;0;5;16
2006;"MONTE HOREBE (PB)";"PB";"MONTE HOREBE";3;1;2;6
2006;"MONTEIRO (PB)";"PB";"MONTEIRO";194;37;31;262
2006;"MULUNGU (PB)";"PB";"MULUNGU";25;0;6;31
2006;"NATUBA (PB)";"PB";"NATUBA";13;1;0;14
2006;"NAZAREZINHO (PB)";"PB";"NAZAREZINHO";18;2;1;21
2006;"NOVA FLORESTA (PB)";"PB";"NOVA FLORESTA";20;3;5;28
2006;"NOVA OLINDA (PB)";"PB";"NOVA OLINDA";12;3;1;16
2006;"NOVA PALMEIRA (PB)";"PB";"NOVA PALMEIRA";11;0;1;12
2006;"OLHO D AGUA (PB)";"PB";"OLHO D AGUA";2;3;3;8
2006;"OLIVEDOS (PB)";"PB";"OLIVEDOS";24;3;6;33
2006;"OURO VELHO (PB)";"PB";"OURO VELHO";6;2;0;8
2006;"PARARI (PB)";"PB";"PARARI";1;1;0;2
2006;"PASSAGEM (PB)";"PB";"PASSAGEM";11;0;1;12
2006;"PATOS (PB)";"PB";"PATOS";676;47;39;762
2006;"PAULISTA (PB)";"PB";"PAULISTA";29;1;2;32
2006;"PEDRA BRANCA (PB)";"PB";"PEDRA BRANCA";4;0;3;7
2006;"PEDRA LAVRADA (PB)";"PB";"PEDRA LAVRADA";15;3;3;21
2006;"PEDRAS DE FOGO (PB)";"PB";"PEDRAS DE FOGO";198;14;45;257
2006;"PEDRO REGIS (PB)";"PB";"PEDRO REGIS";17;1;2;20
2006;"PIANCO (PB)";"PB";"PIANCO";63;7;2;72
2006;"PICUI (PB)";"PB";"PICUI";74;3;12;89
2006;"PILAR (PB)";"PB";"PILAR";12;1;9;22
2006;"PILOES (PB)";"PB";"PILOES";10;1;2;13
2006;"PILOEZINHOS (PB)";"PB";"PILOEZINHOS";6;2;3;11
2006;"PIRPIRITUBA (PB)";"PB";"PIRPIRITUBA";16;1;6;23
2006;"PITIMBU (PB)";"PB";"PITIMBU";11;8;3;22
2006;"POCINHOS (PB)";"PB";"POCINHOS";62;6;12;80
2006;"POCO DANTAS (PB)";"PB";"POCO DANTAS";2;1;1;4
2006;"POCO DE JOSE DE MOURA (PB)";"PB";"POCO DE JOSE DE MOURA";2;1;2;5
2006;"POMBAL (PB)";"PB";"POMBAL";222;6;9;237
2006;"PRATA (PB)";"PB";"PRATA";10;2;2;14
2006;"PRINCESA ISABEL (PB)";"PB";"PRINCESA ISABEL";74;30;2;106
2006;"PUXINANA (PB)";"PB";"PUXINANA";38;3;6;47
2006;"QUEIMADAS (PB)";"PB";"QUEIMADAS";274;39;68;381
2006;"QUIXABA (PB)";"PB";"QUIXABA";2;1;2;5
2006;"REMIGIO (PB)";"PB";"REMIGIO";151;3;12;166
2006;"RIACHAO (PB)";"PB";"RIACHAO";2;0;3;5
2006;"RIACHAO DO BACAMARTE (PB)";"PB";"RIACHAO DO BACAMARTE";5;0;3;8
2006;"RIACHAO DO POCO (PB)";"PB";"RIACHAO DO POCO";6;0;5;11
2006;"RIACHO DE SANTO ANTONIO (PB)";"PB";"RIACHO DE SANTO ANTONIO";5;3;2;10
2006;"RIACHO DOS CAVALOS (PB)";"PB";"RIACHO DOS CAVALOS";6;1;2;9
2006;"RIO TINTO (PB)";"PB";"RIO TINTO";46;4;14;64
2006;"SALGADINHO (PB)";"PB";"SALGADINHO";4;0;0;4
2006;"SALGADO DE SAO FELIX (PB)";"PB";"SALGADO DE SAO FELIX";11;2;1;14
2006;"SANTA CECILIA (PB)";"PB";"SANTA CECILIA";2;0;3;5
2006;"SANTA CRUZ (PB)";"PB";"SANTA CRUZ";6;4;6;16
2006;"SANTA HELENA (PB)";"PB";"SANTA HELENA";6;0;4;10
2006;"SANTA INES (PB)";"PB";"SANTA INES";13;0;0;13
2006;"SANTA LUZIA (PB)";"PB";"SANTA LUZIA";179;17;11;207
2006;"SANTA RITA (PB)";"PB";"SANTA RITA";415;32;153;600
2006;"SANTA TERESINHA (PB)";"PB";"SANTA TERESINHA";12;0;4;16
2006;"SANTANA DE MANGUEIRA (PB)";"PB";"SANTANA DE MANGUEIRA";1;0;0;1
2006;"SANTANA DOS GARROTES (PB)";"PB";"SANTANA DOS GARROTES";16;2;0;18
2006;"SANTAREM (PB)";"PB";"SANTAREM";3;0;0;3
2006;"SANTO ANDRE (PB)";"PB";"SANTO ANDRE";11;0;2;13
2006;"SAO BENTO (PB)";"PB";"SAO BENTO";189;11;10;210
2006;"SAO BENTO DE POMBAL (PB)";"PB";"SAO BENTO DE POMBAL";6;2;1;9
2006;"SAO DOMINGOS DE POMBAL (PB)";"PB";"SAO DOMINGOS DE POMBAL";0;0;2;2
2006;"SAO DOMINGOS DO CARIRI (PB)";"PB";"SAO DOMINGOS DO CARIRI";3;0;1;4
2006;"SAO FRANCISCO (PB)";"PB";"SAO FRANCISCO";9;0;1;10
2006;"SAO JOAO DO CARIRI (PB)";"PB";"SAO JOAO DO CARIRI";6;4;3;13
2006;"SAO JOAO DO RIO DO PEIXE (PB)";"PB";"SAO JOAO DO RIO DO PEIXE";20;1;6;27
2006;"SAO JOAO DO TIGRE (PB)";"PB";"SAO JOAO DO TIGRE";6;0;1;7
2006;"SAO JOSE DA LAGOA TAPADA (PB)";"PB";"SAO JOSE DA LAGOA TAPADA";7;1;0;8
2006;"SAO JOSE DE CAIANA (PB)";"PB";"SAO JOSE DE CAIANA";2;2;1;5
2006;"SAO JOSE DE ESPINHARAS (PB)";"PB";"SAO JOSE DE ESPINHARAS";10;1;1;12
2006;"SAO JOSE DE PIRANHAS (PB)";"PB";"SAO JOSE DE PIRANHAS";27;4;2;33
2006;"SAO JOSE DE PRINCESA (PB)";"PB";"SAO JOSE DE PRINCESA";3;0;0;3
2006;"SAO JOSE DO BONFIM (PB)";"PB";"SAO JOSE DO BONFIM";5;0;1;6
2006;"SAO JOSE DO BREJO DO CRUZ (PB)";"PB";"SAO JOSE DO BREJO DO CRUZ";0;1;0;1
2006;"SAO JOSE DO SABUGI (PB)";"PB";"SAO JOSE DO SABUGI";17;2;1;20
2006;"SAO JOSE DOS CORDEIROS (PB)";"PB";"SAO JOSE DOS CORDEIROS";4;1;1;6
2006;"SAO JOSE DOS RAMOS (PB)";"PB";"SAO JOSE DOS RAMOS";14;2;4;20
2006;"SAO MAMEDE (PB)";"PB";"SAO MAMEDE";13;1;1;15
2006;"SAO MIGUEL DE TAIPU (PB)";"PB";"SAO MIGUEL DE TAIPU";9;0;3;12
2006;"SAO SEBASTIAO DE LAGOA DE ROCA (PB)";"PB";"SAO SEBASTIAO DE LAGOA DE ROCA";23;3;2;28
2006;"SAO SEBASTIAO DO UMBUZEIRO (PB)";"PB";"SAO SEBASTIAO DO UMBUZEIRO";6;0;2;8
2006;"SAPE (PB)";"PB";"SAPE";288;9;56;353
2006;"SERIDO (PB)";"PB";"SERIDO";13;2;2;17
2006;"SERRA BRANCA (PB)";"PB";"SERRA BRANCA";51;6;6;63
2006;"SERRA DA RAIZ (PB)";"PB";"SERRA DA RAIZ";2;0;3;5
2006;"SERRA GRANDE (PB)";"PB";"SERRA GRANDE";2;0;0;2
2006;"SERRA REDONDA (PB)";"PB";"SERRA REDONDA";14;0;1;15
2006;"SERRARIA (PB)";"PB";"SERRARIA";13;3;2;18
2006;"SERTAOZINHO (PB)";"PB";"SERTAOZINHO";2;0;5;7
2006;"SOBRADO (PB)";"PB";"SOBRADO";18;1;4;23
2006;"SOLANEA (PB)";"PB";"SOLANEA";143;14;22;179
2006;"SOLEDADE (PB)";"PB";"SOLEDADE";75;8;7;90
2006;"SOSSEGO (PB)";"PB";"SOSSEGO";9;2;2;13
2006;"SOUSA (PB)";"PB";"SOUSA";500;14;38;552
2006;"SUME (PB)";"PB";"SUME";47;10;16;73
2006;"TACIMA (PB)";"PB";"TACIMA";20;1;11;32
2006;"TAPEROA (PB)";"PB";"TAPEROA";46;7;1;54
2006;"TAVARES (PB)";"PB";"TAVARES";22;8;2;32
2006;"TEIXEIRA (PB)";"PB";"TEIXEIRA";88;9;11;108
2006;"TENORIO (PB)";"PB";"TENORIO";12;0;0;12
2006;"TRIUNFO (PB)";"PB";"TRIUNFO";4;1;1;6
2006;"UIRAUNA (PB)";"PB";"UIRAUNA";48;3;4;55
2006;"UMBUZEIRO (PB)";"PB";"UMBUZEIRO";39;10;15;64
2006;"VARZEA (PB)";"PB";"VARZEA";5;4;1;10
2006;"VIEIROPOLIS (PB)";"PB";"VIEIROPOLIS";7;0;2;9
2006;"VISTA SERRANA (PB)";"PB";"VISTA SERRANA";13;0;3;16
2006;"ZABELE (PB)";"PB";"ZABELE";3;0;0;3
2006;"ABREU E LIMA (PE)";"PE";"ABREU E LIMA";358;24;255;637
2006;"AFOGADOS DA INGAZEIRA (PE)";"PE";"AFOGADOS DA INGAZEIRA";198;21;19;238
2006;"AFRANIO (PE)";"PE";"AFRANIO";57;7;4;68
2006;"AGRESTINA (PE)";"PE";"AGRESTINA";89;8;13;110
2006;"AGUA PRETA (PE)";"PE";"AGUA PRETA";105;28;25;158
2006;"AGUAS BELAS (PE)";"PE";"AGUAS BELAS";178;39;27;244
2006;"ALAGOINHA (PE)";"PE";"ALAGOINHA";59;8;7;74
2006;"ALIANCA (PE)";"PE";"ALIANCA";76;1;55;132
2006;"ALTINHO (PE)";"PE";"ALTINHO";40;7;16;63
2006;"AMARAJI (PE)";"PE";"AMARAJI";53;10;13;76
2006;"ANGELIM (PE)";"PE";"ANGELIM";25;4;2;31
2006;"ARACOIABA (PE)";"PE";"ARACOIABA";50;7;52;109
2006;"ARARIPINA (PE)";"PE";"ARARIPINA";773;18;39;830
2006;"ARCOVERDE (PE)";"PE";"ARCOVERDE";785;60;77;922
2006;"BARRA DE GUABIRABA (PE)";"PE";"BARRA DE GUABIRABA";45;9;7;61
2006;"BARREIROS (PE)";"PE";"BARREIROS";194;10;25;229
2006;"BELEM DE MARIA (PE)";"PE";"BELEM DE MARIA";71;9;4;84
2006;"BELEM DE SAO FRANCISCO (PE)";"PE";"BELEM DE SAO FRANCISCO";66;6;7;79
2006;"BELO JARDIM (PE)";"PE";"BELO JARDIM";448;47;42;537
2006;"BETANIA (PE)";"PE";"BETANIA";26;3;3;32
2006;"BEZERROS (PE)";"PE";"BEZERROS";476;43;41;560
2006;"BODOCO (PE)";"PE";"BODOCO";118;3;6;127
2006;"BOM CONSELHO (PE)";"PE";"BOM CONSELHO";263;31;19;313
2006;"BOM JARDIM (PE)";"PE";"BOM JARDIM";89;96;17;202
2006;"BONITO (PE)";"PE";"BONITO";201;12;19;232
2006;"BREJAO (PE)";"PE";"BREJAO";28;1;7;36
2006;"BREJINHO (PE)";"PE";"BREJINHO";12;2;3;17
2006;"BREJO DA MADRE DE DEUS (PE)";"PE";"BREJO DA MADRE DE DEUS";122;104;6;232
2006;"BUENOS AIRES (PE)";"PE";"BUENOS AIRES";34;2;5;41
2006;"BUIQUE (PE)";"PE";"BUIQUE";179;18;18;215
2006;"CABO DE SANTO AGOSTINHO (PE)";"PE";"CABO DE SANTO AGOSTINHO";779;105;245;1129
2006;"CABROBO (PE)";"PE";"CABROBO";179;7;6;192
2006;"CACHOEIRINHA (PE)";"PE";"CACHOEIRINHA";85;8;8;101
2006;"CAETES (PE)";"PE";"CAETES";176;16;7;199
2006;"CALCADO (PE)";"PE";"CALCADO";28;2;13;43
2006;"CALUMBI (PE)";"PE";"CALUMBI";42;2;2;46
2006;"CAMARAGIBE (PE)";"PE";"CAMARAGIBE";521;167;130;818
2006;"CAMOCIM DE SAO FELIX (PE)";"PE";"CAMOCIM DE SAO FELIX";105;12;4;121
2006;"CAMUTANGA (PE)";"PE";"CAMUTANGA";61;0;10;71
2006;"CANHOTINHO (PE)";"PE";"CANHOTINHO";142;11;6;159
2006;"CAPOEIRAS (PE)";"PE";"CAPOEIRAS";139;21;1;161
2006;"CARNAIBA (PE)";"PE";"CARNAIBA";36;9;2;47
2006;"CARNAUBEIRA DA PENHA (PE)";"PE";"CARNAUBEIRA DA PENHA";24;2;0;26
2006;"CARPINA (PE)";"PE";"CARPINA";672;73;71;816
2006;"CARUARU (PE)";"PE";"CARUARU";3054;311;389;3754
2006;"CASINHAS (PE)";"PE";"CASINHAS";12;72;7;91
2006;"CATENDE (PE)";"PE";"CATENDE";159;16;23;198
2006;"CEDRO (PE)";"PE";"CEDRO";25;3;7;35
2006;"CHA DE ALEGRIA (PE)";"PE";"CHA DE ALEGRIA";27;7;14;48
2006;"CHA GRANDE (PE)";"PE";"CHA GRANDE";155;19;14;188
2006;"CONDADO (PE)";"PE";"CONDADO";121;4;56;181
2006;"CORRENTES (PE)";"PE";"CORRENTES";54;21;4;79
2006;"CORTES (PE)";"PE";"CORTES";93;9;13;115
2006;"CUMARU (PE)";"PE";"CUMARU";65;18;3;86
2006;"CUPIRA (PE)";"PE";"CUPIRA";193;21;11;225
2006;"CUSTODIA (PE)";"PE";"CUSTODIA";194;16;12;222
2006;"DORMENTES (PE)";"PE";"DORMENTES";53;4;5;62
2006;"ESCADA (PE)";"PE";"ESCADA";248;35;85;368
2006;"EXU (PE)";"PE";"EXU";228;3;17;248
2006;"FEIRA NOVA (PE)";"PE";"FEIRA NOVA";124;10;6;140
2006;"FERNANDO DE NORONHA (PE)";"PE";"FERNANDO DE NORONHA";13;16;7;36
2006;"FERREIROS (PE)";"PE";"FERREIROS";39;2;22;63
2006;"FLORES (PE)";"PE";"FLORES";31;6;3;40
2006;"FLORESTA (PE)";"PE";"FLORESTA";268;2;2;272
2006;"FREI MIGUELINHO (PE)";"PE";"FREI MIGUELINHO";80;78;12;170
2006;"GAMELEIRA (PE)";"PE";"GAMELEIRA";47;8;27;82
2006;"GARANHUNS (PE)";"PE";"GARANHUNS";1232;91;75;1398
2006;"GLORIA DO GOITA (PE)";"PE";"GLORIA DO GOITA";107;19;17;143
2006;"GOIANA (PE)";"PE";"GOIANA";650;35;90;775
2006;"GRANITO (PE)";"PE";"GRANITO";12;0;0;12
2006;"GRAVATA (PE)";"PE";"GRAVATA";634;40;32;706
2006;"IATI (PE)";"PE";"IATI";26;13;15;54
2006;"IBIMIRIM (PE)";"PE";"IBIMIRIM";106;16;5;127
2006;"IBIRAJUBA (PE)";"PE";"IBIRAJUBA";31;0;3;34
2006;"IGARASSU (PE)";"PE";"IGARASSU";606;34;252;892
2006;"IGUARACI (PE)";"PE";"IGUARACI";63;6;11;80
2006;"ILHA DE ITAMARACA (PE)";"PE";"ILHA DE ITAMARACA";45;9;7;61
2006;"INAJA (PE)";"PE";"INAJA";28;2;3;33
2006;"INGAZEIRA (PE)";"PE";"INGAZEIRA";10;0;1;11
2006;"IPOJUCA (PE)";"PE";"IPOJUCA";371;121;95;587
2006;"IPUBI (PE)";"PE";"IPUBI";114;5;16;135
2006;"ITACURUBA (PE)";"PE";"ITACURUBA";11;1;2;14
2006;"ITAIBA (PE)";"PE";"ITAIBA";72;11;4;87
2006;"ITAMBE (PE)";"PE";"ITAMBE";292;9;63;364
2006;"ITAPETIM (PE)";"PE";"ITAPETIM";28;2;2;32
2006;"ITAPISSUMA (PE)";"PE";"ITAPISSUMA";51;47;6;104
2006;"ITAQUITINGA (PE)";"PE";"ITAQUITINGA";24;2;23;49
2006;"JABOATAO DOS GUARARAPES (PE)";"PE";"JABOATAO DOS GUARARAPES";3433;692;1361;5486
2006;"JAQUEIRA (PE)";"PE";"JAQUEIRA";37;1;7;45
2006;"JATAUBA (PE)";"PE";"JATAUBA";35;48;4;87
2006;"JATOBA (PE)";"PE";"JATOBA";13;1;3;17
2006;"JOAO ALFREDO (PE)";"PE";"JOAO ALFREDO";122;269;4;395
2006;"JOAQUIM NABUCO (PE)";"PE";"JOAQUIM NABUCO";94;10;21;125
2006;"JUCATI (PE)";"PE";"JUCATI";76;3;9;88
2006;"JUPI (PE)";"PE";"JUPI";113;5;6;124
2006;"JUREMA (PE)";"PE";"JUREMA";55;3;2;60
2006;"LAGOA DO CARRO (PE)";"PE";"LAGOA DO CARRO";52;8;7;67
2006;"LAGOA DO ITAENGA (PE)";"PE";"LAGOA DO ITAENGA";196;10;38;244
2006;"LAGOA DO OURO (PE)";"PE";"LAGOA DO OURO";29;10;3;42
2006;"LAGOA DOS GATOS (PE)";"PE";"LAGOA DOS GATOS";75;5;3;83
2006;"LAGOA GRANDE (PE)";"PE";"LAGOA GRANDE";53;5;13;71
2006;"LAJEDO (PE)";"PE";"LAJEDO";384;32;28;444
2006;"LIMOEIRO (PE)";"PE";"LIMOEIRO";339;42;36;417
2006;"MACAPARANA (PE)";"PE";"MACAPARANA";117;11;25;153
2006;"MACHADOS (PE)";"PE";"MACHADOS";65;11;5;81
2006;"MANARI (PE)";"PE";"MANARI";17;3;3;23
2006;"MARAIAL (PE)";"PE";"MARAIAL";108;0;10;118
2006;"MIRANDIBA (PE)";"PE";"MIRANDIBA";73;3;0;76
2006;"MOREILANDIA (PE)";"PE";"MOREILANDIA";25;0;4;29
2006;"MORENO (PE)";"PE";"MORENO";330;44;55;429
2006;"NAZARE DA MATA (PE)";"PE";"NAZARE DA MATA";165;8;27;200
2006;"OLINDA (PE)";"PE";"OLINDA";2049;248;960;3257
2006;"OROBO (PE)";"PE";"OROBO";65;78;11;154
2006;"OROCO (PE)";"PE";"OROCO";43;1;2;46
2006;"OURICURI (PE)";"PE";"OURICURI";411;14;51;476
2006;"PALMARES (PE)";"PE";"PALMARES";446;48;107;601
2006;"PALMEIRINA (PE)";"PE";"PALMEIRINA";11;5;1;17
2006;"PANELAS (PE)";"PE";"PANELAS";60;6;8;74
2006;"PARANATAMA (PE)";"PE";"PARANATAMA";34;8;8;50
2006;"PARNAMIRIM (PE)";"PE";"PARNAMIRIM";96;1;6;103
2006;"PASSIRA (PE)";"PE";"PASSIRA";131;19;16;166
2006;"PAUDALHO (PE)";"PE";"PAUDALHO";305;12;30;347
2006;"PAULISTA (PE)";"PE";"PAULISTA";966;131;173;1270
2006;"PEDRA (PE)";"PE";"PEDRA";86;11;8;105
2006;"PESQUEIRA (PE)";"PE";"PESQUEIRA";391;31;66;488
2006;"PETROLANDIA (PE)";"PE";"PETROLANDIA";178;1;11;190
2006;"PETROLINA (PE)";"PE";"PETROLINA";2049;175;261;2485
2006;"POCAO (PE)";"PE";"POCAO";42;6;2;50
2006;"POMBOS (PE)";"PE";"POMBOS";206;10;12;228
2006;"PRIMAVERA (PE)";"PE";"PRIMAVERA";53;6;20;79
2006;"QUIPAPA (PE)";"PE";"QUIPAPA";56;7;16;79
2006;"QUIXABA (PE)";"PE";"QUIXABA";12;2;2;16
2006;"RECIFE (PE)";"PE";"RECIFE";12263;1327;2554;16144
2006;"RIACHO DAS ALMAS (PE)";"PE";"RIACHO DAS ALMAS";151;35;18;204
2006;"RIBEIRAO (PE)";"PE";"RIBEIRAO";203;29;51;283
2006;"RIO FORMOSO (PE)";"PE";"RIO FORMOSO";97;7;41;145
2006;"SAIRE (PE)";"PE";"SAIRE";56;6;19;81
2006;"SALGADINHO (PE)";"PE";"SALGADINHO";12;15;1;28
2006;"SALGUEIRO (PE)";"PE";"SALGUEIRO";397;22;32;451
2006;"SALOA (PE)";"PE";"SALOA";44;12;2;58
2006;"SANHARO (PE)";"PE";"SANHARO";59;5;12;76
2006;"SANTA CRUZ (PE)";"PE";"SANTA CRUZ";73;3;4;80
2006;"SANTA CRUZ DA BAIXA VERDE (PE)";"PE";"SANTA CRUZ DA BAIXA VERDE";147;0;2;149
2006;"SANTA CRUZ DO CAPIBARIBE (PE)";"PE";"SANTA CRUZ DO CAPIBARIBE";477;151;29;657
2006;"SANTA FILOMENA (PE)";"PE";"SANTA FILOMENA";22;0;11;33
2006;"SANTA MARIA DA BOA VISTA (PE)";"PE";"SANTA MARIA DA BOA VISTA";114;7;26;147
2006;"SANTA MARIA DO CAMBUCA (PE)";"PE";"SANTA MARIA DO CAMBUCA";98;53;8;159
2006;"SANTA TEREZINHA (PE)";"PE";"SANTA TEREZINHA";22;3;3;28
2006;"SAO BENEDITO DO SUL (PE)";"PE";"SAO BENEDITO DO SUL";23;2;5;30
2006;"SAO BENTO DO UNA (PE)";"PE";"SAO BENTO DO UNA";459;19;47;525
2006;"SAO CAITANO (PE)";"PE";"SAO CAITANO";184;18;28;230
2006;"SAO JOAO (PE)";"PE";"SAO JOAO";71;15;7;93
2006;"SAO JOAQUIM DO MONTE (PE)";"PE";"SAO JOAQUIM DO MONTE";50;6;13;69
2006;"SAO JOSE DA COROA GRANDE (PE)";"PE";"SAO JOSE DA COROA GRANDE";41;3;7;51
2006;"SAO JOSE DO BELMONTE (PE)";"PE";"SAO JOSE DO BELMONTE";203;7;17;227
2006;"SAO JOSE DO EGITO (PE)";"PE";"SAO JOSE DO EGITO";352;20;37;409
2006;"SAO LOURENCO DA MATA (PE)";"PE";"SAO LOURENCO DA MATA";245;19;244;508
2006;"SAO VICENTE FERRER (PE)";"PE";"SAO VICENTE FERRER";89;4;8;101
2006;"SERRA TALHADA (PE)";"PE";"SERRA TALHADA";1066;26;29;1121
2006;"SERRITA (PE)";"PE";"SERRITA";53;3;5;61
2006;"SERTANIA (PE)";"PE";"SERTANIA";276;16;22;314
2006;"SIRINHAEM (PE)";"PE";"SIRINHAEM";152;7;20;179
2006;"SOLIDAO (PE)";"PE";"SOLIDAO";12;0;1;13
2006;"SURUBIM (PE)";"PE";"SURUBIM";459;335;37;831
2006;"TABIRA (PE)";"PE";"TABIRA";105;9;8;122
2006;"TACAIMBO (PE)";"PE";"TACAIMBO";60;7;12;79
2006;"TACARATU (PE)";"PE";"TACARATU";27;7;3;37
2006;"TAMANDARE (PE)";"PE";"TAMANDARE";48;8;10;66
2006;"TAQUARITINGA DO NORTE (PE)";"PE";"TAQUARITINGA DO NORTE";107;38;4;149
2006;"TEREZINHA (PE)";"PE";"TEREZINHA";16;1;4;21
2006;"TERRA NOVA (PE)";"PE";"TERRA NOVA";74;0;4;78
2006;"TIMBAUBA (PE)";"PE";"TIMBAUBA";704;16;54;774
2006;"TORITAMA (PE)";"PE";"TORITAMA";157;24;9;190
2006;"TRACUNHAEM (PE)";"PE";"TRACUNHAEM";29;8;15;52
2006;"TRINDADE (PE)";"PE";"TRINDADE";208;7;9;224
2006;"TRIUNFO (PE)";"PE";"TRIUNFO";144;6;4;154
2006;"TUPANATINGA (PE)";"PE";"TUPANATINGA";84;6;2;92
2006;"TUPARETAMA (PE)";"PE";"TUPARETAMA";65;6;11;82
2006;"VENTUROSA (PE)";"PE";"VENTUROSA";91;14;7;112
2006;"VERDEJANTE (PE)";"PE";"VERDEJANTE";47;1;8;56
2006;"VERTENTE DO LERIO (PE)";"PE";"VERTENTE DO LERIO";40;36;4;80
2006;"VERTENTES (PE)";"PE";"VERTENTES";84;31;15;130
2006;"VICENCIA (PE)";"PE";"VICENCIA";205;7;48;260
2006;"VITORIA DE SANTO ANTAO (PE)";"PE";"VITORIA DE SANTO ANTAO";1687;54;206;1947
2006;"XEXEU (PE)";"PE";"XEXEU";39;4;14;57
2006;"ACAUA (PI)";"PI";"ACAUA";9;1;0;10
2006;"AGRICOLANDIA (PI)";"PI";"AGRICOLANDIA";9;0;4;13
2006;"AGUA BRANCA (PI)";"PI";"AGUA BRANCA";52;3;3;58
2006;"ALAGOINHA DO PIAUI (PI)";"PI";"ALAGOINHA DO PIAUI";6;1;2;9
2006;"ALEGRETE DO PIAUI (PI)";"PI";"ALEGRETE DO PIAUI";3;1;1;5
2006;"ALTO LONGA (PI)";"PI";"ALTO LONGA";13;2;3;18
2006;"ALTOS (PI)";"PI";"ALTOS";115;2;11;128
2006;"ALVORADA DO GURGUEIA (PI)";"PI";"ALVORADA DO GURGUEIA";13;2;2;17
2006;"AMARANTE (PI)";"PI";"AMARANTE";28;2;3;33
2006;"ANGICAL DO PIAUI (PI)";"PI";"ANGICAL DO PIAUI";12;0;1;13
2006;"ANISIO DE ABREU (PI)";"PI";"ANISIO DE ABREU";2;6;1;9
2006;"ANTONIO ALMEIDA (PI)";"PI";"ANTONIO ALMEIDA";10;1;1;12
2006;"AROAZES (PI)";"PI";"AROAZES";5;1;3;9
2006;"AROEIRAS DO ITAIM (PI)";"PI";"AROEIRAS DO ITAIM";4;0;2;6
2006;"ARRAIAL (PI)";"PI";"ARRAIAL";1;0;2;3
2006;"ASSUNCAO DO PIAUI (PI)";"PI";"ASSUNCAO DO PIAUI";5;0;0;5
2006;"AVELINO LOPES (PI)";"PI";"AVELINO LOPES";6;3;1;10
2006;"BAIXA GRANDE DO RIBEIRO (PI)";"PI";"BAIXA GRANDE DO RIBEIRO";4;0;0;4
2006;"BARRA D ALCANTARA (PI)";"PI";"BARRA D ALCANTARA";6;0;0;6
2006;"BARRAS (PI)";"PI";"BARRAS";71;5;12;88
2006;"BARREIRAS DO PIAUI (PI)";"PI";"BARREIRAS DO PIAUI";2;0;0;2
2006;"BARRO DURO (PI)";"PI";"BARRO DURO";34;2;1;37
2006;"BATALHA (PI)";"PI";"BATALHA";35;2;7;44
2006;"BELA VISTA DO PIAUI (PI)";"PI";"BELA VISTA DO PIAUI";2;1;0;3
2006;"BELEM DO PIAUI (PI)";"PI";"BELEM DO PIAUI";2;0;0;2
2006;"BENEDITINOS (PI)";"PI";"BENEDITINOS";11;1;6;18
2006;"BERTOLINIA (PI)";"PI";"BERTOLINIA";9;2;0;11
2006;"BETANIA DO PIAUI (PI)";"PI";"BETANIA DO PIAUI";4;3;1;8
2006;"BOA HORA (PI)";"PI";"BOA HORA";5;0;1;6
2006;"BOCAINA (PI)";"PI";"BOCAINA";5;5;2;12
2006;"BOM JESUS (PI)";"PI";"BOM JESUS";120;0;8;128
2006;"BOM PRINCIPIO DO PIAUI (PI)";"PI";"BOM PRINCIPIO DO PIAUI";2;4;1;7
2006;"BONFIM DO PIAUI (PI)";"PI";"BONFIM DO PIAUI";4;1;2;7
2006;"BOQUEIRAO DO PIAUI (PI)";"PI";"BOQUEIRAO DO PIAUI";5;1;0;6
2006;"BRASILEIRA (PI)";"PI";"BRASILEIRA";5;0;4;9
2006;"BREJO DO PIAUI (PI)";"PI";"BREJO DO PIAUI";2;1;0;3
2006;"BURITI DOS LOPES (PI)";"PI";"BURITI DOS LOPES";13;0;5;18
2006;"BURITI DOS MONTES (PI)";"PI";"BURITI DOS MONTES";5;1;0;6
2006;"CABECEIRAS DO PIAUI (PI)";"PI";"CABECEIRAS DO PIAUI";3;0;2;5
2006;"CAJAZEIRAS DO PIAUI (PI)";"PI";"CAJAZEIRAS DO PIAUI";0;0;0;0
2006;"CAJUEIRO DA PRAIA (PI)";"PI";"CAJUEIRO DA PRAIA";5;1;2;8
2006;"CALDEIRAO GRANDE DO PIAUI (PI)";"PI";"CALDEIRAO GRANDE DO PIAUI";3;1;1;5
2006;"CAMPINAS DO PIAUI (PI)";"PI";"CAMPINAS DO PIAUI";0;1;1;2
2006;"CAMPO ALEGRE DO FIDALGO (PI)";"PI";"CAMPO ALEGRE DO FIDALGO";1;1;0;2
2006;"CAMPO GRANDE DO PIAUI (PI)";"PI";"CAMPO GRANDE DO PIAUI";5;3;0;8
2006;"CAMPO LARGO DO PIAUI (PI)";"PI";"CAMPO LARGO DO PIAUI";0;2;0;2
2006;"CAMPO MAIOR (PI)";"PI";"CAMPO MAIOR";259;12;31;302
2006;"CANAVIEIRA (PI)";"PI";"CANAVIEIRA";0;0;0;0
2006;"CANTO DO BURITI (PI)";"PI";"CANTO DO BURITI";47;4;3;54
2006;"CAPITAO DE CAMPOS (PI)";"PI";"CAPITAO DE CAMPOS";11;4;5;20
2006;"CAPITAO GERVASIO OLIVEIRA (PI)";"PI";"CAPITAO GERVASIO OLIVEIRA";1;0;2;3
2006;"CARACOL (PI)";"PI";"CARACOL";14;1;0;15
2006;"CARAUBAS DO PIAUI (PI)";"PI";"CARAUBAS DO PIAUI";3;1;0;4
2006;"CARIDADE DO PIAUI (PI)";"PI";"CARIDADE DO PIAUI";4;0;1;5
2006;"CASTELO DO PIAUI (PI)";"PI";"CASTELO DO PIAUI";27;0;3;30
2006;"CAXINGO (PI)";"PI";"CAXINGO";5;1;1;7
2006;"COCAL (PI)";"PI";"COCAL";29;2;3;34
2006;"COCAL DE TELHA (PI)";"PI";"COCAL DE TELHA";2;1;0;3
2006;"COCAL DOS ALVES (PI)";"PI";"COCAL DOS ALVES";0;2;0;2
2006;"COIVARAS (PI)";"PI";"COIVARAS";3;0;3;6
2006;"COLONIA DO GURGUEIA (PI)";"PI";"COLONIA DO GURGUEIA";2;3;0;5
2006;"COLONIA DO PIAUI (PI)";"PI";"COLONIA DO PIAUI";7;1;0;8
2006;"CONCEICAO DO CANINDE (PI)";"PI";"CONCEICAO DO CANINDE";2;2;0;4
2006;"CORONEL JOSE DIAS (PI)";"PI";"CORONEL JOSE DIAS";3;0;1;4
2006;"CORRENTE (PI)";"PI";"CORRENTE";45;3;1;49
2006;"CRISTALANDIA DO PIAUI (PI)";"PI";"CRISTALANDIA DO PIAUI";1;0;1;2
2006;"CRISTINO CASTRO (PI)";"PI";"CRISTINO CASTRO";25;1;3;29
2006;"CURIMATA (PI)";"PI";"CURIMATA";3;0;1;4
2006;"CURRAIS (PI)";"PI";"CURRAIS";2;1;0;3
2006;"CURRAL NOVO DO PIAUI (PI)";"PI";"CURRAL NOVO DO PIAUI";0;1;0;1
2006;"CURRALINHOS (PI)";"PI";"CURRALINHOS";2;0;0;2
2006;"DEMERVAL LOBAO (PI)";"PI";"DEMERVAL LOBAO";25;2;2;29
2006;"DIRCEU ARCOVERDE (PI)";"PI";"DIRCEU ARCOVERDE";4;1;0;5
2006;"DOM EXPEDITO LOPES (PI)";"PI";"DOM EXPEDITO LOPES";67;2;2;71
2006;"DOM INOCENCIO (PI)";"PI";"DOM INOCENCIO";7;2;2;11
2006;"DOMINGOS MOURAO (PI)";"PI";"DOMINGOS MOURAO";2;0;0;2
2006;"ELESBAO VELOSO (PI)";"PI";"ELESBAO VELOSO";29;1;3;33
2006;"ELISEU MARTINS (PI)";"PI";"ELISEU MARTINS";7;1;1;9
2006;"ESPERANTINA (PI)";"PI";"ESPERANTINA";97;12;16;125
2006;"FARTURA DO PIAUI (PI)";"PI";"FARTURA DO PIAUI";3;0;0;3
2006;"FLORES DO PIAUI (PI)";"PI";"FLORES DO PIAUI";2;0;0;2
2006;"FLORESTA DO PIAUI (PI)";"PI";"FLORESTA DO PIAUI";0;1;0;1
2006;"FLORIANO (PI)";"PI";"FLORIANO";989;49;25;1063
2006;"FRANCINOPOLIS (PI)";"PI";"FRANCINOPOLIS";8;4;0;12
2006;"FRANCISCO AYRES (PI)";"PI";"FRANCISCO AYRES";3;3;1;7
2006;"FRANCISCO MACEDO (PI)";"PI";"FRANCISCO MACEDO";1;1;1;3
2006;"FRANCISCO SANTOS (PI)";"PI";"FRANCISCO SANTOS";44;6;1;51
2006;"FRONTEIRAS (PI)";"PI";"FRONTEIRAS";52;7;2;61
2006;"GEMINIANO (PI)";"PI";"GEMINIANO";8;3;4;15
2006;"GILBUES (PI)";"PI";"GILBUES";5;1;2;8
2006;"GUADALUPE (PI)";"PI";"GUADALUPE";35;7;2;44
2006;"GUARIBAS (PI)";"PI";"GUARIBAS";1;0;0;1
2006;"HUGO NAPOLEAO (PI)";"PI";"HUGO NAPOLEAO";3;0;0;3
2006;"ILHA GRANDE (PI)";"PI";"ILHA GRANDE";1;2;1;4
2006;"INHUMA (PI)";"PI";"INHUMA";48;2;4;54
2006;"IPIRANGA DO PIAUI (PI)";"PI";"IPIRANGA DO PIAUI";25;5;3;33
2006;"ISAIAS COELHO (PI)";"PI";"ISAIAS COELHO";2;0;2;4
2006;"ITAINOPOLIS (PI)";"PI";"ITAINOPOLIS";12;9;4;25
2006;"ITAUEIRA (PI)";"PI";"ITAUEIRA";18;2;0;20
2006;"JACOBINA DO PIAUI (PI)";"PI";"JACOBINA DO PIAUI";12;1;0;13
2006;"JAICOS (PI)";"PI";"JAICOS";54;6;2;62
2006;"JARDIM DO MULATO (PI)";"PI";"JARDIM DO MULATO";3;0;0;3
2006;"JATOBA DO PIAUI (PI)";"PI";"JATOBA DO PIAUI";15;0;0;15
2006;"JERUMENHA (PI)";"PI";"JERUMENHA";8;1;0;9
2006;"JOAO COSTA (PI)";"PI";"JOAO COSTA";1;0;0;1
2006;"JOAQUIM PIRES (PI)";"PI";"JOAQUIM PIRES";9;0;0;9
2006;"JOCA MARQUES (PI)";"PI";"JOCA MARQUES";1;0;1;2
2006;"JOSE DE FREITAS (PI)";"PI";"JOSE DE FREITAS";43;3;11;57
2006;"JUAZEIRO DO PIAUI (PI)";"PI";"JUAZEIRO DO PIAUI";1;0;0;1
2006;"JULIO BORGES (PI)";"PI";"JULIO BORGES";1;1;0;2
2006;"JUREMA (PI)";"PI";"JUREMA";0;1;1;2
2006;"LAGOA ALEGRE (PI)";"PI";"LAGOA ALEGRE";1;0;2;3
2006;"LAGOA DE SAO FRANCISCO (PI)";"PI";"LAGOA DE SAO FRANCISCO";1;0;0;1
2006;"LAGOA DO BARRO DO PIAUI (PI)";"PI";"LAGOA DO BARRO DO PIAUI";1;1;4;6
2006;"LAGOA DO PIAUI (PI)";"PI";"LAGOA DO PIAUI";6;0;0;6
2006;"LAGOA DO SITIO (PI)";"PI";"LAGOA DO SITIO";8;1;1;10
2006;"LAGOINHA DO PIAUI (PI)";"PI";"LAGOINHA DO PIAUI";4;2;2;8
2006;"LANDRI SALES (PI)";"PI";"LANDRI SALES";2;1;0;3
2006;"LUIS CORREIA (PI)";"PI";"LUIS CORREIA";21;3;6;30
2006;"LUZILANDIA (PI)";"PI";"LUZILANDIA";15;2;6;23
2006;"MADEIRO (PI)";"PI";"MADEIRO";3;1;1;5
2006;"MANOEL EMIDIO (PI)";"PI";"MANOEL EMIDIO";3;1;2;6
2006;"MARCOLANDIA (PI)";"PI";"MARCOLANDIA";50;10;2;62
2006;"MARCOS PARENTE (PI)";"PI";"MARCOS PARENTE";1;5;0;6
2006;"MASSAPE DO PIAUI (PI)";"PI";"MASSAPE DO PIAUI";3;1;0;4
2006;"MATIAS OLIMPIO (PI)";"PI";"MATIAS OLIMPIO";8;4;4;16
2006;"MIGUEL ALVES (PI)";"PI";"MIGUEL ALVES";14;2;4;20
2006;"MIGUEL LEAO (PI)";"PI";"MIGUEL LEAO";2;0;0;2
2006;"MILTON BRANDAO (PI)";"PI";"MILTON BRANDAO";0;0;0;0
2006;"MONSENHOR GIL (PI)";"PI";"MONSENHOR GIL";7;1;1;9
2006;"MONSENHOR HIPOLITO (PI)";"PI";"MONSENHOR HIPOLITO";7;6;1;14
2006;"MONTE ALEGRE DO PIAUI (PI)";"PI";"MONTE ALEGRE DO PIAUI";5;1;2;8
2006;"MORRO CABECA NO TEMPO (PI)";"PI";"MORRO CABECA NO TEMPO";0;0;0;0
2006;"MORRO DO CHAPEU DO PIAUI (PI)";"PI";"MORRO DO CHAPEU DO PIAUI";1;0;1;2
2006;"MURICI DOS PORTELAS (PI)";"PI";"MURICI DOS PORTELAS";2;0;1;3
2006;"NAZARE DO PIAUI (PI)";"PI";"NAZARE DO PIAUI";5;4;1;10
2006;"NOSSA SENHORA DE NAZARE (PI)";"PI";"NOSSA SENHORA DE NAZARE";1;0;1;2
2006;"NOSSA SENHORA DOS REMEDIOS (PI)";"PI";"NOSSA SENHORA DOS REMEDIOS";0;1;0;1
2006;"NOVA SANTA RITA (PI)";"PI";"NOVA SANTA RITA";0;2;0;2
2006;"NOVO ORIENTE DO PIAUI (PI)";"PI";"NOVO ORIENTE DO PIAUI";8;1;2;11
2006;"NOVO SANTO ANTONIO (PI)";"PI";"NOVO SANTO ANTONIO";4;0;0;4
2006;"OEIRAS (PI)";"PI";"OEIRAS";195;16;14;225
2006;"OLHO D AGUA DO PIAUI (PI)";"PI";"OLHO D AGUA DO PIAUI";2;1;1;4
2006;"PADRE MARCOS (PI)";"PI";"PADRE MARCOS";7;3;1;11
2006;"PAES LANDIM (PI)";"PI";"PAES LANDIM";2;1;0;3
2006;"PAJEU DO PIAUI (PI)";"PI";"PAJEU DO PIAUI";3;1;0;4
2006;"PALMEIRA DO PIAUI (PI)";"PI";"PALMEIRA DO PIAUI";13;1;0;14
2006;"PALMEIRAIS (PI)";"PI";"PALMEIRAIS";12;3;1;16
2006;"PAQUETA (PI)";"PI";"PAQUETA";6;5;2;13
2006;"PARNAGUA (PI)";"PI";"PARNAGUA";3;0;0;3
2006;"PARNAIBA (PI)";"PI";"PARNAIBA";704;84;147;935
2006;"PASSAGEM FRANCA DO PIAUI (PI)";"PI";"PASSAGEM FRANCA DO PIAUI";1;0;0;1
2006;"PATOS DO PIAUI (PI)";"PI";"PATOS DO PIAUI";9;0;3;12
2006;"PAU D ARCO DO PIAUI (PI)";"PI";"PAU D ARCO DO PIAUI";2;0;1;3
2006;"PAULISTANA (PI)";"PI";"PAULISTANA";64;13;5;82
2006;"PAVUSSU (PI)";"PI";"PAVUSSU";1;2;0;3
2006;"PEDRO II (PI)";"PI";"PEDRO II";41;5;3;49
2006;"PEDRO LAURENTINO (PI)";"PI";"PEDRO LAURENTINO";0;0;0;0
2006;"PICOS (PI)";"PI";"PICOS";1251;97;41;1389
2006;"PIMENTEIRAS (PI)";"PI";"PIMENTEIRAS";17;3;1;21
2006;"PIO IX (PI)";"PI";"PIO IX";19;2;3;24
2006;"PIRACURUCA (PI)";"PI";"PIRACURUCA";103;4;18;125
2006;"PIRIPIRI (PI)";"PI";"PIRIPIRI";208;13;49;270
2006;"PORTO (PI)";"PI";"PORTO";1;2;0;3
2006;"PORTO ALEGRE DO PIAUI (PI)";"PI";"PORTO ALEGRE DO PIAUI";3;3;0;6
2006;"PRATA DO PIAUI (PI)";"PI";"PRATA DO PIAUI";2;1;1;4
2006;"QUEIMADA NOVA (PI)";"PI";"QUEIMADA NOVA";7;1;2;10
2006;"REDENCAO DO GURGUEIA (PI)";"PI";"REDENCAO DO GURGUEIA";4;0;6;10
2006;"REGENERACAO (PI)";"PI";"REGENERACAO";43;4;2;49
2006;"RIACHO FRIO (PI)";"PI";"RIACHO FRIO";1;1;0;2
2006;"RIBEIRA DO PIAUI (PI)";"PI";"RIBEIRA DO PIAUI";1;0;1;2
2006;"RIBEIRO GONCALVES (PI)";"PI";"RIBEIRO GONCALVES";8;0;0;8
2006;"RIO GRANDE DO PIAUI (PI)";"PI";"RIO GRANDE DO PIAUI";4;1;2;7
2006;"SANTA CRUZ DO PIAUI (PI)";"PI";"SANTA CRUZ DO PIAUI";7;4;0;11
2006;"SANTA CRUZ DOS MILAGRES (PI)";"PI";"SANTA CRUZ DOS MILAGRES";1;0;0;1
2006;"SANTA FILOMENA (PI)";"PI";"SANTA FILOMENA";5;1;1;7
2006;"SANTA LUZ (PI)";"PI";"SANTA LUZ";5;0;1;6
2006;"SANTA ROSA DO PIAUI (PI)";"PI";"SANTA ROSA DO PIAUI";3;1;3;7
2006;"SANTANA DO PIAUI (PI)";"PI";"SANTANA DO PIAUI";15;2;4;21
2006;"SANTO ANTONIO DE LISBOA (PI)";"PI";"SANTO ANTONIO DE LISBOA";18;7;4;29
2006;"SANTO ANTONIO DOS MILAGRES (PI)";"PI";"SANTO ANTONIO DOS MILAGRES";1;3;0;4
2006;"SANTO INACIO DO PIAUI (PI)";"PI";"SANTO INACIO DO PIAUI";2;3;0;5
2006;"SAO BRAZ DO PIAUI (PI)";"PI";"SAO BRAZ DO PIAUI";1;0;0;1
2006;"SAO FELIX DO PIAUI (PI)";"PI";"SAO FELIX DO PIAUI";3;0;1;4
2006;"SAO FRANCISCO DE ASSIS DO PIAU (PI)";"PI";"SAO FRANCISCO DE ASSIS DO PIAU";1;0;2;3
2006;"SAO FRANCISCO DO PIAUI (PI)";"PI";"SAO FRANCISCO DO PIAUI";3;0;3;6
2006;"SAO GONCALO DO GURGUEIA (PI)";"PI";"SAO GONCALO DO GURGUEIA";0;2;0;2
2006;"SAO GONCALO DO PIAUI (PI)";"PI";"SAO GONCALO DO PIAUI";9;3;7;19
2006;"SAO JOAO DA CANABRAVA (PI)";"PI";"SAO JOAO DA CANABRAVA";6;4;2;12
2006;"SAO JOAO DA FRONTEIRA (PI)";"PI";"SAO JOAO DA FRONTEIRA";1;1;3;5
2006;"SAO JOAO DA SERRA (PI)";"PI";"SAO JOAO DA SERRA";0;0;0;0
2006;"SAO JOAO DA VARJOTA (PI)";"PI";"SAO JOAO DA VARJOTA";0;0;1;1
2006;"SAO JOAO DO ARRAIAL (PI)";"PI";"SAO JOAO DO ARRAIAL";2;1;0;3
2006;"SAO JOAO DO PIAUI (PI)";"PI";"SAO JOAO DO PIAUI";45;6;4;55
2006;"SAO JOSE DO DIVINO (PI)";"PI";"SAO JOSE DO DIVINO";3;1;1;5
2006;"SAO JOSE DO PEIXE (PI)";"PI";"SAO JOSE DO PEIXE";1;1;0;2
2006;"SAO JOSE DO PIAUI (PI)";"PI";"SAO JOSE DO PIAUI";13;5;2;20
2006;"SAO JULIAO (PI)";"PI";"SAO JULIAO";6;2;1;9
2006;"SAO LOURENCO DO PIAUI (PI)";"PI";"SAO LOURENCO DO PIAUI";0;0;1;1
2006;"SAO LUIS DO PIAUI (PI)";"PI";"SAO LUIS DO PIAUI";4;2;0;6
2006;"SAO MIGUEL DA BAIXA GRANDE (PI)";"PI";"SAO MIGUEL DA BAIXA GRANDE";3;0;0;3
2006;"SAO MIGUEL DO FIDALGO (PI)";"PI";"SAO MIGUEL DO FIDALGO";2;1;1;4
2006;"SAO MIGUEL DO TAPUIO (PI)";"PI";"SAO MIGUEL DO TAPUIO";5;0;3;8
2006;"SAO PEDRO DO PIAUI (PI)";"PI";"SAO PEDRO DO PIAUI";21;1;1;23
2006;"SAO RAIMUNDO NONATO (PI)";"PI";"SAO RAIMUNDO NONATO";141;3;14;158
2006;"SEBASTIAO BARROS (PI)";"PI";"SEBASTIAO BARROS";0;2;0;2
2006;"SEBASTIAO LEAL (PI)";"PI";"SEBASTIAO LEAL";3;1;0;4
2006;"SIGEFREDO PACHECO (PI)";"PI";"SIGEFREDO PACHECO";13;3;0;16
2006;"SIMOES (PI)";"PI";"SIMOES";31;4;1;36
2006;"SIMPLICIO MENDES (PI)";"PI";"SIMPLICIO MENDES";26;5;4;35
2006;"SOCORRO DO PIAUI (PI)";"PI";"SOCORRO DO PIAUI";0;0;0;0
2006;"SUSSUAPARA (PI)";"PI";"SUSSUAPARA";11;7;1;19
2006;"TAMBORIL DO PIAUI (PI)";"PI";"TAMBORIL DO PIAUI";1;0;0;1
2006;"TANQUE DO PIAUI (PI)";"PI";"TANQUE DO PIAUI";3;0;2;5
2006;"TERESINA (PI)";"PI";"TERESINA";7209;655;1777;9641
2006;"UNIAO (PI)";"PI";"UNIAO";59;11;9;79
2006;"URUCUI (PI)";"PI";"URUCUI";95;4;4;103
2006;"VALENCA DO PIAUI (PI)";"PI";"VALENCA DO PIAUI";79;15;8;102
2006;"VARZEA BRANCA (PI)";"PI";"VARZEA BRANCA";1;0;4;5
2006;"VARZEA GRANDE (PI)";"PI";"VARZEA GRANDE";4;2;1;7
2006;"VERA MENDES (PI)";"PI";"VERA MENDES";2;4;0;6
2006;"VILA NOVA DO PIAUI (PI)";"PI";"VILA NOVA DO PIAUI";2;0;1;3
2006;"WALL FERRAZ (PI)";"PI";"WALL FERRAZ";3;3;0;6
2006;"ABATIA (PR)";"PR";"ABATIA";112;2;25;139
2006;"ADRIANOPOLIS (PR)";"PR";"ADRIANOPOLIS";68;3;15;86
2006;"AGUDOS DO SUL (PR)";"PR";"AGUDOS DO SUL";247;4;12;263
2006;"ALMIRANTE TAMANDARE (PR)";"PR";"ALMIRANTE TAMANDARE";917;63;201;1181
2006;"ALTAMIRA DO PARANA (PR)";"PR";"ALTAMIRA DO PARANA";31;3;9;43
2006;"ALTO PARANA (PR)";"PR";"ALTO PARANA";198;6;52;256
2006;"ALTO PIQUIRI (PR)";"PR";"ALTO PIQUIRI";161;5;24;190
2006;"ALTONIA (PR)";"PR";"ALTONIA";335;9;33;377
2006;"ALVORADA DO SUL (PR)";"PR";"ALVORADA DO SUL";234;6;45;285
2006;"AMAPORA (PR)";"PR";"AMAPORA";63;3;22;88
2006;"AMPERE (PR)";"PR";"AMPERE";303;11;20;334
2006;"ANAHY (PR)";"PR";"ANAHY";42;3;7;52
2006;"ANDIRA (PR)";"PR";"ANDIRA";471;14;57;542
2006;"ANGULO (PR)";"PR";"ANGULO";52;1;6;59
2006;"ANTONINA (PR)";"PR";"ANTONINA";76;11;23;110
2006;"ANTONIO OLINTO (PR)";"PR";"ANTONIO OLINTO";108;2;18;128
2006;"APUCARANA (PR)";"PR";"APUCARANA";2027;171;214;2412
2006;"ARAPONGAS (PR)";"PR";"ARAPONGAS";2715;109;91;2915
2006;"ARAPOTI (PR)";"PR";"ARAPOTI";396;20;57;473
2006;"ARAPUA (PR)";"PR";"ARAPUA";73;2;13;88
2006;"ARARUNA (PR)";"PR";"ARARUNA";292;4;20;316
2006;"ARAUCARIA (PR)";"PR";"ARAUCARIA";2472;171;379;3022
2006;"ARIRANHA DO IVAI (PR)";"PR";"ARIRANHA DO IVAI";29;3;11;43
2006;"ASSAI (PR)";"PR";"ASSAI";408;8;26;442
2006;"ASSIS CHATEAUBRIAND (PR)";"PR";"ASSIS CHATEAUBRIAND";968;19;56;1043
2006;"ASTORGA (PR)";"PR";"ASTORGA";519;21;67;607
2006;"ATALAIA (PR)";"PR";"ATALAIA";83;9;13;105
2006;"BALSA NOVA (PR)";"PR";"BALSA NOVA";205;10;26;241
2006;"BANDEIRANTES (PR)";"PR";"BANDEIRANTES";781;22;78;881
2006;"BARBOSA FERRAZ (PR)";"PR";"BARBOSA FERRAZ";134;8;16;158
2006;"BARRA DO JACARE (PR)";"PR";"BARRA DO JACARE";33;2;7;42
2006;"BARRACAO (PR)";"PR";"BARRACAO";167;15;30;212
2006;"BELA VISTA DO CAROBA (PR)";"PR";"BELA VISTA DO CAROBA";38;2;9;49
2006;"BELA VISTA DO PARAISO (PR)";"PR";"BELA VISTA DO PARAISO";336;9;48;393
2006;"BITURUNA (PR)";"PR";"BITURUNA";326;11;62;399
2006;"BOA ESPERANCA (PR)";"PR";"BOA ESPERANCA";143;3;13;159
2006;"BOA ESPERANCA DO IGUACU (PR)";"PR";"BOA ESPERANCA DO IGUACU";52;3;5;60
2006;"BOA VENTURA DE SAO ROQUE (PR)";"PR";"BOA VENTURA DE SAO ROQUE";130;4;19;153
2006;"BOA VISTA DA APARECIDA (PR)";"PR";"BOA VISTA DA APARECIDA";120;7;19;146
2006;"BOCAIUVA DO SUL (PR)";"PR";"BOCAIUVA DO SUL";194;6;11;211
2006;"BOM JESUS DO SUL (PR)";"PR";"BOM JESUS DO SUL";29;5;3;37
2006;"BOM SUCESSO (PR)";"PR";"BOM SUCESSO";88;2;28;118
2006;"BOM SUCESSO DO SUL (PR)";"PR";"BOM SUCESSO DO SUL";76;10;5;91
2006;"BORRAZOPOLIS (PR)";"PR";"BORRAZOPOLIS";203;3;9;215
2006;"BRAGANEY (PR)";"PR";"BRAGANEY";125;4;9;138
2006;"BRASILANDIA DO SUL (PR)";"PR";"BRASILANDIA DO SUL";41;1;6;48
2006;"CAFEARA (PR)";"PR";"CAFEARA";28;0;9;37
2006;"CAFELANDIA (PR)";"PR";"CAFELANDIA";386;9;30;425
2006;"CAFEZAL DO SUL (PR)";"PR";"CAFEZAL DO SUL";88;2;36;126
2006;"CALIFORNIA (PR)";"PR";"CALIFORNIA";177;4;11;192
2006;"CAMBARA (PR)";"PR";"CAMBARA";1013;20;57;1090
2006;"CAMBE (PR)";"PR";"CAMBE";1502;130;232;1864
2006;"CAMBIRA (PR)";"PR";"CAMBIRA";200;1;11;212
2006;"CAMPINA DA LAGOA (PR)";"PR";"CAMPINA DA LAGOA";296;10;39;345
2006;"CAMPINA DO SIMAO (PR)";"PR";"CAMPINA DO SIMAO";60;4;18;82
2006;"CAMPINA GRANDE DO SUL (PR)";"PR";"CAMPINA GRANDE DO SUL";554;30;40;624
2006;"CAMPO BONITO (PR)";"PR";"CAMPO BONITO";79;3;6;88
2006;"CAMPO DO TENENTE (PR)";"PR";"CAMPO DO TENENTE";107;8;26;141
2006;"CAMPO LARGO (PR)";"PR";"CAMPO LARGO";1771;147;388;2306
2006;"CAMPO MAGRO (PR)";"PR";"CAMPO MAGRO";273;24;23;320
2006;"CAMPO MOURAO (PR)";"PR";"CAMPO MOURAO";1724;42;432;2198
2006;"CANDIDO DE ABREU (PR)";"PR";"CANDIDO DE ABREU";176;4;31;211
2006;"CANDOI (PR)";"PR";"CANDOI";293;4;67;364
2006;"CANTAGALO (PR)";"PR";"CANTAGALO";194;7;28;229
2006;"CAPANEMA (PR)";"PR";"CAPANEMA";328;8;42;378
2006;"CAPITAO LEONIDAS MARQUES (PR)";"PR";"CAPITAO LEONIDAS MARQUES";368;12;21;401
2006;"CARAMBEI (PR)";"PR";"CARAMBEI";439;22;46;507
2006;"CARLOPOLIS (PR)";"PR";"CARLOPOLIS";220;13;27;260
2006;"CASCAVEL (PR)";"PR";"CASCAVEL";6086;227;641;6954
2006;"CASTRO (PR)";"PR";"CASTRO";1345;61;179;1585
2006;"CATANDUVAS (PR)";"PR";"CATANDUVAS";167;7;21;195
2006;"CENTENARIO DO SUL (PR)";"PR";"CENTENARIO DO SUL";103;12;42;157
2006;"CERRO AZUL (PR)";"PR";"CERRO AZUL";295;7;40;342
2006;"CEU AZUL (PR)";"PR";"CEU AZUL";270;11;41;322
2006;"CHOPINZINHO (PR)";"PR";"CHOPINZINHO";432;13;62;507
2006;"CIANORTE (PR)";"PR";"CIANORTE";1240;32;154;1426
2006;"CIDADE GAUCHA (PR)";"PR";"CIDADE GAUCHA";176;7;62;245
2006;"CLEVELANDIA (PR)";"PR";"CLEVELANDIA";446;22;32;500
2006;"COLOMBO (PR)";"PR";"COLOMBO";2994;137;385;3516
2006;"COLORADO (PR)";"PR";"COLORADO";523;29;63;615
2006;"CONGONHINHAS (PR)";"PR";"CONGONHINHAS";102;5;21;128
2006;"CONSELHEIRO MAIRINCK (PR)";"PR";"CONSELHEIRO MAIRINCK";26;2;8;36
2006;"CONTENDA (PR)";"PR";"CONTENDA";567;14;43;624
2006;"CORBELIA (PR)";"PR";"CORBELIA";613;12;30;655
2006;"CORNELIO PROCOPIO (PR)";"PR";"CORNELIO PROCOPIO";875;65;96;1036
2006;"CORONEL DOMINGOS SOARES (PR)";"PR";"CORONEL DOMINGOS SOARES";74;3;21;98
2006;"CORONEL VIVIDA (PR)";"PR";"CORONEL VIVIDA";567;18;74;659
2006;"CORUMBATAI DO SUL (PR)";"PR";"CORUMBATAI DO SUL";38;2;18;58
2006;"CRUZ MACHADO (PR)";"PR";"CRUZ MACHADO";346;11;42;399
2006;"CRUZEIRO DO IGUACU (PR)";"PR";"CRUZEIRO DO IGUACU";59;2;12;73
2006;"CRUZEIRO DO OESTE (PR)";"PR";"CRUZEIRO DO OESTE";346;11;59;416
2006;"CRUZEIRO DO SUL (PR)";"PR";"CRUZEIRO DO SUL";71;3;14;88
2006;"CRUZMALTINA (PR)";"PR";"CRUZMALTINA";51;1;5;57
2006;"CURITIBA (PR)";"PR";"CURITIBA";31739;2880;5159;39778
2006;"CURIUVA (PR)";"PR";"CURIUVA";168;17;50;235
2006;"DIAMANTE D OESTE (PR)";"PR";"DIAMANTE D OESTE";57;8;14;79
2006;"DIAMANTE DO NORTE (PR)";"PR";"DIAMANTE DO NORTE";65;1;17;83
2006;"DIAMANTE DO SUL (PR)";"PR";"DIAMANTE DO SUL";36;1;6;43
2006;"DOIS VIZINHOS (PR)";"PR";"DOIS VIZINHOS";707;27;73;807
2006;"DOURADINA (PR)";"PR";"DOURADINA";157;5;7;169
2006;"DOUTOR CAMARGO (PR)";"PR";"DOUTOR CAMARGO";132;3;28;163
2006;"DOUTOR ULYSSES (PR)";"PR";"DOUTOR ULYSSES";35;2;5;42
2006;"ENEAS MARQUES (PR)";"PR";"ENEAS MARQUES";115;7;15;137
2006;"ENGENHEIRO BELTRAO (PR)";"PR";"ENGENHEIRO BELTRAO";396;8;47;451
2006;"ENTRE RIOS DO OESTE (PR)";"PR";"ENTRE RIOS DO OESTE";111;2;6;119
2006;"ESPERANCA NOVA (PR)";"PR";"ESPERANCA NOVA";23;3;4;30
2006;"ESPIGAO ALTO DO IGUACU (PR)";"PR";"ESPIGAO ALTO DO IGUACU";44;3;2;49
2006;"FAROL (PR)";"PR";"FAROL";57;0;9;66
2006;"FAXINAL (PR)";"PR";"FAXINAL";292;5;22;319
2006;"FAZENDA RIO GRANDE (PR)";"PR";"FAZENDA RIO GRANDE";692;32;170;894
2006;"FENIX (PR)";"PR";"FENIX";84;1;12;97
2006;"FERNANDES PINHEIRO (PR)";"PR";"FERNANDES PINHEIRO";80;4;13;97
2006;"FIGUEIRA (PR)";"PR";"FIGUEIRA";103;7;24;134
2006;"FLOR DA SERRA DO SUL (PR)";"PR";"FLOR DA SERRA DO SUL";87;2;21;110
2006;"FLORAI (PR)";"PR";"FLORAI";127;3;21;151
2006;"FLORESTA (PR)";"PR";"FLORESTA";193;5;15;213
2006;"FLORESTOPOLIS (PR)";"PR";"FLORESTOPOLIS";158;5;59;222
2006;"FLORIDA (PR)";"PR";"FLORIDA";37;7;7;51
2006;"FORMOSA DO OESTE (PR)";"PR";"FORMOSA DO OESTE";160;17;13;190
2006;"FOZ DO IGUACU (PR)";"PR";"FOZ DO IGUACU";2738;820;780;4338
2006;"FOZ DO JORDAO (PR)";"PR";"FOZ DO JORDAO";61;1;7;69
2006;"FRANCISCO ALVES (PR)";"PR";"FRANCISCO ALVES";135;2;19;156
2006;"FRANCISCO BELTRAO (PR)";"PR";"FRANCISCO BELTRAO";1555;58;146;1759
2006;"GENERAL CARNEIRO (PR)";"PR";"GENERAL CARNEIRO";368;6;39;413
2006;"GODOY MOREIRA (PR)";"PR";"GODOY MOREIRA";42;2;7;51
2006;"GOIOERE (PR)";"PR";"GOIOERE";640;17;58;715
2006;"GOIOXIM (PR)";"PR";"GOIOXIM";73;3;16;92
2006;"GRANDES RIOS (PR)";"PR";"GRANDES RIOS";66;5;7;78
2006;"GUAIRA (PR)";"PR";"GUAIRA";1150;25;73;1248
2006;"GUAIRACA (PR)";"PR";"GUAIRACA";126;2;18;146
2006;"GUAMIRANGA (PR)";"PR";"GUAMIRANGA";120;4;11;135
2006;"GUAPIRAMA (PR)";"PR";"GUAPIRAMA";79;5;17;101
2006;"GUAPOREMA (PR)";"PR";"GUAPOREMA";36;0;5;41
2006;"GUARACI (PR)";"PR";"GUARACI";77;0;16;93
2006;"GUARANIACU (PR)";"PR";"GUARANIACU";313;13;48;374
2006;"GUARAPUAVA (PR)";"PR";"GUARAPUAVA";3648;220;305;4173
2006;"GUARAQUECABA (PR)";"PR";"GUARAQUECABA";15;0;4;19
2006;"GUARATUBA (PR)";"PR";"GUARATUBA";199;14;41;254
2006;"HONORIO SERPA (PR)";"PR";"HONORIO SERPA";93;1;22;116
2006;"IBAITI (PR)";"PR";"IBAITI";429;14;129;572
2006;"IBEMA (PR)";"PR";"IBEMA";122;3;11;136
2006;"IBIPORA (PR)";"PR";"IBIPORA";732;24;92;848
2006;"ICARAIMA (PR)";"PR";"ICARAIMA";93;2;25;120
2006;"IGUARACU (PR)";"PR";"IGUARACU";48;0;11;59
2006;"IGUATU (PR)";"PR";"IGUATU";33;0;6;39
2006;"IMBAU (PR)";"PR";"IMBAU";156;10;26;192
2006;"IMBITUVA (PR)";"PR";"IMBITUVA";635;13;44;692
2006;"INACIO MARTINS (PR)";"PR";"INACIO MARTINS";201;10;22;233
2006;"INAJA (PR)";"PR";"INAJA";31;1;14;46
2006;"INDIANOPOLIS (PR)";"PR";"INDIANOPOLIS";107;1;6;114
2006;"IPIRANGA (PR)";"PR";"IPIRANGA";284;9;27;320
2006;"IPORA (PR)";"PR";"IPORA";311;10;29;350
2006;"IRACEMA DO OESTE (PR)";"PR";"IRACEMA DO OESTE";60;5;3;68
2006;"IRATI (PR)";"PR";"IRATI";1223;52;108;1383
2006;"IRETAMA (PR)";"PR";"IRETAMA";125;2;22;149
2006;"ITAGUAJE (PR)";"PR";"ITAGUAJE";76;2;18;96
2006;"ITAIPULANDIA (PR)";"PR";"ITAIPULANDIA";145;7;21;173
2006;"ITAMBARACA (PR)";"PR";"ITAMBARACA";124;4;21;149
2006;"ITAMBE (PR)";"PR";"ITAMBE";163;6;20;189
2006;"ITAPEJARA D OESTE (PR)";"PR";"ITAPEJARA D OESTE";231;6;17;254
2006;"ITAPERUCU (PR)";"PR";"ITAPERUCU";394;31;38;463
2006;"ITAUNA DO SUL (PR)";"PR";"ITAUNA DO SUL";39;2;6;47
2006;"IVAI (PR)";"PR";"IVAI";238;4;25;267
2006;"IVAIPORA (PR)";"PR";"IVAIPORA";663;13;74;750
2006;"IVATE (PR)";"PR";"IVATE";121;0;37;158
2006;"IVATUBA (PR)";"PR";"IVATUBA";47;2;7;56
2006;"JABOTI (PR)";"PR";"JABOTI";55;3;5;63
2006;"JACAREZINHO (PR)";"PR";"JACAREZINHO";450;43;91;584
2006;"JAGUAPITA (PR)";"PR";"JAGUAPITA";249;15;33;297
2006;"JAGUARIAIVA (PR)";"PR";"JAGUARIAIVA";550;28;88;666
2006;"JANDAIA DO SUL (PR)";"PR";"JANDAIA DO SUL";457;17;82;556
2006;"JANIOPOLIS (PR)";"PR";"JANIOPOLIS";108;6;15;129
2006;"JAPIRA (PR)";"PR";"JAPIRA";37;3;4;44
2006;"JAPURA (PR)";"PR";"JAPURA";187;2;15;204
2006;"JARDIM ALEGRE (PR)";"PR";"JARDIM ALEGRE";164;9;16;189
2006;"JARDIM OLINDA (PR)";"PR";"JARDIM OLINDA";36;1;6;43
2006;"JATAIZINHO (PR)";"PR";"JATAIZINHO";275;21;19;315
2006;"JESUITAS (PR)";"PR";"JESUITAS";216;9;19;244
2006;"JOAQUIM TAVORA (PR)";"PR";"JOAQUIM TAVORA";189;5;12;206
2006;"JUNDIAI DO SUL (PR)";"PR";"JUNDIAI DO SUL";17;2;9;28
2006;"JURANDA (PR)";"PR";"JURANDA";267;3;8;278
2006;"JUSSARA (PR)";"PR";"JUSSARA";157;4;22;183
2006;"KALORE (PR)";"PR";"KALORE";121;6;15;142
2006;"LAPA (PR)";"PR";"LAPA";985;37;122;1144
2006;"LARANJAL (PR)";"PR";"LARANJAL";26;4;13;43
2006;"LARANJEIRAS DO SUL (PR)";"PR";"LARANJEIRAS DO SUL";537;14;62;613
2006;"LEOPOLIS (PR)";"PR";"LEOPOLIS";53;3;4;60
2006;"LIDIANOPOLIS (PR)";"PR";"LIDIANOPOLIS";60;5;11;76
2006;"LINDOESTE (PR)";"PR";"LINDOESTE";71;6;10;87
2006;"LOANDA (PR)";"PR";"LOANDA";343;9;42;394
2006;"LOBATO (PR)";"PR";"LOBATO";148;4;19;171
2006;"LONDRINA (PR)";"PR";"LONDRINA";7427;530;1588;9545
2006;"LUIZIANA (PR)";"PR";"LUIZIANA";123;2;12;137
2006;"LUNARDELLI (PR)";"PR";"LUNARDELLI";80;6;5;91
2006;"LUPIONOPOLIS (PR)";"PR";"LUPIONOPOLIS";82;2;53;137
2006;"MALLET (PR)";"PR";"MALLET";260;9;30;299
2006;"MAMBORE (PR)";"PR";"MAMBORE";477;4;27;508
2006;"MANDAGUACU (PR)";"PR";"MANDAGUACU";322;5;44;371
2006;"MANDAGUARI (PR)";"PR";"MANDAGUARI";594;19;50;663
2006;"MANDIRITUBA (PR)";"PR";"MANDIRITUBA";702;14;49;765
2006;"MANFRINOPOLIS (PR)";"PR";"MANFRINOPOLIS";21;3;13;37
2006;"MANGUEIRINHA (PR)";"PR";"MANGUEIRINHA";370;9;38;417
2006;"MANOEL RIBAS (PR)";"PR";"MANOEL RIBAS";246;8;21;275
2006;"MARECHAL CANDIDO RONDON (PR)";"PR";"MARECHAL CANDIDO RONDON";1212;42;106;1360
2006;"MARIA HELENA (PR)";"PR";"MARIA HELENA";77;2;14;93
2006;"MARIALVA (PR)";"PR";"MARIALVA";682;32;41;755
2006;"MARILANDIA DO SUL (PR)";"PR";"MARILANDIA DO SUL";195;5;8;208
2006;"MARILENA (PR)";"PR";"MARILENA";97;2;33;132
2006;"MARILUZ (PR)";"PR";"MARILUZ";168;5;40;213
2006;"MARINGA (PR)";"PR";"MARINGA";6831;294;718;7843
2006;"MARIOPOLIS (PR)";"PR";"MARIOPOLIS";163;6;18;187
2006;"MARIPA (PR)";"PR";"MARIPA";240;6;12;258
2006;"MARMELEIRO (PR)";"PR";"MARMELEIRO";239;11;37;287
2006;"MARQUINHO (PR)";"PR";"MARQUINHO";44;2;7;53
2006;"MARUMBI (PR)";"PR";"MARUMBI";65;3;14;82
2006;"MATELANDIA (PR)";"PR";"MATELANDIA";336;5;34;375
2006;"MATINHOS (PR)";"PR";"MATINHOS";185;20;24;229
2006;"MATO RICO (PR)";"PR";"MATO RICO";27;1;5;33
2006;"MAUA DA SERRA (PR)";"PR";"MAUA DA SERRA";165;2;16;183
2006;"MEDIANEIRA (PR)";"PR";"MEDIANEIRA";921;31;82;1034
2006;"MERCEDES (PR)";"PR";"MERCEDES";148;5;22;175
2006;"MIRADOR (PR)";"PR";"MIRADOR";15;1;8;24
2006;"MIRASELVA (PR)";"PR";"MIRASELVA";29;5;12;46
2006;"MISSAL (PR)";"PR";"MISSAL";264;12;27;303
2006;"MOREIRA SALES (PR)";"PR";"MOREIRA SALES";153;7;47;207
2006;"MORRETES (PR)";"PR";"MORRETES";126;8;22;156
2006;"MUNHOZ DE MELLO (PR)";"PR";"MUNHOZ DE MELLO";40;3;6;49
2006;"NOSSA SENHORA DAS GRACAS (PR)";"PR";"NOSSA SENHORA DAS GRACAS";17;5;17;39
2006;"NOVA ALIANCA DO IVAI (PR)";"PR";"NOVA ALIANCA DO IVAI";14;4;2;20
2006;"NOVA AMERICA DA COLINA (PR)";"PR";"NOVA AMERICA DA COLINA";81;3;9;93
2006;"NOVA AURORA (PR)";"PR";"NOVA AURORA";352;6;26;384
2006;"NOVA CANTU (PR)";"PR";"NOVA CANTU";96;1;19;116
2006;"NOVA ESPERANCA (PR)";"PR";"NOVA ESPERANCA";684;21;36;741
2006;"NOVA ESPERANCA DO SUDOESTE (PR)";"PR";"NOVA ESPERANCA DO SUDOESTE";56;6;11;73
2006;"NOVA FATIMA (PR)";"PR";"NOVA FATIMA";195;1;20;216
2006;"NOVA LARANJEIRAS (PR)";"PR";"NOVA LARANJEIRAS";117;3;23;143
2006;"NOVA LONDRINA (PR)";"PR";"NOVA LONDRINA";339;8;32;379
2006;"NOVA OLIMPIA (PR)";"PR";"NOVA OLIMPIA";76;5;15;96
2006;"NOVA PRATA DO IGUACU (PR)";"PR";"NOVA PRATA DO IGUACU";176;3;26;205
2006;"NOVA SANTA BARBARA (PR)";"PR";"NOVA SANTA BARBARA";95;4;4;103
2006;"NOVA SANTA ROSA (PR)";"PR";"NOVA SANTA ROSA";261;5;6;272
2006;"NOVA TEBAS (PR)";"PR";"NOVA TEBAS";74;4;10;88
2006;"NOVO ITACOLOMI (PR)";"PR";"NOVO ITACOLOMI";62;2;5;69
2006;"ORTIGUEIRA (PR)";"PR";"ORTIGUEIRA";206;8;50;264
2006;"OURIZONA (PR)";"PR";"OURIZONA";59;4;19;82
2006;"OURO VERDE DO OESTE (PR)";"PR";"OURO VERDE DO OESTE";114;4;10;128
2006;"PAICANDU (PR)";"PR";"PAICANDU";376;12;35;423
2006;"PALMAS (PR)";"PR";"PALMAS";743;37;56;836
2006;"PALMEIRA (PR)";"PR";"PALMEIRA";763;33;51;847
2006;"PALMITAL (PR)";"PR";"PALMITAL";182;10;34;226
2006;"PALOTINA (PR)";"PR";"PALOTINA";953;19;80;1052
2006;"PARAISO DO NORTE (PR)";"PR";"PARAISO DO NORTE";177;9;40;226
2006;"PARANACITY (PR)";"PR";"PARANACITY";153;9;33;195
2006;"PARANAGUA (PR)";"PR";"PARANAGUA";1376;95;107;1578
2006;"PARANAPOEMA (PR)";"PR";"PARANAPOEMA";35;1;12;48
2006;"PARANAVAI (PR)";"PR";"PARANAVAI";1536;43;138;1717
2006;"PATO BRAGADO (PR)";"PR";"PATO BRAGADO";105;2;11;118
2006;"PATO BRANCO (PR)";"PR";"PATO BRANCO";1498;87;288;1873
2006;"PAULA FREITAS (PR)";"PR";"PAULA FREITAS";115;2;13;130
2006;"PAULO FRONTIN (PR)";"PR";"PAULO FRONTIN";118;1;10;129
2006;"PEABIRU (PR)";"PR";"PEABIRU";257;12;14;283
2006;"PEROBAL (PR)";"PR";"PEROBAL";81;3;27;111
2006;"PEROLA (PR)";"PR";"PEROLA";172;4;12;188
2006;"PEROLA D OESTE (PR)";"PR";"PEROLA D OESTE";116;3;24;143
2006;"PIEN (PR)";"PR";"PIEN";278;16;17;311
2006;"PINHAIS (PR)";"PR";"PINHAIS";1501;89;218;1808
2006;"PINHAL DO SAO BENTO (PR)";"PR";"PINHAL DO SAO BENTO";31;1;7;39
2006;"PINHALAO (PR)";"PR";"PINHALAO";76;1;11;88
2006;"PINHAO (PR)";"PR";"PINHAO";353;3;67;423
2006;"PIRAI DO SUL (PR)";"PR";"PIRAI DO SUL";363;18;63;444
2006;"PIRAQUARA (PR)";"PR";"PIRAQUARA";329;50;106;485
2006;"PITANGA (PR)";"PR";"PITANGA";633;22;84;739
2006;"PITANGUEIRAS (PR)";"PR";"PITANGUEIRAS";52;4;15;71
2006;"PLANALTINA DO PARANA (PR)";"PR";"PLANALTINA DO PARANA";74;3;6;83
2006;"PLANALTO (PR)";"PR";"PLANALTO";269;10;22;301
2006;"PONTA GROSSA (PR)";"PR";"PONTA GROSSA";4935;357;827;6119
2006;"PONTAL DO PARANA (PR)";"PR";"PONTAL DO PARANA";127;9;30;166
2006;"PORECATU (PR)";"PR";"PORECATU";288;12;107;407
2006;"PORTO AMAZONAS (PR)";"PR";"PORTO AMAZONAS";48;5;9;62
2006;"PORTO BARREIRO (PR)";"PR";"PORTO BARREIRO";45;2;15;62
2006;"PORTO RICO (PR)";"PR";"PORTO RICO";15;0;6;21
2006;"PORTO VITORIA (PR)";"PR";"PORTO VITORIA";135;3;8;146
2006;"PRADO FERREIRA (PR)";"PR";"PRADO FERREIRA";56;2;8;66
2006;"PRANCHITA (PR)";"PR";"PRANCHITA";183;2;10;195
2006;"PRESIDENTE CASTELO BRANCO (PR)";"PR";"PRESIDENTE CASTELO BRANCO";73;1;18;92
2006;"PRIMEIRO DE MAIO (PR)";"PR";"PRIMEIRO DE MAIO";252;11;16;279
2006;"PRUDENTOPOLIS (PR)";"PR";"PRUDENTOPOLIS";876;14;93;983
2006;"QUARTO CENTENARIO (PR)";"PR";"QUARTO CENTENARIO";114;6;10;130
2006;"QUATIGUA (PR)";"PR";"QUATIGUA";308;6;12;326
2006;"QUATRO BARRAS (PR)";"PR";"QUATRO BARRAS";505;28;121;654
2006;"QUATRO PONTES (PR)";"PR";"QUATRO PONTES";149;5;5;159
2006;"QUEDAS DO IGUACU (PR)";"PR";"QUEDAS DO IGUACU";496;11;102;609
2006;"QUERENCIA DO NORTE (PR)";"PR";"QUERENCIA DO NORTE";145;4;18;167
2006;"QUINTA DO SOL (PR)";"PR";"QUINTA DO SOL";104;3;13;120
2006;"QUITANDINHA (PR)";"PR";"QUITANDINHA";368;4;48;420
2006;"RAMILANDIA (PR)";"PR";"RAMILANDIA";39;2;8;49
2006;"RANCHO ALEGRE (PR)";"PR";"RANCHO ALEGRE";102;3;11;116
2006;"RANCHO ALEGRE D OESTE (PR)";"PR";"RANCHO ALEGRE D OESTE";68;1;6;75
2006;"REALEZA (PR)";"PR";"REALEZA";437;12;26;475
2006;"REBOUCAS (PR)";"PR";"REBOUCAS";190;7;29;226
2006;"RENASCENCA (PR)";"PR";"RENASCENCA";173;6;19;198
2006;"RESERVA (PR)";"PR";"RESERVA";400;12;40;452
2006;"RESERVA DO IGUACU (PR)";"PR";"RESERVA DO IGUACU";64;5;15;84
2006;"RIBEIRAO CLARO (PR)";"PR";"RIBEIRAO CLARO";144;19;17;180
2006;"RIBEIRAO DO PINHAL (PR)";"PR";"RIBEIRAO DO PINHAL";176;25;15;216
2006;"RIO AZUL (PR)";"PR";"RIO AZUL";211;6;30;247
2006;"RIO BOM (PR)";"PR";"RIO BOM";53;4;3;60
2006;"RIO BONITO DO IGUACU (PR)";"PR";"RIO BONITO DO IGUACU";182;5;53;240
2006;"RIO BRANCO DO IVAI (PR)";"PR";"RIO BRANCO DO IVAI";35;3;8;46
2006;"RIO BRANCO DO SUL (PR)";"PR";"RIO BRANCO DO SUL";534;50;75;659
2006;"RIO NEGRO (PR)";"PR";"RIO NEGRO";713;47;44;804
2006;"ROLANDIA (PR)";"PR";"ROLANDIA";1372;57;87;1516
2006;"RONCADOR (PR)";"PR";"RONCADOR";223;4;24;251
2006;"RONDON (PR)";"PR";"RONDON";236;7;45;288
2006;"ROSARIO DO IVAI (PR)";"PR";"ROSARIO DO IVAI";44;6;20;70
2006;"SABAUDIA (PR)";"PR";"SABAUDIA";126;5;10;141
2006;"SALGADO FILHO (PR)";"PR";"SALGADO FILHO";73;3;11;87
2006;"SALTO DO ITARARE (PR)";"PR";"SALTO DO ITARARE";77;4;16;97
2006;"SALTO DO LONTRA (PR)";"PR";"SALTO DO LONTRA";202;7;31;240
2006;"SANTA AMELIA (PR)";"PR";"SANTA AMELIA";60;5;11;76
2006;"SANTA CECILIA DO PAVAO (PR)";"PR";"SANTA CECILIA DO PAVAO";65;7;9;81
2006;"SANTA CRUZ DO MONTE CASTELO (PR)";"PR";"SANTA CRUZ DO MONTE CASTELO";166;5;15;186
2006;"SANTA FE (PR)";"PR";"SANTA FE";150;6;20;176
2006;"SANTA HELENA (PR)";"PR";"SANTA HELENA";519;25;75;619
2006;"SANTA INES (PR)";"PR";"SANTA INES";9;3;6;18
2006;"SANTA ISABEL DO IVAI (PR)";"PR";"SANTA ISABEL DO IVAI";149;7;17;173
2006;"SANTA IZABEL DO OESTE (PR)";"PR";"SANTA IZABEL DO OESTE";192;13;21;226
2006;"SANTA LUCIA (PR)";"PR";"SANTA LUCIA";71;1;7;79
2006;"SANTA MARIA DO OESTE (PR)";"PR";"SANTA MARIA DO OESTE";128;4;19;151
2006;"SANTA MARIANA (PR)";"PR";"SANTA MARIANA";262;10;30;302
2006;"SANTA MONICA (PR)";"PR";"SANTA MONICA";33;2;6;41
2006;"SANTA TEREZA DO OESTE (PR)";"PR";"SANTA TEREZA DO OESTE";141;9;10;160
2006;"SANTA TEREZINHA DE ITAIPU (PR)";"PR";"SANTA TEREZINHA DE ITAIPU";333;19;34;386
2006;"SANTANA DO ITARARE (PR)";"PR";"SANTANA DO ITARARE";80;3;14;97
2006;"SANTO ANTONIO DA PLATINA (PR)";"PR";"SANTO ANTONIO DA PLATINA";515;23;227;765
2006;"SANTO ANTONIO DO CAIUA (PR)";"PR";"SANTO ANTONIO DO CAIUA";16;2;8;26
2006;"SANTO ANTONIO DO PARAISO (PR)";"PR";"SANTO ANTONIO DO PARAISO";60;2;7;69
2006;"SANTO ANTONIO DO SUDOESTE (PR)";"PR";"SANTO ANTONIO DO SUDOESTE";288;11;33;332
2006;"SANTO INACIO (PR)";"PR";"SANTO INACIO";72;3;14;89
2006;"SAO CARLOS DO IVAI (PR)";"PR";"SAO CARLOS DO IVAI";190;8;17;215
2006;"SAO JERONIMO DA SERRA (PR)";"PR";"SAO JERONIMO DA SERRA";95;4;14;113
2006;"SAO JOAO (PR)";"PR";"SAO JOAO";267;8;34;309
2006;"SAO JOAO DO CAIUA (PR)";"PR";"SAO JOAO DO CAIUA";48;4;14;66
2006;"SAO JOAO DO IVAI (PR)";"PR";"SAO JOAO DO IVAI";235;11;34;280
2006;"SAO JOAO DO TRIUNFO (PR)";"PR";"SAO JOAO DO TRIUNFO";158;5;28;191
2006;"SAO JORGE D OESTE (PR)";"PR";"SAO JORGE D OESTE";153;8;24;185
2006;"SAO JORGE DO IVAI (PR)";"PR";"SAO JORGE DO IVAI";226;5;10;241
2006;"SAO JORGE DO PATROCINIO (PR)";"PR";"SAO JORGE DO PATROCINIO";80;5;9;94
2006;"SAO JOSE DA BOA VISTA (PR)";"PR";"SAO JOSE DA BOA VISTA";88;3;15;106
2006;"SAO JOSE DAS PALMEIRAS (PR)";"PR";"SAO JOSE DAS PALMEIRAS";53;7;8;68
2006;"SAO JOSE DOS PINHAIS (PR)";"PR";"SAO JOSE DOS PINHAIS";4822;351;480;5653
2006;"SAO MANOEL DO PARANA (PR)";"PR";"SAO MANOEL DO PARANA";33;2;6;41
2006;"SAO MATEUS DO SUL (PR)";"PR";"SAO MATEUS DO SUL";721;30;81;832
2006;"SAO MIGUEL DO IGUACU (PR)";"PR";"SAO MIGUEL DO IGUACU";679;13;71;763
2006;"SAO PEDRO DO IGUACU (PR)";"PR";"SAO PEDRO DO IGUACU";129;5;17;151
2006;"SAO PEDRO DO IVAI (PR)";"PR";"SAO PEDRO DO IVAI";236;4;40;280
2006;"SAO PEDRO DO PARANA (PR)";"PR";"SAO PEDRO DO PARANA";26;1;7;34
2006;"SAO SEBASTIAO DA AMOREIRA (PR)";"PR";"SAO SEBASTIAO DA AMOREIRA";178;5;17;200
2006;"SAO TOME (PR)";"PR";"SAO TOME";88;5;18;111
2006;"SAPOPEMA (PR)";"PR";"SAPOPEMA";57;0;8;65
2006;"SARANDI (PR)";"PR";"SARANDI";713;22;83;818
2006;"SAUDADE DO IGUACU (PR)";"PR";"SAUDADE DO IGUACU";58;8;14;80
2006;"SENGES (PR)";"PR";"SENGES";416;13;41;470
2006;"SERRANOPOLIS DO IGUACU (PR)";"PR";"SERRANOPOLIS DO IGUACU";115;12;9;136
2006;"SERTANEJA (PR)";"PR";"SERTANEJA";183;7;18;208
2006;"SERTANOPOLIS (PR)";"PR";"SERTANOPOLIS";466;9;41;516
2006;"SIQUEIRA CAMPOS (PR)";"PR";"SIQUEIRA CAMPOS";286;8;36;330
2006;"SULINA (PR)";"PR";"SULINA";66;3;12;81
2006;"TAMARANA (PR)";"PR";"TAMARANA";214;7;33;254
2006;"TAMBOARA (PR)";"PR";"TAMBOARA";62;5;4;71
2006;"TAPEJARA (PR)";"PR";"TAPEJARA";282;11;52;345
2006;"TAPIRA (PR)";"PR";"TAPIRA";111;4;6;121
2006;"TEIXEIRA SOARES (PR)";"PR";"TEIXEIRA SOARES";186;9;34;229
2006;"TELEMACO BORBA (PR)";"PR";"TELEMACO BORBA";998;146;192;1336
2006;"TERRA BOA (PR)";"PR";"TERRA BOA";263;9;44;316
2006;"TERRA RICA (PR)";"PR";"TERRA RICA";262;3;42;307
2006;"TERRA ROXA (PR)";"PR";"TERRA ROXA";379;12;27;418
2006;"TIBAGI (PR)";"PR";"TIBAGI";237;15;34;286
2006;"TIJUCAS DO SUL (PR)";"PR";"TIJUCAS DO SUL";285;6;25;316
2006;"TOLEDO (PR)";"PR";"TOLEDO";2364;142;211;2717
2006;"TOMAZINA (PR)";"PR";"TOMAZINA";63;4;14;81
2006;"TRES BARRAS DO PARANA (PR)";"PR";"TRES BARRAS DO PARANA";262;3;17;282
2006;"TUNAS DO PARANA (PR)";"PR";"TUNAS DO PARANA";79;6;16;101
2006;"TUNEIRAS DO OESTE (PR)";"PR";"TUNEIRAS DO OESTE";111;0;27;138
2006;"TUPASSI (PR)";"PR";"TUPASSI";287;6;15;308
2006;"TURVO (PR)";"PR";"TURVO";300;6;35;341
2006;"UBIRATA (PR)";"PR";"UBIRATA";533;18;38;589
2006;"UMUARAMA (PR)";"PR";"UMUARAMA";2029;42;170;2241
2006;"UNIAO DA VITORIA (PR)";"PR";"UNIAO DA VITORIA";1116;26;58;1200
2006;"UNIFLOR (PR)";"PR";"UNIFLOR";19;5;9;33
2006;"URAI (PR)";"PR";"URAI";246;19;19;284
2006;"VENTANIA (PR)";"PR";"VENTANIA";118;9;31;158
2006;"VERA CRUZ DO OESTE (PR)";"PR";"VERA CRUZ DO OESTE";214;8;10;232
2006;"VERE (PR)";"PR";"VERE";153;10;18;181
2006;"VILA ALTA (PR)";"PR";"VILA ALTA";32;6;11;49
2006;"VIRMOND (PR)";"PR";"VIRMOND";81;1;12;94
2006;"VITORINO (PR)";"PR";"VITORINO";204;5;12;221
2006;"WENCESLAU BRAZ (PR)";"PR";"WENCESLAU BRAZ";350;13;60;423
2006;"XAMBRE (PR)";"PR";"XAMBRE";71;6;6;83
2006;"ANGRA DOS REIS (RJ)";"RJ";"ANGRA DOS REIS";879;153;227;1259
2006;"APERIBE (RJ)";"RJ";"APERIBE";75;5;3;83
2006;"ARARUAMA (RJ)";"RJ";"ARARUAMA";1111;207;78;1396
2006;"AREAL (RJ)";"RJ";"AREAL";86;33;26;145
2006;"ARMACAO DE BUZIOS (RJ)";"RJ";"ARMACAO DE BUZIOS";159;154;19;332
2006;"ARRAIAL DO CABO (RJ)";"RJ";"ARRAIAL DO CABO";100;27;12;139
2006;"BARRA DO PIRAI (RJ)";"RJ";"BARRA DO PIRAI";2227;106;221;2554
2006;"BARRA MANSA (RJ)";"RJ";"BARRA MANSA";1475;95;422;1992
2006;"BELFORD ROXO (RJ)";"RJ";"BELFORD ROXO";818;202;485;1505
2006;"BOM JARDIM (RJ)";"RJ";"BOM JARDIM";343;19;26;388
2006;"BOM JESUS DO ITABAPOANA (RJ)";"RJ";"BOM JESUS DO ITABAPOANA";263;29;27;319
2006;"CABO FRIO (RJ)";"RJ";"CABO FRIO";2675;279;368;3322
2006;"CACHOEIRAS DE MACACU (RJ)";"RJ";"CACHOEIRAS DE MACACU";595;84;28;707
2006;"CAMBUCI (RJ)";"RJ";"CAMBUCI";67;6;11;84
2006;"CAMPOS DOS GOYTACAZES (RJ)";"RJ";"CAMPOS DOS GOYTACAZES";4607;340;809;5756
2006;"CANTAGALO (RJ)";"RJ";"CANTAGALO";118;19;26;163
2006;"CARAPEBUS (RJ)";"RJ";"CARAPEBUS";49;22;4;75
2006;"CARDOSO MOREIRA (RJ)";"RJ";"CARDOSO MOREIRA";124;8;22;154
2006;"CARMO (RJ)";"RJ";"CARMO";88;11;24;123
2006;"CASIMIRO DE ABREU (RJ)";"RJ";"CASIMIRO DE ABREU";466;68;26;560
2006;"COMENDADOR LEVY GASPARIAN (RJ)";"RJ";"COMENDADOR LEVY GASPARIAN";84;25;11;120
2006;"CONCEICAO DE MACABU (RJ)";"RJ";"CONCEICAO DE MACABU";150;28;50;228
2006;"CORDEIRO (RJ)";"RJ";"CORDEIRO";262;35;35;332
2006;"DUAS BARRAS (RJ)";"RJ";"DUAS BARRAS";50;12;5;67
2006;"DUQUE DE CAXIAS (RJ)";"RJ";"DUQUE DE CAXIAS";5600;678;2362;8640
2006;"ENGENHEIRO PAULO DE FRONTIN (RJ)";"RJ";"ENGENHEIRO PAULO DE FRONTIN";124;15;13;152
2006;"GUAPIMIRIM (RJ)";"RJ";"GUAPIMIRIM";223;42;29;294
2006;"IGUABA GRANDE (RJ)";"RJ";"IGUABA GRANDE";88;77;11;176
2006;"ITABORAI (RJ)";"RJ";"ITABORAI";2787;817;605;4209
2006;"ITAGUAI (RJ)";"RJ";"ITAGUAI";949;252;197;1398
2006;"ITALVA (RJ)";"RJ";"ITALVA";148;12;15;175
2006;"ITAOCARA (RJ)";"RJ";"ITAOCARA";237;26;19;282
2006;"ITAPERUNA (RJ)";"RJ";"ITAPERUNA";892;79;87;1058
2006;"ITATIAIA (RJ)";"RJ";"ITATIAIA";175;64;41;280
2006;"JAPERI (RJ)";"RJ";"JAPERI";148;24;21;193
2006;"LAJE DO MURIAE (RJ)";"RJ";"LAJE DO MURIAE";38;5;6;49
2006;"MACAE (RJ)";"RJ";"MACAE";2408;511;691;3610
2006;"MACUCO (RJ)";"RJ";"MACUCO";99;7;4;110
2006;"MAGE (RJ)";"RJ";"MAGE";837;251;135;1223
2006;"MANGARATIBA (RJ)";"RJ";"MANGARATIBA";101;85;84;270
2006;"MARICA (RJ)";"RJ";"MARICA";568;232;181;981
2006;"MENDES (RJ)";"RJ";"MENDES";201;29;16;246
2006;"MESQUITA (RJ)";"RJ";"MESQUITA";239;88;376;703
2006;"MIGUEL PEREIRA (RJ)";"RJ";"MIGUEL PEREIRA";228;46;27;301
2006;"MIRACEMA (RJ)";"RJ";"MIRACEMA";182;10;18;210
2006;"NATIVIDADE (RJ)";"RJ";"NATIVIDADE";74;11;19;104
2006;"NILOPOLIS (RJ)";"RJ";"NILOPOLIS";487;127;277;891
2006;"NITEROI (RJ)";"RJ";"NITEROI";1767;1191;1677;4635
2006;"NOVA FRIBURGO (RJ)";"RJ";"NOVA FRIBURGO";3096;170;286;3552
2006;"NOVA IGUACU (RJ)";"RJ";"NOVA IGUACU";4618;852;1362;6832
2006;"PARACAMBI (RJ)";"RJ";"PARACAMBI";152;33;71;256
2006;"PARAIBA DO SUL (RJ)";"RJ";"PARAIBA DO SUL";344;55;80;479
2006;"PARATI (RJ)";"RJ";"PARATI";140;48;35;223
2006;"PATY DO ALFERES (RJ)";"RJ";"PATY DO ALFERES";366;40;24;430
2006;"PETROPOLIS (RJ)";"RJ";"PETROPOLIS";3080;489;603;4172
2006;"PINHEIRAL (RJ)";"RJ";"PINHEIRAL";112;23;22;157
2006;"PIRAI (RJ)";"RJ";"PIRAI";405;36;47;488
2006;"PORCIUNCULA (RJ)";"RJ";"PORCIUNCULA";63;7;6;76
2006;"PORTO REAL (RJ)";"RJ";"PORTO REAL";311;22;24;357
2006;"QUATIS (RJ)";"RJ";"QUATIS";207;90;38;335
2006;"QUEIMADOS (RJ)";"RJ";"QUEIMADOS";307;201;94;602
2006;"QUISSAMA (RJ)";"RJ";"QUISSAMA";184;16;57;257
2006;"RESENDE (RJ)";"RJ";"RESENDE";841;131;258;1230
2006;"RIO BONITO (RJ)";"RJ";"RIO BONITO";3666;352;176;4194
2006;"RIO CLARO (RJ)";"RJ";"RIO CLARO";64;6;6;76
2006;"RIO DAS FLORES (RJ)";"RJ";"RIO DAS FLORES";54;11;4;69
2006;"RIO DAS OSTRAS (RJ)";"RJ";"RIO DAS OSTRAS";645;259;46;950
2006;"RIO DE JANEIRO (RJ)";"RJ";"RIO DE JANEIRO";26913;11502;11671;50086
2006;"SANTA MARIA MADALENA (RJ)";"RJ";"SANTA MARIA MADALENA";42;8;2;52
2006;"SANTO ANTONIO DE PADUA (RJ)";"RJ";"SANTO ANTONIO DE PADUA";466;63;17;546
2006;"SAO FIDELIS (RJ)";"RJ";"SAO FIDELIS";330;23;47;400
2006;"SAO FRANCISCO DE ITABAPOANA (RJ)";"RJ";"SAO FRANCISCO DE ITABAPOANA";209;24;20;253
2006;"SAO GONCALO (RJ)";"RJ";"SAO GONCALO";2193;1380;1763;5336
2006;"SAO JOAO DA BARRA (RJ)";"RJ";"SAO JOAO DA BARRA";219;22;24;265
2006;"SAO JOAO DE MERITI (RJ)";"RJ";"SAO JOAO DE MERITI";2203;324;1077;3604
2006;"SAO JOSE DE UBA (RJ)";"RJ";"SAO JOSE DE UBA";8;4;3;15
2006;"SAO JOSE DO VALE DO RIO PRETO (RJ)";"RJ";"SAO JOSE DO VALE DO RIO PRETO";475;33;14;522
2006;"SAO PEDRO DA ALDEIA (RJ)";"RJ";"SAO PEDRO DA ALDEIA";348;55;34;437
2006;"SAO SEBASTIAO DO ALTO (RJ)";"RJ";"SAO SEBASTIAO DO ALTO";59;2;2;63
2006;"SAPUCAIA (RJ)";"RJ";"SAPUCAIA";90;5;4;99
2006;"SAQUAREMA (RJ)";"RJ";"SAQUAREMA";408;75;55;538
2006;"SEROPEDICA (RJ)";"RJ";"SEROPEDICA";389;36;131;556
2006;"SILVA JARDIM (RJ)";"RJ";"SILVA JARDIM";246;32;15;293
2006;"SUMIDOURO (RJ)";"RJ";"SUMIDOURO";181;7;11;199
2006;"TANGUA (RJ)";"RJ";"TANGUA";169;13;11;193
2006;"TERESOPOLIS (RJ)";"RJ";"TERESOPOLIS";1533;170;272;1975
2006;"TRAJANO DE MORAIS (RJ)";"RJ";"TRAJANO DE MORAIS";37;3;9;49
2006;"TRES RIOS (RJ)";"RJ";"TRES RIOS";683;71;179;933
2006;"VALENCA (RJ)";"RJ";"VALENCA";243;42;46;331
2006;"VARRE SAI (RJ)";"RJ";"VARRE SAI";29;3;1;33
2006;"VASSOURAS (RJ)";"RJ";"VASSOURAS";330;38;80;448
2006;"VOLTA REDONDA (RJ)";"RJ";"VOLTA REDONDA";1865;223;469;2557
2006;"ACARI (RN)";"RN";"ACARI";71;8;4;83
2006;"AFONSO BEZERRA (RN)";"RN";"AFONSO BEZERRA";16;4;3;23
2006;"AGUA NOVA (RN)";"RN";"AGUA NOVA";3;4;1;8
2006;"ALEXANDRIA (RN)";"RN";"ALEXANDRIA";43;11;9;63
2006;"ALMINO AFONSO (RN)";"RN";"ALMINO AFONSO";8;5;0;13
2006;"ALTO DO RODRIGUES (RN)";"RN";"ALTO DO RODRIGUES";76;11;18;105
2006;"ANGICOS (RN)";"RN";"ANGICOS";75;6;9;90
2006;"ANTONIO MARTINS (RN)";"RN";"ANTONIO MARTINS";8;9;0;17
2006;"APODI (RN)";"RN";"APODI";148;11;14;173
2006;"AREIA BRANCA (RN)";"RN";"AREIA BRANCA";96;34;32;162
2006;"ARES (RN)";"RN";"ARES";75;5;11;91
2006;"ASSU (RN)";"RN";"ASSU";360;36;41;437
2006;"BAIA FORMOSA (RN)";"RN";"BAIA FORMOSA";36;0;8;44
2006;"BARAUNA (RN)";"RN";"BARAUNA";114;14;8;136
2006;"BARCELONA (RN)";"RN";"BARCELONA";19;3;1;23
2006;"BENTO FERNANDES (RN)";"RN";"BENTO FERNANDES";11;4;1;16
2006;"BOA SAUDE (RN)";"RN";"BOA SAUDE";32;6;2;40
2006;"BODO (RN)";"RN";"BODO";3;5;1;9
2006;"BOM JESUS (RN)";"RN";"BOM JESUS";44;2;3;49
2006;"BREJINHO (RN)";"RN";"BREJINHO";47;10;8;65
2006;"CAICARA DO NORTE (RN)";"RN";"CAICARA DO NORTE";8;0;1;9
2006;"CAICARA DO RIO DO VENTO (RN)";"RN";"CAICARA DO RIO DO VENTO";18;5;1;24
2006;"CAICO (RN)";"RN";"CAICO";1110;47;36;1193
2006;"CAMPO GRANDE (RN)";"RN";"CAMPO GRANDE";22;7;0;29
2006;"CAMPO REDONDO (RN)";"RN";"CAMPO REDONDO";33;5;2;40
2006;"CANGUARETAMA (RN)";"RN";"CANGUARETAMA";112;18;53;183
2006;"CARAUBAS (RN)";"RN";"CARAUBAS";99;17;5;121
2006;"CARNAUBA DOS DANTAS (RN)";"RN";"CARNAUBA DOS DANTAS";96;1;4;101
2006;"CARNAUBAIS (RN)";"RN";"CARNAUBAIS";31;17;9;57
2006;"CEARA MIRIM (RN)";"RN";"CEARA MIRIM";230;20;50;300
2006;"CERRO CORA (RN)";"RN";"CERRO CORA";58;7;3;68
2006;"CORONEL EZEQUIEL (RN)";"RN";"CORONEL EZEQUIEL";18;5;3;26
2006;"CORONEL JOAO PESSOA (RN)";"RN";"CORONEL JOAO PESSOA";8;3;0;11
2006;"CRUZETA (RN)";"RN";"CRUZETA";41;7;2;50
2006;"CURRAIS NOVOS (RN)";"RN";"CURRAIS NOVOS";486;21;36;543
2006;"DOUTOR SEVERIANO (RN)";"RN";"DOUTOR SEVERIANO";6;7;1;14
2006;"ENCANTO (RN)";"RN";"ENCANTO";10;5;1;16
2006;"EQUADOR (RN)";"RN";"EQUADOR";42;3;0;45
2006;"ESPIRITO SANTO (RN)";"RN";"ESPIRITO SANTO";13;3;8;24
2006;"ESPIRITO SANTO DO OESTE (RN)";"RN";"ESPIRITO SANTO DO OESTE";12;5;1;18
2006;"EXTREMOZ (RN)";"RN";"EXTREMOZ";38;15;46;99
2006;"FELIPE GUERRA (RN)";"RN";"FELIPE GUERRA";10;6;3;19
2006;"FERNANDO PEDROZA (RN)";"RN";"FERNANDO PEDROZA";12;3;1;16
2006;"FLORANIA (RN)";"RN";"FLORANIA";38;8;3;49
2006;"FRANCISCO DANTAS (RN)";"RN";"FRANCISCO DANTAS";5;0;1;6
2006;"FRUTUOSO GOMES (RN)";"RN";"FRUTUOSO GOMES";12;6;0;18
2006;"GALINHOS (RN)";"RN";"GALINHOS";7;3;2;12
2006;"GOIANINHA (RN)";"RN";"GOIANINHA";84;25;34;143
2006;"GOVERNADOR DIX SEPT ROSADO (RN)";"RN";"GOVERNADOR DIX SEPT ROSADO";89;8;9;106
2006;"GROSSOS (RN)";"RN";"GROSSOS";27;4;5;36
2006;"GUAMARE (RN)";"RN";"GUAMARE";35;13;17;65
2006;"IELMO MARINHO (RN)";"RN";"IELMO MARINHO";28;3;9;40
2006;"IPANGUACU (RN)";"RN";"IPANGUACU";41;10;41;92
2006;"IPUEIRA (RN)";"RN";"IPUEIRA";10;4;7;21
2006;"ITAJA (RN)";"RN";"ITAJA";47;3;4;54
2006;"ITAU (RN)";"RN";"ITAU";15;2;0;17
2006;"JACANA (RN)";"RN";"JACANA";76;16;9;101
2006;"JANDAIRA (RN)";"RN";"JANDAIRA";32;1;5;38
2006;"JANDUIS (RN)";"RN";"JANDUIS";10;1;0;11
2006;"JAPI (RN)";"RN";"JAPI";27;3;6;36
2006;"JARDIM DE ANGICOS (RN)";"RN";"JARDIM DE ANGICOS";4;0;1;5
2006;"JARDIM DE PIRANHAS (RN)";"RN";"JARDIM DE PIRANHAS";53;21;5;79
2006;"JARDIM DO SERIDO (RN)";"RN";"JARDIM DO SERIDO";120;6;45;171
2006;"JOAO CAMARA (RN)";"RN";"JOAO CAMARA";200;7;18;225
2006;"JOAO DIAS (RN)";"RN";"JOAO DIAS";2;2;0;4
2006;"JOSE DA PENHA (RN)";"RN";"JOSE DA PENHA";15;10;1;26
2006;"JUCURUTU (RN)";"RN";"JUCURUTU";93;14;5;112
2006;"JUNDIA (RN)";"RN";"JUNDIA";9;2;3;14
2006;"LAGOA DANTA (RN)";"RN";"LAGOA DANTA";22;3;9;34
2006;"LAGOA DE PEDRAS (RN)";"RN";"LAGOA DE PEDRAS";21;2;4;27
2006;"LAGOA DE VELHOS (RN)";"RN";"LAGOA DE VELHOS";9;0;0;9
2006;"LAGOA NOVA (RN)";"RN";"LAGOA NOVA";49;6;2;57
2006;"LAGOA SALGADA (RN)";"RN";"LAGOA SALGADA";40;3;4;47
2006;"LAJES (RN)";"RN";"LAJES";38;5;5;48
2006;"LAJES PINTADAS (RN)";"RN";"LAJES PINTADAS";13;5;4;22
2006;"LUCRECIA (RN)";"RN";"LUCRECIA";16;2;1;19
2006;"LUIS GOMES (RN)";"RN";"LUIS GOMES";15;9;2;26
2006;"MACAIBA (RN)";"RN";"MACAIBA";359;31;51;441
2006;"MACAU (RN)";"RN";"MACAU";104;23;36;163
2006;"MAJOR SALES (RN)";"RN";"MAJOR SALES";5;6;1;12
2006;"MARCELINO VIEIRA (RN)";"RN";"MARCELINO VIEIRA";10;7;1;18
2006;"MARTINS (RN)";"RN";"MARTINS";28;4;3;35
2006;"MAXARANGUAPE (RN)";"RN";"MAXARANGUAPE";10;5;4;19
2006;"MESSIAS TARGINO (RN)";"RN";"MESSIAS TARGINO";20;6;1;27
2006;"MONTANHAS (RN)";"RN";"MONTANHAS";25;4;9;38
2006;"MONTE ALEGRE (RN)";"RN";"MONTE ALEGRE";64;5;8;77
2006;"MONTE DAS GAMELEIRAS (RN)";"RN";"MONTE DAS GAMELEIRAS";9;3;5;17
2006;"MOSSORO (RN)";"RN";"MOSSORO";2531;168;127;2826
2006;"NATAL (RN)";"RN";"NATAL";5191;986;1732;7909
2006;"NISIA FLORESTA (RN)";"RN";"NISIA FLORESTA";53;19;51;123
2006;"NOVA CRUZ (RN)";"RN";"NOVA CRUZ";222;17;35;274
2006;"OLHO D AGUA DO BORGES (RN)";"RN";"OLHO D AGUA DO BORGES";14;4;0;18
2006;"OURO BRANCO (RN)";"RN";"OURO BRANCO";38;3;7;48
2006;"PARANA (RN)";"RN";"PARANA";7;4;1;12
2006;"PARAZINHO (RN)";"RN";"PARAZINHO";15;0;6;21
2006;"PARELHAS (RN)";"RN";"PARELHAS";220;12;19;251
2006;"PARNAMIRIM (RN)";"RN";"PARNAMIRIM";1092;236;214;1542
2006;"PASSA E FICA (RN)";"RN";"PASSA E FICA";59;15;6;80
2006;"PASSAGEM (RN)";"RN";"PASSAGEM";14;8;2;24
2006;"PATU (RN)";"RN";"PATU";58;21;2;81
2006;"PAU DOS FERROS (RN)";"RN";"PAU DOS FERROS";257;30;7;294
2006;"PEDRA GRANDE (RN)";"RN";"PEDRA GRANDE";7;2;3;12
2006;"PEDRA PRETA (RN)";"RN";"PEDRA PRETA";18;2;4;24
2006;"PEDRO AVELINO (RN)";"RN";"PEDRO AVELINO";28;1;1;30
2006;"PEDRO VELHO (RN)";"RN";"PEDRO VELHO";36;2;7;45
2006;"PENDENCIAS (RN)";"RN";"PENDENCIAS";37;6;11;54
2006;"PILOES (RN)";"RN";"PILOES";0;2;0;2
2006;"POCO BRANCO (RN)";"RN";"POCO BRANCO";25;4;4;33
2006;"PORTALEGRE (RN)";"RN";"PORTALEGRE";28;5;2;35
2006;"PORTO DO MANGUE (RN)";"RN";"PORTO DO MANGUE";28;9;2;39
2006;"PUREZA (RN)";"RN";"PUREZA";42;2;7;51
2006;"RAFAEL FERNANDES (RN)";"RN";"RAFAEL FERNANDES";11;2;0;13
2006;"RAFAEL GODEIRO (RN)";"RN";"RAFAEL GODEIRO";8;1;0;9
2006;"RIACHO DA CRUZ (RN)";"RN";"RIACHO DA CRUZ";1;2;0;3
2006;"RIACHO DE SANTANA (RN)";"RN";"RIACHO DE SANTANA";2;5;2;9
2006;"RIACHUELO (RN)";"RN";"RIACHUELO";24;2;2;28
2006;"RIO DO FOGO (RN)";"RN";"RIO DO FOGO";14;2;2;18
2006;"RODOLFO FERNANDES (RN)";"RN";"RODOLFO FERNANDES";17;5;1;23
2006;"RUY BARBOSA (RN)";"RN";"RUY BARBOSA";13;2;1;16
2006;"SANTA CRUZ (RN)";"RN";"SANTA CRUZ";278;19;18;315
2006;"SANTA MARIA (RN)";"RN";"SANTA MARIA";23;0;3;26
2006;"SANTANA DO MATOS (RN)";"RN";"SANTANA DO MATOS";55;10;1;66
2006;"SANTANA DO SERIDO (RN)";"RN";"SANTANA DO SERIDO";17;2;0;19
2006;"SANTO ANTONIO (RN)";"RN";"SANTO ANTONIO";88;23;10;121
2006;"SAO BENTO DO NORTE (RN)";"RN";"SAO BENTO DO NORTE";9;3;1;13
2006;"SAO BENTO DO TRAIRI (RN)";"RN";"SAO BENTO DO TRAIRI";14;2;2;18
2006;"SAO FERNANDO (RN)";"RN";"SAO FERNANDO";5;6;1;12
2006;"SAO FRANCISCO DO OESTE (RN)";"RN";"SAO FRANCISCO DO OESTE";8;2;2;12
2006;"SAO GONCALO DO AMARANTE (RN)";"RN";"SAO GONCALO DO AMARANTE";194;60;88;342
2006;"SAO JOAO DO SABUGI (RN)";"RN";"SAO JOAO DO SABUGI";27;11;1;39
2006;"SAO JOSE DE MIPIBU (RN)";"RN";"SAO JOSE DE MIPIBU";176;34;32;242
2006;"SAO JOSE DO CAMPESTRE (RN)";"RN";"SAO JOSE DO CAMPESTRE";54;5;8;67
2006;"SAO JOSE DO SERIDO (RN)";"RN";"SAO JOSE DO SERIDO";21;6;1;28
2006;"SAO MIGUEL (RN)";"RN";"SAO MIGUEL";104;14;13;131
2006;"SAO MIGUEL DE TOUROS (RN)";"RN";"SAO MIGUEL DE TOUROS";14;5;5;24
2006;"SAO PAULO DO POTENGI (RN)";"RN";"SAO PAULO DO POTENGI";76;5;5;86
2006;"SAO PEDRO (RN)";"RN";"SAO PEDRO";24;3;4;31
2006;"SAO RAFAEL (RN)";"RN";"SAO RAFAEL";21;10;0;31
2006;"SAO TOME (RN)";"RN";"SAO TOME";36;3;17;56
2006;"SAO VICENTE (RN)";"RN";"SAO VICENTE";34;1;1;36
2006;"SENADOR ELOI DE SOUZA (RN)";"RN";"SENADOR ELOI DE SOUZA";9;4;2;15
2006;"SENADOR GEORGINO AVELINO (RN)";"RN";"SENADOR GEORGINO AVELINO";8;1;1;10
2006;"SERRA CAIADA (RN)";"RN";"SERRA CAIADA";27;4;5;36
2006;"SERRA DE SAO BENTO (RN)";"RN";"SERRA DE SAO BENTO";17;2;2;21
2006;"SERRA DO MEL (RN)";"RN";"SERRA DO MEL";43;9;5;57
2006;"SERRA NEGRA DO NORTE (RN)";"RN";"SERRA NEGRA DO NORTE";89;11;3;103
2006;"SERRINHA (RN)";"RN";"SERRINHA";18;14;1;33
2006;"SERRINHA DOS PINTOS (RN)";"RN";"SERRINHA DOS PINTOS";24;5;1;30
2006;"SEVERIANO MELO (RN)";"RN";"SEVERIANO MELO";27;4;5;36
2006;"SITIO NOVO (RN)";"RN";"SITIO NOVO";19;3;0;22
2006;"TABOLEIRO GRANDE (RN)";"RN";"TABOLEIRO GRANDE";5;3;1;9
2006;"TAIPU (RN)";"RN";"TAIPU";35;2;5;42
2006;"TANGARA (RN)";"RN";"TANGARA";71;2;16;89
2006;"TENENTE ANANIAS (RN)";"RN";"TENENTE ANANIAS";22;6;2;30
2006;"TENENTE LAURENTINO CRUZ (RN)";"RN";"TENENTE LAURENTINO CRUZ";33;7;2;42
2006;"TIBAU (RN)";"RN";"TIBAU";15;14;6;35
2006;"TIBAU DO SUL (RN)";"RN";"TIBAU DO SUL";25;35;8;68
2006;"TIMBAUBA DOS BATISTAS (RN)";"RN";"TIMBAUBA DOS BATISTAS";12;7;2;21
2006;"TOUROS (RN)";"RN";"TOUROS";127;20;25;172
2006;"TRIUNFO POTIGUAR (RN)";"RN";"TRIUNFO POTIGUAR";12;4;0;16
2006;"UMARIZAL (RN)";"RN";"UMARIZAL";42;14;1;57
2006;"UPANEMA (RN)";"RN";"UPANEMA";28;10;6;44
2006;"VARZEA (RN)";"RN";"VARZEA";11;4;5;20
2006;"VENHA VER (RN)";"RN";"VENHA VER";14;2;0;16
2006;"VERA CRUZ (RN)";"RN";"VERA CRUZ";77;3;15;95
2006;"VICOSA (RN)";"RN";"VICOSA";4;2;0;6
2006;"VILA FLOR (RN)";"RN";"VILA FLOR";5;1;1;7
2006;"ALTA FLORESTA D OESTE (RO)";"RO";"ALTA FLORESTA D OESTE";364;7;26;397
2006;"ALTO ALEGRE DOS PARECIS (RO)";"RO";"ALTO ALEGRE DOS PARECIS";64;2;7;73
2006;"ALTO PARAISO (RO)";"RO";"ALTO PARAISO";107;4;21;132
2006;"ALVORADA D OESTE (RO)";"RO";"ALVORADA D OESTE";200;4;24;228
2006;"ARIQUEMES (RO)";"RO";"ARIQUEMES";1577;20;135;1732
2006;"BURITIS (RO)";"RO";"BURITIS";224;2;11;237
2006;"CABIXI (RO)";"RO";"CABIXI";56;1;9;66
2006;"CACAULANDIA (RO)";"RO";"CACAULANDIA";25;1;8;34
2006;"CACOAL (RO)";"RO";"CACOAL";1249;28;161;1438
2006;"CAMPO NOVO DE RONDONIA (RO)";"RO";"CAMPO NOVO DE RONDONIA";28;0;6;34
2006;"CANDEIAS DO JAMARI (RO)";"RO";"CANDEIAS DO JAMARI";73;2;5;80
2006;"CASTANHEIRAS (RO)";"RO";"CASTANHEIRAS";20;2;4;26
2006;"CEREJEIRAS (RO)";"RO";"CEREJEIRAS";289;10;28;327
2006;"CHUPINGUAIA (RO)";"RO";"CHUPINGUAIA";40;1;11;52
2006;"COLORADO DO OESTE (RO)";"RO";"COLORADO DO OESTE";317;7;24;348
2006;"CORUMBIARA (RO)";"RO";"CORUMBIARA";32;3;4;39
2006;"COSTA MARQUES (RO)";"RO";"COSTA MARQUES";35;2;3;40
2006;"CUJUBIM (RO)";"RO";"CUJUBIM";47;1;4;52
2006;"ESPIGAO D OESTE (RO)";"RO";"ESPIGAO D OESTE";379;4;48;431
2006;"GOVERNADOR JORGE TEIXEIRA (RO)";"RO";"GOVERNADOR JORGE TEIXEIRA";23;0;7;30
2006;"GUAJARA MIRIM (RO)";"RO";"GUAJARA MIRIM";389;8;11;408
2006;"JAMARI (RO)";"RO";"JAMARI";44;0;9;53
2006;"JARU (RO)";"RO";"JARU";826;18;108;952
2006;"JI PARANA (RO)";"RO";"JI PARANA";2078;50;482;2610
2006;"MACHADINHO D OESTE (RO)";"RO";"MACHADINHO D OESTE";186;2;31;219
2006;"MINISTRO ANDREAZZA (RO)";"RO";"MINISTRO ANDREAZZA";98;1;9;108
2006;"MIRANTE DA SERRA (RO)";"RO";"MIRANTE DA SERRA";124;1;12;137
2006;"MONTE NEGRO (RO)";"RO";"MONTE NEGRO";161;2;33;196
2006;"NOVA BRASILANDIA D OESTE (RO)";"RO";"NOVA BRASILANDIA D OESTE";186;5;20;211
2006;"NOVA UNIAO (RO)";"RO";"NOVA UNIAO";17;1;3;21
2006;"NOVO HORIZONTE DO OESTE (RO)";"RO";"NOVO HORIZONTE DO OESTE";50;1;7;58
2006;"OURO PRETO DO OESTE (RO)";"RO";"OURO PRETO DO OESTE";654;20;87;761
2006;"PARECIS (RO)";"RO";"PARECIS";14;0;6;20
2006;"PIMENTA BUENO (RO)";"RO";"PIMENTA BUENO";738;17;46;801
2006;"PIMENTEIRAS DO OESTE (RO)";"RO";"PIMENTEIRAS DO OESTE";9;0;8;17
2006;"PORTO VELHO (RO)";"RO";"PORTO VELHO";3336;193;604;4133
2006;"PRESIDENTE MEDICI (RO)";"RO";"PRESIDENTE MEDICI";197;1;28;226
2006;"PRIMAVERA DE RONDONIA (RO)";"RO";"PRIMAVERA DE RONDONIA";27;1;5;33
2006;"RIO CRESPO (RO)";"RO";"RIO CRESPO";31;1;11;43
2006;"ROLIM DE MOURA (RO)";"RO";"ROLIM DE MOURA";957;22;65;1044
2006;"SANTA LUZIA D OESTE (RO)";"RO";"SANTA LUZIA D OESTE";82;2;29;113
2006;"SAO FELIPE D OESTE (RO)";"RO";"SAO FELIPE D OESTE";29;1;12;42
2006;"SAO FRANCISCO DO GUAPORE (RO)";"RO";"SAO FRANCISCO DO GUAPORE";118;1;12;131
2006;"SAO MIGUEL DO GUAPORE (RO)";"RO";"SAO MIGUEL DO GUAPORE";158;3;16;177
2006;"SERINGUEIRAS (RO)";"RO";"SERINGUEIRAS";50;3;8;61
2006;"TEIXEIROPOLIS (RO)";"RO";"TEIXEIROPOLIS";11;0;5;16
2006;"THEOBROMA (RO)";"RO";"THEOBROMA";22;0;14;36
2006;"URUPA (RO)";"RO";"URUPA";82;1;23;106
2006;"VALE DO ANARI (RO)";"RO";"VALE DO ANARI";24;1;1;26
2006;"VALE DO PARAISO (RO)";"RO";"VALE DO PARAISO";31;0;2;33
2006;"VILA NOVA DO MAMORE (RO)";"RO";"VILA NOVA DO MAMORE";85;1;8;94
2006;"VILHENA (RO)";"RO";"VILHENA";1029;26;104;1159
2006;"ALTO ALEGRE (RR)";"RR";"ALTO ALEGRE";20;1;5;26
2006;"AMAJARI (RR)";"RR";"AMAJARI";7;2;0;9
2006;"BOA VISTA (RR)";"RR";"BOA VISTA";2196;204;366;2766
2006;"BONFIM (RR)";"RR";"BONFIM";6;0;0;6
2006;"CANTA (RR)";"RR";"CANTA";11;0;4;15
2006;"CARACARAI (RR)";"RR";"CARACARAI";36;4;0;40
2006;"CAROEBE (RR)";"RR";"CAROEBE";17;2;6;25
2006;"IRACEMA (RR)";"RR";"IRACEMA";6;5;0;11
2006;"MUCAJAI (RR)";"RR";"MUCAJAI";55;22;10;87
2006;"NORMANDIA (RR)";"RR";"NORMANDIA";7;0;0;7
2006;"PACARAIMA (RR)";"RR";"PACARAIMA";23;0;1;24
2006;"RORAINOPOLIS (RR)";"RR";"RORAINOPOLIS";40;5;4;49
2006;"SAO JOAO DA BALIZA (RR)";"RR";"SAO JOAO DA BALIZA";18;3;1;22
2006;"SAO LUIZ (RR)";"RR";"SAO LUIZ";22;2;0;24
2006;"UIRAMUTA (RR)";"RR";"UIRAMUTA";1;0;0;1
2006;"ACEGUA (RS)";"RS";"ACEGUA";51;11;10;72
2006;"AGUA SANTA (RS)";"RS";"AGUA SANTA";115;3;14;132
2006;"AGUDO (RS)";"RS";"AGUDO";256;8;50;314
2006;"AJURICABA (RS)";"RS";"AJURICABA";290;8;26;324
2006;"ALECRIM (RS)";"RS";"ALECRIM";74;6;21;101
2006;"ALEGRETE (RS)";"RS";"ALEGRETE";832;33;157;1022
2006;"ALEGRIA (RS)";"RS";"ALEGRIA";70;3;13;86
2006;"ALMIRANTE TAMANDARE DO SUL (RS)";"RS";"ALMIRANTE TAMANDARE DO SUL";66;5;5;76
2006;"ALPESTRE (RS)";"RS";"ALPESTRE";101;17;25;143
2006;"ALTO ALEGRE (RS)";"RS";"ALTO ALEGRE";61;3;9;73
2006;"ALTO FELIZ (RS)";"RS";"ALTO FELIZ";79;7;10;96
2006;"ALVORADA (RS)";"RS";"ALVORADA";1107;104;479;1690
2006;"AMARAL FERRADOR (RS)";"RS";"AMARAL FERRADOR";115;7;15;137
2006;"AMETISTA DO SUL (RS)";"RS";"AMETISTA DO SUL";43;0;18;61
2006;"ANDRE DA ROCHA (RS)";"RS";"ANDRE DA ROCHA";43;3;3;49
2006;"ANTA GORDA (RS)";"RS";"ANTA GORDA";169;11;21;201
2006;"ANTONIO PRADO (RS)";"RS";"ANTONIO PRADO";567;21;42;630
2006;"ARAMBARE (RS)";"RS";"ARAMBARE";33;2;6;41
2006;"ARARICA (RS)";"RS";"ARARICA";53;8;5;66
2006;"ARATIBA (RS)";"RS";"ARATIBA";131;22;24;177
2006;"ARROIO DO MEIO (RS)";"RS";"ARROIO DO MEIO";366;15;44;425
2006;"ARROIO DO PADRE (RS)";"RS";"ARROIO DO PADRE";78;9;9;96
2006;"ARROIO DO SAL (RS)";"RS";"ARROIO DO SAL";64;8;9;81
2006;"ARROIO DO TIGRE (RS)";"RS";"ARROIO DO TIGRE";245;19;30;294
2006;"ARROIO DOS RATOS (RS)";"RS";"ARROIO DOS RATOS";166;5;54;225
2006;"ARROIO GRANDE (RS)";"RS";"ARROIO GRANDE";194;15;34;243
2006;"ARVOREZINHA (RS)";"RS";"ARVOREZINHA";348;38;26;412
2006;"AUGUSTO PESTANA (RS)";"RS";"AUGUSTO PESTANA";302;11;21;334
2006;"AUREA (RS)";"RS";"AUREA";85;5;6;96
2006;"BAGE (RS)";"RS";"BAGE";973;112;222;1307
2006;"BALNEARIO PINHAL (RS)";"RS";"BALNEARIO PINHAL";82;7;8;97
2006;"BARAO (RS)";"RS";"BARAO";143;17;31;191
2006;"BARAO DE COTEGIPE (RS)";"RS";"BARAO DE COTEGIPE";168;11;16;195
2006;"BARAO DO TRIUNFO (RS)";"RS";"BARAO DO TRIUNFO";117;12;24;153
2006;"BARRA DO GUARITA (RS)";"RS";"BARRA DO GUARITA";16;2;4;22
2006;"BARRA DO QUARAI (RS)";"RS";"BARRA DO QUARAI";28;3;12;43
2006;"BARRA DO RIBEIRO (RS)";"RS";"BARRA DO RIBEIRO";147;5;46;198
2006;"BARRA DO RIO AZUL (RS)";"RS";"BARRA DO RIO AZUL";34;8;8;50
2006;"BARRA FUNDA (RS)";"RS";"BARRA FUNDA";128;3;8;139
2006;"BARRACAO (RS)";"RS";"BARRACAO";100;7;11;118
2006;"BARROS CASSAL (RS)";"RS";"BARROS CASSAL";131;5;31;167
2006;"BENJAMIN CONSTANT DO SUL (RS)";"RS";"BENJAMIN CONSTANT DO SUL";22;4;4;30
2006;"BENTO GONCALVES (RS)";"RS";"BENTO GONCALVES";2849;183;273;3305
2006;"BOA VISTA DAS MISSOES (RS)";"RS";"BOA VISTA DAS MISSOES";77;4;8;89
2006;"BOA VISTA DO BURICA (RS)";"RS";"BOA VISTA DO BURICA";161;9;20;190
2006;"BOA VISTA DO CADEADO (RS)";"RS";"BOA VISTA DO CADEADO";36;4;16;56
2006;"BOA VISTA DO INCRA (RS)";"RS";"BOA VISTA DO INCRA";42;2;7;51
2006;"BOA VISTA DO SUL (RS)";"RS";"BOA VISTA DO SUL";282;5;7;294
2006;"BOM JESUS (RS)";"RS";"BOM JESUS";215;11;29;255
2006;"BOM PRINCIPIO (RS)";"RS";"BOM PRINCIPIO";320;24;32;376
2006;"BOM PROGRESSO (RS)";"RS";"BOM PROGRESSO";32;4;4;40
2006;"BOM RETIRO DO SUL (RS)";"RS";"BOM RETIRO DO SUL";136;8;23;167
2006;"BOQUEIRAO DO LEAO (RS)";"RS";"BOQUEIRAO DO LEAO";139;6;17;162
2006;"BOSSOROCA (RS)";"RS";"BOSSOROCA";141;5;12;158
2006;"BOZANO (RS)";"RS";"BOZANO";96;2;8;106
2006;"BRAGA (RS)";"RS";"BRAGA";53;0;8;61
2006;"BROCHIER (RS)";"RS";"BROCHIER";201;13;21;235
2006;"BUTIA (RS)";"RS";"BUTIA";261;9;78;348
2006;"CACAPAVA DO SUL (RS)";"RS";"CACAPAVA DO SUL";502;23;87;612
2006;"CACEQUI (RS)";"RS";"CACEQUI";117;9;20;146
2006;"CACHOEIRA DO SUL (RS)";"RS";"CACHOEIRA DO SUL";939;48;198;1185
2006;"CACHOEIRINHA (RS)";"RS";"CACHOEIRINHA";1735;170;339;2244
2006;"CACIQUE DOBLE (RS)";"RS";"CACIQUE DOBLE";75;3;9;87
2006;"CAIBATE (RS)";"RS";"CAIBATE";107;6;3;116
2006;"CAICARA (RS)";"RS";"CAICARA";64;6;15;85
2006;"CAMAQUA (RS)";"RS";"CAMAQUA";1182;36;182;1400
2006;"CAMARGO (RS)";"RS";"CAMARGO";90;5;11;106
2006;"CAMBARA DO SUL (RS)";"RS";"CAMBARA DO SUL";267;14;28;309
2006;"CAMPESTRE DA SERRA (RS)";"RS";"CAMPESTRE DA SERRA";132;6;7;145
2006;"CAMPINA DAS MISSOES (RS)";"RS";"CAMPINA DAS MISSOES";105;9;24;138
2006;"CAMPINAS DO SUL (RS)";"RS";"CAMPINAS DO SUL";176;13;22;211
2006;"CAMPO BOM (RS)";"RS";"CAMPO BOM";588;84;113;785
2006;"CAMPO NOVO (RS)";"RS";"CAMPO NOVO";133;8;15;156
2006;"CAMPOS BORGES (RS)";"RS";"CAMPOS BORGES";88;7;11;106
2006;"CANDELARIA (RS)";"RS";"CANDELARIA";320;16;66;402
2006;"CANDIDO GODOI (RS)";"RS";"CANDIDO GODOI";161;16;15;192
2006;"CANDIOTA (RS)";"RS";"CANDIOTA";94;20;25;139
2006;"CANELA (RS)";"RS";"CANELA";475;57;102;634
2006;"CANGUCU (RS)";"RS";"CANGUCU";896;30;119;1045
2006;"CANOAS (RS)";"RS";"CANOAS";3427;310;914;4651
2006;"CANUDOS DO VALE (RS)";"RS";"CANUDOS DO VALE";19;7;1;27
2006;"CAPAO BONITO DO SUL (RS)";"RS";"CAPAO BONITO DO SUL";24;2;3;29
2006;"CAPAO DA CANOA (RS)";"RS";"CAPAO DA CANOA";351;68;77;496
2006;"CAPAO DO CIPO (RS)";"RS";"CAPAO DO CIPO";44;4;5;53
2006;"CAPAO DO LEAO (RS)";"RS";"CAPAO DO LEAO";210;11;24;245
2006;"CAPELA DE SANTANA (RS)";"RS";"CAPELA DE SANTANA";85;7;27;119
2006;"CAPITAO (RS)";"RS";"CAPITAO";47;7;7;61
2006;"CAPIVARI DO SUL (RS)";"RS";"CAPIVARI DO SUL";88;7;4;99
2006;"CARAA (RS)";"RS";"CARAA";76;1;12;89
2006;"CARAZINHO (RS)";"RS";"CARAZINHO";1203;53;195;1451
2006;"CARLOS BARBOSA (RS)";"RS";"CARLOS BARBOSA";588;42;80;710
2006;"CARLOS GOMES (RS)";"RS";"CARLOS GOMES";22;2;6;30
2006;"CASCA (RS)";"RS";"CASCA";326;10;11;347
2006;"CASEIROS (RS)";"RS";"CASEIROS";103;7;12;122
2006;"CATUIPE (RS)";"RS";"CATUIPE";279;6;19;304
2006;"CAXIAS DO SUL (RS)";"RS";"CAXIAS DO SUL";6931;1043;1228;9202
2006;"CENTENARIO (RS)";"RS";"CENTENARIO";78;7;2;87
2006;"CERRITO (RS)";"RS";"CERRITO";96;2;8;106
2006;"CERRO BRANCO (RS)";"RS";"CERRO BRANCO";57;5;14;76
2006;"CERRO GRANDE (RS)";"RS";"CERRO GRANDE";39;1;8;48
2006;"CERRO GRANDE DO SUL (RS)";"RS";"CERRO GRANDE DO SUL";199;14;17;230
2006;"CERRO LARGO (RS)";"RS";"CERRO LARGO";246;10;40;296
2006;"CHAPADA (RS)";"RS";"CHAPADA";267;30;24;321
2006;"CHARQUEADAS (RS)";"RS";"CHARQUEADAS";268;54;61;383
2006;"CHARRUA (RS)";"RS";"CHARRUA";74;1;10;85
2006;"CHIAPETTA (RS)";"RS";"CHIAPETTA";108;5;11;124
2006;"CHUI (RS)";"RS";"CHUI";139;11;13;163
2006;"CHUVISCA (RS)";"RS";"CHUVISCA";89;2;22;113
2006;"CIDREIRA (RS)";"RS";"CIDREIRA";72;8;17;97
2006;"CIRIACO (RS)";"RS";"CIRIACO";109;12;18;139
2006;"COLINAS (RS)";"RS";"COLINAS";53;6;12;71
2006;"COLORADO (RS)";"RS";"COLORADO";184;12;13;209
2006;"CONDOR (RS)";"RS";"CONDOR";175;6;20;201
2006;"CONSTANTINA (RS)";"RS";"CONSTANTINA";226;11;65;302
2006;"COQUEIRO BAIXO (RS)";"RS";"COQUEIRO BAIXO";13;8;2;23
2006;"COQUEIROS DO SUL (RS)";"RS";"COQUEIROS DO SUL";85;5;10;100
2006;"CORONEL BARROS (RS)";"RS";"CORONEL BARROS";72;1;9;82
2006;"CORONEL BICACO (RS)";"RS";"CORONEL BICACO";146;14;13;173
2006;"CORONEL PILAR (RS)";"RS";"CORONEL PILAR";159;3;9;171
2006;"COTIPORA (RS)";"RS";"COTIPORA";148;9;9;166
2006;"COXILHA (RS)";"RS";"COXILHA";85;4;7;96
2006;"CRISSIUMAL (RS)";"RS";"CRISSIUMAL";238;16;46;300
2006;"CRISTAL (RS)";"RS";"CRISTAL";147;4;21;172
2006;"CRISTAL DO SUL (RS)";"RS";"CRISTAL DO SUL";14;1;12;27
2006;"CRUZ ALTA (RS)";"RS";"CRUZ ALTA";1109;56;113;1278
2006;"CRUZALTENSE (RS)";"RS";"CRUZALTENSE";50;2;8;60
2006;"CRUZEIRO DO SUL (RS)";"RS";"CRUZEIRO DO SUL";249;8;14;271
2006;"DAVID CANABARRO (RS)";"RS";"DAVID CANABARRO";143;7;21;171
2006;"DERRUBADAS (RS)";"RS";"DERRUBADAS";60;10;1;71
2006;"DEZESSEIS DE NOVEMBRO (RS)";"RS";"DEZESSEIS DE NOVEMBRO";43;3;5;51
2006;"DILERMANDO DE AGUIAR (RS)";"RS";"DILERMANDO DE AGUIAR";27;1;19;47
2006;"DOIS IRMAOS (RS)";"RS";"DOIS IRMAOS";353;17;114;484
2006;"DOIS IRMAOS DAS MISSOES (RS)";"RS";"DOIS IRMAOS DAS MISSOES";36;3;4;43
2006;"DOIS LAJEADOS (RS)";"RS";"DOIS LAJEADOS";97;3;10;110
2006;"DOM FELICIANO (RS)";"RS";"DOM FELICIANO";210;11;61;282
2006;"DOM PEDRITO (RS)";"RS";"DOM PEDRITO";499;24;26;549
2006;"DOM PEDRO DE ALCANTARA (RS)";"RS";"DOM PEDRO DE ALCANTARA";67;4;5;76
2006;"DONA FRANCISCA (RS)";"RS";"DONA FRANCISCA";35;1;6;42
2006;"DOUTOR MAURICIO CARDOSO (RS)";"RS";"DOUTOR MAURICIO CARDOSO";143;17;17;177
2006;"DOUTOR RICARDO (RS)";"RS";"DOUTOR RICARDO";46;3;7;56
2006;"ELDORADO DO SUL (RS)";"RS";"ELDORADO DO SUL";333;17;35;385
2006;"ENCANTADO (RS)";"RS";"ENCANTADO";489;30;95;614
2006;"ENCRUZILHADA DO SUL (RS)";"RS";"ENCRUZILHADA DO SUL";284;12;97;393
2006;"ENGENHO VELHO (RS)";"RS";"ENGENHO VELHO";21;3;8;32
2006;"ENTRE IJUIS (RS)";"RS";"ENTRE IJUIS";223;12;34;269
2006;"ENTRE RIOS DO SUL (RS)";"RS";"ENTRE RIOS DO SUL";39;9;11;59
2006;"EREBANGO (RS)";"RS";"EREBANGO";94;2;5;101
2006;"ERECHIM (RS)";"RS";"ERECHIM";1490;174;588;2252
2006;"ERNESTINA (RS)";"RS";"ERNESTINA";124;10;12;146
2006;"ERVAL GRANDE (RS)";"RS";"ERVAL GRANDE";85;13;11;109
2006;"ERVAL SECO (RS)";"RS";"ERVAL SECO";120;4;25;149
2006;"ESMERALDA (RS)";"RS";"ESMERALDA";60;2;11;73
2006;"ESPERANCA DO SUL (RS)";"RS";"ESPERANCA DO SUL";38;2;9;49
2006;"ESPUMOSO (RS)";"RS";"ESPUMOSO";510;27;60;597
2006;"ESTACAO (RS)";"RS";"ESTACAO";165;10;4;179
2006;"ESTANCIA VELHA (RS)";"RS";"ESTANCIA VELHA";651;56;128;835
2006;"ESTEIO (RS)";"RS";"ESTEIO";1035;104;214;1353
2006;"ESTRELA (RS)";"RS";"ESTRELA";664;39;84;787
2006;"ESTRELA VELHA (RS)";"RS";"ESTRELA VELHA";81;5;9;95
2006;"EUGENIO DE CASTRO (RS)";"RS";"EUGENIO DE CASTRO";82;6;6;94
2006;"FAGUNDES VARELA (RS)";"RS";"FAGUNDES VARELA";77;4;11;92
2006;"FARROUPILHA (RS)";"RS";"FARROUPILHA";1771;185;179;2135
2006;"FAXINAL DO SOTURNO (RS)";"RS";"FAXINAL DO SOTURNO";101;7;6;114
2006;"FAXINALZINHO (RS)";"RS";"FAXINALZINHO";48;5;9;62
2006;"FAZENDA VILANOVA (RS)";"RS";"FAZENDA VILANOVA";101;11;9;121
2006;"FELIZ (RS)";"RS";"FELIZ";353;22;76;451
2006;"FLORES DA CUNHA (RS)";"RS";"FLORES DA CUNHA";1197;52;89;1338
2006;"FLORIANO PEIXOTO (RS)";"RS";"FLORIANO PEIXOTO";47;8;10;65
2006;"FONTOURA XAVIER (RS)";"RS";"FONTOURA XAVIER";142;9;29;180
2006;"FORMIGUEIRO (RS)";"RS";"FORMIGUEIRO";91;3;18;112
2006;"FORQUETINHA (RS)";"RS";"FORQUETINHA";38;2;2;42
2006;"FORTALEZA DOS VALOS (RS)";"RS";"FORTALEZA DOS VALOS";230;1;13;244
2006;"FREDERICO WESTPHALEN (RS)";"RS";"FREDERICO WESTPHALEN";536;27;62;625
2006;"GARIBALDI (RS)";"RS";"GARIBALDI";1140;65;83;1288
2006;"GARRUCHOS (RS)";"RS";"GARRUCHOS";22;5;9;36
2006;"GAURAMA (RS)";"RS";"GAURAMA";151;11;9;171
2006;"GENERAL CAMARA (RS)";"RS";"GENERAL CAMARA";69;9;17;95
2006;"GENTIL (RS)";"RS";"GENTIL";81;5;12;98
2006;"GETULIO VARGAS (RS)";"RS";"GETULIO VARGAS";430;20;27;477
2006;"GIRUA (RS)";"RS";"GIRUA";430;21;36;487
2006;"GLORINHA (RS)";"RS";"GLORINHA";153;15;6;174
2006;"GRAMADO (RS)";"RS";"GRAMADO";585;95;92;772
2006;"GRAMADO DOS LOUREIROS (RS)";"RS";"GRAMADO DOS LOUREIROS";19;2;9;30
2006;"GRAMADO XAVIER (RS)";"RS";"GRAMADO XAVIER";51;3;7;61
2006;"GRAVATAI (RS)";"RS";"GRAVATAI";2515;335;470;3320
2006;"GUABIJU (RS)";"RS";"GUABIJU";41;5;7;53
2006;"GUAIBA (RS)";"RS";"GUAIBA";911;101;364;1376
2006;"GUAPORE (RS)";"RS";"GUAPORE";333;29;47;409
2006;"GUARANI DAS MISSOES (RS)";"RS";"GUARANI DAS MISSOES";167;4;15;186
2006;"HARMONIA (RS)";"RS";"HARMONIA";187;4;9;200
2006;"HERVAL (RS)";"RS";"HERVAL";86;2;7;95
2006;"HERVEIRAS (RS)";"RS";"HERVEIRAS";41;3;2;46
2006;"HORIZONTINA (RS)";"RS";"HORIZONTINA";288;31;53;372
2006;"HULHA NEGRA (RS)";"RS";"HULHA NEGRA";25;8;15;48
2006;"HUMAITA (RS)";"RS";"HUMAITA";86;2;8;96
2006;"IBARAMA (RS)";"RS";"IBARAMA";83;2;14;99
2006;"IBIACA (RS)";"RS";"IBIACA";217;5;15;237
2006;"IBIRAIARAS (RS)";"RS";"IBIRAIARAS";377;4;20;401
2006;"IBIRAPUITA (RS)";"RS";"IBIRAPUITA";99;3;18;120
2006;"IBIRUBA (RS)";"RS";"IBIRUBA";747;28;57;832
2006;"IGREJINHA (RS)";"RS";"IGREJINHA";323;28;71;422
2006;"IJUI (RS)";"RS";"IJUI";1578;83;118;1779
2006;"ILOPOLIS (RS)";"RS";"ILOPOLIS";129;13;6;148
2006;"IMBE (RS)";"RS";"IMBE";164;16;40;220
2006;"IMIGRANTE (RS)";"RS";"IMIGRANTE";80;12;21;113
2006;"INDEPENDENCIA (RS)";"RS";"INDEPENDENCIA";152;17;29;198
2006;"INHACORA (RS)";"RS";"INHACORA";53;6;5;64
2006;"IPE (RS)";"RS";"IPE";209;16;24;249
2006;"IPIRANGA DO SUL (RS)";"RS";"IPIRANGA DO SUL";88;5;7;100
2006;"IRAI (RS)";"RS";"IRAI";92;11;17;120
2006;"ITAARA (RS)";"RS";"ITAARA";110;2;8;120
2006;"ITACURUBI (RS)";"RS";"ITACURUBI";25;7;8;40
2006;"ITAPUCA (RS)";"RS";"ITAPUCA";33;4;7;44
2006;"ITAQUI (RS)";"RS";"ITAQUI";550;12;53;615
2006;"ITATI (RS)";"RS";"ITATI";48;3;4;55
2006;"ITATIBA DO SUL (RS)";"RS";"ITATIBA DO SUL";72;10;5;87
2006;"IVORA (RS)";"RS";"IVORA";54;4;3;61
2006;"IVOTI (RS)";"RS";"IVOTI";448;34;92;574
2006;"JABOTICABA (RS)";"RS";"JABOTICABA";45;4;15;64
2006;"JACUIZINHO (RS)";"RS";"JACUIZINHO";29;4;5;38
2006;"JACUTINGA (RS)";"RS";"JACUTINGA";101;13;7;121
2006;"JAGUARAO (RS)";"RS";"JAGUARAO";280;13;29;322
2006;"JAGUARI (RS)";"RS";"JAGUARI";200;19;44;263
2006;"JAQUIRANA (RS)";"RS";"JAQUIRANA";136;3;8;147
2006;"JARI (RS)";"RS";"JARI";37;2;9;48
2006;"JOIA (RS)";"RS";"JOIA";245;7;26;278
2006;"JULIO DE CASTILHOS (RS)";"RS";"JULIO DE CASTILHOS";498;14;46;558
2006;"LAGOA BONITA DO SUL (RS)";"RS";"LAGOA BONITA DO SUL";38;3;20;61
2006;"LAGOA DOS TRES CANTOS (RS)";"RS";"LAGOA DOS TRES CANTOS";63;7;5;75
2006;"LAGOA VERMELHA (RS)";"RS";"LAGOA VERMELHA";535;25;69;629
2006;"LAGOAO (RS)";"RS";"LAGOAO";52;2;22;76
2006;"LAJEADO (RS)";"RS";"LAJEADO";1615;108;243;1966
2006;"LAJEADO DO BUGRE (RS)";"RS";"LAJEADO DO BUGRE";21;1;6;28
2006;"LAVRAS DO SUL (RS)";"RS";"LAVRAS DO SUL";66;12;18;96
2006;"LIBERATO SALZANO (RS)";"RS";"LIBERATO SALZANO";87;7;18;112
2006;"LINDOLFO COLLOR (RS)";"RS";"LINDOLFO COLLOR";90;13;16;119
2006;"LINHA NOVA (RS)";"RS";"LINHA NOVA";55;6;5;66
2006;"MACAMBARA (RS)";"RS";"MACAMBARA";28;3;18;49
2006;"MACHADINHO (RS)";"RS";"MACHADINHO";88;5;15;108
2006;"MAMPITUBA (RS)";"RS";"MAMPITUBA";19;0;5;24
2006;"MANOEL VIANA (RS)";"RS";"MANOEL VIANA";132;5;8;145
2006;"MAQUINE (RS)";"RS";"MAQUINE";222;12;9;243
2006;"MARATA (RS)";"RS";"MARATA";83;8;25;116
2006;"MARAU (RS)";"RS";"MARAU";798;56;124;978
2006;"MARCELINO RAMOS (RS)";"RS";"MARCELINO RAMOS";104;17;15;136
2006;"MARIANA PIMENTEL (RS)";"RS";"MARIANA PIMENTEL";85;3;18;106
2006;"MARIANO MORO (RS)";"RS";"MARIANO MORO";57;11;5;73
2006;"MARQUES DE SOUZA (RS)";"RS";"MARQUES DE SOUZA";102;15;15;132
2006;"MATA (RS)";"RS";"MATA";77;3;16;96
2006;"MATO CASTELHANO (RS)";"RS";"MATO CASTELHANO";102;6;20;128
2006;"MATO LEITAO (RS)";"RS";"MATO LEITAO";231;4;8;243
2006;"MATO QUEIMADO (RS)";"RS";"MATO QUEIMADO";33;2;7;42
2006;"MAXIMILIANO DE ALMEIDA (RS)";"RS";"MAXIMILIANO DE ALMEIDA";128;7;41;176
2006;"MINAS DO LEAO (RS)";"RS";"MINAS DO LEAO";87;14;21;122
2006;"MIRAGUAI (RS)";"RS";"MIRAGUAI";55;3;14;72
2006;"MONTAURI (RS)";"RS";"MONTAURI";49;6;3;58
2006;"MONTE ALEGRE DOS CAMPOS (RS)";"RS";"MONTE ALEGRE DOS CAMPOS";52;4;21;77
2006;"MONTE BELO DO SUL (RS)";"RS";"MONTE BELO DO SUL";187;6;13;206
2006;"MONTENEGRO (RS)";"RS";"MONTENEGRO";1090;121;215;1426
2006;"MORMACO (RS)";"RS";"MORMACO";53;4;8;65
2006;"MORRINHOS DO SUL (RS)";"RS";"MORRINHOS DO SUL";121;2;6;129
2006;"MORRO REDONDO (RS)";"RS";"MORRO REDONDO";187;5;19;211
2006;"MORRO REUTER (RS)";"RS";"MORRO REUTER";122;10;28;160
2006;"MOSTARDAS (RS)";"RS";"MOSTARDAS";204;8;39;251
2006;"MUCUM (RS)";"RS";"MUCUM";86;11;23;120
2006;"MUITOS CAPOES (RS)";"RS";"MUITOS CAPOES";38;2;3;43
2006;"MULITERNO (RS)";"RS";"MULITERNO";71;4;5;80
2006;"NAO ME TOQUE (RS)";"RS";"NAO ME TOQUE";435;20;45;500
2006;"NICOLAU VERGUEIRO (RS)";"RS";"NICOLAU VERGUEIRO";67;4;10;81
2006;"NONOAI (RS)";"RS";"NONOAI";170;12;34;216
2006;"NOVA ALVORADA (RS)";"RS";"NOVA ALVORADA";105;3;7;115
2006;"NOVA ARACA (RS)";"RS";"NOVA ARACA";144;15;21;180
2006;"NOVA BASSANO (RS)";"RS";"NOVA BASSANO";368;21;26;415
2006;"NOVA BOA VISTA (RS)";"RS";"NOVA BOA VISTA";48;9;11;68
2006;"NOVA BRESCIA (RS)";"RS";"NOVA BRESCIA";85;14;6;105
2006;"NOVA CANDELARIA (RS)";"RS";"NOVA CANDELARIA";59;6;7;72
2006;"NOVA ESPERANCA DO SUL (RS)";"RS";"NOVA ESPERANCA DO SUL";46;11;22;79
2006;"NOVA HARTZ (RS)";"RS";"NOVA HARTZ";102;14;52;168
2006;"NOVA PADUA (RS)";"RS";"NOVA PADUA";253;4;6;263
2006;"NOVA PALMA (RS)";"RS";"NOVA PALMA";183;11;19;213
2006;"NOVA PETROPOLIS (RS)";"RS";"NOVA PETROPOLIS";446;41;73;560
2006;"NOVA PRATA (RS)";"RS";"NOVA PRATA";511;24;45;580
2006;"NOVA RAMADA (RS)";"RS";"NOVA RAMADA";74;3;7;84
2006;"NOVA ROMA DO SUL (RS)";"RS";"NOVA ROMA DO SUL";200;10;17;227
2006;"NOVA SANTA RITA (RS)";"RS";"NOVA SANTA RITA";433;41;38;512
2006;"NOVO BARREIRO (RS)";"RS";"NOVO BARREIRO";78;10;11;99
2006;"NOVO CABRAIS (RS)";"RS";"NOVO CABRAIS";60;2;6;68
2006;"NOVO HAMBURGO (RS)";"RS";"NOVO HAMBURGO";2341;227;467;3035
2006;"NOVO MACHADO (RS)";"RS";"NOVO MACHADO";120;19;7;146
2006;"NOVO TIRADENTES (RS)";"RS";"NOVO TIRADENTES";19;0;10;29
2006;"NOVO XINGU (RS)";"RS";"NOVO XINGU";24;6;7;37
2006;"OSORIO (RS)";"RS";"OSORIO";697;43;123;863
2006;"PAIM FILHO (RS)";"RS";"PAIM FILHO";93;6;15;114
2006;"PALMARES DO SUL (RS)";"RS";"PALMARES DO SUL";154;16;24;194
2006;"PALMEIRA DAS MISSOES (RS)";"RS";"PALMEIRA DAS MISSOES";728;25;59;812
2006;"PALMITINHO (RS)";"RS";"PALMITINHO";117;6;21;144
2006;"PANAMBI (RS)";"RS";"PANAMBI";817;38;99;954
2006;"PANTANO GRANDE (RS)";"RS";"PANTANO GRANDE";257;11;23;291
2006;"PARAI (RS)";"RS";"PARAI";273;9;21;303
2006;"PARAISO DO SUL (RS)";"RS";"PARAISO DO SUL";76;3;8;87
2006;"PARECI NOVO (RS)";"RS";"PARECI NOVO";375;6;24;405
2006;"PAROBE (RS)";"RS";"PAROBE";380;56;126;562
2006;"PASSA SETE (RS)";"RS";"PASSA SETE";60;2;19;81
2006;"PASSO DO SOBRADO (RS)";"RS";"PASSO DO SOBRADO";119;6;40;165
2006;"PASSO FUNDO (RS)";"RS";"PASSO FUNDO";2613;145;332;3090
2006;"PAULO BENTO (RS)";"RS";"PAULO BENTO";59;10;5;74
2006;"PAVERAMA (RS)";"RS";"PAVERAMA";136;21;37;194
2006;"PEDRAS ALTAS (RS)";"RS";"PEDRAS ALTAS";9;8;4;21
2006;"PEDRO OSORIO (RS)";"RS";"PEDRO OSORIO";94;6;22;122
2006;"PEJUCARA (RS)";"RS";"PEJUCARA";196;3;13;212
2006;"PELOTAS (RS)";"RS";"PELOTAS";4410;201;937;5548
2006;"PICADA CAFE (RS)";"RS";"PICADA CAFE";81;13;40;134
2006;"PINHAL (RS)";"RS";"PINHAL";50;2;7;59
2006;"PINHAL DA SERRA (RS)";"RS";"PINHAL DA SERRA";28;4;6;38
2006;"PINHAL GRANDE (RS)";"RS";"PINHAL GRANDE";78;9;11;98
2006;"PINHEIRINHO DO VALE (RS)";"RS";"PINHEIRINHO DO VALE";42;1;15;58
2006;"PINHEIRO MACHADO (RS)";"RS";"PINHEIRO MACHADO";136;10;28;174
2006;"PINTO BANDEIRA (RS)";"RS";"PINTO BANDEIRA";8;0;0;8
2006;"PIRAPO (RS)";"RS";"PIRAPO";25;4;6;35
2006;"PIRATINI (RS)";"RS";"PIRATINI";225;23;82;330
2006;"PLANALTO (RS)";"RS";"PLANALTO";152;5;27;184
2006;"POCO DAS ANTAS (RS)";"RS";"POCO DAS ANTAS";77;10;14;101
2006;"PONTAO (RS)";"RS";"PONTAO";70;4;17;91
2006;"PONTE PRETA (RS)";"RS";"PONTE PRETA";44;6;5;55
2006;"PORTAO (RS)";"RS";"PORTAO";1397;62;96;1555
2006;"PORTO ALEGRE (RS)";"RS";"PORTO ALEGRE";12760;1989;3652;18401
2006;"PORTO LUCENA (RS)";"RS";"PORTO LUCENA";72;6;18;96
2006;"PORTO MAUA (RS)";"RS";"PORTO MAUA";35;6;6;47
2006;"PORTO VERA CRUZ (RS)";"RS";"PORTO VERA CRUZ";7;2;4;13
2006;"PORTO XAVIER (RS)";"RS";"PORTO XAVIER";161;10;26;197
2006;"POUSO NOVO (RS)";"RS";"POUSO NOVO";27;4;5;36
2006;"PRESIDENTE LUCENA (RS)";"RS";"PRESIDENTE LUCENA";91;3;5;99
2006;"PROGRESSO (RS)";"RS";"PROGRESSO";92;8;18;118
2006;"PROTASIO ALVES (RS)";"RS";"PROTASIO ALVES";48;3;5;56
2006;"PUTINGA (RS)";"RS";"PUTINGA";75;4;9;88
2006;"QUARAI (RS)";"RS";"QUARAI";129;8;33;170
2006;"QUATRO IRMAOS (RS)";"RS";"QUATRO IRMAOS";42;9;3;54
2006;"QUEVEDOS (RS)";"RS";"QUEVEDOS";21;1;5;27
2006;"QUINZE DE NOVEMBRO (RS)";"RS";"QUINZE DE NOVEMBRO";152;9;16;177
2006;"REDENTORA (RS)";"RS";"REDENTORA";77;6;12;95
2006;"RELVADO (RS)";"RS";"RELVADO";36;7;3;46
2006;"RESTINGA SECA (RS)";"RS";"RESTINGA SECA";236;7;48;291
2006;"RIO DOS INDIOS (RS)";"RS";"RIO DOS INDIOS";45;1;22;68
2006;"RIO GRANDE (RS)";"RS";"RIO GRANDE";1620;96;392;2108
2006;"RIO PARDO (RS)";"RS";"RIO PARDO";356;27;64;447
2006;"RIOZINHO (RS)";"RS";"RIOZINHO";39;6;23;68
2006;"ROCA SALES (RS)";"RS";"ROCA SALES";136;15;37;188
2006;"RODEIO BONITO (RS)";"RS";"RODEIO BONITO";75;4;23;102
2006;"ROLADOR (RS)";"RS";"ROLADOR";32;3;8;43
2006;"ROLANTE (RS)";"RS";"ROLANTE";163;13;49;225
2006;"RONDA ALTA (RS)";"RS";"RONDA ALTA";222;12;22;256
2006;"RONDINHA (RS)";"RS";"RONDINHA";127;10;17;154
2006;"ROQUE GONZALES (RS)";"RS";"ROQUE GONZALES";93;2;20;115
2006;"ROSARIO DO SUL (RS)";"RS";"ROSARIO DO SUL";381;19;48;448
2006;"SAGRADA FAMILIA (RS)";"RS";"SAGRADA FAMILIA";18;2;7;27
2006;"SALDANHA MARINHO (RS)";"RS";"SALDANHA MARINHO";139;9;8;156
2006;"SALTO DO JACUI (RS)";"RS";"SALTO DO JACUI";164;14;20;198
2006;"SALVADOR DAS MISSOES (RS)";"RS";"SALVADOR DAS MISSOES";72;2;7;81
2006;"SALVADOR DO SUL (RS)";"RS";"SALVADOR DO SUL";211;20;30;261
2006;"SANANDUVA (RS)";"RS";"SANANDUVA";496;13;41;550
2006;"SANTA BARBARA DO SUL (RS)";"RS";"SANTA BARBARA DO SUL";305;16;32;353
2006;"SANTA CECILIA DO SUL (RS)";"RS";"SANTA CECILIA DO SUL";32;3;9;44
2006;"SANTA CLARA DO SUL (RS)";"RS";"SANTA CLARA DO SUL";100;19;10;129
2006;"SANTA CRUZ DO SUL (RS)";"RS";"SANTA CRUZ DO SUL";1597;133;492;2222
2006;"SANTA MARGARIDA DO SUL (RS)";"RS";"SANTA MARGARIDA DO SUL";31;6;2;39
2006;"SANTA MARIA (RS)";"RS";"SANTA MARIA";2543;265;861;3669
2006;"SANTA MARIA DO HERVAL (RS)";"RS";"SANTA MARIA DO HERVAL";152;7;50;209
2006;"SANTA ROSA (RS)";"RS";"SANTA ROSA";1205;78;144;1427
2006;"SANTA TEREZA (RS)";"RS";"SANTA TEREZA";72;4;6;82
2006;"SANTA VITORIA DO PALMAR (RS)";"RS";"SANTA VITORIA DO PALMAR";452;10;68;530
2006;"SANTANA DA BOA VISTA (RS)";"RS";"SANTANA DA BOA VISTA";54;5;32;91
2006;"SANTANA DO LIVRAMENTO (RS)";"RS";"SANTANA DO LIVRAMENTO";624;37;119;780
2006;"SANTIAGO (RS)";"RS";"SANTIAGO";652;45;83;780
2006;"SANTO ANGELO (RS)";"RS";"SANTO ANGELO";1003;70;89;1162
2006;"SANTO ANTONIO DA PATRULHA (RS)";"RS";"SANTO ANTONIO DA PATRULHA";658;26;131;815
2006;"SANTO ANTONIO DAS MISSOES (RS)";"RS";"SANTO ANTONIO DAS MISSOES";139;24;18;181
2006;"SANTO ANTONIO DO PALMA (RS)";"RS";"SANTO ANTONIO DO PALMA";35;4;8;47
2006;"SANTO ANTONIO DO PLANALTO (RS)";"RS";"SANTO ANTONIO DO PLANALTO";76;3;8;87
2006;"SANTO AUGUSTO (RS)";"RS";"SANTO AUGUSTO";436;22;22;480
2006;"SANTO CRISTO (RS)";"RS";"SANTO CRISTO";358;18;49;425
2006;"SANTO EXPEDITO DO SUL (RS)";"RS";"SANTO EXPEDITO DO SUL";76;4;9;89
2006;"SAO BORJA (RS)";"RS";"SAO BORJA";977;27;86;1090
2006;"SAO DOMINGOS DO SUL (RS)";"RS";"SAO DOMINGOS DO SUL";75;5;3;83
2006;"SAO FRANCISCO DE ASSIS (RS)";"RS";"SAO FRANCISCO DE ASSIS";231;8;65;304
2006;"SAO FRANCISCO DE PAULA (RS)";"RS";"SAO FRANCISCO DE PAULA";435;26;38;499
2006;"SAO GABRIEL (RS)";"RS";"SAO GABRIEL";736;17;80;833
2006;"SAO JERONIMO (RS)";"RS";"SAO JERONIMO";235;15;106;356
2006;"SAO JOAO DA URTIGA (RS)";"RS";"SAO JOAO DA URTIGA";120;6;13;139
2006;"SAO JOAO DO POLESINE (RS)";"RS";"SAO JOAO DO POLESINE";52;1;5;58
2006;"SAO JORGE (RS)";"RS";"SAO JORGE";123;5;17;145
2006;"SAO JOSE DAS MISSOES (RS)";"RS";"SAO JOSE DAS MISSOES";32;3;6;41
2006;"SAO JOSE DO HERVAL (RS)";"RS";"SAO JOSE DO HERVAL";57;2;10;69
2006;"SAO JOSE DO HORTENCIO (RS)";"RS";"SAO JOSE DO HORTENCIO";182;6;36;224
2006;"SAO JOSE DO INHACORA (RS)";"RS";"SAO JOSE DO INHACORA";28;4;6;38
2006;"SAO JOSE DO NORTE (RS)";"RS";"SAO JOSE DO NORTE";262;3;41;306
2006;"SAO JOSE DO OURO (RS)";"RS";"SAO JOSE DO OURO";240;8;22;270
2006;"SAO JOSE DO SUL (RS)";"RS";"SAO JOSE DO SUL";102;13;2;117
2006;"SAO JOSE DOS AUSENTES (RS)";"RS";"SAO JOSE DOS AUSENTES";75;5;9;89
2006;"SAO LEOPOLDO (RS)";"RS";"SAO LEOPOLDO";1649;172;492;2313
2006;"SAO LOURENCO DO SUL (RS)";"RS";"SAO LOURENCO DO SUL";842;29;120;991
2006;"SAO LUIZ GONZAGA (RS)";"RS";"SAO LUIZ GONZAGA";478;39;65;582
2006;"SAO MARCOS (RS)";"RS";"SAO MARCOS";595;14;89;698
2006;"SAO MARTINHO (RS)";"RS";"SAO MARTINHO";150;11;12;173
2006;"SAO MARTINHO DA SERRA (RS)";"RS";"SAO MARTINHO DA SERRA";30;1;4;35
2006;"SAO MIGUEL DAS MISSOES (RS)";"RS";"SAO MIGUEL DAS MISSOES";173;14;30;217
2006;"SAO NICOLAU (RS)";"RS";"SAO NICOLAU";55;4;9;68
2006;"SAO PAULO DAS MISSOES (RS)";"RS";"SAO PAULO DAS MISSOES";95;4;21;120
2006;"SAO PEDRO DA SERRA (RS)";"RS";"SAO PEDRO DA SERRA";97;5;9;111
2006;"SAO PEDRO DAS MISSOES (RS)";"RS";"SAO PEDRO DAS MISSOES";20;4;4;28
2006;"SAO PEDRO DO BUTIA (RS)";"RS";"SAO PEDRO DO BUTIA";88;1;8;97
2006;"SAO PEDRO DO SUL (RS)";"RS";"SAO PEDRO DO SUL";242;25;45;312
2006;"SAO SEBASTIAO DO CAI (RS)";"RS";"SAO SEBASTIAO DO CAI";645;22;59;726
2006;"SAO SEPE (RS)";"RS";"SAO SEPE";387;16;72;475
2006;"SAO VALENTIM (RS)";"RS";"SAO VALENTIM";55;7;9;71
2006;"SAO VALENTIM DO SUL (RS)";"RS";"SAO VALENTIM DO SUL";65;3;11;79
2006;"SAO VALERIO DO SUL (RS)";"RS";"SAO VALERIO DO SUL";35;2;6;43
2006;"SAO VENDELINO (RS)";"RS";"SAO VENDELINO";70;7;2;79
2006;"SAO VICENTE DO SUL (RS)";"RS";"SAO VICENTE DO SUL";104;5;27;136
2006;"SAPIRANGA (RS)";"RS";"SAPIRANGA";750;94;154;998
2006;"SAPUCAIA DO SUL (RS)";"RS";"SAPUCAIA DO SUL";1329;142;172;1643
2006;"SARANDI (RS)";"RS";"SARANDI";492;18;53;563
2006;"SEBERI (RS)";"RS";"SEBERI";196;9;31;236
2006;"SEDE NOVA (RS)";"RS";"SEDE NOVA";53;5;10;68
2006;"SEGREDO (RS)";"RS";"SEGREDO";96;6;21;123
2006;"SELBACH (RS)";"RS";"SELBACH";243;6;15;264
2006;"SENADOR SALGADO FILHO (RS)";"RS";"SENADOR SALGADO FILHO";80;8;15;103
2006;"SENTINELA DO SUL (RS)";"RS";"SENTINELA DO SUL";96;4;9;109
2006;"SERAFINA CORREA (RS)";"RS";"SERAFINA CORREA";235;36;37;308
2006;"SERIO (RS)";"RS";"SERIO";48;8;5;61
2006;"SERTAO (RS)";"RS";"SERTAO";203;11;23;237
2006;"SERTAO SANTANA (RS)";"RS";"SERTAO SANTANA";147;9;17;173
2006;"SETE DE SETEMBRO (RS)";"RS";"SETE DE SETEMBRO";44;1;4;49
2006;"SEVERIANO DE ALMEIDA (RS)";"RS";"SEVERIANO DE ALMEIDA";73;10;12;95
2006;"SILVEIRA MARTINS (RS)";"RS";"SILVEIRA MARTINS";107;1;5;113
2006;"SINIMBU (RS)";"RS";"SINIMBU";109;2;5;116
2006;"SOBRADINHO (RS)";"RS";"SOBRADINHO";252;21;51;324
2006;"SOLEDADE (RS)";"RS";"SOLEDADE";409;16;91;516
2006;"TABAI (RS)";"RS";"TABAI";124;18;8;150
2006;"TAPEJARA (RS)";"RS";"TAPEJARA";540;16;57;613
2006;"TAPERA (RS)";"RS";"TAPERA";315;18;23;356
2006;"TAPES (RS)";"RS";"TAPES";260;11;23;294
2006;"TAQUARA (RS)";"RS";"TAQUARA";612;56;229;897
2006;"TAQUARI (RS)";"RS";"TAQUARI";367;34;107;508
2006;"TAQUARUCU DO SUL (RS)";"RS";"TAQUARUCU DO SUL";48;2;9;59
2006;"TAVARES (RS)";"RS";"TAVARES";78;3;7;88
2006;"TENENTE PORTELA (RS)";"RS";"TENENTE PORTELA";235;4;26;265
2006;"TERRA DE AREIA (RS)";"RS";"TERRA DE AREIA";268;14;23;305
2006;"TEUTONIA (RS)";"RS";"TEUTONIA";479;36;64;579
2006;"TIO HUGO (RS)";"RS";"TIO HUGO";68;5;7;80
2006;"TIRADENTES DO SUL (RS)";"RS";"TIRADENTES DO SUL";79;5;6;90
2006;"TOROPI (RS)";"RS";"TOROPI";39;4;13;56
2006;"TORRES (RS)";"RS";"TORRES";333;18;59;410
2006;"TRAMANDAI (RS)";"RS";"TRAMANDAI";493;49;135;677
2006;"TRAVESSEIRO (RS)";"RS";"TRAVESSEIRO";33;5;8;46
2006;"TRES ARROIOS (RS)";"RS";"TRES ARROIOS";64;8;2;74
2006;"TRES CACHOEIRAS (RS)";"RS";"TRES CACHOEIRAS";567;8;14;589
2006;"TRES COROAS (RS)";"RS";"TRES COROAS";178;27;49;254
2006;"TRES DE MAIO (RS)";"RS";"TRES DE MAIO";593;53;76;722
2006;"TRES FORQUILHAS (RS)";"RS";"TRES FORQUILHAS";78;2;2;82
2006;"TRES PALMEIRAS (RS)";"RS";"TRES PALMEIRAS";60;3;11;74
2006;"TRES PASSOS (RS)";"RS";"TRES PASSOS";378;24;110;512
2006;"TRINDADE DO SUL (RS)";"RS";"TRINDADE DO SUL";79;2;17;98
2006;"TRIUNFO (RS)";"RS";"TRIUNFO";350;76;120;546
2006;"TUCUNDUVA (RS)";"RS";"TUCUNDUVA";198;11;14;223
2006;"TUNAS (RS)";"RS";"TUNAS";29;3;12;44
2006;"TUPANCI DO SUL (RS)";"RS";"TUPANCI DO SUL";44;3;8;55
2006;"TUPANCIRETA (RS)";"RS";"TUPANCIRETA";446;24;37;507
2006;"TUPANDI (RS)";"RS";"TUPANDI";65;14;21;100
2006;"TUPARENDI (RS)";"RS";"TUPARENDI";182;8;24;214
2006;"TURUCU (RS)";"RS";"TURUCU";69;4;8;81
2006;"UBIRETAMA (RS)";"RS";"UBIRETAMA";61;2;4;67
2006;"UNIAO DA SERRA (RS)";"RS";"UNIAO DA SERRA";47;3;8;58
2006;"UNISTALDA (RS)";"RS";"UNISTALDA";23;3;9;35
2006;"URUGUAIANA (RS)";"RS";"URUGUAIANA";1629;62;153;1844
2006;"VACARIA (RS)";"RS";"VACARIA";1472;80;338;1890
2006;"VALE DO SOL (RS)";"RS";"VALE DO SOL";161;6;24;191
2006;"VALE REAL (RS)";"RS";"VALE REAL";223;9;16;248
2006;"VALE VERDE (RS)";"RS";"VALE VERDE";30;3;4;37
2006;"VANINI (RS)";"RS";"VANINI";73;9;13;95
2006;"VENANCIO AIRES (RS)";"RS";"VENANCIO AIRES";1004;54;167;1225
2006;"VERA CRUZ (RS)";"RS";"VERA CRUZ";299;12;74;385
2006;"VERANOPOLIS (RS)";"RS";"VERANOPOLIS";788;38;62;888
2006;"VESPASIANO CORREA (RS)";"RS";"VESPASIANO CORREA";59;4;15;78
2006;"VIADUTOS (RS)";"RS";"VIADUTOS";107;8;15;130
2006;"VIAMAO (RS)";"RS";"VIAMAO";1539;199;482;2220
2006;"VICENTE DUTRA (RS)";"RS";"VICENTE DUTRA";39;0;13;52
2006;"VICTOR GRAEFF (RS)";"RS";"VICTOR GRAEFF";135;15;4;154
2006;"VILA FLORES (RS)";"RS";"VILA FLORES";146;13;13;172
2006;"VILA LANGARO (RS)";"RS";"VILA LANGARO";71;4;10;85
2006;"VILA MARIA (RS)";"RS";"VILA MARIA";197;6;32;235
2006;"VILA NOVA DO SUL (RS)";"RS";"VILA NOVA DO SUL";71;2;7;80
2006;"VISTA ALEGRE (RS)";"RS";"VISTA ALEGRE";41;1;10;52
2006;"VISTA ALEGRE DO PRATA (RS)";"RS";"VISTA ALEGRE DO PRATA";27;7;5;39
2006;"VISTA GAUCHA (RS)";"RS";"VISTA GAUCHA";41;2;9;52
2006;"VITORIA DAS MISSOES (RS)";"RS";"VITORIA DAS MISSOES";78;1;9;88
2006;"WESTFALIA (RS)";"RS";"WESTFALIA";99;18;7;124
2006;"XANGRI LA (RS)";"RS";"XANGRI LA";118;7;3;128
2006;"ABDON BATISTA (SC)";"SC";"ABDON BATISTA";42;5;9;56
2006;"ABELARDO LUZ (SC)";"SC";"ABELARDO LUZ";306;9;43;358
2006;"AGROLANDIA (SC)";"SC";"AGROLANDIA";171;9;12;192
2006;"AGRONOMICA (SC)";"SC";"AGRONOMICA";119;1;9;129
2006;"AGUA DOCE (SC)";"SC";"AGUA DOCE";144;11;13;168
2006;"AGUAS DE CHAPECO (SC)";"SC";"AGUAS DE CHAPECO";60;2;11;73
2006;"AGUAS FRIAS (SC)";"SC";"AGUAS FRIAS";31;0;5;36
2006;"AGUAS MORNAS (SC)";"SC";"AGUAS MORNAS";196;3;9;208
2006;"ALFREDO WAGNER (SC)";"SC";"ALFREDO WAGNER";188;17;8;213
2006;"ALTO BELA VISTA (SC)";"SC";"ALTO BELA VISTA";42;5;6;53
2006;"ANCHIETA (SC)";"SC";"ANCHIETA";127;12;11;150
2006;"ANGELINA (SC)";"SC";"ANGELINA";136;11;10;157
2006;"ANITA GARIBALDI (SC)";"SC";"ANITA GARIBALDI";121;9;19;149
2006;"ANITAPOLIS (SC)";"SC";"ANITAPOLIS";66;6;9;81
2006;"ANTONIO CARLOS (SC)";"SC";"ANTONIO CARLOS";484;7;6;497
2006;"APIUNA (SC)";"SC";"APIUNA";120;12;13;145
2006;"ARABUTA (SC)";"SC";"ARABUTA";78;8;19;105
2006;"ARAQUARI (SC)";"SC";"ARAQUARI";267;13;20;300
2006;"ARARANGUA (SC)";"SC";"ARARANGUA";1108;44;142;1294
2006;"ARMAZEM (SC)";"SC";"ARMAZEM";209;8;5;222
2006;"ARROIO TRINTA (SC)";"SC";"ARROIO TRINTA";126;6;8;140
2006;"ARVOREDO (SC)";"SC";"ARVOREDO";22;5;5;32
2006;"ASCURRA (SC)";"SC";"ASCURRA";162;13;24;199
2006;"ATALANTA (SC)";"SC";"ATALANTA";74;2;4;80
2006;"AURORA (SC)";"SC";"AURORA";136;5;6;147
2006;"BALNEARIO ARROIO DO SILVA (SC)";"SC";"BALNEARIO ARROIO DO SILVA";69;9;19;97
2006;"BALNEARIO CAMBORIU (SC)";"SC";"BALNEARIO CAMBORIU";723;169;146;1038
2006;"BALNEARIO GAIVOTA (SC)";"SC";"BALNEARIO GAIVOTA";115;6;9;130
2006;"BANDEIRANTE (SC)";"SC";"BANDEIRANTE";18;2;11;31
2006;"BARRA BONITA (SC)";"SC";"BARRA BONITA";26;2;8;36
2006;"BARRA DO SUL (SC)";"SC";"BARRA DO SUL";70;4;3;77
2006;"BARRA VELHA (SC)";"SC";"BARRA VELHA";229;17;15;261
2006;"BELA VISTA DO TOLDO (SC)";"SC";"BELA VISTA DO TOLDO";64;3;8;75
2006;"BELMONTE (SC)";"SC";"BELMONTE";41;2;4;47
2006;"BENEDITO NOVO (SC)";"SC";"BENEDITO NOVO";234;16;22;272
2006;"BIGUACU (SC)";"SC";"BIGUACU";712;45;161;918
2006;"BLUMENAU (SC)";"SC";"BLUMENAU";3957;313;707;4977
2006;"BOCAINA DO SUL (SC)";"SC";"BOCAINA DO SUL";37;7;13;57
2006;"BOM JARDIM DA SERRA (SC)";"SC";"BOM JARDIM DA SERRA";86;1;13;100
2006;"BOM JESUS (SC)";"SC";"BOM JESUS";47;1;6;54
2006;"BOM JESUS DO OESTE (SC)";"SC";"BOM JESUS DO OESTE";31;0;8;39
2006;"BOM RETIRO (SC)";"SC";"BOM RETIRO";130;13;18;161
2006;"BOMBINHAS (SC)";"SC";"BOMBINHAS";96;18;15;129
2006;"BOTUVERA (SC)";"SC";"BOTUVERA";161;4;7;172
2006;"BRACO DO NORTE (SC)";"SC";"BRACO DO NORTE";742;36;45;823
2006;"BRACO DO TROMBUDO (SC)";"SC";"BRACO DO TROMBUDO";108;4;5;117
2006;"BRUNOPOLIS (SC)";"SC";"BRUNOPOLIS";45;2;8;55
2006;"BRUSQUE (SC)";"SC";"BRUSQUE";1660;84;151;1895
2006;"CACADOR (SC)";"SC";"CACADOR";1724;84;759;2567
2006;"CAIBI (SC)";"SC";"CAIBI";136;2;21;159
2006;"CALMON (SC)";"SC";"CALMON";40;4;19;63
2006;"CAMBORIU (SC)";"SC";"CAMBORIU";669;28;36;733
2006;"CAMPO ALEGRE (SC)";"SC";"CAMPO ALEGRE";325;14;11;350
2006;"CAMPO BELO DO SUL (SC)";"SC";"CAMPO BELO DO SUL";161;7;20;188
2006;"CAMPO ERE (SC)";"SC";"CAMPO ERE";193;8;25;226
2006;"CAMPOS NOVOS (SC)";"SC";"CAMPOS NOVOS";780;30;76;886
2006;"CANELINHA (SC)";"SC";"CANELINHA";412;9;5;426
2006;"CANOINHAS (SC)";"SC";"CANOINHAS";1090;44;105;1239
2006;"CAPAO ALTO (SC)";"SC";"CAPAO ALTO";32;4;9;45
2006;"CAPINZAL (SC)";"SC";"CAPINZAL";360;28;26;414
2006;"CAPIVARI DE BAIXO (SC)";"SC";"CAPIVARI DE BAIXO";232;10;23;265
2006;"CATANDUVAS (SC)";"SC";"CATANDUVAS";261;14;25;300
2006;"CAXAMBU DO SUL (SC)";"SC";"CAXAMBU DO SUL";74;3;13;90
2006;"CELSO RAMOS (SC)";"SC";"CELSO RAMOS";40;6;3;49
2006;"CERRO NEGRO (SC)";"SC";"CERRO NEGRO";25;5;11;41
2006;"CHAPADAO DO LAGEADO (SC)";"SC";"CHAPADAO DO LAGEADO";30;2;6;38
2006;"CHAPECO (SC)";"SC";"CHAPECO";3060;155;261;3476
2006;"COCAL DO SUL (SC)";"SC";"COCAL DO SUL";207;11;9;227
2006;"CONCORDIA (SC)";"SC";"CONCORDIA";1644;94;158;1896
2006;"CORDILHEIRA ALTA (SC)";"SC";"CORDILHEIRA ALTA";181;6;4;191
2006;"CORONEL FREITAS (SC)";"SC";"CORONEL FREITAS";235;7;26;268
2006;"CORONEL MARTINS (SC)";"SC";"CORONEL MARTINS";33;5;10;48
2006;"CORREIA PINTO (SC)";"SC";"CORREIA PINTO";296;20;43;359
2006;"CORUPA (SC)";"SC";"CORUPA";317;8;27;352
2006;"CRICIUMA (SC)";"SC";"CRICIUMA";3056;276;362;3694
2006;"CUNHA PORA (SC)";"SC";"CUNHA PORA";283;11;41;335
2006;"CUNHATAI (SC)";"SC";"CUNHATAI";22;2;2;26
2006;"CURITIBANOS (SC)";"SC";"CURITIBANOS";837;31;84;952
2006;"DESCANSO (SC)";"SC";"DESCANSO";184;9;21;214
2006;"DIONISIO CERQUEIRA (SC)";"SC";"DIONISIO CERQUEIRA";112;8;18;138
2006;"DONA EMMA (SC)";"SC";"DONA EMMA";85;7;5;97
2006;"DOUTOR PEDRINHO (SC)";"SC";"DOUTOR PEDRINHO";101;5;7;113
2006;"ENTRE RIOS (SC)";"SC";"ENTRE RIOS";18;2;6;26
2006;"ERMO (SC)";"SC";"ERMO";49;0;4;53
2006;"ERVAL VELHO (SC)";"SC";"ERVAL VELHO";85;2;19;106
2006;"FAXINAL DOS GUEDES (SC)";"SC";"FAXINAL DOS GUEDES";315;11;20;346
2006;"FLOR DO SERTAO (SC)";"SC";"FLOR DO SERTAO";21;4;9;34
2006;"FLORIANOPOLIS (SC)";"SC";"FLORIANOPOLIS";3055;806;1352;5213
2006;"FORMOSA DO SUL (SC)";"SC";"FORMOSA DO SUL";46;3;13;62
2006;"FORQUILHINHA (SC)";"SC";"FORQUILHINHA";437;12;32;481
2006;"FRAIBURGO (SC)";"SC";"FRAIBURGO";698;41;187;926
2006;"FREI ROGERIO (SC)";"SC";"FREI ROGERIO";56;3;12;71
2006;"GALVAO (SC)";"SC";"GALVAO";70;3;9;82
2006;"GAROPABA (SC)";"SC";"GAROPABA";163;15;34;212
2006;"GARUVA (SC)";"SC";"GARUVA";259;14;14;287
2006;"GASPAR (SC)";"SC";"GASPAR";1023;46;65;1134
2006;"GOVERNADOR CELSO RAMOS (SC)";"SC";"GOVERNADOR CELSO RAMOS";122;18;6;146
2006;"GRAO PARA (SC)";"SC";"GRAO PARA";190;3;9;202
2006;"GRAVATAL (SC)";"SC";"GRAVATAL";177;6;10;193
2006;"GUABIRUBA (SC)";"SC";"GUABIRUBA";228;11;12;251
2006;"GUARACIABA (SC)";"SC";"GUARACIABA";182;8;29;219
2006;"GUARAMIRIM (SC)";"SC";"GUARAMIRIM";737;20;16;773
2006;"GUARUJA DO SUL (SC)";"SC";"GUARUJA DO SUL";148;7;14;169
2006;"GUATAMBU (SC)";"SC";"GUATAMBU";63;3;17;83
2006;"HERVAL D OESTE (SC)";"SC";"HERVAL D OESTE";244;29;46;319
2006;"IBIAM (SC)";"SC";"IBIAM";42;2;12;56
2006;"IBICARE (SC)";"SC";"IBICARE";107;7;4;118
2006;"IBIRAMA (SC)";"SC";"IBIRAMA";302;20;54;376
2006;"ICARA (SC)";"SC";"ICARA";1111;51;100;1262
2006;"ILHOTA (SC)";"SC";"ILHOTA";220;16;11;247
2006;"IMARUI (SC)";"SC";"IMARUI";86;11;18;115
2006;"IMBITUBA (SC)";"SC";"IMBITUBA";448;60;63;571
2006;"IMBUIA (SC)";"SC";"IMBUIA";141;5;13;159
2006;"INDAIAL (SC)";"SC";"INDAIAL";992;37;69;1098
2006;"IOMERE (SC)";"SC";"IOMERE";104;10;6;120
2006;"IPIRA (SC)";"SC";"IPIRA";76;6;12;94
2006;"IPORA DO OESTE (SC)";"SC";"IPORA DO OESTE";174;5;33;212
2006;"IPUACU (SC)";"SC";"IPUACU";68;7;15;90
2006;"IPUMIRIM (SC)";"SC";"IPUMIRIM";174;5;16;195
2006;"IRACEMINHA (SC)";"SC";"IRACEMINHA";76;3;16;95
2006;"IRANI (SC)";"SC";"IRANI";207;15;45;267
2006;"IRATI (SC)";"SC";"IRATI";24;6;5;35
2006;"IRINEOPOLIS (SC)";"SC";"IRINEOPOLIS";175;3;9;187
2006;"ITA (SC)";"SC";"ITA";76;14;24;114
2006;"ITAIOPOLIS (SC)";"SC";"ITAIOPOLIS";422;14;51;487
2006;"ITAJAI (SC)";"SC";"ITAJAI";3363;275;279;3917
2006;"ITAPEMA (SC)";"SC";"ITAPEMA";366;41;36;443
2006;"ITAPIRANGA (SC)";"SC";"ITAPIRANGA";197;16;41;254
2006;"ITAPOA (SC)";"SC";"ITAPOA";102;6;3;111
2006;"ITUPORANGA (SC)";"SC";"ITUPORANGA";504;16;36;556
2006;"JABORA (SC)";"SC";"JABORA";97;8;15;120
2006;"JACINTO MACHADO (SC)";"SC";"JACINTO MACHADO";342;6;24;372
2006;"JAGUARUNA (SC)";"SC";"JAGUARUNA";347;9;28;384
2006;"JARAGUA DO SUL (SC)";"SC";"JARAGUA DO SUL";1966;155;253;2374
2006;"JARDINOPOLIS (SC)";"SC";"JARDINOPOLIS";18;2;2;22
2006;"JOACABA (SC)";"SC";"JOACABA";686;41;27;754
2006;"JOINVILLE (SC)";"SC";"JOINVILLE";6513;557;749;7819
2006;"JOSE BOITEUX (SC)";"SC";"JOSE BOITEUX";85;8;8;101
2006;"JUPIA (SC)";"SC";"JUPIA";35;3;5;43
2006;"LACERDOPOLIS (SC)";"SC";"LACERDOPOLIS";90;7;5;102
2006;"LAGEADO GRANDE (SC)";"SC";"LAGEADO GRANDE";27;1;5;33
2006;"LAGES (SC)";"SC";"LAGES";3181;175;293;3649
2006;"LAGUNA (SC)";"SC";"LAGUNA";430;54;73;557
2006;"LAURENTINO (SC)";"SC";"LAURENTINO";211;3;6;220
2006;"LAURO MULLER (SC)";"SC";"LAURO MULLER";320;15;27;362
2006;"LEBON REGIS (SC)";"SC";"LEBON REGIS";175;3;29;207
2006;"LEOBERTO LEAL (SC)";"SC";"LEOBERTO LEAL";98;6;8;112
2006;"LINDOIA DO SUL (SC)";"SC";"LINDOIA DO SUL";108;10;30;148
2006;"LONTRAS (SC)";"SC";"LONTRAS";228;11;12;251
2006;"LUIZ ALVES (SC)";"SC";"LUIZ ALVES";320;8;11;339
2006;"LUZERNA (SC)";"SC";"LUZERNA";93;10;14;117
2006;"MACIEIRA (SC)";"SC";"MACIEIRA";46;5;9;60
2006;"MAFRA (SC)";"SC";"MAFRA";1053;56;110;1219
2006;"MAJOR GERCINO (SC)";"SC";"MAJOR GERCINO";114;11;5;130
2006;"MAJOR VIEIRA (SC)";"SC";"MAJOR VIEIRA";141;5;8;154
2006;"MARACAJA (SC)";"SC";"MARACAJA";170;2;6;178
2006;"MARAVILHA (SC)";"SC";"MARAVILHA";444;30;54;528
2006;"MAREMA (SC)";"SC";"MAREMA";48;7;6;61
2006;"MASSARANDUBA (SC)";"SC";"MASSARANDUBA";400;15;28;443
2006;"MATOS COSTA (SC)";"SC";"MATOS COSTA";30;3;7;40
2006;"MELEIRO (SC)";"SC";"MELEIRO";184;2;14;200
2006;"MIRIM DOCE (SC)";"SC";"MIRIM DOCE";45;1;6;52
2006;"MODELO (SC)";"SC";"MODELO";86;7;6;99
2006;"MONDAI (SC)";"SC";"MONDAI";156;6;32;194
2006;"MONTE CARLO (SC)";"SC";"MONTE CARLO";169;11;74;254
2006;"MONTE CASTELO (SC)";"SC";"MONTE CASTELO";137;5;12;154
2006;"MORRO DA FUMACA (SC)";"SC";"MORRO DA FUMACA";652;30;27;709
2006;"MORRO GRANDE (SC)";"SC";"MORRO GRANDE";78;0;6;84
2006;"NAVEGANTES (SC)";"SC";"NAVEGANTES";482;46;34;562
2006;"NOVA ERECHIM (SC)";"SC";"NOVA ERECHIM";60;3;7;70
2006;"NOVA ITABERABA (SC)";"SC";"NOVA ITABERABA";52;4;14;70
2006;"NOVA TRENTO (SC)";"SC";"NOVA TRENTO";174;12;29;215
2006;"NOVA VENEZA (SC)";"SC";"NOVA VENEZA";340;25;13;378
2006;"NOVO HORIZONTE (SC)";"SC";"NOVO HORIZONTE";59;7;8;74
2006;"ORLEANS (SC)";"SC";"ORLEANS";702;9;38;749
2006;"OTACILIO COSTA (SC)";"SC";"OTACILIO COSTA";356;32;28;416
2006;"OURO (SC)";"SC";"OURO";178;15;24;217
2006;"OURO VERDE (SC)";"SC";"OURO VERDE";64;1;4;69
2006;"PAIAL (SC)";"SC";"PAIAL";8;4;11;23
2006;"PAINEL (SC)";"SC";"PAINEL";22;2;6;30
2006;"PALHOCA (SC)";"SC";"PALHOCA";1450;95;266;1811
2006;"PALMA SOLA (SC)";"SC";"PALMA SOLA";160;3;17;180
2006;"PALMEIRA (SC)";"SC";"PALMEIRA";63;6;1;70
2006;"PALMITOS (SC)";"SC";"PALMITOS";260;17;51;328
2006;"PAPANDUVA (SC)";"SC";"PAPANDUVA";424;13;53;490
2006;"PARAISO (SC)";"SC";"PARAISO";47;2;6;55
2006;"PASSO DE TORRES (SC)";"SC";"PASSO DE TORRES";88;5;14;107
2006;"PASSOS MAIA (SC)";"SC";"PASSOS MAIA";80;2;22;104
2006;"PAULO LOPES (SC)";"SC";"PAULO LOPES";186;7;9;202
2006;"PEDRAS GRANDES (SC)";"SC";"PEDRAS GRANDES";211;8;9;228
2006;"PENHA (SC)";"SC";"PENHA";252;19;26;297
2006;"PERITIBA (SC)";"SC";"PERITIBA";71;3;9;83
2006;"PETROLANDIA (SC)";"SC";"PETROLANDIA";133;5;21;159
2006;"PICARRAS (SC)";"SC";"PICARRAS";212;15;14;241
2006;"PINHALZINHO (SC)";"SC";"PINHALZINHO";323;15;33;371
2006;"PINHEIRO PRETO (SC)";"SC";"PINHEIRO PRETO";221;6;6;233
2006;"PIRATUBA (SC)";"SC";"PIRATUBA";68;8;16;92
2006;"PLANALTO ALEGRE (SC)";"SC";"PLANALTO ALEGRE";44;5;4;53
2006;"POMERODE (SC)";"SC";"POMERODE";445;26;87;558
2006;"PONTE ALTA (SC)";"SC";"PONTE ALTA";105;4;10;119
2006;"PONTE ALTA DO NORTE (SC)";"SC";"PONTE ALTA DO NORTE";57;2;10;69
2006;"PONTE SERRADA (SC)";"SC";"PONTE SERRADA";253;17;45;315
2006;"PORTO BELO (SC)";"SC";"PORTO BELO";147;14;16;177
2006;"PORTO UNIAO (SC)";"SC";"PORTO UNIAO";474;15;36;525
2006;"POUSO REDONDO (SC)";"SC";"POUSO REDONDO";325;11;22;358
2006;"PRAIA GRANDE (SC)";"SC";"PRAIA GRANDE";174;10;19;203
2006;"PRESIDENTE CASTELO BRANCO (SC)";"SC";"PRESIDENTE CASTELO BRANCO";31;3;7;41
2006;"PRESIDENTE GETULIO (SC)";"SC";"PRESIDENTE GETULIO";239;19;61;319
2006;"PRESIDENTE NEREU (SC)";"SC";"PRESIDENTE NEREU";19;5;4;28
2006;"PRINCESA (SC)";"SC";"PRINCESA";30;1;8;39
2006;"QUILOMBO (SC)";"SC";"QUILOMBO";165;12;26;203
2006;"RANCHO QUEIMADO (SC)";"SC";"RANCHO QUEIMADO";104;5;4;113
2006;"RIO DAS ANTAS (SC)";"SC";"RIO DAS ANTAS";169;7;18;194
2006;"RIO DO CAMPO (SC)";"SC";"RIO DO CAMPO";131;7;15;153
2006;"RIO DO OESTE (SC)";"SC";"RIO DO OESTE";136;11;18;165
2006;"RIO DO SUL (SC)";"SC";"RIO DO SUL";1243;52;111;1406
2006;"RIO DOS CEDROS (SC)";"SC";"RIO DOS CEDROS";205;14;24;243
2006;"RIO FORTUNA (SC)";"SC";"RIO FORTUNA";206;7;10;223
2006;"RIO NEGRINHO (SC)";"SC";"RIO NEGRINHO";823;46;59;928
2006;"RIO RUFINO (SC)";"SC";"RIO RUFINO";26;5;9;40
2006;"RIQUEZA (SC)";"SC";"RIQUEZA";81;1;16;98
2006;"RODEIO (SC)";"SC";"RODEIO";173;7;13;193
2006;"ROMELANDIA (SC)";"SC";"ROMELANDIA";79;5;15;99
2006;"SALETE (SC)";"SC";"SALETE";145;10;14;169
2006;"SALTINHO (SC)";"SC";"SALTINHO";37;1;17;55
2006;"SALTO VELOSO (SC)";"SC";"SALTO VELOSO";109;4;4;117
2006;"SANGAO (SC)";"SC";"SANGAO";327;6;10;343
2006;"SANTA CECILIA (SC)";"SC";"SANTA CECILIA";310;16;30;356
2006;"SANTA HELENA (SC)";"SC";"SANTA HELENA";46;10;5;61
2006;"SANTA ROSA DE LIMA (SC)";"SC";"SANTA ROSA DE LIMA";86;5;5;96
2006;"SANTA ROSA DO SUL (SC)";"SC";"SANTA ROSA DO SUL";219;8;12;239
2006;"SANTA TEREZINHA (SC)";"SC";"SANTA TEREZINHA";118;8;18;144
2006;"SANTA TEREZINHA DO PROGRESSO (SC)";"SC";"SANTA TEREZINHA DO PROGRESSO";31;2;12;45
2006;"SANTIAGO DO SUL (SC)";"SC";"SANTIAGO DO SUL";32;4;2;38
2006;"SANTO AMARO DA IMPERATRIZ (SC)";"SC";"SANTO AMARO DA IMPERATRIZ";471;23;61;555
2006;"SAO BENTO DO SUL (SC)";"SC";"SAO BENTO DO SUL";1154;107;135;1396
2006;"SAO BERNARDINO (SC)";"SC";"SAO BERNARDINO";31;2;17;50
2006;"SAO BONIFACIO (SC)";"SC";"SAO BONIFACIO";98;4;7;109
2006;"SAO CARLOS (SC)";"SC";"SAO CARLOS";155;11;36;202
2006;"SAO CRISTOVAO DO SUL (SC)";"SC";"SAO CRISTOVAO DO SUL";96;1;9;106
2006;"SAO DOMINGOS (SC)";"SC";"SAO DOMINGOS";233;10;32;275
2006;"SAO FRANCISCO DO SUL (SC)";"SC";"SAO FRANCISCO DO SUL";490;31;54;575
2006;"SAO JOAO BATISTA (SC)";"SC";"SAO JOAO BATISTA";401;11;29;441
2006;"SAO JOAO DO ITAPERIU (SC)";"SC";"SAO JOAO DO ITAPERIU";145;2;5;152
2006;"SAO JOAO DO OESTE (SC)";"SC";"SAO JOAO DO OESTE";124;7;6;137
2006;"SAO JOAO DO SUL (SC)";"SC";"SAO JOAO DO SUL";173;5;7;185
2006;"SAO JOAQUIM (SC)";"SC";"SAO JOAQUIM";646;35;148;829
2006;"SAO JOSE (SC)";"SC";"SAO JOSE";2854;229;171;3254
2006;"SAO JOSE DO CEDRO (SC)";"SC";"SAO JOSE DO CEDRO";305;12;109;426
2006;"SAO JOSE DO CERRITO (SC)";"SC";"SAO JOSE DO CERRITO";108;4;28;140
2006;"SAO LOURENCO D OESTE (SC)";"SC";"SAO LOURENCO D OESTE";661;20;47;728
2006;"SAO LUDGERO (SC)";"SC";"SAO LUDGERO";476;7;18;501
2006;"SAO MARTINHO (SC)";"SC";"SAO MARTINHO";115;7;6;128
2006;"SAO MIGUEL D OESTE (SC)";"SC";"SAO MIGUEL D OESTE";817;27;103;947
2006;"SAO MIGUEL DA BOA VISTA (SC)";"SC";"SAO MIGUEL DA BOA VISTA";14;4;6;24
2006;"SAO PEDRO DE ALCANTARA (SC)";"SC";"SAO PEDRO DE ALCANTARA";106;5;4;115
2006;"SAUDADES (SC)";"SC";"SAUDADES";133;6;32;171
2006;"SCHROEDER (SC)";"SC";"SCHROEDER";148;4;18;170
2006;"SEARA (SC)";"SC";"SEARA";307;24;53;384
2006;"SERRA ALTA (SC)";"SC";"SERRA ALTA";45;6;10;61
2006;"SIDEROPOLIS (SC)";"SC";"SIDEROPOLIS";350;16;49;415
2006;"SOMBRIO (SC)";"SC";"SOMBRIO";625;39;29;693
2006;"SUL BRASIL (SC)";"SC";"SUL BRASIL";32;5;7;44
2006;"TAIO (SC)";"SC";"TAIO";434;9;35;478
2006;"TANGARA (SC)";"SC";"TANGARA";321;5;31;357
2006;"TIGRINHOS (SC)";"SC";"TIGRINHOS";14;3;11;28
2006;"TIJUCAS (SC)";"SC";"TIJUCAS";633;33;40;706
2006;"TIMBE DO SUL (SC)";"SC";"TIMBE DO SUL";129;5;8;142
2006;"TIMBO (SC)";"SC";"TIMBO";521;45;42;608
2006;"TIMBO GRANDE (SC)";"SC";"TIMBO GRANDE";122;3;12;137
2006;"TRES BARRAS (SC)";"SC";"TRES BARRAS";232;18;41;291
2006;"TREVISO (SC)";"SC";"TREVISO";71;7;4;82
2006;"TREZE DE MAIO (SC)";"SC";"TREZE DE MAIO";340;6;13;359
2006;"TREZE TILIAS (SC)";"SC";"TREZE TILIAS";195;12;10;217
2006;"TROMBUDO CENTRAL (SC)";"SC";"TROMBUDO CENTRAL";192;9;7;208
2006;"TUBARAO (SC)";"SC";"TUBARAO";1946;70;351;2367
2006;"TUNAPOLIS (SC)";"SC";"TUNAPOLIS";65;5;22;92
2006;"TURVO (SC)";"SC";"TURVO";306;9;19;334
2006;"UNIAO DO OESTE (SC)";"SC";"UNIAO DO OESTE";54;2;9;65
2006;"URUBICI (SC)";"SC";"URUBICI";186;6;27;219
2006;"URUPEMA (SC)";"SC";"URUPEMA";41;5;6;52
2006;"URUSSANGA (SC)";"SC";"URUSSANGA";338;24;79;441
2006;"VARGEAO (SC)";"SC";"VARGEAO";94;1;9;104
2006;"VARGEM (SC)";"SC";"VARGEM";37;2;8;47
2006;"VARGEM BONITA (SC)";"SC";"VARGEM BONITA";141;12;26;179
2006;"VIDAL RAMOS (SC)";"SC";"VIDAL RAMOS";113;7;7;127
2006;"VIDEIRA (SC)";"SC";"VIDEIRA";1269;75;89;1433
2006;"VITOR MEIRELES (SC)";"SC";"VITOR MEIRELES";68;7;12;87
2006;"WITMARSUM (SC)";"SC";"WITMARSUM";67;8;6;81
2006;"XANXERE (SC)";"SC";"XANXERE";1062;70;98;1230
2006;"XAVANTINA (SC)";"SC";"XAVANTINA";130;15;4;149
2006;"XAXIM (SC)";"SC";"XAXIM";583;31;92;706
2006;"ZORTEA (SC)";"SC";"ZORTEA";34;5;4;43
2006;"AMPARO DE SAO FRANCISCO (SE)";"SE";"AMPARO DE SAO FRANCISCO";4;4;1;9
2006;"AQUIDABA (SE)";"SE";"AQUIDABA";93;5;30;128
2006;"ARACAJU (SE)";"SE";"ARACAJU";4278;712;1493;6483
2006;"ARAUA (SE)";"SE";"ARAUA";43;10;14;67
2006;"AREIA BRANCA (SE)";"SE";"AREIA BRANCA";108;8;13;129
2006;"BARRA DOS COQUEIROS (SE)";"SE";"BARRA DOS COQUEIROS";33;5;17;55
2006;"BOQUIM (SE)";"SE";"BOQUIM";174;11;23;208
2006;"BREJO GRANDE (SE)";"SE";"BREJO GRANDE";4;3;5;12
2006;"CAMPO DO BRITO (SE)";"SE";"CAMPO DO BRITO";223;16;31;270
2006;"CANHOBA (SE)";"SE";"CANHOBA";4;2;2;8
2006;"CANINDE DE SAO FRANCISCO (SE)";"SE";"CANINDE DE SAO FRANCISCO";101;13;12;126
2006;"CAPELA (SE)";"SE";"CAPELA";66;14;29;109
2006;"CARIRA (SE)";"SE";"CARIRA";166;39;42;247
2006;"CARMOPOLIS (SE)";"SE";"CARMOPOLIS";79;22;21;122
2006;"CEDRO DE SAO JOAO (SE)";"SE";"CEDRO DE SAO JOAO";20;6;0;26
2006;"CRISTINAPOLIS (SE)";"SE";"CRISTINAPOLIS";52;21;14;87
2006;"CUMBE (SE)";"SE";"CUMBE";14;3;2;19
2006;"DIVINA PASTORA (SE)";"SE";"DIVINA PASTORA";8;7;1;16
2006;"ESTANCIA (SE)";"SE";"ESTANCIA";300;105;104;509
2006;"FEIRA NOVA (SE)";"SE";"FEIRA NOVA";7;5;3;15
2006;"FREI PAULO (SE)";"SE";"FREI PAULO";72;17;16;105
2006;"GARARU (SE)";"SE";"GARARU";23;3;15;41
2006;"GENERAL MAYNARD (SE)";"SE";"GENERAL MAYNARD";10;17;19;46
2006;"GRACCHO CARDOSO (SE)";"SE";"GRACCHO CARDOSO";17;3;6;26
2006;"ILHA DAS FLORES (SE)";"SE";"ILHA DAS FLORES";8;5;4;17
2006;"INDIAROBA (SE)";"SE";"INDIAROBA";27;12;8;47
2006;"ITABAIANA (SE)";"SE";"ITABAIANA";2303;99;83;2485
2006;"ITABAIANINHA (SE)";"SE";"ITABAIANINHA";311;40;32;383
2006;"ITABI (SE)";"SE";"ITABI";16;3;4;23
2006;"ITAPORANGA D AJUDA (SE)";"SE";"ITAPORANGA D AJUDA";162;18;26;206
2006;"JAPARATUBA (SE)";"SE";"JAPARATUBA";32;16;33;81
2006;"JAPOATA (SE)";"SE";"JAPOATA";35;5;17;57
2006;"LAGARTO (SE)";"SE";"LAGARTO";683;110;126;919
2006;"LARANJEIRAS (SE)";"SE";"LARANJEIRAS";82;12;32;126
2006;"MACAMBIRA (SE)";"SE";"MACAMBIRA";32;14;6;52
2006;"MALHADA DOS BOIS (SE)";"SE";"MALHADA DOS BOIS";12;5;3;20
2006;"MALHADOR (SE)";"SE";"MALHADOR";126;22;24;172
2006;"MARUIM (SE)";"SE";"MARUIM";32;10;12;54
2006;"MOITA BONITA (SE)";"SE";"MOITA BONITA";311;22;9;342
2006;"MONTE ALEGRE DE SERGIPE (SE)";"SE";"MONTE ALEGRE DE SERGIPE";68;14;13;95
2006;"MURIBECA (SE)";"SE";"MURIBECA";12;7;20;39
2006;"NEOPOLIS (SE)";"SE";"NEOPOLIS";34;8;12;54
2006;"NOSSA SENHORA APARECIDA (SE)";"SE";"NOSSA SENHORA APARECIDA";103;13;6;122
2006;"NOSSA SENHORA DA GLORIA (SE)";"SE";"NOSSA SENHORA DA GLORIA";293;15;51;359
2006;"NOSSA SENHORA DAS DORES (SE)";"SE";"NOSSA SENHORA DAS DORES";98;20;37;155
2006;"NOSSA SENHORA DE LOURDES (SE)";"SE";"NOSSA SENHORA DE LOURDES";20;4;7;31
2006;"NOSSA SENHORA DO SOCORRO (SE)";"SE";"NOSSA SENHORA DO SOCORRO";484;39;83;606
2006;"PACATUBA (SE)";"SE";"PACATUBA";23;3;19;45
2006;"PEDRA MOLE (SE)";"SE";"PEDRA MOLE";8;4;2;14
2006;"PEDRINHAS (SE)";"SE";"PEDRINHAS";46;4;2;52
2006;"PINHAO (SE)";"SE";"PINHAO";17;19;1;37
2006;"PIRAMBU (SE)";"SE";"PIRAMBU";12;8;13;33
2006;"POCO REDONDO (SE)";"SE";"POCO REDONDO";69;8;31;108
2006;"POCO VERDE (SE)";"SE";"POCO VERDE";68;19;45;132
2006;"PORTO DA FOLHA (SE)";"SE";"PORTO DA FOLHA";58;14;23;95
2006;"PROPRIA (SE)";"SE";"PROPRIA";174;19;46;239
2006;"RIACHAO DO DANTAS (SE)";"SE";"RIACHAO DO DANTAS";17;7;15;39
2006;"RIACHUELO (SE)";"SE";"RIACHUELO";22;5;12;39
2006;"RIBEIROPOLIS (SE)";"SE";"RIBEIROPOLIS";230;43;27;300
2006;"ROSARIO DO CATETE (SE)";"SE";"ROSARIO DO CATETE";25;23;14;62
2006;"SALGADO (SE)";"SE";"SALGADO";81;17;34;132
2006;"SANTA LUZIA DO ITANHY (SE)";"SE";"SANTA LUZIA DO ITANHY";12;5;6;23
2006;"SANTA ROSA DE LIMA (SE)";"SE";"SANTA ROSA DE LIMA";13;4;4;21
2006;"SANTANA DO SAO FRANCISCO (SE)";"SE";"SANTANA DO SAO FRANCISCO";3;3;4;10
2006;"SANTO AMARO DAS BROTAS (SE)";"SE";"SANTO AMARO DAS BROTAS";13;4;8;25
2006;"SAO CRISTOVAO (SE)";"SE";"SAO CRISTOVAO";218;49;53;320
2006;"SAO DOMINGOS (SE)";"SE";"SAO DOMINGOS";96;13;8;117
2006;"SAO FRANCISCO (SE)";"SE";"SAO FRANCISCO";14;3;15;32
2006;"SAO MIGUEL DO ALEIXO (SE)";"SE";"SAO MIGUEL DO ALEIXO";24;8;5;37
2006;"SIMAO DIAS (SE)";"SE";"SIMAO DIAS";166;35;138;339
2006;"SIRIRI (SE)";"SE";"SIRIRI";28;8;15;51
2006;"TELHA (SE)";"SE";"TELHA";6;1;4;11
2006;"TOBIAS BARRETO (SE)";"SE";"TOBIAS BARRETO";171;43;80;294
2006;"TOMAR DO GERU (SE)";"SE";"TOMAR DO GERU";30;11;9;50
2006;"UMBAUBA (SE)";"SE";"UMBAUBA";211;28;23;262
2006;"ADAMANTINA (SP)";"SP";"ADAMANTINA";622;41;51;714
2006;"ADOLFO (SP)";"SP";"ADOLFO";60;3;22;85
2006;"AGUAI (SP)";"SP";"AGUAI";638;26;97;761
2006;"AGUAS DA PRATA (SP)";"SP";"AGUAS DA PRATA";100;11;6;117
2006;"AGUAS DE LINDOIA (SP)";"SP";"AGUAS DE LINDOIA";133;31;30;194
2006;"AGUAS DE SANTA BARBARA (SP)";"SP";"AGUAS DE SANTA BARBARA";87;5;14;106
2006;"AGUAS DE SAO PEDRO (SP)";"SP";"AGUAS DE SAO PEDRO";25;7;2;34
2006;"AGUDOS (SP)";"SP";"AGUDOS";435;32;59;526
2006;"ALAMBARI (SP)";"SP";"ALAMBARI";65;8;2;75
2006;"ALFREDO MARCONDES (SP)";"SP";"ALFREDO MARCONDES";45;3;7;55
2006;"ALTAIR (SP)";"SP";"ALTAIR";58;4;26;88
2006;"ALTINOPOLIS (SP)";"SP";"ALTINOPOLIS";302;18;74;394
2006;"ALTO ALEGRE (SP)";"SP";"ALTO ALEGRE";65;2;31;98
2006;"ALUMINIO (SP)";"SP";"ALUMINIO";169;19;34;222
2006;"ALVARES FLORENCE (SP)";"SP";"ALVARES FLORENCE";54;2;14;70
2006;"ALVARES MACHADO (SP)";"SP";"ALVARES MACHADO";365;13;30;408
2006;"ALVARO DE CARVALHO (SP)";"SP";"ALVARO DE CARVALHO";18;3;13;34
2006;"ALVINLANDIA (SP)";"SP";"ALVINLANDIA";31;2;8;41
2006;"AMERICANA (SP)";"SP";"AMERICANA";2703;324;735;3762
2006;"AMERICO BRASILIENSE (SP)";"SP";"AMERICO BRASILIENSE";553;26;197;776
2006;"AMERICO DE CAMPOS (SP)";"SP";"AMERICO DE CAMPOS";128;4;16;148
2006;"AMPARO (SP)";"SP";"AMPARO";1124;146;95;1365
2006;"ANALANDIA (SP)";"SP";"ANALANDIA";53;6;12;71
2006;"ANDRADINA (SP)";"SP";"ANDRADINA";794;29;85;908
2006;"ANGATUBA (SP)";"SP";"ANGATUBA";322;34;52;408
2006;"ANHEMBI (SP)";"SP";"ANHEMBI";48;9;7;64
2006;"ANHUMAS (SP)";"SP";"ANHUMAS";60;4;4;68
2006;"APARECIDA (SP)";"SP";"APARECIDA";764;46;530;1340
2006;"APARECIDA D OESTE (SP)";"SP";"APARECIDA D OESTE";80;8;17;105
2006;"APIAI (SP)";"SP";"APIAI";231;28;58;317
2006;"ARACARIGUAMA (SP)";"SP";"ARACARIGUAMA";326;32;30;388
2006;"ARACATUBA (SP)";"SP";"ARACATUBA";2649;153;520;3322
2006;"ARACOIABA DA SERRA (SP)";"SP";"ARACOIABA DA SERRA";342;35;15;392
2006;"ARAMINA (SP)";"SP";"ARAMINA";64;4;13;81
2006;"ARANDU (SP)";"SP";"ARANDU";36;10;8;54
2006;"ARAPEI (SP)";"SP";"ARAPEI";30;4;6;40
2006;"ARARAQUARA (SP)";"SP";"ARARAQUARA";2670;298;772;3740
2006;"ARARAS (SP)";"SP";"ARARAS";1836;165;196;2197
2006;"ARCO IRIS (SP)";"SP";"ARCO IRIS";41;3;8;52
2006;"AREALVA (SP)";"SP";"AREALVA";140;6;14;160
2006;"AREIAS (SP)";"SP";"AREIAS";34;3;3;40
2006;"AREIOPOLIS (SP)";"SP";"AREIOPOLIS";105;8;44;157
2006;"ARIRANHA (SP)";"SP";"ARIRANHA";226;16;91;333
2006;"ARTUR NOGUEIRA (SP)";"SP";"ARTUR NOGUEIRA";738;67;122;927
2006;"ARUJA (SP)";"SP";"ARUJA";1659;153;248;2060
2006;"ASPASIA (SP)";"SP";"ASPASIA";25;1;2;28
2006;"ASSIS (SP)";"SP";"ASSIS";1362;96;294;1752
2006;"ATIBAIA (SP)";"SP";"ATIBAIA";1703;197;189;2089
2006;"AURIFLAMA (SP)";"SP";"AURIFLAMA";289;11;35;335
2006;"AVAI (SP)";"SP";"AVAI";48;5;17;70
2006;"AVANHANDAVA (SP)";"SP";"AVANHANDAVA";111;6;29;146
2006;"AVARE (SP)";"SP";"AVARE";995;72;222;1289
2006;"BADY BASSITT (SP)";"SP";"BADY BASSITT";223;21;21;265
2006;"BALBINOS (SP)";"SP";"BALBINOS";11;1;5;17
2006;"BALSAMO (SP)";"SP";"BALSAMO";148;4;12;164
2006;"BANANAL (SP)";"SP";"BANANAL";96;10;19;125
2006;"BARAO DE ANTONINA (SP)";"SP";"BARAO DE ANTONINA";18;2;10;30
2006;"BARBOSA (SP)";"SP";"BARBOSA";78;4;17;99
2006;"BARIRI (SP)";"SP";"BARIRI";689;21;68;778
2006;"BARRA BONITA (SP)";"SP";"BARRA BONITA";1051;52;167;1270
2006;"BARRA DO CHAPEU (SP)";"SP";"BARRA DO CHAPEU";27;3;6;36
2006;"BARRA DO TURVO (SP)";"SP";"BARRA DO TURVO";44;3;26;73
2006;"BARRETOS (SP)";"SP";"BARRETOS";1646;92;372;2110
2006;"BARRINHA (SP)";"SP";"BARRINHA";302;22;123;447
2006;"BARUERI (SP)";"SP";"BARUERI";3364;467;742;4573
2006;"BASTOS (SP)";"SP";"BASTOS";591;15;56;662
2006;"BATATAIS (SP)";"SP";"BATATAIS";910;34;128;1072
2006;"BAURU (SP)";"SP";"BAURU";3988;360;917;5265
2006;"BEBEDOURO (SP)";"SP";"BEBEDOURO";1477;81;194;1752
2006;"BENTO DE ABREU (SP)";"SP";"BENTO DE ABREU";72;4;11;87
2006;"BERNARDINO DE CAMPOS (SP)";"SP";"BERNARDINO DE CAMPOS";254;15;25;294
2006;"BERTIOGA (SP)";"SP";"BERTIOGA";352;39;62;453
2006;"BILAC (SP)";"SP";"BILAC";100;6;20;126
2006;"BIRIGUI (SP)";"SP";"BIRIGUI";1271;42;96;1409
2006;"BIRITIBA MIRIM (SP)";"SP";"BIRITIBA MIRIM";239;13;19;271
2006;"BOA ESPERANCA DO SUL (SP)";"SP";"BOA ESPERANCA DO SUL";341;16;71;428
2006;"BOCAINA (SP)";"SP";"BOCAINA";183;26;31;240
2006;"BOFETE (SP)";"SP";"BOFETE";136;10;28;174
2006;"BOITUVA (SP)";"SP";"BOITUVA";800;54;82;936
2006;"BOM JESUS DOS PERDOES (SP)";"SP";"BOM JESUS DOS PERDOES";285;36;18;339
2006;"BOM SUCESSO DE ITARARE (SP)";"SP";"BOM SUCESSO DE ITARARE";48;9;4;61
2006;"BORA (SP)";"SP";"BORA";19;0;3;22
2006;"BORACEIA (SP)";"SP";"BORACEIA";186;3;13;202
2006;"BORBOREMA (SP)";"SP";"BORBOREMA";255;8;49;312
2006;"BOREBI (SP)";"SP";"BOREBI";28;4;5;37
2006;"BOTUCATU (SP)";"SP";"BOTUCATU";1271;158;344;1773
2006;"BRAGANCA PAULISTA (SP)";"SP";"BRAGANCA PAULISTA";2048;185;205;2438
2006;"BRAUNA (SP)";"SP";"BRAUNA";57;1;24;82
2006;"BREJO ALEGRE (SP)";"SP";"BREJO ALEGRE";36;0;7;43
2006;"BRODOSQUI (SP)";"SP";"BRODOSQUI";409;13;29;451
2006;"BROTAS (SP)";"SP";"BROTAS";406;27;98;531
2006;"BURI (SP)";"SP";"BURI";280;19;37;336
2006;"BURITAMA (SP)";"SP";"BURITAMA";230;19;29;278
2006;"BURITIZAL (SP)";"SP";"BURITIZAL";86;10;27;123
2006;"CABRALIA PAULISTA (SP)";"SP";"CABRALIA PAULISTA";107;2;6;115
2006;"CABREUVA (SP)";"SP";"CABREUVA";809;72;53;934
2006;"CACAPAVA (SP)";"SP";"CACAPAVA";614;163;83;860
2006;"CACHOEIRA PAULISTA (SP)";"SP";"CACHOEIRA PAULISTA";269;28;11;308
2006;"CACONDE (SP)";"SP";"CACONDE";174;17;62;253
2006;"CAFELANDIA (SP)";"SP";"CAFELANDIA";209;10;35;254
2006;"CAIABU (SP)";"SP";"CAIABU";32;5;26;63
2006;"CAIEIRAS (SP)";"SP";"CAIEIRAS";666;127;353;1146
2006;"CAIUA (SP)";"SP";"CAIUA";45;4;11;60
2006;"CAJAMAR (SP)";"SP";"CAJAMAR";769;63;90;922
2006;"CAJATI (SP)";"SP";"CAJATI";303;27;51;381
2006;"CAJOBI (SP)";"SP";"CAJOBI";284;4;62;350
2006;"CAJURU (SP)";"SP";"CAJURU";378;11;86;475
2006;"CAMPINA DO MONTE ALEGRE (SP)";"SP";"CAMPINA DO MONTE ALEGRE";61;10;21;92
2006;"CAMPINAS (SP)";"SP";"CAMPINAS";13485;2460;3698;19643
2006;"CAMPO LIMPO PAULISTA (SP)";"SP";"CAMPO LIMPO PAULISTA";421;79;19;519
2006;"CAMPOS DO JORDAO (SP)";"SP";"CAMPOS DO JORDAO";485;126;38;649
2006;"CAMPOS NOVOS PAULISTA (SP)";"SP";"CAMPOS NOVOS PAULISTA";75;2;19;96
2006;"CANANEIA (SP)";"SP";"CANANEIA";55;3;8;66
2006;"CANAS (SP)";"SP";"CANAS";34;3;4;41
2006;"CANDIDO MOTA (SP)";"SP";"CANDIDO MOTA";681;12;41;734
2006;"CANDIDO RODRIGUES (SP)";"SP";"CANDIDO RODRIGUES";96;5;4;105
2006;"CANITAR (SP)";"SP";"CANITAR";45;6;22;73
2006;"CAPAO BONITO (SP)";"SP";"CAPAO BONITO";748;70;109;927
2006;"CAPELA DO ALTO (SP)";"SP";"CAPELA DO ALTO";300;15;23;338
2006;"CAPIVARI (SP)";"SP";"CAPIVARI";988;57;146;1191
2006;"CARAGUATATUBA (SP)";"SP";"CARAGUATATUBA";936;86;83;1105
2006;"CARAPICUIBA (SP)";"SP";"CARAPICUIBA";1817;373;669;2859
2006;"CARDOSO (SP)";"SP";"CARDOSO";146;7;32;185
2006;"CASA BRANCA (SP)";"SP";"CASA BRANCA";389;44;60;493
2006;"CASSIA DOS COQUEIROS (SP)";"SP";"CASSIA DOS COQUEIROS";12;3;7;22
2006;"CASTILHO (SP)";"SP";"CASTILHO";157;16;68;241
2006;"CATANDUVA (SP)";"SP";"CATANDUVA";2464;151;375;2990
2006;"CATIGUA (SP)";"SP";"CATIGUA";110;4;28;142
2006;"CEDRAL (SP)";"SP";"CEDRAL";231;9;10;250
2006;"CERQUEIRA CESAR (SP)";"SP";"CERQUEIRA CESAR";230;20;53;303
2006;"CERQUILHO (SP)";"SP";"CERQUILHO";726;64;65;855
2006;"CESARIO LANGE (SP)";"SP";"CESARIO LANGE";259;28;29;316
2006;"CHARQUEADA (SP)";"SP";"CHARQUEADA";355;20;66;441
2006;"CHAVANTES (SP)";"SP";"CHAVANTES";127;9;30;166
2006;"CLEMENTINA (SP)";"SP";"CLEMENTINA";178;2;40;220
2006;"COLINA (SP)";"SP";"COLINA";344;7;63;414
2006;"COLOMBIA (SP)";"SP";"COLOMBIA";106;9;52;167
2006;"CONCHAL (SP)";"SP";"CONCHAL";587;25;130;742
2006;"CONCHAS (SP)";"SP";"CONCHAS";260;20;24;304
2006;"CORDEIROPOLIS (SP)";"SP";"CORDEIROPOLIS";532;45;30;607
2006;"COROADOS (SP)";"SP";"COROADOS";62;3;14;79
2006;"CORONEL MACEDO (SP)";"SP";"CORONEL MACEDO";51;6;21;78
2006;"CORUMBATAI (SP)";"SP";"CORUMBATAI";125;12;7;144
2006;"COSMOPOLIS (SP)";"SP";"COSMOPOLIS";564;113;197;874
2006;"COSMORAMA (SP)";"SP";"COSMORAMA";129;4;27;160
2006;"COTIA (SP)";"SP";"COTIA";1777;606;228;2611
2006;"CRAVINHOS (SP)";"SP";"CRAVINHOS";767;53;103;923
2006;"CRISTAIS PAULISTA (SP)";"SP";"CRISTAIS PAULISTA";75;1;16;92
2006;"CRUZALIA (SP)";"SP";"CRUZALIA";72;9;4;85
2006;"CRUZEIRO (SP)";"SP";"CRUZEIRO";543;52;37;632
2006;"CUBATAO (SP)";"SP";"CUBATAO";1761;273;296;2330
2006;"CUNHA (SP)";"SP";"CUNHA";197;19;21;237
2006;"DESCALVADO (SP)";"SP";"DESCALVADO";747;41;117;905
2006;"DIADEMA (SP)";"SP";"DIADEMA";3099;516;464;4079
2006;"DIRCE REIS (SP)";"SP";"DIRCE REIS";50;2;4;56
2006;"DIVINOLANDIA (SP)";"SP";"DIVINOLANDIA";384;13;23;420
2006;"DOBRADA (SP)";"SP";"DOBRADA";63;4;47;114
2006;"DOIS CORREGOS (SP)";"SP";"DOIS CORREGOS";547;23;97;667
2006;"DOLCINOPOLIS (SP)";"SP";"DOLCINOPOLIS";20;4;3;27
2006;"DOURADO (SP)";"SP";"DOURADO";153;13;33;199
2006;"DRACENA (SP)";"SP";"DRACENA";887;23;124;1034
2006;"DUARTINA (SP)";"SP";"DUARTINA";204;16;36;256
2006;"DUMONT (SP)";"SP";"DUMONT";256;9;38;303
2006;"ECHAPORA (SP)";"SP";"ECHAPORA";97;2;15;114
2006;"ELDORADO (SP)";"SP";"ELDORADO";177;7;38;222
2006;"ELIAS FAUSTO (SP)";"SP";"ELIAS FAUSTO";254;14;41;309
2006;"ELISIARIO (SP)";"SP";"ELISIARIO";55;3;6;64
2006;"EMBAUBA (SP)";"SP";"EMBAUBA";92;2;22;116
2006;"EMBU (SP)";"SP";"EMBU";1323;361;454;2138
2006;"EMBU GUACU (SP)";"SP";"EMBU GUACU";801;122;130;1053
2006;"EMILIANOPOLIS (SP)";"SP";"EMILIANOPOLIS";45;2;9;56
2006;"ENGENHEIRO COELHO (SP)";"SP";"ENGENHEIRO COELHO";255;19;99;373
2006;"ESPIRITO SANTO DO PINHAL (SP)";"SP";"ESPIRITO SANTO DO PINHAL";537;72;60;669
2006;"ESPIRITO SANTO DO TURVO (SP)";"SP";"ESPIRITO SANTO DO TURVO";89;14;26;129
2006;"ESTIVA GERBI (SP)";"SP";"ESTIVA GERBI";195;7;15;217
2006;"ESTRELA D OESTE (SP)";"SP";"ESTRELA D OESTE";238;5;14;257
2006;"ESTRELA DO NORTE (SP)";"SP";"ESTRELA DO NORTE";17;3;6;26
2006;"EUCLIDES DA CUNHA PAULISTA (SP)";"SP";"EUCLIDES DA CUNHA PAULISTA";69;5;27;101
2006;"FARTURA (SP)";"SP";"FARTURA";201;13;20;234
2006;"FERNANDO PRESTES (SP)";"SP";"FERNANDO PRESTES";200;7;8;215
2006;"FERNANDOPOLIS (SP)";"SP";"FERNANDOPOLIS";1088;37;123;1248
2006;"FERNAO (SP)";"SP";"FERNAO";15;1;4;20
2006;"FERRAZ DE VASCONCELOS (SP)";"SP";"FERRAZ DE VASCONCELOS";880;122;171;1173
2006;"FLORA RICA (SP)";"SP";"FLORA RICA";18;1;7;26
2006;"FLOREAL (SP)";"SP";"FLOREAL";44;6;6;56
2006;"FLORIDA PAULISTA (SP)";"SP";"FLORIDA PAULISTA";274;5;82;361
2006;"FLORINEA (SP)";"SP";"FLORINEA";34;4;5;43
2006;"FRANCA (SP)";"SP";"FRANCA";2362;229;414;3005
2006;"FRANCISCO MORATO (SP)";"SP";"FRANCISCO MORATO";362;91;143;596
2006;"FRANCO DA ROCHA (SP)";"SP";"FRANCO DA ROCHA";446;109;115;670
2006;"GABRIEL MONTEIRO (SP)";"SP";"GABRIEL MONTEIRO";43;2;9;54
2006;"GALIA (SP)";"SP";"GALIA";107;5;23;135
2006;"GARCA (SP)";"SP";"GARCA";625;37;92;754
2006;"GASTAO VIDIGAL (SP)";"SP";"GASTAO VIDIGAL";61;2;19;82
2006;"GAVIAO PEIXOTO (SP)";"SP";"GAVIAO PEIXOTO";44;4;17;65
2006;"GENERAL SALGADO (SP)";"SP";"GENERAL SALGADO";234;7;54;295
2006;"GETULINA (SP)";"SP";"GETULINA";133;2;49;184
2006;"GLICERIO (SP)";"SP";"GLICERIO";83;2;24;109
2006;"GUAICARA (SP)";"SP";"GUAICARA";57;5;17;79
2006;"GUAIMBE (SP)";"SP";"GUAIMBE";96;3;16;115
2006;"GUAIRA (SP)";"SP";"GUAIRA";864;23;92;979
2006;"GUAPIACU (SP)";"SP";"GUAPIACU";375;12;72;459
2006;"GUAPIARA (SP)";"SP";"GUAPIARA";255;11;33;299
2006;"GUARA (SP)";"SP";"GUARA";215;14;113;342
2006;"GUARACAI (SP)";"SP";"GUARACAI";280;4;19;303
2006;"GUARACI (SP)";"SP";"GUARACI";113;3;46;162
2006;"GUARANI D OESTE (SP)";"SP";"GUARANI D OESTE";23;2;9;34
2006;"GUARANTA (SP)";"SP";"GUARANTA";80;1;25;106
2006;"GUARARAPES (SP)";"SP";"GUARARAPES";618;23;106;747
2006;"GUARAREMA (SP)";"SP";"GUARAREMA";226;28;15;269
2006;"GUARATINGUETA (SP)";"SP";"GUARATINGUETA";845;164;197;1206
2006;"GUAREI (SP)";"SP";"GUAREI";193;19;29;241
2006;"GUARIBA (SP)";"SP";"GUARIBA";753;29;216;998
2006;"GUARUJA (SP)";"SP";"GUARUJA";1559;355;307;2221
2006;"GUARULHOS (SP)";"SP";"GUARULHOS";13594;2594;2423;18611
2006;"GUATAPARA (SP)";"SP";"GUATAPARA";115;6;38;159
2006;"GUZOLANDIA (SP)";"SP";"GUZOLANDIA";53;3;28;84
2006;"HERCULANDIA (SP)";"SP";"HERCULANDIA";334;3;19;356
2006;"HOLAMBRA (SP)";"SP";"HOLAMBRA";344;20;46;410
2006;"HORTOLANDIA (SP)";"SP";"HORTOLANDIA";1057;202;210;1469
2006;"IACANGA (SP)";"SP";"IACANGA";149;7;20;176
2006;"IACRI (SP)";"SP";"IACRI";115;2;13;130
2006;"IARAS (SP)";"SP";"IARAS";35;11;15;61
2006;"IBATE (SP)";"SP";"IBATE";436;35;197;668
2006;"IBIRA (SP)";"SP";"IBIRA";139;16;46;201
2006;"IBIRAREMA (SP)";"SP";"IBIRAREMA";115;6;19;140
2006;"IBITINGA (SP)";"SP";"IBITINGA";624;44;101;769
2006;"IBIUNA (SP)";"SP";"IBIUNA";1318;93;85;1496
2006;"ICEM (SP)";"SP";"ICEM";145;7;67;219
2006;"IEPE (SP)";"SP";"IEPE";127;5;19;151
2006;"IGARACU DO TIETE (SP)";"SP";"IGARACU DO TIETE";338;16;45;399
2006;"IGARAPAVA (SP)";"SP";"IGARAPAVA";655;31;96;782
2006;"IGARATA (SP)";"SP";"IGARATA";89;5;9;103
2006;"IGUAPE (SP)";"SP";"IGUAPE";174;18;31;223
2006;"ILHA COMPRIDA (SP)";"SP";"ILHA COMPRIDA";92;7;34;133
2006;"ILHA SOLTEIRA (SP)";"SP";"ILHA SOLTEIRA";199;23;56;278
2006;"ILHABELA (SP)";"SP";"ILHABELA";193;27;35;255
2006;"INDAIATUBA (SP)";"SP";"INDAIATUBA";2154;251;198;2603
2006;"INDIANA (SP)";"SP";"INDIANA";106;2;7;115
2006;"INDIAPORA (SP)";"SP";"INDIAPORA";55;4;11;70
2006;"INUBIA PAULISTA (SP)";"SP";"INUBIA PAULISTA";42;3;11;56
2006;"IPAUCU (SP)";"SP";"IPAUCU";142;13;34;189
2006;"IPERO (SP)";"SP";"IPERO";168;9;36;213
2006;"IPEUNA (SP)";"SP";"IPEUNA";110;15;16;141
2006;"IPIGUA (SP)";"SP";"IPIGUA";18;2;5;25
2006;"IPORANGA (SP)";"SP";"IPORANGA";21;3;8;32
2006;"IPUA (SP)";"SP";"IPUA";244;9;62;315
2006;"IRACEMAPOLIS (SP)";"SP";"IRACEMAPOLIS";473;26;73;572
2006;"IRAPUA (SP)";"SP";"IRAPUA";142;1;48;191
2006;"IRAPURU (SP)";"SP";"IRAPURU";105;10;18;133
2006;"ITABERA (SP)";"SP";"ITABERA";166;9;25;200
2006;"ITAI (SP)";"SP";"ITAI";403;22;82;507
2006;"ITAJOBI (SP)";"SP";"ITAJOBI";415;10;39;464
2006;"ITAJU (SP)";"SP";"ITAJU";56;1;9;66
2006;"ITANHAEM (SP)";"SP";"ITANHAEM";589;88;94;771
2006;"ITAOCA (SP)";"SP";"ITAOCA";10;7;5;22
2006;"ITAPECERICA DA SERRA (SP)";"SP";"ITAPECERICA DA SERRA";1377;399;294;2070
2006;"ITAPETININGA (SP)";"SP";"ITAPETININGA";1957;205;243;2405
2006;"ITAPEVA (SP)";"SP";"ITAPEVA";1524;132;265;1921
2006;"ITAPEVI (SP)";"SP";"ITAPEVI";1021;130;79;1230
2006;"ITAPIRA (SP)";"SP";"ITAPIRA";1365;76;158;1599
2006;"ITAPIRAPUA PAULISTA (SP)";"SP";"ITAPIRAPUA PAULISTA";29;6;5;40
2006;"ITAPOLIS (SP)";"SP";"ITAPOLIS";1108;21;147;1276
2006;"ITAPORANGA (SP)";"SP";"ITAPORANGA";195;7;35;237
2006;"ITAPUI (SP)";"SP";"ITAPUI";334;14;33;381
2006;"ITAPURA (SP)";"SP";"ITAPURA";15;3;5;23
2006;"ITAQUAQUECETUBA (SP)";"SP";"ITAQUAQUECETUBA";1464;235;396;2095
2006;"ITARARE (SP)";"SP";"ITARARE";815;31;241;1087
2006;"ITARIRI (SP)";"SP";"ITARIRI";241;7;15;263
2006;"ITATIBA (SP)";"SP";"ITATIBA";1805;121;179;2105
2006;"ITATINGA (SP)";"SP";"ITATINGA";159;19;72;250
2006;"ITIRAPINA (SP)";"SP";"ITIRAPINA";198;11;46;255
2006;"ITIRAPUA (SP)";"SP";"ITIRAPUA";55;5;20;80
2006;"ITOBI (SP)";"SP";"ITOBI";109;7;61;177
2006;"ITU (SP)";"SP";"ITU";2259;215;415;2889
2006;"ITUPEVA (SP)";"SP";"ITUPEVA";633;69;39;741
2006;"ITUVERAVA (SP)";"SP";"ITUVERAVA";622;29;113;764
2006;"JABORANDI (SP)";"SP";"JABORANDI";140;8;37;185
2006;"JABOTICABAL (SP)";"SP";"JABOTICABAL";1392;68;172;1632
2006;"JACAREI (SP)";"SP";"JACAREI";2061;376;262;2699
2006;"JACI (SP)";"SP";"JACI";138;5;11;154
2006;"JACUPIRANGA (SP)";"SP";"JACUPIRANGA";314;17;179;510
2006;"JAGUARIUNA (SP)";"SP";"JAGUARIUNA";838;68;115;1021
2006;"JALES (SP)";"SP";"JALES";954;28;53;1035
2006;"JAMBEIRO (SP)";"SP";"JAMBEIRO";29;7;7;43
2006;"JANDIRA (SP)";"SP";"JANDIRA";921;145;101;1167
2006;"JARDINOPOLIS (SP)";"SP";"JARDINOPOLIS";719;47;85;851
2006;"JARINU (SP)";"SP";"JARINU";409;18;32;459
2006;"JAU (SP)";"SP";"JAU";1782;199;251;2232
2006;"JERIQUARA (SP)";"SP";"JERIQUARA";36;5;7;48
2006;"JOANOPOLIS (SP)";"SP";"JOANOPOLIS";230;15;11;256
2006;"JOAO RAMALHO (SP)";"SP";"JOAO RAMALHO";25;4;21;50
2006;"JOSE BONIFACIO (SP)";"SP";"JOSE BONIFACIO";604;20;74;698
2006;"JULIO MESQUITA (SP)";"SP";"JULIO MESQUITA";34;1;15;50
2006;"JUMIRIM (SP)";"SP";"JUMIRIM";67;4;4;75
2006;"JUNDIAI (SP)";"SP";"JUNDIAI";5505;675;755;6935
2006;"JUNQUEIROPOLIS (SP)";"SP";"JUNQUEIROPOLIS";362;13;92;467
2006;"JUQUIA (SP)";"SP";"JUQUIA";323;16;18;357
2006;"JUQUITIBA (SP)";"SP";"JUQUITIBA";376;55;51;482
2006;"LAGOINHA (SP)";"SP";"LAGOINHA";64;9;9;82
2006;"LARANJAL PAULISTA (SP)";"SP";"LARANJAL PAULISTA";526;29;98;653
2006;"LAVINIA (SP)";"SP";"LAVINIA";69;7;9;85
2006;"LAVRINHAS (SP)";"SP";"LAVRINHAS";99;20;10;129
2006;"LEME (SP)";"SP";"LEME";1833;73;343;2249
2006;"LENCOIS PAULISTA (SP)";"SP";"LENCOIS PAULISTA";1102;77;141;1320
2006;"LIMEIRA (SP)";"SP";"LIMEIRA";3820;471;512;4803
2006;"LINDOIA (SP)";"SP";"LINDOIA";95;7;10;112
2006;"LINS (SP)";"SP";"LINS";1054;54;146;1254
2006;"LORENA (SP)";"SP";"LORENA";680;85;26;791
2006;"LOURDES (SP)";"SP";"LOURDES";20;3;9;32
2006;"LOUVEIRA (SP)";"SP";"LOUVEIRA";715;68;32;815
2006;"LUCELIA (SP)";"SP";"LUCELIA";351;24;126;501
2006;"LUCIANOPOLIS (SP)";"SP";"LUCIANOPOLIS";42;4;9;55
2006;"LUIS ANTONIO (SP)";"SP";"LUIS ANTONIO";226;19;104;349
2006;"LUIZIANIA (SP)";"SP";"LUIZIANIA";52;1;16;69
2006;"LUPERCIO (SP)";"SP";"LUPERCIO";48;2;24;74
2006;"LUTECIA (SP)";"SP";"LUTECIA";38;5;6;49
2006;"MACATUBA (SP)";"SP";"MACATUBA";553;18;59;630
2006;"MACAUBAL (SP)";"SP";"MACAUBAL";113;7;13;133
2006;"MACEDONIA (SP)";"SP";"MACEDONIA";46;3;9;58
2006;"MAGDA (SP)";"SP";"MAGDA";81;7;11;99
2006;"MAIRINQUE (SP)";"SP";"MAIRINQUE";399;62;78;539
2006;"MAIRIPORA (SP)";"SP";"MAIRIPORA";816;109;115;1040
2006;"MANDURI (SP)";"SP";"MANDURI";131;13;39;183
2006;"MARABA PAULISTA (SP)";"SP";"MARABA PAULISTA";30;2;12;44
2006;"MARACAI (SP)";"SP";"MARACAI";291;23;42;356
2006;"MARAPOAMA (SP)";"SP";"MARAPOAMA";121;7;12;140
2006;"MARIAPOLIS (SP)";"SP";"MARIAPOLIS";36;1;16;53
2006;"MARILIA (SP)";"SP";"MARILIA";2453;176;354;2983
2006;"MARINOPOLIS (SP)";"SP";"MARINOPOLIS";53;1;5;59
2006;"MARTINOPOLIS (SP)";"SP";"MARTINOPOLIS";337;17;63;417
2006;"MATAO (SP)";"SP";"MATAO";1277;51;211;1539
2006;"MAUA (SP)";"SP";"MAUA";2613;805;696;4114
2006;"MENDONCA (SP)";"SP";"MENDONCA";93;2;17;112
2006;"MERIDIANO (SP)";"SP";"MERIDIANO";61;1;13;75
2006;"MESOPOLIS (SP)";"SP";"MESOPOLIS";17;3;7;27
2006;"MIGUELOPOLIS (SP)";"SP";"MIGUELOPOLIS";291;7;81;379
2006;"MINEIROS DO TIETE (SP)";"SP";"MINEIROS DO TIETE";240;7;28;275
2006;"MIRA ESTRELA (SP)";"SP";"MIRA ESTRELA";28;5;18;51
2006;"MIRACATU (SP)";"SP";"MIRACATU";473;20;23;516
2006;"MIRANDOPOLIS (SP)";"SP";"MIRANDOPOLIS";450;19;102;571
2006;"MIRANTE DO PARANAPANEMA (SP)";"SP";"MIRANTE DO PARANAPANEMA";169;11;48;228
2006;"MIRASSOL (SP)";"SP";"MIRASSOL";887;40;49;976
2006;"MIRASSOLANDIA (SP)";"SP";"MIRASSOLANDIA";26;5;10;41
2006;"MOCOCA (SP)";"SP";"MOCOCA";860;54;192;1106
2006;"MOGI DAS CRUZES (SP)";"SP";"MOGI DAS CRUZES";3569;426;936;4931
2006;"MOGI GUACU (SP)";"SP";"MOGI GUACU";1627;255;307;2189
2006;"MOGI MIRIM (SP)";"SP";"MOGI MIRIM";1584;151;435;2170
2006;"MOMBUCA (SP)";"SP";"MOMBUCA";67;8;14;89
2006;"MONCOES (SP)";"SP";"MONCOES";43;2;9;54
2006;"MONGAGUA (SP)";"SP";"MONGAGUA";342;43;46;431
2006;"MONTE ALEGRE DO SUL (SP)";"SP";"MONTE ALEGRE DO SUL";174;21;20;215
2006;"MONTE ALTO (SP)";"SP";"MONTE ALTO";1263;32;90;1385
2006;"MONTE APRAZIVEL (SP)";"SP";"MONTE APRAZIVEL";468;7;62;537
2006;"MONTE AZUL PAULISTA (SP)";"SP";"MONTE AZUL PAULISTA";469;16;94;579
2006;"MONTE CASTELO (SP)";"SP";"MONTE CASTELO";73;3;10;86
2006;"MONTE MOR (SP)";"SP";"MONTE MOR";514;55;123;692
2006;"MONTEIRO LOBATO (SP)";"SP";"MONTEIRO LOBATO";42;11;9;62
2006;"MORRO AGUDO (SP)";"SP";"MORRO AGUDO";554;17;129;700
2006;"MORUNGABA (SP)";"SP";"MORUNGABA";277;41;18;336
2006;"MOTUCA (SP)";"SP";"MOTUCA";155;6;53;214
2006;"MUNICIPIO NAO INFORMADO (SP)";"SP";"MUNICIPIO NAO INFORMADO";0;0;0;0
2006;"MURUTINGA DO SUL (SP)";"SP";"MURUTINGA DO SUL";78;9;5;92
2006;"NANTES (SP)";"SP";"NANTES";17;0;17;34
2006;"NARANDIBA (SP)";"SP";"NARANDIBA";22;3;16;41
2006;"NATIVIDADE DA SERRA (SP)";"SP";"NATIVIDADE DA SERRA";49;12;9;70
2006;"NAZARE PAULISTA (SP)";"SP";"NAZARE PAULISTA";362;9;33;404
2006;"NEVES PAULISTA (SP)";"SP";"NEVES PAULISTA";171;3;25;199
2006;"NHANDEARA (SP)";"SP";"NHANDEARA";165;10;25;200
2006;"NIPOA (SP)";"SP";"NIPOA";93;4;12;109
2006;"NOVA ALIANCA (SP)";"SP";"NOVA ALIANCA";108;9;15;132
2006;"NOVA CAMPINA (SP)";"SP";"NOVA CAMPINA";64;7;9;80
2006;"NOVA CANAA PAULISTA (SP)";"SP";"NOVA CANAA PAULISTA";21;3;4;28
2006;"NOVA CASTILHO (SP)";"SP";"NOVA CASTILHO";11;1;5;17
2006;"NOVA EUROPA (SP)";"SP";"NOVA EUROPA";150;3;80;233
2006;"NOVA GRANADA (SP)";"SP";"NOVA GRANADA";263;10;70;343
2006;"NOVA GUATAPORANGA (SP)";"SP";"NOVA GUATAPORANGA";26;2;12;40
2006;"NOVA INDEPENDENCIA (SP)";"SP";"NOVA INDEPENDENCIA";24;4;4;32
2006;"NOVA LUZITANIA (SP)";"SP";"NOVA LUZITANIA";34;3;17;54
2006;"NOVA ODESSA (SP)";"SP";"NOVA ODESSA";677;86;95;858
2006;"NOVAIS (SP)";"SP";"NOVAIS";101;5;30;136
2006;"NOVO HORIZONTE (SP)";"SP";"NOVO HORIZONTE";800;17;152;969
2006;"NUPORANGA (SP)";"SP";"NUPORANGA";165;8;27;200
2006;"OCAUCU (SP)";"SP";"OCAUCU";80;2;11;93
2006;"OLEO (SP)";"SP";"OLEO";20;9;4;33
2006;"OLIMPIA (SP)";"SP";"OLIMPIA";932;43;141;1116
2006;"ONDA VERDE (SP)";"SP";"ONDA VERDE";78;3;16;97
2006;"ORIENTE (SP)";"SP";"ORIENTE";54;2;15;71
2006;"ORINDIUVA (SP)";"SP";"ORINDIUVA";114;9;63;186
2006;"ORLANDIA (SP)";"SP";"ORLANDIA";793;33;223;1049
2006;"OSASCO (SP)";"SP";"OSASCO";6339;1144;1875;9358
2006;"OSCAR BRESSANE (SP)";"SP";"OSCAR BRESSANE";38;3;8;49
2006;"OSVALDO CRUZ (SP)";"SP";"OSVALDO CRUZ";495;21;71;587
2006;"OURINHOS (SP)";"SP";"OURINHOS";1736;82;254;2072
2006;"OURO VERDE (SP)";"SP";"OURO VERDE";110;1;34;145
2006;"OUROESTE (SP)";"SP";"OUROESTE";82;6;18;106
2006;"PACAEMBU (SP)";"SP";"PACAEMBU";172;18;34;224
2006;"PALESTINA (SP)";"SP";"PALESTINA";122;2;25;149
2006;"PALMARES PAULISTA (SP)";"SP";"PALMARES PAULISTA";74;4;72;150
2006;"PALMEIRA D OESTE (SP)";"SP";"PALMEIRA D OESTE";177;4;26;207
2006;"PALMITAL (SP)";"SP";"PALMITAL";559;23;52;634
2006;"PANORAMA (SP)";"SP";"PANORAMA";195;4;16;215
2006;"PARAGUACU PAULISTA (SP)";"SP";"PARAGUACU PAULISTA";521;40;86;647
2006;"PARAIBUNA (SP)";"SP";"PARAIBUNA";166;37;31;234
2006;"PARAISO (SP)";"SP";"PARAISO";172;4;43;219
2006;"PARANAPANEMA (SP)";"SP";"PARANAPANEMA";396;17;45;458
2006;"PARANAPUA (SP)";"SP";"PARANAPUA";53;5;8;66
2006;"PARAPUA (SP)";"SP";"PARAPUA";212;4;28;244
2006;"PARDINHO (SP)";"SP";"PARDINHO";124;9;14;147
2006;"PARIQUERA ACU (SP)";"SP";"PARIQUERA ACU";249;12;9;270
2006;"PARISI (SP)";"SP";"PARISI";24;4;8;36
2006;"PATROCINIO PAULISTA (SP)";"SP";"PATROCINIO PAULISTA";153;6;35;194
2006;"PAULICEIA (SP)";"SP";"PAULICEIA";154;3;14;171
2006;"PAULINIA (SP)";"SP";"PAULINIA";1428;97;256;1781
2006;"PAULISTANIA (SP)";"SP";"PAULISTANIA";20;5;3;28
2006;"PAULO DE FARIA (SP)";"SP";"PAULO DE FARIA";92;9;42;143
2006;"PEDERNEIRAS (SP)";"SP";"PEDERNEIRAS";764;55;155;974
2006;"PEDRA BELA (SP)";"SP";"PEDRA BELA";100;4;12;116
2006;"PEDRANOPOLIS (SP)";"SP";"PEDRANOPOLIS";37;1;11;49
2006;"PEDREGULHO (SP)";"SP";"PEDREGULHO";214;16;83;313
2006;"PEDREIRA (SP)";"SP";"PEDREIRA";543;73;63;679
2006;"PEDRINHAS PAULISTA (SP)";"SP";"PEDRINHAS PAULISTA";130;3;11;144
2006;"PEDRO DE TOLEDO (SP)";"SP";"PEDRO DE TOLEDO";120;11;3;134
2006;"PENAPOLIS (SP)";"SP";"PENAPOLIS";1164;29;206;1399
2006;"PEREIRA BARRETO (SP)";"SP";"PEREIRA BARRETO";352;17;88;457
2006;"PEREIRAS (SP)";"SP";"PEREIRAS";197;12;23;232
2006;"PERUIBE (SP)";"SP";"PERUIBE";436;101;67;604
2006;"PIACATU (SP)";"SP";"PIACATU";76;1;9;86
2006;"PIEDADE (SP)";"SP";"PIEDADE";1072;71;67;1210
2006;"PILAR DO SUL (SP)";"SP";"PILAR DO SUL";600;32;53;685
2006;"PINDAMONHANGABA (SP)";"SP";"PINDAMONHANGABA";1079;155;163;1397
2006;"PINDORAMA (SP)";"SP";"PINDORAMA";214;8;50;272
2006;"PINHALZINHO (SP)";"SP";"PINHALZINHO";284;15;8;307
2006;"PIQUEROBI (SP)";"SP";"PIQUEROBI";27;5;4;36
2006;"PIQUETE (SP)";"SP";"PIQUETE";107;30;13;150
2006;"PIRACAIA (SP)";"SP";"PIRACAIA";391;37;23;451
2006;"PIRACICABA (SP)";"SP";"PIRACICABA";5839;597;959;7395
2006;"PIRAJU (SP)";"SP";"PIRAJU";349;33;62;444
2006;"PIRAJUI (SP)";"SP";"PIRAJUI";280;11;46;337
2006;"PIRANGI (SP)";"SP";"PIRANGI";340;19;44;403
2006;"PIRAPORA DO BOM JESUS (SP)";"SP";"PIRAPORA DO BOM JESUS";164;16;11;191
2006;"PIRAPOZINHO (SP)";"SP";"PIRAPOZINHO";399;14;22;435
2006;"PIRASSUNUNGA (SP)";"SP";"PIRASSUNUNGA";844;107;233;1184
2006;"PIRATININGA (SP)";"SP";"PIRATININGA";191;8;22;221
2006;"PITANGUEIRAS (SP)";"SP";"PITANGUEIRAS";655;22;199;876
2006;"PLANALTO (SP)";"SP";"PLANALTO";76;4;21;101
2006;"PLATINA (SP)";"SP";"PLATINA";42;5;7;54
2006;"POA (SP)";"SP";"POA";631;89;76;796
2006;"POLONI (SP)";"SP";"POLONI";142;5;32;179
2006;"POMPEIA (SP)";"SP";"POMPEIA";221;9;40;270
2006;"PONGAI (SP)";"SP";"PONGAI";41;6;11;58
2006;"PONTAL (SP)";"SP";"PONTAL";740;18;348;1106
2006;"PONTALINDA (SP)";"SP";"PONTALINDA";33;3;19;55
2006;"PONTES GESTAL (SP)";"SP";"PONTES GESTAL";43;1;15;59
2006;"POPULINA (SP)";"SP";"POPULINA";60;3;14;77
2006;"PORANGABA (SP)";"SP";"PORANGABA";88;11;13;112
2006;"PORTO FELIZ (SP)";"SP";"PORTO FELIZ";977;50;115;1142
2006;"PORTO FERREIRA (SP)";"SP";"PORTO FERREIRA";775;49;129;953
2006;"POTIM (SP)";"SP";"POTIM";36;26;10;72
2006;"POTIRENDABA (SP)";"SP";"POTIRENDABA";356;14;44;414
2006;"PRACINHA (SP)";"SP";"PRACINHA";11;1;11;23
2006;"PRADOPOLIS (SP)";"SP";"PRADOPOLIS";323;18;112;453
2006;"PRAIA GRANDE (SP)";"SP";"PRAIA GRANDE";1382;200;256;1838
2006;"PRATANIA (SP)";"SP";"PRATANIA";85;4;16;105
2006;"PRESIDENTE ALVES (SP)";"SP";"PRESIDENTE ALVES";79;3;29;111
2006;"PRESIDENTE BERNARDES (SP)";"SP";"PRESIDENTE BERNARDES";189;11;24;224
2006;"PRESIDENTE EPITACIO (SP)";"SP";"PRESIDENTE EPITACIO";369;20;85;474
2006;"PRESIDENTE PRUDENTE (SP)";"SP";"PRESIDENTE PRUDENTE";3091;200;716;4007
2006;"PRESIDENTE VENCESLAU (SP)";"SP";"PRESIDENTE VENCESLAU";547;28;51;626
2006;"PROMISSAO (SP)";"SP";"PROMISSAO";559;23;118;700
2006;"QUADRA (SP)";"SP";"QUADRA";36;6;16;58
2006;"QUATA (SP)";"SP";"QUATA";146;10;53;209
2006;"QUEIROZ (SP)";"SP";"QUEIROZ";16;2;6;24
2006;"QUELUZ (SP)";"SP";"QUELUZ";102;14;7;123
2006;"QUINTANA (SP)";"SP";"QUINTANA";78;7;8;93
2006;"RAFARD (SP)";"SP";"RAFARD";217;12;17;246
2006;"RANCHARIA (SP)";"SP";"RANCHARIA";491;43;52;586
2006;"REDENCAO DA SERRA (SP)";"SP";"REDENCAO DA SERRA";34;10;14;58
2006;"REGENTE FEIJO (SP)";"SP";"REGENTE FEIJO";305;20;18;343
2006;"REGINOPOLIS (SP)";"SP";"REGINOPOLIS";67;3;20;90
2006;"REGISTRO (SP)";"SP";"REGISTRO";799;58;221;1078
2006;"RESTINGA (SP)";"SP";"RESTINGA";40;4;12;56
2006;"RIBEIRA (SP)";"SP";"RIBEIRA";22;4;3;29
2006;"RIBEIRAO BONITO (SP)";"SP";"RIBEIRAO BONITO";245;16;43;304
2006;"RIBEIRAO BRANCO (SP)";"SP";"RIBEIRAO BRANCO";113;11;23;147
2006;"RIBEIRAO CORRENTE (SP)";"SP";"RIBEIRAO CORRENTE";43;6;20;69
2006;"RIBEIRAO DO SUL (SP)";"SP";"RIBEIRAO DO SUL";92;6;12;110
2006;"RIBEIRAO DOS INDIOS (SP)";"SP";"RIBEIRAO DOS INDIOS";18;1;10;29
2006;"RIBEIRAO GRANDE (SP)";"SP";"RIBEIRAO GRANDE";70;8;10;88
2006;"RIBEIRAO PIRES (SP)";"SP";"RIBEIRAO PIRES";1130;250;295;1675
2006;"RIBEIRAO PRETO (SP)";"SP";"RIBEIRAO PRETO";7116;614;1232;8962
2006;"RIFAINA (SP)";"SP";"RIFAINA";32;1;6;39
2006;"RINCAO (SP)";"SP";"RINCAO";172;8;38;218
2006;"RINOPOLIS (SP)";"SP";"RINOPOLIS";159;6;38;203
2006;"RIO CLARO (SP)";"SP";"RIO CLARO";2509;215;396;3120
2006;"RIO DAS PEDRAS (SP)";"SP";"RIO DAS PEDRAS";598;38;132;768
2006;"RIO GRANDE DA SERRA (SP)";"SP";"RIO GRANDE DA SERRA";192;50;19;261
2006;"RIOLANDIA (SP)";"SP";"RIOLANDIA";84;4;38;126
2006;"RIVERSUL (SP)";"SP";"RIVERSUL";46;4;19;69
2006;"ROSANA (SP)";"SP";"ROSANA";131;7;37;175
2006;"ROSEIRA (SP)";"SP";"ROSEIRA";121;27;13;161
2006;"RUBIACEA (SP)";"SP";"RUBIACEA";23;1;14;38
2006;"RUBINEIA (SP)";"SP";"RUBINEIA";15;2;6;23
2006;"SABINO (SP)";"SP";"SABINO";53;4;7;64
2006;"SAGRES (SP)";"SP";"SAGRES";9;2;5;16
2006;"SALES (SP)";"SP";"SALES";72;2;20;94
2006;"SALES OLIVEIRA (SP)";"SP";"SALES OLIVEIRA";205;7;37;249
2006;"SALESOPOLIS (SP)";"SP";"SALESOPOLIS";497;29;42;568
2006;"SALMOURAO (SP)";"SP";"SALMOURAO";20;2;26;48
2006;"SALTINHO (SP)";"SP";"SALTINHO";287;6;4;297
2006;"SALTO (SP)";"SP";"SALTO";1459;143;168;1770
2006;"SALTO DE PIRAPORA (SP)";"SP";"SALTO DE PIRAPORA";487;31;50;568
2006;"SALTO GRANDE (SP)";"SP";"SALTO GRANDE";113;7;23;143
2006;"SANDOVALINA (SP)";"SP";"SANDOVALINA";21;3;6;30
2006;"SANTA ADELIA (SP)";"SP";"SANTA ADELIA";518;16;76;610
2006;"SANTA ALBERTINA (SP)";"SP";"SANTA ALBERTINA";63;6;14;83
2006;"SANTA BARBARA D OESTE (SP)";"SP";"SANTA BARBARA D OESTE";2034;286;226;2546
2006;"SANTA BRANCA (SP)";"SP";"SANTA BRANCA";84;16;42;142
2006;"SANTA CLARA D OESTE (SP)";"SP";"SANTA CLARA D OESTE";17;1;3;21
2006;"SANTA CRUZ DA CONCEICAO (SP)";"SP";"SANTA CRUZ DA CONCEICAO";112;6;10;128
2006;"SANTA CRUZ DA ESPERANCA (SP)";"SP";"SANTA CRUZ DA ESPERANCA";18;0;6;24
2006;"SANTA CRUZ DAS PALMEIRAS (SP)";"SP";"SANTA CRUZ DAS PALMEIRAS";630;24;206;860
2006;"SANTA CRUZ DO RIO PARDO (SP)";"SP";"SANTA CRUZ DO RIO PARDO";1001;63;62;1126
2006;"SANTA ERNESTINA (SP)";"SP";"SANTA ERNESTINA";71;4;34;109
2006;"SANTA FE DO SUL (SP)";"SP";"SANTA FE DO SUL";551;12;29;592
2006;"SANTA GERTRUDES (SP)";"SP";"SANTA GERTRUDES";395;28;22;445
2006;"SANTA ISABEL (SP)";"SP";"SANTA ISABEL";630;51;42;723
2006;"SANTA LUCIA (SP)";"SP";"SANTA LUCIA";118;15;45;178
2006;"SANTA MARIA DA SERRA (SP)";"SP";"SANTA MARIA DA SERRA";198;21;17;236
2006;"SANTA MERCEDES (SP)";"SP";"SANTA MERCEDES";28;5;7;40
2006;"SANTA RITA D OESTE (SP)";"SP";"SANTA RITA D OESTE";29;0;5;34
2006;"SANTA RITA DO PASSA QUATRO (SP)";"SP";"SANTA RITA DO PASSA QUATRO";484;37;40;561
2006;"SANTA ROSA DE VITERBO (SP)";"SP";"SANTA ROSA DE VITERBO";334;27;72;433
2006;"SANTA SALETE (SP)";"SP";"SANTA SALETE";38;4;4;46
2006;"SANTANA DA PONTE PENSA (SP)";"SP";"SANTANA DA PONTE PENSA";25;3;1;29
2006;"SANTANA DE PARNAIBA (SP)";"SP";"SANTANA DE PARNAIBA";1164;174;66;1404
2006;"SANTO ANASTACIO (SP)";"SP";"SANTO ANASTACIO";386;11;43;440
2006;"SANTO ANDRE (SP)";"SP";"SANTO ANDRE";7300;1383;1473;10156
2006;"SANTO ANTONIO DA ALEGRIA (SP)";"SP";"SANTO ANTONIO DA ALEGRIA";81;4;16;101
2006;"SANTO ANTONIO DE POSSE (SP)";"SP";"SANTO ANTONIO DE POSSE";540;26;80;646
2006;"SANTO ANTONIO DO ARACANGUA (SP)";"SP";"SANTO ANTONIO DO ARACANGUA";154;6;57;217
2006;"SANTO ANTONIO DO JARDIM (SP)";"SP";"SANTO ANTONIO DO JARDIM";172;11;11;194
2006;"SANTO ANTONIO DO PINHAL (SP)";"SP";"SANTO ANTONIO DO PINHAL";89;16;6;111
2006;"SANTO EXPEDITO (SP)";"SP";"SANTO EXPEDITO";21;1;4;26
2006;"SANTOPOLIS DO AGUAPEI (SP)";"SP";"SANTOPOLIS DO AGUAPEI";63;4;30;97
2006;"SANTOS (SP)";"SP";"SANTOS";4299;643;604;5546
2006;"SAO BENTO DO SAPUCAI (SP)";"SP";"SAO BENTO DO SAPUCAI";100;32;6;138
2006;"SAO BERNARDO DO CAMPO (SP)";"SP";"SAO BERNARDO DO CAMPO";9464;1544;2099;13107
2006;"SAO CAETANO DO SUL (SP)";"SP";"SAO CAETANO DO SUL";2459;424;391;3274
2006;"SAO CARLOS (SP)";"SP";"SAO CARLOS";2895;257;296;3448
2006;"SAO FRANCISCO (SP)";"SP";"SAO FRANCISCO";29;4;12;45
2006;"SAO JOAO DA BOA VISTA (SP)";"SP";"SAO JOAO DA BOA VISTA";1525;159;88;1772
2006;"SAO JOAO DAS DUAS PONTES (SP)";"SP";"SAO JOAO DAS DUAS PONTES";17;3;6;26
2006;"SAO JOAO DE IRACEMA (SP)";"SP";"SAO JOAO DE IRACEMA";16;2;9;27
2006;"SAO JOAO DO PAU D ALHO (SP)";"SP";"SAO JOAO DO PAU D ALHO";30;4;4;38
2006;"SAO JOAQUIM DA BARRA (SP)";"SP";"SAO JOAQUIM DA BARRA";760;34;136;930
2006;"SAO JOSE DA BELA VISTA (SP)";"SP";"SAO JOSE DA BELA VISTA";63;5;32;100
2006;"SAO JOSE DO BARREIRO (SP)";"SP";"SAO JOSE DO BARREIRO";28;6;4;38
2006;"SAO JOSE DO RIO PARDO (SP)";"SP";"SAO JOSE DO RIO PARDO";1037;49;107;1193
2006;"SAO JOSE DO RIO PRETO (SP)";"SP";"SAO JOSE DO RIO PRETO";5518;424;930;6872
2006;"SAO JOSE DOS CAMPOS (SP)";"SP";"SAO JOSE DOS CAMPOS";5033;1193;1023;7249
2006;"SAO LOURENCO DA SERRA (SP)";"SP";"SAO LOURENCO DA SERRA";163;13;14;190
2006;"SAO LUIZ DO PARAITINGA (SP)";"SP";"SAO LUIZ DO PARAITINGA";108;12;13;133
2006;"SAO MANUEL (SP)";"SP";"SAO MANUEL";640;54;96;790
2006;"SAO MIGUEL ARCANJO (SP)";"SP";"SAO MIGUEL ARCANJO";574;44;40;658
2006;"SAO PAULO (SP)";"SP";"SAO PAULO";124489;26618;35382;186489
2006;"SAO PEDRO (SP)";"SP";"SAO PEDRO";471;50;67;588
2006;"SAO PEDRO DO TURVO (SP)";"SP";"SAO PEDRO DO TURVO";132;10;19;161
2006;"SAO ROQUE (SP)";"SP";"SAO ROQUE";752;115;156;1023
2006;"SAO SEBASTIAO (SP)";"SP";"SAO SEBASTIAO";427;45;107;579
2006;"SAO SEBASTIAO DA GRAMA (SP)";"SP";"SAO SEBASTIAO DA GRAMA";209;14;22;245
2006;"SAO SIMAO (SP)";"SP";"SAO SIMAO";270;16;34;320
2006;"SAO VICENTE (SP)";"SP";"SAO VICENTE";1383;662;636;2681
2006;"SARAPUI (SP)";"SP";"SARAPUI";118;9;7;134
2006;"SARUTAIA (SP)";"SP";"SARUTAIA";30;7;12;49
2006;"SEBASTIANOPOLIS DO SUL (SP)";"SP";"SEBASTIANOPOLIS DO SUL";78;3;12;93
2006;"SERRA AZUL (SP)";"SP";"SERRA AZUL";121;9;69;199
2006;"SERRA NEGRA (SP)";"SP";"SERRA NEGRA";329;32;26;387
2006;"SERRANA (SP)";"SP";"SERRANA";522;99;183;804
2006;"SERTAOZINHO (SP)";"SP";"SERTAOZINHO";2018;94;320;2432
2006;"SETE BARRAS (SP)";"SP";"SETE BARRAS";151;6;24;181
2006;"SEVERINIA (SP)";"SP";"SEVERINIA";311;7;128;446
2006;"SILVEIRAS (SP)";"SP";"SILVEIRAS";63;9;4;76
2006;"SOCORRO (SP)";"SP";"SOCORRO";602;67;36;705
2006;"SOROCABA (SP)";"SP";"SOROCABA";5904;874;1034;7812
2006;"SUD MENUCCI (SP)";"SP";"SUD MENUCCI";129;10;42;181
2006;"SUMARE (SP)";"SP";"SUMARE";1911;348;335;2594
2006;"SUZANO (SP)";"SP";"SUZANO";2128;275;312;2715
2006;"SUZANOPOLIS (SP)";"SP";"SUZANOPOLIS";50;4;10;64
2006;"TABAPUA (SP)";"SP";"TABAPUA";145;11;37;193
2006;"TABATINGA (SP)";"SP";"TABATINGA";320;10;92;422
2006;"TABOAO DA SERRA (SP)";"SP";"TABOAO DA SERRA";1585;478;421;2484
2006;"TACIBA (SP)";"SP";"TACIBA";58;2;9;69
2006;"TAGUAI (SP)";"SP";"TAGUAI";117;3;18;138
2006;"TAIACU (SP)";"SP";"TAIACU";132;3;18;153
2006;"TAIUVA (SP)";"SP";"TAIUVA";141;4;20;165
2006;"TAMBAU (SP)";"SP";"TAMBAU";461;23;38;522
2006;"TANABI (SP)";"SP";"TANABI";409;18;70;497
2006;"TAPIRAI (SP)";"SP";"TAPIRAI";120;7;7;134
2006;"TAPIRATIBA (SP)";"SP";"TAPIRATIBA";255;9;45;309
2006;"TAQUARAL (SP)";"SP";"TAQUARAL";50;4;17;71
2006;"TAQUARITINGA (SP)";"SP";"TAQUARITINGA";1328;48;241;1617
2006;"TAQUARITUBA (SP)";"SP";"TAQUARITUBA";504;22;54;580
2006;"TAQUARIVAI (SP)";"SP";"TAQUARIVAI";50;5;9;64
2006;"TARABAI (SP)";"SP";"TARABAI";76;2;24;102
2006;"TARUMA (SP)";"SP";"TARUMA";255;12;145;412
2006;"TATUI (SP)";"SP";"TATUI";1430;87;390;1907
2006;"TAUBATE (SP)";"SP";"TAUBATE";2296;533;631;3460
2006;"TEJUPA (SP)";"SP";"TEJUPA";43;5;6;54
2006;"TEODORO SAMPAIO (SP)";"SP";"TEODORO SAMPAIO";200;7;43;250
2006;"TERRA ROXA (SP)";"SP";"TERRA ROXA";168;8;49;225
2006;"TIETE (SP)";"SP";"TIETE";1021;33;130;1184
2006;"TIMBURI (SP)";"SP";"TIMBURI";24;3;6;33
2006;"TORRE DE PEDRA (SP)";"SP";"TORRE DE PEDRA";43;1;2;46
2006;"TORRINHA (SP)";"SP";"TORRINHA";338;11;33;382
2006;"TRABIJU (SP)";"SP";"TRABIJU";24;8;6;38
2006;"TREMEMBE (SP)";"SP";"TREMEMBE";296;44;10;350
2006;"TRES FRONTEIRAS (SP)";"SP";"TRES FRONTEIRAS";56;2;6;64
2006;"TUIUTI (SP)";"SP";"TUIUTI";57;16;13;86
2006;"TUPA (SP)";"SP";"TUPA";1165;36;176;1377
2006;"TUPI PAULISTA (SP)";"SP";"TUPI PAULISTA";265;6;22;293
2006;"TURIUBA (SP)";"SP";"TURIUBA";15;1;2;18
2006;"TURMALINA (SP)";"SP";"TURMALINA";27;3;7;37
2006;"UBARANA (SP)";"SP";"UBARANA";83;4;18;105
2006;"UBATUBA (SP)";"SP";"UBATUBA";532;62;55;649
2006;"UBIRAJARA (SP)";"SP";"UBIRAJARA";72;6;14;92
2006;"UCHOA (SP)";"SP";"UCHOA";124;4;28;156
2006;"UNIAO PAULISTA (SP)";"SP";"UNIAO PAULISTA";21;3;5;29
2006;"URANIA (SP)";"SP";"URANIA";130;8;20;158
2006;"URU (SP)";"SP";"URU";12;4;6;22
2006;"URUPES (SP)";"SP";"URUPES";321;10;42;373
2006;"VALENTIM GENTIL (SP)";"SP";"VALENTIM GENTIL";157;15;20;192
2006;"VALINHOS (SP)";"SP";"VALINHOS";1698;335;816;2849
2006;"VALPARAISO (SP)";"SP";"VALPARAISO";304;18;100;422
2006;"VARGEM (SP)";"SP";"VARGEM";180;10;11;201
2006;"VARGEM GRANDE DO SUL (SP)";"SP";"VARGEM GRANDE DO SUL";934;45;131;1110
2006;"VARGEM GRANDE PAULISTA (SP)";"SP";"VARGEM GRANDE PAULISTA";674;63;46;783
2006;"VARZEA PAULISTA (SP)";"SP";"VARZEA PAULISTA";777;214;146;1137
2006;"VERA CRUZ (SP)";"SP";"VERA CRUZ";127;14;19;160
2006;"VINHEDO (SP)";"SP";"VINHEDO";1003;105;72;1180
2006;"VIRADOURO (SP)";"SP";"VIRADOURO";341;15;58;414
2006;"VISTA ALEGRE DO ALTO (SP)";"SP";"VISTA ALEGRE DO ALTO";266;18;73;357
2006;"VITORIA BRASIL (SP)";"SP";"VITORIA BRASIL";14;0;9;23
2006;"VOTORANTIM (SP)";"SP";"VOTORANTIM";907;170;64;1141
2006;"VOTUPORANGA (SP)";"SP";"VOTUPORANGA";1435;48;132;1615
2006;"ZACARIAS (SP)";"SP";"ZACARIAS";31;6;10;47
2006;"ABREULANDIA (TO)";"TO";"ABREULANDIA";12;1;0;13
2006;"AGUIARNOPOLIS (TO)";"TO";"AGUIARNOPOLIS";21;2;3;26
2006;"ALIANCA DO TOCANTINS (TO)";"TO";"ALIANCA DO TOCANTINS";68;3;3;74
2006;"ALMAS (TO)";"TO";"ALMAS";32;0;2;34
2006;"ALVORADA (TO)";"TO";"ALVORADA";114;0;3;117
2006;"ANANAS (TO)";"TO";"ANANAS";38;7;13;58
2006;"ANGICO (TO)";"TO";"ANGICO";5;1;2;8
2006;"APARECIDA DO RIO NEGRO (TO)";"TO";"APARECIDA DO RIO NEGRO";38;25;2;65
2006;"ARAGOMINAS (TO)";"TO";"ARAGOMINAS";131;4;4;139
2006;"ARAGUACEMA (TO)";"TO";"ARAGUACEMA";13;1;4;18
2006;"ARAGUACU (TO)";"TO";"ARAGUACU";64;1;3;68
2006;"ARAGUAINA (TO)";"TO";"ARAGUAINA";2699;88;223;3010
2006;"ARAGUANA (TO)";"TO";"ARAGUANA";227;7;7;241
2006;"ARAGUATINS (TO)";"TO";"ARAGUATINS";219;35;46;300
2006;"ARAPOEMA (TO)";"TO";"ARAPOEMA";37;2;8;47
2006;"ARRAIAS (TO)";"TO";"ARRAIAS";27;1;4;32
2006;"AUGUSTINOPOLIS (TO)";"TO";"AUGUSTINOPOLIS";88;34;3;125
2006;"AURORA DO TOCANTINS (TO)";"TO";"AURORA DO TOCANTINS";2;0;2;4
2006;"AXIXA DO TOCANTINS (TO)";"TO";"AXIXA DO TOCANTINS";19;14;4;37
2006;"BABACULANDIA (TO)";"TO";"BABACULANDIA";297;14;8;319
2006;"BANDEIRANTES DO TOCANTINS (TO)";"TO";"BANDEIRANTES DO TOCANTINS";19;3;3;25
2006;"BARRA DO OURO (TO)";"TO";"BARRA DO OURO";2;0;0;2
2006;"BARROLANDIA (TO)";"TO";"BARROLANDIA";32;1;2;35
2006;"BERNARDO SAYAO (TO)";"TO";"BERNARDO SAYAO";29;3;7;39
2006;"BOM JESUS DO TOCANTINS (TO)";"TO";"BOM JESUS DO TOCANTINS";0;2;0;2
2006;"BRASILANDIA DO TOCANTINS (TO)";"TO";"BRASILANDIA DO TOCANTINS";11;1;1;13
2006;"BREJINHO DE NAZARE (TO)";"TO";"BREJINHO DE NAZARE";25;0;5;30
2006;"BURITI DO TOCANTINS (TO)";"TO";"BURITI DO TOCANTINS";11;9;1;21
2006;"CACHOEIRINHA (TO)";"TO";"CACHOEIRINHA";3;1;0;4
2006;"CAMPOS LINDOS (TO)";"TO";"CAMPOS LINDOS";28;0;1;29
2006;"CARIRI DO TOCANTINS (TO)";"TO";"CARIRI DO TOCANTINS";29;1;1;31
2006;"CARMOLANDIA (TO)";"TO";"CARMOLANDIA";611;51;52;714
2006;"CARRASCO BONITO (TO)";"TO";"CARRASCO BONITO";5;4;1;10
2006;"CASEARA (TO)";"TO";"CASEARA";19;2;1;22
2006;"CENTENARIO (TO)";"TO";"CENTENARIO";3;0;0;3
2006;"CHAPADA DA NATIVIDADE (TO)";"TO";"CHAPADA DA NATIVIDADE";16;0;2;18
2006;"CHAPADA DE AREIA (TO)";"TO";"CHAPADA DE AREIA";1;0;2;3
2006;"COLINAS DO TOCANTINS (TO)";"TO";"COLINAS DO TOCANTINS";397;10;23;430
2006;"COLMEIA (TO)";"TO";"COLMEIA";105;6;7;118
2006;"COMBINADO (TO)";"TO";"COMBINADO";11;1;3;15
2006;"CONCEICAO DO TOCANTINS (TO)";"TO";"CONCEICAO DO TOCANTINS";5;0;0;5
2006;"COUTO DE MAGALHAES (TO)";"TO";"COUTO DE MAGALHAES";5;7;2;14
2006;"CRISTALANDIA (TO)";"TO";"CRISTALANDIA";67;0;2;69
2006;"CRIXAS DO TOCANTINS (TO)";"TO";"CRIXAS DO TOCANTINS";4;2;0;6
2006;"DARCINOPOLIS (TO)";"TO";"DARCINOPOLIS";143;16;3;162
2006;"DIANOPOLIS (TO)";"TO";"DIANOPOLIS";85;2;19;106
2006;"DIVINOPOLIS DO TOCANTINS (TO)";"TO";"DIVINOPOLIS DO TOCANTINS";44;2;2;48
2006;"DOIS IRMAOS DO TOCANTINS (TO)";"TO";"DOIS IRMAOS DO TOCANTINS";28;2;1;31
2006;"DUERE (TO)";"TO";"DUERE";21;2;3;26
2006;"ESPERANTINA (TO)";"TO";"ESPERANTINA";12;9;2;23
2006;"FATIMA (TO)";"TO";"FATIMA";23;2;2;27
2006;"FIGUEIROPOLIS (TO)";"TO";"FIGUEIROPOLIS";40;4;3;47
2006;"FILADELFIA (TO)";"TO";"FILADELFIA";33;7;5;45
2006;"FORMOSO DO ARAGUAIA (TO)";"TO";"FORMOSO DO ARAGUAIA";116;6;14;136
2006;"FORTALEZA DO TABOCAO (TO)";"TO";"FORTALEZA DO TABOCAO";23;5;1;29
2006;"GOIANORTE (TO)";"TO";"GOIANORTE";14;1;3;18
2006;"GOIATINS (TO)";"TO";"GOIATINS";68;13;5;86
2006;"GUARAI (TO)";"TO";"GUARAI";266;8;12;286
2006;"GURUPI (TO)";"TO";"GURUPI";1123;26;126;1275
2006;"IPUEIRAS (TO)";"TO";"IPUEIRAS";1;0;2;3
2006;"ITACAJA (TO)";"TO";"ITACAJA";22;2;0;24
2006;"ITAGUATINS (TO)";"TO";"ITAGUATINS";20;4;1;25
2006;"ITAPIRATINS (TO)";"TO";"ITAPIRATINS";7;1;5;13
2006;"ITAPORA DO TOCANTINS (TO)";"TO";"ITAPORA DO TOCANTINS";10;3;3;16
2006;"JAU DO TOCANTINS (TO)";"TO";"JAU DO TOCANTINS";13;0;5;18
2006;"JUARINA (TO)";"TO";"JUARINA";4;1;1;6
2006;"LAGOA DA CONFUSAO (TO)";"TO";"LAGOA DA CONFUSAO";42;1;3;46
2006;"LAGOA DO TOCANTINS (TO)";"TO";"LAGOA DO TOCANTINS";4;1;2;7
2006;"LAJEADO (TO)";"TO";"LAJEADO";10;0;9;19
2006;"LAVANDEIRA (TO)";"TO";"LAVANDEIRA";1;1;1;3
2006;"LIZARDA (TO)";"TO";"LIZARDA";6;1;0;7
2006;"LUZINOPOLIS (TO)";"TO";"LUZINOPOLIS";5;1;0;6
2006;"MARIANOPOLIS DO TOCANTINS (TO)";"TO";"MARIANOPOLIS DO TOCANTINS";21;0;3;24
2006;"MATEIROS (TO)";"TO";"MATEIROS";11;0;2;13
2006;"MAURILANDIA DO TOCANTINS (TO)";"TO";"MAURILANDIA DO TOCANTINS";3;0;1;4
2006;"MIRACEMA DO TOCANTINS (TO)";"TO";"MIRACEMA DO TOCANTINS";136;9;31;176
2006;"MIRANORTE (TO)";"TO";"MIRANORTE";169;7;5;181
2006;"MONTE DO CARMO (TO)";"TO";"MONTE DO CARMO";6;1;2;9
2006;"MONTE SANTO DO TOCANTINS (TO)";"TO";"MONTE SANTO DO TOCANTINS";53;2;1;56
2006;"MURICILANDIA (TO)";"TO";"MURICILANDIA";12;2;1;15
2006;"NATIVIDADE (TO)";"TO";"NATIVIDADE";35;1;1;37
2006;"NAZARE (TO)";"TO";"NAZARE";11;4;2;17
2006;"NOVA OLINDA (TO)";"TO";"NOVA OLINDA";47;5;5;57
2006;"NOVA ROSALANDIA (TO)";"TO";"NOVA ROSALANDIA";14;0;3;17
2006;"NOVO ACORDO (TO)";"TO";"NOVO ACORDO";15;0;1;16
2006;"NOVO ALEGRE (TO)";"TO";"NOVO ALEGRE";6;2;1;9
2006;"NOVO JARDIM (TO)";"TO";"NOVO JARDIM";6;0;2;8
2006;"OLIVEIRA DE FATIMA (TO)";"TO";"OLIVEIRA DE FATIMA";4;0;2;6
2006;"PALMAS (TO)";"TO";"PALMAS";2620;252;449;3321
2006;"PALMEIRANTE (TO)";"TO";"PALMEIRANTE";3;3;1;7
2006;"PALMEIRAS DO TOCANTINS (TO)";"TO";"PALMEIRAS DO TOCANTINS";23;4;1;28
2006;"PALMEIROPOLIS (TO)";"TO";"PALMEIROPOLIS";56;2;8;66
2006;"PARAISO DO TOCANTINS (TO)";"TO";"PARAISO DO TOCANTINS";806;21;102;929
2006;"PARANA (TO)";"TO";"PARANA";12;2;1;15
2006;"PAU D ARCO (TO)";"TO";"PAU D ARCO";7;0;1;8
2006;"PEDRO AFONSO (TO)";"TO";"PEDRO AFONSO";72;1;8;81
2006;"PEIXE (TO)";"TO";"PEIXE";34;6;64;104
2006;"PEQUIZEIRO (TO)";"TO";"PEQUIZEIRO";17;0;4;21
2006;"PINDORAMA DO TOCANTINS (TO)";"TO";"PINDORAMA DO TOCANTINS";16;0;2;18
2006;"PIRAQUE (TO)";"TO";"PIRAQUE";4;0;4;8
2006;"PIUM (TO)";"TO";"PIUM";26;2;4;32
2006;"PONTE ALTA DO BOM JESUS (TO)";"TO";"PONTE ALTA DO BOM JESUS";5;0;0;5
2006;"PONTE ALTA DO TOCANTINS (TO)";"TO";"PONTE ALTA DO TOCANTINS";17;4;3;24
2006;"PORTO ALEGRE DO TOCANTINS (TO)";"TO";"PORTO ALEGRE DO TOCANTINS";6;0;1;7
2006;"PORTO NACIONAL (TO)";"TO";"PORTO NACIONAL";471;17;75;563
2006;"PRAIA NORTE (TO)";"TO";"PRAIA NORTE";4;5;1;10
2006;"PRESIDENTE KENNEDY (TO)";"TO";"PRESIDENTE KENNEDY";16;2;1;19
2006;"PUGMIL (TO)";"TO";"PUGMIL";11;2;0;13
2006;"RECURSOLANDIA (TO)";"TO";"RECURSOLANDIA";8;0;0;8
2006;"RIACHINHO (TO)";"TO";"RIACHINHO";87;2;7;96
2006;"RIO DA CONCEICAO (TO)";"TO";"RIO DA CONCEICAO";4;1;1;6
2006;"RIO DOS BOIS (TO)";"TO";"RIO DOS BOIS";4;1;3;8
2006;"RIO SONO (TO)";"TO";"RIO SONO";14;1;3;18
2006;"SAMPAIO (TO)";"TO";"SAMPAIO";94;3;1;98
2006;"SANDOLANDIA (TO)";"TO";"SANDOLANDIA";6;1;1;8
2006;"SANTA FE DO ARAGUAIA (TO)";"TO";"SANTA FE DO ARAGUAIA";73;30;11;114
2006;"SANTA MARIA DO TOCANTINS (TO)";"TO";"SANTA MARIA DO TOCANTINS";7;2;0;9
2006;"SANTA RITA DO TOCANTINS (TO)";"TO";"SANTA RITA DO TOCANTINS";5;2;1;8
2006;"SANTA ROSA DO TOCANTINS (TO)";"TO";"SANTA ROSA DO TOCANTINS";15;1;2;18
2006;"SANTA TEREZA DO TOCANTINS (TO)";"TO";"SANTA TEREZA DO TOCANTINS";6;1;0;7
2006;"SANTA TEREZINHA DO TOCANTINS (TO)";"TO";"SANTA TEREZINHA DO TOCANTINS";4;2;3;9
2006;"SAO BENTO DO TOCANTINS (TO)";"TO";"SAO BENTO DO TOCANTINS";6;3;3;12
2006;"SAO FELIX DO TOCANTINS (TO)";"TO";"SAO FELIX DO TOCANTINS";1;1;0;2
2006;"SAO MIGUEL DO TOCANTINS (TO)";"TO";"SAO MIGUEL DO TOCANTINS";35;13;5;53
2006;"SAO SALVADOR DO TOCANTINS (TO)";"TO";"SAO SALVADOR DO TOCANTINS";29;0;1;30
2006;"SAO SEBASTIAO DO TOCANTINS (TO)";"TO";"SAO SEBASTIAO DO TOCANTINS";5;3;1;9
2006;"SAO VALERIO DA NATIVIDADE (TO)";"TO";"SAO VALERIO DA NATIVIDADE";27;1;4;32
2006;"SILVANOPOLIS (TO)";"TO";"SILVANOPOLIS";15;0;0;15
2006;"SITIO NOVO DO TOCANTINS (TO)";"TO";"SITIO NOVO DO TOCANTINS";25;6;5;36
2006;"SUCUPIRA (TO)";"TO";"SUCUPIRA";5;0;5;10
2006;"TAGUATINGA (TO)";"TO";"TAGUATINGA";45;4;10;59
2006;"TAIPAS DO TOCANTINS (TO)";"TO";"TAIPAS DO TOCANTINS";4;0;0;4
2006;"TALISMA (TO)";"TO";"TALISMA";8;5;0;13
2006;"TOCANTINIA (TO)";"TO";"TOCANTINIA";20;0;8;28
2006;"TOCANTINOPOLIS (TO)";"TO";"TOCANTINOPOLIS";1739;277;224;2240
2006;"TUPIRAMA (TO)";"TO";"TUPIRAMA";5;3;1;9
2006;"TUPIRATINS (TO)";"TO";"TUPIRATINS";5;0;2;7
2006;"WANDERLANDIA (TO)";"TO";"WANDERLANDIA";35;4;5;44
2006;"XAMBIOA (TO)";"TO";"XAMBIOA";43;4;4;51
