"ano";"chave";"UF";"MUNICIPIO";"CAMINHAO";"MICRO_ONIBUS";"ONIBUS";"total"
2009;"ACRELANDIA (AC)";"AC";"ACRELANDIA";124;1;17;142
2009;"ASSIS BRASIL (AC)";"AC";"ASSIS BRASIL";11;0;2;13
2009;"BRASILEIA (AC)";"AC";"BRASILEIA";127;0;6;133
2009;"BUJARI (AC)";"AC";"BUJARI";66;3;2;71
2009;"CAPIXABA (AC)";"AC";"CAPIXABA";48;1;5;54
2009;"CRUZEIRO DO SUL (AC)";"AC";"CRUZEIRO DO SUL";367;26;30;423
2009;"EPITACIOLANDIA (AC)";"AC";"EPITACIOLANDIA";104;1;9;114
2009;"FEIJO (AC)";"AC";"FEIJO";60;1;1;62
2009;"JORDAO (AC)";"AC";"JORDAO";0;0;0;0
2009;"MANCIO LIMA (AC)";"AC";"MANCIO LIMA";39;1;5;45
2009;"MANOEL URBANO (AC)";"AC";"MANOEL URBANO";11;0;0;11
2009;"MARECHAL THAUMATURGO (AC)";"AC";"MARECHAL THAUMATURGO";3;0;0;3
2009;"PLACIDO DE CASTRO (AC)";"AC";"PLACIDO DE CASTRO";91;1;3;95
2009;"PORTO ACRE (AC)";"AC";"PORTO ACRE";90;3;22;115
2009;"PORTO WALTER (AC)";"AC";"PORTO WALTER";0;0;0;0
2009;"RIO BRANCO (AC)";"AC";"RIO BRANCO";3163;114;397;3674
2009;"RODRIGUES ALVES (AC)";"AC";"RODRIGUES ALVES";4;0;0;4
2009;"SANTA ROSA (AC)";"AC";"SANTA ROSA";1;0;0;1
2009;"SENA MADUREIRA (AC)";"AC";"SENA MADUREIRA";77;2;2;81
2009;"SENADOR GUIOMARD (AC)";"AC";"SENADOR GUIOMARD";214;3;14;231
2009;"TARAUACA (AC)";"AC";"TARAUACA";89;0;2;91
2009;"XAPURI (AC)";"AC";"XAPURI";42;0;1;43
2009;"AGUA BRANCA (AL)";"AL";"AGUA BRANCA";40;68;4;112
2009;"ANADIA (AL)";"AL";"ANADIA";23;45;23;91
2009;"ARAPIRACA (AL)";"AL";"ARAPIRACA";2280;368;230;2878
2009;"ATALAIA (AL)";"AL";"ATALAIA";172;43;76;291
2009;"BARRA DE SANTO ANTONIO (AL)";"AL";"BARRA DE SANTO ANTONIO";19;8;9;36
2009;"BARRA DE SAO MIGUEL (AL)";"AL";"BARRA DE SAO MIGUEL";16;2;3;21
2009;"BATALHA (AL)";"AL";"BATALHA";60;11;1;72
2009;"BELEM (AL)";"AL";"BELEM";6;18;1;25
2009;"BELO MONTE (AL)";"AL";"BELO MONTE";21;3;0;24
2009;"BOCA DA MATA (AL)";"AL";"BOCA DA MATA";216;60;79;355
2009;"BRANQUINHA (AL)";"AL";"BRANQUINHA";9;22;4;35
2009;"CACIMBINHAS (AL)";"AL";"CACIMBINHAS";34;18;5;57
2009;"CAJUEIRO (AL)";"AL";"CAJUEIRO";86;13;34;133
2009;"CAMPESTRE (AL)";"AL";"CAMPESTRE";7;42;8;57
2009;"CAMPO ALEGRE (AL)";"AL";"CAMPO ALEGRE";128;109;99;336
2009;"CAMPO GRANDE (AL)";"AL";"CAMPO GRANDE";35;11;3;49
2009;"CANAPI (AL)";"AL";"CANAPI";21;20;10;51
2009;"CAPELA (AL)";"AL";"CAPELA";56;5;23;84
2009;"CARNEIROS (AL)";"AL";"CARNEIROS";18;1;0;19
2009;"CHA PRETA (AL)";"AL";"CHA PRETA";18;6;4;28
2009;"COITE DO NOIA (AL)";"AL";"COITE DO NOIA";33;4;9;46
2009;"COLONIA LEOPOLDINA (AL)";"AL";"COLONIA LEOPOLDINA";35;16;18;69
2009;"COQUEIRO SECO (AL)";"AL";"COQUEIRO SECO";5;4;2;11
2009;"CORURIPE (AL)";"AL";"CORURIPE";279;47;142;468
2009;"CRAIBAS (AL)";"AL";"CRAIBAS";61;16;14;91
2009;"DELMIRO GOUVEIA (AL)";"AL";"DELMIRO GOUVEIA";371;250;22;643
2009;"DOIS RIACHOS (AL)";"AL";"DOIS RIACHOS";42;10;2;54
2009;"ESTRELA DE ALAGOAS (AL)";"AL";"ESTRELA DE ALAGOAS";26;33;11;70
2009;"FEIRA GRANDE (AL)";"AL";"FEIRA GRANDE";28;0;20;48
2009;"FELIZ DESERTO (AL)";"AL";"FELIZ DESERTO";3;6;4;13
2009;"FLEXEIRAS (AL)";"AL";"FLEXEIRAS";20;18;26;64
2009;"GIRAU DO PONCIANO (AL)";"AL";"GIRAU DO PONCIANO";68;22;32;122
2009;"IBATEGUARA (AL)";"AL";"IBATEGUARA";24;55;8;87
2009;"IGACI (AL)";"AL";"IGACI";50;39;21;110
2009;"IGREJA NOVA (AL)";"AL";"IGREJA NOVA";57;18;50;125
2009;"INHAPI (AL)";"AL";"INHAPI";31;6;1;38
2009;"JACARE DOS HOMENS (AL)";"AL";"JACARE DOS HOMENS";26;1;3;30
2009;"JACUIPE (AL)";"AL";"JACUIPE";5;7;8;20
2009;"JAPARATINGA (AL)";"AL";"JAPARATINGA";10;12;2;24
2009;"JARAMATAIA (AL)";"AL";"JARAMATAIA";11;8;2;21
2009;"JEQUIA DA PRAIA (AL)";"AL";"JEQUIA DA PRAIA";14;8;14;36
2009;"JOAQUIM GOMES (AL)";"AL";"JOAQUIM GOMES";73;23;36;132
2009;"JUNDIA (AL)";"AL";"JUNDIA";8;4;8;20
2009;"JUNQUEIRO (AL)";"AL";"JUNQUEIRO";125;22;72;219
2009;"LAGOA DA CANOA (AL)";"AL";"LAGOA DA CANOA";44;10;19;73
2009;"LIMOEIRO DE ANADIA (AL)";"AL";"LIMOEIRO DE ANADIA";43;15;30;88
2009;"MACEIO (AL)";"AL";"MACEIO";4848;751;1358;6957
2009;"MAJOR ISIDORO (AL)";"AL";"MAJOR ISIDORO";48;16;7;71
2009;"MAR VERMELHO (AL)";"AL";"MAR VERMELHO";5;1;4;10
2009;"MARAGOGI (AL)";"AL";"MARAGOGI";31;66;18;115
2009;"MARAVILHA (AL)";"AL";"MARAVILHA";26;18;4;48
2009;"MARECHAL DEODORO (AL)";"AL";"MARECHAL DEODORO";174;79;51;304
2009;"MARIBONDO (AL)";"AL";"MARIBONDO";35;19;9;63
2009;"MATA GRANDE (AL)";"AL";"MATA GRANDE";44;19;2;65
2009;"MATRIZ DE CAMARAGIBE (AL)";"AL";"MATRIZ DE CAMARAGIBE";108;28;76;212
2009;"MESSIAS (AL)";"AL";"MESSIAS";50;33;52;135
2009;"MINADOR DO NEGRAO (AL)";"AL";"MINADOR DO NEGRAO";24;10;3;37
2009;"MONTEIROPOLIS (AL)";"AL";"MONTEIROPOLIS";6;2;3;11
2009;"MURICI (AL)";"AL";"MURICI";94;22;81;197
2009;"NOVO LINO (AL)";"AL";"NOVO LINO";46;21;23;90
2009;"OLHO D AGUA DAS FLORES (AL)";"AL";"OLHO D AGUA DAS FLORES";79;34;7;120
2009;"OLHO D AGUA DO CASADO (AL)";"AL";"OLHO D AGUA DO CASADO";17;11;5;33
2009;"OLHO D AGUA GRANDE (AL)";"AL";"OLHO D AGUA GRANDE";9;2;9;20
2009;"OLIVENCA (AL)";"AL";"OLIVENCA";19;7;4;30
2009;"OURO BRANCO (AL)";"AL";"OURO BRANCO";32;25;11;68
2009;"PALESTINA (AL)";"AL";"PALESTINA";5;4;1;10
2009;"PALMEIRA DOS INDIOS (AL)";"AL";"PALMEIRA DOS INDIOS";454;101;30;585
2009;"PAO DE ACUCAR (AL)";"AL";"PAO DE ACUCAR";51;15;5;71
2009;"PARICONHA (AL)";"AL";"PARICONHA";11;11;3;25
2009;"PARIPUEIRA (AL)";"AL";"PARIPUEIRA";40;3;7;50
2009;"PASSO DE CAMARAGIBE (AL)";"AL";"PASSO DE CAMARAGIBE";23;4;16;43
2009;"PAULO JACINTO (AL)";"AL";"PAULO JACINTO";9;4;3;16
2009;"PENEDO (AL)";"AL";"PENEDO";223;63;129;415
2009;"PIACABUCU (AL)";"AL";"PIACABUCU";17;23;7;47
2009;"PILAR (AL)";"AL";"PILAR";129;52;56;237
2009;"PINDOBA (AL)";"AL";"PINDOBA";10;1;1;12
2009;"PIRANHAS (AL)";"AL";"PIRANHAS";32;43;5;80
2009;"POCO DAS TRINCHEIRAS (AL)";"AL";"POCO DAS TRINCHEIRAS";34;28;13;75
2009;"PORTO CALVO (AL)";"AL";"PORTO CALVO";161;89;38;288
2009;"PORTO DE PEDRAS (AL)";"AL";"PORTO DE PEDRAS";5;9;3;17
2009;"PORTO REAL DO COLEGIO (AL)";"AL";"PORTO REAL DO COLEGIO";9;20;15;44
2009;"QUEBRANGULO (AL)";"AL";"QUEBRANGULO";16;4;2;22
2009;"RIO LARGO (AL)";"AL";"RIO LARGO";323;112;124;559
2009;"ROTEIRO (AL)";"AL";"ROTEIRO";12;16;5;33
2009;"SANTA LUZIA DO NORTE (AL)";"AL";"SANTA LUZIA DO NORTE";5;3;59;67
2009;"SANTANA DO IPANEMA (AL)";"AL";"SANTANA DO IPANEMA";291;65;19;375
2009;"SANTANA DO MUNDAU (AL)";"AL";"SANTANA DO MUNDAU";46;21;0;67
2009;"SAO BRAS (AL)";"AL";"SAO BRAS";1;1;2;4
2009;"SAO JOSE DA LAJE (AL)";"AL";"SAO JOSE DA LAJE";74;65;37;176
2009;"SAO JOSE DA TAPERA (AL)";"AL";"SAO JOSE DA TAPERA";61;12;7;80
2009;"SAO LUIS DO QUITUNDE (AL)";"AL";"SAO LUIS DO QUITUNDE";209;17;84;310
2009;"SAO MIGUEL DOS CAMPOS (AL)";"AL";"SAO MIGUEL DOS CAMPOS";421;135;140;696
2009;"SAO MIGUEL DOS MILAGRES (AL)";"AL";"SAO MIGUEL DOS MILAGRES";16;1;4;21
2009;"SAO SEBASTIAO (AL)";"AL";"SAO SEBASTIAO";105;25;66;196
2009;"SATUBA (AL)";"AL";"SATUBA";44;15;9;68
2009;"SENADOR RUI PALMEIRA (AL)";"AL";"SENADOR RUI PALMEIRA";21;5;5;31
2009;"TANQUE D ARCA (AL)";"AL";"TANQUE D ARCA";8;5;2;15
2009;"TAQUARANA (AL)";"AL";"TAQUARANA";48;23;15;86
2009;"TEOTONIO VILELA (AL)";"AL";"TEOTONIO VILELA";163;77;132;372
2009;"TRAIPU (AL)";"AL";"TRAIPU";51;9;6;66
2009;"UNIAO DOS PALMARES (AL)";"AL";"UNIAO DOS PALMARES";376;192;106;674
2009;"VICOSA (AL)";"AL";"VICOSA";106;10;24;140
2009;"ALVARAES (AM)";"AM";"ALVARAES";1;0;1;2
2009;"AMATURA (AM)";"AM";"AMATURA";1;0;0;1
2009;"ANAMA (AM)";"AM";"ANAMA";0;0;2;2
2009;"ANORI (AM)";"AM";"ANORI";1;0;1;2
2009;"APUI (AM)";"AM";"APUI";43;2;7;52
2009;"ATALAIA DO NORTE (AM)";"AM";"ATALAIA DO NORTE";1;0;1;2
2009;"AUTAZES (AM)";"AM";"AUTAZES";11;3;5;19
2009;"BARCELOS (AM)";"AM";"BARCELOS";7;1;0;8
2009;"BARREIRINHA (AM)";"AM";"BARREIRINHA";1;0;0;1
2009;"BENJAMIN CONSTANT (AM)";"AM";"BENJAMIN CONSTANT";9;3;1;13
2009;"BERURI (AM)";"AM";"BERURI";0;0;0;0
2009;"BOA VISTA DO RAMOS (AM)";"AM";"BOA VISTA DO RAMOS";1;0;0;1
2009;"BOCA DO ACRE (AM)";"AM";"BOCA DO ACRE";20;2;0;22
2009;"BORBA (AM)";"AM";"BORBA";5;0;0;5
2009;"CAAPIRANGA (AM)";"AM";"CAAPIRANGA";4;1;1;6
2009;"CANUTAMA (AM)";"AM";"CANUTAMA";0;0;0;0
2009;"CARAUARI (AM)";"AM";"CARAUARI";16;1;0;17
2009;"CAREIRO (AM)";"AM";"CAREIRO";39;12;35;86
2009;"CAREIRO DA VARZEA (AM)";"AM";"CAREIRO DA VARZEA";7;21;18;46
2009;"COARI (AM)";"AM";"COARI";84;3;6;93
2009;"CODAJAS (AM)";"AM";"CODAJAS";6;0;2;8
2009;"EIRUNEPE (AM)";"AM";"EIRUNEPE";20;0;0;20
2009;"ENVIRA (AM)";"AM";"ENVIRA";10;0;1;11
2009;"FONTE BOA (AM)";"AM";"FONTE BOA";12;0;0;12
2009;"GUAJARA (AM)";"AM";"GUAJARA";0;0;0;0
2009;"HUMAITA (AM)";"AM";"HUMAITA";93;1;7;101
2009;"IPIXUNA (AM)";"AM";"IPIXUNA";1;0;0;1
2009;"IRANDUBA (AM)";"AM";"IRANDUBA";127;8;39;174
2009;"ITACOATIARA (AM)";"AM";"ITACOATIARA";252;16;75;343
2009;"ITAMARATI (AM)";"AM";"ITAMARATI";2;0;0;2
2009;"ITAPIRANGA (AM)";"AM";"ITAPIRANGA";4;1;2;7
2009;"JAPURA (AM)";"AM";"JAPURA";3;0;0;3
2009;"JURUA (AM)";"AM";"JURUA";4;0;0;4
2009;"JUTAI (AM)";"AM";"JUTAI";2;0;0;2
2009;"LABREA (AM)";"AM";"LABREA";10;1;1;12
2009;"MANACAPURU (AM)";"AM";"MANACAPURU";201;27;52;280
2009;"MANAQUIRI (AM)";"AM";"MANAQUIRI";6;2;1;9
2009;"MANAUS (AM)";"AM";"MANAUS";13729;2166;5417;21312
2009;"MANICORE (AM)";"AM";"MANICORE";11;1;4;16
2009;"MARAA (AM)";"AM";"MARAA";2;0;0;2
2009;"MAUES (AM)";"AM";"MAUES";28;0;5;33
2009;"NHAMUNDA (AM)";"AM";"NHAMUNDA";4;0;0;4
2009;"NOVA OLINDA DO NORTE (AM)";"AM";"NOVA OLINDA DO NORTE";9;6;3;18
2009;"NOVO AIRAO (AM)";"AM";"NOVO AIRAO";14;4;14;32
2009;"NOVO ARIPUANA (AM)";"AM";"NOVO ARIPUANA";10;1;4;15
2009;"PARINTINS (AM)";"AM";"PARINTINS";107;3;9;119
2009;"PAUINI (AM)";"AM";"PAUINI";2;1;0;3
2009;"PRESIDENTE FIGUEIREDO (AM)";"AM";"PRESIDENTE FIGUEIREDO";173;27;42;242
2009;"RIO PRETO DA EVA (AM)";"AM";"RIO PRETO DA EVA";60;9;41;110
2009;"SANTA ISABEL DO RIO NEGRO (AM)";"AM";"SANTA ISABEL DO RIO NEGRO";5;2;3;10
2009;"SANTO ANTONIO DO ICA (AM)";"AM";"SANTO ANTONIO DO ICA";5;0;0;5
2009;"SAO GABRIEL DA CACHOEIRA (AM)";"AM";"SAO GABRIEL DA CACHOEIRA";58;7;20;85
2009;"SAO PAULO DE OLIVENCA (AM)";"AM";"SAO PAULO DE OLIVENCA";3;0;0;3
2009;"SAO SEBASTIAO DO UATUMA (AM)";"AM";"SAO SEBASTIAO DO UATUMA";3;0;0;3
2009;"SILVES (AM)";"AM";"SILVES";7;2;1;10
2009;"TABATINGA (AM)";"AM";"TABATINGA";37;3;0;40
2009;"TAPAUA (AM)";"AM";"TAPAUA";1;0;1;2
2009;"TEFE (AM)";"AM";"TEFE";39;9;4;52
2009;"TONANTINS (AM)";"AM";"TONANTINS";1;1;0;2
2009;"UARINI (AM)";"AM";"UARINI";1;0;0;1
2009;"URUCARA (AM)";"AM";"URUCARA";10;1;1;12
2009;"URUCURITUBA (AM)";"AM";"URUCURITUBA";2;0;0;2
2009;"AMAPA (AP)";"AP";"AMAPA";6;2;1;9
2009;"AMAPARI (AP)";"AP";"AMAPARI";11;2;3;16
2009;"CALCOENE (AP)";"AP";"CALCOENE";5;0;1;6
2009;"CUTIAS (AP)";"AP";"CUTIAS";1;1;0;2
2009;"FERREIRA GOMES (AP)";"AP";"FERREIRA GOMES";3;0;0;3
2009;"ITAUBAL (AP)";"AP";"ITAUBAL";3;0;2;5
2009;"LARANJAL DO JARI (AP)";"AP";"LARANJAL DO JARI";50;7;7;64
2009;"MACAPA (AP)";"AP";"MACAPA";2329;231;456;3016
2009;"MAZAGAO (AP)";"AP";"MAZAGAO";53;4;8;65
2009;"OIAPOQUE (AP)";"AP";"OIAPOQUE";35;5;3;43
2009;"PORTO GRANDE (AP)";"AP";"PORTO GRANDE";19;0;5;24
2009;"PRACUUBA (AP)";"AP";"PRACUUBA";3;0;0;3
2009;"SANTANA (AP)";"AP";"SANTANA";455;32;56;543
2009;"SERRA DO NAVIO (AP)";"AP";"SERRA DO NAVIO";1;3;0;4
2009;"TARTARUGALZINHO (AP)";"AP";"TARTARUGALZINHO";5;0;0;5
2009;"VITORIA DO JARI (AP)";"AP";"VITORIA DO JARI";0;0;1;1
2009;"ABAIRA (BA)";"BA";"ABAIRA";42;9;13;64
2009;"ABARE (BA)";"BA";"ABARE";40;10;15;65
2009;"ACAJUTIBA (BA)";"BA";"ACAJUTIBA";47;6;10;63
2009;"ADUSTINA (BA)";"BA";"ADUSTINA";5;6;5;16
2009;"AGUA FRIA (BA)";"BA";"AGUA FRIA";9;11;27;47
2009;"AIQUARA (BA)";"BA";"AIQUARA";4;2;2;8
2009;"ALAGOINHAS (BA)";"BA";"ALAGOINHAS";917;218;361;1496
2009;"ALCOBACA (BA)";"BA";"ALCOBACA";24;2;17;43
2009;"ALMADINA (BA)";"BA";"ALMADINA";15;1;3;19
2009;"AMARGOSA (BA)";"BA";"AMARGOSA";206;35;47;288
2009;"AMELIA RODRIGUES (BA)";"BA";"AMELIA RODRIGUES";172;48;22;242
2009;"AMERICA DOURADA (BA)";"BA";"AMERICA DOURADA";16;6;3;25
2009;"ANAGE (BA)";"BA";"ANAGE";50;32;30;112
2009;"ANDARAI (BA)";"BA";"ANDARAI";21;3;8;32
2009;"ANDORINHA (BA)";"BA";"ANDORINHA";54;7;27;88
2009;"ANGICAL (BA)";"BA";"ANGICAL";26;10;13;49
2009;"ANGUERA (BA)";"BA";"ANGUERA";16;3;10;29
2009;"ANTAS (BA)";"BA";"ANTAS";22;5;6;33
2009;"ANTONIO CARDOSO (BA)";"BA";"ANTONIO CARDOSO";2;20;8;30
2009;"ANTONIO GONCALVES (BA)";"BA";"ANTONIO GONCALVES";19;4;5;28
2009;"APORA (BA)";"BA";"APORA";23;13;15;51
2009;"APUAREMA (BA)";"BA";"APUAREMA";25;4;7;36
2009;"ARACAS (BA)";"BA";"ARACAS";52;9;21;82
2009;"ARACATU (BA)";"BA";"ARACATU";57;13;14;84
2009;"ARACI (BA)";"BA";"ARACI";158;14;38;210
2009;"ARAMARI (BA)";"BA";"ARAMARI";22;4;6;32
2009;"ARATACA (BA)";"BA";"ARATACA";18;0;2;20
2009;"ARATUIPE (BA)";"BA";"ARATUIPE";23;3;9;35
2009;"AURELINO LEAL (BA)";"BA";"AURELINO LEAL";37;3;11;51
2009;"BAIANOPOLIS (BA)";"BA";"BAIANOPOLIS";35;5;19;59
2009;"BAIXA GRANDE (BA)";"BA";"BAIXA GRANDE";58;26;31;115
2009;"BANZAE (BA)";"BA";"BANZAE";17;3;14;34
2009;"BARRA (BA)";"BA";"BARRA";36;13;19;68
2009;"BARRA DA ESTIVA (BA)";"BA";"BARRA DA ESTIVA";142;26;39;207
2009;"BARRA DO CHOCA (BA)";"BA";"BARRA DO CHOCA";85;116;19;220
2009;"BARRA DO MENDES (BA)";"BA";"BARRA DO MENDES";47;11;4;62
2009;"BARRA DO ROCHA (BA)";"BA";"BARRA DO ROCHA";6;4;0;10
2009;"BARREIRAS (BA)";"BA";"BARREIRAS";2027;86;265;2378
2009;"BARRO ALTO (BA)";"BA";"BARRO ALTO";30;5;10;45
2009;"BARRO PRETO (BA)";"BA";"BARRO PRETO";8;1;7;16
2009;"BARROCAS (BA)";"BA";"BARROCAS";59;1;13;73
2009;"BELMONTE (BA)";"BA";"BELMONTE";38;1;7;46
2009;"BELO CAMPO (BA)";"BA";"BELO CAMPO";67;8;17;92
2009;"BIRITINGA (BA)";"BA";"BIRITINGA";16;8;23;47
2009;"BOA NOVA (BA)";"BA";"BOA NOVA";17;9;14;40
2009;"BOA VISTA DO TUPIM (BA)";"BA";"BOA VISTA DO TUPIM";43;7;13;63
2009;"BOM JESUS DA LAPA (BA)";"BA";"BOM JESUS DA LAPA";355;36;79;470
2009;"BOM JESUS DA SERRA (BA)";"BA";"BOM JESUS DA SERRA";19;28;14;61
2009;"BONINAL (BA)";"BA";"BONINAL";58;14;23;95
2009;"BONITO (BA)";"BA";"BONITO";46;6;7;59
2009;"BOQUIRA (BA)";"BA";"BOQUIRA";86;6;46;138
2009;"BOTUPORA (BA)";"BA";"BOTUPORA";31;4;31;66
2009;"BREJOES (BA)";"BA";"BREJOES";68;4;23;95
2009;"BREJOLANDIA (BA)";"BA";"BREJOLANDIA";25;8;16;49
2009;"BROTAS DE MACAUBAS (BA)";"BA";"BROTAS DE MACAUBAS";18;17;11;46
2009;"BRUMADO (BA)";"BA";"BRUMADO";899;147;203;1249
2009;"BUERAREMA (BA)";"BA";"BUERAREMA";103;5;21;129
2009;"BURITIRAMA (BA)";"BA";"BURITIRAMA";11;3;11;25
2009;"CAATIBA (BA)";"BA";"CAATIBA";12;3;0;15
2009;"CABACEIRAS DO PARAGUACU (BA)";"BA";"CABACEIRAS DO PARAGUACU";36;14;29;79
2009;"CACHOEIRA (BA)";"BA";"CACHOEIRA";84;78;59;221
2009;"CACULE (BA)";"BA";"CACULE";246;16;43;305
2009;"CAEM (BA)";"BA";"CAEM";13;5;8;26
2009;"CAETANOS (BA)";"BA";"CAETANOS";30;7;7;44
2009;"CAETITE (BA)";"BA";"CAETITE";390;54;74;518
2009;"CAFARNAUM (BA)";"BA";"CAFARNAUM";38;4;19;61
2009;"CAIRU (BA)";"BA";"CAIRU";7;5;2;14
2009;"CALDEIRAO GRANDE (BA)";"BA";"CALDEIRAO GRANDE";23;2;10;35
2009;"CAMACAN (BA)";"BA";"CAMACAN";173;23;36;232
2009;"CAMACARI (BA)";"BA";"CAMACARI";1590;315;972;2877
2009;"CAMAMU (BA)";"BA";"CAMAMU";101;34;26;161
2009;"CAMPO ALEGRE DE LOURDES (BA)";"BA";"CAMPO ALEGRE DE LOURDES";39;6;5;50
2009;"CAMPO FORMOSO (BA)";"BA";"CAMPO FORMOSO";164;22;62;248
2009;"CANAPOLIS (BA)";"BA";"CANAPOLIS";8;14;11;33
2009;"CANARANA (BA)";"BA";"CANARANA";111;6;9;126
2009;"CANAVIEIRAS (BA)";"BA";"CANAVIEIRAS";68;8;12;88
2009;"CANDEAL (BA)";"BA";"CANDEAL";17;13;6;36
2009;"CANDEIAS (BA)";"BA";"CANDEIAS";695;223;262;1180
2009;"CANDIBA (BA)";"BA";"CANDIBA";44;0;21;65
2009;"CANDIDO SALES (BA)";"BA";"CANDIDO SALES";273;20;33;326
2009;"CANSANCAO (BA)";"BA";"CANSANCAO";94;20;28;142
2009;"CANUDOS (BA)";"BA";"CANUDOS";32;2;27;61
2009;"CAPELA DO ALTO ALEGRE (BA)";"BA";"CAPELA DO ALTO ALEGRE";42;15;17;74
2009;"CAPIM GROSSO (BA)";"BA";"CAPIM GROSSO";403;24;38;465
2009;"CARAIBAS (BA)";"BA";"CARAIBAS";24;16;12;52
2009;"CARAVELAS (BA)";"BA";"CARAVELAS";29;12;32;73
2009;"CARDEAL DA SILVA (BA)";"BA";"CARDEAL DA SILVA";19;6;2;27
2009;"CARINHANHA (BA)";"BA";"CARINHANHA";105;13;26;144
2009;"CASA NOVA (BA)";"BA";"CASA NOVA";275;143;136;554
2009;"CASTRO ALVES (BA)";"BA";"CASTRO ALVES";121;17;51;189
2009;"CATOLANDIA (BA)";"BA";"CATOLANDIA";4;3;3;10
2009;"CATU (BA)";"BA";"CATU";331;88;74;493
2009;"CATURAMA (BA)";"BA";"CATURAMA";21;4;7;32
2009;"CENTRAL (BA)";"BA";"CENTRAL";71;8;7;86
2009;"CHORROCHO (BA)";"BA";"CHORROCHO";14;2;4;20
2009;"CICERO DANTAS (BA)";"BA";"CICERO DANTAS";78;14;26;118
2009;"CIPO (BA)";"BA";"CIPO";32;3;5;40
2009;"COARACI (BA)";"BA";"COARACI";73;3;18;94
2009;"COCOS (BA)";"BA";"COCOS";54;5;32;91
2009;"CONCEICAO DA FEIRA (BA)";"BA";"CONCEICAO DA FEIRA";210;88;10;308
2009;"CONCEICAO DO ALMEIDA (BA)";"BA";"CONCEICAO DO ALMEIDA";90;28;18;136
2009;"CONCEICAO DO COITE (BA)";"BA";"CONCEICAO DO COITE";355;58;88;501
2009;"CONCEICAO DO JACUIPE (BA)";"BA";"CONCEICAO DO JACUIPE";212;111;13;336
2009;"CONDE (BA)";"BA";"CONDE";34;10;11;55
2009;"CONDEUBA (BA)";"BA";"CONDEUBA";89;22;47;158
2009;"CONTENDAS DO SINCORA (BA)";"BA";"CONTENDAS DO SINCORA";14;7;4;25
2009;"CORACAO DE MARIA (BA)";"BA";"CORACAO DE MARIA";91;19;37;147
2009;"CORDEIROS (BA)";"BA";"CORDEIROS";28;13;14;55
2009;"CORIBE (BA)";"BA";"CORIBE";38;13;14;65
2009;"CORONEL JOAO SA (BA)";"BA";"CORONEL JOAO SA";17;0;24;41
2009;"CORRENTINA (BA)";"BA";"CORRENTINA";119;16;56;191
2009;"COTEGIPE (BA)";"BA";"COTEGIPE";28;7;11;46
2009;"CRAVOLANDIA (BA)";"BA";"CRAVOLANDIA";16;1;4;21
2009;"CRISOPOLIS (BA)";"BA";"CRISOPOLIS";49;15;23;87
2009;"CRISTOPOLIS (BA)";"BA";"CRISTOPOLIS";43;9;21;73
2009;"CRUZ DAS ALMAS (BA)";"BA";"CRUZ DAS ALMAS";820;177;61;1058
2009;"CURACA (BA)";"BA";"CURACA";49;26;22;97
2009;"DARIO MEIRA (BA)";"BA";"DARIO MEIRA";11;11;5;27
2009;"DIAS D AVILA (BA)";"BA";"DIAS D AVILA";556;61;346;963
2009;"DOM BASILIO (BA)";"BA";"DOM BASILIO";219;6;15;240
2009;"DOM MACEDO COSTA (BA)";"BA";"DOM MACEDO COSTA";10;10;5;25
2009;"ELISIO MEDRADO (BA)";"BA";"ELISIO MEDRADO";20;6;9;35
2009;"ENCRUZILHADA (BA)";"BA";"ENCRUZILHADA";64;27;11;102
2009;"ENTRE RIOS (BA)";"BA";"ENTRE RIOS";156;66;77;299
2009;"ERICO CARDOSO (BA)";"BA";"ERICO CARDOSO";21;3;14;38
2009;"ESPLANADA (BA)";"BA";"ESPLANADA";124;31;60;215
2009;"EUCLIDES DA CUNHA (BA)";"BA";"EUCLIDES DA CUNHA";204;20;103;327
2009;"EUNAPOLIS (BA)";"BA";"EUNAPOLIS";1039;76;241;1356
2009;"FATIMA (BA)";"BA";"FATIMA";9;5;16;30
2009;"FEIRA DA MATA (BA)";"BA";"FEIRA DA MATA";13;8;5;26
2009;"FEIRA DE SANTANA (BA)";"BA";"FEIRA DE SANTANA";6694;801;1043;8538
2009;"FILADELFIA (BA)";"BA";"FILADELFIA";75;8;19;102
2009;"FIRMINO ALVES (BA)";"BA";"FIRMINO ALVES";11;1;1;13
2009;"FLORESTA AZUL (BA)";"BA";"FLORESTA AZUL";31;1;1;33
2009;"FORMOSA DO RIO PRETO (BA)";"BA";"FORMOSA DO RIO PRETO";86;2;12;100
2009;"GANDU (BA)";"BA";"GANDU";225;20;17;262
2009;"GAVIAO (BA)";"BA";"GAVIAO";10;8;5;23
2009;"GENTIO DO OURO (BA)";"BA";"GENTIO DO OURO";9;0;1;10
2009;"GLORIA (BA)";"BA";"GLORIA";43;19;33;95
2009;"GONGOGI (BA)";"BA";"GONGOGI";5;1;2;8
2009;"GOVERNADOR MANGABEIRA (BA)";"BA";"GOVERNADOR MANGABEIRA";129;25;32;186
2009;"GUAJERU (BA)";"BA";"GUAJERU";9;18;6;33
2009;"GUANAMBI (BA)";"BA";"GUANAMBI";938;63;116;1117
2009;"GUARATINGA (BA)";"BA";"GUARATINGA";57;5;20;82
2009;"HELIOPOLIS (BA)";"BA";"HELIOPOLIS";17;7;7;31
2009;"IACU (BA)";"BA";"IACU";100;16;22;138
2009;"IBIASSUCE (BA)";"BA";"IBIASSUCE";57;12;9;78
2009;"IBICARAI (BA)";"BA";"IBICARAI";108;8;20;136
2009;"IBICOARA (BA)";"BA";"IBICOARA";154;22;45;221
2009;"IBICUI (BA)";"BA";"IBICUI";37;8;9;54
2009;"IBIPEBA (BA)";"BA";"IBIPEBA";30;7;5;42
2009;"IBIPITANGA (BA)";"BA";"IBIPITANGA";56;11;21;88
2009;"IBIQUERA (BA)";"BA";"IBIQUERA";6;5;0;11
2009;"IBIRAPITANGA (BA)";"BA";"IBIRAPITANGA";37;4;9;50
2009;"IBIRAPUA (BA)";"BA";"IBIRAPUA";35;4;6;45
2009;"IBIRATAIA (BA)";"BA";"IBIRATAIA";76;28;7;111
2009;"IBITIARA (BA)";"BA";"IBITIARA";78;23;29;130
2009;"IBITITA (BA)";"BA";"IBITITA";32;1;9;42
2009;"IBOTIRAMA (BA)";"BA";"IBOTIRAMA";160;46;23;229
2009;"ICHU (BA)";"BA";"ICHU";15;6;10;31
2009;"IGAPORA (BA)";"BA";"IGAPORA";79;14;13;106
2009;"IGRAPIUNA (BA)";"BA";"IGRAPIUNA";34;19;14;67
2009;"IGUAI (BA)";"BA";"IGUAI";48;22;25;95
2009;"ILHEUS (BA)";"BA";"ILHEUS";514;123;296;933
2009;"INHAMBUPE (BA)";"BA";"INHAMBUPE";136;62;76;274
2009;"IPECAETA (BA)";"BA";"IPECAETA";5;3;33;41
2009;"IPIAU (BA)";"BA";"IPIAU";310;20;29;359
2009;"IPIRA (BA)";"BA";"IPIRA";315;32;69;416
2009;"IPUPIARA (BA)";"BA";"IPUPIARA";30;16;1;47
2009;"IRAJUBA (BA)";"BA";"IRAJUBA";22;2;18;42
2009;"IRAMAIA (BA)";"BA";"IRAMAIA";24;4;8;36
2009;"IRAQUARA (BA)";"BA";"IRAQUARA";98;22;19;139
2009;"IRARA (BA)";"BA";"IRARA";111;36;48;195
2009;"IRECE (BA)";"BA";"IRECE";641;44;41;726
2009;"ITABELA (BA)";"BA";"ITABELA";213;12;51;276
2009;"ITABERABA (BA)";"BA";"ITABERABA";399;51;39;489
2009;"ITABUNA (BA)";"BA";"ITABUNA";1526;52;676;2254
2009;"ITACARE (BA)";"BA";"ITACARE";16;19;5;40
2009;"ITAETE (BA)";"BA";"ITAETE";55;8;16;79
2009;"ITAGI (BA)";"BA";"ITAGI";28;2;2;32
2009;"ITAGIBA (BA)";"BA";"ITAGIBA";25;22;14;61
2009;"ITAGIMIRIM (BA)";"BA";"ITAGIMIRIM";40;2;2;44
2009;"ITAGUACU DA BAHIA (BA)";"BA";"ITAGUACU DA BAHIA";17;0;6;23
2009;"ITAJU DO COLONIA (BA)";"BA";"ITAJU DO COLONIA";9;0;3;12
2009;"ITAJUIPE (BA)";"BA";"ITAJUIPE";61;6;14;81
2009;"ITAMARAJU (BA)";"BA";"ITAMARAJU";363;18;107;488
2009;"ITAMARI (BA)";"BA";"ITAMARI";31;3;1;35
2009;"ITAMBE (BA)";"BA";"ITAMBE";56;26;6;88
2009;"ITANAGRA (BA)";"BA";"ITANAGRA";16;2;1;19
2009;"ITANHEM (BA)";"BA";"ITANHEM";42;8;15;65
2009;"ITAPARICA (BA)";"BA";"ITAPARICA";20;30;38;88
2009;"ITAPE (BA)";"BA";"ITAPE";18;0;1;19
2009;"ITAPEBI (BA)";"BA";"ITAPEBI";46;1;8;55
2009;"ITAPETINGA (BA)";"BA";"ITAPETINGA";434;46;91;571
2009;"ITAPICURU (BA)";"BA";"ITAPICURU";21;17;31;69
2009;"ITAPITANGA (BA)";"BA";"ITAPITANGA";13;3;3;19
2009;"ITAQUARA (BA)";"BA";"ITAQUARA";27;2;2;31
2009;"ITARANTIM (BA)";"BA";"ITARANTIM";63;4;3;70
2009;"ITATIM (BA)";"BA";"ITATIM";111;21;22;154
2009;"ITIRUCU (BA)";"BA";"ITIRUCU";98;6;14;118
2009;"ITIUBA (BA)";"BA";"ITIUBA";61;27;45;133
2009;"ITORORO (BA)";"BA";"ITORORO";80;15;18;113
2009;"ITUACU (BA)";"BA";"ITUACU";105;13;17;135
2009;"ITUBERA (BA)";"BA";"ITUBERA";119;13;14;146
2009;"IUIU (BA)";"BA";"IUIU";30;4;2;36
2009;"JABORANDI (BA)";"BA";"JABORANDI";47;2;20;69
2009;"JACARACI (BA)";"BA";"JACARACI";36;9;19;64
2009;"JACOBINA (BA)";"BA";"JACOBINA";606;77;145;828
2009;"JAGUAQUARA (BA)";"BA";"JAGUAQUARA";469;9;43;521
2009;"JAGUARARI (BA)";"BA";"JAGUARARI";146;45;59;250
2009;"JAGUARIPE (BA)";"BA";"JAGUARIPE";31;6;15;52
2009;"JANDAIRA (BA)";"BA";"JANDAIRA";15;3;8;26
2009;"JEQUIE (BA)";"BA";"JEQUIE";1308;70;297;1675
2009;"JEREMOABO (BA)";"BA";"JEREMOABO";74;19;27;120
2009;"JIQUIRICA (BA)";"BA";"JIQUIRICA";31;18;16;65
2009;"JITAUNA (BA)";"BA";"JITAUNA";24;8;5;37
2009;"JOAO DOURADO (BA)";"BA";"JOAO DOURADO";72;11;9;92
2009;"JUAZEIRO (BA)";"BA";"JUAZEIRO";2562;663;718;3943
2009;"JUCURUCU (BA)";"BA";"JUCURUCU";11;0;2;13
2009;"JUSSARA (BA)";"BA";"JUSSARA";41;11;17;69
2009;"JUSSARI (BA)";"BA";"JUSSARI";11;1;3;15
2009;"JUSSIAPE (BA)";"BA";"JUSSIAPE";51;10;14;75
2009;"LAFAIETE COUTINHO (BA)";"BA";"LAFAIETE COUTINHO";11;4;2;17
2009;"LAGEDO DO TABOCAL (BA)";"BA";"LAGEDO DO TABOCAL";25;2;5;32
2009;"LAGOA REAL (BA)";"BA";"LAGOA REAL";25;5;12;42
2009;"LAJE (BA)";"BA";"LAJE";103;37;29;169
2009;"LAJEDAO (BA)";"BA";"LAJEDAO";6;1;7;14
2009;"LAJEDINHO (BA)";"BA";"LAJEDINHO";8;3;4;15
2009;"LAMARAO (BA)";"BA";"LAMARAO";4;1;4;9
2009;"LAPAO (BA)";"BA";"LAPAO";96;5;22;123
2009;"LAURO DE FREITAS (BA)";"BA";"LAURO DE FREITAS";1736;363;419;2518
2009;"LENCOIS (BA)";"BA";"LENCOIS";12;11;1;24
2009;"LICINIO DE ALMEIDA (BA)";"BA";"LICINIO DE ALMEIDA";93;10;12;115
2009;"LIVRAMENTO DO BRUMADO (BA)";"BA";"LIVRAMENTO DO BRUMADO";319;37;70;426
2009;"LUIZ EDUARDO MAGALHAES (BA)";"BA";"LUIZ EDUARDO MAGALHAES";991;37;70;1098
2009;"MACAJUBA (BA)";"BA";"MACAJUBA";16;17;25;58
2009;"MACAUBAS (BA)";"BA";"MACAUBAS";152;13;218;383
2009;"MACURURE (BA)";"BA";"MACURURE";7;3;5;15
2009;"MADRE DE DEUS (BA)";"BA";"MADRE DE DEUS";58;34;32;124
2009;"MAETINGA (BA)";"BA";"MAETINGA";23;6;9;38
2009;"MAIQUINIQUE (BA)";"BA";"MAIQUINIQUE";43;2;8;53
2009;"MAIRI (BA)";"BA";"MAIRI";53;17;28;98
2009;"MALHADA (BA)";"BA";"MALHADA";29;3;7;39
2009;"MALHADA DAS PEDRAS (BA)";"BA";"MALHADA DAS PEDRAS";61;32;27;120
2009;"MANOEL VITORINO (BA)";"BA";"MANOEL VITORINO";42;8;8;58
2009;"MANSIDAO (BA)";"BA";"MANSIDAO";6;0;6;12
2009;"MARACANI (BA)";"BA";"MARACANI";73;5;15;93
2009;"MARACAS (BA)";"BA";"MARACAS";147;10;38;195
2009;"MARAGOGIPE (BA)";"BA";"MARAGOGIPE";91;21;17;129
2009;"MARAU (BA)";"BA";"MARAU";8;2;0;10
2009;"MARCIONILIO SOUZA (BA)";"BA";"MARCIONILIO SOUZA";15;12;11;38
2009;"MASCOTE (BA)";"BA";"MASCOTE";39;4;7;50
2009;"MATA DE SAO JOAO (BA)";"BA";"MATA DE SAO JOAO";180;62;39;281
2009;"MATINA (BA)";"BA";"MATINA";15;2;16;33
2009;"MEDEIROS NETO (BA)";"BA";"MEDEIROS NETO";76;10;21;107
2009;"MIGUEL CALMON (BA)";"BA";"MIGUEL CALMON";86;11;25;122
2009;"MILAGRES (BA)";"BA";"MILAGRES";111;5;12;128
2009;"MIRANGABA (BA)";"BA";"MIRANGABA";33;10;18;61
2009;"MIRANTE (BA)";"BA";"MIRANTE";26;9;14;49
2009;"MONTE SANTO (BA)";"BA";"MONTE SANTO";123;17;85;225
2009;"MORPARA (BA)";"BA";"MORPARA";11;9;2;22
2009;"MORRO DO CHAPEU (BA)";"BA";"MORRO DO CHAPEU";111;25;12;148
2009;"MORTUGABA (BA)";"BA";"MORTUGABA";61;5;9;75
2009;"MUCUGE (BA)";"BA";"MUCUGE";88;10;31;129
2009;"MUCURI (BA)";"BA";"MUCURI";82;21;34;137
2009;"MULUNGU DO MORRO (BA)";"BA";"MULUNGU DO MORRO";34;6;4;44
2009;"MUNDO NOVO (BA)";"BA";"MUNDO NOVO";46;11;19;76
2009;"MUNIZ FERREIRA (BA)";"BA";"MUNIZ FERREIRA";33;55;3;91
2009;"MUQUEM DO SAO FRANCISCO (BA)";"BA";"MUQUEM DO SAO FRANCISCO";8;12;17;37
2009;"MURITIBA (BA)";"BA";"MURITIBA";110;29;29;168
2009;"MUTUIPE (BA)";"BA";"MUTUIPE";100;47;32;179
2009;"NAZARE (BA)";"BA";"NAZARE";199;39;22;260
2009;"NILO PECANHA (BA)";"BA";"NILO PECANHA";32;21;9;62
2009;"NORDESTINA (BA)";"BA";"NORDESTINA";21;6;13;40
2009;"NOVA CANAA (BA)";"BA";"NOVA CANAA";42;6;9;57
2009;"NOVA FATIMA (BA)";"BA";"NOVA FATIMA";44;2;4;50
2009;"NOVA IBIA (BA)";"BA";"NOVA IBIA";18;2;4;24
2009;"NOVA ITARANA (BA)";"BA";"NOVA ITARANA";16;5;3;24
2009;"NOVA REDENCAO (BA)";"BA";"NOVA REDENCAO";11;6;3;20
2009;"NOVA SOURE (BA)";"BA";"NOVA SOURE";35;10;14;59
2009;"NOVA VICOSA (BA)";"BA";"NOVA VICOSA";88;18;30;136
2009;"NOVO HORIZONTE (BA)";"BA";"NOVO HORIZONTE";32;4;8;44
2009;"NOVO TRIUNFO (BA)";"BA";"NOVO TRIUNFO";6;1;1;8
2009;"OLINDINA (BA)";"BA";"OLINDINA";79;22;39;140
2009;"OLIVEIRA DOS BREJINHOS (BA)";"BA";"OLIVEIRA DOS BREJINHOS";62;26;20;108
2009;"OURICANGAS (BA)";"BA";"OURICANGAS";27;9;17;53
2009;"OUROLANDIA (BA)";"BA";"OUROLANDIA";40;14;5;59
2009;"PALMAS DE MONTE ALTO (BA)";"BA";"PALMAS DE MONTE ALTO";45;3;20;68
2009;"PALMEIRAS (BA)";"BA";"PALMEIRAS";27;10;2;39
2009;"PARAMIRIM (BA)";"BA";"PARAMIRIM";129;7;55;191
2009;"PARATINGA (BA)";"BA";"PARATINGA";38;14;37;89
2009;"PARIPIRANGA (BA)";"BA";"PARIPIRANGA";62;3;34;99
2009;"PAU BRASIL (BA)";"BA";"PAU BRASIL";29;5;25;59
2009;"PAULO AFONSO (BA)";"BA";"PAULO AFONSO";771;258;225;1254
2009;"PE DE SERRA (BA)";"BA";"PE DE SERRA";30;3;10;43
2009;"PEDRAO (BA)";"BA";"PEDRAO";8;5;4;17
2009;"PEDRO ALEXANDRE (BA)";"BA";"PEDRO ALEXANDRE";2;4;4;10
2009;"PIATA (BA)";"BA";"PIATA";81;19;22;122
2009;"PILAO ARCADO (BA)";"BA";"PILAO ARCADO";22;18;1;41
2009;"PINDAI (BA)";"BA";"PINDAI";39;6;20;65
2009;"PINDOBACU (BA)";"BA";"PINDOBACU";36;14;19;69
2009;"PINTADAS (BA)";"BA";"PINTADAS";35;18;30;83
2009;"PIRAI DO NORTE (BA)";"BA";"PIRAI DO NORTE";16;3;0;19
2009;"PIRIPA (BA)";"BA";"PIRIPA";54;23;15;92
2009;"PIRITIBA (BA)";"BA";"PIRITIBA";45;15;15;75
2009;"PLANALTINO (BA)";"BA";"PLANALTINO";15;3;13;31
2009;"PLANALTO (BA)";"BA";"PLANALTO";109;19;38;166
2009;"POCOES (BA)";"BA";"POCOES";270;139;66;475
2009;"POJUCA (BA)";"BA";"POJUCA";297;64;65;426
2009;"PONTO NOVO (BA)";"BA";"PONTO NOVO";54;5;20;79
2009;"PORTO SEGURO (BA)";"BA";"PORTO SEGURO";506;165;425;1096
2009;"POTIRIGUA (BA)";"BA";"POTIRIGUA";27;3;3;33
2009;"PRADO (BA)";"BA";"PRADO";50;9;23;82
2009;"PRESIDENTE DUTRA (BA)";"BA";"PRESIDENTE DUTRA";41;6;3;50
2009;"PRESIDENTE JANIO QUADROS (BA)";"BA";"PRESIDENTE JANIO QUADROS";24;12;8;44
2009;"PRESIDENTE TANCREDO NEVES (BA)";"BA";"PRESIDENTE TANCREDO NEVES";102;47;20;169
2009;"QUEIMADAS (BA)";"BA";"QUEIMADAS";76;10;56;142
2009;"QUIJINGUE (BA)";"BA";"QUIJINGUE";38;12;35;85
2009;"QUIXABEIRA (BA)";"BA";"QUIXABEIRA";29;7;11;47
2009;"RAFAEL JAMBEIRO (BA)";"BA";"RAFAEL JAMBEIRO";50;15;39;104
2009;"REMANSO (BA)";"BA";"REMANSO";195;43;23;261
2009;"RETIROLANDIA (BA)";"BA";"RETIROLANDIA";43;5;9;57
2009;"RIACHAO DAS NEVES (BA)";"BA";"RIACHAO DAS NEVES";37;18;16;71
2009;"RIACHAO DO JACUIPE (BA)";"BA";"RIACHAO DO JACUIPE";211;24;27;262
2009;"RIACHO DE SANTANA (BA)";"BA";"RIACHO DE SANTANA";187;21;53;261
2009;"RIBEIRA DO AMPARO (BA)";"BA";"RIBEIRA DO AMPARO";9;8;25;42
2009;"RIBEIRA DO POMBAL (BA)";"BA";"RIBEIRA DO POMBAL";196;50;94;340
2009;"RIBEIRAO DO LARGO (BA)";"BA";"RIBEIRAO DO LARGO";17;14;4;35
2009;"RIO DE CONTAS (BA)";"BA";"RIO DE CONTAS";59;22;15;96
2009;"RIO DO ANTONIO (BA)";"BA";"RIO DO ANTONIO";84;28;11;123
2009;"RIO DO PIRES (BA)";"BA";"RIO DO PIRES";36;9;14;59
2009;"RIO REAL (BA)";"BA";"RIO REAL";133;10;37;180
2009;"RODELAS (BA)";"BA";"RODELAS";23;6;2;31
2009;"RUY BARBOSA (BA)";"BA";"RUY BARBOSA";98;32;13;143
2009;"SALINAS DA MARGARIDA (BA)";"BA";"SALINAS DA MARGARIDA";18;3;4;25
2009;"SALVADOR (BA)";"BA";"SALVADOR";13674;3006;6752;23432
2009;"SANTA BARBARA (BA)";"BA";"SANTA BARBARA";35;5;14;54
2009;"SANTA BRIGIDA (BA)";"BA";"SANTA BRIGIDA";17;14;15;46
2009;"SANTA CRUZ CABRALIA (BA)";"BA";"SANTA CRUZ CABRALIA";63;21;15;99
2009;"SANTA CRUZ DA VITORIA (BA)";"BA";"SANTA CRUZ DA VITORIA";10;4;1;15
2009;"SANTA INES (BA)";"BA";"SANTA INES";41;6;3;50
2009;"SANTA LUZIA (BA)";"BA";"SANTA LUZIA";26;1;5;32
2009;"SANTA MARIA DA VITORIA (BA)";"BA";"SANTA MARIA DA VITORIA";305;31;40;376
2009;"SANTA RITA DE CASSIA (BA)";"BA";"SANTA RITA DE CASSIA";49;7;7;63
2009;"SANTA TERESINHA (BA)";"BA";"SANTA TERESINHA";23;5;16;44
2009;"SANTALUZ (BA)";"BA";"SANTALUZ";163;13;31;207
2009;"SANTANA (BA)";"BA";"SANTANA";132;10;42;184
2009;"SANTANOPOLIS (BA)";"BA";"SANTANOPOLIS";16;10;7;33
2009;"SANTO AMARO (BA)";"BA";"SANTO AMARO";174;80;280;534
2009;"SANTO ANTONIO DE JESUS (BA)";"BA";"SANTO ANTONIO DE JESUS";1796;159;120;2075
2009;"SANTO ESTEVAO (BA)";"BA";"SANTO ESTEVAO";193;62;32;287
2009;"SAO DESIDERIO (BA)";"BA";"SAO DESIDERIO";183;12;40;235
2009;"SAO DOMINGOS (BA)";"BA";"SAO DOMINGOS";34;0;7;41
2009;"SAO FELIPE (BA)";"BA";"SAO FELIPE";155;40;34;229
2009;"SAO FELIX (BA)";"BA";"SAO FELIX";42;19;12;73
2009;"SAO FELIX DO CORIBE (BA)";"BA";"SAO FELIX DO CORIBE";104;8;14;126
2009;"SAO FRANCISCO DO CONDE (BA)";"BA";"SAO FRANCISCO DO CONDE";103;64;80;247
2009;"SAO GABRIEL (BA)";"BA";"SAO GABRIEL";21;5;6;32
2009;"SAO GONCALO DOS CAMPOS (BA)";"BA";"SAO GONCALO DOS CAMPOS";71;136;37;244
2009;"SAO JOSE DA VITORIA (BA)";"BA";"SAO JOSE DA VITORIA";6;0;4;10
2009;"SAO JOSE DO JACUIPE (BA)";"BA";"SAO JOSE DO JACUIPE";47;7;2;56
2009;"SAO MIGUEL DAS MATAS (BA)";"BA";"SAO MIGUEL DAS MATAS";36;4;7;47
2009;"SAO SEBASTIAO DO PASSE (BA)";"BA";"SAO SEBASTIAO DO PASSE";131;114;98;343
2009;"SAPEACU (BA)";"BA";"SAPEACU";79;50;26;155
2009;"SATIRO DIAS (BA)";"BA";"SATIRO DIAS";17;10;9;36
2009;"SAUBARA (BA)";"BA";"SAUBARA";14;11;1;26
2009;"SAUDE (BA)";"BA";"SAUDE";30;10;8;48
2009;"SEABRA (BA)";"BA";"SEABRA";293;77;114;484
2009;"SEBASTIAO LARANJEIRAS (BA)";"BA";"SEBASTIAO LARANJEIRAS";11;2;19;32
2009;"SENHOR DO BONFIM (BA)";"BA";"SENHOR DO BONFIM";471;103;147;721
2009;"SENTO SE (BA)";"BA";"SENTO SE";44;1;17;62
2009;"SERRA DO RAMALHO (BA)";"BA";"SERRA DO RAMALHO";43;19;17;79
2009;"SERRA DOURADA (BA)";"BA";"SERRA DOURADA";45;7;24;76
2009;"SERRA PRETA (BA)";"BA";"SERRA PRETA";24;12;38;74
2009;"SERRINHA (BA)";"BA";"SERRINHA";482;83;142;707
2009;"SERROLANDIA (BA)";"BA";"SERROLANDIA";36;21;10;67
2009;"SIMOES FILHO (BA)";"BA";"SIMOES FILHO";1922;356;592;2870
2009;"SITIO DO MATO (BA)";"BA";"SITIO DO MATO";20;9;15;44
2009;"SITIO DO QUINTO (BA)";"BA";"SITIO DO QUINTO";15;2;10;27
2009;"SOBRADINHO (BA)";"BA";"SOBRADINHO";77;17;15;109
2009;"SOUTO SOARES (BA)";"BA";"SOUTO SOARES";77;7;17;101
2009;"TABOCAS DO BREJO VELHO (BA)";"BA";"TABOCAS DO BREJO VELHO";15;3;8;26
2009;"TANHACU (BA)";"BA";"TANHACU";131;22;30;183
2009;"TANQUE NOVO (BA)";"BA";"TANQUE NOVO";231;7;32;270
2009;"TANQUINHO (BA)";"BA";"TANQUINHO";22;12;8;42
2009;"TAPEROA (BA)";"BA";"TAPEROA";95;21;10;126
2009;"TAPIRAMUTA (BA)";"BA";"TAPIRAMUTA";31;5;6;42
2009;"TEIXEIRA DE FREITAS (BA)";"BA";"TEIXEIRA DE FREITAS";1118;64;285;1467
2009;"TEODORO SAMPAIO (BA)";"BA";"TEODORO SAMPAIO";10;8;10;28
2009;"TEOFILANDIA (BA)";"BA";"TEOFILANDIA";78;14;23;115
2009;"TEOLANDIA (BA)";"BA";"TEOLANDIA";100;14;5;119
2009;"TERRA NOVA (BA)";"BA";"TERRA NOVA";14;5;18;37
2009;"TREMEDAL (BA)";"BA";"TREMEDAL";33;11;26;70
2009;"TUCANO (BA)";"BA";"TUCANO";211;31;77;319
2009;"UAUA (BA)";"BA";"UAUA";86;12;14;112
2009;"UBAIRA (BA)";"BA";"UBAIRA";84;13;31;128
2009;"UBAITABA (BA)";"BA";"UBAITABA";148;5;13;166
2009;"UBATA (BA)";"BA";"UBATA";179;13;9;201
2009;"UIBAI (BA)";"BA";"UIBAI";37;4;5;46
2009;"UMBURANAS (BA)";"BA";"UMBURANAS";25;12;14;51
2009;"UNA (BA)";"BA";"UNA";42;5;14;61
2009;"URANDI (BA)";"BA";"URANDI";78;14;20;112
2009;"URUCUCA (BA)";"BA";"URUCUCA";83;1;6;90
2009;"UTINGA (BA)";"BA";"UTINGA";45;9;6;60
2009;"VALENCA (BA)";"BA";"VALENCA";548;91;89;728
2009;"VALENTE (BA)";"BA";"VALENTE";95;8;19;122
2009;"VARZEA DA ROCA (BA)";"BA";"VARZEA DA ROCA";33;15;10;58
2009;"VARZEA DO POCO (BA)";"BA";"VARZEA DO POCO";50;5;8;63
2009;"VARZEA NOVA (BA)";"BA";"VARZEA NOVA";43;7;9;59
2009;"VARZEDO (BA)";"BA";"VARZEDO";50;7;11;68
2009;"VERA CRUZ (BA)";"BA";"VERA CRUZ";124;119;22;265
2009;"VEREDA (BA)";"BA";"VEREDA";7;1;1;9
2009;"VITORIA DA CONQUISTA (BA)";"BA";"VITORIA DA CONQUISTA";3191;430;1050;4671
2009;"WAGNER (BA)";"BA";"WAGNER";20;3;10;33
2009;"WANDERLEY (BA)";"BA";"WANDERLEY";40;6;15;61
2009;"WENCESLAU GUIMARAES (BA)";"BA";"WENCESLAU GUIMARAES";96;11;7;114
2009;"XIQUE XIQUE (BA)";"BA";"XIQUE XIQUE";92;9;8;109
2009;"ABAIARA (CE)";"CE";"ABAIARA";11;24;4;39
2009;"ACARAPE (CE)";"CE";"ACARAPE";81;20;57;158
2009;"ACARAU (CE)";"CE";"ACARAU";147;15;33;195
2009;"ACOPIARA (CE)";"CE";"ACOPIARA";225;17;26;268
2009;"AIUABA (CE)";"CE";"AIUABA";14;0;0;14
2009;"ALCANTARAS (CE)";"CE";"ALCANTARAS";40;1;6;47
2009;"ALTANEIRA (CE)";"CE";"ALTANEIRA";10;6;2;18
2009;"ALTO SANTO (CE)";"CE";"ALTO SANTO";96;4;10;110
2009;"AMONTADA (CE)";"CE";"AMONTADA";129;10;10;149
2009;"ANTONINA DO NORTE (CE)";"CE";"ANTONINA DO NORTE";28;2;1;31
2009;"APUIARES (CE)";"CE";"APUIARES";60;7;0;67
2009;"AQUIRAZ (CE)";"CE";"AQUIRAZ";384;87;35;506
2009;"ARACATI (CE)";"CE";"ARACATI";362;54;71;487
2009;"ARACOIABA (CE)";"CE";"ARACOIABA";81;8;8;97
2009;"ARARENDA (CE)";"CE";"ARARENDA";19;4;1;24
2009;"ARARIPE (CE)";"CE";"ARARIPE";52;45;18;115
2009;"ARATUBA (CE)";"CE";"ARATUBA";51;2;7;60
2009;"ARNEIROZ (CE)";"CE";"ARNEIROZ";23;5;0;28
2009;"ASSARE (CE)";"CE";"ASSARE";77;13;1;91
2009;"AURORA (CE)";"CE";"AURORA";61;33;5;99
2009;"BAIXIO (CE)";"CE";"BAIXIO";16;20;4;40
2009;"BANABUIU (CE)";"CE";"BANABUIU";88;11;14;113
2009;"BARBALHA (CE)";"CE";"BARBALHA";267;70;56;393
2009;"BARREIRA (CE)";"CE";"BARREIRA";76;5;8;89
2009;"BARRO (CE)";"CE";"BARRO";39;18;10;67
2009;"BARROQUINHA (CE)";"CE";"BARROQUINHA";25;9;3;37
2009;"BATURITE (CE)";"CE";"BATURITE";170;18;25;213
2009;"BEBERIBE (CE)";"CE";"BEBERIBE";142;56;42;240
2009;"BELA CRUZ (CE)";"CE";"BELA CRUZ";83;5;15;103
2009;"BOA VIAGEM (CE)";"CE";"BOA VIAGEM";329;12;31;372
2009;"BREJO SANTO (CE)";"CE";"BREJO SANTO";257;68;29;354
2009;"CAMOCIM (CE)";"CE";"CAMOCIM";140;29;15;184
2009;"CAMPOS SALES (CE)";"CE";"CAMPOS SALES";157;52;30;239
2009;"CANINDE (CE)";"CE";"CANINDE";422;16;53;491
2009;"CAPISTRANO (CE)";"CE";"CAPISTRANO";45;4;10;59
2009;"CARIDADE (CE)";"CE";"CARIDADE";64;7;9;80
2009;"CARIRE (CE)";"CE";"CARIRE";35;13;8;56
2009;"CARIRIACU (CE)";"CE";"CARIRIACU";44;25;4;73
2009;"CARIUS (CE)";"CE";"CARIUS";38;10;3;51
2009;"CARNAUBAL (CE)";"CE";"CARNAUBAL";65;21;7;93
2009;"CASCAVEL (CE)";"CE";"CASCAVEL";356;40;70;466
2009;"CATARINA (CE)";"CE";"CATARINA";38;4;1;43
2009;"CATUNDA (CE)";"CE";"CATUNDA";26;10;2;38
2009;"CAUCAIA (CE)";"CE";"CAUCAIA";1040;118;307;1465
2009;"CEDRO (CE)";"CE";"CEDRO";73;24;20;117
2009;"CHAVAL (CE)";"CE";"CHAVAL";23;5;4;32
2009;"CHORO (CE)";"CE";"CHORO";47;6;13;66
2009;"CHOROZINHO (CE)";"CE";"CHOROZINHO";90;9;31;130
2009;"COREAU (CE)";"CE";"COREAU";75;8;16;99
2009;"CRATEUS (CE)";"CE";"CRATEUS";235;33;57;325
2009;"CRATO (CE)";"CE";"CRATO";725;77;63;865
2009;"CROATA (CE)";"CE";"CROATA";38;7;4;49
2009;"CRUZ (CE)";"CE";"CRUZ";92;20;35;147
2009;"DEPUTADO IRAPUAN PINHEIRO (CE)";"CE";"DEPUTADO IRAPUAN PINHEIRO";24;3;3;30
2009;"ERERE (CE)";"CE";"ERERE";1;1;0;2
2009;"EUSEBIO (CE)";"CE";"EUSEBIO";773;37;38;848
2009;"FARIAS BRITO (CE)";"CE";"FARIAS BRITO";62;30;8;100
2009;"FORQUILHA (CE)";"CE";"FORQUILHA";80;20;21;121
2009;"FORTALEZA (CE)";"CE";"FORTALEZA";17800;2461;5364;25625
2009;"FORTIM (CE)";"CE";"FORTIM";25;26;7;58
2009;"FRECHEIRINHA (CE)";"CE";"FRECHEIRINHA";72;12;16;100
2009;"GENERAL SAMPAIO (CE)";"CE";"GENERAL SAMPAIO";28;1;2;31
2009;"GRACA (CE)";"CE";"GRACA";16;5;6;27
2009;"GRANJA (CE)";"CE";"GRANJA";146;28;11;185
2009;"GRANJEIRO (CE)";"CE";"GRANJEIRO";9;1;0;10
2009;"GROAIRAS (CE)";"CE";"GROAIRAS";40;20;12;72
2009;"GUAIUBA (CE)";"CE";"GUAIUBA";52;24;6;82
2009;"GUARACIABA DO NORTE (CE)";"CE";"GUARACIABA DO NORTE";294;7;15;316
2009;"GUARAMIRANGA (CE)";"CE";"GUARAMIRANGA";28;1;3;32
2009;"HIDROLANDIA (CE)";"CE";"HIDROLANDIA";106;11;8;125
2009;"HORIZONTE (CE)";"CE";"HORIZONTE";288;43;55;386
2009;"IBARETAMA (CE)";"CE";"IBARETAMA";46;9;16;71
2009;"IBIAPINA (CE)";"CE";"IBIAPINA";102;18;16;136
2009;"IBICUITINGA (CE)";"CE";"IBICUITINGA";50;3;8;61
2009;"ICAPUI (CE)";"CE";"ICAPUI";54;17;33;104
2009;"ICO (CE)";"CE";"ICO";244;46;40;330
2009;"IGUATU (CE)";"CE";"IGUATU";790;50;74;914
2009;"INDEPENDENCIA (CE)";"CE";"INDEPENDENCIA";157;3;12;172
2009;"IPAPORANGA (CE)";"CE";"IPAPORANGA";18;2;1;21
2009;"IPAUMIRIM (CE)";"CE";"IPAUMIRIM";167;42;26;235
2009;"IPU (CE)";"CE";"IPU";245;21;24;290
2009;"IPUEIRAS (CE)";"CE";"IPUEIRAS";52;12;4;68
2009;"IRACEMA (CE)";"CE";"IRACEMA";50;7;8;65
2009;"IRAUCUBA (CE)";"CE";"IRAUCUBA";76;13;10;99
2009;"ITAICABA (CE)";"CE";"ITAICABA";28;5;7;40
2009;"ITAITINGA (CE)";"CE";"ITAITINGA";234;51;16;301
2009;"ITAPAGE (CE)";"CE";"ITAPAGE";214;24;14;252
2009;"ITAPIPOCA (CE)";"CE";"ITAPIPOCA";557;18;30;605
2009;"ITAPIUNA (CE)";"CE";"ITAPIUNA";52;7;11;70
2009;"ITAREMA (CE)";"CE";"ITAREMA";104;10;24;138
2009;"ITATIRA (CE)";"CE";"ITATIRA";83;4;5;92
2009;"JAGUARETAMA (CE)";"CE";"JAGUARETAMA";72;3;6;81
2009;"JAGUARIBARA (CE)";"CE";"JAGUARIBARA";59;9;8;76
2009;"JAGUARIBE (CE)";"CE";"JAGUARIBE";283;14;17;314
2009;"JAGUARUANA (CE)";"CE";"JAGUARUANA";181;11;6;198
2009;"JARDIM (CE)";"CE";"JARDIM";61;47;5;113
2009;"JATI (CE)";"CE";"JATI";21;8;1;30
2009;"JIJOCA DE JERICOACOARA (CE)";"CE";"JIJOCA DE JERICOACOARA";46;10;4;60
2009;"JUAZEIRO DO NORTE (CE)";"CE";"JUAZEIRO DO NORTE";1337;143;186;1666
2009;"JUCAS (CE)";"CE";"JUCAS";57;6;15;78
2009;"LAVRAS DA MANGABEIRA (CE)";"CE";"LAVRAS DA MANGABEIRA";73;13;16;102
2009;"LIMOEIRO DO NORTE (CE)";"CE";"LIMOEIRO DO NORTE";536;20;94;650
2009;"MADALENA (CE)";"CE";"MADALENA";65;5;9;79
2009;"MARACANAU (CE)";"CE";"MARACANAU";1067;175;225;1467
2009;"MARANGUAPE (CE)";"CE";"MARANGUAPE";459;55;128;642
2009;"MARCO (CE)";"CE";"MARCO";175;6;14;195
2009;"MARTINOPOLE (CE)";"CE";"MARTINOPOLE";20;4;1;25
2009;"MASSAPE (CE)";"CE";"MASSAPE";69;8;40;117
2009;"MAURITI (CE)";"CE";"MAURITI";66;46;16;128
2009;"MERUOCA (CE)";"CE";"MERUOCA";28;5;6;39
2009;"MILAGRES (CE)";"CE";"MILAGRES";74;29;12;115
2009;"MILHA (CE)";"CE";"MILHA";54;3;14;71
2009;"MIRAIMA (CE)";"CE";"MIRAIMA";27;2;2;31
2009;"MISSAO VELHA (CE)";"CE";"MISSAO VELHA";120;52;6;178
2009;"MOMBACA (CE)";"CE";"MOMBACA";185;9;3;197
2009;"MONSENHOR TABOSA (CE)";"CE";"MONSENHOR TABOSA";47;4;0;51
2009;"MORADA NOVA (CE)";"CE";"MORADA NOVA";347;38;59;444
2009;"MORAUJO (CE)";"CE";"MORAUJO";14;4;5;23
2009;"MORRINHOS (CE)";"CE";"MORRINHOS";57;11;9;77
2009;"MUCAMBO (CE)";"CE";"MUCAMBO";31;16;4;51
2009;"MULUNGU (CE)";"CE";"MULUNGU";49;4;2;55
2009;"NOVA OLINDA (CE)";"CE";"NOVA OLINDA";70;23;3;96
2009;"NOVA RUSSAS (CE)";"CE";"NOVA RUSSAS";164;10;5;179
2009;"NOVO ORIENTE (CE)";"CE";"NOVO ORIENTE";54;12;9;75
2009;"OCARA (CE)";"CE";"OCARA";100;16;28;144
2009;"OROS (CE)";"CE";"OROS";94;20;13;127
2009;"PACAJUS (CE)";"CE";"PACAJUS";495;55;136;686
2009;"PACATUBA (CE)";"CE";"PACATUBA";136;72;9;217
2009;"PACOTI (CE)";"CE";"PACOTI";83;3;8;94
2009;"PACUJA (CE)";"CE";"PACUJA";33;4;11;48
2009;"PALHANO (CE)";"CE";"PALHANO";42;8;11;61
2009;"PALMACIA (CE)";"CE";"PALMACIA";39;20;8;67
2009;"PARACURU (CE)";"CE";"PARACURU";154;16;17;187
2009;"PARAIPABA (CE)";"CE";"PARAIPABA";149;11;18;178
2009;"PARAMBU (CE)";"CE";"PARAMBU";160;4;5;169
2009;"PARAMOTI (CE)";"CE";"PARAMOTI";40;2;6;48
2009;"PEDRA BRANCA (CE)";"CE";"PEDRA BRANCA";223;9;16;248
2009;"PENAFORTE (CE)";"CE";"PENAFORTE";30;22;15;67
2009;"PENTECOSTE (CE)";"CE";"PENTECOSTE";176;8;5;189
2009;"PEREIRO (CE)";"CE";"PEREIRO";62;13;6;81
2009;"PINDORETAMA (CE)";"CE";"PINDORETAMA";118;20;6;144
2009;"PIQUET CARNEIRO (CE)";"CE";"PIQUET CARNEIRO";30;4;5;39
2009;"PIRES FERREIRA (CE)";"CE";"PIRES FERREIRA";15;2;1;18
2009;"PORANGA (CE)";"CE";"PORANGA";14;4;1;19
2009;"PORTEIRAS (CE)";"CE";"PORTEIRAS";22;61;7;90
2009;"POTENGI (CE)";"CE";"POTENGI";21;3;0;24
2009;"POTIRETAMA (CE)";"CE";"POTIRETAMA";23;0;5;28
2009;"QUITERIANOPOLIS (CE)";"CE";"QUITERIANOPOLIS";35;6;2;43
2009;"QUIXADA (CE)";"CE";"QUIXADA";521;37;62;620
2009;"QUIXELO (CE)";"CE";"QUIXELO";36;5;19;60
2009;"QUIXERAMOBIM (CE)";"CE";"QUIXERAMOBIM";357;24;70;451
2009;"QUIXERE (CE)";"CE";"QUIXERE";149;11;38;198
2009;"REDENCAO (CE)";"CE";"REDENCAO";185;29;23;237
2009;"RERIUTABA (CE)";"CE";"RERIUTABA";66;16;16;98
2009;"RUSSAS (CE)";"CE";"RUSSAS";605;30;73;708
2009;"SABOEIRO (CE)";"CE";"SABOEIRO";25;11;3;39
2009;"SALITRE (CE)";"CE";"SALITRE";40;7;17;64
2009;"SANTA QUITERIA (CE)";"CE";"SANTA QUITERIA";203;20;6;229
2009;"SANTANA DO ACARAU (CE)";"CE";"SANTANA DO ACARAU";112;21;16;149
2009;"SANTANA DO CARIRI (CE)";"CE";"SANTANA DO CARIRI";48;16;2;66
2009;"SAO BENEDITO (CE)";"CE";"SAO BENEDITO";366;63;35;464
2009;"SAO GONCALO DO AMARANTE (CE)";"CE";"SAO GONCALO DO AMARANTE";207;50;38;295
2009;"SAO JOAO DO JAGUARIBE (CE)";"CE";"SAO JOAO DO JAGUARIBE";46;5;9;60
2009;"SAO LUIS DO CURU (CE)";"CE";"SAO LUIS DO CURU";47;2;6;55
2009;"SENADOR POMPEU (CE)";"CE";"SENADOR POMPEU";126;6;28;160
2009;"SENADOR SA (CE)";"CE";"SENADOR SA";20;3;9;32
2009;"SOBRAL (CE)";"CE";"SOBRAL";1210;173;204;1587
2009;"SOLONOPOLE (CE)";"CE";"SOLONOPOLE";66;3;8;77
2009;"TABULEIRO DO NORTE (CE)";"CE";"TABULEIRO DO NORTE";277;31;32;340
2009;"TAMBORIL (CE)";"CE";"TAMBORIL";59;13;12;84
2009;"TARRAFAS (CE)";"CE";"TARRAFAS";18;6;2;26
2009;"TAUA (CE)";"CE";"TAUA";314;24;27;365
2009;"TEJUCUOCA (CE)";"CE";"TEJUCUOCA";62;3;4;69
2009;"TIANGUA (CE)";"CE";"TIANGUA";1033;125;92;1250
2009;"TRAIRI (CE)";"CE";"TRAIRI";148;12;22;182
2009;"TURURU (CE)";"CE";"TURURU";36;3;4;43
2009;"UBAJARA (CE)";"CE";"UBAJARA";206;15;29;250
2009;"UMARI (CE)";"CE";"UMARI";6;3;3;12
2009;"UMIRIM (CE)";"CE";"UMIRIM";48;38;11;97
2009;"URUBURETAMA (CE)";"CE";"URUBURETAMA";60;8;34;102
2009;"URUOCA (CE)";"CE";"URUOCA";36;6;10;52
2009;"VARJOTA (CE)";"CE";"VARJOTA";97;23;5;125
2009;"VARZEA ALEGRE (CE)";"CE";"VARZEA ALEGRE";172;32;27;231
2009;"VICOSA DO CEARA (CE)";"CE";"VICOSA DO CEARA";249;23;22;294
2009;"BRASILIA (DF)";"DF";"BRASILIA";18323;4531;8498;31352
2009;"AFONSO CLAUDIO (ES)";"ES";"AFONSO CLAUDIO";445;40;100;585
2009;"AGUA DOCE DO NORTE (ES)";"ES";"AGUA DOCE DO NORTE";78;12;19;109
2009;"AGUIA BRANCA (ES)";"ES";"AGUIA BRANCA";119;3;19;141
2009;"ALEGRE (ES)";"ES";"ALEGRE";164;30;18;212
2009;"ALFREDO CHAVES (ES)";"ES";"ALFREDO CHAVES";387;16;33;436
2009;"ALTO RIO NOVO (ES)";"ES";"ALTO RIO NOVO";80;19;16;115
2009;"ANCHIETA (ES)";"ES";"ANCHIETA";246;43;33;322
2009;"APIACA (ES)";"ES";"APIACA";60;14;1;75
2009;"ARACRUZ (ES)";"ES";"ARACRUZ";987;140;401;1528
2009;"ATILIO VIVACQUA (ES)";"ES";"ATILIO VIVACQUA";153;13;15;181
2009;"BAIXO GUANDU (ES)";"ES";"BAIXO GUANDU";511;20;61;592
2009;"BARRA DE SAO FRANCISCO (ES)";"ES";"BARRA DE SAO FRANCISCO";443;13;88;544
2009;"BOA ESPERANCA (ES)";"ES";"BOA ESPERANCA";202;12;42;256
2009;"BOM JESUS DO NORTE (ES)";"ES";"BOM JESUS DO NORTE";173;29;22;224
2009;"BREJETUBA (ES)";"ES";"BREJETUBA";151;12;27;190
2009;"CACHOEIRO DE ITAPEMIRIM (ES)";"ES";"CACHOEIRO DE ITAPEMIRIM";4438;191;1994;6623
2009;"CARIACICA (ES)";"ES";"CARIACICA";4533;465;1502;6500
2009;"CASTELO (ES)";"ES";"CASTELO";1165;56;57;1278
2009;"COLATINA (ES)";"ES";"COLATINA";2095;105;439;2639
2009;"CONCEICAO DA BARRA (ES)";"ES";"CONCEICAO DA BARRA";200;12;92;304
2009;"CONCEICAO DO CASTELO (ES)";"ES";"CONCEICAO DO CASTELO";199;25;42;266
2009;"DIVINO DE SAO LOURENCO (ES)";"ES";"DIVINO DE SAO LOURENCO";38;2;6;46
2009;"DOMINGOS MARTINS (ES)";"ES";"DOMINGOS MARTINS";824;69;65;958
2009;"DORES DO RIO PRETO (ES)";"ES";"DORES DO RIO PRETO";104;8;16;128
2009;"ECOPORANGA (ES)";"ES";"ECOPORANGA";122;26;62;210
2009;"FUNDAO (ES)";"ES";"FUNDAO";289;39;44;372
2009;"GOVERNADOR LINDENBERG (ES)";"ES";"GOVERNADOR LINDENBERG";202;5;1;208
2009;"GUACUI (ES)";"ES";"GUACUI";380;40;34;454
2009;"GUARAPARI (ES)";"ES";"GUARAPARI";979;198;194;1371
2009;"IBATIBA (ES)";"ES";"IBATIBA";334;34;35;403
2009;"IBIRACU (ES)";"ES";"IBIRACU";332;26;35;393
2009;"IBITIRAMA (ES)";"ES";"IBITIRAMA";86;6;10;102
2009;"ICONHA (ES)";"ES";"ICONHA";615;17;43;675
2009;"IRUPI (ES)";"ES";"IRUPI";125;29;18;172
2009;"ITAGUACU (ES)";"ES";"ITAGUACU";221;11;52;284
2009;"ITAPEMIRIM (ES)";"ES";"ITAPEMIRIM";394;33;45;472
2009;"ITARANA (ES)";"ES";"ITARANA";273;24;28;325
2009;"IUNA (ES)";"ES";"IUNA";341;31;67;439
2009;"JAGUARE (ES)";"ES";"JAGUARE";348;13;65;426
2009;"JERONIMO MONTEIRO (ES)";"ES";"JERONIMO MONTEIRO";59;11;10;80
2009;"JOAO NEIVA (ES)";"ES";"JOAO NEIVA";288;16;23;327
2009;"LARANJA DA TERRA (ES)";"ES";"LARANJA DA TERRA";233;12;22;267
2009;"LINHARES (ES)";"ES";"LINHARES";2501;103;361;2965
2009;"MANTENOPOLIS (ES)";"ES";"MANTENOPOLIS";110;13;23;146
2009;"MARATAIZES (ES)";"ES";"MARATAIZES";625;29;39;693
2009;"MARECHAL FLORIANO (ES)";"ES";"MARECHAL FLORIANO";572;25;16;613
2009;"MARILANDIA (ES)";"ES";"MARILANDIA";315;14;21;350
2009;"MIMOSO DO SUL (ES)";"ES";"MIMOSO DO SUL";223;26;58;307
2009;"MONTANHA (ES)";"ES";"MONTANHA";173;12;27;212
2009;"MUCURICI (ES)";"ES";"MUCURICI";54;4;19;77
2009;"MUNIZ FREIRE (ES)";"ES";"MUNIZ FREIRE";147;30;25;202
2009;"MUQUI (ES)";"ES";"MUQUI";131;15;20;166
2009;"NOVA VENECIA (ES)";"ES";"NOVA VENECIA";710;36;143;889
2009;"PANCAS (ES)";"ES";"PANCAS";222;19;8;249
2009;"PEDRO CANARIO (ES)";"ES";"PEDRO CANARIO";351;28;203;582
2009;"PINHEIROS (ES)";"ES";"PINHEIROS";255;20;92;367
2009;"PIUMA (ES)";"ES";"PIUMA";177;39;12;228
2009;"PONTO BELO (ES)";"ES";"PONTO BELO";43;6;18;67
2009;"PRESIDENTE KENNEDY (ES)";"ES";"PRESIDENTE KENNEDY";238;22;15;275
2009;"RIO BANANAL (ES)";"ES";"RIO BANANAL";453;15;39;507
2009;"RIO NOVO DO SUL (ES)";"ES";"RIO NOVO DO SUL";255;7;21;283
2009;"SANTA LEOPOLDINA (ES)";"ES";"SANTA LEOPOLDINA";308;32;28;368
2009;"SANTA MARIA DE JETIBA (ES)";"ES";"SANTA MARIA DE JETIBA";1624;76;44;1744
2009;"SANTA TERESA (ES)";"ES";"SANTA TERESA";566;30;73;669
2009;"SAO DOMINGOS DO NORTE (ES)";"ES";"SAO DOMINGOS DO NORTE";173;5;16;194
2009;"SAO GABRIEL DA PALHA (ES)";"ES";"SAO GABRIEL DA PALHA";540;13;80;633
2009;"SAO JOSE DO CALCADO (ES)";"ES";"SAO JOSE DO CALCADO";76;7;13;96
2009;"SAO MATEUS (ES)";"ES";"SAO MATEUS";904;88;295;1287
2009;"SAO ROQUE DO CANAA (ES)";"ES";"SAO ROQUE DO CANAA";249;14;15;278
2009;"SERRA (ES)";"ES";"SERRA";6998;409;1971;9378
2009;"SOORETAMA (ES)";"ES";"SOORETAMA";276;11;42;329
2009;"VARGEM ALTA (ES)";"ES";"VARGEM ALTA";366;21;43;430
2009;"VENDA NOVA DO IMIGRANTE (ES)";"ES";"VENDA NOVA DO IMIGRANTE";722;19;101;842
2009;"VIANA (ES)";"ES";"VIANA";955;60;228;1243
2009;"VILA PAVAO (ES)";"ES";"VILA PAVAO";119;5;16;140
2009;"VILA VALERIO (ES)";"ES";"VILA VALERIO";296;6;26;328
2009;"VILA VELHA (ES)";"ES";"VILA VELHA";3638;667;737;5042
2009;"VITORIA (ES)";"ES";"VITORIA";3219;899;989;5107
2009;"ABADIA DE GOIAS (GO)";"GO";"ABADIA DE GOIAS";53;4;3;60
2009;"ABADIANIA (GO)";"GO";"ABADIANIA";216;17;16;249
2009;"ACREUNA (GO)";"GO";"ACREUNA";331;6;64;401
2009;"ADELANDIA (GO)";"GO";"ADELANDIA";25;0;1;26
2009;"AGUA FRIA DE GOIAS (GO)";"GO";"AGUA FRIA DE GOIAS";30;7;7;44
2009;"AGUA LIMPA (GO)";"GO";"AGUA LIMPA";17;7;1;25
2009;"AGUAS LINDAS DE GOIAS (GO)";"GO";"AGUAS LINDAS DE GOIAS";461;121;289;871
2009;"ALEXANIA (GO)";"GO";"ALEXANIA";304;26;22;352
2009;"ALOANDIA (GO)";"GO";"ALOANDIA";20;3;2;25
2009;"ALTO HORIZONTE (GO)";"GO";"ALTO HORIZONTE";25;4;8;37
2009;"ALTO PARAISO DE GOIAS (GO)";"GO";"ALTO PARAISO DE GOIAS";37;7;9;53
2009;"ALVORADA DO NORTE (GO)";"GO";"ALVORADA DO NORTE";111;4;5;120
2009;"AMARALINA (GO)";"GO";"AMARALINA";8;2;5;15
2009;"AMERICANO DO BRASIL (GO)";"GO";"AMERICANO DO BRASIL";49;4;14;67
2009;"AMORINOPOLIS (GO)";"GO";"AMORINOPOLIS";26;3;8;37
2009;"ANAPOLIS (GO)";"GO";"ANAPOLIS";8292;221;1198;9711
2009;"ANHANGUERA (GO)";"GO";"ANHANGUERA";5;2;1;8
2009;"ANICUNS (GO)";"GO";"ANICUNS";283;17;66;366
2009;"APARECIDA DE GOIANIA (GO)";"GO";"APARECIDA DE GOIANIA";4185;184;370;4739
2009;"APARECIDA DO RIO DOCE (GO)";"GO";"APARECIDA DO RIO DOCE";38;3;7;48
2009;"APORE (GO)";"GO";"APORE";49;8;12;69
2009;"ARACU (GO)";"GO";"ARACU";21;3;3;27
2009;"ARAGARCAS (GO)";"GO";"ARAGARCAS";449;6;26;481
2009;"ARAGOIANIA (GO)";"GO";"ARAGOIANIA";46;0;4;50
2009;"ARAGUAPAZ (GO)";"GO";"ARAGUAPAZ";81;3;8;92
2009;"ARENOPOLIS (GO)";"GO";"ARENOPOLIS";9;4;2;15
2009;"ARUANA (GO)";"GO";"ARUANA";20;2;5;27
2009;"AURILANDIA (GO)";"GO";"AURILANDIA";14;4;1;19
2009;"AVELINOPOLIS (GO)";"GO";"AVELINOPOLIS";29;2;0;31
2009;"BALIZA (GO)";"GO";"BALIZA";4;1;2;7
2009;"BARRO ALTO (GO)";"GO";"BARRO ALTO";92;12;89;193
2009;"BELA VISTA DE GOIAS (GO)";"GO";"BELA VISTA DE GOIAS";293;9;29;331
2009;"BOM JARDIM DE GOIAS (GO)";"GO";"BOM JARDIM DE GOIAS";91;5;13;109
2009;"BOM JESUS DE GOIAS (GO)";"GO";"BOM JESUS DE GOIAS";369;19;85;473
2009;"BONFINOPOLIS (GO)";"GO";"BONFINOPOLIS";34;2;8;44
2009;"BONOPOLIS (GO)";"GO";"BONOPOLIS";11;2;2;15
2009;"BRAZABRANTES (GO)";"GO";"BRAZABRANTES";58;1;3;62
2009;"BRITANIA (GO)";"GO";"BRITANIA";61;4;3;68
2009;"BURITI ALEGRE (GO)";"GO";"BURITI ALEGRE";155;21;6;182
2009;"BURITI DE GOIAS (GO)";"GO";"BURITI DE GOIAS";13;9;2;24
2009;"BURITINOPOLIS (GO)";"GO";"BURITINOPOLIS";12;1;3;16
2009;"CABECEIRAS (GO)";"GO";"CABECEIRAS";63;2;21;86
2009;"CACHOEIRA ALTA (GO)";"GO";"CACHOEIRA ALTA";139;14;29;182
2009;"CACHOEIRA DE GOIAS (GO)";"GO";"CACHOEIRA DE GOIAS";5;0;1;6
2009;"CACHOEIRA DOURADA (GO)";"GO";"CACHOEIRA DOURADA";82;12;29;123
2009;"CACU (GO)";"GO";"CACU";205;5;31;241
2009;"CAIAPONIA (GO)";"GO";"CAIAPONIA";137;1;7;145
2009;"CALDAS NOVAS (GO)";"GO";"CALDAS NOVAS";553;58;64;675
2009;"CALDAZINHA (GO)";"GO";"CALDAZINHA";20;0;2;22
2009;"CAMPESTRE DE GOIAS (GO)";"GO";"CAMPESTRE DE GOIAS";30;2;3;35
2009;"CAMPINACU (GO)";"GO";"CAMPINACU";9;2;5;16
2009;"CAMPINORTE (GO)";"GO";"CAMPINORTE";106;6;11;123
2009;"CAMPO ALEGRE DE GOIAS (GO)";"GO";"CAMPO ALEGRE DE GOIAS";110;6;20;136
2009;"CAMPO LIMPO DE GOIAS (GO)";"GO";"CAMPO LIMPO DE GOIAS";80;0;4;84
2009;"CAMPOS BELOS (GO)";"GO";"CAMPOS BELOS";164;9;32;205
2009;"CAMPOS VERDES (GO)";"GO";"CAMPOS VERDES";34;6;1;41
2009;"CARMO DO RIO VERDE (GO)";"GO";"CARMO DO RIO VERDE";63;9;35;107
2009;"CASTELANDIA (GO)";"GO";"CASTELANDIA";33;3;8;44
2009;"CATALAO (GO)";"GO";"CATALAO";1508;90;224;1822
2009;"CATURAI (GO)";"GO";"CATURAI";29;3;7;39
2009;"CAVALCANTE (GO)";"GO";"CAVALCANTE";26;3;3;32
2009;"CERES (GO)";"GO";"CERES";459;16;21;496
2009;"CEZARINA (GO)";"GO";"CEZARINA";86;3;7;96
2009;"CHAPADAO DO CEU (GO)";"GO";"CHAPADAO DO CEU";182;13;15;210
2009;"CIDADE OCIDENTAL (GO)";"GO";"CIDADE OCIDENTAL";91;38;60;189
2009;"COCALZINHO DE GOIAS (GO)";"GO";"COCALZINHO DE GOIAS";117;15;16;148
2009;"COLINAS DO SUL (GO)";"GO";"COLINAS DO SUL";8;2;3;13
2009;"CORREGO DO OURO (GO)";"GO";"CORREGO DO OURO";19;1;1;21
2009;"CORUMBA DE GOIAS (GO)";"GO";"CORUMBA DE GOIAS";74;7;15;96
2009;"CORUMBAIBA (GO)";"GO";"CORUMBAIBA";112;20;8;140
2009;"CRISTALINA (GO)";"GO";"CRISTALINA";1081;39;256;1376
2009;"CRISTIANOPOLIS (GO)";"GO";"CRISTIANOPOLIS";44;8;1;53
2009;"CRIXAS (GO)";"GO";"CRIXAS";78;12;12;102
2009;"CROMINIA (GO)";"GO";"CROMINIA";37;3;2;42
2009;"CUMARI (GO)";"GO";"CUMARI";23;5;0;28
2009;"DAMIANOPOLIS (GO)";"GO";"DAMIANOPOLIS";8;1;5;14
2009;"DAMOLANDIA (GO)";"GO";"DAMOLANDIA";27;4;3;34
2009;"DAVINOPOLIS (GO)";"GO";"DAVINOPOLIS";25;4;3;32
2009;"DIORAMA (GO)";"GO";"DIORAMA";7;3;4;14
2009;"DIVINOPOLIS DE GOIAS (GO)";"GO";"DIVINOPOLIS DE GOIAS";20;0;5;25
2009;"DOVERLANDIA (GO)";"GO";"DOVERLANDIA";93;4;32;129
2009;"EDEALINA (GO)";"GO";"EDEALINA";55;4;7;66
2009;"EDEIA (GO)";"GO";"EDEIA";154;3;11;168
2009;"ESTRELA DO NORTE (GO)";"GO";"ESTRELA DO NORTE";25;3;1;29
2009;"FAINA (GO)";"GO";"FAINA";32;13;5;50
2009;"FAZENDA NOVA (GO)";"GO";"FAZENDA NOVA";30;4;6;40
2009;"FIRMINOPOLIS (GO)";"GO";"FIRMINOPOLIS";72;1;6;79
2009;"FLORES DE GOIAS (GO)";"GO";"FLORES DE GOIAS";23;6;5;34
2009;"FORMOSA (GO)";"GO";"FORMOSA";2482;111;496;3089
2009;"FORMOSO (GO)";"GO";"FORMOSO";32;3;6;41
2009;"GAMELEIRA DE GOIAS (GO)";"GO";"GAMELEIRA DE GOIAS";17;8;10;35
2009;"GOIANAPOLIS (GO)";"GO";"GOIANAPOLIS";166;5;11;182
2009;"GOIANDIRA (GO)";"GO";"GOIANDIRA";40;5;3;48
2009;"GOIANESIA (GO)";"GO";"GOIANESIA";773;44;150;967
2009;"GOIANIA (GO)";"GO";"GOIANIA";22345;1713;6520;30578
2009;"GOIANIRA (GO)";"GO";"GOIANIRA";173;4;63;240
2009;"GOIAS (GO)";"GO";"GOIAS";187;12;32;231
2009;"GOIATUBA (GO)";"GO";"GOIATUBA";573;19;54;646
2009;"GOUVELANDIA (GO)";"GO";"GOUVELANDIA";47;5;6;58
2009;"GUAPO (GO)";"GO";"GUAPO";128;13;10;151
2009;"GUARAITA (GO)";"GO";"GUARAITA";12;1;1;14
2009;"GUARANI DE GOIAS (GO)";"GO";"GUARANI DE GOIAS";10;2;6;18
2009;"GUARINOS (GO)";"GO";"GUARINOS";4;4;2;10
2009;"HEITORAI (GO)";"GO";"HEITORAI";16;2;3;21
2009;"HIDROLANDIA (GO)";"GO";"HIDROLANDIA";211;16;18;245
2009;"HIDROLINA (GO)";"GO";"HIDROLINA";14;0;2;16
2009;"IACIARA (GO)";"GO";"IACIARA";107;6;10;123
2009;"INACIOLANDIA (GO)";"GO";"INACIOLANDIA";40;8;5;53
2009;"INDIARA (GO)";"GO";"INDIARA";156;12;15;183
2009;"INHUMAS (GO)";"GO";"INHUMAS";947;38;133;1118
2009;"IPAMERI (GO)";"GO";"IPAMERI";238;50;66;354
2009;"IPIRANGA DE GOIAS (GO)";"GO";"IPIRANGA DE GOIAS";14;5;6;25
2009;"IPORA (GO)";"GO";"IPORA";337;15;38;390
2009;"ISRAELANDIA (GO)";"GO";"ISRAELANDIA";12;1;5;18
2009;"ITABERAI (GO)";"GO";"ITABERAI";521;15;48;584
2009;"ITAGUARI (GO)";"GO";"ITAGUARI";44;4;8;56
2009;"ITAGUARU (GO)";"GO";"ITAGUARU";48;5;8;61
2009;"ITAJA (GO)";"GO";"ITAJA";59;3;9;71
2009;"ITAPACI (GO)";"GO";"ITAPACI";138;16;56;210
2009;"ITAPIRAPUA (GO)";"GO";"ITAPIRAPUA";52;1;8;61
2009;"ITAPURANGA (GO)";"GO";"ITAPURANGA";267;14;58;339
2009;"ITARUMA (GO)";"GO";"ITARUMA";65;12;10;87
2009;"ITAUCU (GO)";"GO";"ITAUCU";72;6;8;86
2009;"ITUMBIARA (GO)";"GO";"ITUMBIARA";2017;149;242;2408
2009;"IVOLANDIA (GO)";"GO";"IVOLANDIA";4;2;3;9
2009;"JANDAIA (GO)";"GO";"JANDAIA";89;4;9;102
2009;"JARAGUA (GO)";"GO";"JARAGUA";283;21;39;343
2009;"JATAI (GO)";"GO";"JATAI";1753;70;168;1991
2009;"JAUPACI (GO)";"GO";"JAUPACI";19;4;5;28
2009;"JESUPOLIS (GO)";"GO";"JESUPOLIS";11;2;5;18
2009;"JOVIANIA (GO)";"GO";"JOVIANIA";118;6;11;135
2009;"JUSSARA (GO)";"GO";"JUSSARA";319;12;15;346
2009;"LAGOA SANTA (GO)";"GO";"LAGOA SANTA";7;3;5;15
2009;"LEOPOLDO DE BULHOES (GO)";"GO";"LEOPOLDO DE BULHOES";94;6;5;105
2009;"LUZIANIA (GO)";"GO";"LUZIANIA";2011;103;342;2456
2009;"MAIRIPOTABA (GO)";"GO";"MAIRIPOTABA";20;2;2;24
2009;"MAMBAI (GO)";"GO";"MAMBAI";54;3;11;68
2009;"MARA ROSA (GO)";"GO";"MARA ROSA";90;3;16;109
2009;"MARZAGAO (GO)";"GO";"MARZAGAO";23;4;0;27
2009;"MATRINCHA (GO)";"GO";"MATRINCHA";30;5;7;42
2009;"MAURILANDIA (GO)";"GO";"MAURILANDIA";321;16;73;410
2009;"MIMOSO DE GOIAS (GO)";"GO";"MIMOSO DE GOIAS";7;1;2;10
2009;"MINACU (GO)";"GO";"MINACU";333;31;26;390
2009;"MINEIROS (GO)";"GO";"MINEIROS";1080;61;102;1243
2009;"MOIPORA (GO)";"GO";"MOIPORA";8;3;1;12
2009;"MONTE ALEGRE DE GOIAS (GO)";"GO";"MONTE ALEGRE DE GOIAS";12;0;4;16
2009;"MONTES CLAROS DE GOIAS (GO)";"GO";"MONTES CLAROS DE GOIAS";55;8;12;75
2009;"MONTIVIDIU (GO)";"GO";"MONTIVIDIU";284;6;43;333
2009;"MONTIVIDIU DO NORTE (GO)";"GO";"MONTIVIDIU DO NORTE";18;2;14;34
2009;"MORRINHOS (GO)";"GO";"MORRINHOS";619;36;65;720
2009;"MORRO AGUDO DE GOIAS (GO)";"GO";"MORRO AGUDO DE GOIAS";12;5;2;19
2009;"MOSSAMEDES (GO)";"GO";"MOSSAMEDES";26;7;2;35
2009;"MOZARLANDIA (GO)";"GO";"MOZARLANDIA";105;2;22;129
2009;"MUNDO NOVO (GO)";"GO";"MUNDO NOVO";17;4;13;34
2009;"MUTUNOPOLIS (GO)";"GO";"MUTUNOPOLIS";21;2;7;30
2009;"NAZARIO (GO)";"GO";"NAZARIO";98;4;7;109
2009;"NEROPOLIS (GO)";"GO";"NEROPOLIS";351;16;21;388
2009;"NIQUELANDIA (GO)";"GO";"NIQUELANDIA";500;48;127;675
2009;"NOVA AMERICA (GO)";"GO";"NOVA AMERICA";13;1;3;17
2009;"NOVA AURORA (GO)";"GO";"NOVA AURORA";20;3;5;28
2009;"NOVA CRIXAS (GO)";"GO";"NOVA CRIXAS";55;3;24;82
2009;"NOVA GLORIA (GO)";"GO";"NOVA GLORIA";57;6;20;83
2009;"NOVA IGUACU DE GOIAS (GO)";"GO";"NOVA IGUACU DE GOIAS";15;2;4;21
2009;"NOVA ROMA (GO)";"GO";"NOVA ROMA";3;5;3;11
2009;"NOVA VENEZA (GO)";"GO";"NOVA VENEZA";187;6;12;205
2009;"NOVO BRASIL (GO)";"GO";"NOVO BRASIL";18;2;1;21
2009;"NOVO GAMA (GO)";"GO";"NOVO GAMA";305;56;106;467
2009;"NOVO PLANALTO (GO)";"GO";"NOVO PLANALTO";27;3;0;30
2009;"ORIZONA (GO)";"GO";"ORIZONA";153;22;33;208
2009;"OURO VERDE DE GOIAS (GO)";"GO";"OURO VERDE DE GOIAS";75;0;7;82
2009;"OUVIDOR (GO)";"GO";"OUVIDOR";73;7;9;89
2009;"PADRE BERNARDO (GO)";"GO";"PADRE BERNARDO";251;5;48;304
2009;"PALESTINA DE GOIAS (GO)";"GO";"PALESTINA DE GOIAS";17;12;4;33
2009;"PALMEIRAS DE GOIAS (GO)";"GO";"PALMEIRAS DE GOIAS";259;6;49;314
2009;"PALMELO (GO)";"GO";"PALMELO";17;1;2;20
2009;"PALMINOPOLIS (GO)";"GO";"PALMINOPOLIS";28;1;3;32
2009;"PANAMA (GO)";"GO";"PANAMA";30;4;5;39
2009;"PARANAIGUARA (GO)";"GO";"PARANAIGUARA";80;8;9;97
2009;"PARAUNA (GO)";"GO";"PARAUNA";126;10;25;161
2009;"PEROLANDIA (GO)";"GO";"PEROLANDIA";21;0;8;29
2009;"PETROLINA DE GOIAS (GO)";"GO";"PETROLINA DE GOIAS";88;2;12;102
2009;"PILAR DE GOIAS (GO)";"GO";"PILAR DE GOIAS";6;4;3;13
2009;"PIRACANJUBA (GO)";"GO";"PIRACANJUBA";306;14;27;347
2009;"PIRANHAS (GO)";"GO";"PIRANHAS";170;3;29;202
2009;"PIRENOPOLIS (GO)";"GO";"PIRENOPOLIS";222;22;23;267
2009;"PIRES DO RIO (GO)";"GO";"PIRES DO RIO";425;24;25;474
2009;"PLANALTINA (GO)";"GO";"PLANALTINA";453;33;312;798
2009;"PONTALINA (GO)";"GO";"PONTALINA";208;9;21;238
2009;"PORANGATU (GO)";"GO";"PORANGATU";506;27;60;593
2009;"PORTEIRAO (GO)";"GO";"PORTEIRAO";73;5;7;85
2009;"PORTELANDIA (GO)";"GO";"PORTELANDIA";39;16;4;59
2009;"POSSE (GO)";"GO";"POSSE";487;43;63;593
2009;"PROFESSOR JAMIL (GO)";"GO";"PROFESSOR JAMIL";27;1;5;33
2009;"QUIRINOPOLIS (GO)";"GO";"QUIRINOPOLIS";738;21;83;842
2009;"RIALMA (GO)";"GO";"RIALMA";285;15;19;319
2009;"RIANAPOLIS (GO)";"GO";"RIANAPOLIS";70;4;3;77
2009;"RIO QUENTE (GO)";"GO";"RIO QUENTE";34;14;39;87
2009;"RIO VERDE (GO)";"GO";"RIO VERDE";2780;161;380;3321
2009;"RUBIATABA (GO)";"GO";"RUBIATABA";239;15;44;298
2009;"SANCLERLANDIA (GO)";"GO";"SANCLERLANDIA";74;6;5;85
2009;"SANTA BARBARA DE GOIAS (GO)";"GO";"SANTA BARBARA DE GOIAS";70;2;6;78
2009;"SANTA CRUZ DE GOIAS (GO)";"GO";"SANTA CRUZ DE GOIAS";4;1;2;7
2009;"SANTA FE DE GOIAS (GO)";"GO";"SANTA FE DE GOIAS";31;2;3;36
2009;"SANTA HELENA DE GOIAS (GO)";"GO";"SANTA HELENA DE GOIAS";738;27;161;926
2009;"SANTA ISABEL (GO)";"GO";"SANTA ISABEL";8;4;2;14
2009;"SANTA RITA DO ARAGUAIA (GO)";"GO";"SANTA RITA DO ARAGUAIA";129;10;3;142
2009;"SANTA RITA DO NOVO DESTINO (GO)";"GO";"SANTA RITA DO NOVO DESTINO";18;5;7;30
2009;"SANTA ROSA DE GOIAS (GO)";"GO";"SANTA ROSA DE GOIAS";19;3;2;24
2009;"SANTA TEREZA DE GOIAS (GO)";"GO";"SANTA TEREZA DE GOIAS";30;1;3;34
2009;"SANTA TEREZINHA DE GOIAS (GO)";"GO";"SANTA TEREZINHA DE GOIAS";65;5;17;87
2009;"SANTO ANTONIO DA BARRA (GO)";"GO";"SANTO ANTONIO DA BARRA";27;4;10;41
2009;"SANTO ANTONIO DE GOIAS (GO)";"GO";"SANTO ANTONIO DE GOIAS";37;7;9;53
2009;"SANTO ANTONIO DO DESCOBERTO (GO)";"GO";"SANTO ANTONIO DO DESCOBERTO";230;30;201;461
2009;"SAO DOMINGOS (GO)";"GO";"SAO DOMINGOS";36;3;17;56
2009;"SAO FRANCISCO DE GOIAS (GO)";"GO";"SAO FRANCISCO DE GOIAS";42;4;7;53
2009;"SAO JOAO D ALIANCA (GO)";"GO";"SAO JOAO D ALIANCA";101;6;9;116
2009;"SAO JOAO DA PARAUNA (GO)";"GO";"SAO JOAO DA PARAUNA";13;0;3;16
2009;"SAO LUIS DE MONTES BELOS (GO)";"GO";"SAO LUIS DE MONTES BELOS";297;15;58;370
2009;"SAO LUIZ DO NORTE (GO)";"GO";"SAO LUIZ DO NORTE";28;3;10;41
2009;"SAO MIGUEL DO ARAGUAIA (GO)";"GO";"SAO MIGUEL DO ARAGUAIA";255;6;38;299
2009;"SAO MIGUEL DO PASSA QUATRO (GO)";"GO";"SAO MIGUEL DO PASSA QUATRO";30;1;3;34
2009;"SAO PATRICIO (GO)";"GO";"SAO PATRICIO";8;0;5;13
2009;"SAO SIMAO (GO)";"GO";"SAO SIMAO";136;18;54;208
2009;"SENADOR CANEDO (GO)";"GO";"SENADOR CANEDO";469;32;37;538
2009;"SERRANOPOLIS (GO)";"GO";"SERRANOPOLIS";82;7;16;105
2009;"SILVANIA (GO)";"GO";"SILVANIA";280;11;30;321
2009;"SIMOLANDIA (GO)";"GO";"SIMOLANDIA";88;1;6;95
2009;"SITIO D ABADIA (GO)";"GO";"SITIO D ABADIA";5;0;6;11
2009;"TAQUARAL DE GOIAS (GO)";"GO";"TAQUARAL DE GOIAS";18;3;3;24
2009;"TERESINA DE GOIAS (GO)";"GO";"TERESINA DE GOIAS";6;1;1;8
2009;"TEREZOPOLIS DE GOIAS (GO)";"GO";"TEREZOPOLIS DE GOIAS";61;3;13;77
2009;"TRES RANCHOS (GO)";"GO";"TRES RANCHOS";27;10;2;39
2009;"TRINDADE (GO)";"GO";"TRINDADE";810;42;83;935
2009;"TROMBAS (GO)";"GO";"TROMBAS";18;3;8;29
2009;"TURVANIA (GO)";"GO";"TURVANIA";58;3;4;65
2009;"TURVELANDIA (GO)";"GO";"TURVELANDIA";38;2;14;54
2009;"UIRAPURU (GO)";"GO";"UIRAPURU";15;10;4;29
2009;"URUACU (GO)";"GO";"URUACU";412;25;55;492
2009;"URUANA (GO)";"GO";"URUANA";206;3;8;217
2009;"URUTAI (GO)";"GO";"URUTAI";16;0;7;23
2009;"VALPARAISO DE GOIAS (GO)";"GO";"VALPARAISO DE GOIAS";389;178;123;690
2009;"VARJAO (GO)";"GO";"VARJAO";42;0;4;46
2009;"VIANOPOLIS (GO)";"GO";"VIANOPOLIS";359;17;16;392
2009;"VICENTINOPOLIS (GO)";"GO";"VICENTINOPOLIS";152;5;31;188
2009;"VILA BOA (GO)";"GO";"VILA BOA";11;2;3;16
2009;"VILA PROPICIO (GO)";"GO";"VILA PROPICIO";9;4;12;25
2009;"ACAILANDIA (MA)";"MA";"ACAILANDIA";848;81;100;1029
2009;"AFONSO CUNHA (MA)";"MA";"AFONSO CUNHA";3;2;1;6
2009;"AGUA DOCE DO MARANHAO (MA)";"MA";"AGUA DOCE DO MARANHAO";1;1;0;2
2009;"ALCANTARA (MA)";"MA";"ALCANTARA";28;8;9;45
2009;"ALDEIAS ALTAS (MA)";"MA";"ALDEIAS ALTAS";32;3;4;39
2009;"ALTAMIRA DO MARANHAO (MA)";"MA";"ALTAMIRA DO MARANHAO";18;3;1;22
2009;"ALTO ALEGRE DO MARANHAO (MA)";"MA";"ALTO ALEGRE DO MARANHAO";29;17;0;46
2009;"ALTO ALEGRE DO PINDARE (MA)";"MA";"ALTO ALEGRE DO PINDARE";30;9;2;41
2009;"ALTO PARNAIBA (MA)";"MA";"ALTO PARNAIBA";27;2;3;32
2009;"AMAPA DO MARANHAO (MA)";"MA";"AMAPA DO MARANHAO";7;1;1;9
2009;"AMARANTE DO MARANHAO (MA)";"MA";"AMARANTE DO MARANHAO";62;4;4;70
2009;"ANAJATUBA (MA)";"MA";"ANAJATUBA";24;3;2;29
2009;"ANAPURUS (MA)";"MA";"ANAPURUS";33;1;9;43
2009;"APICUM ACU (MA)";"MA";"APICUM ACU";6;4;0;10
2009;"ARAGUANA (MA)";"MA";"ARAGUANA";5;0;1;6
2009;"ARAIOSES (MA)";"MA";"ARAIOSES";12;5;11;28
2009;"ARAME (MA)";"MA";"ARAME";81;9;0;90
2009;"ARARI (MA)";"MA";"ARARI";63;7;3;73
2009;"AXIXA (MA)";"MA";"AXIXA";11;5;3;19
2009;"BACABAL (MA)";"MA";"BACABAL";647;65;47;759
2009;"BACABEIRA (MA)";"MA";"BACABEIRA";56;0;4;60
2009;"BACURI (MA)";"MA";"BACURI";6;2;2;10
2009;"BACURITUBA (MA)";"MA";"BACURITUBA";2;0;0;2
2009;"BALSAS (MA)";"MA";"BALSAS";935;34;52;1021
2009;"BARAO DE GRAJAU (MA)";"MA";"BARAO DE GRAJAU";34;1;3;38
2009;"BARRA DO CORDA (MA)";"MA";"BARRA DO CORDA";366;24;9;399
2009;"BARREIRINHAS (MA)";"MA";"BARREIRINHAS";42;6;9;57
2009;"BELA VISTA DO MARANHAO (MA)";"MA";"BELA VISTA DO MARANHAO";20;1;1;22
2009;"BELAGUA (MA)";"MA";"BELAGUA";2;4;3;9
2009;"BENEDITO LEITE (MA)";"MA";"BENEDITO LEITE";0;1;0;1
2009;"BEQUIMAO (MA)";"MA";"BEQUIMAO";56;8;9;73
2009;"BERNARDO DO MEARIM (MA)";"MA";"BERNARDO DO MEARIM";13;1;2;16
2009;"BOA VISTA DO GURUPI (MA)";"MA";"BOA VISTA DO GURUPI";3;1;1;5
2009;"BOM JARDIM (MA)";"MA";"BOM JARDIM";79;4;6;89
2009;"BOM JESUS DAS SELVAS (MA)";"MA";"BOM JESUS DAS SELVAS";60;4;1;65
2009;"BOM LUGAR (MA)";"MA";"BOM LUGAR";30;5;11;46
2009;"BREJO (MA)";"MA";"BREJO";40;13;10;63
2009;"BREJO DE AREIA (MA)";"MA";"BREJO DE AREIA";18;4;1;23
2009;"BURITI (MA)";"MA";"BURITI";12;5;13;30
2009;"BURITI BRAVO (MA)";"MA";"BURITI BRAVO";20;0;1;21
2009;"BURITICUPU (MA)";"MA";"BURITICUPU";248;30;8;286
2009;"BURITIRANA (MA)";"MA";"BURITIRANA";11;0;0;11
2009;"CACHOEIRA GRANDE (MA)";"MA";"CACHOEIRA GRANDE";4;2;2;8
2009;"CAJAPIO (MA)";"MA";"CAJAPIO";6;0;2;8
2009;"CAJARI (MA)";"MA";"CAJARI";4;0;0;4
2009;"CAMPESTRE DO MARANHAO (MA)";"MA";"CAMPESTRE DO MARANHAO";8;11;0;19
2009;"CANDIDO MENDES (MA)";"MA";"CANDIDO MENDES";12;5;2;19
2009;"CANTANHEDE (MA)";"MA";"CANTANHEDE";18;4;1;23
2009;"CAPINZAL DO NORTE (MA)";"MA";"CAPINZAL DO NORTE";21;15;1;37
2009;"CAROLINA (MA)";"MA";"CAROLINA";45;3;3;51
2009;"CARUTAPERA (MA)";"MA";"CARUTAPERA";15;4;5;24
2009;"CAXIAS (MA)";"MA";"CAXIAS";595;44;68;707
2009;"CEDRAL (MA)";"MA";"CEDRAL";4;1;4;9
2009;"CENTRAL DO MARANHAO (MA)";"MA";"CENTRAL DO MARANHAO";6;1;0;7
2009;"CENTRO DO GUILHERME (MA)";"MA";"CENTRO DO GUILHERME";5;0;1;6
2009;"CENTRO NOVO DO MARANHAO (MA)";"MA";"CENTRO NOVO DO MARANHAO";22;0;3;25
2009;"CHAPADINHA (MA)";"MA";"CHAPADINHA";227;34;9;270
2009;"CIDELANDIA (MA)";"MA";"CIDELANDIA";25;8;6;39
2009;"CODO (MA)";"MA";"CODO";442;21;18;481
2009;"COELHO NETO (MA)";"MA";"COELHO NETO";76;8;15;99
2009;"COLINAS (MA)";"MA";"COLINAS";93;7;6;106
2009;"CONCEICAO DO LAGO ACU (MA)";"MA";"CONCEICAO DO LAGO ACU";9;4;0;13
2009;"COROATA (MA)";"MA";"COROATA";147;27;6;180
2009;"CURURUPU (MA)";"MA";"CURURUPU";22;4;6;32
2009;"DAVINOPOLIS (MA)";"MA";"DAVINOPOLIS";33;3;2;38
2009;"DOM PEDRO (MA)";"MA";"DOM PEDRO";261;7;23;291
2009;"DUQUE BACELAR (MA)";"MA";"DUQUE BACELAR";0;3;4;7
2009;"ESPERANTINOPOLIS (MA)";"MA";"ESPERANTINOPOLIS";57;10;0;67
2009;"ESTREITO (MA)";"MA";"ESTREITO";41;13;1;55
2009;"FEIRA NOVA DO MARANHAO (MA)";"MA";"FEIRA NOVA DO MARANHAO";1;1;0;2
2009;"FERNANDO FALCAO (MA)";"MA";"FERNANDO FALCAO";8;0;2;10
2009;"FORMOSA DA SERRA NEGRA (MA)";"MA";"FORMOSA DA SERRA NEGRA";16;2;0;18
2009;"FORTALEZA DOS NOGUEIRAS (MA)";"MA";"FORTALEZA DOS NOGUEIRAS";35;3;4;42
2009;"FORTUNA (MA)";"MA";"FORTUNA";20;2;0;22
2009;"GODOFREDO VIANA (MA)";"MA";"GODOFREDO VIANA";4;4;2;10
2009;"GONCALVES DIAS (MA)";"MA";"GONCALVES DIAS";31;3;2;36
2009;"GOVERNADOR ARCHER (MA)";"MA";"GOVERNADOR ARCHER";15;7;2;24
2009;"GOVERNADOR EDISON LOBAO (MA)";"MA";"GOVERNADOR EDISON LOBAO";27;2;6;35
2009;"GOVERNADOR EUGENIO BARROS (MA)";"MA";"GOVERNADOR EUGENIO BARROS";25;5;6;36
2009;"GOVERNADOR LUIZ ROCHA (MA)";"MA";"GOVERNADOR LUIZ ROCHA";11;3;4;18
2009;"GOVERNADOR NEWTON BELLO (MA)";"MA";"GOVERNADOR NEWTON BELLO";16;0;2;18
2009;"GOVERNADOR NUNES FREIRE (MA)";"MA";"GOVERNADOR NUNES FREIRE";39;4;2;45
2009;"GRACA ARANHA (MA)";"MA";"GRACA ARANHA";12;4;2;18
2009;"GRAJAU (MA)";"MA";"GRAJAU";295;13;13;321
2009;"GUIMARAES (MA)";"MA";"GUIMARAES";9;1;3;13
2009;"HUMBERTO DE CAMPOS (MA)";"MA";"HUMBERTO DE CAMPOS";12;2;1;15
2009;"ICATU (MA)";"MA";"ICATU";9;2;5;16
2009;"IGARAPE DO MEIO (MA)";"MA";"IGARAPE DO MEIO";24;3;6;33
2009;"IGARAPE GRANDE (MA)";"MA";"IGARAPE GRANDE";53;10;4;67
2009;"IMPERATRIZ (MA)";"MA";"IMPERATRIZ";2190;161;231;2582
2009;"ITAIPAVA DO GRAJAU (MA)";"MA";"ITAIPAVA DO GRAJAU";14;2;0;16
2009;"ITAPECURU MIRIM (MA)";"MA";"ITAPECURU MIRIM";232;14;25;271
2009;"ITINGA DO MARANHAO (MA)";"MA";"ITINGA DO MARANHAO";78;5;4;87
2009;"JATOBA (MA)";"MA";"JATOBA";2;2;0;4
2009;"JENIPAPO DOS VIEIRAS (MA)";"MA";"JENIPAPO DOS VIEIRAS";27;1;1;29
2009;"JOAO LISBOA (MA)";"MA";"JOAO LISBOA";62;4;5;71
2009;"JOSELANDIA (MA)";"MA";"JOSELANDIA";39;4;3;46
2009;"JUNCO DO MARANHAO (MA)";"MA";"JUNCO DO MARANHAO";6;13;0;19
2009;"LAGO DA PEDRA (MA)";"MA";"LAGO DA PEDRA";210;26;5;241
2009;"LAGO DO JUNCO (MA)";"MA";"LAGO DO JUNCO";16;2;3;21
2009;"LAGO DOS RODRIGUES (MA)";"MA";"LAGO DOS RODRIGUES";32;12;2;46
2009;"LAGO VERDE (MA)";"MA";"LAGO VERDE";17;1;4;22
2009;"LAGOA DO MATO (MA)";"MA";"LAGOA DO MATO";8;0;2;10
2009;"LAGOA GRANDE DO MARANHAO (MA)";"MA";"LAGOA GRANDE DO MARANHAO";15;1;0;16
2009;"LAJEADO NOVO (MA)";"MA";"LAJEADO NOVO";12;6;0;18
2009;"LIMA CAMPOS (MA)";"MA";"LIMA CAMPOS";53;17;2;72
2009;"LORETO (MA)";"MA";"LORETO";5;4;1;10
2009;"LUIS DOMINGUES (MA)";"MA";"LUIS DOMINGUES";0;2;1;3
2009;"MAGALHAES DE ALMEIDA (MA)";"MA";"MAGALHAES DE ALMEIDA";7;2;1;10
2009;"MARACACUME (MA)";"MA";"MARACACUME";39;27;1;67
2009;"MARAJA DO SENA (MA)";"MA";"MARAJA DO SENA";10;0;0;10
2009;"MARANHAOZINHO (MA)";"MA";"MARANHAOZINHO";16;0;1;17
2009;"MATA ROMA (MA)";"MA";"MATA ROMA";26;5;7;38
2009;"MATINHA (MA)";"MA";"MATINHA";22;8;0;30
2009;"MATOES (MA)";"MA";"MATOES";20;2;9;31
2009;"MATOES DO NORTE (MA)";"MA";"MATOES DO NORTE";9;4;1;14
2009;"MILAGRES DO MARANHAO (MA)";"MA";"MILAGRES DO MARANHAO";3;2;2;7
2009;"MIRADOR (MA)";"MA";"MIRADOR";14;1;1;16
2009;"MIRANDA DO NORTE (MA)";"MA";"MIRANDA DO NORTE";77;1;5;83
2009;"MIRINZAL (MA)";"MA";"MIRINZAL";21;1;4;26
2009;"MONCAO (MA)";"MA";"MONCAO";10;3;4;17
2009;"MONTES ALTOS (MA)";"MA";"MONTES ALTOS";30;0;1;31
2009;"MORROS (MA)";"MA";"MORROS";9;3;2;14
2009;"NINA RODRIGUES (MA)";"MA";"NINA RODRIGUES";5;4;1;10
2009;"NOVA COLINAS (MA)";"MA";"NOVA COLINAS";6;2;5;13
2009;"NOVA IORQUE (MA)";"MA";"NOVA IORQUE";3;1;1;5
2009;"NOVA OLINDA DO MARANHAO (MA)";"MA";"NOVA OLINDA DO MARANHAO";33;16;1;50
2009;"OLHO D AGUA DAS CUNHAS (MA)";"MA";"OLHO D AGUA DAS CUNHAS";58;9;5;72
2009;"OLINDA NOVA DO MARANHAO (MA)";"MA";"OLINDA NOVA DO MARANHAO";13;1;0;14
2009;"PACO DO LUMIAR (MA)";"MA";"PACO DO LUMIAR";273;99;77;449
2009;"PALMEIRANDIA (MA)";"MA";"PALMEIRANDIA";8;1;6;15
2009;"PARAIBANO (MA)";"MA";"PARAIBANO";29;12;3;44
2009;"PARNARAMA (MA)";"MA";"PARNARAMA";21;2;0;23
2009;"PASSAGEM FRANCA (MA)";"MA";"PASSAGEM FRANCA";15;2;1;18
2009;"PASTOS BONS (MA)";"MA";"PASTOS BONS";54;9;2;65
2009;"PAULINO NEVES (MA)";"MA";"PAULINO NEVES";0;0;0;0
2009;"PAULO RAMOS (MA)";"MA";"PAULO RAMOS";48;5;0;53
2009;"PEDREIRAS (MA)";"MA";"PEDREIRAS";278;43;24;345
2009;"PEDRO DO ROSARIO (MA)";"MA";"PEDRO DO ROSARIO";10;1;1;12
2009;"PENALVA (MA)";"MA";"PENALVA";10;2;1;13
2009;"PERI MIRIM (MA)";"MA";"PERI MIRIM";16;4;5;25
2009;"PERITORO (MA)";"MA";"PERITORO";26;44;6;76
2009;"PINDARE MIRIM (MA)";"MA";"PINDARE MIRIM";82;8;15;105
2009;"PINHEIRO (MA)";"MA";"PINHEIRO";335;23;49;407
2009;"PIO XII (MA)";"MA";"PIO XII";75;3;1;79
2009;"PIRAPEMAS (MA)";"MA";"PIRAPEMAS";10;5;3;18
2009;"POCAO DE PEDRAS (MA)";"MA";"POCAO DE PEDRAS";30;14;3;47
2009;"PORTO FRANCO (MA)";"MA";"PORTO FRANCO";37;15;5;57
2009;"PORTO RICO DO MARANHAO (MA)";"MA";"PORTO RICO DO MARANHAO";3;0;1;4
2009;"PRESIDENTE DUTRA (MA)";"MA";"PRESIDENTE DUTRA";259;18;9;286
2009;"PRESIDENTE JUSCELINO (MA)";"MA";"PRESIDENTE JUSCELINO";5;1;3;9
2009;"PRESIDENTE MEDICI (MA)";"MA";"PRESIDENTE MEDICI";5;4;0;9
2009;"PRESIDENTE SARNEY (MA)";"MA";"PRESIDENTE SARNEY";2;1;1;4
2009;"PRESIDENTE VARGAS (MA)";"MA";"PRESIDENTE VARGAS";17;4;1;22
2009;"PRIMEIRA CRUZ (MA)";"MA";"PRIMEIRA CRUZ";0;0;0;0
2009;"RAPOSA (MA)";"MA";"RAPOSA";40;2;25;67
2009;"RIACHAO (MA)";"MA";"RIACHAO";28;4;2;34
2009;"RIBAMAR FIQUENE (MA)";"MA";"RIBAMAR FIQUENE";6;3;1;10
2009;"ROSARIO (MA)";"MA";"ROSARIO";147;17;33;197
2009;"SAMBAIBA (MA)";"MA";"SAMBAIBA";10;1;0;11
2009;"SANTA FILOMENA DO MARANHAO (MA)";"MA";"SANTA FILOMENA DO MARANHAO";2;5;0;7
2009;"SANTA HELENA (MA)";"MA";"SANTA HELENA";61;5;3;69
2009;"SANTA INES (MA)";"MA";"SANTA INES";499;117;75;691
2009;"SANTA LUZIA (MA)";"MA";"SANTA LUZIA";198;73;8;279
2009;"SANTA LUZIA DO PARUA (MA)";"MA";"SANTA LUZIA DO PARUA";82;8;5;95
2009;"SANTA QUITERIA DO MARANHAO (MA)";"MA";"SANTA QUITERIA DO MARANHAO";18;4;6;28
2009;"SANTA RITA (MA)";"MA";"SANTA RITA";100;7;5;112
2009;"SANTANA DO MARANHAO (MA)";"MA";"SANTANA DO MARANHAO";6;0;3;9
2009;"SANTO AMARO DO MARANHAO (MA)";"MA";"SANTO AMARO DO MARANHAO";2;4;2;8
2009;"SANTO ANTONIO DOS LOPES (MA)";"MA";"SANTO ANTONIO DOS LOPES";66;7;1;74
2009;"SAO BENEDITO DO RIO PRETO (MA)";"MA";"SAO BENEDITO DO RIO PRETO";14;9;2;25
2009;"SAO BENTO (MA)";"MA";"SAO BENTO";80;19;11;110
2009;"SAO BERNARDO (MA)";"MA";"SAO BERNARDO";55;0;6;61
2009;"SAO DOMINGOS DO AZEITAO (MA)";"MA";"SAO DOMINGOS DO AZEITAO";15;1;1;17
2009;"SAO DOMINGOS DO MARANHAO (MA)";"MA";"SAO DOMINGOS DO MARANHAO";117;2;2;121
2009;"SAO FELIX DE BALSAS (MA)";"MA";"SAO FELIX DE BALSAS";4;0;0;4
2009;"SAO FRANCISCO DO BREJAO (MA)";"MA";"SAO FRANCISCO DO BREJAO";35;2;2;39
2009;"SAO FRANCISCO DO MARANHAO (MA)";"MA";"SAO FRANCISCO DO MARANHAO";3;0;0;3
2009;"SAO JOAO BATISTA (MA)";"MA";"SAO JOAO BATISTA";28;4;4;36
2009;"SAO JOAO DO CARU (MA)";"MA";"SAO JOAO DO CARU";13;1;0;14
2009;"SAO JOAO DO PARAISO (MA)";"MA";"SAO JOAO DO PARAISO";6;2;2;10
2009;"SAO JOAO DO SOTER (MA)";"MA";"SAO JOAO DO SOTER";9;1;0;10
2009;"SAO JOAO DOS PATOS (MA)";"MA";"SAO JOAO DOS PATOS";109;6;5;120
2009;"SAO JOSE DE RIBAMAR (MA)";"MA";"SAO JOSE DE RIBAMAR";419;108;84;611
2009;"SAO JOSE DOS BASILIOS (MA)";"MA";"SAO JOSE DOS BASILIOS";8;1;1;10
2009;"SAO LUIS (MA)";"MA";"SAO LUIS";6384;1056;2827;10267
2009;"SAO LUIS GONZAGA DO MARANHAO (MA)";"MA";"SAO LUIS GONZAGA DO MARANHAO";25;6;2;33
2009;"SAO MATEUS DO MARANHAO (MA)";"MA";"SAO MATEUS DO MARANHAO";81;37;14;132
2009;"SAO PEDRO DA AGUA BRANCA (MA)";"MA";"SAO PEDRO DA AGUA BRANCA";10;5;2;17
2009;"SAO PEDRO DOS CRENTES (MA)";"MA";"SAO PEDRO DOS CRENTES";7;1;1;9
2009;"SAO RAIMUNDO DAS MANGABEIRAS (MA)";"MA";"SAO RAIMUNDO DAS MANGABEIRAS";74;6;30;110
2009;"SAO RAIMUNDO DO DOCA BEZERRA (MA)";"MA";"SAO RAIMUNDO DO DOCA BEZERRA";12;0;1;13
2009;"SAO ROBERTO (MA)";"MA";"SAO ROBERTO";11;3;1;15
2009;"SAO VICENTE FERRER (MA)";"MA";"SAO VICENTE FERRER";17;2;4;23
2009;"SATUBINHA (MA)";"MA";"SATUBINHA";18;3;0;21
2009;"SENADOR ALEXANDRE COSTA (MA)";"MA";"SENADOR ALEXANDRE COSTA";14;4;1;19
2009;"SENADOR LA ROCQUE (MA)";"MA";"SENADOR LA ROCQUE";29;0;1;30
2009;"SERRANO DO MARANHAO (MA)";"MA";"SERRANO DO MARANHAO";1;0;1;2
2009;"SITIO NOVO (MA)";"MA";"SITIO NOVO";28;1;1;30
2009;"SUCUPIRA DO NORTE (MA)";"MA";"SUCUPIRA DO NORTE";13;2;2;17
2009;"SUCUPIRA DO RIACHAO (MA)";"MA";"SUCUPIRA DO RIACHAO";3;3;1;7
2009;"TASSO FRAGOSO (MA)";"MA";"TASSO FRAGOSO";28;3;2;33
2009;"TIMBIRAS (MA)";"MA";"TIMBIRAS";24;10;1;35
2009;"TIMON (MA)";"MA";"TIMON";442;36;35;513
2009;"TRIZIDELA DO VALE (MA)";"MA";"TRIZIDELA DO VALE";88;15;4;107
2009;"TUFILANDIA (MA)";"MA";"TUFILANDIA";7;6;0;13
2009;"TUNTUM (MA)";"MA";"TUNTUM";73;5;3;81
2009;"TURIACU (MA)";"MA";"TURIACU";23;1;6;30
2009;"TURILANDIA (MA)";"MA";"TURILANDIA";11;4;1;16
2009;"TUTOIA (MA)";"MA";"TUTOIA";29;3;3;35
2009;"URBANO SANTOS (MA)";"MA";"URBANO SANTOS";38;5;4;47
2009;"VARGEM GRANDE (MA)";"MA";"VARGEM GRANDE";84;3;2;89
2009;"VIANA (MA)";"MA";"VIANA";114;4;3;121
2009;"VILA NOVA DOS MARTIRIOS (MA)";"MA";"VILA NOVA DOS MARTIRIOS";15;3;0;18
2009;"VITORIA DO MEARIM (MA)";"MA";"VITORIA DO MEARIM";59;6;3;68
2009;"VITORINO FREIRE (MA)";"MA";"VITORINO FREIRE";98;7;3;108
2009;"ZE DOCA (MA)";"MA";"ZE DOCA";154;21;17;192
2009;"ABADIA DOS DOURADOS (MG)";"MG";"ABADIA DOS DOURADOS";79;27;7;113
2009;"ABAETE (MG)";"MG";"ABAETE";416;16;139;571
2009;"ABRE CAMPO (MG)";"MG";"ABRE CAMPO";147;11;59;217
2009;"ACAIACA (MG)";"MG";"ACAIACA";15;6;6;27
2009;"ACUCENA (MG)";"MG";"ACUCENA";29;10;26;65
2009;"AGUA BOA (MG)";"MG";"AGUA BOA";49;6;21;76
2009;"AGUA COMPRIDA (MG)";"MG";"AGUA COMPRIDA";35;7;5;47
2009;"AGUANIL (MG)";"MG";"AGUANIL";34;4;8;46
2009;"AGUAS FORMOSAS (MG)";"MG";"AGUAS FORMOSAS";78;18;26;122
2009;"AGUAS VERMELHAS (MG)";"MG";"AGUAS VERMELHAS";62;9;13;84
2009;"AIMORES (MG)";"MG";"AIMORES";153;22;28;203
2009;"AIURUOCA (MG)";"MG";"AIURUOCA";74;12;11;97
2009;"ALAGOA (MG)";"MG";"ALAGOA";20;3;9;32
2009;"ALBERTINA (MG)";"MG";"ALBERTINA";35;12;4;51
2009;"ALEM PARAIBA (MG)";"MG";"ALEM PARAIBA";1216;69;78;1363
2009;"ALFENAS (MG)";"MG";"ALFENAS";1006;79;234;1319
2009;"ALFREDO VASCONCELOS (MG)";"MG";"ALFREDO VASCONCELOS";118;10;10;138
2009;"ALMENARA (MG)";"MG";"ALMENARA";195;29;76;300
2009;"ALPERCATA (MG)";"MG";"ALPERCATA";53;2;4;59
2009;"ALPINOPOLIS (MG)";"MG";"ALPINOPOLIS";378;20;33;431
2009;"ALTEROSA (MG)";"MG";"ALTEROSA";195;28;32;255
2009;"ALTO CAPARAO (MG)";"MG";"ALTO CAPARAO";58;6;2;66
2009;"ALTO JEQUITIBA (MG)";"MG";"ALTO JEQUITIBA";55;9;8;72
2009;"ALTO RIO DOCE (MG)";"MG";"ALTO RIO DOCE";84;16;22;122
2009;"ALVARENGA (MG)";"MG";"ALVARENGA";26;1;9;36
2009;"ALVINOPOLIS (MG)";"MG";"ALVINOPOLIS";148;14;18;180
2009;"ALVORADA DE MINAS (MG)";"MG";"ALVORADA DE MINAS";6;5;7;18
2009;"AMPARO DA SERRA (MG)";"MG";"AMPARO DA SERRA";31;5;17;53
2009;"ANDRADAS (MG)";"MG";"ANDRADAS";866;61;74;1001
2009;"ANDRELANDIA (MG)";"MG";"ANDRELANDIA";120;26;16;162
2009;"ANGELANDIA (MG)";"MG";"ANGELANDIA";42;5;17;64
2009;"ANTONIO CARLOS (MG)";"MG";"ANTONIO CARLOS";130;11;15;156
2009;"ANTONIO DIAS (MG)";"MG";"ANTONIO DIAS";87;8;32;127
2009;"ANTONIO PRADO DE MINAS (MG)";"MG";"ANTONIO PRADO DE MINAS";11;2;3;16
2009;"ARACAI (MG)";"MG";"ARACAI";13;6;5;24
2009;"ARACITABA (MG)";"MG";"ARACITABA";10;1;1;12
2009;"ARACUAI (MG)";"MG";"ARACUAI";182;9;64;255
2009;"ARAGUARI (MG)";"MG";"ARAGUARI";1880;277;151;2308
2009;"ARANTINA (MG)";"MG";"ARANTINA";23;1;2;26
2009;"ARAPONGA (MG)";"MG";"ARAPONGA";46;6;7;59
2009;"ARAPORA (MG)";"MG";"ARAPORA";155;12;62;229
2009;"ARAPUA (MG)";"MG";"ARAPUA";39;2;14;55
2009;"ARAUJOS (MG)";"MG";"ARAUJOS";100;6;5;111
2009;"ARAXA (MG)";"MG";"ARAXA";1364;127;257;1748
2009;"ARCEBURGO (MG)";"MG";"ARCEBURGO";85;19;33;137
2009;"ARCOS (MG)";"MG";"ARCOS";999;65;242;1306
2009;"AREADO (MG)";"MG";"AREADO";181;11;68;260
2009;"ARGIRITA (MG)";"MG";"ARGIRITA";20;4;4;28
2009;"ARICANDUVA (MG)";"MG";"ARICANDUVA";8;3;8;19
2009;"ARINOS (MG)";"MG";"ARINOS";157;13;45;215
2009;"ASTOLFO DUTRA (MG)";"MG";"ASTOLFO DUTRA";184;10;21;215
2009;"ATALEIA (MG)";"MG";"ATALEIA";61;16;21;98
2009;"AUGUSTO DE LIMA (MG)";"MG";"AUGUSTO DE LIMA";27;3;12;42
2009;"BAEPENDI (MG)";"MG";"BAEPENDI";319;31;27;377
2009;"BALDIM (MG)";"MG";"BALDIM";124;5;12;141
2009;"BAMBUI (MG)";"MG";"BAMBUI";362;25;70;457
2009;"BANDEIRA (MG)";"MG";"BANDEIRA";2;2;2;6
2009;"BANDEIRA DO SUL (MG)";"MG";"BANDEIRA DO SUL";113;20;4;137
2009;"BARAO DE COCAIS (MG)";"MG";"BARAO DE COCAIS";399;47;57;503
2009;"BARAO DE MONTE ALTO (MG)";"MG";"BARAO DE MONTE ALTO";18;2;7;27
2009;"BARBACENA (MG)";"MG";"BARBACENA";1441;285;204;1930
2009;"BARRA LONGA (MG)";"MG";"BARRA LONGA";41;7;8;56
2009;"BARROSO (MG)";"MG";"BARROSO";369;24;19;412
2009;"BELA VISTA DE MINAS (MG)";"MG";"BELA VISTA DE MINAS";126;13;10;149
2009;"BELMIRO BRAGA (MG)";"MG";"BELMIRO BRAGA";43;6;3;52
2009;"BELO HORIZONTE (MG)";"MG";"BELO HORIZONTE";29295;4453;7769;41517
2009;"BELO ORIENTE (MG)";"MG";"BELO ORIENTE";222;102;79;403
2009;"BELO VALE (MG)";"MG";"BELO VALE";102;15;22;139
2009;"BERILO (MG)";"MG";"BERILO";45;5;20;70
2009;"BERIZAL (MG)";"MG";"BERIZAL";15;3;6;24
2009;"BERTOPOLIS (MG)";"MG";"BERTOPOLIS";9;3;2;14
2009;"BETIM (MG)";"MG";"BETIM";3715;453;1076;5244
2009;"BIAS FORTES (MG)";"MG";"BIAS FORTES";18;4;3;25
2009;"BICAS (MG)";"MG";"BICAS";198;30;28;256
2009;"BIQUINHAS (MG)";"MG";"BIQUINHAS";38;9;3;50
2009;"BOA ESPERANCA (MG)";"MG";"BOA ESPERANCA";527;43;139;709
2009;"BOCAINA DE MINAS (MG)";"MG";"BOCAINA DE MINAS";52;10;7;69
2009;"BOCAIUVA (MG)";"MG";"BOCAIUVA";346;33;116;495
2009;"BOM DESPACHO (MG)";"MG";"BOM DESPACHO";860;58;308;1226
2009;"BOM JARDIM DE MINAS (MG)";"MG";"BOM JARDIM DE MINAS";88;11;11;110
2009;"BOM JESUS DA PENHA (MG)";"MG";"BOM JESUS DA PENHA";105;9;7;121
2009;"BOM JESUS DO AMPARO (MG)";"MG";"BOM JESUS DO AMPARO";71;7;10;88
2009;"BOM JESUS DO GALHO (MG)";"MG";"BOM JESUS DO GALHO";75;6;14;95
2009;"BOM REPOUSO (MG)";"MG";"BOM REPOUSO";169;12;6;187
2009;"BOM SUCESSO (MG)";"MG";"BOM SUCESSO";207;20;40;267
2009;"BONFIM (MG)";"MG";"BONFIM";104;14;14;132
2009;"BONFINOPOLIS DE MINAS (MG)";"MG";"BONFINOPOLIS DE MINAS";68;2;21;91
2009;"BONITO DE MINAS (MG)";"MG";"BONITO DE MINAS";14;3;14;31
2009;"BORDA DA MATA (MG)";"MG";"BORDA DA MATA";236;21;55;312
2009;"BOTELHOS (MG)";"MG";"BOTELHOS";219;42;28;289
2009;"BOTUMIRIM (MG)";"MG";"BOTUMIRIM";14;1;8;23
2009;"BRAS PIRES (MG)";"MG";"BRAS PIRES";29;7;5;41
2009;"BRASILANDIA DE MINAS (MG)";"MG";"BRASILANDIA DE MINAS";197;7;74;278
2009;"BRASILIA DE MINAS (MG)";"MG";"BRASILIA DE MINAS";193;8;67;268
2009;"BRASOPOLIS (MG)";"MG";"BRASOPOLIS";172;23;21;216
2009;"BRAUNAS (MG)";"MG";"BRAUNAS";10;5;14;29
2009;"BRUMADINHO (MG)";"MG";"BRUMADINHO";719;101;178;998
2009;"BUENO BRANDAO (MG)";"MG";"BUENO BRANDAO";166;32;22;220
2009;"BUENOPOLIS (MG)";"MG";"BUENOPOLIS";91;4;23;118
2009;"BUGRE (MG)";"MG";"BUGRE";18;1;4;23
2009;"BURITIS (MG)";"MG";"BURITIS";235;10;83;328
2009;"BURITIZEIRO (MG)";"MG";"BURITIZEIRO";194;8;78;280
2009;"CABECEIRA GRANDE (MG)";"MG";"CABECEIRA GRANDE";27;0;9;36
2009;"CABO VERDE (MG)";"MG";"CABO VERDE";173;17;28;218
2009;"CACHOEIRA DA PRATA (MG)";"MG";"CACHOEIRA DA PRATA";50;3;2;55
2009;"CACHOEIRA DE MINAS (MG)";"MG";"CACHOEIRA DE MINAS";108;18;9;135
2009;"CACHOEIRA DE PAJEU (MG)";"MG";"CACHOEIRA DE PAJEU";31;8;12;51
2009;"CACHOEIRA DOURADA (MG)";"MG";"CACHOEIRA DOURADA";20;10;2;32
2009;"CAETANOPOLIS (MG)";"MG";"CAETANOPOLIS";98;13;41;152
2009;"CAETE (MG)";"MG";"CAETE";439;60;52;551
2009;"CAIANA (MG)";"MG";"CAIANA";28;5;7;40
2009;"CAJURI (MG)";"MG";"CAJURI";33;5;7;45
2009;"CALDAS (MG)";"MG";"CALDAS";239;21;24;284
2009;"CAMACHO (MG)";"MG";"CAMACHO";56;6;5;67
2009;"CAMANDUCAIA (MG)";"MG";"CAMANDUCAIA";422;37;38;497
2009;"CAMBUI (MG)";"MG";"CAMBUI";463;42;86;591
2009;"CAMBUQUIRA (MG)";"MG";"CAMBUQUIRA";108;21;9;138
2009;"CAMPANARIO (MG)";"MG";"CAMPANARIO";9;6;3;18
2009;"CAMPANHA (MG)";"MG";"CAMPANHA";198;30;21;249
2009;"CAMPESTRE (MG)";"MG";"CAMPESTRE";419;35;40;494
2009;"CAMPINA VERDE (MG)";"MG";"CAMPINA VERDE";221;21;37;279
2009;"CAMPO AZUL (MG)";"MG";"CAMPO AZUL";6;3;4;13
2009;"CAMPO BELO (MG)";"MG";"CAMPO BELO";1049;66;113;1228
2009;"CAMPO DO MEIO (MG)";"MG";"CAMPO DO MEIO";105;23;56;184
2009;"CAMPO FLORIDO (MG)";"MG";"CAMPO FLORIDO";108;23;55;186
2009;"CAMPOS ALTOS (MG)";"MG";"CAMPOS ALTOS";272;18;70;360
2009;"CAMPOS GERAIS (MG)";"MG";"CAMPOS GERAIS";286;17;68;371
2009;"CANA VERDE (MG)";"MG";"CANA VERDE";52;6;5;63
2009;"CANAA (MG)";"MG";"CANAA";60;5;10;75
2009;"CANAPOLIS (MG)";"MG";"CANAPOLIS";190;10;90;290
2009;"CANDEIAS (MG)";"MG";"CANDEIAS";213;14;27;254
2009;"CANTAGALO (MG)";"MG";"CANTAGALO";12;2;7;21
2009;"CAPARAO (MG)";"MG";"CAPARAO";40;3;4;47
2009;"CAPELA NOVA (MG)";"MG";"CAPELA NOVA";16;12;3;31
2009;"CAPELINHA (MG)";"MG";"CAPELINHA";554;26;134;714
2009;"CAPETINGA (MG)";"MG";"CAPETINGA";156;14;25;195
2009;"CAPIM BRANCO (MG)";"MG";"CAPIM BRANCO";61;10;11;82
2009;"CAPINOPOLIS (MG)";"MG";"CAPINOPOLIS";242;27;69;338
2009;"CAPITAO ANDRADE (MG)";"MG";"CAPITAO ANDRADE";27;6;2;35
2009;"CAPITAO ENEAS (MG)";"MG";"CAPITAO ENEAS";54;2;19;75
2009;"CAPITOLIO (MG)";"MG";"CAPITOLIO";131;16;12;159
2009;"CAPUTIRA (MG)";"MG";"CAPUTIRA";113;4;27;144
2009;"CARAI (MG)";"MG";"CARAI";50;27;28;105
2009;"CARANAIBA (MG)";"MG";"CARANAIBA";15;5;9;29
2009;"CARANDAI (MG)";"MG";"CARANDAI";420;32;88;540
2009;"CARANGOLA (MG)";"MG";"CARANGOLA";328;32;42;402
2009;"CARATINGA (MG)";"MG";"CARATINGA";1043;60;779;1882
2009;"CARBONITA (MG)";"MG";"CARBONITA";142;10;31;183
2009;"CAREACU (MG)";"MG";"CAREACU";85;7;5;97
2009;"CARLOS CHAGAS (MG)";"MG";"CARLOS CHAGAS";123;28;40;191
2009;"CARMESIA (MG)";"MG";"CARMESIA";60;3;1122;1185
2009;"CARMO DA CACHOEIRA (MG)";"MG";"CARMO DA CACHOEIRA";132;27;40;199
2009;"CARMO DA MATA (MG)";"MG";"CARMO DA MATA";121;15;35;171
2009;"CARMO DE MINAS (MG)";"MG";"CARMO DE MINAS";125;24;14;163
2009;"CARMO DO CAJURU (MG)";"MG";"CARMO DO CAJURU";305;34;65;404
2009;"CARMO DO PARANAIBA (MG)";"MG";"CARMO DO PARANAIBA";506;45;87;638
2009;"CARMO DO RIO CLARO (MG)";"MG";"CARMO DO RIO CLARO";284;15;62;361
2009;"CARMOPOLIS DE MINAS (MG)";"MG";"CARMOPOLIS DE MINAS";457;28;32;517
2009;"CARNEIRINHO (MG)";"MG";"CARNEIRINHO";163;18;58;239
2009;"CARRANCAS (MG)";"MG";"CARRANCAS";39;9;11;59
2009;"CARVALHOPOLIS (MG)";"MG";"CARVALHOPOLIS";29;9;5;43
2009;"CARVALHOS (MG)";"MG";"CARVALHOS";52;5;6;63
2009;"CASA GRANDE (MG)";"MG";"CASA GRANDE";24;4;2;30
2009;"CASCALHO RICO (MG)";"MG";"CASCALHO RICO";47;18;2;67
2009;"CASSIA (MG)";"MG";"CASSIA";353;32;35;420
2009;"CATAGUASES (MG)";"MG";"CATAGUASES";576;65;165;806
2009;"CATAS ALTAS (MG)";"MG";"CATAS ALTAS";105;11;5;121
2009;"CATAS ALTAS DA NORUEGA (MG)";"MG";"CATAS ALTAS DA NORUEGA";35;3;5;43
2009;"CATUJI (MG)";"MG";"CATUJI";33;13;10;56
2009;"CATUTI (MG)";"MG";"CATUTI";14;6;13;33
2009;"CAXAMBU (MG)";"MG";"CAXAMBU";200;31;19;250
2009;"CEDRO DO ABAETE (MG)";"MG";"CEDRO DO ABAETE";8;1;1;10
2009;"CENTRAL DE MINAS (MG)";"MG";"CENTRAL DE MINAS";68;8;10;86
2009;"CENTRALINA (MG)";"MG";"CENTRALINA";96;4;15;115
2009;"CHACARA (MG)";"MG";"CHACARA";27;7;4;38
2009;"CHALE (MG)";"MG";"CHALE";44;6;11;61
2009;"CHAPADA DO NORTE (MG)";"MG";"CHAPADA DO NORTE";37;7;15;59
2009;"CHAPADA GAUCHA (MG)";"MG";"CHAPADA GAUCHA";68;7;12;87
2009;"CHIADOR (MG)";"MG";"CHIADOR";42;7;7;56
2009;"CIPOTANEA (MG)";"MG";"CIPOTANEA";32;2;9;43
2009;"CLARAVAL (MG)";"MG";"CLARAVAL";132;4;30;166
2009;"CLARO DOS POCOES (MG)";"MG";"CLARO DOS POCOES";28;3;18;49
2009;"CLAUDIO (MG)";"MG";"CLAUDIO";624;27;48;699
2009;"COIMBRA (MG)";"MG";"COIMBRA";92;4;8;104
2009;"COLUNA (MG)";"MG";"COLUNA";32;1;12;45
2009;"COMENDADOR GOMES (MG)";"MG";"COMENDADOR GOMES";36;4;6;46
2009;"COMERCINHO (MG)";"MG";"COMERCINHO";22;5;10;37
2009;"CONCEICAO DA APARECIDA (MG)";"MG";"CONCEICAO DA APARECIDA";117;6;12;135
2009;"CONCEICAO DA BARRA DE MINAS (MG)";"MG";"CONCEICAO DA BARRA DE MINAS";26;4;5;35
2009;"CONCEICAO DAS ALAGOAS (MG)";"MG";"CONCEICAO DAS ALAGOAS";414;15;92;521
2009;"CONCEICAO DAS PEDRAS (MG)";"MG";"CONCEICAO DAS PEDRAS";20;10;2;32
2009;"CONCEICAO DE IPANEMA (MG)";"MG";"CONCEICAO DE IPANEMA";28;6;2;36
2009;"CONCEICAO DO MATO DENTRO (MG)";"MG";"CONCEICAO DO MATO DENTRO";94;13;115;222
2009;"CONCEICAO DO PARA (MG)";"MG";"CONCEICAO DO PARA";50;11;16;77
2009;"CONCEICAO DO RIO VERDE (MG)";"MG";"CONCEICAO DO RIO VERDE";184;34;18;236
2009;"CONCEICAO DOS OUROS (MG)";"MG";"CONCEICAO DOS OUROS";254;28;9;291
2009;"CONEGO MARINHO (MG)";"MG";"CONEGO MARINHO";10;4;8;22
2009;"CONFINS (MG)";"MG";"CONFINS";84;12;12;108
2009;"CONGONHAL (MG)";"MG";"CONGONHAL";200;7;13;220
2009;"CONGONHAS (MG)";"MG";"CONGONHAS";688;92;99;879
2009;"CONGONHAS DO NORTE (MG)";"MG";"CONGONHAS DO NORTE";25;4;5;34
2009;"CONQUISTA (MG)";"MG";"CONQUISTA";149;15;27;191
2009;"CONSELHEIRO LAFAIETE (MG)";"MG";"CONSELHEIRO LAFAIETE";1106;210;479;1795
2009;"CONSELHEIRO PENA (MG)";"MG";"CONSELHEIRO PENA";165;2;47;214
2009;"CONSOLACAO (MG)";"MG";"CONSOLACAO";13;5;1;19
2009;"CONTAGEM (MG)";"MG";"CONTAGEM";10767;1227;2248;14242
2009;"COQUEIRAL (MG)";"MG";"COQUEIRAL";81;11;12;104
2009;"CORACAO DE JESUS (MG)";"MG";"CORACAO DE JESUS";128;5;74;207
2009;"CORDISBURGO (MG)";"MG";"CORDISBURGO";72;8;7;87
2009;"CORDISLANDIA (MG)";"MG";"CORDISLANDIA";42;6;3;51
2009;"CORINTO (MG)";"MG";"CORINTO";262;12;54;328
2009;"COROACI (MG)";"MG";"COROACI";42;5;9;56
2009;"COROMANDEL (MG)";"MG";"COROMANDEL";480;45;80;605
2009;"CORONEL FABRICIANO (MG)";"MG";"CORONEL FABRICIANO";1002;134;468;1604
2009;"CORONEL MURTA (MG)";"MG";"CORONEL MURTA";14;2;9;25
2009;"CORONEL PACHECO (MG)";"MG";"CORONEL PACHECO";40;6;8;54
2009;"CORONEL XAVIER CHAVES (MG)";"MG";"CORONEL XAVIER CHAVES";67;5;2;74
2009;"CORREGO DANTA (MG)";"MG";"CORREGO DANTA";25;4;6;35
2009;"CORREGO DO BOM JESUS (MG)";"MG";"CORREGO DO BOM JESUS";33;5;7;45
2009;"CORREGO FUNDO (MG)";"MG";"CORREGO FUNDO";293;14;17;324
2009;"CORREGO NOVO (MG)";"MG";"CORREGO NOVO";13;4;7;24
2009;"COUTO DE MAGALHAES DE MINAS (MG)";"MG";"COUTO DE MAGALHAES DE MINAS";31;1;7;39
2009;"CRISOLITA (MG)";"MG";"CRISOLITA";8;10;8;26
2009;"CRISTAIS (MG)";"MG";"CRISTAIS";129;6;13;148
2009;"CRISTALIA (MG)";"MG";"CRISTALIA";21;4;14;39
2009;"CRISTIANO OTONI (MG)";"MG";"CRISTIANO OTONI";67;12;9;88
2009;"CRISTINA (MG)";"MG";"CRISTINA";122;23;10;155
2009;"CRUCILANDIA (MG)";"MG";"CRUCILANDIA";130;6;11;147
2009;"CRUZEIRO DA FORTALEZA (MG)";"MG";"CRUZEIRO DA FORTALEZA";48;4;11;63
2009;"CRUZILIA (MG)";"MG";"CRUZILIA";276;20;18;314
2009;"CUPARAQUE (MG)";"MG";"CUPARAQUE";34;7;3;44
2009;"CURRAL DE DENTRO (MG)";"MG";"CURRAL DE DENTRO";36;5;7;48
2009;"CURVELO (MG)";"MG";"CURVELO";953;35;1624;2612
2009;"DATAS (MG)";"MG";"DATAS";24;4;11;39
2009;"DELFIM MOREIRA (MG)";"MG";"DELFIM MOREIRA";72;5;17;94
2009;"DELFINOPOLIS (MG)";"MG";"DELFINOPOLIS";70;10;6;86
2009;"DELTA (MG)";"MG";"DELTA";384;26;117;527
2009;"DESCOBERTO (MG)";"MG";"DESCOBERTO";25;7;1;33
2009;"DESTERRO DE ENTRE RIOS (MG)";"MG";"DESTERRO DE ENTRE RIOS";83;13;16;112
2009;"DESTERRO DO MELO (MG)";"MG";"DESTERRO DO MELO";26;2;5;33
2009;"DIAMANTINA (MG)";"MG";"DIAMANTINA";269;56;292;617
2009;"DIOGO DE VASCONCELOS (MG)";"MG";"DIOGO DE VASCONCELOS";15;3;6;24
2009;"DIONISIO (MG)";"MG";"DIONISIO";38;5;16;59
2009;"DIVINESIA (MG)";"MG";"DIVINESIA";56;7;5;68
2009;"DIVINO (MG)";"MG";"DIVINO";213;15;34;262
2009;"DIVINO DAS LARANJEIRAS (MG)";"MG";"DIVINO DAS LARANJEIRAS";28;1;4;33
2009;"DIVINOLANDIA DE MINAS (MG)";"MG";"DIVINOLANDIA DE MINAS";47;3;17;67
2009;"DIVINOPOLIS (MG)";"MG";"DIVINOPOLIS";2890;206;677;3773
2009;"DIVISA ALEGRE (MG)";"MG";"DIVISA ALEGRE";33;2;5;40
2009;"DIVISA NOVA (MG)";"MG";"DIVISA NOVA";58;14;18;90
2009;"DIVISOPOLIS (MG)";"MG";"DIVISOPOLIS";15;7;8;30
2009;"DOM BOSCO (MG)";"MG";"DOM BOSCO";18;1;9;28
2009;"DOM CAVATI (MG)";"MG";"DOM CAVATI";151;6;6;163
2009;"DOM JOAQUIM (MG)";"MG";"DOM JOAQUIM";10;4;5;19
2009;"DOM SILVERIO (MG)";"MG";"DOM SILVERIO";48;7;5;60
2009;"DOM VICOSO (MG)";"MG";"DOM VICOSO";27;12;8;47
2009;"DONA EUZEBIA (MG)";"MG";"DONA EUZEBIA";246;5;2;253
2009;"DORES DE CAMPOS (MG)";"MG";"DORES DE CAMPOS";63;9;22;94
2009;"DORES DE GUANHAES (MG)";"MG";"DORES DE GUANHAES";28;3;17;48
2009;"DORES DO INDAIA (MG)";"MG";"DORES DO INDAIA";195;22;25;242
2009;"DORES DO TURVO (MG)";"MG";"DORES DO TURVO";33;3;12;48
2009;"DORESOPOLIS (MG)";"MG";"DORESOPOLIS";10;10;1;21
2009;"DOURADOQUARA (MG)";"MG";"DOURADOQUARA";26;8;1;35
2009;"DURANDE (MG)";"MG";"DURANDE";79;4;11;94
2009;"ELOI MENDES (MG)";"MG";"ELOI MENDES";461;48;31;540
2009;"ENGENHEIRO CALDAS (MG)";"MG";"ENGENHEIRO CALDAS";112;8;7;127
2009;"ENGENHEIRO NAVARRO (MG)";"MG";"ENGENHEIRO NAVARRO";44;1;17;62
2009;"ENTRE FOLHAS (MG)";"MG";"ENTRE FOLHAS";54;2;7;63
2009;"ENTRE RIOS DE MINAS (MG)";"MG";"ENTRE RIOS DE MINAS";238;17;63;318
2009;"ERVALIA (MG)";"MG";"ERVALIA";246;11;28;285
2009;"ESMERALDAS (MG)";"MG";"ESMERALDAS";365;31;240;636
2009;"ESPERA FELIZ (MG)";"MG";"ESPERA FELIZ";267;26;36;329
2009;"ESPINOSA (MG)";"MG";"ESPINOSA";251;9;49;309
2009;"ESPIRITO SANTO DO DOURADO (MG)";"MG";"ESPIRITO SANTO DO DOURADO";66;3;5;74
2009;"ESTIVA (MG)";"MG";"ESTIVA";250;17;17;284
2009;"ESTRELA DALVA (MG)";"MG";"ESTRELA DALVA";22;4;0;26
2009;"ESTRELA DO INDAIA (MG)";"MG";"ESTRELA DO INDAIA";36;5;2;43
2009;"ESTRELA DO SUL (MG)";"MG";"ESTRELA DO SUL";84;11;14;109
2009;"EUGENOPOLIS (MG)";"MG";"EUGENOPOLIS";75;19;21;115
2009;"EWBANK DA CAMARA (MG)";"MG";"EWBANK DA CAMARA";35;3;4;42
2009;"EXTREMA (MG)";"MG";"EXTREMA";421;58;49;528
2009;"FAMA (MG)";"MG";"FAMA";13;8;1;22
2009;"FARIA LEMOS (MG)";"MG";"FARIA LEMOS";19;8;0;27
2009;"FELICIO DOS SANTOS (MG)";"MG";"FELICIO DOS SANTOS";17;8;14;39
2009;"FELISBURGO (MG)";"MG";"FELISBURGO";14;3;6;23
2009;"FELIXLANDIA (MG)";"MG";"FELIXLANDIA";183;10;41;234
2009;"FERNANDES TOURINHO (MG)";"MG";"FERNANDES TOURINHO";14;8;7;29
2009;"FERROS (MG)";"MG";"FERROS";78;6;39;123
2009;"FERVEDOURO (MG)";"MG";"FERVEDOURO";80;10;7;97
2009;"FLORESTAL (MG)";"MG";"FLORESTAL";53;9;14;76
2009;"FORMIGA (MG)";"MG";"FORMIGA";1389;112;174;1675
2009;"FORMOSO (MG)";"MG";"FORMOSO";27;1;19;47
2009;"FORTALEZA DE MINAS (MG)";"MG";"FORTALEZA DE MINAS";47;17;7;71
2009;"FORTUNA DE MINAS (MG)";"MG";"FORTUNA DE MINAS";20;3;6;29
2009;"FRANCISCO BADARO (MG)";"MG";"FRANCISCO BADARO";37;2;14;53
2009;"FRANCISCO DUMONT (MG)";"MG";"FRANCISCO DUMONT";45;3;19;67
2009;"FRANCISCO SA (MG)";"MG";"FRANCISCO SA";106;7;64;177
2009;"FRANCISCOPOLIS (MG)";"MG";"FRANCISCOPOLIS";11;6;9;26
2009;"FREI GASPAR (MG)";"MG";"FREI GASPAR";19;8;6;33
2009;"FREI INOCENCIO (MG)";"MG";"FREI INOCENCIO";81;8;20;109
2009;"FREI LAGONEGRO (MG)";"MG";"FREI LAGONEGRO";2;4;4;10
2009;"FRONTEIRA (MG)";"MG";"FRONTEIRA";211;32;62;305
2009;"FRONTEIRA DOS VALES (MG)";"MG";"FRONTEIRA DOS VALES";7;5;1;13
2009;"FRUTA DE LEITE (MG)";"MG";"FRUTA DE LEITE";19;2;18;39
2009;"FRUTAL (MG)";"MG";"FRUTAL";1287;108;181;1576
2009;"FUNILANDIA (MG)";"MG";"FUNILANDIA";32;3;11;46
2009;"GALILEIA (MG)";"MG";"GALILEIA";59;2;7;68
2009;"GAMELEIRAS (MG)";"MG";"GAMELEIRAS";24;2;12;38
2009;"GLAUCILANDIA (MG)";"MG";"GLAUCILANDIA";0;2;3;5
2009;"GOIABEIRA (MG)";"MG";"GOIABEIRA";20;7;3;30
2009;"GOIANA (MG)";"MG";"GOIANA";17;4;4;25
2009;"GONCALVES (MG)";"MG";"GONCALVES";112;14;4;130
2009;"GONZAGA (MG)";"MG";"GONZAGA";28;4;8;40
2009;"GOUVEA (MG)";"MG";"GOUVEA";123;7;26;156
2009;"GOVERNADOR VALADARES (MG)";"MG";"GOVERNADOR VALADARES";2909;224;355;3488
2009;"GRAO MOGOL (MG)";"MG";"GRAO MOGOL";44;6;63;113
2009;"GRUPIARA (MG)";"MG";"GRUPIARA";9;2;2;13
2009;"GUANHAES (MG)";"MG";"GUANHAES";403;29;79;511
2009;"GUAPE (MG)";"MG";"GUAPE";153;16;44;213
2009;"GUARACIABA (MG)";"MG";"GUARACIABA";52;10;26;88
2009;"GUARACIAMA (MG)";"MG";"GUARACIAMA";26;3;12;41
2009;"GUARANESIA (MG)";"MG";"GUARANESIA";318;33;75;426
2009;"GUARANI (MG)";"MG";"GUARANI";84;11;8;103
2009;"GUARARA (MG)";"MG";"GUARARA";43;8;2;53
2009;"GUARDA MOR (MG)";"MG";"GUARDA MOR";75;11;11;97
2009;"GUAXUPE (MG)";"MG";"GUAXUPE";778;63;155;996
2009;"GUIDOVAL (MG)";"MG";"GUIDOVAL";111;1;4;116
2009;"GUIMARANIA (MG)";"MG";"GUIMARANIA";115;4;21;140
2009;"GUIRICEMA (MG)";"MG";"GUIRICEMA";203;8;16;227
2009;"GURINHATA (MG)";"MG";"GURINHATA";76;8;20;104
2009;"HELIODORA (MG)";"MG";"HELIODORA";74;7;9;90
2009;"IAPU (MG)";"MG";"IAPU";113;12;18;143
2009;"IBERTIOGA (MG)";"MG";"IBERTIOGA";31;9;3;43
2009;"IBIA (MG)";"MG";"IBIA";341;31;80;452
2009;"IBIAI (MG)";"MG";"IBIAI";41;4;6;51
2009;"IBIRACATU (MG)";"MG";"IBIRACATU";9;5;10;24
2009;"IBIRACI (MG)";"MG";"IBIRACI";322;27;24;373
2009;"IBIRITE (MG)";"MG";"IBIRITE";1091;164;245;1500
2009;"IBITIURA DE MINAS (MG)";"MG";"IBITIURA DE MINAS";73;3;3;79
2009;"IBITURUNA (MG)";"MG";"IBITURUNA";29;6;3;38
2009;"ICARAI DE MINAS (MG)";"MG";"ICARAI DE MINAS";18;4;4;26
2009;"IGARAPE (MG)";"MG";"IGARAPE";561;48;120;729
2009;"IGARATINGA (MG)";"MG";"IGARATINGA";390;6;15;411
2009;"IGUATAMA (MG)";"MG";"IGUATAMA";110;9;16;135
2009;"IJACI (MG)";"MG";"IJACI";92;6;11;109
2009;"ILICINEA (MG)";"MG";"ILICINEA";157;8;33;198
2009;"IMBE DE MINAS (MG)";"MG";"IMBE DE MINAS";36;3;10;49
2009;"INCONFIDENTES (MG)";"MG";"INCONFIDENTES";65;13;13;91
2009;"INDAIABIRA (MG)";"MG";"INDAIABIRA";38;5;20;63
2009;"INDIANOPOLIS (MG)";"MG";"INDIANOPOLIS";59;28;18;105
2009;"INGAI (MG)";"MG";"INGAI";15;8;6;29
2009;"INHAPIM (MG)";"MG";"INHAPIM";318;12;51;381
2009;"INHAUMA (MG)";"MG";"INHAUMA";73;4;12;89
2009;"INIMUTABA (MG)";"MG";"INIMUTABA";30;4;4;38
2009;"IPABA (MG)";"MG";"IPABA";75;13;16;104
2009;"IPANEMA (MG)";"MG";"IPANEMA";161;21;20;202
2009;"IPATINGA (MG)";"MG";"IPATINGA";2726;411;537;3674
2009;"IPIACU (MG)";"MG";"IPIACU";51;2;9;62
2009;"IPUIUNA (MG)";"MG";"IPUIUNA";332;20;19;371
2009;"IRAI DE MINAS (MG)";"MG";"IRAI DE MINAS";170;15;30;215
2009;"ITABIRA (MG)";"MG";"ITABIRA";1220;167;330;1717
2009;"ITABIRINHA DE MANTENA (MG)";"MG";"ITABIRINHA DE MANTENA";115;5;28;148
2009;"ITABIRITO (MG)";"MG";"ITABIRITO";798;149;258;1205
2009;"ITACAMBIRA (MG)";"MG";"ITACAMBIRA";9;0;6;15
2009;"ITACARAMBI (MG)";"MG";"ITACARAMBI";79;6;26;111
2009;"ITAGUARA (MG)";"MG";"ITAGUARA";354;17;33;404
2009;"ITAIPE (MG)";"MG";"ITAIPE";48;3;20;71
2009;"ITAJUBA (MG)";"MG";"ITAJUBA";757;76;104;937
2009;"ITAMARANDIBA (MG)";"MG";"ITAMARANDIBA";487;21;86;594
2009;"ITAMARATI DE MINAS (MG)";"MG";"ITAMARATI DE MINAS";86;7;13;106
2009;"ITAMBACURI (MG)";"MG";"ITAMBACURI";150;15;31;196
2009;"ITAMBE DO MATO DENTRO (MG)";"MG";"ITAMBE DO MATO DENTRO";15;7;2;24
2009;"ITAMOGI (MG)";"MG";"ITAMOGI";178;14;17;209
2009;"ITAMONTE (MG)";"MG";"ITAMONTE";284;21;23;328
2009;"ITANHANDU (MG)";"MG";"ITANHANDU";300;19;18;337
2009;"ITANHOMI (MG)";"MG";"ITANHOMI";83;14;17;114
2009;"ITAOBIM (MG)";"MG";"ITAOBIM";182;20;29;231
2009;"ITAPAGIPE (MG)";"MG";"ITAPAGIPE";166;16;24;206
2009;"ITAPECERICA (MG)";"MG";"ITAPECERICA";307;27;59;393
2009;"ITAPEVA (MG)";"MG";"ITAPEVA";215;15;8;238
2009;"ITATIAIUCU (MG)";"MG";"ITATIAIUCU";262;4;33;299
2009;"ITAU DE MINAS (MG)";"MG";"ITAU DE MINAS";233;34;35;302
2009;"ITAUNA (MG)";"MG";"ITAUNA";1267;182;225;1674
2009;"ITAVERAVA (MG)";"MG";"ITAVERAVA";39;4;10;53
2009;"ITINGA (MG)";"MG";"ITINGA";44;9;20;73
2009;"ITUETA (MG)";"MG";"ITUETA";40;5;12;57
2009;"ITUIUTABA (MG)";"MG";"ITUIUTABA";1074;150;261;1485
2009;"ITUMIRIM (MG)";"MG";"ITUMIRIM";52;14;4;70
2009;"ITURAMA (MG)";"MG";"ITURAMA";642;61;273;976
2009;"ITUTINGA (MG)";"MG";"ITUTINGA";56;18;1;75
2009;"JABOTICATUBAS (MG)";"MG";"JABOTICATUBAS";175;7;46;228
2009;"JACINTO (MG)";"MG";"JACINTO";18;5;14;37
2009;"JACUI (MG)";"MG";"JACUI";109;13;19;141
2009;"JACUTINGA (MG)";"MG";"JACUTINGA";304;46;52;402
2009;"JAGUARACU (MG)";"MG";"JAGUARACU";38;3;3;44
2009;"JAIBA (MG)";"MG";"JAIBA";264;11;71;346
2009;"JAMPRUCA (MG)";"MG";"JAMPRUCA";13;4;15;32
2009;"JANAUBA (MG)";"MG";"JANAUBA";665;14;92;771
2009;"JANUARIA (MG)";"MG";"JANUARIA";287;12;68;367
2009;"JAPARAIBA (MG)";"MG";"JAPARAIBA";66;3;18;87
2009;"JAPONVAR (MG)";"MG";"JAPONVAR";6;3;9;18
2009;"JECEABA (MG)";"MG";"JECEABA";66;20;10;96
2009;"JENIPAPO DE MINAS (MG)";"MG";"JENIPAPO DE MINAS";16;10;11;37
2009;"JEQUERI (MG)";"MG";"JEQUERI";68;7;27;102
2009;"JEQUITAI (MG)";"MG";"JEQUITAI";49;3;12;64
2009;"JEQUITIBA (MG)";"MG";"JEQUITIBA";57;5;21;83
2009;"JEQUITINHONHA (MG)";"MG";"JEQUITINHONHA";76;21;19;116
2009;"JESUANIA (MG)";"MG";"JESUANIA";56;12;8;76
2009;"JOAIMA (MG)";"MG";"JOAIMA";52;7;20;79
2009;"JOANESIA (MG)";"MG";"JOANESIA";13;3;10;26
2009;"JOAO MONLEVADE (MG)";"MG";"JOAO MONLEVADE";1004;98;210;1312
2009;"JOAO PINHEIRO (MG)";"MG";"JOAO PINHEIRO";766;28;185;979
2009;"JOAQUIM FELICIO (MG)";"MG";"JOAQUIM FELICIO";24;0;9;33
2009;"JORDANIA (MG)";"MG";"JORDANIA";18;8;16;42
2009;"JOSE GONCALVES DE MINAS (MG)";"MG";"JOSE GONCALVES DE MINAS";23;8;9;40
2009;"JOSE RAYDAN (MG)";"MG";"JOSE RAYDAN";16;2;10;28
2009;"JOSENOPOLIS (MG)";"MG";"JOSENOPOLIS";17;3;5;25
2009;"JUATUBA (MG)";"MG";"JUATUBA";282;31;129;442
2009;"JUIZ DE FORA (MG)";"MG";"JUIZ DE FORA";4671;548;1329;6548
2009;"JURAMENTO (MG)";"MG";"JURAMENTO";14;2;11;27
2009;"JURUAIA (MG)";"MG";"JURUAIA";61;13;15;89
2009;"JUVENILIA (MG)";"MG";"JUVENILIA";8;5;5;18
2009;"LADAINHA (MG)";"MG";"LADAINHA";45;11;21;77
2009;"LAGAMAR (MG)";"MG";"LAGAMAR";71;20;19;110
2009;"LAGOA DA PRATA (MG)";"MG";"LAGOA DA PRATA";725;47;149;921
2009;"LAGOA DOS PATOS (MG)";"MG";"LAGOA DOS PATOS";28;2;7;37
2009;"LAGOA DOURADA (MG)";"MG";"LAGOA DOURADA";325;8;41;374
2009;"LAGOA FORMOSA (MG)";"MG";"LAGOA FORMOSA";255;19;60;334
2009;"LAGOA GRANDE (MG)";"MG";"LAGOA GRANDE";89;5;39;133
2009;"LAGOA SANTA (MG)";"MG";"LAGOA SANTA";567;84;104;755
2009;"LAJINHA (MG)";"MG";"LAJINHA";201;19;36;256
2009;"LAMBARI (MG)";"MG";"LAMBARI";252;32;18;302
2009;"LAMIM (MG)";"MG";"LAMIM";39;3;5;47
2009;"LARANJAL (MG)";"MG";"LARANJAL";141;10;1;152
2009;"LASSANCE (MG)";"MG";"LASSANCE";33;5;4;42
2009;"LAVRAS (MG)";"MG";"LAVRAS";1032;132;212;1376
2009;"LEANDRO FERREIRA (MG)";"MG";"LEANDRO FERREIRA";25;6;3;34
2009;"LEME DO PRADO (MG)";"MG";"LEME DO PRADO";23;5;18;46
2009;"LEOPOLDINA (MG)";"MG";"LEOPOLDINA";598;48;66;712
2009;"LIBERDADE (MG)";"MG";"LIBERDADE";62;8;7;77
2009;"LIMA DUARTE (MG)";"MG";"LIMA DUARTE";153;26;37;216
2009;"LIMEIRA DO OESTE (MG)";"MG";"LIMEIRA DO OESTE";96;14;42;152
2009;"LONTRA (MG)";"MG";"LONTRA";10;3;6;19
2009;"LUISBURGO (MG)";"MG";"LUISBURGO";23;6;20;49
2009;"LUISLANDIA (MG)";"MG";"LUISLANDIA";6;4;5;15
2009;"LUMINARIAS (MG)";"MG";"LUMINARIAS";81;4;33;118
2009;"LUZ (MG)";"MG";"LUZ";264;50;27;341
2009;"MACHACALIS (MG)";"MG";"MACHACALIS";23;3;5;31
2009;"MACHADO (MG)";"MG";"MACHADO";630;78;96;804
2009;"MADRE DE DEUS DE MINAS (MG)";"MG";"MADRE DE DEUS DE MINAS";74;4;3;81
2009;"MALACACHETA (MG)";"MG";"MALACACHETA";92;10;33;135
2009;"MAMONAS (MG)";"MG";"MAMONAS";87;5;16;108
2009;"MANGA (MG)";"MG";"MANGA";101;7;40;148
2009;"MANHUACU (MG)";"MG";"MANHUACU";1251;75;132;1458
2009;"MANHUMIRIM (MG)";"MG";"MANHUMIRIM";253;25;38;316
2009;"MANTENA (MG)";"MG";"MANTENA";540;36;87;663
2009;"MAR DE ESPANHA (MG)";"MG";"MAR DE ESPANHA";122;18;11;151
2009;"MARAVILHAS (MG)";"MG";"MARAVILHAS";150;15;6;171
2009;"MARIA DA FE (MG)";"MG";"MARIA DA FE";225;11;26;262
2009;"MARIANA (MG)";"MG";"MARIANA";519;120;225;864
2009;"MARILAC (MG)";"MG";"MARILAC";18;5;6;29
2009;"MARIO CAMPOS (MG)";"MG";"MARIO CAMPOS";158;12;12;182
2009;"MARIPA DE MINAS (MG)";"MG";"MARIPA DE MINAS";36;5;3;44
2009;"MARLIERIA (MG)";"MG";"MARLIERIA";35;4;7;46
2009;"MARMELOPOLIS (MG)";"MG";"MARMELOPOLIS";35;8;5;48
2009;"MARTINHO CAMPOS (MG)";"MG";"MARTINHO CAMPOS";313;29;58;400
2009;"MARTINS SOARES (MG)";"MG";"MARTINS SOARES";62;3;11;76
2009;"MATA VERDE (MG)";"MG";"MATA VERDE";13;8;2;23
2009;"MATERLANDIA (MG)";"MG";"MATERLANDIA";10;4;5;19
2009;"MATEUS LEME (MG)";"MG";"MATEUS LEME";546;62;76;684
2009;"MATHIAS LOBATO (MG)";"MG";"MATHIAS LOBATO";34;3;4;41
2009;"MATIAS BARBOSA (MG)";"MG";"MATIAS BARBOSA";438;22;35;495
2009;"MATIAS CARDOSO (MG)";"MG";"MATIAS CARDOSO";15;3;13;31
2009;"MATIPO (MG)";"MG";"MATIPO";240;22;34;296
2009;"MATO VERDE (MG)";"MG";"MATO VERDE";117;5;26;148
2009;"MATOZINHOS (MG)";"MG";"MATOZINHOS";290;58;116;464
2009;"MATUTINA (MG)";"MG";"MATUTINA";62;8;4;74
2009;"MEDEIROS (MG)";"MG";"MEDEIROS";39;15;2;56
2009;"MEDINA (MG)";"MG";"MEDINA";113;35;31;179
2009;"MENDES PIMENTEL (MG)";"MG";"MENDES PIMENTEL";37;6;11;54
2009;"MERCES (MG)";"MG";"MERCES";141;10;10;161
2009;"MESQUITA (MG)";"MG";"MESQUITA";20;7;3;30
2009;"MINAS NOVAS (MG)";"MG";"MINAS NOVAS";99;20;78;197
2009;"MINDURI (MG)";"MG";"MINDURI";56;9;3;68
2009;"MIRABELA (MG)";"MG";"MIRABELA";71;8;24;103
2009;"MIRADOURO (MG)";"MG";"MIRADOURO";91;7;23;121
2009;"MIRAI (MG)";"MG";"MIRAI";119;10;19;148
2009;"MIRAVANIA (MG)";"MG";"MIRAVANIA";7;3;6;16
2009;"MOEDA (MG)";"MG";"MOEDA";87;3;14;104
2009;"MOEMA (MG)";"MG";"MOEMA";140;10;108;258
2009;"MONJOLOS (MG)";"MG";"MONJOLOS";6;3;6;15
2009;"MONSENHOR PAULO (MG)";"MG";"MONSENHOR PAULO";140;11;8;159
2009;"MONTALVANIA (MG)";"MG";"MONTALVANIA";89;6;36;131
2009;"MONTE ALEGRE DE MINAS (MG)";"MG";"MONTE ALEGRE DE MINAS";436;29;40;505
2009;"MONTE AZUL (MG)";"MG";"MONTE AZUL";168;13;46;227
2009;"MONTE BELO (MG)";"MG";"MONTE BELO";223;19;39;281
2009;"MONTE CARMELO (MG)";"MG";"MONTE CARMELO";1157;74;126;1357
2009;"MONTE FORMOSO (MG)";"MG";"MONTE FORMOSO";8;4;18;30
2009;"MONTE SANTO DE MINAS (MG)";"MG";"MONTE SANTO DE MINAS";381;28;84;493
2009;"MONTE SIAO (MG)";"MG";"MONTE SIAO";198;33;34;265
2009;"MONTES CLAROS (MG)";"MG";"MONTES CLAROS";3769;204;917;4890
2009;"MONTEZUMA (MG)";"MG";"MONTEZUMA";18;7;10;35
2009;"MORADA NOVA DE MINAS (MG)";"MG";"MORADA NOVA DE MINAS";86;21;16;123
2009;"MORRO DA GARCA (MG)";"MG";"MORRO DA GARCA";41;4;16;61
2009;"MORRO DO PILAR (MG)";"MG";"MORRO DO PILAR";20;7;0;27
2009;"MUNHOZ (MG)";"MG";"MUNHOZ";108;12;9;129
2009;"MURIAE (MG)";"MG";"MURIAE";1225;87;160;1472
2009;"MUTUM (MG)";"MG";"MUTUM";149;19;39;207
2009;"MUZAMBINHO (MG)";"MG";"MUZAMBINHO";325;55;43;423
2009;"NACIP RAYDAN (MG)";"MG";"NACIP RAYDAN";9;0;4;13
2009;"NANUQUE (MG)";"MG";"NANUQUE";562;46;161;769
2009;"NAQUE (MG)";"MG";"NAQUE";29;3;18;50
2009;"NATALANDIA (MG)";"MG";"NATALANDIA";18;2;14;34
2009;"NATERCIA (MG)";"MG";"NATERCIA";68;10;16;94
2009;"NAZARENO (MG)";"MG";"NAZARENO";147;11;25;183
2009;"NEPOMUCENO (MG)";"MG";"NEPOMUCENO";372;20;57;449
2009;"NINHEIRA (MG)";"MG";"NINHEIRA";21;3;18;42
2009;"NOVA BELEM (MG)";"MG";"NOVA BELEM";36;3;9;48
2009;"NOVA ERA (MG)";"MG";"NOVA ERA";168;18;61;247
2009;"NOVA LIMA (MG)";"MG";"NOVA LIMA";932;263;149;1344
2009;"NOVA MODICA (MG)";"MG";"NOVA MODICA";14;1;12;27
2009;"NOVA PONTE (MG)";"MG";"NOVA PONTE";189;46;61;296
2009;"NOVA PORTEIRINHA (MG)";"MG";"NOVA PORTEIRINHA";16;2;10;28
2009;"NOVA RESENDE (MG)";"MG";"NOVA RESENDE";290;20;40;350
2009;"NOVA SERRANA (MG)";"MG";"NOVA SERRANA";380;43;59;482
2009;"NOVA UNIAO (MG)";"MG";"NOVA UNIAO";115;11;16;142
2009;"NOVO CRUZEIRO (MG)";"MG";"NOVO CRUZEIRO";120;23;75;218
2009;"NOVO ORIENTE DE MINAS (MG)";"MG";"NOVO ORIENTE DE MINAS";26;12;11;49
2009;"NOVORIZONTE (MG)";"MG";"NOVORIZONTE";38;2;7;47
2009;"OLARIA (MG)";"MG";"OLARIA";13;5;4;22
2009;"OLHOS D AGUA (MG)";"MG";"OLHOS D AGUA";46;9;26;81
2009;"OLIMPIO NORONHA (MG)";"MG";"OLIMPIO NORONHA";21;12;6;39
2009;"OLIVEIRA (MG)";"MG";"OLIVEIRA";680;60;107;847
2009;"OLIVEIRA FORTES (MG)";"MG";"OLIVEIRA FORTES";20;4;2;26
2009;"ONCA DE PITANGUI (MG)";"MG";"ONCA DE PITANGUI";23;5;8;36
2009;"ORATORIOS (MG)";"MG";"ORATORIOS";57;2;14;73
2009;"ORIZANIA (MG)";"MG";"ORIZANIA";45;6;7;58
2009;"OURO BRANCO (MG)";"MG";"OURO BRANCO";430;88;208;726
2009;"OURO FINO (MG)";"MG";"OURO FINO";440;49;69;558
2009;"OURO PRETO (MG)";"MG";"OURO PRETO";885;186;256;1327
2009;"OURO VERDE DE MINAS (MG)";"MG";"OURO VERDE DE MINAS";17;3;5;25
2009;"PADRE CARVALHO (MG)";"MG";"PADRE CARVALHO";14;3;15;32
2009;"PADRE PARAISO (MG)";"MG";"PADRE PARAISO";105;59;46;210
2009;"PAI PEDRO (MG)";"MG";"PAI PEDRO";13;4;15;32
2009;"PAINEIRAS (MG)";"MG";"PAINEIRAS";69;11;8;88
2009;"PAINS (MG)";"MG";"PAINS";202;15;21;238
2009;"PAIVA (MG)";"MG";"PAIVA";10;3;1;14
2009;"PALMA (MG)";"MG";"PALMA";72;7;5;84
2009;"PALMOPOLIS (MG)";"MG";"PALMOPOLIS";14;4;7;25
2009;"PAPAGAIOS (MG)";"MG";"PAPAGAIOS";501;6;51;558
2009;"PARA DE MINAS (MG)";"MG";"PARA DE MINAS";1884;127;182;2193
2009;"PARACATU (MG)";"MG";"PARACATU";1211;67;294;1572
2009;"PARAGUACU (MG)";"MG";"PARAGUACU";277;38;29;344
2009;"PARAISOPOLIS (MG)";"MG";"PARAISOPOLIS";375;39;27;441
2009;"PARAOPEBA (MG)";"MG";"PARAOPEBA";391;19;48;458
2009;"PASSA QUATRO (MG)";"MG";"PASSA QUATRO";315;21;27;363
2009;"PASSA TEMPO (MG)";"MG";"PASSA TEMPO";158;23;13;194
2009;"PASSA VINTE (MG)";"MG";"PASSA VINTE";50;15;6;71
2009;"PASSABEM (MG)";"MG";"PASSABEM";10;4;2;16
2009;"PASSOS (MG)";"MG";"PASSOS";1743;115;363;2221
2009;"PATIS (MG)";"MG";"PATIS";8;2;6;16
2009;"PATOS DE MINAS (MG)";"MG";"PATOS DE MINAS";2539;113;366;3018
2009;"PATROCINIO (MG)";"MG";"PATROCINIO";1437;94;480;2011
2009;"PATROCINIO DO MURIAE (MG)";"MG";"PATROCINIO DO MURIAE";62;4;5;71
2009;"PAULA CANDIDO (MG)";"MG";"PAULA CANDIDO";56;8;10;74
2009;"PAULISTAS (MG)";"MG";"PAULISTAS";10;2;7;19
2009;"PAVAO (MG)";"MG";"PAVAO";41;12;7;60
2009;"PECANHA (MG)";"MG";"PECANHA";118;8;52;178
2009;"PEDRA AZUL (MG)";"MG";"PEDRA AZUL";124;17;46;187
2009;"PEDRA BONITA (MG)";"MG";"PEDRA BONITA";36;10;15;61
2009;"PEDRA DO ANTA (MG)";"MG";"PEDRA DO ANTA";26;2;12;40
2009;"PEDRA DO INDAIA (MG)";"MG";"PEDRA DO INDAIA";58;6;2;66
2009;"PEDRA DOURADA (MG)";"MG";"PEDRA DOURADA";10;3;7;20
2009;"PEDRALVA (MG)";"MG";"PEDRALVA";118;17;16;151
2009;"PEDRAS DE MARIA DA CRUZ (MG)";"MG";"PEDRAS DE MARIA DA CRUZ";16;5;23;44
2009;"PEDRINOPOLIS (MG)";"MG";"PEDRINOPOLIS";55;16;7;78
2009;"PEDRO LEOPOLDO (MG)";"MG";"PEDRO LEOPOLDO";887;119;195;1201
2009;"PEDRO TEIXEIRA (MG)";"MG";"PEDRO TEIXEIRA";14;4;1;19
2009;"PEQUERI (MG)";"MG";"PEQUERI";68;8;3;79
2009;"PEQUI (MG)";"MG";"PEQUI";43;13;4;60
2009;"PERDIGAO (MG)";"MG";"PERDIGAO";141;11;7;159
2009;"PERDIZES (MG)";"MG";"PERDIZES";236;50;29;315
2009;"PERDOES (MG)";"MG";"PERDOES";465;30;55;550
2009;"PERIQUITO (MG)";"MG";"PERIQUITO";33;6;18;57
2009;"PESCADOR (MG)";"MG";"PESCADOR";13;8;3;24
2009;"PIAU (MG)";"MG";"PIAU";36;8;7;51
2009;"PIEDADE DE CARATINGA (MG)";"MG";"PIEDADE DE CARATINGA";106;7;10;123
2009;"PIEDADE DE PONTE NOVA (MG)";"MG";"PIEDADE DE PONTE NOVA";34;3;14;51
2009;"PIEDADE DO RIO GRANDE (MG)";"MG";"PIEDADE DO RIO GRANDE";44;4;8;56
2009;"PIEDADE DOS GERAIS (MG)";"MG";"PIEDADE DOS GERAIS";60;2;13;75
2009;"PIMENTA (MG)";"MG";"PIMENTA";175;6;25;206
2009;"PINGO D AGUA (MG)";"MG";"PINGO D AGUA";14;3;6;23
2009;"PINTOPOLIS (MG)";"MG";"PINTOPOLIS";9;2;1;12
2009;"PIRACEMA (MG)";"MG";"PIRACEMA";77;11;11;99
2009;"PIRAJUBA (MG)";"MG";"PIRAJUBA";119;18;10;147
2009;"PIRANGA (MG)";"MG";"PIRANGA";119;20;38;177
2009;"PIRANGUCU (MG)";"MG";"PIRANGUCU";30;20;29;79
2009;"PIRANGUINHO (MG)";"MG";"PIRANGUINHO";138;11;7;156
2009;"PIRAPETINGA (MG)";"MG";"PIRAPETINGA";312;20;25;357
2009;"PIRAPORA (MG)";"MG";"PIRAPORA";470;24;122;616
2009;"PIRAUBA (MG)";"MG";"PIRAUBA";110;19;10;139
2009;"PITANGUI (MG)";"MG";"PITANGUI";502;42;67;611
2009;"PIUI (MG)";"MG";"PIUI";600;50;58;708
2009;"PLANURA (MG)";"MG";"PLANURA";142;13;46;201
2009;"POCO FUNDO (MG)";"MG";"POCO FUNDO";212;41;15;268
2009;"POCOS DE CALDAS (MG)";"MG";"POCOS DE CALDAS";2550;435;392;3377
2009;"POCRANE (MG)";"MG";"POCRANE";74;7;7;88
2009;"POMPEU (MG)";"MG";"POMPEU";399;26;99;524
2009;"PONTE NOVA (MG)";"MG";"PONTE NOVA";882;44;129;1055
2009;"PONTO CHIQUE (MG)";"MG";"PONTO CHIQUE";7;1;10;18
2009;"PONTO DOS VOLANTES (MG)";"MG";"PONTO DOS VOLANTES";21;4;26;51
2009;"PORTEIRINHA (MG)";"MG";"PORTEIRINHA";271;11;150;432
2009;"PORTO FIRME (MG)";"MG";"PORTO FIRME";55;5;11;71
2009;"POTE (MG)";"MG";"POTE";57;11;21;89
2009;"POUSO ALEGRE (MG)";"MG";"POUSO ALEGRE";2094;204;484;2782
2009;"POUSO ALTO (MG)";"MG";"POUSO ALTO";107;14;6;127
2009;"PRADOS (MG)";"MG";"PRADOS";75;8;8;91
2009;"PRATA (MG)";"MG";"PRATA";368;83;73;524
2009;"PRATAPOLIS (MG)";"MG";"PRATAPOLIS";156;25;17;198
2009;"PRATINHA (MG)";"MG";"PRATINHA";39;8;3;50
2009;"PRESIDENTE BERNARDES (MG)";"MG";"PRESIDENTE BERNARDES";16;7;7;30
2009;"PRESIDENTE JUSCELINO (MG)";"MG";"PRESIDENTE JUSCELINO";38;3;12;53
2009;"PRESIDENTE KUBITSCHEK (MG)";"MG";"PRESIDENTE KUBITSCHEK";17;10;7;34
2009;"PRESIDENTE OLEGARIO (MG)";"MG";"PRESIDENTE OLEGARIO";193;15;78;286
2009;"PRUDENTE DE MORAIS (MG)";"MG";"PRUDENTE DE MORAIS";86;9;12;107
2009;"QUARTEL GERAL (MG)";"MG";"QUARTEL GERAL";39;8;2;49
2009;"QUELUZITA (MG)";"MG";"QUELUZITA";19;6;3;28
2009;"RAPOSOS (MG)";"MG";"RAPOSOS";59;33;25;117
2009;"RAUL SOARES (MG)";"MG";"RAUL SOARES";183;26;39;248
2009;"RECREIO (MG)";"MG";"RECREIO";133;14;20;167
2009;"REDUTO (MG)";"MG";"REDUTO";41;4;5;50
2009;"RESENDE COSTA (MG)";"MG";"RESENDE COSTA";148;12;11;171
2009;"RESPLENDOR (MG)";"MG";"RESPLENDOR";183;28;33;244
2009;"RESSAQUINHA (MG)";"MG";"RESSAQUINHA";118;4;12;134
2009;"RIACHINHO (MG)";"MG";"RIACHINHO";61;5;18;84
2009;"RIACHO DOS MACHADOS (MG)";"MG";"RIACHO DOS MACHADOS";48;2;30;80
2009;"RIBEIRAO DAS NEVES (MG)";"MG";"RIBEIRAO DAS NEVES";1944;334;591;2869
2009;"RIBEIRAO VERMELHO (MG)";"MG";"RIBEIRAO VERMELHO";26;6;4;36
2009;"RIO ACIMA (MG)";"MG";"RIO ACIMA";102;13;14;129
2009;"RIO CASCA (MG)";"MG";"RIO CASCA";206;11;42;259
2009;"RIO DO PRADO (MG)";"MG";"RIO DO PRADO";9;7;6;22
2009;"RIO DOCE (MG)";"MG";"RIO DOCE";18;7;7;32
2009;"RIO ESPERA (MG)";"MG";"RIO ESPERA";28;0;5;33
2009;"RIO MANSO (MG)";"MG";"RIO MANSO";100;3;10;113
2009;"RIO NOVO (MG)";"MG";"RIO NOVO";102;13;20;135
2009;"RIO PARANAIBA (MG)";"MG";"RIO PARANAIBA";149;8;49;206
2009;"RIO PARDO DE MINAS (MG)";"MG";"RIO PARDO DE MINAS";154;9;90;253
2009;"RIO PIRACICABA (MG)";"MG";"RIO PIRACICABA";169;21;28;218
2009;"RIO POMBA (MG)";"MG";"RIO POMBA";213;20;25;258
2009;"RIO PRETO (MG)";"MG";"RIO PRETO";706;118;80;904
2009;"RIO VERMELHO (MG)";"MG";"RIO VERMELHO";57;16;34;107
2009;"RITAPOLIS (MG)";"MG";"RITAPOLIS";24;6;6;36
2009;"ROCHEDO DE MINAS (MG)";"MG";"ROCHEDO DE MINAS";18;5;2;25
2009;"RODEIRO (MG)";"MG";"RODEIRO";206;6;14;226
2009;"ROMARIA (MG)";"MG";"ROMARIA";44;17;7;68
2009;"ROSARIO DA LIMEIRA (MG)";"MG";"ROSARIO DA LIMEIRA";64;7;31;102
2009;"RUBELITA (MG)";"MG";"RUBELITA";8;3;8;19
2009;"RUBIM (MG)";"MG";"RUBIM";18;1;25;44
2009;"SABARA (MG)";"MG";"SABARA";525;193;296;1014
2009;"SABINOPOLIS (MG)";"MG";"SABINOPOLIS";109;18;30;157
2009;"SACRAMENTO (MG)";"MG";"SACRAMENTO";425;65;51;541
2009;"SALINAS (MG)";"MG";"SALINAS";322;39;109;470
2009;"SALTO DA DIVISA (MG)";"MG";"SALTO DA DIVISA";6;3;6;15
2009;"SANTA BARBARA (MG)";"MG";"SANTA BARBARA";352;51;109;512
2009;"SANTA BARBARA DO LESTE (MG)";"MG";"SANTA BARBARA DO LESTE";150;6;5;161
2009;"SANTA BARBARA DO MONTE VERDE (MG)";"MG";"SANTA BARBARA DO MONTE VERDE";1359;113;194;1666
2009;"SANTA BARBARA DO TUGURIO (MG)";"MG";"SANTA BARBARA DO TUGURIO";53;11;10;74
2009;"SANTA CRUZ DE MINAS (MG)";"MG";"SANTA CRUZ DE MINAS";56;4;3;63
2009;"SANTA CRUZ DE SALINAS (MG)";"MG";"SANTA CRUZ DE SALINAS";9;2;16;27
2009;"SANTA CRUZ DO ESCALVADO (MG)";"MG";"SANTA CRUZ DO ESCALVADO";28;3;7;38
2009;"SANTA EFIGENIA DE MINAS (MG)";"MG";"SANTA EFIGENIA DE MINAS";18;5;3;26
2009;"SANTA FE DE MINAS (MG)";"MG";"SANTA FE DE MINAS";7;2;3;12
2009;"SANTA HELENA DE MINAS (MG)";"MG";"SANTA HELENA DE MINAS";11;4;5;20
2009;"SANTA JULIANA (MG)";"MG";"SANTA JULIANA";278;27;41;346
2009;"SANTA LUZIA (MG)";"MG";"SANTA LUZIA";1457;168;545;2170
2009;"SANTA MARGARIDA (MG)";"MG";"SANTA MARGARIDA";187;19;21;227
2009;"SANTA MARIA DE ITABIRA (MG)";"MG";"SANTA MARIA DE ITABIRA";90;11;28;129
2009;"SANTA MARIA DO SALTO (MG)";"MG";"SANTA MARIA DO SALTO";5;4;5;14
2009;"SANTA MARIA DO SUACUI (MG)";"MG";"SANTA MARIA DO SUACUI";71;4;31;106
2009;"SANTA RITA DE CALDAS (MG)";"MG";"SANTA RITA DE CALDAS";240;19;12;271
2009;"SANTA RITA DE JACUTINGA (MG)";"MG";"SANTA RITA DE JACUTINGA";52;7;6;65
2009;"SANTA RITA DE MINAS (MG)";"MG";"SANTA RITA DE MINAS";98;9;9;116
2009;"SANTA RITA DO IBITIPOCA (MG)";"MG";"SANTA RITA DO IBITIPOCA";36;4;1;41
2009;"SANTA RITA DO ITUETO (MG)";"MG";"SANTA RITA DO ITUETO";65;6;11;82
2009;"SANTA RITA DO SAPUCAI (MG)";"MG";"SANTA RITA DO SAPUCAI";343;50;62;455
2009;"SANTA ROSA DA SERRA (MG)";"MG";"SANTA ROSA DA SERRA";33;5;7;45
2009;"SANTA VITORIA (MG)";"MG";"SANTA VITORIA";304;17;52;373
2009;"SANTANA DA VARGEM (MG)";"MG";"SANTANA DA VARGEM";65;11;17;93
2009;"SANTANA DE CATAGUASES (MG)";"MG";"SANTANA DE CATAGUASES";32;11;6;49
2009;"SANTANA DE PIRAPAMA (MG)";"MG";"SANTANA DE PIRAPAMA";59;2;20;81
2009;"SANTANA DO DESERTO (MG)";"MG";"SANTANA DO DESERTO";50;5;6;61
2009;"SANTANA DO GARAMBEU (MG)";"MG";"SANTANA DO GARAMBEU";11;3;3;17
2009;"SANTANA DO JACARE (MG)";"MG";"SANTANA DO JACARE";30;7;9;46
2009;"SANTANA DO MANHUACU (MG)";"MG";"SANTANA DO MANHUACU";123;4;15;142
2009;"SANTANA DO PARAISO (MG)";"MG";"SANTANA DO PARAISO";109;12;35;156
2009;"SANTANA DO RIACHO (MG)";"MG";"SANTANA DO RIACHO";19;6;9;34
2009;"SANTANA DOS MONTES (MG)";"MG";"SANTANA DOS MONTES";23;7;4;34
2009;"SANTO ANTONIO DO AMPARO (MG)";"MG";"SANTO ANTONIO DO AMPARO";215;22;44;281
2009;"SANTO ANTONIO DO AVENTUREIRO (MG)";"MG";"SANTO ANTONIO DO AVENTUREIRO";50;4;6;60
2009;"SANTO ANTONIO DO GRAMA (MG)";"MG";"SANTO ANTONIO DO GRAMA";45;2;8;55
2009;"SANTO ANTONIO DO ITAMBE (MG)";"MG";"SANTO ANTONIO DO ITAMBE";9;5;7;21
2009;"SANTO ANTONIO DO JACINTO (MG)";"MG";"SANTO ANTONIO DO JACINTO";27;3;27;57
2009;"SANTO ANTONIO DO MONTE (MG)";"MG";"SANTO ANTONIO DO MONTE";417;37;89;543
2009;"SANTO ANTONIO DO RETIRO (MG)";"MG";"SANTO ANTONIO DO RETIRO";21;3;17;41
2009;"SANTO ANTONIO DO RIO ABAIXO (MG)";"MG";"SANTO ANTONIO DO RIO ABAIXO";10;7;3;20
2009;"SANTO HIPOLITO (MG)";"MG";"SANTO HIPOLITO";21;3;2;26
2009;"SANTOS DUMONT (MG)";"MG";"SANTOS DUMONT";360;60;106;526
2009;"SAO BENTO ABADE (MG)";"MG";"SAO BENTO ABADE";36;9;9;54
2009;"SAO BRAS DO SUACUI (MG)";"MG";"SAO BRAS DO SUACUI";36;2;6;44
2009;"SAO DOMINGOS DAS DORES (MG)";"MG";"SAO DOMINGOS DAS DORES";79;3;4;86
2009;"SAO DOMINGOS DO PRATA (MG)";"MG";"SAO DOMINGOS DO PRATA";195;10;50;255
2009;"SAO FELIX DE MINAS (MG)";"MG";"SAO FELIX DE MINAS";13;3;5;21
2009;"SAO FRANCISCO (MG)";"MG";"SAO FRANCISCO";208;11;75;294
2009;"SAO FRANCISCO DE PAULA (MG)";"MG";"SAO FRANCISCO DE PAULA";70;14;21;105
2009;"SAO FRANCISCO DE SALES (MG)";"MG";"SAO FRANCISCO DE SALES";62;7;20;89
2009;"SAO FRANCISCO DO GLORIA (MG)";"MG";"SAO FRANCISCO DO GLORIA";53;9;3;65
2009;"SAO GERALDO (MG)";"MG";"SAO GERALDO";116;10;7;133
2009;"SAO GERALDO DA PIEDADE (MG)";"MG";"SAO GERALDO DA PIEDADE";13;3;6;22
2009;"SAO GERALDO DO BAIXIO (MG)";"MG";"SAO GERALDO DO BAIXIO";16;6;5;27
2009;"SAO GONCALO DO ABAETE (MG)";"MG";"SAO GONCALO DO ABAETE";74;12;12;98
2009;"SAO GONCALO DO PARA (MG)";"MG";"SAO GONCALO DO PARA";163;7;11;181
2009;"SAO GONCALO DO RIO ABAIXO (MG)";"MG";"SAO GONCALO DO RIO ABAIXO";121;23;17;161
2009;"SAO GONCALO DO RIO PRETO (MG)";"MG";"SAO GONCALO DO RIO PRETO";23;8;7;38
2009;"SAO GONCALO DO SAPUCAI (MG)";"MG";"SAO GONCALO DO SAPUCAI";399;28;57;484
2009;"SAO GOTARDO (MG)";"MG";"SAO GOTARDO";718;65;163;946
2009;"SAO JOAO BATISTA DO GLORIA (MG)";"MG";"SAO JOAO BATISTA DO GLORIA";96;7;12;115
2009;"SAO JOAO DA LAGOA (MG)";"MG";"SAO JOAO DA LAGOA";27;6;11;44
2009;"SAO JOAO DA MATA (MG)";"MG";"SAO JOAO DA MATA";36;11;0;47
2009;"SAO JOAO DA PONTE (MG)";"MG";"SAO JOAO DA PONTE";44;8;35;87
2009;"SAO JOAO DAS MISSOES (MG)";"MG";"SAO JOAO DAS MISSOES";13;3;11;27
2009;"SAO JOAO DEL REI (MG)";"MG";"SAO JOAO DEL REI";1001;112;192;1305
2009;"SAO JOAO DO MANHUACU (MG)";"MG";"SAO JOAO DO MANHUACU";109;8;16;133
2009;"SAO JOAO DO MANTENINHA (MG)";"MG";"SAO JOAO DO MANTENINHA";74;5;4;83
2009;"SAO JOAO DO ORIENTE (MG)";"MG";"SAO JOAO DO ORIENTE";87;7;4;98
2009;"SAO JOAO DO PACUI (MG)";"MG";"SAO JOAO DO PACUI";6;0;2;8
2009;"SAO JOAO DO PARAISO (MG)";"MG";"SAO JOAO DO PARAISO";132;7;66;205
2009;"SAO JOAO EVANGELISTA (MG)";"MG";"SAO JOAO EVANGELISTA";96;4;32;132
2009;"SAO JOAO NEPOMUCENO (MG)";"MG";"SAO JOAO NEPOMUCENO";237;25;30;292
2009;"SAO JOAQUIM DE BICAS (MG)";"MG";"SAO JOAQUIM DE BICAS";497;63;50;610
2009;"SAO JOSE DA BARRA (MG)";"MG";"SAO JOSE DA BARRA";87;11;26;124
2009;"SAO JOSE DA LAPA (MG)";"MG";"SAO JOSE DA LAPA";240;34;30;304
2009;"SAO JOSE DA SAFIRA (MG)";"MG";"SAO JOSE DA SAFIRA";5;1;1;7
2009;"SAO JOSE DA VARGINHA (MG)";"MG";"SAO JOSE DA VARGINHA";36;4;11;51
2009;"SAO JOSE DO ALEGRE (MG)";"MG";"SAO JOSE DO ALEGRE";43;7;4;54
2009;"SAO JOSE DO DIVINO (MG)";"MG";"SAO JOSE DO DIVINO";15;3;7;25
2009;"SAO JOSE DO GOIABAL (MG)";"MG";"SAO JOSE DO GOIABAL";42;12;34;88
2009;"SAO JOSE DO JACURI (MG)";"MG";"SAO JOSE DO JACURI";12;3;6;21
2009;"SAO JOSE DO MANTIMENTO (MG)";"MG";"SAO JOSE DO MANTIMENTO";23;2;5;30
2009;"SAO LOURENCO (MG)";"MG";"SAO LOURENCO";439;66;44;549
2009;"SAO MIGUEL DO ANTA (MG)";"MG";"SAO MIGUEL DO ANTA";81;5;8;94
2009;"SAO PEDRO DA UNIAO (MG)";"MG";"SAO PEDRO DA UNIAO";94;15;5;114
2009;"SAO PEDRO DO SUACUI (MG)";"MG";"SAO PEDRO DO SUACUI";21;3;7;31
2009;"SAO PEDRO DOS FERROS (MG)";"MG";"SAO PEDRO DOS FERROS";126;6;27;159
2009;"SAO ROMAO (MG)";"MG";"SAO ROMAO";17;2;12;31
2009;"SAO ROQUE DE MINAS (MG)";"MG";"SAO ROQUE DE MINAS";110;12;8;130
2009;"SAO SEBASTIAO DA BELA VISTA (MG)";"MG";"SAO SEBASTIAO DA BELA VISTA";37;4;11;52
2009;"SAO SEBASTIAO DA VARGEM ALEGRE (MG)";"MG";"SAO SEBASTIAO DA VARGEM ALEGRE";10;3;7;20
2009;"SAO SEBASTIAO DO ANTA (MG)";"MG";"SAO SEBASTIAO DO ANTA";37;1;6;44
2009;"SAO SEBASTIAO DO MARANHAO (MG)";"MG";"SAO SEBASTIAO DO MARANHAO";26;5;10;41
2009;"SAO SEBASTIAO DO OESTE (MG)";"MG";"SAO SEBASTIAO DO OESTE";104;6;11;121
2009;"SAO SEBASTIAO DO PARAISO (MG)";"MG";"SAO SEBASTIAO DO PARAISO";1317;89;176;1582
2009;"SAO SEBASTIAO DO RIO PRETO (MG)";"MG";"SAO SEBASTIAO DO RIO PRETO";10;2;4;16
2009;"SAO SEBASTIAO DO RIO VERDE (MG)";"MG";"SAO SEBASTIAO DO RIO VERDE";12;2;5;19
2009;"SAO TIAGO (MG)";"MG";"SAO TIAGO";117;10;14;141
2009;"SAO TOMAS DE AQUINO (MG)";"MG";"SAO TOMAS DE AQUINO";71;20;9;100
2009;"SAO TOME DAS LETRAS (MG)";"MG";"SAO TOME DAS LETRAS";85;8;10;103
2009;"SAO VICENTE DE MINAS (MG)";"MG";"SAO VICENTE DE MINAS";76;14;1;91
2009;"SAPUCAI MIRIM (MG)";"MG";"SAPUCAI MIRIM";175;35;10;220
2009;"SARDOA (MG)";"MG";"SARDOA";33;7;6;46
2009;"SARZEDO (MG)";"MG";"SARZEDO";327;24;36;387
2009;"SEM PEIXE (MG)";"MG";"SEM PEIXE";5;3;8;16
2009;"SENADOR AMARAL (MG)";"MG";"SENADOR AMARAL";76;13;10;99
2009;"SENADOR CORTES (MG)";"MG";"SENADOR CORTES";15;3;1;19
2009;"SENADOR FIRMINO (MG)";"MG";"SENADOR FIRMINO";75;8;15;98
2009;"SENADOR JOSE BENTO (MG)";"MG";"SENADOR JOSE BENTO";15;1;7;23
2009;"SENADOR MODESTINO GONCALVES (MG)";"MG";"SENADOR MODESTINO GONCALVES";21;7;5;33
2009;"SENHORA DE OLIVEIRA (MG)";"MG";"SENHORA DE OLIVEIRA";64;4;12;80
2009;"SENHORA DO PORTO (MG)";"MG";"SENHORA DO PORTO";25;3;9;37
2009;"SENHORA DOS REMEDIOS (MG)";"MG";"SENHORA DOS REMEDIOS";72;14;12;98
2009;"SERICITA (MG)";"MG";"SERICITA";70;2;4;76
2009;"SERITINGA (MG)";"MG";"SERITINGA";26;1;2;29
2009;"SERRA AZUL DE MINAS (MG)";"MG";"SERRA AZUL DE MINAS";12;3;8;23
2009;"SERRA DA SAUDADE (MG)";"MG";"SERRA DA SAUDADE";5;7;0;12
2009;"SERRA DO SALITRE (MG)";"MG";"SERRA DO SALITRE";196;11;61;268
2009;"SERRA DOS AIMORES (MG)";"MG";"SERRA DOS AIMORES";59;4;22;85
2009;"SERRANIA (MG)";"MG";"SERRANIA";111;13;10;134
2009;"SERRANOPOLIS DE MINAS (MG)";"MG";"SERRANOPOLIS DE MINAS";4;0;12;16
2009;"SERRANOS (MG)";"MG";"SERRANOS";14;5;1;20
2009;"SERRO (MG)";"MG";"SERRO";157;15;42;214
2009;"SETE LAGOAS (MG)";"MG";"SETE LAGOAS";2795;347;443;3585
2009;"SETUBINHA (MG)";"MG";"SETUBINHA";17;2;18;37
2009;"SILVEIRANIA (MG)";"MG";"SILVEIRANIA";10;2;4;16
2009;"SILVIANOPOLIS (MG)";"MG";"SILVIANOPOLIS";73;11;9;93
2009;"SIMAO PEREIRA (MG)";"MG";"SIMAO PEREIRA";50;5;3;58
2009;"SIMONESIA (MG)";"MG";"SIMONESIA";156;13;27;196
2009;"SOBRALIA (MG)";"MG";"SOBRALIA";29;4;6;39
2009;"SOLEDADE DE MINAS (MG)";"MG";"SOLEDADE DE MINAS";40;7;0;47
2009;"TABULEIRO (MG)";"MG";"TABULEIRO";59;6;7;72
2009;"TAIOBEIRAS (MG)";"MG";"TAIOBEIRAS";542;24;115;681
2009;"TAPARUBA (MG)";"MG";"TAPARUBA";21;2;10;33
2009;"TAPIRA (MG)";"MG";"TAPIRA";36;7;13;56
2009;"TAPIRAI (MG)";"MG";"TAPIRAI";12;1;2;15
2009;"TAQUARACU DE MINAS (MG)";"MG";"TAQUARACU DE MINAS";57;5;10;72
2009;"TARUMIRIM (MG)";"MG";"TARUMIRIM";108;11;20;139
2009;"TEIXEIRAS (MG)";"MG";"TEIXEIRAS";119;11;16;146
2009;"TEOFILO OTONI (MG)";"MG";"TEOFILO OTONI";1339;158;135;1632
2009;"TIMOTEO (MG)";"MG";"TIMOTEO";983;162;130;1275
2009;"TIRADENTES (MG)";"MG";"TIRADENTES";67;14;12;93
2009;"TIROS (MG)";"MG";"TIROS";134;16;8;158
2009;"TOCANTINS (MG)";"MG";"TOCANTINS";200;6;15;221
2009;"TOCOS DO MOJI (MG)";"MG";"TOCOS DO MOJI";43;9;8;60
2009;"TOLEDO (MG)";"MG";"TOLEDO";51;3;7;61
2009;"TOMBOS (MG)";"MG";"TOMBOS";96;14;19;129
2009;"TRES CORACOES (MG)";"MG";"TRES CORACOES";887;71;139;1097
2009;"TRES MARIAS (MG)";"MG";"TRES MARIAS";317;35;84;436
2009;"TRES PONTAS (MG)";"MG";"TRES PONTAS";740;66;138;944
2009;"TUMIRITINGA (MG)";"MG";"TUMIRITINGA";32;4;6;42
2009;"TUPACIGUARA (MG)";"MG";"TUPACIGUARA";410;62;58;530
2009;"TURMALINA (MG)";"MG";"TURMALINA";256;25;41;322
2009;"TURVOLANDIA (MG)";"MG";"TURVOLANDIA";81;16;4;101
2009;"UBA (MG)";"MG";"UBA";1645;71;113;1829
2009;"UBAI (MG)";"MG";"UBAI";21;4;15;40
2009;"UBAPORANGA (MG)";"MG";"UBAPORANGA";128;7;17;152
2009;"UBERABA (MG)";"MG";"UBERABA";3822;680;751;5253
2009;"UBERLANDIA (MG)";"MG";"UBERLANDIA";9795;873;1440;12108
2009;"UMBURATIBA (MG)";"MG";"UMBURATIBA";7;2;1;10
2009;"UNAI (MG)";"MG";"UNAI";1214;57;283;1554
2009;"UNIAO DE MINAS (MG)";"MG";"UNIAO DE MINAS";37;6;29;72
2009;"URUANA DE MINAS (MG)";"MG";"URUANA DE MINAS";17;3;9;29
2009;"URUCANIA (MG)";"MG";"URUCANIA";145;5;33;183
2009;"URUCUIA (MG)";"MG";"URUCUIA";57;4;19;80
2009;"VARGEM ALEGRE (MG)";"MG";"VARGEM ALEGRE";48;6;11;65
2009;"VARGEM BONITA (MG)";"MG";"VARGEM BONITA";20;7;3;30
2009;"VARGEM GRANDE DO RIO PARDO (MG)";"MG";"VARGEM GRANDE DO RIO PARDO";28;4;7;39
2009;"VARGINHA (MG)";"MG";"VARGINHA";1759;134;239;2132
2009;"VARJAO DE MINAS (MG)";"MG";"VARJAO DE MINAS";86;10;39;135
2009;"VARZEA DA PALMA (MG)";"MG";"VARZEA DA PALMA";399;14;69;482
2009;"VARZELANDIA (MG)";"MG";"VARZELANDIA";40;6;26;72
2009;"VAZANTE (MG)";"MG";"VAZANTE";278;29;71;378
2009;"VERDELANDIA (MG)";"MG";"VERDELANDIA";13;3;6;22
2009;"VEREDINHA (MG)";"MG";"VEREDINHA";35;5;13;53
2009;"VERISSIMO (MG)";"MG";"VERISSIMO";35;24;4;63
2009;"VERMELHO NOVO (MG)";"MG";"VERMELHO NOVO";65;6;16;87
2009;"VESPASIANO (MG)";"MG";"VESPASIANO";586;101;130;817
2009;"VICOSA (MG)";"MG";"VICOSA";589;122;160;871
2009;"VIEIRAS (MG)";"MG";"VIEIRAS";27;6;5;38
2009;"VIRGEM DA LAPA (MG)";"MG";"VIRGEM DA LAPA";52;7;17;76
2009;"VIRGINIA (MG)";"MG";"VIRGINIA";109;12;4;125
2009;"VIRGINOPOLIS (MG)";"MG";"VIRGINOPOLIS";80;6;18;104
2009;"VIRGOLANDIA (MG)";"MG";"VIRGOLANDIA";18;5;5;28
2009;"VISCONDE DO RIO BRANCO (MG)";"MG";"VISCONDE DO RIO BRANCO";818;33;62;913
2009;"VOLTA GRANDE (MG)";"MG";"VOLTA GRANDE";40;5;6;51
2009;"WENCESLAU BRAZ (MG)";"MG";"WENCESLAU BRAZ";43;5;6;54
2009;"AGUA CLARA (MS)";"MS";"AGUA CLARA";365;9;64;438
2009;"ALCINOPOLIS (MS)";"MS";"ALCINOPOLIS";73;11;14;98
2009;"AMAMBAI (MS)";"MS";"AMAMBAI";621;14;44;679
2009;"ANASTACIO (MS)";"MS";"ANASTACIO";322;11;20;353
2009;"ANAURILANDIA (MS)";"MS";"ANAURILANDIA";107;11;39;157
2009;"ANGELICA (MS)";"MS";"ANGELICA";199;5;41;245
2009;"ANTONIO JOAO (MS)";"MS";"ANTONIO JOAO";104;1;17;122
2009;"APARECIDA DO TABOADO (MS)";"MS";"APARECIDA DO TABOADO";336;29;45;410
2009;"AQUIDAUANA (MS)";"MS";"AQUIDAUANA";327;19;51;397
2009;"ARAL MOREIRA (MS)";"MS";"ARAL MOREIRA";156;11;15;182
2009;"BANDEIRANTES (MS)";"MS";"BANDEIRANTES";119;2;23;144
2009;"BATAGUASSU (MS)";"MS";"BATAGUASSU";481;21;139;641
2009;"BATAYPORA (MS)";"MS";"BATAYPORA";139;6;25;170
2009;"BELA VISTA (MS)";"MS";"BELA VISTA";199;19;34;252
2009;"BODOQUENA (MS)";"MS";"BODOQUENA";79;13;29;121
2009;"BONITO (MS)";"MS";"BONITO";226;49;47;322
2009;"BRASILANDIA (MS)";"MS";"BRASILANDIA";216;18;64;298
2009;"CAARAPO (MS)";"MS";"CAARAPO";456;7;103;566
2009;"CAMAPUA (MS)";"MS";"CAMAPUA";282;24;24;330
2009;"CAMPO GRANDE (MS)";"MS";"CAMPO GRANDE";11379;670;1588;13637
2009;"CARACOL (MS)";"MS";"CARACOL";35;13;7;55
2009;"CASSILANDIA (MS)";"MS";"CASSILANDIA";414;10;28;452
2009;"CHAPADAO DO SUL (MS)";"MS";"CHAPADAO DO SUL";620;13;79;712
2009;"CORGUINHO (MS)";"MS";"CORGUINHO";47;6;18;71
2009;"CORONEL SAPUCAIA (MS)";"MS";"CORONEL SAPUCAIA";248;5;20;273
2009;"CORUMBA (MS)";"MS";"CORUMBA";721;53;177;951
2009;"COSTA RICA (MS)";"MS";"COSTA RICA";415;8;67;490
2009;"COXIM (MS)";"MS";"COXIM";491;11;55;557
2009;"DEODAPOLIS (MS)";"MS";"DEODAPOLIS";195;12;74;281
2009;"DOIS IRMAOS DO BURITI (MS)";"MS";"DOIS IRMAOS DO BURITI";99;18;24;141
2009;"DOURADINA (MS)";"MS";"DOURADINA";205;4;17;226
2009;"DOURADOS (MS)";"MS";"DOURADOS";3450;174;284;3908
2009;"ELDORADO (MS)";"MS";"ELDORADO";238;7;28;273
2009;"FATIMA DO SUL (MS)";"MS";"FATIMA DO SUL";370;5;24;399
2009;"FIGUEIRAO (MS)";"MS";"FIGUEIRAO";26;19;2;47
2009;"GLORIA DE DOURADOS (MS)";"MS";"GLORIA DE DOURADOS";164;4;31;199
2009;"GUIA LOPES DA LAGUNA (MS)";"MS";"GUIA LOPES DA LAGUNA";130;13;26;169
2009;"IGUATEMI (MS)";"MS";"IGUATEMI";207;4;48;259
2009;"INOCENCIA (MS)";"MS";"INOCENCIA";150;2;21;173
2009;"ITAPORA (MS)";"MS";"ITAPORA";321;17;44;382
2009;"ITAQUIRAI (MS)";"MS";"ITAQUIRAI";164;8;62;234
2009;"IVINHEMA (MS)";"MS";"IVINHEMA";488;11;184;683
2009;"JAPORA (MS)";"MS";"JAPORA";13;5;11;29
2009;"JARAGUARI (MS)";"MS";"JARAGUARI";68;3;17;88
2009;"JARDIM (MS)";"MS";"JARDIM";370;17;37;424
2009;"JATEI (MS)";"MS";"JATEI";34;5;14;53
2009;"JUTI (MS)";"MS";"JUTI";56;3;15;74
2009;"LADARIO (MS)";"MS";"LADARIO";145;22;59;226
2009;"LAGUNA CARAPA (MS)";"MS";"LAGUNA CARAPA";144;2;15;161
2009;"MARACAJU (MS)";"MS";"MARACAJU";828;12;138;978
2009;"MIRANDA (MS)";"MS";"MIRANDA";271;23;62;356
2009;"MUNDO NOVO (MS)";"MS";"MUNDO NOVO";256;24;25;305
2009;"NAVIRAI (MS)";"MS";"NAVIRAI";761;28;144;933
2009;"NIOAQUE (MS)";"MS";"NIOAQUE";124;13;49;186
2009;"NOVA ALVORADA DO SUL (MS)";"MS";"NOVA ALVORADA DO SUL";291;15;78;384
2009;"NOVA ANDRADINA (MS)";"MS";"NOVA ANDRADINA";855;17;185;1057
2009;"NOVO HORIZONTE DO SUL (MS)";"MS";"NOVO HORIZONTE DO SUL";59;5;13;77
2009;"PARANAIBA (MS)";"MS";"PARANAIBA";738;20;80;838
2009;"PARANHOS (MS)";"MS";"PARANHOS";95;4;18;117
2009;"PEDRO GOMES (MS)";"MS";"PEDRO GOMES";77;7;9;93
2009;"PONTA PORA (MS)";"MS";"PONTA PORA";1457;45;188;1690
2009;"PORTO MURTINHO (MS)";"MS";"PORTO MURTINHO";51;6;17;74
2009;"RIBAS DO RIO PARDO (MS)";"MS";"RIBAS DO RIO PARDO";494;16;48;558
2009;"RIO BRILHANTE (MS)";"MS";"RIO BRILHANTE";598;29;129;756
2009;"RIO NEGRO (MS)";"MS";"RIO NEGRO";45;6;8;59
2009;"RIO VERDE DE MATO GROSSO (MS)";"MS";"RIO VERDE DE MATO GROSSO";288;12;18;318
2009;"ROCHEDO (MS)";"MS";"ROCHEDO";41;2;9;52
2009;"SANTA RITA DO PARDO (MS)";"MS";"SANTA RITA DO PARDO";114;12;30;156
2009;"SAO GABRIEL DO OESTE (MS)";"MS";"SAO GABRIEL DO OESTE";754;19;39;812
2009;"SELVIRIA (MS)";"MS";"SELVIRIA";82;8;19;109
2009;"SETE QUEDAS (MS)";"MS";"SETE QUEDAS";192;4;20;216
2009;"SIDROLANDIA (MS)";"MS";"SIDROLANDIA";578;55;196;829
2009;"SONORA (MS)";"MS";"SONORA";177;12;86;275
2009;"TACURU (MS)";"MS";"TACURU";96;5;13;114
2009;"TAQUARUSSU (MS)";"MS";"TAQUARUSSU";38;2;9;49
2009;"TERENOS (MS)";"MS";"TERENOS";277;14;32;323
2009;"TRES LAGOAS (MS)";"MS";"TRES LAGOAS";1405;92;341;1838
2009;"VICENTINA (MS)";"MS";"VICENTINA";99;6;53;158
2009;"ACORIZAL (MT)";"MT";"ACORIZAL";11;2;3;16
2009;"AGUA BOA (MT)";"MT";"AGUA BOA";414;6;26;446
2009;"ALTA FLORESTA (MT)";"MT";"ALTA FLORESTA";1088;14;70;1172
2009;"ALTO ARAGUAIA (MT)";"MT";"ALTO ARAGUAIA";113;12;25;150
2009;"ALTO BOA VISTA (MT)";"MT";"ALTO BOA VISTA";17;1;2;20
2009;"ALTO GARCAS (MT)";"MT";"ALTO GARCAS";242;5;28;275
2009;"ALTO PARAGUAI (MT)";"MT";"ALTO PARAGUAI";25;7;4;36
2009;"ALTO TAQUARI (MT)";"MT";"ALTO TAQUARI";140;7;12;159
2009;"APIACAS (MT)";"MT";"APIACAS";85;8;3;96
2009;"ARAGUAIANA (MT)";"MT";"ARAGUAIANA";8;0;2;10
2009;"ARAGUAINHA (MT)";"MT";"ARAGUAINHA";7;1;0;8
2009;"ARAPUTANGA (MT)";"MT";"ARAPUTANGA";233;11;20;264
2009;"ARENAPOLIS (MT)";"MT";"ARENAPOLIS";176;7;53;236
2009;"ARIPUANA (MT)";"MT";"ARIPUANA";281;10;24;315
2009;"BARAO DE MELGACO (MT)";"MT";"BARAO DE MELGACO";8;1;3;12
2009;"BARRA DO BUGRES (MT)";"MT";"BARRA DO BUGRES";448;16;118;582
2009;"BARRA DO GARCAS (MT)";"MT";"BARRA DO GARCAS";745;27;152;924
2009;"BOM JESUS DO ARAGUAIA (MT)";"MT";"BOM JESUS DO ARAGUAIA";12;1;6;19
2009;"BRASNORTE (MT)";"MT";"BRASNORTE";256;3;44;303
2009;"CACERES (MT)";"MT";"CACERES";717;44;271;1032
2009;"CAMPINAPOLIS (MT)";"MT";"CAMPINAPOLIS";58;1;13;72
2009;"CAMPO NOVO DO PARECIS (MT)";"MT";"CAMPO NOVO DO PARECIS";603;13;92;708
2009;"CAMPO VERDE (MT)";"MT";"CAMPO VERDE";726;34;96;856
2009;"CAMPOS DE JULIO (MT)";"MT";"CAMPOS DE JULIO";135;10;22;167
2009;"CANABRAVA DO NORTE (MT)";"MT";"CANABRAVA DO NORTE";22;0;7;29
2009;"CANARANA (MT)";"MT";"CANARANA";428;9;24;461
2009;"CARLINDA (MT)";"MT";"CARLINDA";105;0;22;127
2009;"CASTANHEIRA (MT)";"MT";"CASTANHEIRA";92;2;12;106
2009;"CHAPADA DOS GUIMARAES (MT)";"MT";"CHAPADA DOS GUIMARAES";181;16;40;237
2009;"CLAUDIA (MT)";"MT";"CLAUDIA";358;3;16;377
2009;"COCALINHO (MT)";"MT";"COCALINHO";16;1;7;24
2009;"COLIDER (MT)";"MT";"COLIDER";770;12;70;852
2009;"COLNIZA (MT)";"MT";"COLNIZA";215;0;4;219
2009;"COMODORO (MT)";"MT";"COMODORO";384;7;67;458
2009;"CONFRESA (MT)";"MT";"CONFRESA";111;4;23;138
2009;"CONQUISTA D OESTE (MT)";"MT";"CONQUISTA D OESTE";31;1;10;42
2009;"COTRIGUACU (MT)";"MT";"COTRIGUACU";113;1;29;143
2009;"CUIABA (MT)";"MT";"CUIABA";7303;628;1602;9533
2009;"CURVELANDIA (MT)";"MT";"CURVELANDIA";62;0;13;75
2009;"DENISE (MT)";"MT";"DENISE";66;4;23;93
2009;"DIAMANTINO (MT)";"MT";"DIAMANTINO";429;12;57;498
2009;"DOM AQUINO (MT)";"MT";"DOM AQUINO";95;7;19;121
2009;"FELIZ NATAL (MT)";"MT";"FELIZ NATAL";209;3;16;228
2009;"FIGUEIROPOLIS D OESTE (MT)";"MT";"FIGUEIROPOLIS D OESTE";61;3;8;72
2009;"GAUCHA DO NORTE (MT)";"MT";"GAUCHA DO NORTE";46;5;11;62
2009;"GENERAL CARNEIRO (MT)";"MT";"GENERAL CARNEIRO";19;4;3;26
2009;"GLORIA D OESTE (MT)";"MT";"GLORIA D OESTE";38;3;11;52
2009;"GUARANTA DO NORTE (MT)";"MT";"GUARANTA DO NORTE";792;8;54;854
2009;"GUIRATINGA (MT)";"MT";"GUIRATINGA";141;7;9;157
2009;"INDIAVAI (MT)";"MT";"INDIAVAI";21;1;6;28
2009;"IPIRANGA DO NORTE (MT)";"MT";"IPIRANGA DO NORTE";78;2;5;85
2009;"ITANHANGA (MT)";"MT";"ITANHANGA";87;2;14;103
2009;"ITAUBA (MT)";"MT";"ITAUBA";92;4;7;103
2009;"ITIQUIRA (MT)";"MT";"ITIQUIRA";83;11;28;122
2009;"JACIARA (MT)";"MT";"JACIARA";498;34;102;634
2009;"JANGADA (MT)";"MT";"JANGADA";46;10;13;69
2009;"JAURU (MT)";"MT";"JAURU";138;3;23;164
2009;"JUARA (MT)";"MT";"JUARA";646;12;42;700
2009;"JUINA (MT)";"MT";"JUINA";772;5;49;826
2009;"JURUENA (MT)";"MT";"JURUENA";130;2;10;142
2009;"JUSCIMEIRA (MT)";"MT";"JUSCIMEIRA";104;5;43;152
2009;"LAMBARI D OESTE (MT)";"MT";"LAMBARI D OESTE";52;1;22;75
2009;"LUCAS DO RIO VERDE (MT)";"MT";"LUCAS DO RIO VERDE";1274;28;95;1397
2009;"LUCIARA (MT)";"MT";"LUCIARA";7;0;2;9
2009;"MARCELANDIA (MT)";"MT";"MARCELANDIA";331;6;14;351
2009;"MATUPA (MT)";"MT";"MATUPA";316;6;30;352
2009;"MIRASSOL D OESTE (MT)";"MT";"MIRASSOL D OESTE";629;6;64;699
2009;"NOBRES (MT)";"MT";"NOBRES";232;8;46;286
2009;"NORTELANDIA (MT)";"MT";"NORTELANDIA";80;4;12;96
2009;"NOSSA SENHORA DO LIVRAMENTO (MT)";"MT";"NOSSA SENHORA DO LIVRAMENTO";51;2;24;77
2009;"NOVA BANDEIRANTES (MT)";"MT";"NOVA BANDEIRANTES";115;1;21;137
2009;"NOVA BRASILANDIA (MT)";"MT";"NOVA BRASILANDIA";29;1;8;38
2009;"NOVA CANAA DO NORTE (MT)";"MT";"NOVA CANAA DO NORTE";163;1;30;194
2009;"NOVA GUARITA (MT)";"MT";"NOVA GUARITA";76;0;11;87
2009;"NOVA LACERDA (MT)";"MT";"NOVA LACERDA";69;0;20;89
2009;"NOVA MARILANDIA (MT)";"MT";"NOVA MARILANDIA";22;4;3;29
2009;"NOVA MARINGA (MT)";"MT";"NOVA MARINGA";82;0;7;89
2009;"NOVA MONTE VERDE (MT)";"MT";"NOVA MONTE VERDE";94;6;3;103
2009;"NOVA MUTUM (MT)";"MT";"NOVA MUTUM";751;14;45;810
2009;"NOVA NAZARE (MT)";"MT";"NOVA NAZARE";7;2;3;12
2009;"NOVA OLIMPIA (MT)";"MT";"NOVA OLIMPIA";299;19;70;388
2009;"NOVA SANTA HELENA (MT)";"MT";"NOVA SANTA HELENA";46;1;10;57
2009;"NOVA UBIRATA (MT)";"MT";"NOVA UBIRATA";106;8;16;130
2009;"NOVA XAVANTINA (MT)";"MT";"NOVA XAVANTINA";298;11;35;344
2009;"NOVO HORIZONTE DO NORTE (MT)";"MT";"NOVO HORIZONTE DO NORTE";35;0;12;47
2009;"NOVO MUNDO (MT)";"MT";"NOVO MUNDO";80;1;7;88
2009;"NOVO SANTO ANTONIO (MT)";"MT";"NOVO SANTO ANTONIO";2;0;3;5
2009;"NOVO SAO JOAQUIM (MT)";"MT";"NOVO SAO JOAQUIM";49;2;9;60
2009;"PARANAITA (MT)";"MT";"PARANAITA";160;6;28;194
2009;"PARANATINGA (MT)";"MT";"PARANATINGA";317;9;40;366
2009;"PEDRA PRETA (MT)";"MT";"PEDRA PRETA";267;10;30;307
2009;"PEIXOTO DE AZEVEDO (MT)";"MT";"PEIXOTO DE AZEVEDO";247;7;46;300
2009;"PLANALTO DA SERRA (MT)";"MT";"PLANALTO DA SERRA";8;1;4;13
2009;"POCONE (MT)";"MT";"POCONE";301;11;28;340
2009;"PONTAL DO ARAGUAIA (MT)";"MT";"PONTAL DO ARAGUAIA";12;1;0;13
2009;"PONTE BRANCA (MT)";"MT";"PONTE BRANCA";4;1;0;5
2009;"PONTES E LACERDA (MT)";"MT";"PONTES E LACERDA";726;23;85;834
2009;"PORTO ALEGRE DO NORTE (MT)";"MT";"PORTO ALEGRE DO NORTE";37;6;22;65
2009;"PORTO DOS GAUCHOS (MT)";"MT";"PORTO DOS GAUCHOS";87;8;6;101
2009;"PORTO ESPERIDIAO (MT)";"MT";"PORTO ESPERIDIAO";106;4;31;141
2009;"PORTO ESTRELA (MT)";"MT";"PORTO ESTRELA";13;2;4;19
2009;"POXOREO (MT)";"MT";"POXOREO";87;10;28;125
2009;"PRIMAVERA DO LESTE (MT)";"MT";"PRIMAVERA DO LESTE";1524;50;108;1682
2009;"QUERENCIA (MT)";"MT";"QUERENCIA";216;1;14;231
2009;"RESERVA DO CABACAL (MT)";"MT";"RESERVA DO CABACAL";19;2;4;25
2009;"RIBEIRAO CASCALHEIRA (MT)";"MT";"RIBEIRAO CASCALHEIRA";69;6;8;83
2009;"RIBEIRAOZINHO (MT)";"MT";"RIBEIRAOZINHO";7;3;5;15
2009;"RIO BRANCO (MT)";"MT";"RIO BRANCO";76;6;16;98
2009;"RONDOLANDIA (MT)";"MT";"RONDOLANDIA";6;0;9;15
2009;"RONDONOPOLIS (MT)";"MT";"RONDONOPOLIS";3421;123;352;3896
2009;"ROSARIO OESTE (MT)";"MT";"ROSARIO OESTE";106;10;16;132
2009;"SALTO DO CEU (MT)";"MT";"SALTO DO CEU";40;3;11;54
2009;"SANTA CARMEN (MT)";"MT";"SANTA CARMEN";126;2;10;138
2009;"SANTA CRUZ DO XINGU (MT)";"MT";"SANTA CRUZ DO XINGU";4;1;3;8
2009;"SANTA RITA DO TRIVELATO (MT)";"MT";"SANTA RITA DO TRIVELATO";36;2;10;48
2009;"SANTA TEREZINHA (MT)";"MT";"SANTA TEREZINHA";6;1;9;16
2009;"SANTO AFONSO (MT)";"MT";"SANTO AFONSO";22;1;5;28
2009;"SANTO ANTONIO DO LESTE (MT)";"MT";"SANTO ANTONIO DO LESTE";51;1;12;64
2009;"SANTO ANTONIO DO LEVERGER (MT)";"MT";"SANTO ANTONIO DO LEVERGER";70;11;13;94
2009;"SAO FELIX DO ARAGUAIA (MT)";"MT";"SAO FELIX DO ARAGUAIA";29;4;16;49
2009;"SAO JOSE DO POVO (MT)";"MT";"SAO JOSE DO POVO";14;1;4;19
2009;"SAO JOSE DO RIO CLARO (MT)";"MT";"SAO JOSE DO RIO CLARO";287;9;39;335
2009;"SAO JOSE DO XINGU (MT)";"MT";"SAO JOSE DO XINGU";9;0;7;16
2009;"SAO JOSE DOS QUATRO MARCOS (MT)";"MT";"SAO JOSE DOS QUATRO MARCOS";369;8;49;426
2009;"SAO PEDRO DA CIPA (MT)";"MT";"SAO PEDRO DA CIPA";18;3;20;41
2009;"SAPEZAL (MT)";"MT";"SAPEZAL";418;9;44;471
2009;"SERRA NOVA DOURADA (MT)";"MT";"SERRA NOVA DOURADA";6;1;1;8
2009;"SINOP (MT)";"MT";"SINOP";2728;48;137;2913
2009;"SORRISO (MT)";"MT";"SORRISO";1863;39;120;2022
2009;"TABAPORA (MT)";"MT";"TABAPORA";103;5;17;125
2009;"TANGARA DA SERRA (MT)";"MT";"TANGARA DA SERRA";1649;68;194;1911
2009;"TAPURAH (MT)";"MT";"TAPURAH";291;8;20;319
2009;"TERRA NOVA DO NORTE (MT)";"MT";"TERRA NOVA DO NORTE";235;10;20;265
2009;"TESOURO (MT)";"MT";"TESOURO";10;2;3;15
2009;"TORIXOREU (MT)";"MT";"TORIXOREU";17;2;3;22
2009;"UNIAO DO SUL (MT)";"MT";"UNIAO DO SUL";70;0;7;77
2009;"VALE DE SAO DOMINGOS (MT)";"MT";"VALE DE SAO DOMINGOS";21;0;10;31
2009;"VARZEA GRANDE (MT)";"MT";"VARZEA GRANDE";3786;221;413;4420
2009;"VERA (MT)";"MT";"VERA";250;5;18;273
2009;"VILA BELA DA SANTISSIMA TRINDA (MT)";"MT";"VILA BELA DA SANTISSIMA TRINDA";82;2;23;107
2009;"VILA RICA (MT)";"MT";"VILA RICA";204;3;22;229
2009;"ABAETETUBA (PA)";"PA";"ABAETETUBA";222;15;167;404
2009;"ABEL FIGUEIREDO (PA)";"PA";"ABEL FIGUEIREDO";50;6;3;59
2009;"ACARA (PA)";"PA";"ACARA";55;4;32;91
2009;"AFUA (PA)";"PA";"AFUA";0;0;0;0
2009;"AGUA AZUL DO NORTE (PA)";"PA";"AGUA AZUL DO NORTE";43;5;11;59
2009;"ALENQUER (PA)";"PA";"ALENQUER";107;4;30;141
2009;"ALMEIRIM (PA)";"PA";"ALMEIRIM";181;12;74;267
2009;"ALTAMIRA (PA)";"PA";"ALTAMIRA";808;116;56;980
2009;"ANAJAS (PA)";"PA";"ANAJAS";0;0;1;1
2009;"ANANINDEUA (PA)";"PA";"ANANINDEUA";3386;355;1102;4843
2009;"ANAPU (PA)";"PA";"ANAPU";43;7;3;53
2009;"AUGUSTO CORREA (PA)";"PA";"AUGUSTO CORREA";27;1;38;66
2009;"AURORA DO PARA (PA)";"PA";"AURORA DO PARA";46;5;45;96
2009;"AVEIRO (PA)";"PA";"AVEIRO";4;0;0;4
2009;"BAGRE (PA)";"PA";"BAGRE";1;0;0;1
2009;"BAIAO (PA)";"PA";"BAIAO";29;2;12;43
2009;"BANNACH (PA)";"PA";"BANNACH";12;0;0;12
2009;"BARCARENA (PA)";"PA";"BARCARENA";644;141;499;1284
2009;"BELEM (PA)";"PA";"BELEM";7210;1306;2623;11139
2009;"BELTERRA (PA)";"PA";"BELTERRA";29;3;18;50
2009;"BENEVIDES (PA)";"PA";"BENEVIDES";370;27;80;477
2009;"BOM JESUS DO TOCANTINS (PA)";"PA";"BOM JESUS DO TOCANTINS";62;12;3;77
2009;"BONITO (PA)";"PA";"BONITO";37;1;35;73
2009;"BRAGANCA (PA)";"PA";"BRAGANCA";330;23;133;486
2009;"BRASIL NOVO (PA)";"PA";"BRASIL NOVO";133;29;4;166
2009;"BREJO GRANDE DO ARAGUAIA (PA)";"PA";"BREJO GRANDE DO ARAGUAIA";8;10;7;25
2009;"BREU BRANCO (PA)";"PA";"BREU BRANCO";233;9;57;299
2009;"BREVES (PA)";"PA";"BREVES";19;1;3;23
2009;"BUJARU (PA)";"PA";"BUJARU";30;6;8;44
2009;"CACHOEIRA DO ARARI (PA)";"PA";"CACHOEIRA DO ARARI";7;3;9;19
2009;"CACHOEIRA DO PIRIA (PA)";"PA";"CACHOEIRA DO PIRIA";24;1;15;40
2009;"CAMETA (PA)";"PA";"CAMETA";79;5;36;120
2009;"CANAA DOS CARAJAS (PA)";"PA";"CANAA DOS CARAJAS";153;48;64;265
2009;"CAPANEMA (PA)";"PA";"CAPANEMA";533;20;91;644
2009;"CAPITAO POCO (PA)";"PA";"CAPITAO POCO";265;19;55;339
2009;"CASTANHAL (PA)";"PA";"CASTANHAL";2184;128;262;2574
2009;"CHAVES (PA)";"PA";"CHAVES";0;0;0;0
2009;"COLARES (PA)";"PA";"COLARES";4;1;0;5
2009;"CONCEICAO DO ARAGUAIA (PA)";"PA";"CONCEICAO DO ARAGUAIA";312;22;58;392
2009;"CONCORDIA DO PARA (PA)";"PA";"CONCORDIA DO PARA";96;1;27;124
2009;"CUMARU DO NORTE (PA)";"PA";"CUMARU DO NORTE";17;0;5;22
2009;"CURIONOPOLIS (PA)";"PA";"CURIONOPOLIS";57;96;3;156
2009;"CURRALINHO (PA)";"PA";"CURRALINHO";1;0;1;2
2009;"CURUA (PA)";"PA";"CURUA";2;0;0;2
2009;"CURUCA (PA)";"PA";"CURUCA";41;6;10;57
2009;"DOM ELISEU (PA)";"PA";"DOM ELISEU";455;35;29;519
2009;"ELDORADO DOS CARAJAS (PA)";"PA";"ELDORADO DOS CARAJAS";116;27;5;148
2009;"FARO (PA)";"PA";"FARO";2;1;0;3
2009;"FLORESTA DO ARAGUAIA (PA)";"PA";"FLORESTA DO ARAGUAIA";73;2;4;79
2009;"GARRAFAO DO NORTE (PA)";"PA";"GARRAFAO DO NORTE";59;2;12;73
2009;"GOIANESIA DO PARA (PA)";"PA";"GOIANESIA DO PARA";253;13;21;287
2009;"GURUPA (PA)";"PA";"GURUPA";3;0;1;4
2009;"IGARAPE ACU (PA)";"PA";"IGARAPE ACU";120;51;60;231
2009;"IGARAPE MIRI (PA)";"PA";"IGARAPE MIRI";55;10;18;83
2009;"INHANGAPI (PA)";"PA";"INHANGAPI";23;1;27;51
2009;"IPIXUNA DO PARA (PA)";"PA";"IPIXUNA DO PARA";52;3;16;71
2009;"IRITUIA (PA)";"PA";"IRITUIA";46;3;33;82
2009;"ITAITUBA (PA)";"PA";"ITAITUBA";575;32;57;664
2009;"ITUPIRANGA (PA)";"PA";"ITUPIRANGA";119;83;17;219
2009;"JACAREACANGA (PA)";"PA";"JACAREACANGA";6;0;0;6
2009;"JACUNDA (PA)";"PA";"JACUNDA";540;21;32;593
2009;"JURUTI (PA)";"PA";"JURUTI";58;8;3;69
2009;"LIMOEIRO DO AJURU (PA)";"PA";"LIMOEIRO DO AJURU";0;0;0;0
2009;"MAE DO RIO (PA)";"PA";"MAE DO RIO";243;10;55;308
2009;"MAGALHAES BARATA (PA)";"PA";"MAGALHAES BARATA";8;23;4;35
2009;"MARABA (PA)";"PA";"MARABA";2862;192;345;3399
2009;"MARACANA (PA)";"PA";"MARACANA";18;11;13;42
2009;"MARAPANIM (PA)";"PA";"MARAPANIM";30;11;16;57
2009;"MARITUBA (PA)";"PA";"MARITUBA";597;93;223;913
2009;"MEDICILANDIA (PA)";"PA";"MEDICILANDIA";136;8;18;162
2009;"MELGACO (PA)";"PA";"MELGACO";1;0;0;1
2009;"MOCAJUBA (PA)";"PA";"MOCAJUBA";8;1;6;15
2009;"MOJU (PA)";"PA";"MOJU";101;11;115;227
2009;"MONTE ALEGRE (PA)";"PA";"MONTE ALEGRE";198;4;103;305
2009;"MUANA (PA)";"PA";"MUANA";1;2;1;4
2009;"NOVA ESPERANCA DO PIRIA (PA)";"PA";"NOVA ESPERANCA DO PIRIA";47;2;13;62
2009;"NOVA IPIXUNA (PA)";"PA";"NOVA IPIXUNA";122;2;22;146
2009;"NOVA TIMBOTEUA (PA)";"PA";"NOVA TIMBOTEUA";46;6;11;63
2009;"NOVO PROGRESSO (PA)";"PA";"NOVO PROGRESSO";174;2;16;192
2009;"NOVO REPARTIMENTO (PA)";"PA";"NOVO REPARTIMENTO";309;26;19;354
2009;"OBIDOS (PA)";"PA";"OBIDOS";135;0;27;162
2009;"OEIRAS DO PARA (PA)";"PA";"OEIRAS DO PARA";4;1;0;5
2009;"ORIXIMINA (PA)";"PA";"ORIXIMINA";251;8;16;275
2009;"OUREM (PA)";"PA";"OUREM";76;2;12;90
2009;"OURILANDIA DO NORTE (PA)";"PA";"OURILANDIA DO NORTE";156;6;14;176
2009;"PACAJA (PA)";"PA";"PACAJA";91;8;9;108
2009;"PALESTINA DO PARA (PA)";"PA";"PALESTINA DO PARA";16;14;1;31
2009;"PARAGOMINAS (PA)";"PA";"PARAGOMINAS";1114;15;128;1257
2009;"PARAUAPEBAS (PA)";"PA";"PARAUAPEBAS";1116;480;251;1847
2009;"PAU D ARCO (PA)";"PA";"PAU D ARCO";13;6;3;22
2009;"PEIXE BOI (PA)";"PA";"PEIXE BOI";15;3;11;29
2009;"PICARRA (PA)";"PA";"PICARRA";12;1;2;15
2009;"PLACAS (PA)";"PA";"PLACAS";45;1;1;47
2009;"PONTA DE PEDRAS (PA)";"PA";"PONTA DE PEDRAS";3;0;0;3
2009;"PORTEL (PA)";"PA";"PORTEL";14;0;0;14
2009;"PORTO DE MOZ (PA)";"PA";"PORTO DE MOZ";10;0;0;10
2009;"PRAINHA (PA)";"PA";"PRAINHA";21;0;3;24
2009;"PRIMAVERA (PA)";"PA";"PRIMAVERA";10;1;13;24
2009;"QUATIPURU (PA)";"PA";"QUATIPURU";8;2;11;21
2009;"REDENCAO (PA)";"PA";"REDENCAO";897;58;86;1041
2009;"RIO MARIA (PA)";"PA";"RIO MARIA";195;40;20;255
2009;"RONDON DO PARA (PA)";"PA";"RONDON DO PARA";420;42;11;473
2009;"RUROPOLIS (PA)";"PA";"RUROPOLIS";138;6;9;153
2009;"SALINOPOLIS (PA)";"PA";"SALINOPOLIS";120;20;44;184
2009;"SALVATERRA (PA)";"PA";"SALVATERRA";19;16;18;53
2009;"SANTA BARBARA DO PARA (PA)";"PA";"SANTA BARBARA DO PARA";39;12;39;90
2009;"SANTA CRUZ DO ARARI (PA)";"PA";"SANTA CRUZ DO ARARI";1;0;0;1
2009;"SANTA ISABEL DO PARA (PA)";"PA";"SANTA ISABEL DO PARA";471;24;126;621
2009;"SANTA LUZIA DO PARA (PA)";"PA";"SANTA LUZIA DO PARA";89;8;27;124
2009;"SANTA MARIA DAS BARREIRAS (PA)";"PA";"SANTA MARIA DAS BARREIRAS";56;1;12;69
2009;"SANTA MARIA DO PARA (PA)";"PA";"SANTA MARIA DO PARA";206;26;45;277
2009;"SANTANA DO ARAGUAIA (PA)";"PA";"SANTANA DO ARAGUAIA";132;12;10;154
2009;"SANTAREM (PA)";"PA";"SANTAREM";2067;73;489;2629
2009;"SANTAREM NOVO (PA)";"PA";"SANTAREM NOVO";6;3;8;17
2009;"SANTO ANTONIO DO TAUA (PA)";"PA";"SANTO ANTONIO DO TAUA";87;32;84;203
2009;"SAO CAETANO DE ODIVELAS (PA)";"PA";"SAO CAETANO DE ODIVELAS";17;0;3;20
2009;"SAO DOMINGOS DO ARAGUAIA (PA)";"PA";"SAO DOMINGOS DO ARAGUAIA";113;24;13;150
2009;"SAO DOMINGOS DO CAPIM (PA)";"PA";"SAO DOMINGOS DO CAPIM";39;1;12;52
2009;"SAO FELIX DO XINGU (PA)";"PA";"SAO FELIX DO XINGU";170;4;15;189
2009;"SAO FRANCISCO DO PARA (PA)";"PA";"SAO FRANCISCO DO PARA";26;37;21;84
2009;"SAO GERALDO DO ARAGUAIA (PA)";"PA";"SAO GERALDO DO ARAGUAIA";94;8;12;114
2009;"SAO JOAO DA PONTA (PA)";"PA";"SAO JOAO DA PONTA";2;5;7;14
2009;"SAO JOAO DE PIRABAS (PA)";"PA";"SAO JOAO DE PIRABAS";19;10;10;39
2009;"SAO JOAO DO ARAGUAIA (PA)";"PA";"SAO JOAO DO ARAGUAIA";16;18;6;40
2009;"SAO MIGUEL DO GUAMA (PA)";"PA";"SAO MIGUEL DO GUAMA";307;22;68;397
2009;"SAO SEBASTIAO DA BOA VISTA (PA)";"PA";"SAO SEBASTIAO DA BOA VISTA";2;0;0;2
2009;"SAPUCAIA (PA)";"PA";"SAPUCAIA";24;3;3;30
2009;"SENADOR JOSE PORFIRIO (PA)";"PA";"SENADOR JOSE PORFIRIO";15;3;1;19
2009;"SOURE (PA)";"PA";"SOURE";25;2;9;36
2009;"TAILANDIA (PA)";"PA";"TAILANDIA";504;23;60;587
2009;"TERRA ALTA (PA)";"PA";"TERRA ALTA";19;16;15;50
2009;"TERRA SANTA (PA)";"PA";"TERRA SANTA";8;0;3;11
2009;"TOME ACU (PA)";"PA";"TOME ACU";343;11;76;430
2009;"TRACUATEUA (PA)";"PA";"TRACUATEUA";22;4;21;47
2009;"TRAIRAO (PA)";"PA";"TRAIRAO";68;3;3;74
2009;"TUCUMA (PA)";"PA";"TUCUMA";364;13;40;417
2009;"TUCURUI (PA)";"PA";"TUCURUI";643;97;137;877
2009;"ULIANOPOLIS (PA)";"PA";"ULIANOPOLIS";143;16;14;173
2009;"URUARA (PA)";"PA";"URUARA";383;12;15;410
2009;"VIGIA (PA)";"PA";"VIGIA";98;2;60;160
2009;"VISEU (PA)";"PA";"VISEU";42;3;23;68
2009;"VITORIA DO XINGU (PA)";"PA";"VITORIA DO XINGU";8;11;8;27
2009;"XINGUARA (PA)";"PA";"XINGUARA";611;25;65;701
2009;"AGUA BRANCA (PB)";"PB";"AGUA BRANCA";10;5;2;17
2009;"AGUIAR (PB)";"PB";"AGUIAR";7;3;0;10
2009;"ALAGOA GRANDE (PB)";"PB";"ALAGOA GRANDE";81;13;24;118
2009;"ALAGOA NOVA (PB)";"PB";"ALAGOA NOVA";86;68;12;166
2009;"ALAGOINHA (PB)";"PB";"ALAGOINHA";45;10;14;69
2009;"ALCANTIL (PB)";"PB";"ALCANTIL";34;14;10;58
2009;"ALGODAO DE JANDAIRA (PB)";"PB";"ALGODAO DE JANDAIRA";12;0;1;13
2009;"ALHANDRA (PB)";"PB";"ALHANDRA";90;14;12;116
2009;"AMPARO (PB)";"PB";"AMPARO";5;1;3;9
2009;"APARECIDA (PB)";"PB";"APARECIDA";23;4;6;33
2009;"ARACAGI (PB)";"PB";"ARACAGI";46;1;24;71
2009;"ARARA (PB)";"PB";"ARARA";40;3;12;55
2009;"ARARUNA (PB)";"PB";"ARARUNA";64;20;17;101
2009;"AREIA (PB)";"PB";"AREIA";92;19;13;124
2009;"AREIA DE BARAUNAS (PB)";"PB";"AREIA DE BARAUNAS";2;1;2;5
2009;"AREIAL (PB)";"PB";"AREIAL";19;4;4;27
2009;"AROEIRAS (PB)";"PB";"AROEIRAS";43;6;9;58
2009;"ASSUNCAO (PB)";"PB";"ASSUNCAO";11;7;3;21
2009;"BAIA DA TRAICAO (PB)";"PB";"BAIA DA TRAICAO";10;4;5;19
2009;"BANANEIRAS (PB)";"PB";"BANANEIRAS";60;12;20;92
2009;"BARAUNA (PB)";"PB";"BARAUNA";16;0;3;19
2009;"BARRA DE SANTA ROSA (PB)";"PB";"BARRA DE SANTA ROSA";53;5;10;68
2009;"BARRA DE SANTANA (PB)";"PB";"BARRA DE SANTANA";48;3;6;57
2009;"BARRA DE SAO MIGUEL (PB)";"PB";"BARRA DE SAO MIGUEL";5;0;1;6
2009;"BAYEUX (PB)";"PB";"BAYEUX";499;26;134;659
2009;"BELEM (PB)";"PB";"BELEM";95;9;11;115
2009;"BELEM DO BREJO DO CRUZ (PB)";"PB";"BELEM DO BREJO DO CRUZ";8;14;1;23
2009;"BERNARDINO BATISTA (PB)";"PB";"BERNARDINO BATISTA";2;0;3;5
2009;"BOA VENTURA (PB)";"PB";"BOA VENTURA";9;2;0;11
2009;"BOA VISTA (PB)";"PB";"BOA VISTA";87;4;10;101
2009;"BOM JESUS (PB)";"PB";"BOM JESUS";4;1;0;5
2009;"BOM SUCESSO (PB)";"PB";"BOM SUCESSO";4;1;3;8
2009;"BONITO DE SANTA FE (PB)";"PB";"BONITO DE SANTA FE";21;5;0;26
2009;"BOQUEIRAO (PB)";"PB";"BOQUEIRAO";168;6;17;191
2009;"BORBOREMA (PB)";"PB";"BORBOREMA";20;13;0;33
2009;"BREJO DO CRUZ (PB)";"PB";"BREJO DO CRUZ";54;8;3;65
2009;"BREJO DOS SANTOS (PB)";"PB";"BREJO DOS SANTOS";13;2;0;15
2009;"CAAPORA (PB)";"PB";"CAAPORA";20;5;3;28
2009;"CABACEIRAS (PB)";"PB";"CABACEIRAS";18;4;13;35
2009;"CABEDELO (PB)";"PB";"CABEDELO";316;12;26;354
2009;"CACHOEIRA DOS INDIOS (PB)";"PB";"CACHOEIRA DOS INDIOS";13;0;3;16
2009;"CACIMBA DE AREIA (PB)";"PB";"CACIMBA DE AREIA";5;0;5;10
2009;"CACIMBA DE DENTRO (PB)";"PB";"CACIMBA DE DENTRO";52;9;28;89
2009;"CACIMBAS (PB)";"PB";"CACIMBAS";3;4;1;8
2009;"CAICARA (PB)";"PB";"CAICARA";13;4;3;20
2009;"CAJAZEIRAS (PB)";"PB";"CAJAZEIRAS";408;25;36;469
2009;"CAJAZEIRINHAS (PB)";"PB";"CAJAZEIRINHAS";5;2;0;7
2009;"CALDAS BRANDAO (PB)";"PB";"CALDAS BRANDAO";20;3;4;27
2009;"CAMALAU (PB)";"PB";"CAMALAU";19;4;10;33
2009;"CAMPINA GRANDE (PB)";"PB";"CAMPINA GRANDE";3898;233;661;4792
2009;"CAPIM (PB)";"PB";"CAPIM";15;1;9;25
2009;"CARAUBAS (PB)";"PB";"CARAUBAS";5;4;2;11
2009;"CARRAPATEIRA (PB)";"PB";"CARRAPATEIRA";0;2;0;2
2009;"CASSERENGUE (PB)";"PB";"CASSERENGUE";18;4;15;37
2009;"CATINGUEIRA (PB)";"PB";"CATINGUEIRA";9;1;0;10
2009;"CATOLE DO ROCHA (PB)";"PB";"CATOLE DO ROCHA";205;27;13;245
2009;"CATURITE (PB)";"PB";"CATURITE";69;11;8;88
2009;"CONCEICAO (PB)";"PB";"CONCEICAO";63;18;5;86
2009;"CONDADO (PB)";"PB";"CONDADO";18;2;5;25
2009;"CONDE (PB)";"PB";"CONDE";66;8;8;82
2009;"CONGO (PB)";"PB";"CONGO";16;2;0;18
2009;"COREMAS (PB)";"PB";"COREMAS";44;10;4;58
2009;"COXIXOLA (PB)";"PB";"COXIXOLA";1;5;0;6
2009;"CRUZ DO ESPIRITO SANTO (PB)";"PB";"CRUZ DO ESPIRITO SANTO";19;4;15;38
2009;"CUBATI (PB)";"PB";"CUBATI";15;3;0;18
2009;"CUITE (PB)";"PB";"CUITE";70;3;9;82
2009;"CUITE DE MAMANGUAPE (PB)";"PB";"CUITE DE MAMANGUAPE";10;9;18;37
2009;"CUITEGI (PB)";"PB";"CUITEGI";15;1;2;18
2009;"CURRAL DE CIMA (PB)";"PB";"CURRAL DE CIMA";16;3;9;28
2009;"CURRAL VELHO (PB)";"PB";"CURRAL VELHO";3;0;1;4
2009;"DAMIAO (PB)";"PB";"DAMIAO";13;2;5;20
2009;"DESTERRO (PB)";"PB";"DESTERRO";20;5;2;27
2009;"DIAMANTE (PB)";"PB";"DIAMANTE";7;2;1;10
2009;"DONA INES (PB)";"PB";"DONA INES";25;3;16;44
2009;"DUAS ESTRADAS (PB)";"PB";"DUAS ESTRADAS";7;4;5;16
2009;"EMAS (PB)";"PB";"EMAS";2;4;1;7
2009;"ESPERANCA (PB)";"PB";"ESPERANCA";390;15;91;496
2009;"FAGUNDES (PB)";"PB";"FAGUNDES";32;4;14;50
2009;"FREI MARTINHO (PB)";"PB";"FREI MARTINHO";6;0;3;9
2009;"GADO BRAVO (PB)";"PB";"GADO BRAVO";22;6;5;33
2009;"GUARABIRA (PB)";"PB";"GUARABIRA";425;43;116;584
2009;"GURINHEM (PB)";"PB";"GURINHEM";30;4;18;52
2009;"GURJAO (PB)";"PB";"GURJAO";8;4;1;13
2009;"IBIARA (PB)";"PB";"IBIARA";7;2;1;10
2009;"IGARACY (PB)";"PB";"IGARACY";11;5;2;18
2009;"IMACULADA (PB)";"PB";"IMACULADA";10;3;1;14
2009;"INGA (PB)";"PB";"INGA";83;10;25;118
2009;"ITABAIANA (PB)";"PB";"ITABAIANA";149;10;31;190
2009;"ITAPORANGA (PB)";"PB";"ITAPORANGA";86;35;12;133
2009;"ITAPOROROCA (PB)";"PB";"ITAPOROROCA";63;3;15;81
2009;"ITATUBA (PB)";"PB";"ITATUBA";28;1;7;36
2009;"JACARAU (PB)";"PB";"JACARAU";40;3;10;53
2009;"JERICO (PB)";"PB";"JERICO";16;3;0;19
2009;"JOAO PESSOA (PB)";"PB";"JOAO PESSOA";4268;677;1018;5963
2009;"JUAREZ TAVORA (PB)";"PB";"JUAREZ TAVORA";24;4;9;37
2009;"JUAZEIRINHO (PB)";"PB";"JUAZEIRINHO";45;16;8;69
2009;"JUNCO DO SERIDO (PB)";"PB";"JUNCO DO SERIDO";45;6;4;55
2009;"JURIPIRANGA (PB)";"PB";"JURIPIRANGA";31;2;17;50
2009;"JURU (PB)";"PB";"JURU";7;6;0;13
2009;"LAGOA (PB)";"PB";"LAGOA";8;2;3;13
2009;"LAGOA DE DENTRO (PB)";"PB";"LAGOA DE DENTRO";23;3;7;33
2009;"LAGOA SECA (PB)";"PB";"LAGOA SECA";147;28;16;191
2009;"LASTRO (PB)";"PB";"LASTRO";4;2;0;6
2009;"LIVRAMENTO (PB)";"PB";"LIVRAMENTO";31;5;1;37
2009;"LOGRADOURO (PB)";"PB";"LOGRADOURO";2;4;7;13
2009;"LUCENA (PB)";"PB";"LUCENA";16;1;7;24
2009;"MAE D AGUA (PB)";"PB";"MAE D AGUA";2;0;3;5
2009;"MALTA (PB)";"PB";"MALTA";8;5;2;15
2009;"MAMANGUAPE (PB)";"PB";"MAMANGUAPE";326;6;67;399
2009;"MANAIRA (PB)";"PB";"MANAIRA";11;4;1;16
2009;"MARCACAO (PB)";"PB";"MARCACAO";0;6;8;14
2009;"MARI (PB)";"PB";"MARI";78;4;36;118
2009;"MARIZOPOLIS (PB)";"PB";"MARIZOPOLIS";16;4;1;21
2009;"MASSARANDUBA (PB)";"PB";"MASSARANDUBA";17;5;6;28
2009;"MATARACA (PB)";"PB";"MATARACA";29;5;14;48
2009;"MATINHAS (PB)";"PB";"MATINHAS";7;2;1;10
2009;"MATO GROSSO (PB)";"PB";"MATO GROSSO";6;2;1;9
2009;"MATUREIA (PB)";"PB";"MATUREIA";14;11;2;27
2009;"MOGEIRO (PB)";"PB";"MOGEIRO";22;4;3;29
2009;"MONTADAS (PB)";"PB";"MONTADAS";20;2;4;26
2009;"MONTE HOREBE (PB)";"PB";"MONTE HOREBE";5;2;2;9
2009;"MONTEIRO (PB)";"PB";"MONTEIRO";208;53;32;293
2009;"MULUNGU (PB)";"PB";"MULUNGU";25;3;10;38
2009;"NATUBA (PB)";"PB";"NATUBA";12;1;1;14
2009;"NAZAREZINHO (PB)";"PB";"NAZAREZINHO";20;5;2;27
2009;"NOVA FLORESTA (PB)";"PB";"NOVA FLORESTA";32;6;6;44
2009;"NOVA OLINDA (PB)";"PB";"NOVA OLINDA";19;5;2;26
2009;"NOVA PALMEIRA (PB)";"PB";"NOVA PALMEIRA";14;1;1;16
2009;"OLHO D AGUA (PB)";"PB";"OLHO D AGUA";3;5;3;11
2009;"OLIVEDOS (PB)";"PB";"OLIVEDOS";20;4;8;32
2009;"OURO VELHO (PB)";"PB";"OURO VELHO";10;5;1;16
2009;"PARARI (PB)";"PB";"PARARI";3;1;0;4
2009;"PASSAGEM (PB)";"PB";"PASSAGEM";14;0;1;15
2009;"PATOS (PB)";"PB";"PATOS";698;107;45;850
2009;"PAULISTA (PB)";"PB";"PAULISTA";34;3;4;41
2009;"PEDRA BRANCA (PB)";"PB";"PEDRA BRANCA";4;3;3;10
2009;"PEDRA LAVRADA (PB)";"PB";"PEDRA LAVRADA";28;3;3;34
2009;"PEDRAS DE FOGO (PB)";"PB";"PEDRAS DE FOGO";210;16;51;277
2009;"PEDRO REGIS (PB)";"PB";"PEDRO REGIS";17;1;2;20
2009;"PIANCO (PB)";"PB";"PIANCO";75;14;2;91
2009;"PICUI (PB)";"PB";"PICUI";85;4;16;105
2009;"PILAR (PB)";"PB";"PILAR";20;1;13;34
2009;"PILOES (PB)";"PB";"PILOES";18;3;3;24
2009;"PILOEZINHOS (PB)";"PB";"PILOEZINHOS";10;3;2;15
2009;"PIRPIRITUBA (PB)";"PB";"PIRPIRITUBA";23;0;8;31
2009;"PITIMBU (PB)";"PB";"PITIMBU";15;11;5;31
2009;"POCINHOS (PB)";"PB";"POCINHOS";86;14;17;117
2009;"POCO DANTAS (PB)";"PB";"POCO DANTAS";1;1;1;3
2009;"POCO DE JOSE DE MOURA (PB)";"PB";"POCO DE JOSE DE MOURA";4;1;2;7
2009;"POMBAL (PB)";"PB";"POMBAL";237;21;8;266
2009;"PRATA (PB)";"PB";"PRATA";16;6;2;24
2009;"PRINCESA ISABEL (PB)";"PB";"PRINCESA ISABEL";80;60;5;145
2009;"PUXINANA (PB)";"PB";"PUXINANA";52;10;7;69
2009;"QUEIMADAS (PB)";"PB";"QUEIMADAS";352;107;84;543
2009;"QUIXABA (PB)";"PB";"QUIXABA";5;3;2;10
2009;"REMIGIO (PB)";"PB";"REMIGIO";173;5;15;193
2009;"RIACHAO (PB)";"PB";"RIACHAO";1;1;5;7
2009;"RIACHAO DO BACAMARTE (PB)";"PB";"RIACHAO DO BACAMARTE";8;0;3;11
2009;"RIACHAO DO POCO (PB)";"PB";"RIACHAO DO POCO";8;0;6;14
2009;"RIACHO DE SANTO ANTONIO (PB)";"PB";"RIACHO DE SANTO ANTONIO";9;7;2;18
2009;"RIACHO DOS CAVALOS (PB)";"PB";"RIACHO DOS CAVALOS";16;1;2;19
2009;"RIO TINTO (PB)";"PB";"RIO TINTO";58;4;25;87
2009;"SALGADINHO (PB)";"PB";"SALGADINHO";2;1;1;4
2009;"SALGADO DE SAO FELIX (PB)";"PB";"SALGADO DE SAO FELIX";14;3;0;17
2009;"SANTA CECILIA (PB)";"PB";"SANTA CECILIA";14;0;4;18
2009;"SANTA CRUZ (PB)";"PB";"SANTA CRUZ";11;4;5;20
2009;"SANTA HELENA (PB)";"PB";"SANTA HELENA";7;0;5;12
2009;"SANTA INES (PB)";"PB";"SANTA INES";10;1;0;11
2009;"SANTA LUZIA (PB)";"PB";"SANTA LUZIA";171;18;12;201
2009;"SANTA RITA (PB)";"PB";"SANTA RITA";537;46;185;768
2009;"SANTA TERESINHA (PB)";"PB";"SANTA TERESINHA";19;1;5;25
2009;"SANTANA DE MANGUEIRA (PB)";"PB";"SANTANA DE MANGUEIRA";3;0;1;4
2009;"SANTANA DOS GARROTES (PB)";"PB";"SANTANA DOS GARROTES";16;4;0;20
2009;"SANTAREM (PB)";"PB";"SANTAREM";2;0;1;3
2009;"SANTO ANDRE (PB)";"PB";"SANTO ANDRE";14;6;9;29
2009;"SAO BENTO (PB)";"PB";"SAO BENTO";217;18;12;247
2009;"SAO BENTO DE POMBAL (PB)";"PB";"SAO BENTO DE POMBAL";10;2;1;13
2009;"SAO DOMINGOS DE POMBAL (PB)";"PB";"SAO DOMINGOS DE POMBAL";3;1;2;6
2009;"SAO DOMINGOS DO CARIRI (PB)";"PB";"SAO DOMINGOS DO CARIRI";8;0;1;9
2009;"SAO FRANCISCO (PB)";"PB";"SAO FRANCISCO";9;0;4;13
2009;"SAO JOAO DO CARIRI (PB)";"PB";"SAO JOAO DO CARIRI";15;4;3;22
2009;"SAO JOAO DO RIO DO PEIXE (PB)";"PB";"SAO JOAO DO RIO DO PEIXE";31;1;13;45
2009;"SAO JOAO DO TIGRE (PB)";"PB";"SAO JOAO DO TIGRE";8;2;1;11
2009;"SAO JOSE DA LAGOA TAPADA (PB)";"PB";"SAO JOSE DA LAGOA TAPADA";10;4;3;17
2009;"SAO JOSE DE CAIANA (PB)";"PB";"SAO JOSE DE CAIANA";3;3;2;8
2009;"SAO JOSE DE ESPINHARAS (PB)";"PB";"SAO JOSE DE ESPINHARAS";12;2;2;16
2009;"SAO JOSE DE PIRANHAS (PB)";"PB";"SAO JOSE DE PIRANHAS";33;6;3;42
2009;"SAO JOSE DE PRINCESA (PB)";"PB";"SAO JOSE DE PRINCESA";3;1;1;5
2009;"SAO JOSE DO BONFIM (PB)";"PB";"SAO JOSE DO BONFIM";6;0;3;9
2009;"SAO JOSE DO BREJO DO CRUZ (PB)";"PB";"SAO JOSE DO BREJO DO CRUZ";1;1;1;3
2009;"SAO JOSE DO SABUGI (PB)";"PB";"SAO JOSE DO SABUGI";16;2;1;19
2009;"SAO JOSE DOS CORDEIROS (PB)";"PB";"SAO JOSE DOS CORDEIROS";5;2;2;9
2009;"SAO JOSE DOS RAMOS (PB)";"PB";"SAO JOSE DOS RAMOS";18;1;6;25
2009;"SAO MAMEDE (PB)";"PB";"SAO MAMEDE";16;1;1;18
2009;"SAO MIGUEL DE TAIPU (PB)";"PB";"SAO MIGUEL DE TAIPU";12;0;4;16
2009;"SAO SEBASTIAO DE LAGOA DE ROCA (PB)";"PB";"SAO SEBASTIAO DE LAGOA DE ROCA";43;9;5;57
2009;"SAO SEBASTIAO DO UMBUZEIRO (PB)";"PB";"SAO SEBASTIAO DO UMBUZEIRO";8;0;4;12
2009;"SAPE (PB)";"PB";"SAPE";292;19;73;384
2009;"SERIDO (PB)";"PB";"SERIDO";10;6;4;20
2009;"SERRA BRANCA (PB)";"PB";"SERRA BRANCA";65;14;7;86
2009;"SERRA DA RAIZ (PB)";"PB";"SERRA DA RAIZ";4;0;4;8
2009;"SERRA GRANDE (PB)";"PB";"SERRA GRANDE";3;0;1;4
2009;"SERRA REDONDA (PB)";"PB";"SERRA REDONDA";16;5;2;23
2009;"SERRARIA (PB)";"PB";"SERRARIA";11;4;4;19
2009;"SERTAOZINHO (PB)";"PB";"SERTAOZINHO";3;0;5;8
2009;"SOBRADO (PB)";"PB";"SOBRADO";29;3;4;36
2009;"SOLANEA (PB)";"PB";"SOLANEA";148;20;26;194
2009;"SOLEDADE (PB)";"PB";"SOLEDADE";111;16;11;138
2009;"SOSSEGO (PB)";"PB";"SOSSEGO";20;3;2;25
2009;"SOUSA (PB)";"PB";"SOUSA";570;26;47;643
2009;"SUME (PB)";"PB";"SUME";61;14;15;90
2009;"TACIMA (PB)";"PB";"TACIMA";24;3;15;42
2009;"TAPEROA (PB)";"PB";"TAPEROA";55;6;2;63
2009;"TAVARES (PB)";"PB";"TAVARES";19;6;4;29
2009;"TEIXEIRA (PB)";"PB";"TEIXEIRA";83;9;14;106
2009;"TENORIO (PB)";"PB";"TENORIO";12;1;2;15
2009;"TRIUNFO (PB)";"PB";"TRIUNFO";7;3;2;12
2009;"UIRAUNA (PB)";"PB";"UIRAUNA";49;6;4;59
2009;"UMBUZEIRO (PB)";"PB";"UMBUZEIRO";52;25;21;98
2009;"VARZEA (PB)";"PB";"VARZEA";6;3;3;12
2009;"VIEIROPOLIS (PB)";"PB";"VIEIROPOLIS";11;1;4;16
2009;"VISTA SERRANA (PB)";"PB";"VISTA SERRANA";16;0;3;19
2009;"ZABELE (PB)";"PB";"ZABELE";4;1;0;5
2009;"ABREU E LIMA (PE)";"PE";"ABREU E LIMA";413;30;302;745
2009;"AFOGADOS DA INGAZEIRA (PE)";"PE";"AFOGADOS DA INGAZEIRA";258;27;30;315
2009;"AFRANIO (PE)";"PE";"AFRANIO";85;7;5;97
2009;"AGRESTINA (PE)";"PE";"AGRESTINA";120;18;15;153
2009;"AGUA PRETA (PE)";"PE";"AGUA PRETA";123;27;32;182
2009;"AGUAS BELAS (PE)";"PE";"AGUAS BELAS";221;47;35;303
2009;"ALAGOINHA (PE)";"PE";"ALAGOINHA";71;12;8;91
2009;"ALIANCA (PE)";"PE";"ALIANCA";104;3;81;188
2009;"ALTINHO (PE)";"PE";"ALTINHO";57;18;17;92
2009;"AMARAJI (PE)";"PE";"AMARAJI";65;16;23;104
2009;"ANGELIM (PE)";"PE";"ANGELIM";37;7;3;47
2009;"ARACOIABA (PE)";"PE";"ARACOIABA";64;8;56;128
2009;"ARARIPINA (PE)";"PE";"ARARIPINA";1030;25;49;1104
2009;"ARCOVERDE (PE)";"PE";"ARCOVERDE";841;78;95;1014
2009;"BARRA DE GUABIRABA (PE)";"PE";"BARRA DE GUABIRABA";57;12;6;75
2009;"BARREIROS (PE)";"PE";"BARREIROS";213;13;34;260
2009;"BELEM DE MARIA (PE)";"PE";"BELEM DE MARIA";65;11;11;87
2009;"BELEM DE SAO FRANCISCO (PE)";"PE";"BELEM DE SAO FRANCISCO";81;8;8;97
2009;"BELO JARDIM (PE)";"PE";"BELO JARDIM";513;101;48;662
2009;"BETANIA (PE)";"PE";"BETANIA";30;4;3;37
2009;"BEZERROS (PE)";"PE";"BEZERROS";565;61;42;668
2009;"BODOCO (PE)";"PE";"BODOCO";154;2;5;161
2009;"BOM CONSELHO (PE)";"PE";"BOM CONSELHO";259;34;26;319
2009;"BOM JARDIM (PE)";"PE";"BOM JARDIM";125;164;27;316
2009;"BONITO (PE)";"PE";"BONITO";246;43;16;305
2009;"BREJAO (PE)";"PE";"BREJAO";29;5;7;41
2009;"BREJINHO (PE)";"PE";"BREJINHO";23;2;3;28
2009;"BREJO DA MADRE DE DEUS (PE)";"PE";"BREJO DA MADRE DE DEUS";169;234;7;410
2009;"BUENOS AIRES (PE)";"PE";"BUENOS AIRES";42;2;9;53
2009;"BUIQUE (PE)";"PE";"BUIQUE";223;37;23;283
2009;"CABO DE SANTO AGOSTINHO (PE)";"PE";"CABO DE SANTO AGOSTINHO";1038;157;292;1487
2009;"CABROBO (PE)";"PE";"CABROBO";197;8;8;213
2009;"CACHOEIRINHA (PE)";"PE";"CACHOEIRINHA";114;15;7;136
2009;"CAETES (PE)";"PE";"CAETES";199;28;9;236
2009;"CALCADO (PE)";"PE";"CALCADO";48;5;16;69
2009;"CALUMBI (PE)";"PE";"CALUMBI";42;4;4;50
2009;"CAMARAGIBE (PE)";"PE";"CAMARAGIBE";614;196;96;906
2009;"CAMOCIM DE SAO FELIX (PE)";"PE";"CAMOCIM DE SAO FELIX";117;13;6;136
2009;"CAMUTANGA (PE)";"PE";"CAMUTANGA";65;0;13;78
2009;"CANHOTINHO (PE)";"PE";"CANHOTINHO";178;32;6;216
2009;"CAPOEIRAS (PE)";"PE";"CAPOEIRAS";160;23;1;184
2009;"CARNAIBA (PE)";"PE";"CARNAIBA";55;15;5;75
2009;"CARNAUBEIRA DA PENHA (PE)";"PE";"CARNAUBEIRA DA PENHA";29;3;0;32
2009;"CARPINA (PE)";"PE";"CARPINA";734;80;104;918
2009;"CARUARU (PE)";"PE";"CARUARU";3386;478;425;4289
2009;"CASINHAS (PE)";"PE";"CASINHAS";32;125;6;163
2009;"CATENDE (PE)";"PE";"CATENDE";171;26;38;235
2009;"CEDRO (PE)";"PE";"CEDRO";31;5;7;43
2009;"CHA DE ALEGRIA (PE)";"PE";"CHA DE ALEGRIA";36;6;17;59
2009;"CHA GRANDE (PE)";"PE";"CHA GRANDE";208;26;13;247
2009;"CONDADO (PE)";"PE";"CONDADO";112;5;54;171
2009;"CORRENTES (PE)";"PE";"CORRENTES";61;25;5;91
2009;"CORTES (PE)";"PE";"CORTES";150;21;24;195
2009;"CUMARU (PE)";"PE";"CUMARU";79;38;10;127
2009;"CUPIRA (PE)";"PE";"CUPIRA";211;35;13;259
2009;"CUSTODIA (PE)";"PE";"CUSTODIA";259;30;11;300
2009;"DORMENTES (PE)";"PE";"DORMENTES";112;3;5;120
2009;"ESCADA (PE)";"PE";"ESCADA";295;38;112;445
2009;"EXU (PE)";"PE";"EXU";256;5;19;280
2009;"FEIRA NOVA (PE)";"PE";"FEIRA NOVA";152;17;6;175
2009;"FERNANDO DE NORONHA (PE)";"PE";"FERNANDO DE NORONHA";16;16;14;46
2009;"FERREIROS (PE)";"PE";"FERREIROS";43;2;37;82
2009;"FLORES (PE)";"PE";"FLORES";53;7;3;63
2009;"FLORESTA (PE)";"PE";"FLORESTA";351;2;4;357
2009;"FREI MIGUELINHO (PE)";"PE";"FREI MIGUELINHO";107;121;14;242
2009;"GAMELEIRA (PE)";"PE";"GAMELEIRA";65;6;41;112
2009;"GARANHUNS (PE)";"PE";"GARANHUNS";1473;141;86;1700
2009;"GLORIA DO GOITA (PE)";"PE";"GLORIA DO GOITA";126;25;20;171
2009;"GOIANA (PE)";"PE";"GOIANA";631;41;120;792
2009;"GRANITO (PE)";"PE";"GRANITO";18;1;4;23
2009;"GRAVATA (PE)";"PE";"GRAVATA";737;73;39;849
2009;"IATI (PE)";"PE";"IATI";30;17;12;59
2009;"IBIMIRIM (PE)";"PE";"IBIMIRIM";159;22;4;185
2009;"IBIRAJUBA (PE)";"PE";"IBIRAJUBA";41;0;3;44
2009;"IGARASSU (PE)";"PE";"IGARASSU";670;39;385;1094
2009;"IGUARACI (PE)";"PE";"IGUARACI";75;10;15;100
2009;"ILHA DE ITAMARACA (PE)";"PE";"ILHA DE ITAMARACA";56;9;6;71
2009;"INAJA (PE)";"PE";"INAJA";38;1;4;43
2009;"INGAZEIRA (PE)";"PE";"INGAZEIRA";16;1;1;18
2009;"IPOJUCA (PE)";"PE";"IPOJUCA";458;174;161;793
2009;"IPUBI (PE)";"PE";"IPUBI";157;9;16;182
2009;"ITACURUBA (PE)";"PE";"ITACURUBA";16;1;4;21
2009;"ITAIBA (PE)";"PE";"ITAIBA";85;15;3;103
2009;"ITAMBE (PE)";"PE";"ITAMBE";298;9;97;404
2009;"ITAPETIM (PE)";"PE";"ITAPETIM";36;1;4;41
2009;"ITAPISSUMA (PE)";"PE";"ITAPISSUMA";65;34;10;109
2009;"ITAQUITINGA (PE)";"PE";"ITAQUITINGA";32;5;23;60
2009;"JABOATAO DOS GUARARAPES (PE)";"PE";"JABOATAO DOS GUARARAPES";4140;729;1627;6496
2009;"JAQUEIRA (PE)";"PE";"JAQUEIRA";52;3;13;68
2009;"JATAUBA (PE)";"PE";"JATAUBA";56;112;5;173
2009;"JATOBA (PE)";"PE";"JATOBA";25;3;4;32
2009;"JOAO ALFREDO (PE)";"PE";"JOAO ALFREDO";170;403;6;579
2009;"JOAQUIM NABUCO (PE)";"PE";"JOAQUIM NABUCO";92;12;35;139
2009;"JUCATI (PE)";"PE";"JUCATI";98;5;7;110
2009;"JUPI (PE)";"PE";"JUPI";128;14;15;157
2009;"JUREMA (PE)";"PE";"JUREMA";64;10;3;77
2009;"LAGOA DO CARRO (PE)";"PE";"LAGOA DO CARRO";61;11;11;83
2009;"LAGOA DO ITAENGA (PE)";"PE";"LAGOA DO ITAENGA";250;18;46;314
2009;"LAGOA DO OURO (PE)";"PE";"LAGOA DO OURO";34;18;3;55
2009;"LAGOA DOS GATOS (PE)";"PE";"LAGOA DOS GATOS";84;11;4;99
2009;"LAGOA GRANDE (PE)";"PE";"LAGOA GRANDE";76;9;12;97
2009;"LAJEDO (PE)";"PE";"LAJEDO";437;33;32;502
2009;"LIMOEIRO (PE)";"PE";"LIMOEIRO";394;83;41;518
2009;"MACAPARANA (PE)";"PE";"MACAPARANA";133;8;31;172
2009;"MACHADOS (PE)";"PE";"MACHADOS";82;22;7;111
2009;"MANARI (PE)";"PE";"MANARI";28;2;3;33
2009;"MARAIAL (PE)";"PE";"MARAIAL";125;4;11;140
2009;"MIRANDIBA (PE)";"PE";"MIRANDIBA";85;4;1;90
2009;"MOREILANDIA (PE)";"PE";"MOREILANDIA";38;0;2;40
2009;"MORENO (PE)";"PE";"MORENO";453;69;200;722
2009;"NAZARE DA MATA (PE)";"PE";"NAZARE DA MATA";190;12;31;233
2009;"OLINDA (PE)";"PE";"OLINDA";2302;301;1106;3709
2009;"OROBO (PE)";"PE";"OROBO";94;127;28;249
2009;"OROCO (PE)";"PE";"OROCO";43;1;6;50
2009;"OURICURI (PE)";"PE";"OURICURI";462;18;55;535
2009;"PALMARES (PE)";"PE";"PALMARES";464;44;149;657
2009;"PALMEIRINA (PE)";"PE";"PALMEIRINA";17;11;1;29
2009;"PANELAS (PE)";"PE";"PANELAS";76;22;5;103
2009;"PARANATAMA (PE)";"PE";"PARANATAMA";39;10;9;58
2009;"PARNAMIRIM (PE)";"PE";"PARNAMIRIM";124;3;8;135
2009;"PASSIRA (PE)";"PE";"PASSIRA";179;46;16;241
2009;"PAUDALHO (PE)";"PE";"PAUDALHO";399;21;42;462
2009;"PAULISTA (PE)";"PE";"PAULISTA";1150;181;256;1587
2009;"PEDRA (PE)";"PE";"PEDRA";104;20;9;133
2009;"PESQUEIRA (PE)";"PE";"PESQUEIRA";486;50;83;619
2009;"PETROLANDIA (PE)";"PE";"PETROLANDIA";183;3;19;205
2009;"PETROLINA (PE)";"PE";"PETROLINA";2455;186;272;2913
2009;"POCAO (PE)";"PE";"POCAO";40;18;4;62
2009;"POMBOS (PE)";"PE";"POMBOS";320;31;22;373
2009;"PRIMAVERA (PE)";"PE";"PRIMAVERA";65;9;27;101
2009;"QUIPAPA (PE)";"PE";"QUIPAPA";76;13;24;113
2009;"QUIXABA (PE)";"PE";"QUIXABA";22;5;2;29
2009;"RECIFE (PE)";"PE";"RECIFE";14740;1578;3094;19412
2009;"RIACHO DAS ALMAS (PE)";"PE";"RIACHO DAS ALMAS";184;62;18;264
2009;"RIBEIRAO (PE)";"PE";"RIBEIRAO";237;32;73;342
2009;"RIO FORMOSO (PE)";"PE";"RIO FORMOSO";95;10;50;155
2009;"SAIRE (PE)";"PE";"SAIRE";72;8;17;97
2009;"SALGADINHO (PE)";"PE";"SALGADINHO";15;23;3;41
2009;"SALGUEIRO (PE)";"PE";"SALGUEIRO";424;22;43;489
2009;"SALOA (PE)";"PE";"SALOA";53;13;2;68
2009;"SANHARO (PE)";"PE";"SANHARO";69;9;20;98
2009;"SANTA CRUZ (PE)";"PE";"SANTA CRUZ";102;3;5;110
2009;"SANTA CRUZ DA BAIXA VERDE (PE)";"PE";"SANTA CRUZ DA BAIXA VERDE";184;1;2;187
2009;"SANTA CRUZ DO CAPIBARIBE (PE)";"PE";"SANTA CRUZ DO CAPIBARIBE";592;281;33;906
2009;"SANTA FILOMENA (PE)";"PE";"SANTA FILOMENA";41;0;12;53
2009;"SANTA MARIA DA BOA VISTA (PE)";"PE";"SANTA MARIA DA BOA VISTA";149;5;30;184
2009;"SANTA MARIA DO CAMBUCA (PE)";"PE";"SANTA MARIA DO CAMBUCA";115;90;10;215
2009;"SANTA TEREZINHA (PE)";"PE";"SANTA TEREZINHA";28;4;4;36
2009;"SAO BENEDITO DO SUL (PE)";"PE";"SAO BENEDITO DO SUL";23;4;6;33
2009;"SAO BENTO DO UNA (PE)";"PE";"SAO BENTO DO UNA";576;31;54;661
2009;"SAO CAITANO (PE)";"PE";"SAO CAITANO";234;53;30;317
2009;"SAO JOAO (PE)";"PE";"SAO JOAO";89;18;8;115
2009;"SAO JOAQUIM DO MONTE (PE)";"PE";"SAO JOAQUIM DO MONTE";53;8;15;76
2009;"SAO JOSE DA COROA GRANDE (PE)";"PE";"SAO JOSE DA COROA GRANDE";52;5;14;71
2009;"SAO JOSE DO BELMONTE (PE)";"PE";"SAO JOSE DO BELMONTE";217;14;17;248
2009;"SAO JOSE DO EGITO (PE)";"PE";"SAO JOSE DO EGITO";383;24;43;450
2009;"SAO LOURENCO DA MATA (PE)";"PE";"SAO LOURENCO DA MATA";282;25;274;581
2009;"SAO VICENTE FERRER (PE)";"PE";"SAO VICENTE FERRER";111;6;11;128
2009;"SERRA TALHADA (PE)";"PE";"SERRA TALHADA";1195;41;38;1274
2009;"SERRITA (PE)";"PE";"SERRITA";70;3;4;77
2009;"SERTANIA (PE)";"PE";"SERTANIA";314;16;27;357
2009;"SIRINHAEM (PE)";"PE";"SIRINHAEM";170;8;41;219
2009;"SOLIDAO (PE)";"PE";"SOLIDAO";18;2;1;21
2009;"SURUBIM (PE)";"PE";"SURUBIM";533;468;39;1040
2009;"TABIRA (PE)";"PE";"TABIRA";146;16;12;174
2009;"TACAIMBO (PE)";"PE";"TACAIMBO";67;11;15;93
2009;"TACARATU (PE)";"PE";"TACARATU";38;11;4;53
2009;"TAMANDARE (PE)";"PE";"TAMANDARE";52;8;11;71
2009;"TAQUARITINGA DO NORTE (PE)";"PE";"TAQUARITINGA DO NORTE";132;76;9;217
2009;"TEREZINHA (PE)";"PE";"TEREZINHA";22;3;3;28
2009;"TERRA NOVA (PE)";"PE";"TERRA NOVA";79;0;3;82
2009;"TIMBAUBA (PE)";"PE";"TIMBAUBA";616;28;60;704
2009;"TORITAMA (PE)";"PE";"TORITAMA";173;47;19;239
2009;"TRACUNHAEM (PE)";"PE";"TRACUNHAEM";43;13;14;70
2009;"TRINDADE (PE)";"PE";"TRINDADE";251;15;8;274
2009;"TRIUNFO (PE)";"PE";"TRIUNFO";156;8;6;170
2009;"TUPANATINGA (PE)";"PE";"TUPANATINGA";105;16;4;125
2009;"TUPARETAMA (PE)";"PE";"TUPARETAMA";77;16;15;108
2009;"VENTUROSA (PE)";"PE";"VENTUROSA";109;19;6;134
2009;"VERDEJANTE (PE)";"PE";"VERDEJANTE";52;1;10;63
2009;"VERTENTE DO LERIO (PE)";"PE";"VERTENTE DO LERIO";57;63;5;125
2009;"VERTENTES (PE)";"PE";"VERTENTES";107;59;17;183
2009;"VICENCIA (PE)";"PE";"VICENCIA";216;11;56;283
2009;"VITORIA DE SANTO ANTAO (PE)";"PE";"VITORIA DE SANTO ANTAO";1793;76;252;2121
2009;"XEXEU (PE)";"PE";"XEXEU";56;2;24;82
2009;"ACAUA (PI)";"PI";"ACAUA";11;1;2;14
2009;"AGRICOLANDIA (PI)";"PI";"AGRICOLANDIA";10;0;7;17
2009;"AGUA BRANCA (PI)";"PI";"AGUA BRANCA";79;10;7;96
2009;"ALAGOINHA DO PIAUI (PI)";"PI";"ALAGOINHA DO PIAUI";13;1;2;16
2009;"ALEGRETE DO PIAUI (PI)";"PI";"ALEGRETE DO PIAUI";4;0;1;5
2009;"ALTO LONGA (PI)";"PI";"ALTO LONGA";22;3;8;33
2009;"ALTOS (PI)";"PI";"ALTOS";164;5;18;187
2009;"ALVORADA DO GURGUEIA (PI)";"PI";"ALVORADA DO GURGUEIA";8;2;3;13
2009;"AMARANTE (PI)";"PI";"AMARANTE";43;6;9;58
2009;"ANGICAL DO PIAUI (PI)";"PI";"ANGICAL DO PIAUI";12;0;1;13
2009;"ANISIO DE ABREU (PI)";"PI";"ANISIO DE ABREU";5;6;3;14
2009;"ANTONIO ALMEIDA (PI)";"PI";"ANTONIO ALMEIDA";11;1;2;14
2009;"AROAZES (PI)";"PI";"AROAZES";10;2;3;15
2009;"AROEIRAS DO ITAIM (PI)";"PI";"AROEIRAS DO ITAIM";5;0;5;10
2009;"ARRAIAL (PI)";"PI";"ARRAIAL";4;0;2;6
2009;"ASSUNCAO DO PIAUI (PI)";"PI";"ASSUNCAO DO PIAUI";2;0;1;3
2009;"AVELINO LOPES (PI)";"PI";"AVELINO LOPES";10;4;1;15
2009;"BAIXA GRANDE DO RIBEIRO (PI)";"PI";"BAIXA GRANDE DO RIBEIRO";19;0;1;20
2009;"BARRA D ALCANTARA (PI)";"PI";"BARRA D ALCANTARA";11;1;0;12
2009;"BARRAS (PI)";"PI";"BARRAS";89;7;24;120
2009;"BARREIRAS DO PIAUI (PI)";"PI";"BARREIRAS DO PIAUI";3;0;0;3
2009;"BARRO DURO (PI)";"PI";"BARRO DURO";35;3;2;40
2009;"BATALHA (PI)";"PI";"BATALHA";52;2;7;61
2009;"BELA VISTA DO PIAUI (PI)";"PI";"BELA VISTA DO PIAUI";2;0;1;3
2009;"BELEM DO PIAUI (PI)";"PI";"BELEM DO PIAUI";2;0;0;2
2009;"BENEDITINOS (PI)";"PI";"BENEDITINOS";16;1;7;24
2009;"BERTOLINIA (PI)";"PI";"BERTOLINIA";14;2;1;17
2009;"BETANIA DO PIAUI (PI)";"PI";"BETANIA DO PIAUI";7;4;2;13
2009;"BOA HORA (PI)";"PI";"BOA HORA";9;0;2;11
2009;"BOCAINA (PI)";"PI";"BOCAINA";6;4;1;11
2009;"BOM JESUS (PI)";"PI";"BOM JESUS";150;0;8;158
2009;"BOM PRINCIPIO DO PIAUI (PI)";"PI";"BOM PRINCIPIO DO PIAUI";4;4;2;10
2009;"BONFIM DO PIAUI (PI)";"PI";"BONFIM DO PIAUI";3;2;2;7
2009;"BOQUEIRAO DO PIAUI (PI)";"PI";"BOQUEIRAO DO PIAUI";7;0;0;7
2009;"BRASILEIRA (PI)";"PI";"BRASILEIRA";13;0;5;18
2009;"BREJO DO PIAUI (PI)";"PI";"BREJO DO PIAUI";3;3;0;6
2009;"BURITI DOS LOPES (PI)";"PI";"BURITI DOS LOPES";19;3;10;32
2009;"BURITI DOS MONTES (PI)";"PI";"BURITI DOS MONTES";8;3;2;13
2009;"CABECEIRAS DO PIAUI (PI)";"PI";"CABECEIRAS DO PIAUI";6;1;7;14
2009;"CAJAZEIRAS DO PIAUI (PI)";"PI";"CAJAZEIRAS DO PIAUI";2;0;0;2
2009;"CAJUEIRO DA PRAIA (PI)";"PI";"CAJUEIRO DA PRAIA";6;1;4;11
2009;"CALDEIRAO GRANDE DO PIAUI (PI)";"PI";"CALDEIRAO GRANDE DO PIAUI";6;3;2;11
2009;"CAMPINAS DO PIAUI (PI)";"PI";"CAMPINAS DO PIAUI";1;0;1;2
2009;"CAMPO ALEGRE DO FIDALGO (PI)";"PI";"CAMPO ALEGRE DO FIDALGO";2;1;0;3
2009;"CAMPO GRANDE DO PIAUI (PI)";"PI";"CAMPO GRANDE DO PIAUI";15;4;0;19
2009;"CAMPO LARGO DO PIAUI (PI)";"PI";"CAMPO LARGO DO PIAUI";1;2;0;3
2009;"CAMPO MAIOR (PI)";"PI";"CAMPO MAIOR";311;12;43;366
2009;"CANAVIEIRA (PI)";"PI";"CANAVIEIRA";0;0;0;0
2009;"CANTO DO BURITI (PI)";"PI";"CANTO DO BURITI";69;8;5;82
2009;"CAPITAO DE CAMPOS (PI)";"PI";"CAPITAO DE CAMPOS";12;1;9;22
2009;"CAPITAO GERVASIO OLIVEIRA (PI)";"PI";"CAPITAO GERVASIO OLIVEIRA";1;0;3;4
2009;"CARACOL (PI)";"PI";"CARACOL";16;2;0;18
2009;"CARAUBAS DO PIAUI (PI)";"PI";"CARAUBAS DO PIAUI";9;1;1;11
2009;"CARIDADE DO PIAUI (PI)";"PI";"CARIDADE DO PIAUI";4;0;2;6
2009;"CASTELO DO PIAUI (PI)";"PI";"CASTELO DO PIAUI";43;1;3;47
2009;"CAXINGO (PI)";"PI";"CAXINGO";6;1;4;11
2009;"COCAL (PI)";"PI";"COCAL";36;4;9;49
2009;"COCAL DE TELHA (PI)";"PI";"COCAL DE TELHA";5;1;2;8
2009;"COCAL DOS ALVES (PI)";"PI";"COCAL DOS ALVES";0;2;0;2
2009;"COIVARAS (PI)";"PI";"COIVARAS";5;0;4;9
2009;"COLONIA DO GURGUEIA (PI)";"PI";"COLONIA DO GURGUEIA";3;4;0;7
2009;"COLONIA DO PIAUI (PI)";"PI";"COLONIA DO PIAUI";5;1;2;8
2009;"CONCEICAO DO CANINDE (PI)";"PI";"CONCEICAO DO CANINDE";4;1;0;5
2009;"CORONEL JOSE DIAS (PI)";"PI";"CORONEL JOSE DIAS";3;0;0;3
2009;"CORRENTE (PI)";"PI";"CORRENTE";59;5;3;67
2009;"CRISTALANDIA DO PIAUI (PI)";"PI";"CRISTALANDIA DO PIAUI";4;0;1;5
2009;"CRISTINO CASTRO (PI)";"PI";"CRISTINO CASTRO";23;3;5;31
2009;"CURIMATA (PI)";"PI";"CURIMATA";8;1;1;10
2009;"CURRAIS (PI)";"PI";"CURRAIS";0;1;0;1
2009;"CURRAL NOVO DO PIAUI (PI)";"PI";"CURRAL NOVO DO PIAUI";0;1;1;2
2009;"CURRALINHOS (PI)";"PI";"CURRALINHOS";3;0;1;4
2009;"DEMERVAL LOBAO (PI)";"PI";"DEMERVAL LOBAO";39;7;2;48
2009;"DIRCEU ARCOVERDE (PI)";"PI";"DIRCEU ARCOVERDE";7;1;1;9
2009;"DOM EXPEDITO LOPES (PI)";"PI";"DOM EXPEDITO LOPES";72;2;2;76
2009;"DOM INOCENCIO (PI)";"PI";"DOM INOCENCIO";10;3;3;16
2009;"DOMINGOS MOURAO (PI)";"PI";"DOMINGOS MOURAO";1;0;1;2
2009;"ELESBAO VELOSO (PI)";"PI";"ELESBAO VELOSO";44;1;5;50
2009;"ELISEU MARTINS (PI)";"PI";"ELISEU MARTINS";6;1;1;8
2009;"ESPERANTINA (PI)";"PI";"ESPERANTINA";127;12;21;160
2009;"FARTURA DO PIAUI (PI)";"PI";"FARTURA DO PIAUI";4;0;1;5
2009;"FLORES DO PIAUI (PI)";"PI";"FLORES DO PIAUI";2;2;0;4
2009;"FLORESTA DO PIAUI (PI)";"PI";"FLORESTA DO PIAUI";2;1;2;5
2009;"FLORIANO (PI)";"PI";"FLORIANO";970;54;36;1060
2009;"FRANCINOPOLIS (PI)";"PI";"FRANCINOPOLIS";8;4;0;12
2009;"FRANCISCO AYRES (PI)";"PI";"FRANCISCO AYRES";4;6;3;13
2009;"FRANCISCO MACEDO (PI)";"PI";"FRANCISCO MACEDO";2;2;2;6
2009;"FRANCISCO SANTOS (PI)";"PI";"FRANCISCO SANTOS";54;6;2;62
2009;"FRONTEIRAS (PI)";"PI";"FRONTEIRAS";51;7;11;69
2009;"GEMINIANO (PI)";"PI";"GEMINIANO";14;5;7;26
2009;"GILBUES (PI)";"PI";"GILBUES";7;1;4;12
2009;"GUADALUPE (PI)";"PI";"GUADALUPE";47;7;5;59
2009;"GUARIBAS (PI)";"PI";"GUARIBAS";1;0;1;2
2009;"HUGO NAPOLEAO (PI)";"PI";"HUGO NAPOLEAO";5;1;1;7
2009;"ILHA GRANDE (PI)";"PI";"ILHA GRANDE";10;3;1;14
2009;"INHUMA (PI)";"PI";"INHUMA";53;5;11;69
2009;"IPIRANGA DO PIAUI (PI)";"PI";"IPIRANGA DO PIAUI";38;9;3;50
2009;"ISAIAS COELHO (PI)";"PI";"ISAIAS COELHO";4;0;2;6
2009;"ITAINOPOLIS (PI)";"PI";"ITAINOPOLIS";24;18;6;48
2009;"ITAUEIRA (PI)";"PI";"ITAUEIRA";22;4;1;27
2009;"JACOBINA DO PIAUI (PI)";"PI";"JACOBINA DO PIAUI";15;2;1;18
2009;"JAICOS (PI)";"PI";"JAICOS";62;9;3;74
2009;"JARDIM DO MULATO (PI)";"PI";"JARDIM DO MULATO";3;1;0;4
2009;"JATOBA DO PIAUI (PI)";"PI";"JATOBA DO PIAUI";21;0;2;23
2009;"JERUMENHA (PI)";"PI";"JERUMENHA";9;1;0;10
2009;"JOAO COSTA (PI)";"PI";"JOAO COSTA";2;0;0;2
2009;"JOAQUIM PIRES (PI)";"PI";"JOAQUIM PIRES";13;0;0;13
2009;"JOCA MARQUES (PI)";"PI";"JOCA MARQUES";1;0;2;3
2009;"JOSE DE FREITAS (PI)";"PI";"JOSE DE FREITAS";56;5;13;74
2009;"JUAZEIRO DO PIAUI (PI)";"PI";"JUAZEIRO DO PIAUI";6;0;0;6
2009;"JULIO BORGES (PI)";"PI";"JULIO BORGES";1;1;0;2
2009;"JUREMA (PI)";"PI";"JUREMA";2;2;1;5
2009;"LAGOA ALEGRE (PI)";"PI";"LAGOA ALEGRE";3;1;3;7
2009;"LAGOA DE SAO FRANCISCO (PI)";"PI";"LAGOA DE SAO FRANCISCO";2;0;0;2
2009;"LAGOA DO BARRO DO PIAUI (PI)";"PI";"LAGOA DO BARRO DO PIAUI";1;0;5;6
2009;"LAGOA DO PIAUI (PI)";"PI";"LAGOA DO PIAUI";8;0;0;8
2009;"LAGOA DO SITIO (PI)";"PI";"LAGOA DO SITIO";9;1;1;11
2009;"LAGOINHA DO PIAUI (PI)";"PI";"LAGOINHA DO PIAUI";3;2;2;7
2009;"LANDRI SALES (PI)";"PI";"LANDRI SALES";2;5;1;8
2009;"LUIS CORREIA (PI)";"PI";"LUIS CORREIA";28;10;16;54
2009;"LUZILANDIA (PI)";"PI";"LUZILANDIA";20;1;6;27
2009;"MADEIRO (PI)";"PI";"MADEIRO";4;2;1;7
2009;"MANOEL EMIDIO (PI)";"PI";"MANOEL EMIDIO";5;1;2;8
2009;"MARCOLANDIA (PI)";"PI";"MARCOLANDIA";53;10;6;69
2009;"MARCOS PARENTE (PI)";"PI";"MARCOS PARENTE";3;5;0;8
2009;"MASSAPE DO PIAUI (PI)";"PI";"MASSAPE DO PIAUI";2;1;0;3
2009;"MATIAS OLIMPIO (PI)";"PI";"MATIAS OLIMPIO";13;6;5;24
2009;"MIGUEL ALVES (PI)";"PI";"MIGUEL ALVES";23;1;9;33
2009;"MIGUEL LEAO (PI)";"PI";"MIGUEL LEAO";2;0;0;2
2009;"MILTON BRANDAO (PI)";"PI";"MILTON BRANDAO";3;0;0;3
2009;"MONSENHOR GIL (PI)";"PI";"MONSENHOR GIL";13;0;1;14
2009;"MONSENHOR HIPOLITO (PI)";"PI";"MONSENHOR HIPOLITO";14;9;1;24
2009;"MONTE ALEGRE DO PIAUI (PI)";"PI";"MONTE ALEGRE DO PIAUI";5;1;1;7
2009;"MORRO CABECA NO TEMPO (PI)";"PI";"MORRO CABECA NO TEMPO";0;0;0;0
2009;"MORRO DO CHAPEU DO PIAUI (PI)";"PI";"MORRO DO CHAPEU DO PIAUI";3;0;1;4
2009;"MURICI DOS PORTELAS (PI)";"PI";"MURICI DOS PORTELAS";4;1;1;6
2009;"NAZARE DO PIAUI (PI)";"PI";"NAZARE DO PIAUI";11;9;2;22
2009;"NOSSA SENHORA DE NAZARE (PI)";"PI";"NOSSA SENHORA DE NAZARE";3;0;4;7
2009;"NOSSA SENHORA DOS REMEDIOS (PI)";"PI";"NOSSA SENHORA DOS REMEDIOS";1;2;0;3
2009;"NOVA SANTA RITA (PI)";"PI";"NOVA SANTA RITA";1;2;0;3
2009;"NOVO ORIENTE DO PIAUI (PI)";"PI";"NOVO ORIENTE DO PIAUI";8;3;4;15
2009;"NOVO SANTO ANTONIO (PI)";"PI";"NOVO SANTO ANTONIO";7;1;2;10
2009;"OEIRAS (PI)";"PI";"OEIRAS";237;26;20;283
2009;"OLHO D AGUA DO PIAUI (PI)";"PI";"OLHO D AGUA DO PIAUI";3;1;1;5
2009;"PADRE MARCOS (PI)";"PI";"PADRE MARCOS";8;3;2;13
2009;"PAES LANDIM (PI)";"PI";"PAES LANDIM";3;1;0;4
2009;"PAJEU DO PIAUI (PI)";"PI";"PAJEU DO PIAUI";5;2;0;7
2009;"PALMEIRA DO PIAUI (PI)";"PI";"PALMEIRA DO PIAUI";16;1;0;17
2009;"PALMEIRAIS (PI)";"PI";"PALMEIRAIS";13;3;5;21
2009;"PAQUETA (PI)";"PI";"PAQUETA";3;6;2;11
2009;"PARNAGUA (PI)";"PI";"PARNAGUA";4;1;0;5
2009;"PARNAIBA (PI)";"PI";"PARNAIBA";832;95;168;1095
2009;"PASSAGEM FRANCA DO PIAUI (PI)";"PI";"PASSAGEM FRANCA DO PIAUI";2;0;1;3
2009;"PATOS DO PIAUI (PI)";"PI";"PATOS DO PIAUI";10;1;6;17
2009;"PAU D ARCO DO PIAUI (PI)";"PI";"PAU D ARCO DO PIAUI";3;0;2;5
2009;"PAULISTANA (PI)";"PI";"PAULISTANA";83;14;8;105
2009;"PAVUSSU (PI)";"PI";"PAVUSSU";2;2;0;4
2009;"PEDRO II (PI)";"PI";"PEDRO II";51;5;3;59
2009;"PEDRO LAURENTINO (PI)";"PI";"PEDRO LAURENTINO";2;0;0;2
2009;"PICOS (PI)";"PI";"PICOS";1387;101;59;1547
2009;"PIMENTEIRAS (PI)";"PI";"PIMENTEIRAS";24;6;1;31
2009;"PIO IX (PI)";"PI";"PIO IX";19;4;3;26
2009;"PIRACURUCA (PI)";"PI";"PIRACURUCA";141;8;23;172
2009;"PIRIPIRI (PI)";"PI";"PIRIPIRI";249;18;71;338
2009;"PORTO (PI)";"PI";"PORTO";3;2;0;5
2009;"PORTO ALEGRE DO PIAUI (PI)";"PI";"PORTO ALEGRE DO PIAUI";5;3;0;8
2009;"PRATA DO PIAUI (PI)";"PI";"PRATA DO PIAUI";2;1;1;4
2009;"QUEIMADA NOVA (PI)";"PI";"QUEIMADA NOVA";6;1;2;9
2009;"REDENCAO DO GURGUEIA (PI)";"PI";"REDENCAO DO GURGUEIA";7;0;7;14
2009;"REGENERACAO (PI)";"PI";"REGENERACAO";56;5;5;66
2009;"RIACHO FRIO (PI)";"PI";"RIACHO FRIO";2;1;1;4
2009;"RIBEIRA DO PIAUI (PI)";"PI";"RIBEIRA DO PIAUI";2;0;1;3
2009;"RIBEIRO GONCALVES (PI)";"PI";"RIBEIRO GONCALVES";11;0;0;11
2009;"RIO GRANDE DO PIAUI (PI)";"PI";"RIO GRANDE DO PIAUI";12;2;2;16
2009;"SANTA CRUZ DO PIAUI (PI)";"PI";"SANTA CRUZ DO PIAUI";14;8;0;22
2009;"SANTA CRUZ DOS MILAGRES (PI)";"PI";"SANTA CRUZ DOS MILAGRES";2;0;0;2
2009;"SANTA FILOMENA (PI)";"PI";"SANTA FILOMENA";6;1;1;8
2009;"SANTA LUZ (PI)";"PI";"SANTA LUZ";6;0;1;7
2009;"SANTA ROSA DO PIAUI (PI)";"PI";"SANTA ROSA DO PIAUI";4;3;3;10
2009;"SANTANA DO PIAUI (PI)";"PI";"SANTANA DO PIAUI";18;3;5;26
2009;"SANTO ANTONIO DE LISBOA (PI)";"PI";"SANTO ANTONIO DE LISBOA";21;7;4;32
2009;"SANTO ANTONIO DOS MILAGRES (PI)";"PI";"SANTO ANTONIO DOS MILAGRES";1;3;0;4
2009;"SANTO INACIO DO PIAUI (PI)";"PI";"SANTO INACIO DO PIAUI";2;3;0;5
2009;"SAO BRAZ DO PIAUI (PI)";"PI";"SAO BRAZ DO PIAUI";1;1;1;3
2009;"SAO FELIX DO PIAUI (PI)";"PI";"SAO FELIX DO PIAUI";4;1;0;5
2009;"SAO FRANCISCO DE ASSIS DO PIAU (PI)";"PI";"SAO FRANCISCO DE ASSIS DO PIAU";1;0;0;1
2009;"SAO FRANCISCO DO PIAUI (PI)";"PI";"SAO FRANCISCO DO PIAUI";5;1;3;9
2009;"SAO GONCALO DO GURGUEIA (PI)";"PI";"SAO GONCALO DO GURGUEIA";1;1;0;2
2009;"SAO GONCALO DO PIAUI (PI)";"PI";"SAO GONCALO DO PIAUI";4;4;5;13
2009;"SAO JOAO DA CANABRAVA (PI)";"PI";"SAO JOAO DA CANABRAVA";9;5;3;17
2009;"SAO JOAO DA FRONTEIRA (PI)";"PI";"SAO JOAO DA FRONTEIRA";2;1;3;6
2009;"SAO JOAO DA SERRA (PI)";"PI";"SAO JOAO DA SERRA";5;0;0;5
2009;"SAO JOAO DA VARJOTA (PI)";"PI";"SAO JOAO DA VARJOTA";1;2;1;4
2009;"SAO JOAO DO ARRAIAL (PI)";"PI";"SAO JOAO DO ARRAIAL";6;1;0;7
2009;"SAO JOAO DO PIAUI (PI)";"PI";"SAO JOAO DO PIAUI";62;6;7;75
2009;"SAO JOSE DO DIVINO (PI)";"PI";"SAO JOSE DO DIVINO";7;2;1;10
2009;"SAO JOSE DO PEIXE (PI)";"PI";"SAO JOSE DO PEIXE";1;1;0;2
2009;"SAO JOSE DO PIAUI (PI)";"PI";"SAO JOSE DO PIAUI";19;7;3;29
2009;"SAO JULIAO (PI)";"PI";"SAO JULIAO";8;8;3;19
2009;"SAO LOURENCO DO PIAUI (PI)";"PI";"SAO LOURENCO DO PIAUI";0;0;1;1
2009;"SAO LUIS DO PIAUI (PI)";"PI";"SAO LUIS DO PIAUI";3;3;0;6
2009;"SAO MIGUEL DA BAIXA GRANDE (PI)";"PI";"SAO MIGUEL DA BAIXA GRANDE";10;1;0;11
2009;"SAO MIGUEL DO FIDALGO (PI)";"PI";"SAO MIGUEL DO FIDALGO";1;1;1;3
2009;"SAO MIGUEL DO TAPUIO (PI)";"PI";"SAO MIGUEL DO TAPUIO";9;0;3;12
2009;"SAO PEDRO DO PIAUI (PI)";"PI";"SAO PEDRO DO PIAUI";27;0;2;29
2009;"SAO RAIMUNDO NONATO (PI)";"PI";"SAO RAIMUNDO NONATO";156;6;19;181
2009;"SEBASTIAO BARROS (PI)";"PI";"SEBASTIAO BARROS";1;2;0;3
2009;"SEBASTIAO LEAL (PI)";"PI";"SEBASTIAO LEAL";8;1;0;9
2009;"SIGEFREDO PACHECO (PI)";"PI";"SIGEFREDO PACHECO";20;4;1;25
2009;"SIMOES (PI)";"PI";"SIMOES";30;4;1;35
2009;"SIMPLICIO MENDES (PI)";"PI";"SIMPLICIO MENDES";36;6;4;46
2009;"SOCORRO DO PIAUI (PI)";"PI";"SOCORRO DO PIAUI";0;0;0;0
2009;"SUSSUAPARA (PI)";"PI";"SUSSUAPARA";13;14;3;30
2009;"TAMBORIL DO PIAUI (PI)";"PI";"TAMBORIL DO PIAUI";2;0;0;2
2009;"TANQUE DO PIAUI (PI)";"PI";"TANQUE DO PIAUI";5;0;2;7
2009;"TERESINA (PI)";"PI";"TERESINA";8482;768;2060;11310
2009;"UNIAO (PI)";"PI";"UNIAO";73;19;29;121
2009;"URUCUI (PI)";"PI";"URUCUI";91;6;6;103
2009;"VALENCA DO PIAUI (PI)";"PI";"VALENCA DO PIAUI";99;18;9;126
2009;"VARZEA BRANCA (PI)";"PI";"VARZEA BRANCA";3;0;5;8
2009;"VARZEA GRANDE (PI)";"PI";"VARZEA GRANDE";5;3;0;8
2009;"VERA MENDES (PI)";"PI";"VERA MENDES";3;4;0;7
2009;"VILA NOVA DO PIAUI (PI)";"PI";"VILA NOVA DO PIAUI";6;5;2;13
2009;"WALL FERRAZ (PI)";"PI";"WALL FERRAZ";4;6;1;11
2009;"ABATIA (PR)";"PR";"ABATIA";113;3;33;149
2009;"ADRIANOPOLIS (PR)";"PR";"ADRIANOPOLIS";102;4;15;121
2009;"AGUDOS DO SUL (PR)";"PR";"AGUDOS DO SUL";296;8;19;323
2009;"ALMIRANTE TAMANDARE (PR)";"PR";"ALMIRANTE TAMANDARE";1125;74;198;1397
2009;"ALTAMIRA DO PARANA (PR)";"PR";"ALTAMIRA DO PARANA";37;3;9;49
2009;"ALTO PARANA (PR)";"PR";"ALTO PARANA";228;8;68;304
2009;"ALTO PIQUIRI (PR)";"PR";"ALTO PIQUIRI";165;4;32;201
2009;"ALTONIA (PR)";"PR";"ALTONIA";360;14;35;409
2009;"ALVORADA DO SUL (PR)";"PR";"ALVORADA DO SUL";247;8;46;301
2009;"AMAPORA (PR)";"PR";"AMAPORA";63;4;32;99
2009;"AMPERE (PR)";"PR";"AMPERE";347;13;24;384
2009;"ANAHY (PR)";"PR";"ANAHY";60;2;6;68
2009;"ANDIRA (PR)";"PR";"ANDIRA";479;14;75;568
2009;"ANGULO (PR)";"PR";"ANGULO";55;1;5;61
2009;"ANTONINA (PR)";"PR";"ANTONINA";85;16;25;126
2009;"ANTONIO OLINTO (PR)";"PR";"ANTONIO OLINTO";115;4;23;142
2009;"APUCARANA (PR)";"PR";"APUCARANA";2149;239;256;2644
2009;"ARAPONGAS (PR)";"PR";"ARAPONGAS";2946;141;98;3185
2009;"ARAPOTI (PR)";"PR";"ARAPOTI";443;28;58;529
2009;"ARAPUA (PR)";"PR";"ARAPUA";75;3;17;95
2009;"ARARUNA (PR)";"PR";"ARARUNA";326;8;25;359
2009;"ARAUCARIA (PR)";"PR";"ARAUCARIA";2529;278;605;3412
2009;"ARIRANHA DO IVAI (PR)";"PR";"ARIRANHA DO IVAI";39;3;14;56
2009;"ASSAI (PR)";"PR";"ASSAI";434;20;31;485
2009;"ASSIS CHATEAUBRIAND (PR)";"PR";"ASSIS CHATEAUBRIAND";1006;33;63;1102
2009;"ASTORGA (PR)";"PR";"ASTORGA";545;33;83;661
2009;"ATALAIA (PR)";"PR";"ATALAIA";86;10;21;117
2009;"BALSA NOVA (PR)";"PR";"BALSA NOVA";257;15;41;313
2009;"BANDEIRANTES (PR)";"PR";"BANDEIRANTES";766;33;95;894
2009;"BARBOSA FERRAZ (PR)";"PR";"BARBOSA FERRAZ";154;5;23;182
2009;"BARRA DO JACARE (PR)";"PR";"BARRA DO JACARE";37;5;8;50
2009;"BARRACAO (PR)";"PR";"BARRACAO";178;17;42;237
2009;"BELA VISTA DO CAROBA (PR)";"PR";"BELA VISTA DO CAROBA";46;3;13;62
2009;"BELA VISTA DO PARAISO (PR)";"PR";"BELA VISTA DO PARAISO";352;16;52;420
2009;"BITURUNA (PR)";"PR";"BITURUNA";348;17;100;465
2009;"BOA ESPERANCA (PR)";"PR";"BOA ESPERANCA";150;7;14;171
2009;"BOA ESPERANCA DO IGUACU (PR)";"PR";"BOA ESPERANCA DO IGUACU";51;5;7;63
2009;"BOA VENTURA DE SAO ROQUE (PR)";"PR";"BOA VENTURA DE SAO ROQUE";147;7;25;179
2009;"BOA VISTA DA APARECIDA (PR)";"PR";"BOA VISTA DA APARECIDA";145;11;24;180
2009;"BOCAIUVA DO SUL (PR)";"PR";"BOCAIUVA DO SUL";237;12;14;263
2009;"BOM JESUS DO SUL (PR)";"PR";"BOM JESUS DO SUL";43;5;7;55
2009;"BOM SUCESSO (PR)";"PR";"BOM SUCESSO";89;3;33;125
2009;"BOM SUCESSO DO SUL (PR)";"PR";"BOM SUCESSO DO SUL";93;11;6;110
2009;"BORRAZOPOLIS (PR)";"PR";"BORRAZOPOLIS";223;2;7;232
2009;"BRAGANEY (PR)";"PR";"BRAGANEY";132;5;20;157
2009;"BRASILANDIA DO SUL (PR)";"PR";"BRASILANDIA DO SUL";51;2;7;60
2009;"CAFEARA (PR)";"PR";"CAFEARA";31;3;11;45
2009;"CAFELANDIA (PR)";"PR";"CAFELANDIA";486;14;43;543
2009;"CAFEZAL DO SUL (PR)";"PR";"CAFEZAL DO SUL";77;1;27;105
2009;"CALIFORNIA (PR)";"PR";"CALIFORNIA";224;8;15;247
2009;"CAMBARA (PR)";"PR";"CAMBARA";843;24;68;935
2009;"CAMBE (PR)";"PR";"CAMBE";1621;177;157;1955
2009;"CAMBIRA (PR)";"PR";"CAMBIRA";216;1;16;233
2009;"CAMPINA DA LAGOA (PR)";"PR";"CAMPINA DA LAGOA";337;16;37;390
2009;"CAMPINA DO SIMAO (PR)";"PR";"CAMPINA DO SIMAO";64;3;17;84
2009;"CAMPINA GRANDE DO SUL (PR)";"PR";"CAMPINA GRANDE DO SUL";652;47;48;747
2009;"CAMPO BONITO (PR)";"PR";"CAMPO BONITO";89;5;10;104
2009;"CAMPO DO TENENTE (PR)";"PR";"CAMPO DO TENENTE";130;10;29;169
2009;"CAMPO LARGO (PR)";"PR";"CAMPO LARGO";1945;194;424;2563
2009;"CAMPO MAGRO (PR)";"PR";"CAMPO MAGRO";331;37;20;388
2009;"CAMPO MOURAO (PR)";"PR";"CAMPO MOURAO";1863;65;462;2390
2009;"CANDIDO DE ABREU (PR)";"PR";"CANDIDO DE ABREU";190;5;38;233
2009;"CANDOI (PR)";"PR";"CANDOI";326;5;74;405
2009;"CANTAGALO (PR)";"PR";"CANTAGALO";210;8;33;251
2009;"CAPANEMA (PR)";"PR";"CAPANEMA";381;10;48;439
2009;"CAPITAO LEONIDAS MARQUES (PR)";"PR";"CAPITAO LEONIDAS MARQUES";433;15;25;473
2009;"CARAMBEI (PR)";"PR";"CARAMBEI";507;30;46;583
2009;"CARLOPOLIS (PR)";"PR";"CARLOPOLIS";238;13;43;294
2009;"CASCAVEL (PR)";"PR";"CASCAVEL";6781;281;695;7757
2009;"CASTRO (PR)";"PR";"CASTRO";1547;120;214;1881
2009;"CATANDUVAS (PR)";"PR";"CATANDUVAS";194;9;22;225
2009;"CENTENARIO DO SUL (PR)";"PR";"CENTENARIO DO SUL";112;13;50;175
2009;"CERRO AZUL (PR)";"PR";"CERRO AZUL";352;9;50;411
2009;"CEU AZUL (PR)";"PR";"CEU AZUL";299;11;37;347
2009;"CHOPINZINHO (PR)";"PR";"CHOPINZINHO";461;16;64;541
2009;"CIANORTE (PR)";"PR";"CIANORTE";1379;57;172;1608
2009;"CIDADE GAUCHA (PR)";"PR";"CIDADE GAUCHA";239;9;67;315
2009;"CLEVELANDIA (PR)";"PR";"CLEVELANDIA";472;27;36;535
2009;"COLOMBO (PR)";"PR";"COLOMBO";3544;206;436;4186
2009;"COLORADO (PR)";"PR";"COLORADO";541;34;82;657
2009;"CONGONHINHAS (PR)";"PR";"CONGONHINHAS";104;5;28;137
2009;"CONSELHEIRO MAIRINCK (PR)";"PR";"CONSELHEIRO MAIRINCK";31;1;6;38
2009;"CONTENDA (PR)";"PR";"CONTENDA";628;11;44;683
2009;"CORBELIA (PR)";"PR";"CORBELIA";671;15;32;718
2009;"CORNELIO PROCOPIO (PR)";"PR";"CORNELIO PROCOPIO";940;86;106;1132
2009;"CORONEL DOMINGOS SOARES (PR)";"PR";"CORONEL DOMINGOS SOARES";110;7;19;136
2009;"CORONEL VIVIDA (PR)";"PR";"CORONEL VIVIDA";595;17;86;698
2009;"CORUMBATAI DO SUL (PR)";"PR";"CORUMBATAI DO SUL";41;1;23;65
2009;"CRUZ MACHADO (PR)";"PR";"CRUZ MACHADO";403;13;64;480
2009;"CRUZEIRO DO IGUACU (PR)";"PR";"CRUZEIRO DO IGUACU";62;2;13;77
2009;"CRUZEIRO DO OESTE (PR)";"PR";"CRUZEIRO DO OESTE";406;15;65;486
2009;"CRUZEIRO DO SUL (PR)";"PR";"CRUZEIRO DO SUL";69;7;18;94
2009;"CRUZMALTINA (PR)";"PR";"CRUZMALTINA";71;2;5;78
2009;"CURITIBA (PR)";"PR";"CURITIBA";35108;3424;6908;45440
2009;"CURIUVA (PR)";"PR";"CURIUVA";193;24;68;285
2009;"DIAMANTE D OESTE (PR)";"PR";"DIAMANTE D OESTE";65;4;13;82
2009;"DIAMANTE DO NORTE (PR)";"PR";"DIAMANTE DO NORTE";62;1;22;85
2009;"DIAMANTE DO SUL (PR)";"PR";"DIAMANTE DO SUL";35;2;5;42
2009;"DOIS VIZINHOS (PR)";"PR";"DOIS VIZINHOS";854;30;82;966
2009;"DOURADINA (PR)";"PR";"DOURADINA";248;7;9;264
2009;"DOUTOR CAMARGO (PR)";"PR";"DOUTOR CAMARGO";144;4;31;179
2009;"DOUTOR ULYSSES (PR)";"PR";"DOUTOR ULYSSES";33;1;8;42
2009;"ENEAS MARQUES (PR)";"PR";"ENEAS MARQUES";145;9;20;174
2009;"ENGENHEIRO BELTRAO (PR)";"PR";"ENGENHEIRO BELTRAO";430;8;74;512
2009;"ENTRE RIOS DO OESTE (PR)";"PR";"ENTRE RIOS DO OESTE";117;4;7;128
2009;"ESPERANCA NOVA (PR)";"PR";"ESPERANCA NOVA";17;2;2;21
2009;"ESPIGAO ALTO DO IGUACU (PR)";"PR";"ESPIGAO ALTO DO IGUACU";57;5;5;67
2009;"FAROL (PR)";"PR";"FAROL";69;0;9;78
2009;"FAXINAL (PR)";"PR";"FAXINAL";323;7;38;368
2009;"FAZENDA RIO GRANDE (PR)";"PR";"FAZENDA RIO GRANDE";791;51;194;1036
2009;"FENIX (PR)";"PR";"FENIX";90;2;12;104
2009;"FERNANDES PINHEIRO (PR)";"PR";"FERNANDES PINHEIRO";87;3;17;107
2009;"FIGUEIRA (PR)";"PR";"FIGUEIRA";119;6;25;150
2009;"FLOR DA SERRA DO SUL (PR)";"PR";"FLOR DA SERRA DO SUL";87;3;22;112
2009;"FLORAI (PR)";"PR";"FLORAI";119;3;25;147
2009;"FLORESTA (PR)";"PR";"FLORESTA";220;7;17;244
2009;"FLORESTOPOLIS (PR)";"PR";"FLORESTOPOLIS";187;9;79;275
2009;"FLORIDA (PR)";"PR";"FLORIDA";45;8;11;64
2009;"FORMOSA DO OESTE (PR)";"PR";"FORMOSA DO OESTE";178;27;16;221
2009;"FOZ DO IGUACU (PR)";"PR";"FOZ DO IGUACU";2931;819;825;4575
2009;"FOZ DO JORDAO (PR)";"PR";"FOZ DO JORDAO";66;3;13;82
2009;"FRANCISCO ALVES (PR)";"PR";"FRANCISCO ALVES";146;2;19;167
2009;"FRANCISCO BELTRAO (PR)";"PR";"FRANCISCO BELTRAO";1734;85;189;2008
2009;"GENERAL CARNEIRO (PR)";"PR";"GENERAL CARNEIRO";385;9;55;449
2009;"GODOY MOREIRA (PR)";"PR";"GODOY MOREIRA";39;2;7;48
2009;"GOIOERE (PR)";"PR";"GOIOERE";646;30;61;737
2009;"GOIOXIM (PR)";"PR";"GOIOXIM";71;4;20;95
2009;"GRANDES RIOS (PR)";"PR";"GRANDES RIOS";70;5;7;82
2009;"GUAIRA (PR)";"PR";"GUAIRA";1080;30;61;1171
2009;"GUAIRACA (PR)";"PR";"GUAIRACA";116;3;23;142
2009;"GUAMIRANGA (PR)";"PR";"GUAMIRANGA";131;5;18;154
2009;"GUAPIRAMA (PR)";"PR";"GUAPIRAMA";111;1;17;129
2009;"GUAPOREMA (PR)";"PR";"GUAPOREMA";42;2;6;50
2009;"GUARACI (PR)";"PR";"GUARACI";89;2;25;116
2009;"GUARANIACU (PR)";"PR";"GUARANIACU";369;18;48;435
2009;"GUARAPUAVA (PR)";"PR";"GUARAPUAVA";3951;308;377;4636
2009;"GUARAQUECABA (PR)";"PR";"GUARAQUECABA";20;1;8;29
2009;"GUARATUBA (PR)";"PR";"GUARATUBA";254;21;40;315
2009;"HONORIO SERPA (PR)";"PR";"HONORIO SERPA";109;4;26;139
2009;"IBAITI (PR)";"PR";"IBAITI";474;22;160;656
2009;"IBEMA (PR)";"PR";"IBEMA";125;4;14;143
2009;"IBIPORA (PR)";"PR";"IBIPORA";823;33;118;974
2009;"ICARAIMA (PR)";"PR";"ICARAIMA";109;4;21;134
2009;"IGUARACU (PR)";"PR";"IGUARACU";65;2;13;80
2009;"IGUATU (PR)";"PR";"IGUATU";33;1;7;41
2009;"IMBAU (PR)";"PR";"IMBAU";174;15;25;214
2009;"IMBITUVA (PR)";"PR";"IMBITUVA";641;11;42;694
2009;"INACIO MARTINS (PR)";"PR";"INACIO MARTINS";234;14;27;275
2009;"INAJA (PR)";"PR";"INAJA";36;0;17;53
2009;"INDIANOPOLIS (PR)";"PR";"INDIANOPOLIS";129;3;10;142
2009;"IPIRANGA (PR)";"PR";"IPIRANGA";292;24;39;355
2009;"IPORA (PR)";"PR";"IPORA";316;9;34;359
2009;"IRACEMA DO OESTE (PR)";"PR";"IRACEMA DO OESTE";63;5;4;72
2009;"IRATI (PR)";"PR";"IRATI";1318;64;118;1500
2009;"IRETAMA (PR)";"PR";"IRETAMA";141;4;27;172
2009;"ITAGUAJE (PR)";"PR";"ITAGUAJE";66;6;20;92
2009;"ITAIPULANDIA (PR)";"PR";"ITAIPULANDIA";173;14;27;214
2009;"ITAMBARACA (PR)";"PR";"ITAMBARACA";143;4;26;173
2009;"ITAMBE (PR)";"PR";"ITAMBE";172;4;22;198
2009;"ITAPEJARA D OESTE (PR)";"PR";"ITAPEJARA D OESTE";250;5;19;274
2009;"ITAPERUCU (PR)";"PR";"ITAPERUCU";522;37;54;613
2009;"ITAUNA DO SUL (PR)";"PR";"ITAUNA DO SUL";42;2;7;51
2009;"IVAI (PR)";"PR";"IVAI";291;6;30;327
2009;"IVAIPORA (PR)";"PR";"IVAIPORA";723;29;84;836
2009;"IVATE (PR)";"PR";"IVATE";148;13;46;207
2009;"IVATUBA (PR)";"PR";"IVATUBA";50;2;8;60
2009;"JABOTI (PR)";"PR";"JABOTI";62;4;8;74
2009;"JACAREZINHO (PR)";"PR";"JACAREZINHO";497;62;131;690
2009;"JAGUAPITA (PR)";"PR";"JAGUAPITA";291;15;51;357
2009;"JAGUARIAIVA (PR)";"PR";"JAGUARIAIVA";626;43;99;768
2009;"JANDAIA DO SUL (PR)";"PR";"JANDAIA DO SUL";539;26;86;651
2009;"JANIOPOLIS (PR)";"PR";"JANIOPOLIS";117;4;17;138
2009;"JAPIRA (PR)";"PR";"JAPIRA";35;0;7;42
2009;"JAPURA (PR)";"PR";"JAPURA";211;4;11;226
2009;"JARDIM ALEGRE (PR)";"PR";"JARDIM ALEGRE";188;9;20;217
2009;"JARDIM OLINDA (PR)";"PR";"JARDIM OLINDA";35;2;7;44
2009;"JATAIZINHO (PR)";"PR";"JATAIZINHO";279;23;19;321
2009;"JESUITAS (PR)";"PR";"JESUITAS";225;8;23;256
2009;"JOAQUIM TAVORA (PR)";"PR";"JOAQUIM TAVORA";217;6;20;243
2009;"JUNDIAI DO SUL (PR)";"PR";"JUNDIAI DO SUL";26;2;11;39
2009;"JURANDA (PR)";"PR";"JURANDA";280;2;9;291
2009;"JUSSARA (PR)";"PR";"JUSSARA";148;6;24;178
2009;"KALORE (PR)";"PR";"KALORE";126;7;17;150
2009;"LAPA (PR)";"PR";"LAPA";1091;62;134;1287
2009;"LARANJAL (PR)";"PR";"LARANJAL";41;4;15;60
2009;"LARANJEIRAS DO SUL (PR)";"PR";"LARANJEIRAS DO SUL";593;19;70;682
2009;"LEOPOLIS (PR)";"PR";"LEOPOLIS";64;4;5;73
2009;"LIDIANOPOLIS (PR)";"PR";"LIDIANOPOLIS";61;7;17;85
2009;"LINDOESTE (PR)";"PR";"LINDOESTE";81;6;10;97
2009;"LOANDA (PR)";"PR";"LOANDA";361;9;53;423
2009;"LOBATO (PR)";"PR";"LOBATO";159;5;26;190
2009;"LONDRINA (PR)";"PR";"LONDRINA";8061;671;1793;10525
2009;"LUIZIANA (PR)";"PR";"LUIZIANA";133;4;13;150
2009;"LUNARDELLI (PR)";"PR";"LUNARDELLI";84;5;6;95
2009;"LUPIONOPOLIS (PR)";"PR";"LUPIONOPOLIS";90;2;101;193
2009;"MALLET (PR)";"PR";"MALLET";283;13;32;328
2009;"MAMBORE (PR)";"PR";"MAMBORE";491;4;30;525
2009;"MANDAGUACU (PR)";"PR";"MANDAGUACU";367;8;41;416
2009;"MANDAGUARI (PR)";"PR";"MANDAGUARI";640;24;56;720
2009;"MANDIRITUBA (PR)";"PR";"MANDIRITUBA";846;18;52;916
2009;"MANFRINOPOLIS (PR)";"PR";"MANFRINOPOLIS";29;3;17;49
2009;"MANGUEIRINHA (PR)";"PR";"MANGUEIRINHA";401;21;52;474
2009;"MANOEL RIBAS (PR)";"PR";"MANOEL RIBAS";275;8;27;310
2009;"MARECHAL CANDIDO RONDON (PR)";"PR";"MARECHAL CANDIDO RONDON";1272;54;110;1436
2009;"MARIA HELENA (PR)";"PR";"MARIA HELENA";95;4;20;119
2009;"MARIALVA (PR)";"PR";"MARIALVA";771;39;57;867
2009;"MARILANDIA DO SUL (PR)";"PR";"MARILANDIA DO SUL";225;11;17;253
2009;"MARILENA (PR)";"PR";"MARILENA";101;3;23;127
2009;"MARILUZ (PR)";"PR";"MARILUZ";172;8;56;236
2009;"MARINGA (PR)";"PR";"MARINGA";7768;412;842;9022
2009;"MARIOPOLIS (PR)";"PR";"MARIOPOLIS";179;8;25;212
2009;"MARIPA (PR)";"PR";"MARIPA";267;7;13;287
2009;"MARMELEIRO (PR)";"PR";"MARMELEIRO";291;11;45;347
2009;"MARQUINHO (PR)";"PR";"MARQUINHO";58;5;12;75
2009;"MARUMBI (PR)";"PR";"MARUMBI";82;3;13;98
2009;"MATELANDIA (PR)";"PR";"MATELANDIA";359;4;31;394
2009;"MATINHOS (PR)";"PR";"MATINHOS";231;30;21;282
2009;"MATO RICO (PR)";"PR";"MATO RICO";37;2;8;47
2009;"MAUA DA SERRA (PR)";"PR";"MAUA DA SERRA";174;3;17;194
2009;"MEDIANEIRA (PR)";"PR";"MEDIANEIRA";1034;39;85;1158
2009;"MERCEDES (PR)";"PR";"MERCEDES";179;8;23;210
2009;"MIRADOR (PR)";"PR";"MIRADOR";11;1;9;21
2009;"MIRASELVA (PR)";"PR";"MIRASELVA";32;7;21;60
2009;"MISSAL (PR)";"PR";"MISSAL";290;18;30;338
2009;"MOREIRA SALES (PR)";"PR";"MOREIRA SALES";150;9;57;216
2009;"MORRETES (PR)";"PR";"MORRETES";154;15;26;195
2009;"MUNHOZ DE MELLO (PR)";"PR";"MUNHOZ DE MELLO";46;4;8;58
2009;"NOSSA SENHORA DAS GRACAS (PR)";"PR";"NOSSA SENHORA DAS GRACAS";26;6;31;63
2009;"NOVA ALIANCA DO IVAI (PR)";"PR";"NOVA ALIANCA DO IVAI";16;5;4;25
2009;"NOVA AMERICA DA COLINA (PR)";"PR";"NOVA AMERICA DA COLINA";103;4;10;117
2009;"NOVA AURORA (PR)";"PR";"NOVA AURORA";355;11;36;402
2009;"NOVA CANTU (PR)";"PR";"NOVA CANTU";97;0;21;118
2009;"NOVA ESPERANCA (PR)";"PR";"NOVA ESPERANCA";715;25;58;798
2009;"NOVA ESPERANCA DO SUDOESTE (PR)";"PR";"NOVA ESPERANCA DO SUDOESTE";78;10;14;102
2009;"NOVA FATIMA (PR)";"PR";"NOVA FATIMA";203;2;29;234
2009;"NOVA LARANJEIRAS (PR)";"PR";"NOVA LARANJEIRAS";130;3;27;160
2009;"NOVA LONDRINA (PR)";"PR";"NOVA LONDRINA";352;10;39;401
2009;"NOVA OLIMPIA (PR)";"PR";"NOVA OLIMPIA";80;5;22;107
2009;"NOVA PRATA DO IGUACU (PR)";"PR";"NOVA PRATA DO IGUACU";199;4;24;227
2009;"NOVA SANTA BARBARA (PR)";"PR";"NOVA SANTA BARBARA";117;8;4;129
2009;"NOVA SANTA ROSA (PR)";"PR";"NOVA SANTA ROSA";288;8;16;312
2009;"NOVA TEBAS (PR)";"PR";"NOVA TEBAS";89;3;9;101
2009;"NOVO ITACOLOMI (PR)";"PR";"NOVO ITACOLOMI";73;1;7;81
2009;"ORTIGUEIRA (PR)";"PR";"ORTIGUEIRA";294;17;52;363
2009;"OURIZONA (PR)";"PR";"OURIZONA";66;4;19;89
2009;"OURO VERDE DO OESTE (PR)";"PR";"OURO VERDE DO OESTE";139;3;12;154
2009;"PAICANDU (PR)";"PR";"PAICANDU";390;20;43;453
2009;"PALMAS (PR)";"PR";"PALMAS";798;44;70;912
2009;"PALMEIRA (PR)";"PR";"PALMEIRA";819;31;62;912
2009;"PALMITAL (PR)";"PR";"PALMITAL";194;10;41;245
2009;"PALOTINA (PR)";"PR";"PALOTINA";1045;27;81;1153
2009;"PARAISO DO NORTE (PR)";"PR";"PARAISO DO NORTE";216;11;46;273
2009;"PARANACITY (PR)";"PR";"PARANACITY";198;11;39;248
2009;"PARANAGUA (PR)";"PR";"PARANAGUA";1472;123;134;1729
2009;"PARANAPOEMA (PR)";"PR";"PARANAPOEMA";50;3;14;67
2009;"PARANAVAI (PR)";"PR";"PARANAVAI";1724;68;170;1962
2009;"PATO BRAGADO (PR)";"PR";"PATO BRAGADO";124;2;14;140
2009;"PATO BRANCO (PR)";"PR";"PATO BRANCO";1770;117;337;2224
2009;"PAULA FREITAS (PR)";"PR";"PAULA FREITAS";125;2;19;146
2009;"PAULO FRONTIN (PR)";"PR";"PAULO FRONTIN";143;2;11;156
2009;"PEABIRU (PR)";"PR";"PEABIRU";263;15;19;297
2009;"PEROBAL (PR)";"PR";"PEROBAL";91;2;29;122
2009;"PEROLA (PR)";"PR";"PEROLA";198;7;13;218
2009;"PEROLA D OESTE (PR)";"PR";"PEROLA D OESTE";130;1;16;147
2009;"PIEN (PR)";"PR";"PIEN";335;17;14;366
2009;"PINHAIS (PR)";"PR";"PINHAIS";1717;143;236;2096
2009;"PINHAL DO SAO BENTO (PR)";"PR";"PINHAL DO SAO BENTO";36;3;8;47
2009;"PINHALAO (PR)";"PR";"PINHALAO";79;4;15;98
2009;"PINHAO (PR)";"PR";"PINHAO";417;14;77;508
2009;"PIRAI DO SUL (PR)";"PR";"PIRAI DO SUL";408;19;68;495
2009;"PIRAQUARA (PR)";"PR";"PIRAQUARA";432;73;151;656
2009;"PITANGA (PR)";"PR";"PITANGA";685;23;94;802
2009;"PITANGUEIRAS (PR)";"PR";"PITANGUEIRAS";49;4;24;77
2009;"PLANALTINA DO PARANA (PR)";"PR";"PLANALTINA DO PARANA";88;4;13;105
2009;"PLANALTO (PR)";"PR";"PLANALTO";287;9;26;322
2009;"PONTA GROSSA (PR)";"PR";"PONTA GROSSA";5409;482;916;6807
2009;"PONTAL DO PARANA (PR)";"PR";"PONTAL DO PARANA";164;7;39;210
2009;"PORECATU (PR)";"PR";"PORECATU";298;25;131;454
2009;"PORTO AMAZONAS (PR)";"PR";"PORTO AMAZONAS";58;8;9;75
2009;"PORTO BARREIRO (PR)";"PR";"PORTO BARREIRO";54;4;16;74
2009;"PORTO RICO (PR)";"PR";"PORTO RICO";17;0;7;24
2009;"PORTO VITORIA (PR)";"PR";"PORTO VITORIA";158;3;9;170
2009;"PRADO FERREIRA (PR)";"PR";"PRADO FERREIRA";75;3;10;88
2009;"PRANCHITA (PR)";"PR";"PRANCHITA";202;3;12;217
2009;"PRESIDENTE CASTELO BRANCO (PR)";"PR";"PRESIDENTE CASTELO BRANCO";72;4;23;99
2009;"PRIMEIRO DE MAIO (PR)";"PR";"PRIMEIRO DE MAIO";274;12;21;307
2009;"PRUDENTOPOLIS (PR)";"PR";"PRUDENTOPOLIS";1005;18;99;1122
2009;"QUARTO CENTENARIO (PR)";"PR";"QUARTO CENTENARIO";130;7;6;143
2009;"QUATIGUA (PR)";"PR";"QUATIGUA";356;7;13;376
2009;"QUATRO BARRAS (PR)";"PR";"QUATRO BARRAS";528;39;134;701
2009;"QUATRO PONTES (PR)";"PR";"QUATRO PONTES";154;5;3;162
2009;"QUEDAS DO IGUACU (PR)";"PR";"QUEDAS DO IGUACU";566;21;117;704
2009;"QUERENCIA DO NORTE (PR)";"PR";"QUERENCIA DO NORTE";171;4;23;198
2009;"QUINTA DO SOL (PR)";"PR";"QUINTA DO SOL";104;4;17;125
2009;"QUITANDINHA (PR)";"PR";"QUITANDINHA";458;7;56;521
2009;"RAMILANDIA (PR)";"PR";"RAMILANDIA";52;2;11;65
2009;"RANCHO ALEGRE (PR)";"PR";"RANCHO ALEGRE";94;4;11;109
2009;"RANCHO ALEGRE D OESTE (PR)";"PR";"RANCHO ALEGRE D OESTE";82;2;9;93
2009;"REALEZA (PR)";"PR";"REALEZA";497;17;36;550
2009;"REBOUCAS (PR)";"PR";"REBOUCAS";236;11;35;282
2009;"RENASCENCA (PR)";"PR";"RENASCENCA";187;7;26;220
2009;"RESERVA (PR)";"PR";"RESERVA";472;12;53;537
2009;"RESERVA DO IGUACU (PR)";"PR";"RESERVA DO IGUACU";66;6;15;87
2009;"RIBEIRAO CLARO (PR)";"PR";"RIBEIRAO CLARO";151;24;21;196
2009;"RIBEIRAO DO PINHAL (PR)";"PR";"RIBEIRAO DO PINHAL";180;30;21;231
2009;"RIO AZUL (PR)";"PR";"RIO AZUL";212;6;42;260
2009;"RIO BOM (PR)";"PR";"RIO BOM";73;3;6;82
2009;"RIO BONITO DO IGUACU (PR)";"PR";"RIO BONITO DO IGUACU";212;8;60;280
2009;"RIO BRANCO DO IVAI (PR)";"PR";"RIO BRANCO DO IVAI";40;3;10;53
2009;"RIO BRANCO DO SUL (PR)";"PR";"RIO BRANCO DO SUL";594;77;89;760
2009;"RIO NEGRO (PR)";"PR";"RIO NEGRO";809;63;53;925
2009;"ROLANDIA (PR)";"PR";"ROLANDIA";1490;70;90;1650
2009;"RONCADOR (PR)";"PR";"RONCADOR";274;2;28;304
2009;"RONDON (PR)";"PR";"RONDON";252;9;47;308
2009;"ROSARIO DO IVAI (PR)";"PR";"ROSARIO DO IVAI";59;8;18;85
2009;"SABAUDIA (PR)";"PR";"SABAUDIA";164;7;13;184
2009;"SALGADO FILHO (PR)";"PR";"SALGADO FILHO";71;4;19;94
2009;"SALTO DO ITARARE (PR)";"PR";"SALTO DO ITARARE";84;5;16;105
2009;"SALTO DO LONTRA (PR)";"PR";"SALTO DO LONTRA";221;5;27;253
2009;"SANTA AMELIA (PR)";"PR";"SANTA AMELIA";70;6;14;90
2009;"SANTA CECILIA DO PAVAO (PR)";"PR";"SANTA CECILIA DO PAVAO";63;9;10;82
2009;"SANTA CRUZ DO MONTE CASTELO (PR)";"PR";"SANTA CRUZ DO MONTE CASTELO";180;8;26;214
2009;"SANTA FE (PR)";"PR";"SANTA FE";179;5;25;209
2009;"SANTA HELENA (PR)";"PR";"SANTA HELENA";570;31;87;688
2009;"SANTA INES (PR)";"PR";"SANTA INES";10;3;10;23
2009;"SANTA ISABEL DO IVAI (PR)";"PR";"SANTA ISABEL DO IVAI";165;9;28;202
2009;"SANTA IZABEL DO OESTE (PR)";"PR";"SANTA IZABEL DO OESTE";195;11;26;232
2009;"SANTA LUCIA (PR)";"PR";"SANTA LUCIA";93;1;9;103
2009;"SANTA MARIA DO OESTE (PR)";"PR";"SANTA MARIA DO OESTE";161;9;18;188
2009;"SANTA MARIANA (PR)";"PR";"SANTA MARIANA";257;12;40;309
2009;"SANTA MONICA (PR)";"PR";"SANTA MONICA";42;3;12;57
2009;"SANTA TEREZA DO OESTE (PR)";"PR";"SANTA TEREZA DO OESTE";166;11;10;187
2009;"SANTA TEREZINHA DE ITAIPU (PR)";"PR";"SANTA TEREZINHA DE ITAIPU";387;34;43;464
2009;"SANTANA DO ITARARE (PR)";"PR";"SANTANA DO ITARARE";80;3;14;97
2009;"SANTO ANTONIO DA PLATINA (PR)";"PR";"SANTO ANTONIO DA PLATINA";528;33;226;787
2009;"SANTO ANTONIO DO CAIUA (PR)";"PR";"SANTO ANTONIO DO CAIUA";16;2;14;32
2009;"SANTO ANTONIO DO PARAISO (PR)";"PR";"SANTO ANTONIO DO PARAISO";67;3;7;77
2009;"SANTO ANTONIO DO SUDOESTE (PR)";"PR";"SANTO ANTONIO DO SUDOESTE";312;13;37;362
2009;"SANTO INACIO (PR)";"PR";"SANTO INACIO";75;7;19;101
2009;"SAO CARLOS DO IVAI (PR)";"PR";"SAO CARLOS DO IVAI";202;11;24;237
2009;"SAO JERONIMO DA SERRA (PR)";"PR";"SAO JERONIMO DA SERRA";115;4;17;136
2009;"SAO JOAO (PR)";"PR";"SAO JOAO";278;12;32;322
2009;"SAO JOAO DO CAIUA (PR)";"PR";"SAO JOAO DO CAIUA";65;2;24;91
2009;"SAO JOAO DO IVAI (PR)";"PR";"SAO JOAO DO IVAI";268;10;31;309
2009;"SAO JOAO DO TRIUNFO (PR)";"PR";"SAO JOAO DO TRIUNFO";186;7;33;226
2009;"SAO JORGE D OESTE (PR)";"PR";"SAO JORGE D OESTE";172;7;28;207
2009;"SAO JORGE DO IVAI (PR)";"PR";"SAO JORGE DO IVAI";242;5;15;262
2009;"SAO JORGE DO PATROCINIO (PR)";"PR";"SAO JORGE DO PATROCINIO";102;4;14;120
2009;"SAO JOSE DA BOA VISTA (PR)";"PR";"SAO JOSE DA BOA VISTA";83;3;14;100
2009;"SAO JOSE DAS PALMEIRAS (PR)";"PR";"SAO JOSE DAS PALMEIRAS";66;8;23;97
2009;"SAO JOSE DOS PINHAIS (PR)";"PR";"SAO JOSE DOS PINHAIS";5834;544;611;6989
2009;"SAO MANOEL DO PARANA (PR)";"PR";"SAO MANOEL DO PARANA";35;3;9;47
2009;"SAO MATEUS DO SUL (PR)";"PR";"SAO MATEUS DO SUL";826;60;103;989
2009;"SAO MIGUEL DO IGUACU (PR)";"PR";"SAO MIGUEL DO IGUACU";760;17;76;853
2009;"SAO PEDRO DO IGUACU (PR)";"PR";"SAO PEDRO DO IGUACU";149;7;19;175
2009;"SAO PEDRO DO IVAI (PR)";"PR";"SAO PEDRO DO IVAI";280;4;46;330
2009;"SAO PEDRO DO PARANA (PR)";"PR";"SAO PEDRO DO PARANA";20;3;4;27
2009;"SAO SEBASTIAO DA AMOREIRA (PR)";"PR";"SAO SEBASTIAO DA AMOREIRA";173;5;26;204
2009;"SAO TOME (PR)";"PR";"SAO TOME";109;8;20;137
2009;"SAPOPEMA (PR)";"PR";"SAPOPEMA";79;3;11;93
2009;"SARANDI (PR)";"PR";"SARANDI";820;47;123;990
2009;"SAUDADE DO IGUACU (PR)";"PR";"SAUDADE DO IGUACU";60;10;16;86
2009;"SENGES (PR)";"PR";"SENGES";433;22;50;505
2009;"SERRANOPOLIS DO IGUACU (PR)";"PR";"SERRANOPOLIS DO IGUACU";131;11;10;152
2009;"SERTANEJA (PR)";"PR";"SERTANEJA";185;11;23;219
2009;"SERTANOPOLIS (PR)";"PR";"SERTANOPOLIS";502;7;40;549
2009;"SIQUEIRA CAMPOS (PR)";"PR";"SIQUEIRA CAMPOS";312;12;38;362
2009;"SULINA (PR)";"PR";"SULINA";75;5;11;91
2009;"TAMARANA (PR)";"PR";"TAMARANA";239;12;30;281
2009;"TAMBOARA (PR)";"PR";"TAMBOARA";68;7;9;84
2009;"TAPEJARA (PR)";"PR";"TAPEJARA";324;13;82;419
2009;"TAPIRA (PR)";"PR";"TAPIRA";120;5;19;144
2009;"TEIXEIRA SOARES (PR)";"PR";"TEIXEIRA SOARES";192;12;57;261
2009;"TELEMACO BORBA (PR)";"PR";"TELEMACO BORBA";964;190;218;1372
2009;"TERRA BOA (PR)";"PR";"TERRA BOA";269;10;65;344
2009;"TERRA RICA (PR)";"PR";"TERRA RICA";320;8;53;381
2009;"TERRA ROXA (PR)";"PR";"TERRA ROXA";428;10;42;480
2009;"TIBAGI (PR)";"PR";"TIBAGI";274;22;54;350
2009;"TIJUCAS DO SUL (PR)";"PR";"TIJUCAS DO SUL";376;6;30;412
2009;"TOLEDO (PR)";"PR";"TOLEDO";2514;170;280;2964
2009;"TOMAZINA (PR)";"PR";"TOMAZINA";70;7;18;95
2009;"TRES BARRAS DO PARANA (PR)";"PR";"TRES BARRAS DO PARANA";299;3;20;322
2009;"TUNAS DO PARANA (PR)";"PR";"TUNAS DO PARANA";66;11;23;100
2009;"TUNEIRAS DO OESTE (PR)";"PR";"TUNEIRAS DO OESTE";108;3;28;139
2009;"TUPASSI (PR)";"PR";"TUPASSI";301;9;27;337
2009;"TURVO (PR)";"PR";"TURVO";364;11;48;423
2009;"UBIRATA (PR)";"PR";"UBIRATA";601;19;44;664
2009;"UMUARAMA (PR)";"PR";"UMUARAMA";2187;59;217;2463
2009;"UNIAO DA VITORIA (PR)";"PR";"UNIAO DA VITORIA";1245;40;62;1347
2009;"UNIFLOR (PR)";"PR";"UNIFLOR";33;5;12;50
2009;"URAI (PR)";"PR";"URAI";271;16;23;310
2009;"VENTANIA (PR)";"PR";"VENTANIA";143;17;32;192
2009;"VERA CRUZ DO OESTE (PR)";"PR";"VERA CRUZ DO OESTE";221;7;10;238
2009;"VERE (PR)";"PR";"VERE";172;11;20;203
2009;"VILA ALTA (PR)";"PR";"VILA ALTA";30;6;12;48
2009;"VIRMOND (PR)";"PR";"VIRMOND";95;2;14;111
2009;"VITORINO (PR)";"PR";"VITORINO";208;5;23;236
2009;"WENCESLAU BRAZ (PR)";"PR";"WENCESLAU BRAZ";377;15;71;463
2009;"XAMBRE (PR)";"PR";"XAMBRE";81;5;11;97
2009;"ANGRA DOS REIS (RJ)";"RJ";"ANGRA DOS REIS";901;164;237;1302
2009;"APERIBE (RJ)";"RJ";"APERIBE";87;8;4;99
2009;"ARARUAMA (RJ)";"RJ";"ARARUAMA";1553;301;81;1935
2009;"AREAL (RJ)";"RJ";"AREAL";118;26;28;172
2009;"ARMACAO DE BUZIOS (RJ)";"RJ";"ARMACAO DE BUZIOS";197;224;32;453
2009;"ARRAIAL DO CABO (RJ)";"RJ";"ARRAIAL DO CABO";104;35;9;148
2009;"BARRA DO PIRAI (RJ)";"RJ";"BARRA DO PIRAI";1509;113;210;1832
2009;"BARRA MANSA (RJ)";"RJ";"BARRA MANSA";1706;106;482;2294
2009;"BELFORD ROXO (RJ)";"RJ";"BELFORD ROXO";1068;251;666;1985
2009;"BOM JARDIM (RJ)";"RJ";"BOM JARDIM";462;24;29;515
2009;"BOM JESUS DO ITABAPOANA (RJ)";"RJ";"BOM JESUS DO ITABAPOANA";331;45;40;416
2009;"CABO FRIO (RJ)";"RJ";"CABO FRIO";3506;310;422;4238
2009;"CACHOEIRAS DE MACACU (RJ)";"RJ";"CACHOEIRAS DE MACACU";658;113;36;807
2009;"CAMBUCI (RJ)";"RJ";"CAMBUCI";78;12;14;104
2009;"CAMPOS DOS GOYTACAZES (RJ)";"RJ";"CAMPOS DOS GOYTACAZES";5412;505;952;6869
2009;"CANTAGALO (RJ)";"RJ";"CANTAGALO";145;28;33;206
2009;"CARAPEBUS (RJ)";"RJ";"CARAPEBUS";59;20;4;83
2009;"CARDOSO MOREIRA (RJ)";"RJ";"CARDOSO MOREIRA";135;14;24;173
2009;"CARMO (RJ)";"RJ";"CARMO";94;14;28;136
2009;"CASIMIRO DE ABREU (RJ)";"RJ";"CASIMIRO DE ABREU";443;73;38;554
2009;"COMENDADOR LEVY GASPARIAN (RJ)";"RJ";"COMENDADOR LEVY GASPARIAN";107;30;14;151
2009;"CONCEICAO DE MACABU (RJ)";"RJ";"CONCEICAO DE MACABU";149;29;56;234
2009;"CORDEIRO (RJ)";"RJ";"CORDEIRO";261;33;40;334
2009;"DUAS BARRAS (RJ)";"RJ";"DUAS BARRAS";83;15;6;104
2009;"DUQUE DE CAXIAS (RJ)";"RJ";"DUQUE DE CAXIAS";6520;745;3075;10340
2009;"ENGENHEIRO PAULO DE FRONTIN (RJ)";"RJ";"ENGENHEIRO PAULO DE FRONTIN";123;23;12;158
2009;"GUAPIMIRIM (RJ)";"RJ";"GUAPIMIRIM";245;49;36;330
2009;"IGUABA GRANDE (RJ)";"RJ";"IGUABA GRANDE";121;69;16;206
2009;"ITABORAI (RJ)";"RJ";"ITABORAI";2727;814;593;4134
2009;"ITAGUAI (RJ)";"RJ";"ITAGUAI";1189;242;228;1659
2009;"ITALVA (RJ)";"RJ";"ITALVA";181;15;14;210
2009;"ITAOCARA (RJ)";"RJ";"ITAOCARA";264;39;24;327
2009;"ITAPERUNA (RJ)";"RJ";"ITAPERUNA";1051;103;105;1259
2009;"ITATIAIA (RJ)";"RJ";"ITATIAIA";135;68;39;242
2009;"JAPERI (RJ)";"RJ";"JAPERI";335;49;34;418
2009;"LAJE DO MURIAE (RJ)";"RJ";"LAJE DO MURIAE";40;6;8;54
2009;"MACAE (RJ)";"RJ";"MACAE";2384;574;787;3745
2009;"MACUCO (RJ)";"RJ";"MACUCO";127;11;10;148
2009;"MAGE (RJ)";"RJ";"MAGE";1073;394;199;1666
2009;"MANGARATIBA (RJ)";"RJ";"MANGARATIBA";107;86;135;328
2009;"MARICA (RJ)";"RJ";"MARICA";841;276;246;1363
2009;"MENDES (RJ)";"RJ";"MENDES";228;32;19;279
2009;"MESQUITA (RJ)";"RJ";"MESQUITA";417;108;635;1160
2009;"MIGUEL PEREIRA (RJ)";"RJ";"MIGUEL PEREIRA";294;60;29;383
2009;"MIRACEMA (RJ)";"RJ";"MIRACEMA";203;15;24;242
2009;"NATIVIDADE (RJ)";"RJ";"NATIVIDADE";81;10;25;116
2009;"NILOPOLIS (RJ)";"RJ";"NILOPOLIS";512;118;318;948
2009;"NITEROI (RJ)";"RJ";"NITEROI";1895;1204;1969;5068
2009;"NOVA FRIBURGO (RJ)";"RJ";"NOVA FRIBURGO";3140;183;314;3637
2009;"NOVA IGUACU (RJ)";"RJ";"NOVA IGUACU";4595;1114;1352;7061
2009;"PARACAMBI (RJ)";"RJ";"PARACAMBI";555;61;95;711
2009;"PARAIBA DO SUL (RJ)";"RJ";"PARAIBA DO SUL";425;56;89;570
2009;"PARATI (RJ)";"RJ";"PARATI";144;50;25;219
2009;"PATY DO ALFERES (RJ)";"RJ";"PATY DO ALFERES";406;62;37;505
2009;"PETROPOLIS (RJ)";"RJ";"PETROPOLIS";2775;508;657;3940
2009;"PINHEIRAL (RJ)";"RJ";"PINHEIRAL";137;26;50;213
2009;"PIRAI (RJ)";"RJ";"PIRAI";371;40;39;450
2009;"PORCIUNCULA (RJ)";"RJ";"PORCIUNCULA";71;9;17;97
2009;"PORTO REAL (RJ)";"RJ";"PORTO REAL";295;36;24;355
2009;"QUATIS (RJ)";"RJ";"QUATIS";170;64;34;268
2009;"QUEIMADOS (RJ)";"RJ";"QUEIMADOS";334;229;91;654
2009;"QUISSAMA (RJ)";"RJ";"QUISSAMA";170;18;85;273
2009;"RESENDE (RJ)";"RJ";"RESENDE";1087;178;355;1620
2009;"RIO BONITO (RJ)";"RJ";"RIO BONITO";3920;369;154;4443
2009;"RIO CLARO (RJ)";"RJ";"RIO CLARO";68;8;8;84
2009;"RIO DAS FLORES (RJ)";"RJ";"RIO DAS FLORES";53;14;5;72
2009;"RIO DAS OSTRAS (RJ)";"RJ";"RIO DAS OSTRAS";755;553;65;1373
2009;"RIO DE JANEIRO (RJ)";"RJ";"RIO DE JANEIRO";29407;13361;14050;56818
2009;"SANTA MARIA MADALENA (RJ)";"RJ";"SANTA MARIA MADALENA";41;10;2;53
2009;"SANTO ANTONIO DE PADUA (RJ)";"RJ";"SANTO ANTONIO DE PADUA";523;80;17;620
2009;"SAO FIDELIS (RJ)";"RJ";"SAO FIDELIS";377;25;40;442
2009;"SAO FRANCISCO DE ITABAPOANA (RJ)";"RJ";"SAO FRANCISCO DE ITABAPOANA";256;35;29;320
2009;"SAO GONCALO (RJ)";"RJ";"SAO GONCALO";2510;1808;2258;6576
2009;"SAO JOAO DA BARRA (RJ)";"RJ";"SAO JOAO DA BARRA";286;53;40;379
2009;"SAO JOAO DE MERITI (RJ)";"RJ";"SAO JOAO DE MERITI";2499;404;1209;4112
2009;"SAO JOSE DE UBA (RJ)";"RJ";"SAO JOSE DE UBA";23;6;3;32
2009;"SAO JOSE DO VALE DO RIO PRETO (RJ)";"RJ";"SAO JOSE DO VALE DO RIO PRETO";471;32;12;515
2009;"SAO PEDRO DA ALDEIA (RJ)";"RJ";"SAO PEDRO DA ALDEIA";452;72;45;569
2009;"SAO SEBASTIAO DO ALTO (RJ)";"RJ";"SAO SEBASTIAO DO ALTO";78;5;3;86
2009;"SAPUCAIA (RJ)";"RJ";"SAPUCAIA";100;6;9;115
2009;"SAQUAREMA (RJ)";"RJ";"SAQUAREMA";570;108;75;753
2009;"SEROPEDICA (RJ)";"RJ";"SEROPEDICA";527;40;179;746
2009;"SILVA JARDIM (RJ)";"RJ";"SILVA JARDIM";250;42;27;319
2009;"SUMIDOURO (RJ)";"RJ";"SUMIDOURO";186;6;10;202
2009;"TANGUA (RJ)";"RJ";"TANGUA";219;24;6;249
2009;"TERESOPOLIS (RJ)";"RJ";"TERESOPOLIS";1694;207;283;2184
2009;"TRAJANO DE MORAIS (RJ)";"RJ";"TRAJANO DE MORAIS";42;10;9;61
2009;"TRES RIOS (RJ)";"RJ";"TRES RIOS";741;77;174;992
2009;"VALENCA (RJ)";"RJ";"VALENCA";274;54;55;383
2009;"VARRE SAI (RJ)";"RJ";"VARRE SAI";38;6;2;46
2009;"VASSOURAS (RJ)";"RJ";"VASSOURAS";452;63;94;609
2009;"VOLTA REDONDA (RJ)";"RJ";"VOLTA REDONDA";2062;242;538;2842
2009;"ACARI (RN)";"RN";"ACARI";81;9;6;96
2009;"AFONSO BEZERRA (RN)";"RN";"AFONSO BEZERRA";17;3;2;22
2009;"AGUA NOVA (RN)";"RN";"AGUA NOVA";3;9;1;13
2009;"ALEXANDRIA (RN)";"RN";"ALEXANDRIA";45;24;10;79
2009;"ALMINO AFONSO (RN)";"RN";"ALMINO AFONSO";13;7;0;20
2009;"ALTO DO RODRIGUES (RN)";"RN";"ALTO DO RODRIGUES";114;12;23;149
2009;"ANGICOS (RN)";"RN";"ANGICOS";92;11;11;114
2009;"ANTONIO MARTINS (RN)";"RN";"ANTONIO MARTINS";12;10;0;22
2009;"APODI (RN)";"RN";"APODI";216;14;16;246
2009;"AREIA BRANCA (RN)";"RN";"AREIA BRANCA";96;32;44;172
2009;"ARES (RN)";"RN";"ARES";75;8;20;103
2009;"ASSU (RN)";"RN";"ASSU";405;43;54;502
2009;"BAIA FORMOSA (RN)";"RN";"BAIA FORMOSA";38;1;12;51
2009;"BARAUNA (RN)";"RN";"BARAUNA";125;15;12;152
2009;"BARCELONA (RN)";"RN";"BARCELONA";19;2;1;22
2009;"BENTO FERNANDES (RN)";"RN";"BENTO FERNANDES";13;6;4;23
2009;"BOA SAUDE (RN)";"RN";"BOA SAUDE";42;5;3;50
2009;"BODO (RN)";"RN";"BODO";4;6;1;11
2009;"BOM JESUS (RN)";"RN";"BOM JESUS";46;1;2;49
2009;"BREJINHO (RN)";"RN";"BREJINHO";50;10;12;72
2009;"CAICARA DO NORTE (RN)";"RN";"CAICARA DO NORTE";10;1;2;13
2009;"CAICARA DO RIO DO VENTO (RN)";"RN";"CAICARA DO RIO DO VENTO";19;5;1;25
2009;"CAICO (RN)";"RN";"CAICO";1344;69;35;1448
2009;"CAMPO GRANDE (RN)";"RN";"CAMPO GRANDE";32;8;0;40
2009;"CAMPO REDONDO (RN)";"RN";"CAMPO REDONDO";37;13;7;57
2009;"CANGUARETAMA (RN)";"RN";"CANGUARETAMA";118;23;60;201
2009;"CARAUBAS (RN)";"RN";"CARAUBAS";104;16;5;125
2009;"CARNAUBA DOS DANTAS (RN)";"RN";"CARNAUBA DOS DANTAS";134;4;5;143
2009;"CARNAUBAIS (RN)";"RN";"CARNAUBAIS";41;18;9;68
2009;"CEARA MIRIM (RN)";"RN";"CEARA MIRIM";258;29;88;375
2009;"CERRO CORA (RN)";"RN";"CERRO CORA";68;8;3;79
2009;"CORONEL EZEQUIEL (RN)";"RN";"CORONEL EZEQUIEL";24;7;3;34
2009;"CORONEL JOAO PESSOA (RN)";"RN";"CORONEL JOAO PESSOA";6;2;0;8
2009;"CRUZETA (RN)";"RN";"CRUZETA";63;9;2;74
2009;"CURRAIS NOVOS (RN)";"RN";"CURRAIS NOVOS";548;40;44;632
2009;"DOUTOR SEVERIANO (RN)";"RN";"DOUTOR SEVERIANO";9;7;2;18
2009;"ENCANTO (RN)";"RN";"ENCANTO";11;7;5;23
2009;"EQUADOR (RN)";"RN";"EQUADOR";63;2;0;65
2009;"ESPIRITO SANTO (RN)";"RN";"ESPIRITO SANTO";14;4;10;28
2009;"ESPIRITO SANTO DO OESTE (RN)";"RN";"ESPIRITO SANTO DO OESTE";15;8;2;25
2009;"EXTREMOZ (RN)";"RN";"EXTREMOZ";45;12;40;97
2009;"FELIPE GUERRA (RN)";"RN";"FELIPE GUERRA";12;6;4;22
2009;"FERNANDO PEDROZA (RN)";"RN";"FERNANDO PEDROZA";11;2;1;14
2009;"FLORANIA (RN)";"RN";"FLORANIA";40;6;4;50
2009;"FRANCISCO DANTAS (RN)";"RN";"FRANCISCO DANTAS";6;2;1;9
2009;"FRUTUOSO GOMES (RN)";"RN";"FRUTUOSO GOMES";15;10;0;25
2009;"GALINHOS (RN)";"RN";"GALINHOS";7;3;2;12
2009;"GOIANINHA (RN)";"RN";"GOIANINHA";117;29;46;192
2009;"GOVERNADOR DIX SEPT ROSADO (RN)";"RN";"GOVERNADOR DIX SEPT ROSADO";109;9;9;127
2009;"GROSSOS (RN)";"RN";"GROSSOS";38;4;11;53
2009;"GUAMARE (RN)";"RN";"GUAMARE";49;16;22;87
2009;"IELMO MARINHO (RN)";"RN";"IELMO MARINHO";35;2;15;52
2009;"IPANGUACU (RN)";"RN";"IPANGUACU";61;17;54;132
2009;"IPUEIRA (RN)";"RN";"IPUEIRA";12;7;6;25
2009;"ITAJA (RN)";"RN";"ITAJA";69;4;6;79
2009;"ITAU (RN)";"RN";"ITAU";20;7;1;28
2009;"JACANA (RN)";"RN";"JACANA";77;28;11;116
2009;"JANDAIRA (RN)";"RN";"JANDAIRA";38;1;11;50
2009;"JANDUIS (RN)";"RN";"JANDUIS";11;4;1;16
2009;"JAPI (RN)";"RN";"JAPI";32;8;7;47
2009;"JARDIM DE ANGICOS (RN)";"RN";"JARDIM DE ANGICOS";4;1;1;6
2009;"JARDIM DE PIRANHAS (RN)";"RN";"JARDIM DE PIRANHAS";73;17;5;95
2009;"JARDIM DO SERIDO (RN)";"RN";"JARDIM DO SERIDO";120;18;46;184
2009;"JOAO CAMARA (RN)";"RN";"JOAO CAMARA";247;10;21;278
2009;"JOAO DIAS (RN)";"RN";"JOAO DIAS";4;1;0;5
2009;"JOSE DA PENHA (RN)";"RN";"JOSE DA PENHA";17;10;2;29
2009;"JUCURUTU (RN)";"RN";"JUCURUTU";103;23;7;133
2009;"JUNDIA (RN)";"RN";"JUNDIA";10;3;7;20
2009;"LAGOA DANTA (RN)";"RN";"LAGOA DANTA";32;4;12;48
2009;"LAGOA DE PEDRAS (RN)";"RN";"LAGOA DE PEDRAS";27;3;7;37
2009;"LAGOA DE VELHOS (RN)";"RN";"LAGOA DE VELHOS";17;1;0;18
2009;"LAGOA NOVA (RN)";"RN";"LAGOA NOVA";58;5;5;68
2009;"LAGOA SALGADA (RN)";"RN";"LAGOA SALGADA";50;3;4;57
2009;"LAJES (RN)";"RN";"LAJES";43;4;5;52
2009;"LAJES PINTADAS (RN)";"RN";"LAJES PINTADAS";16;8;5;29
2009;"LUCRECIA (RN)";"RN";"LUCRECIA";21;6;2;29
2009;"LUIS GOMES (RN)";"RN";"LUIS GOMES";24;28;4;56
2009;"MACAIBA (RN)";"RN";"MACAIBA";558;49;49;656
2009;"MACAU (RN)";"RN";"MACAU";128;28;38;194
2009;"MAJOR SALES (RN)";"RN";"MAJOR SALES";10;9;0;19
2009;"MARCELINO VIEIRA (RN)";"RN";"MARCELINO VIEIRA";12;9;1;22
2009;"MARTINS (RN)";"RN";"MARTINS";32;6;4;42
2009;"MAXARANGUAPE (RN)";"RN";"MAXARANGUAPE";13;5;5;23
2009;"MESSIAS TARGINO (RN)";"RN";"MESSIAS TARGINO";29;7;1;37
2009;"MONTANHAS (RN)";"RN";"MONTANHAS";40;3;13;56
2009;"MONTE ALEGRE (RN)";"RN";"MONTE ALEGRE";79;7;10;96
2009;"MONTE DAS GAMELEIRAS (RN)";"RN";"MONTE DAS GAMELEIRAS";6;1;6;13
2009;"MOSSORO (RN)";"RN";"MOSSORO";2947;240;158;3345
2009;"NATAL (RN)";"RN";"NATAL";5708;1064;2066;8838
2009;"NISIA FLORESTA (RN)";"RN";"NISIA FLORESTA";55;32;51;138
2009;"NOVA CRUZ (RN)";"RN";"NOVA CRUZ";272;15;44;331
2009;"OLHO D AGUA DO BORGES (RN)";"RN";"OLHO D AGUA DO BORGES";16;2;1;19
2009;"OURO BRANCO (RN)";"RN";"OURO BRANCO";37;4;4;45
2009;"PARANA (RN)";"RN";"PARANA";13;6;2;21
2009;"PARAZINHO (RN)";"RN";"PARAZINHO";20;2;4;26
2009;"PARELHAS (RN)";"RN";"PARELHAS";285;18;26;329
2009;"PARNAMIRIM (RN)";"RN";"PARNAMIRIM";1458;278;276;2012
2009;"PASSA E FICA (RN)";"RN";"PASSA E FICA";81;21;13;115
2009;"PASSAGEM (RN)";"RN";"PASSAGEM";16;6;2;24
2009;"PATU (RN)";"RN";"PATU";62;17;1;80
2009;"PAU DOS FERROS (RN)";"RN";"PAU DOS FERROS";319;32;20;371
2009;"PEDRA GRANDE (RN)";"RN";"PEDRA GRANDE";6;1;4;11
2009;"PEDRA PRETA (RN)";"RN";"PEDRA PRETA";18;1;6;25
2009;"PEDRO AVELINO (RN)";"RN";"PEDRO AVELINO";29;2;2;33
2009;"PEDRO VELHO (RN)";"RN";"PEDRO VELHO";44;3;9;56
2009;"PENDENCIAS (RN)";"RN";"PENDENCIAS";44;9;15;68
2009;"PILOES (RN)";"RN";"PILOES";3;4;0;7
2009;"POCO BRANCO (RN)";"RN";"POCO BRANCO";28;4;4;36
2009;"PORTALEGRE (RN)";"RN";"PORTALEGRE";30;5;2;37
2009;"PORTO DO MANGUE (RN)";"RN";"PORTO DO MANGUE";40;9;8;57
2009;"PUREZA (RN)";"RN";"PUREZA";52;4;12;68
2009;"RAFAEL FERNANDES (RN)";"RN";"RAFAEL FERNANDES";9;5;0;14
2009;"RAFAEL GODEIRO (RN)";"RN";"RAFAEL GODEIRO";7;3;0;10
2009;"RIACHO DA CRUZ (RN)";"RN";"RIACHO DA CRUZ";3;2;0;5
2009;"RIACHO DE SANTANA (RN)";"RN";"RIACHO DE SANTANA";3;6;1;10
2009;"RIACHUELO (RN)";"RN";"RIACHUELO";19;2;3;24
2009;"RIO DO FOGO (RN)";"RN";"RIO DO FOGO";29;3;6;38
2009;"RODOLFO FERNANDES (RN)";"RN";"RODOLFO FERNANDES";17;7;2;26
2009;"RUY BARBOSA (RN)";"RN";"RUY BARBOSA";12;1;1;14
2009;"SANTA CRUZ (RN)";"RN";"SANTA CRUZ";326;17;20;363
2009;"SANTA MARIA (RN)";"RN";"SANTA MARIA";36;1;5;42
2009;"SANTANA DO MATOS (RN)";"RN";"SANTANA DO MATOS";66;11;3;80
2009;"SANTANA DO SERIDO (RN)";"RN";"SANTANA DO SERIDO";17;2;1;20
2009;"SANTO ANTONIO (RN)";"RN";"SANTO ANTONIO";92;35;15;142
2009;"SAO BENTO DO NORTE (RN)";"RN";"SAO BENTO DO NORTE";7;1;4;12
2009;"SAO BENTO DO TRAIRI (RN)";"RN";"SAO BENTO DO TRAIRI";16;2;2;20
2009;"SAO FERNANDO (RN)";"RN";"SAO FERNANDO";5;6;1;12
2009;"SAO FRANCISCO DO OESTE (RN)";"RN";"SAO FRANCISCO DO OESTE";11;3;1;15
2009;"SAO GONCALO DO AMARANTE (RN)";"RN";"SAO GONCALO DO AMARANTE";262;83;134;479
2009;"SAO JOAO DO SABUGI (RN)";"RN";"SAO JOAO DO SABUGI";32;15;1;48
2009;"SAO JOSE DE MIPIBU (RN)";"RN";"SAO JOSE DE MIPIBU";198;35;38;271
2009;"SAO JOSE DO CAMPESTRE (RN)";"RN";"SAO JOSE DO CAMPESTRE";59;4;9;72
2009;"SAO JOSE DO SERIDO (RN)";"RN";"SAO JOSE DO SERIDO";25;9;1;35
2009;"SAO MIGUEL (RN)";"RN";"SAO MIGUEL";143;16;18;177
2009;"SAO MIGUEL DE TOUROS (RN)";"RN";"SAO MIGUEL DE TOUROS";16;5;6;27
2009;"SAO PAULO DO POTENGI (RN)";"RN";"SAO PAULO DO POTENGI";99;7;9;115
2009;"SAO PEDRO (RN)";"RN";"SAO PEDRO";24;2;5;31
2009;"SAO RAFAEL (RN)";"RN";"SAO RAFAEL";26;15;3;44
2009;"SAO TOME (RN)";"RN";"SAO TOME";43;3;17;63
2009;"SAO VICENTE (RN)";"RN";"SAO VICENTE";38;4;1;43
2009;"SENADOR ELOI DE SOUZA (RN)";"RN";"SENADOR ELOI DE SOUZA";10;4;5;19
2009;"SENADOR GEORGINO AVELINO (RN)";"RN";"SENADOR GEORGINO AVELINO";12;1;1;14
2009;"SERRA CAIADA (RN)";"RN";"SERRA CAIADA";27;1;8;36
2009;"SERRA DE SAO BENTO (RN)";"RN";"SERRA DE SAO BENTO";25;7;2;34
2009;"SERRA DO MEL (RN)";"RN";"SERRA DO MEL";55;10;7;72
2009;"SERRA NEGRA DO NORTE (RN)";"RN";"SERRA NEGRA DO NORTE";77;15;2;94
2009;"SERRINHA (RN)";"RN";"SERRINHA";20;14;2;36
2009;"SERRINHA DOS PINTOS (RN)";"RN";"SERRINHA DOS PINTOS";25;7;1;33
2009;"SEVERIANO MELO (RN)";"RN";"SEVERIANO MELO";24;2;5;31
2009;"SITIO NOVO (RN)";"RN";"SITIO NOVO";15;6;0;21
2009;"TABOLEIRO GRANDE (RN)";"RN";"TABOLEIRO GRANDE";5;7;1;13
2009;"TAIPU (RN)";"RN";"TAIPU";49;3;11;63
2009;"TANGARA (RN)";"RN";"TANGARA";83;6;20;109
2009;"TENENTE ANANIAS (RN)";"RN";"TENENTE ANANIAS";30;6;2;38
2009;"TENENTE LAURENTINO CRUZ (RN)";"RN";"TENENTE LAURENTINO CRUZ";35;9;3;47
2009;"TIBAU (RN)";"RN";"TIBAU";20;13;5;38
2009;"TIBAU DO SUL (RN)";"RN";"TIBAU DO SUL";40;39;10;89
2009;"TIMBAUBA DOS BATISTAS (RN)";"RN";"TIMBAUBA DOS BATISTAS";18;7;1;26
2009;"TOUROS (RN)";"RN";"TOUROS";127;22;28;177
2009;"TRIUNFO POTIGUAR (RN)";"RN";"TRIUNFO POTIGUAR";9;8;1;18
2009;"UMARIZAL (RN)";"RN";"UMARIZAL";53;23;2;78
2009;"UPANEMA (RN)";"RN";"UPANEMA";42;10;8;60
2009;"VARZEA (RN)";"RN";"VARZEA";10;3;5;18
2009;"VENHA VER (RN)";"RN";"VENHA VER";16;4;0;20
2009;"VERA CRUZ (RN)";"RN";"VERA CRUZ";102;6;18;126
2009;"VICOSA (RN)";"RN";"VICOSA";5;1;0;6
2009;"VILA FLOR (RN)";"RN";"VILA FLOR";10;1;2;13
2009;"ALTA FLORESTA D OESTE (RO)";"RO";"ALTA FLORESTA D OESTE";437;11;34;482
2009;"ALTO ALEGRE DOS PARECIS (RO)";"RO";"ALTO ALEGRE DOS PARECIS";93;3;16;112
2009;"ALTO PARAISO (RO)";"RO";"ALTO PARAISO";173;7;30;210
2009;"ALVORADA D OESTE (RO)";"RO";"ALVORADA D OESTE";231;5;48;284
2009;"ARIQUEMES (RO)";"RO";"ARIQUEMES";1778;24;145;1947
2009;"BURITIS (RO)";"RO";"BURITIS";353;4;19;376
2009;"CABIXI (RO)";"RO";"CABIXI";52;1;14;67
2009;"CACAULANDIA (RO)";"RO";"CACAULANDIA";43;2;10;55
2009;"CACOAL (RO)";"RO";"CACOAL";1362;33;218;1613
2009;"CAMPO NOVO DE RONDONIA (RO)";"RO";"CAMPO NOVO DE RONDONIA";41;1;9;51
2009;"CANDEIAS DO JAMARI (RO)";"RO";"CANDEIAS DO JAMARI";97;2;5;104
2009;"CASTANHEIRAS (RO)";"RO";"CASTANHEIRAS";25;1;5;31
2009;"CEREJEIRAS (RO)";"RO";"CEREJEIRAS";325;8;35;368
2009;"CHUPINGUAIA (RO)";"RO";"CHUPINGUAIA";75;4;13;92
2009;"COLORADO DO OESTE (RO)";"RO";"COLORADO DO OESTE";345;7;35;387
2009;"CORUMBIARA (RO)";"RO";"CORUMBIARA";49;4;11;64
2009;"COSTA MARQUES (RO)";"RO";"COSTA MARQUES";48;2;7;57
2009;"CUJUBIM (RO)";"RO";"CUJUBIM";94;3;7;104
2009;"ESPIGAO D OESTE (RO)";"RO";"ESPIGAO D OESTE";447;3;71;521
2009;"GOVERNADOR JORGE TEIXEIRA (RO)";"RO";"GOVERNADOR JORGE TEIXEIRA";36;0;10;46
2009;"GUAJARA MIRIM (RO)";"RO";"GUAJARA MIRIM";499;11;31;541
2009;"JAMARI (RO)";"RO";"JAMARI";75;0;23;98
2009;"JARU (RO)";"RO";"JARU";935;20;155;1110
2009;"JI PARANA (RO)";"RO";"JI PARANA";2376;55;554;2985
2009;"MACHADINHO D OESTE (RO)";"RO";"MACHADINHO D OESTE";240;5;40;285
2009;"MINISTRO ANDREAZZA (RO)";"RO";"MINISTRO ANDREAZZA";140;2;9;151
2009;"MIRANTE DA SERRA (RO)";"RO";"MIRANTE DA SERRA";148;3;14;165
2009;"MONTE NEGRO (RO)";"RO";"MONTE NEGRO";205;5;42;252
2009;"NOVA BRASILANDIA D OESTE (RO)";"RO";"NOVA BRASILANDIA D OESTE";205;7;36;248
2009;"NOVA UNIAO (RO)";"RO";"NOVA UNIAO";35;1;7;43
2009;"NOVO HORIZONTE DO OESTE (RO)";"RO";"NOVO HORIZONTE DO OESTE";75;3;11;89
2009;"OURO PRETO DO OESTE (RO)";"RO";"OURO PRETO DO OESTE";636;25;92;753
2009;"PARECIS (RO)";"RO";"PARECIS";20;1;8;29
2009;"PIMENTA BUENO (RO)";"RO";"PIMENTA BUENO";822;31;63;916
2009;"PIMENTEIRAS DO OESTE (RO)";"RO";"PIMENTEIRAS DO OESTE";8;1;9;18
2009;"PORTO VELHO (RO)";"RO";"PORTO VELHO";4577;260;934;5771
2009;"PRESIDENTE MEDICI (RO)";"RO";"PRESIDENTE MEDICI";249;4;40;293
2009;"PRIMAVERA DE RONDONIA (RO)";"RO";"PRIMAVERA DE RONDONIA";26;1;9;36
2009;"RIO CRESPO (RO)";"RO";"RIO CRESPO";49;1;15;65
2009;"ROLIM DE MOURA (RO)";"RO";"ROLIM DE MOURA";1036;25;91;1152
2009;"SANTA LUZIA D OESTE (RO)";"RO";"SANTA LUZIA D OESTE";112;2;29;143
2009;"SAO FELIPE D OESTE (RO)";"RO";"SAO FELIPE D OESTE";46;1;13;60
2009;"SAO FRANCISCO DO GUAPORE (RO)";"RO";"SAO FRANCISCO DO GUAPORE";152;2;21;175
2009;"SAO MIGUEL DO GUAPORE (RO)";"RO";"SAO MIGUEL DO GUAPORE";210;5;45;260
2009;"SERINGUEIRAS (RO)";"RO";"SERINGUEIRAS";122;3;20;145
2009;"TEIXEIROPOLIS (RO)";"RO";"TEIXEIROPOLIS";25;0;12;37
2009;"THEOBROMA (RO)";"RO";"THEOBROMA";45;0;14;59
2009;"URUPA (RO)";"RO";"URUPA";100;2;24;126
2009;"VALE DO ANARI (RO)";"RO";"VALE DO ANARI";36;3;2;41
2009;"VALE DO PARAISO (RO)";"RO";"VALE DO PARAISO";48;1;8;57
2009;"VILA NOVA DO MAMORE (RO)";"RO";"VILA NOVA DO MAMORE";124;1;8;133
2009;"VILHENA (RO)";"RO";"VILHENA";1224;42;130;1396
2009;"ALTO ALEGRE (RR)";"RR";"ALTO ALEGRE";39;3;7;49
2009;"AMAJARI (RR)";"RR";"AMAJARI";12;3;0;15
2009;"BOA VISTA (RR)";"RR";"BOA VISTA";2545;308;527;3380
2009;"BONFIM (RR)";"RR";"BONFIM";8;1;0;9
2009;"CANTA (RR)";"RR";"CANTA";22;3;6;31
2009;"CARACARAI (RR)";"RR";"CARACARAI";60;3;2;65
2009;"CAROEBE (RR)";"RR";"CAROEBE";17;3;12;32
2009;"IRACEMA (RR)";"RR";"IRACEMA";18;11;0;29
2009;"MUCAJAI (RR)";"RR";"MUCAJAI";67;27;25;119
2009;"NORMANDIA (RR)";"RR";"NORMANDIA";9;0;0;9
2009;"PACARAIMA (RR)";"RR";"PACARAIMA";38;0;3;41
2009;"RORAINOPOLIS (RR)";"RR";"RORAINOPOLIS";58;8;5;71
2009;"SAO JOAO DA BALIZA (RR)";"RR";"SAO JOAO DA BALIZA";33;6;2;41
2009;"SAO LUIZ (RR)";"RR";"SAO LUIZ";30;3;2;35
2009;"UIRAMUTA (RR)";"RR";"UIRAMUTA";1;0;0;1
2009;"ACEGUA (RS)";"RS";"ACEGUA";51;11;10;72
2009;"AGUA SANTA (RS)";"RS";"AGUA SANTA";138;6;12;156
2009;"AGUDO (RS)";"RS";"AGUDO";271;12;50;333
2009;"AJURICABA (RS)";"RS";"AJURICABA";326;15;30;371
2009;"ALECRIM (RS)";"RS";"ALECRIM";73;5;23;101
2009;"ALEGRETE (RS)";"RS";"ALEGRETE";879;47;177;1103
2009;"ALEGRIA (RS)";"RS";"ALEGRIA";74;5;18;97
2009;"ALMIRANTE TAMANDARE DO SUL (RS)";"RS";"ALMIRANTE TAMANDARE DO SUL";68;8;5;81
2009;"ALPESTRE (RS)";"RS";"ALPESTRE";123;22;37;182
2009;"ALTO ALEGRE (RS)";"RS";"ALTO ALEGRE";72;5;6;83
2009;"ALTO FELIZ (RS)";"RS";"ALTO FELIZ";85;8;12;105
2009;"ALVORADA (RS)";"RS";"ALVORADA";1428;129;519;2076
2009;"AMARAL FERRADOR (RS)";"RS";"AMARAL FERRADOR";134;11;19;164
2009;"AMETISTA DO SUL (RS)";"RS";"AMETISTA DO SUL";49;3;35;87
2009;"ANDRE DA ROCHA (RS)";"RS";"ANDRE DA ROCHA";46;4;3;53
2009;"ANTA GORDA (RS)";"RS";"ANTA GORDA";184;11;21;216
2009;"ANTONIO PRADO (RS)";"RS";"ANTONIO PRADO";595;16;37;648
2009;"ARAMBARE (RS)";"RS";"ARAMBARE";36;6;8;50
2009;"ARARICA (RS)";"RS";"ARARICA";83;5;7;95
2009;"ARATIBA (RS)";"RS";"ARATIBA";138;19;25;182
2009;"ARROIO DO MEIO (RS)";"RS";"ARROIO DO MEIO";448;31;45;524
2009;"ARROIO DO PADRE (RS)";"RS";"ARROIO DO PADRE";91;6;13;110
2009;"ARROIO DO SAL (RS)";"RS";"ARROIO DO SAL";88;11;11;110
2009;"ARROIO DO TIGRE (RS)";"RS";"ARROIO DO TIGRE";245;22;30;297
2009;"ARROIO DOS RATOS (RS)";"RS";"ARROIO DOS RATOS";177;10;55;242
2009;"ARROIO GRANDE (RS)";"RS";"ARROIO GRANDE";219;13;43;275
2009;"ARVOREZINHA (RS)";"RS";"ARVOREZINHA";409;35;29;473
2009;"AUGUSTO PESTANA (RS)";"RS";"AUGUSTO PESTANA";351;13;27;391
2009;"AUREA (RS)";"RS";"AUREA";103;5;7;115
2009;"BAGE (RS)";"RS";"BAGE";1029;141;259;1429
2009;"BALNEARIO PINHAL (RS)";"RS";"BALNEARIO PINHAL";89;7;15;111
2009;"BARAO (RS)";"RS";"BARAO";172;26;26;224
2009;"BARAO DE COTEGIPE (RS)";"RS";"BARAO DE COTEGIPE";188;16;16;220
2009;"BARAO DO TRIUNFO (RS)";"RS";"BARAO DO TRIUNFO";119;18;29;166
2009;"BARRA DO GUARITA (RS)";"RS";"BARRA DO GUARITA";19;6;4;29
2009;"BARRA DO QUARAI (RS)";"RS";"BARRA DO QUARAI";30;3;12;45
2009;"BARRA DO RIBEIRO (RS)";"RS";"BARRA DO RIBEIRO";137;10;37;184
2009;"BARRA DO RIO AZUL (RS)";"RS";"BARRA DO RIO AZUL";41;9;9;59
2009;"BARRA FUNDA (RS)";"RS";"BARRA FUNDA";149;6;6;161
2009;"BARRACAO (RS)";"RS";"BARRACAO";127;9;18;154
2009;"BARROS CASSAL (RS)";"RS";"BARROS CASSAL";142;10;38;190
2009;"BENJAMIN CONSTANT DO SUL (RS)";"RS";"BENJAMIN CONSTANT DO SUL";24;4;6;34
2009;"BENTO GONCALVES (RS)";"RS";"BENTO GONCALVES";3014;205;286;3505
2009;"BOA VISTA DAS MISSOES (RS)";"RS";"BOA VISTA DAS MISSOES";71;4;12;87
2009;"BOA VISTA DO BURICA (RS)";"RS";"BOA VISTA DO BURICA";186;11;18;215
2009;"BOA VISTA DO CADEADO (RS)";"RS";"BOA VISTA DO CADEADO";61;2;19;82
2009;"BOA VISTA DO INCRA (RS)";"RS";"BOA VISTA DO INCRA";54;1;6;61
2009;"BOA VISTA DO SUL (RS)";"RS";"BOA VISTA DO SUL";307;6;8;321
2009;"BOM JESUS (RS)";"RS";"BOM JESUS";239;25;35;299
2009;"BOM PRINCIPIO (RS)";"RS";"BOM PRINCIPIO";386;28;24;438
2009;"BOM PROGRESSO (RS)";"RS";"BOM PROGRESSO";36;6;3;45
2009;"BOM RETIRO DO SUL (RS)";"RS";"BOM RETIRO DO SUL";146;8;29;183
2009;"BOQUEIRAO DO LEAO (RS)";"RS";"BOQUEIRAO DO LEAO";146;7;18;171
2009;"BOSSOROCA (RS)";"RS";"BOSSOROCA";152;3;18;173
2009;"BOZANO (RS)";"RS";"BOZANO";115;2;6;123
2009;"BRAGA (RS)";"RS";"BRAGA";58;0;8;66
2009;"BROCHIER (RS)";"RS";"BROCHIER";236;10;20;266
2009;"BUTIA (RS)";"RS";"BUTIA";383;15;86;484
2009;"CACAPAVA DO SUL (RS)";"RS";"CACAPAVA DO SUL";531;49;90;670
2009;"CACEQUI (RS)";"RS";"CACEQUI";117;16;17;150
2009;"CACHOEIRA DO SUL (RS)";"RS";"CACHOEIRA DO SUL";1032;68;197;1297
2009;"CACHOEIRINHA (RS)";"RS";"CACHOEIRINHA";1915;192;280;2387
2009;"CACIQUE DOBLE (RS)";"RS";"CACIQUE DOBLE";91;4;10;105
2009;"CAIBATE (RS)";"RS";"CAIBATE";111;8;3;122
2009;"CAICARA (RS)";"RS";"CAICARA";76;7;18;101
2009;"CAMAQUA (RS)";"RS";"CAMAQUA";1215;50;199;1464
2009;"CAMARGO (RS)";"RS";"CAMARGO";114;9;16;139
2009;"CAMBARA DO SUL (RS)";"RS";"CAMBARA DO SUL";269;14;30;313
2009;"CAMPESTRE DA SERRA (RS)";"RS";"CAMPESTRE DA SERRA";143;2;9;154
2009;"CAMPINA DAS MISSOES (RS)";"RS";"CAMPINA DAS MISSOES";109;13;27;149
2009;"CAMPINAS DO SUL (RS)";"RS";"CAMPINAS DO SUL";192;13;24;229
2009;"CAMPO BOM (RS)";"RS";"CAMPO BOM";646;75;90;811
2009;"CAMPO NOVO (RS)";"RS";"CAMPO NOVO";135;11;17;163
2009;"CAMPOS BORGES (RS)";"RS";"CAMPOS BORGES";115;9;11;135
2009;"CANDELARIA (RS)";"RS";"CANDELARIA";359;17;67;443
2009;"CANDIDO GODOI (RS)";"RS";"CANDIDO GODOI";189;15;18;222
2009;"CANDIOTA (RS)";"RS";"CANDIOTA";105;27;31;163
2009;"CANELA (RS)";"RS";"CANELA";490;74;107;671
2009;"CANGUCU (RS)";"RS";"CANGUCU";958;64;137;1159
2009;"CANOAS (RS)";"RS";"CANOAS";3919;381;1029;5329
2009;"CANUDOS DO VALE (RS)";"RS";"CANUDOS DO VALE";23;7;2;32
2009;"CAPAO BONITO DO SUL (RS)";"RS";"CAPAO BONITO DO SUL";37;3;4;44
2009;"CAPAO DA CANOA (RS)";"RS";"CAPAO DA CANOA";374;59;81;514
2009;"CAPAO DO CIPO (RS)";"RS";"CAPAO DO CIPO";75;6;4;85
2009;"CAPAO DO LEAO (RS)";"RS";"CAPAO DO LEAO";406;21;22;449
2009;"CAPELA DE SANTANA (RS)";"RS";"CAPELA DE SANTANA";150;13;13;176
2009;"CAPITAO (RS)";"RS";"CAPITAO";62;7;6;75
2009;"CAPIVARI DO SUL (RS)";"RS";"CAPIVARI DO SUL";109;9;4;122
2009;"CARAA (RS)";"RS";"CARAA";89;2;19;110
2009;"CARAZINHO (RS)";"RS";"CARAZINHO";1242;66;180;1488
2009;"CARLOS BARBOSA (RS)";"RS";"CARLOS BARBOSA";670;45;82;797
2009;"CARLOS GOMES (RS)";"RS";"CARLOS GOMES";21;3;6;30
2009;"CASCA (RS)";"RS";"CASCA";352;16;18;386
2009;"CASEIROS (RS)";"RS";"CASEIROS";135;5;11;151
2009;"CATUIPE (RS)";"RS";"CATUIPE";317;6;25;348
2009;"CAXIAS DO SUL (RS)";"RS";"CAXIAS DO SUL";7684;1184;1444;10312
2009;"CENTENARIO (RS)";"RS";"CENTENARIO";72;8;8;88
2009;"CERRITO (RS)";"RS";"CERRITO";134;4;6;144
2009;"CERRO BRANCO (RS)";"RS";"CERRO BRANCO";65;6;13;84
2009;"CERRO GRANDE (RS)";"RS";"CERRO GRANDE";33;1;8;42
2009;"CERRO GRANDE DO SUL (RS)";"RS";"CERRO GRANDE DO SUL";214;14;16;244
2009;"CERRO LARGO (RS)";"RS";"CERRO LARGO";309;12;35;356
2009;"CHAPADA (RS)";"RS";"CHAPADA";289;31;25;345
2009;"CHARQUEADAS (RS)";"RS";"CHARQUEADAS";299;58;65;422
2009;"CHARRUA (RS)";"RS";"CHARRUA";82;3;9;94
2009;"CHIAPETTA (RS)";"RS";"CHIAPETTA";120;5;10;135
2009;"CHUI (RS)";"RS";"CHUI";122;13;12;147
2009;"CHUVISCA (RS)";"RS";"CHUVISCA";99;5;30;134
2009;"CIDREIRA (RS)";"RS";"CIDREIRA";86;11;19;116
2009;"CIRIACO (RS)";"RS";"CIRIACO";147;17;18;182
2009;"COLINAS (RS)";"RS";"COLINAS";58;6;8;72
2009;"COLORADO (RS)";"RS";"COLORADO";188;13;11;212
2009;"CONDOR (RS)";"RS";"CONDOR";208;14;22;244
2009;"CONSTANTINA (RS)";"RS";"CONSTANTINA";246;21;63;330
2009;"COQUEIRO BAIXO (RS)";"RS";"COQUEIRO BAIXO";17;6;2;25
2009;"COQUEIROS DO SUL (RS)";"RS";"COQUEIROS DO SUL";99;4;10;113
2009;"CORONEL BARROS (RS)";"RS";"CORONEL BARROS";88;1;10;99
2009;"CORONEL BICACO (RS)";"RS";"CORONEL BICACO";173;16;15;204
2009;"CORONEL PILAR (RS)";"RS";"CORONEL PILAR";193;4;8;205
2009;"COTIPORA (RS)";"RS";"COTIPORA";178;10;9;197
2009;"COXILHA (RS)";"RS";"COXILHA";93;4;12;109
2009;"CRISSIUMAL (RS)";"RS";"CRISSIUMAL";262;21;38;321
2009;"CRISTAL (RS)";"RS";"CRISTAL";148;8;22;178
2009;"CRISTAL DO SUL (RS)";"RS";"CRISTAL DO SUL";18;3;15;36
2009;"CRUZ ALTA (RS)";"RS";"CRUZ ALTA";1130;70;107;1307
2009;"CRUZALTENSE (RS)";"RS";"CRUZALTENSE";57;3;6;66
2009;"CRUZEIRO DO SUL (RS)";"RS";"CRUZEIRO DO SUL";301;11;7;319
2009;"DAVID CANABARRO (RS)";"RS";"DAVID CANABARRO";156;5;24;185
2009;"DERRUBADAS (RS)";"RS";"DERRUBADAS";70;10;4;84
2009;"DEZESSEIS DE NOVEMBRO (RS)";"RS";"DEZESSEIS DE NOVEMBRO";46;3;6;55
2009;"DILERMANDO DE AGUIAR (RS)";"RS";"DILERMANDO DE AGUIAR";39;3;24;66
2009;"DOIS IRMAOS (RS)";"RS";"DOIS IRMAOS";386;20;111;517
2009;"DOIS IRMAOS DAS MISSOES (RS)";"RS";"DOIS IRMAOS DAS MISSOES";52;6;5;63
2009;"DOIS LAJEADOS (RS)";"RS";"DOIS LAJEADOS";108;4;15;127
2009;"DOM FELICIANO (RS)";"RS";"DOM FELICIANO";228;12;75;315
2009;"DOM PEDRITO (RS)";"RS";"DOM PEDRITO";526;27;35;588
2009;"DOM PEDRO DE ALCANTARA (RS)";"RS";"DOM PEDRO DE ALCANTARA";81;1;4;86
2009;"DONA FRANCISCA (RS)";"RS";"DONA FRANCISCA";39;1;8;48
2009;"DOUTOR MAURICIO CARDOSO (RS)";"RS";"DOUTOR MAURICIO CARDOSO";158;17;17;192
2009;"DOUTOR RICARDO (RS)";"RS";"DOUTOR RICARDO";57;6;10;73
2009;"ELDORADO DO SUL (RS)";"RS";"ELDORADO DO SUL";362;26;40;428
2009;"ENCANTADO (RS)";"RS";"ENCANTADO";601;45;99;745
2009;"ENCRUZILHADA DO SUL (RS)";"RS";"ENCRUZILHADA DO SUL";344;14;130;488
2009;"ENGENHO VELHO (RS)";"RS";"ENGENHO VELHO";27;2;9;38
2009;"ENTRE IJUIS (RS)";"RS";"ENTRE IJUIS";267;10;22;299
2009;"ENTRE RIOS DO SUL (RS)";"RS";"ENTRE RIOS DO SUL";49;12;13;74
2009;"EREBANGO (RS)";"RS";"EREBANGO";96;2;7;105
2009;"ERECHIM (RS)";"RS";"ERECHIM";1651;213;515;2379
2009;"ERNESTINA (RS)";"RS";"ERNESTINA";136;15;12;163
2009;"ERVAL GRANDE (RS)";"RS";"ERVAL GRANDE";96;19;16;131
2009;"ERVAL SECO (RS)";"RS";"ERVAL SECO";132;7;31;170
2009;"ESMERALDA (RS)";"RS";"ESMERALDA";63;4;11;78
2009;"ESPERANCA DO SUL (RS)";"RS";"ESPERANCA DO SUL";40;1;9;50
2009;"ESPUMOSO (RS)";"RS";"ESPUMOSO";548;25;64;637
2009;"ESTACAO (RS)";"RS";"ESTACAO";181;14;7;202
2009;"ESTANCIA VELHA (RS)";"RS";"ESTANCIA VELHA";707;61;89;857
2009;"ESTEIO (RS)";"RS";"ESTEIO";1054;123;220;1397
2009;"ESTRELA (RS)";"RS";"ESTRELA";822;40;75;937
2009;"ESTRELA VELHA (RS)";"RS";"ESTRELA VELHA";105;5;12;122
2009;"EUGENIO DE CASTRO (RS)";"RS";"EUGENIO DE CASTRO";81;8;6;95
2009;"FAGUNDES VARELA (RS)";"RS";"FAGUNDES VARELA";91;6;16;113
2009;"FARROUPILHA (RS)";"RS";"FARROUPILHA";1835;210;165;2210
2009;"FAXINAL DO SOTURNO (RS)";"RS";"FAXINAL DO SOTURNO";118;6;6;130
2009;"FAXINALZINHO (RS)";"RS";"FAXINALZINHO";55;7;9;71
2009;"FAZENDA VILANOVA (RS)";"RS";"FAZENDA VILANOVA";111;8;8;127
2009;"FELIZ (RS)";"RS";"FELIZ";356;28;66;450
2009;"FLORES DA CUNHA (RS)";"RS";"FLORES DA CUNHA";1298;65;96;1459
2009;"FLORIANO PEIXOTO (RS)";"RS";"FLORIANO PEIXOTO";52;13;13;78
2009;"FONTOURA XAVIER (RS)";"RS";"FONTOURA XAVIER";181;15;28;224
2009;"FORMIGUEIRO (RS)";"RS";"FORMIGUEIRO";131;5;21;157
2009;"FORQUETINHA (RS)";"RS";"FORQUETINHA";51;3;3;57
2009;"FORTALEZA DOS VALOS (RS)";"RS";"FORTALEZA DOS VALOS";215;2;17;234
2009;"FREDERICO WESTPHALEN (RS)";"RS";"FREDERICO WESTPHALEN";596;29;69;694
2009;"GARIBALDI (RS)";"RS";"GARIBALDI";1300;63;100;1463
2009;"GARRUCHOS (RS)";"RS";"GARRUCHOS";27;7;10;44
2009;"GAURAMA (RS)";"RS";"GAURAMA";171;13;11;195
2009;"GENERAL CAMARA (RS)";"RS";"GENERAL CAMARA";71;11;18;100
2009;"GENTIL (RS)";"RS";"GENTIL";81;8;19;108
2009;"GETULIO VARGAS (RS)";"RS";"GETULIO VARGAS";467;22;29;518
2009;"GIRUA (RS)";"RS";"GIRUA";477;27;39;543
2009;"GLORINHA (RS)";"RS";"GLORINHA";169;26;10;205
2009;"GRAMADO (RS)";"RS";"GRAMADO";616;116;111;843
2009;"GRAMADO DOS LOUREIROS (RS)";"RS";"GRAMADO DOS LOUREIROS";27;1;9;37
2009;"GRAMADO XAVIER (RS)";"RS";"GRAMADO XAVIER";56;4;6;66
2009;"GRAVATAI (RS)";"RS";"GRAVATAI";2774;422;489;3685
2009;"GUABIJU (RS)";"RS";"GUABIJU";48;5;11;64
2009;"GUAIBA (RS)";"RS";"GUAIBA";910;151;370;1431
2009;"GUAPORE (RS)";"RS";"GUAPORE";399;30;54;483
2009;"GUARANI DAS MISSOES (RS)";"RS";"GUARANI DAS MISSOES";203;7;17;227
2009;"HARMONIA (RS)";"RS";"HARMONIA";195;7;8;210
2009;"HERVAL (RS)";"RS";"HERVAL";104;6;7;117
2009;"HERVEIRAS (RS)";"RS";"HERVEIRAS";45;0;2;47
2009;"HORIZONTINA (RS)";"RS";"HORIZONTINA";291;32;47;370
2009;"HULHA NEGRA (RS)";"RS";"HULHA NEGRA";49;9;30;88
2009;"HUMAITA (RS)";"RS";"HUMAITA";92;2;7;101
2009;"IBARAMA (RS)";"RS";"IBARAMA";85;3;15;103
2009;"IBIACA (RS)";"RS";"IBIACA";231;8;16;255
2009;"IBIRAIARAS (RS)";"RS";"IBIRAIARAS";399;8;25;432
2009;"IBIRAPUITA (RS)";"RS";"IBIRAPUITA";114;4;23;141
2009;"IBIRUBA (RS)";"RS";"IBIRUBA";780;39;62;881
2009;"IGREJINHA (RS)";"RS";"IGREJINHA";362;37;69;468
2009;"IJUI (RS)";"RS";"IJUI";1684;98;110;1892
2009;"ILOPOLIS (RS)";"RS";"ILOPOLIS";165;5;5;175
2009;"IMBE (RS)";"RS";"IMBE";205;17;42;264
2009;"IMIGRANTE (RS)";"RS";"IMIGRANTE";86;12;20;118
2009;"INDEPENDENCIA (RS)";"RS";"INDEPENDENCIA";172;20;36;228
2009;"INHACORA (RS)";"RS";"INHACORA";61;6;7;74
2009;"IPE (RS)";"RS";"IPE";239;22;24;285
2009;"IPIRANGA DO SUL (RS)";"RS";"IPIRANGA DO SUL";103;10;9;122
2009;"IRAI (RS)";"RS";"IRAI";107;8;22;137
2009;"ITAARA (RS)";"RS";"ITAARA";96;2;9;107
2009;"ITACURUBI (RS)";"RS";"ITACURUBI";28;6;8;42
2009;"ITAPUCA (RS)";"RS";"ITAPUCA";43;2;9;54
2009;"ITAQUI (RS)";"RS";"ITAQUI";586;19;54;659
2009;"ITATI (RS)";"RS";"ITATI";61;3;7;71
2009;"ITATIBA DO SUL (RS)";"RS";"ITATIBA DO SUL";76;16;7;99
2009;"IVORA (RS)";"RS";"IVORA";58;4;4;66
2009;"IVOTI (RS)";"RS";"IVOTI";453;34;94;581
2009;"JABOTICABA (RS)";"RS";"JABOTICABA";46;2;15;63
2009;"JACUIZINHO (RS)";"RS";"JACUIZINHO";42;4;10;56
2009;"JACUTINGA (RS)";"RS";"JACUTINGA";105;8;8;121
2009;"JAGUARAO (RS)";"RS";"JAGUARAO";285;13;36;334
2009;"JAGUARI (RS)";"RS";"JAGUARI";209;19;48;276
2009;"JAQUIRANA (RS)";"RS";"JAQUIRANA";132;7;7;146
2009;"JARI (RS)";"RS";"JARI";51;5;9;65
2009;"JOIA (RS)";"RS";"JOIA";253;11;33;297
2009;"JULIO DE CASTILHOS (RS)";"RS";"JULIO DE CASTILHOS";532;22;45;599
2009;"LAGOA BONITA DO SUL (RS)";"RS";"LAGOA BONITA DO SUL";46;5;17;68
2009;"LAGOA DOS TRES CANTOS (RS)";"RS";"LAGOA DOS TRES CANTOS";77;7;4;88
2009;"LAGOA VERMELHA (RS)";"RS";"LAGOA VERMELHA";580;34;74;688
2009;"LAGOAO (RS)";"RS";"LAGOAO";58;6;28;92
2009;"LAJEADO (RS)";"RS";"LAJEADO";1767;139;228;2134
2009;"LAJEADO DO BUGRE (RS)";"RS";"LAJEADO DO BUGRE";18;2;6;26
2009;"LAVRAS DO SUL (RS)";"RS";"LAVRAS DO SUL";68;10;19;97
2009;"LIBERATO SALZANO (RS)";"RS";"LIBERATO SALZANO";104;6;21;131
2009;"LINDOLFO COLLOR (RS)";"RS";"LINDOLFO COLLOR";100;8;9;117
2009;"LINHA NOVA (RS)";"RS";"LINHA NOVA";60;8;3;71
2009;"MACAMBARA (RS)";"RS";"MACAMBARA";33;3;25;61
2009;"MACHADINHO (RS)";"RS";"MACHADINHO";93;8;22;123
2009;"MAMPITUBA (RS)";"RS";"MAMPITUBA";29;1;10;40
2009;"MANOEL VIANA (RS)";"RS";"MANOEL VIANA";151;5;11;167
2009;"MAQUINE (RS)";"RS";"MAQUINE";255;9;11;275
2009;"MARATA (RS)";"RS";"MARATA";97;11;23;131
2009;"MARAU (RS)";"RS";"MARAU";926;62;115;1103
2009;"MARCELINO RAMOS (RS)";"RS";"MARCELINO RAMOS";110;18;21;149
2009;"MARIANA PIMENTEL (RS)";"RS";"MARIANA PIMENTEL";102;7;23;132
2009;"MARIANO MORO (RS)";"RS";"MARIANO MORO";58;12;6;76
2009;"MARQUES DE SOUZA (RS)";"RS";"MARQUES DE SOUZA";112;15;14;141
2009;"MATA (RS)";"RS";"MATA";89;2;17;108
2009;"MATO CASTELHANO (RS)";"RS";"MATO CASTELHANO";106;9;22;137
2009;"MATO LEITAO (RS)";"RS";"MATO LEITAO";276;7;8;291
2009;"MATO QUEIMADO (RS)";"RS";"MATO QUEIMADO";38;6;4;48
2009;"MAXIMILIANO DE ALMEIDA (RS)";"RS";"MAXIMILIANO DE ALMEIDA";115;7;74;196
2009;"MINAS DO LEAO (RS)";"RS";"MINAS DO LEAO";99;11;25;135
2009;"MIRAGUAI (RS)";"RS";"MIRAGUAI";78;2;20;100
2009;"MONTAURI (RS)";"RS";"MONTAURI";51;4;5;60
2009;"MONTE ALEGRE DOS CAMPOS (RS)";"RS";"MONTE ALEGRE DOS CAMPOS";59;4;27;90
2009;"MONTE BELO DO SUL (RS)";"RS";"MONTE BELO DO SUL";182;8;15;205
2009;"MONTENEGRO (RS)";"RS";"MONTENEGRO";1177;135;198;1510
2009;"MORMACO (RS)";"RS";"MORMACO";65;4;8;77
2009;"MORRINHOS DO SUL (RS)";"RS";"MORRINHOS DO SUL";134;1;6;141
2009;"MORRO REDONDO (RS)";"RS";"MORRO REDONDO";198;3;16;217
2009;"MORRO REUTER (RS)";"RS";"MORRO REUTER";138;11;23;172
2009;"MOSTARDAS (RS)";"RS";"MOSTARDAS";247;7;53;307
2009;"MUCUM (RS)";"RS";"MUCUM";86;11;20;117
2009;"MUITOS CAPOES (RS)";"RS";"MUITOS CAPOES";51;4;3;58
2009;"MULITERNO (RS)";"RS";"MULITERNO";82;5;7;94
2009;"NAO ME TOQUE (RS)";"RS";"NAO ME TOQUE";475;23;51;549
2009;"NICOLAU VERGUEIRO (RS)";"RS";"NICOLAU VERGUEIRO";83;5;16;104
2009;"NONOAI (RS)";"RS";"NONOAI";190;14;47;251
2009;"NOVA ALVORADA (RS)";"RS";"NOVA ALVORADA";117;3;16;136
2009;"NOVA ARACA (RS)";"RS";"NOVA ARACA";142;16;26;184
2009;"NOVA BASSANO (RS)";"RS";"NOVA BASSANO";448;27;31;506
2009;"NOVA BOA VISTA (RS)";"RS";"NOVA BOA VISTA";64;9;12;85
2009;"NOVA BRESCIA (RS)";"RS";"NOVA BRESCIA";93;13;8;114
2009;"NOVA CANDELARIA (RS)";"RS";"NOVA CANDELARIA";67;7;7;81
2009;"NOVA ESPERANCA DO SUL (RS)";"RS";"NOVA ESPERANCA DO SUL";55;6;21;82
2009;"NOVA HARTZ (RS)";"RS";"NOVA HARTZ";113;11;59;183
2009;"NOVA PADUA (RS)";"RS";"NOVA PADUA";280;4;6;290
2009;"NOVA PALMA (RS)";"RS";"NOVA PALMA";202;13;24;239
2009;"NOVA PETROPOLIS (RS)";"RS";"NOVA PETROPOLIS";485;43;57;585
2009;"NOVA PRATA (RS)";"RS";"NOVA PRATA";563;21;47;631
2009;"NOVA RAMADA (RS)";"RS";"NOVA RAMADA";81;5;7;93
2009;"NOVA ROMA DO SUL (RS)";"RS";"NOVA ROMA DO SUL";245;7;23;275
2009;"NOVA SANTA RITA (RS)";"RS";"NOVA SANTA RITA";462;37;35;534
2009;"NOVO BARREIRO (RS)";"RS";"NOVO BARREIRO";91;7;15;113
2009;"NOVO CABRAIS (RS)";"RS";"NOVO CABRAIS";73;2;9;84
2009;"NOVO HAMBURGO (RS)";"RS";"NOVO HAMBURGO";2474;244;362;3080
2009;"NOVO MACHADO (RS)";"RS";"NOVO MACHADO";128;19;10;157
2009;"NOVO TIRADENTES (RS)";"RS";"NOVO TIRADENTES";27;3;8;38
2009;"NOVO XINGU (RS)";"RS";"NOVO XINGU";29;9;8;46
2009;"OSORIO (RS)";"RS";"OSORIO";805;45;109;959
2009;"PAIM FILHO (RS)";"RS";"PAIM FILHO";109;3;20;132
2009;"PALMARES DO SUL (RS)";"RS";"PALMARES DO SUL";168;15;26;209
2009;"PALMEIRA DAS MISSOES (RS)";"RS";"PALMEIRA DAS MISSOES";801;19;73;893
2009;"PALMITINHO (RS)";"RS";"PALMITINHO";134;5;31;170
2009;"PANAMBI (RS)";"RS";"PANAMBI";878;50;99;1027
2009;"PANTANO GRANDE (RS)";"RS";"PANTANO GRANDE";285;8;24;317
2009;"PARAI (RS)";"RS";"PARAI";362;10;21;393
2009;"PARAISO DO SUL (RS)";"RS";"PARAISO DO SUL";80;5;8;93
2009;"PARECI NOVO (RS)";"RS";"PARECI NOVO";397;9;19;425
2009;"PAROBE (RS)";"RS";"PAROBE";421;64;131;616
2009;"PASSA SETE (RS)";"RS";"PASSA SETE";63;1;26;90
2009;"PASSO DO SOBRADO (RS)";"RS";"PASSO DO SOBRADO";120;8;38;166
2009;"PASSO FUNDO (RS)";"RS";"PASSO FUNDO";2864;172;322;3358
2009;"PAULO BENTO (RS)";"RS";"PAULO BENTO";64;12;8;84
2009;"PAVERAMA (RS)";"RS";"PAVERAMA";178;24;38;240
2009;"PEDRAS ALTAS (RS)";"RS";"PEDRAS ALTAS";14;15;0;29
2009;"PEDRO OSORIO (RS)";"RS";"PEDRO OSORIO";92;4;29;125
2009;"PEJUCARA (RS)";"RS";"PEJUCARA";205;3;15;223
2009;"PELOTAS (RS)";"RS";"PELOTAS";4729;253;927;5909
2009;"PICADA CAFE (RS)";"RS";"PICADA CAFE";94;20;55;169
2009;"PINHAL (RS)";"RS";"PINHAL";63;2;9;74
2009;"PINHAL DA SERRA (RS)";"RS";"PINHAL DA SERRA";38;6;12;56
2009;"PINHAL GRANDE (RS)";"RS";"PINHAL GRANDE";96;11;22;129
2009;"PINHEIRINHO DO VALE (RS)";"RS";"PINHEIRINHO DO VALE";50;4;17;71
2009;"PINHEIRO MACHADO (RS)";"RS";"PINHEIRO MACHADO";131;9;35;175
2009;"PINTO BANDEIRA (RS)";"RS";"PINTO BANDEIRA";4;0;0;4
2009;"PIRAPO (RS)";"RS";"PIRAPO";29;9;10;48
2009;"PIRATINI (RS)";"RS";"PIRATINI";223;24;82;329
2009;"PLANALTO (RS)";"RS";"PLANALTO";172;5;29;206
2009;"POCO DAS ANTAS (RS)";"RS";"POCO DAS ANTAS";77;9;15;101
2009;"PONTAO (RS)";"RS";"PONTAO";89;4;19;112
2009;"PONTE PRETA (RS)";"RS";"PONTE PRETA";53;5;4;62
2009;"PORTAO (RS)";"RS";"PORTAO";1612;82;95;1789
2009;"PORTO ALEGRE (RS)";"RS";"PORTO ALEGRE";14115;2022;4161;20298
2009;"PORTO LUCENA (RS)";"RS";"PORTO LUCENA";80;9;15;104
2009;"PORTO MAUA (RS)";"RS";"PORTO MAUA";48;7;6;61
2009;"PORTO VERA CRUZ (RS)";"RS";"PORTO VERA CRUZ";6;2;8;16
2009;"PORTO XAVIER (RS)";"RS";"PORTO XAVIER";184;9;29;222
2009;"POUSO NOVO (RS)";"RS";"POUSO NOVO";38;8;4;50
2009;"PRESIDENTE LUCENA (RS)";"RS";"PRESIDENTE LUCENA";125;3;7;135
2009;"PROGRESSO (RS)";"RS";"PROGRESSO";101;9;20;130
2009;"PROTASIO ALVES (RS)";"RS";"PROTASIO ALVES";47;4;5;56
2009;"PUTINGA (RS)";"RS";"PUTINGA";96;10;12;118
2009;"QUARAI (RS)";"RS";"QUARAI";151;11;37;199
2009;"QUATRO IRMAOS (RS)";"RS";"QUATRO IRMAOS";49;11;3;63
2009;"QUEVEDOS (RS)";"RS";"QUEVEDOS";24;3;6;33
2009;"QUINZE DE NOVEMBRO (RS)";"RS";"QUINZE DE NOVEMBRO";162;16;16;194
2009;"REDENTORA (RS)";"RS";"REDENTORA";92;13;15;120
2009;"RELVADO (RS)";"RS";"RELVADO";44;5;4;53
2009;"RESTINGA SECA (RS)";"RS";"RESTINGA SECA";279;7;51;337
2009;"RIO DOS INDIOS (RS)";"RS";"RIO DOS INDIOS";53;3;29;85
2009;"RIO GRANDE (RS)";"RS";"RIO GRANDE";1847;133;416;2396
2009;"RIO PARDO (RS)";"RS";"RIO PARDO";375;31;63;469
2009;"RIOZINHO (RS)";"RS";"RIOZINHO";45;6;27;78
2009;"ROCA SALES (RS)";"RS";"ROCA SALES";142;16;42;200
2009;"RODEIO BONITO (RS)";"RS";"RODEIO BONITO";90;5;23;118
2009;"ROLADOR (RS)";"RS";"ROLADOR";53;4;7;64
2009;"ROLANTE (RS)";"RS";"ROLANTE";204;20;48;272
2009;"RONDA ALTA (RS)";"RS";"RONDA ALTA";228;13;22;263
2009;"RONDINHA (RS)";"RS";"RONDINHA";158;9;21;188
2009;"ROQUE GONZALES (RS)";"RS";"ROQUE GONZALES";127;2;20;149
2009;"ROSARIO DO SUL (RS)";"RS";"ROSARIO DO SUL";437;27;66;530
2009;"SAGRADA FAMILIA (RS)";"RS";"SAGRADA FAMILIA";25;3;6;34
2009;"SALDANHA MARINHO (RS)";"RS";"SALDANHA MARINHO";151;11;7;169
2009;"SALTO DO JACUI (RS)";"RS";"SALTO DO JACUI";162;15;25;202
2009;"SALVADOR DAS MISSOES (RS)";"RS";"SALVADOR DAS MISSOES";90;2;3;95
2009;"SALVADOR DO SUL (RS)";"RS";"SALVADOR DO SUL";242;26;23;291
2009;"SANANDUVA (RS)";"RS";"SANANDUVA";574;18;44;636
2009;"SANTA BARBARA DO SUL (RS)";"RS";"SANTA BARBARA DO SUL";307;15;34;356
2009;"SANTA CECILIA DO SUL (RS)";"RS";"SANTA CECILIA DO SUL";47;3;12;62
2009;"SANTA CLARA DO SUL (RS)";"RS";"SANTA CLARA DO SUL";119;26;10;155
2009;"SANTA CRUZ DO SUL (RS)";"RS";"SANTA CRUZ DO SUL";1752;138;507;2397
2009;"SANTA MARGARIDA DO SUL (RS)";"RS";"SANTA MARGARIDA DO SUL";39;6;1;46
2009;"SANTA MARIA (RS)";"RS";"SANTA MARIA";2831;308;887;4026
2009;"SANTA MARIA DO HERVAL (RS)";"RS";"SANTA MARIA DO HERVAL";185;10;45;240
2009;"SANTA ROSA (RS)";"RS";"SANTA ROSA";1304;79;140;1523
2009;"SANTA TEREZA (RS)";"RS";"SANTA TEREZA";78;5;5;88
2009;"SANTA VITORIA DO PALMAR (RS)";"RS";"SANTA VITORIA DO PALMAR";473;8;55;536
2009;"SANTANA DA BOA VISTA (RS)";"RS";"SANTANA DA BOA VISTA";67;6;34;107
2009;"SANTANA DO LIVRAMENTO (RS)";"RS";"SANTANA DO LIVRAMENTO";662;49;148;859
2009;"SANTIAGO (RS)";"RS";"SANTIAGO";710;53;86;849
2009;"SANTO ANGELO (RS)";"RS";"SANTO ANGELO";1055;73;92;1220
2009;"SANTO ANTONIO DA PATRULHA (RS)";"RS";"SANTO ANTONIO DA PATRULHA";776;29;143;948
2009;"SANTO ANTONIO DAS MISSOES (RS)";"RS";"SANTO ANTONIO DAS MISSOES";143;28;21;192
2009;"SANTO ANTONIO DO PALMA (RS)";"RS";"SANTO ANTONIO DO PALMA";46;3;8;57
2009;"SANTO ANTONIO DO PLANALTO (RS)";"RS";"SANTO ANTONIO DO PLANALTO";89;3;7;99
2009;"SANTO AUGUSTO (RS)";"RS";"SANTO AUGUSTO";459;27;24;510
2009;"SANTO CRISTO (RS)";"RS";"SANTO CRISTO";409;18;42;469
2009;"SANTO EXPEDITO DO SUL (RS)";"RS";"SANTO EXPEDITO DO SUL";86;4;10;100
2009;"SAO BORJA (RS)";"RS";"SAO BORJA";1050;47;78;1175
2009;"SAO DOMINGOS DO SUL (RS)";"RS";"SAO DOMINGOS DO SUL";83;7;3;93
2009;"SAO FRANCISCO DE ASSIS (RS)";"RS";"SAO FRANCISCO DE ASSIS";265;14;77;356
2009;"SAO FRANCISCO DE PAULA (RS)";"RS";"SAO FRANCISCO DE PAULA";460;33;52;545
2009;"SAO GABRIEL (RS)";"RS";"SAO GABRIEL";791;27;100;918
2009;"SAO JERONIMO (RS)";"RS";"SAO JERONIMO";260;23;107;390
2009;"SAO JOAO DA URTIGA (RS)";"RS";"SAO JOAO DA URTIGA";124;5;18;147
2009;"SAO JOAO DO POLESINE (RS)";"RS";"SAO JOAO DO POLESINE";62;0;5;67
2009;"SAO JORGE (RS)";"RS";"SAO JORGE";124;6;15;145
2009;"SAO JOSE DAS MISSOES (RS)";"RS";"SAO JOSE DAS MISSOES";39;4;10;53
2009;"SAO JOSE DO HERVAL (RS)";"RS";"SAO JOSE DO HERVAL";64;4;10;78
2009;"SAO JOSE DO HORTENCIO (RS)";"RS";"SAO JOSE DO HORTENCIO";184;9;32;225
2009;"SAO JOSE DO INHACORA (RS)";"RS";"SAO JOSE DO INHACORA";37;4;3;44
2009;"SAO JOSE DO NORTE (RS)";"RS";"SAO JOSE DO NORTE";296;4;48;348
2009;"SAO JOSE DO OURO (RS)";"RS";"SAO JOSE DO OURO";279;7;26;312
2009;"SAO JOSE DO SUL (RS)";"RS";"SAO JOSE DO SUL";123;11;4;138
2009;"SAO JOSE DOS AUSENTES (RS)";"RS";"SAO JOSE DOS AUSENTES";83;7;11;101
2009;"SAO LEOPOLDO (RS)";"RS";"SAO LEOPOLDO";1755;209;487;2451
2009;"SAO LOURENCO DO SUL (RS)";"RS";"SAO LOURENCO DO SUL";864;36;124;1024
2009;"SAO LUIZ GONZAGA (RS)";"RS";"SAO LUIZ GONZAGA";548;46;77;671
2009;"SAO MARCOS (RS)";"RS";"SAO MARCOS";629;14;95;738
2009;"SAO MARTINHO (RS)";"RS";"SAO MARTINHO";165;10;15;190
2009;"SAO MARTINHO DA SERRA (RS)";"RS";"SAO MARTINHO DA SERRA";40;1;2;43
2009;"SAO MIGUEL DAS MISSOES (RS)";"RS";"SAO MIGUEL DAS MISSOES";199;24;25;248
2009;"SAO NICOLAU (RS)";"RS";"SAO NICOLAU";58;9;8;75
2009;"SAO PAULO DAS MISSOES (RS)";"RS";"SAO PAULO DAS MISSOES";96;7;23;126
2009;"SAO PEDRO DA SERRA (RS)";"RS";"SAO PEDRO DA SERRA";94;9;9;112
2009;"SAO PEDRO DAS MISSOES (RS)";"RS";"SAO PEDRO DAS MISSOES";27;4;6;37
2009;"SAO PEDRO DO BUTIA (RS)";"RS";"SAO PEDRO DO BUTIA";97;1;11;109
2009;"SAO PEDRO DO SUL (RS)";"RS";"SAO PEDRO DO SUL";253;42;31;326
2009;"SAO SEBASTIAO DO CAI (RS)";"RS";"SAO SEBASTIAO DO CAI";645;24;58;727
2009;"SAO SEPE (RS)";"RS";"SAO SEPE";393;26;82;501
2009;"SAO VALENTIM (RS)";"RS";"SAO VALENTIM";66;9;8;83
2009;"SAO VALENTIM DO SUL (RS)";"RS";"SAO VALENTIM DO SUL";77;3;10;90
2009;"SAO VALERIO DO SUL (RS)";"RS";"SAO VALERIO DO SUL";42;5;5;52
2009;"SAO VENDELINO (RS)";"RS";"SAO VENDELINO";81;9;3;93
2009;"SAO VICENTE DO SUL (RS)";"RS";"SAO VICENTE DO SUL";115;4;36;155
2009;"SAPIRANGA (RS)";"RS";"SAPIRANGA";787;98;136;1021
2009;"SAPUCAIA DO SUL (RS)";"RS";"SAPUCAIA DO SUL";1419;132;128;1679
2009;"SARANDI (RS)";"RS";"SARANDI";515;29;61;605
2009;"SEBERI (RS)";"RS";"SEBERI";217;10;31;258
2009;"SEDE NOVA (RS)";"RS";"SEDE NOVA";59;8;9;76
2009;"SEGREDO (RS)";"RS";"SEGREDO";140;4;26;170
2009;"SELBACH (RS)";"RS";"SELBACH";262;9;15;286
2009;"SENADOR SALGADO FILHO (RS)";"RS";"SENADOR SALGADO FILHO";100;8;9;117
2009;"SENTINELA DO SUL (RS)";"RS";"SENTINELA DO SUL";113;3;12;128
2009;"SERAFINA CORREA (RS)";"RS";"SERAFINA CORREA";292;42;44;378
2009;"SERIO (RS)";"RS";"SERIO";55;7;5;67
2009;"SERTAO (RS)";"RS";"SERTAO";222;13;26;261
2009;"SERTAO SANTANA (RS)";"RS";"SERTAO SANTANA";158;10;22;190
2009;"SETE DE SETEMBRO (RS)";"RS";"SETE DE SETEMBRO";50;2;10;62
2009;"SEVERIANO DE ALMEIDA (RS)";"RS";"SEVERIANO DE ALMEIDA";84;13;12;109
2009;"SILVEIRA MARTINS (RS)";"RS";"SILVEIRA MARTINS";119;1;5;125
2009;"SINIMBU (RS)";"RS";"SINIMBU";117;2;5;124
2009;"SOBRADINHO (RS)";"RS";"SOBRADINHO";287;19;53;359
2009;"SOLEDADE (RS)";"RS";"SOLEDADE";452;23;92;567
2009;"TABAI (RS)";"RS";"TABAI";148;15;7;170
2009;"TAPEJARA (RS)";"RS";"TAPEJARA";660;20;65;745
2009;"TAPERA (RS)";"RS";"TAPERA";333;22;23;378
2009;"TAPES (RS)";"RS";"TAPES";264;13;30;307
2009;"TAQUARA (RS)";"RS";"TAQUARA";678;46;222;946
2009;"TAQUARI (RS)";"RS";"TAQUARI";418;31;121;570
2009;"TAQUARUCU DO SUL (RS)";"RS";"TAQUARUCU DO SUL";61;2;8;71
2009;"TAVARES (RS)";"RS";"TAVARES";104;4;8;116
2009;"TENENTE PORTELA (RS)";"RS";"TENENTE PORTELA";248;10;34;292
2009;"TERRA DE AREIA (RS)";"RS";"TERRA DE AREIA";294;11;19;324
2009;"TEUTONIA (RS)";"RS";"TEUTONIA";557;30;68;655
2009;"TIO HUGO (RS)";"RS";"TIO HUGO";74;6;10;90
2009;"TIRADENTES DO SUL (RS)";"RS";"TIRADENTES DO SUL";83;6;10;99
2009;"TOROPI (RS)";"RS";"TOROPI";41;1;17;59
2009;"TORRES (RS)";"RS";"TORRES";373;24;56;453
2009;"TRAMANDAI (RS)";"RS";"TRAMANDAI";530;54;121;705
2009;"TRAVESSEIRO (RS)";"RS";"TRAVESSEIRO";42;7;8;57
2009;"TRES ARROIOS (RS)";"RS";"TRES ARROIOS";81;9;3;93
2009;"TRES CACHOEIRAS (RS)";"RS";"TRES CACHOEIRAS";592;10;14;616
2009;"TRES COROAS (RS)";"RS";"TRES COROAS";214;25;52;291
2009;"TRES DE MAIO (RS)";"RS";"TRES DE MAIO";618;47;69;734
2009;"TRES FORQUILHAS (RS)";"RS";"TRES FORQUILHAS";93;4;3;100
2009;"TRES PALMEIRAS (RS)";"RS";"TRES PALMEIRAS";69;4;16;89
2009;"TRES PASSOS (RS)";"RS";"TRES PASSOS";357;24;110;491
2009;"TRINDADE DO SUL (RS)";"RS";"TRINDADE DO SUL";105;10;24;139
2009;"TRIUNFO (RS)";"RS";"TRIUNFO";432;111;130;673
2009;"TUCUNDUVA (RS)";"RS";"TUCUNDUVA";203;11;12;226
2009;"TUNAS (RS)";"RS";"TUNAS";40;5;15;60
2009;"TUPANCI DO SUL (RS)";"RS";"TUPANCI DO SUL";45;3;11;59
2009;"TUPANCIRETA (RS)";"RS";"TUPANCIRETA";468;35;40;543
2009;"TUPANDI (RS)";"RS";"TUPANDI";95;25;26;146
2009;"TUPARENDI (RS)";"RS";"TUPARENDI";202;12;26;240
2009;"TURUCU (RS)";"RS";"TURUCU";81;5;9;95
2009;"UBIRETAMA (RS)";"RS";"UBIRETAMA";69;8;2;79
2009;"UNIAO DA SERRA (RS)";"RS";"UNIAO DA SERRA";53;2;9;64
2009;"UNISTALDA (RS)";"RS";"UNISTALDA";21;5;13;39
2009;"URUGUAIANA (RS)";"RS";"URUGUAIANA";1729;73;150;1952
2009;"VACARIA (RS)";"RS";"VACARIA";1588;105;400;2093
2009;"VALE DO SOL (RS)";"RS";"VALE DO SOL";176;6;29;211
2009;"VALE REAL (RS)";"RS";"VALE REAL";227;10;9;246
2009;"VALE VERDE (RS)";"RS";"VALE VERDE";45;3;6;54
2009;"VANINI (RS)";"RS";"VANINI";87;15;11;113
2009;"VENANCIO AIRES (RS)";"RS";"VENANCIO AIRES";1048;69;166;1283
2009;"VERA CRUZ (RS)";"RS";"VERA CRUZ";345;14;83;442
2009;"VERANOPOLIS (RS)";"RS";"VERANOPOLIS";848;39;61;948
2009;"VESPASIANO CORREA (RS)";"RS";"VESPASIANO CORREA";83;3;14;100
2009;"VIADUTOS (RS)";"RS";"VIADUTOS";126;9;20;155
2009;"VIAMAO (RS)";"RS";"VIAMAO";1674;242;526;2442
2009;"VICENTE DUTRA (RS)";"RS";"VICENTE DUTRA";46;2;16;64
2009;"VICTOR GRAEFF (RS)";"RS";"VICTOR GRAEFF";140;13;5;158
2009;"VILA FLORES (RS)";"RS";"VILA FLORES";159;10;12;181
2009;"VILA LANGARO (RS)";"RS";"VILA LANGARO";86;6;10;102
2009;"VILA MARIA (RS)";"RS";"VILA MARIA";226;10;38;274
2009;"VILA NOVA DO SUL (RS)";"RS";"VILA NOVA DO SUL";89;6;9;104
2009;"VISTA ALEGRE (RS)";"RS";"VISTA ALEGRE";50;6;11;67
2009;"VISTA ALEGRE DO PRATA (RS)";"RS";"VISTA ALEGRE DO PRATA";37;6;4;47
2009;"VISTA GAUCHA (RS)";"RS";"VISTA GAUCHA";47;2;9;58
2009;"VITORIA DAS MISSOES (RS)";"RS";"VITORIA DAS MISSOES";80;1;11;92
2009;"WESTFALIA (RS)";"RS";"WESTFALIA";106;19;7;132
2009;"XANGRI LA (RS)";"RS";"XANGRI LA";143;12;5;160
2009;"ABDON BATISTA (SC)";"SC";"ABDON BATISTA";46;5;7;58
2009;"ABELARDO LUZ (SC)";"SC";"ABELARDO LUZ";326;12;66;404
2009;"AGROLANDIA (SC)";"SC";"AGROLANDIA";194;10;14;218
2009;"AGRONOMICA (SC)";"SC";"AGRONOMICA";130;3;10;143
2009;"AGUA DOCE (SC)";"SC";"AGUA DOCE";164;20;16;200
2009;"AGUAS DE CHAPECO (SC)";"SC";"AGUAS DE CHAPECO";71;5;28;104
2009;"AGUAS FRIAS (SC)";"SC";"AGUAS FRIAS";43;2;4;49
2009;"AGUAS MORNAS (SC)";"SC";"AGUAS MORNAS";217;5;11;233
2009;"ALFREDO WAGNER (SC)";"SC";"ALFREDO WAGNER";215;23;9;247
2009;"ALTO BELA VISTA (SC)";"SC";"ALTO BELA VISTA";49;4;8;61
2009;"ANCHIETA (SC)";"SC";"ANCHIETA";149;15;15;179
2009;"ANGELINA (SC)";"SC";"ANGELINA";167;16;9;192
2009;"ANITA GARIBALDI (SC)";"SC";"ANITA GARIBALDI";131;10;23;164
2009;"ANITAPOLIS (SC)";"SC";"ANITAPOLIS";73;9;10;92
2009;"ANTONIO CARLOS (SC)";"SC";"ANTONIO CARLOS";529;9;7;545
2009;"APIUNA (SC)";"SC";"APIUNA";129;17;17;163
2009;"ARABUTA (SC)";"SC";"ARABUTA";90;7;24;121
2009;"ARAQUARI (SC)";"SC";"ARAQUARI";356;20;24;400
2009;"ARARANGUA (SC)";"SC";"ARARANGUA";1204;53;148;1405
2009;"ARMAZEM (SC)";"SC";"ARMAZEM";228;11;11;250
2009;"ARROIO TRINTA (SC)";"SC";"ARROIO TRINTA";152;12;9;173
2009;"ARVOREDO (SC)";"SC";"ARVOREDO";29;10;6;45
2009;"ASCURRA (SC)";"SC";"ASCURRA";178;15;27;220
2009;"ATALANTA (SC)";"SC";"ATALANTA";84;2;5;91
2009;"AURORA (SC)";"SC";"AURORA";172;4;8;184
2009;"BALNEARIO ARROIO DO SILVA (SC)";"SC";"BALNEARIO ARROIO DO SILVA";83;9;18;110
2009;"BALNEARIO CAMBORIU (SC)";"SC";"BALNEARIO CAMBORIU";872;192;207;1271
2009;"BALNEARIO GAIVOTA (SC)";"SC";"BALNEARIO GAIVOTA";132;10;11;153
2009;"BANDEIRANTE (SC)";"SC";"BANDEIRANTE";25;2;12;39
2009;"BARRA BONITA (SC)";"SC";"BARRA BONITA";29;4;10;43
2009;"BARRA DO SUL (SC)";"SC";"BARRA DO SUL";87;5;5;97
2009;"BARRA VELHA (SC)";"SC";"BARRA VELHA";304;24;22;350
2009;"BELA VISTA DO TOLDO (SC)";"SC";"BELA VISTA DO TOLDO";77;1;9;87
2009;"BELMONTE (SC)";"SC";"BELMONTE";50;6;9;65
2009;"BENEDITO NOVO (SC)";"SC";"BENEDITO NOVO";273;23;17;313
2009;"BIGUACU (SC)";"SC";"BIGUACU";838;54;140;1032
2009;"BLUMENAU (SC)";"SC";"BLUMENAU";4555;332;712;5599
2009;"BOCAINA DO SUL (SC)";"SC";"BOCAINA DO SUL";37;7;18;62
2009;"BOM JARDIM DA SERRA (SC)";"SC";"BOM JARDIM DA SERRA";83;3;18;104
2009;"BOM JESUS (SC)";"SC";"BOM JESUS";46;1;8;55
2009;"BOM JESUS DO OESTE (SC)";"SC";"BOM JESUS DO OESTE";44;1;8;53
2009;"BOM RETIRO (SC)";"SC";"BOM RETIRO";160;14;23;197
2009;"BOMBINHAS (SC)";"SC";"BOMBINHAS";113;28;18;159
2009;"BOTUVERA (SC)";"SC";"BOTUVERA";208;8;10;226
2009;"BRACO DO NORTE (SC)";"SC";"BRACO DO NORTE";910;37;55;1002
2009;"BRACO DO TROMBUDO (SC)";"SC";"BRACO DO TROMBUDO";114;7;1;122
2009;"BRUNOPOLIS (SC)";"SC";"BRUNOPOLIS";65;3;8;76
2009;"BRUSQUE (SC)";"SC";"BRUSQUE";2000;129;166;2295
2009;"CACADOR (SC)";"SC";"CACADOR";1821;94;775;2690
2009;"CAIBI (SC)";"SC";"CAIBI";159;6;22;187
2009;"CALMON (SC)";"SC";"CALMON";28;4;17;49
2009;"CAMBORIU (SC)";"SC";"CAMBORIU";834;32;19;885
2009;"CAMPO ALEGRE (SC)";"SC";"CAMPO ALEGRE";342;12;8;362
2009;"CAMPO BELO DO SUL (SC)";"SC";"CAMPO BELO DO SUL";164;7;23;194
2009;"CAMPO ERE (SC)";"SC";"CAMPO ERE";205;6;25;236
2009;"CAMPOS NOVOS (SC)";"SC";"CAMPOS NOVOS";864;55;75;994
2009;"CANELINHA (SC)";"SC";"CANELINHA";478;17;12;507
2009;"CANOINHAS (SC)";"SC";"CANOINHAS";1151;45;108;1304
2009;"CAPAO ALTO (SC)";"SC";"CAPAO ALTO";38;5;12;55
2009;"CAPINZAL (SC)";"SC";"CAPINZAL";396;30;33;459
2009;"CAPIVARI DE BAIXO (SC)";"SC";"CAPIVARI DE BAIXO";285;14;26;325
2009;"CATANDUVAS (SC)";"SC";"CATANDUVAS";288;18;35;341
2009;"CAXAMBU DO SUL (SC)";"SC";"CAXAMBU DO SUL";84;2;16;102
2009;"CELSO RAMOS (SC)";"SC";"CELSO RAMOS";48;3;3;54
2009;"CERRO NEGRO (SC)";"SC";"CERRO NEGRO";33;5;14;52
2009;"CHAPADAO DO LAGEADO (SC)";"SC";"CHAPADAO DO LAGEADO";42;5;7;54
2009;"CHAPECO (SC)";"SC";"CHAPECO";3729;206;324;4259
2009;"COCAL DO SUL (SC)";"SC";"COCAL DO SUL";239;15;13;267
2009;"CONCORDIA (SC)";"SC";"CONCORDIA";1932;115;159;2206
2009;"CORDILHEIRA ALTA (SC)";"SC";"CORDILHEIRA ALTA";234;10;3;247
2009;"CORONEL FREITAS (SC)";"SC";"CORONEL FREITAS";236;7;26;269
2009;"CORONEL MARTINS (SC)";"SC";"CORONEL MARTINS";39;6;13;58
2009;"CORREIA PINTO (SC)";"SC";"CORREIA PINTO";310;29;45;384
2009;"CORUPA (SC)";"SC";"CORUPA";332;6;30;368
2009;"CRICIUMA (SC)";"SC";"CRICIUMA";3201;273;362;3836
2009;"CUNHA PORA (SC)";"SC";"CUNHA PORA";297;14;41;352
2009;"CUNHATAI (SC)";"SC";"CUNHATAI";22;3;6;31
2009;"CURITIBANOS (SC)";"SC";"CURITIBANOS";868;41;87;996
2009;"DESCANSO (SC)";"SC";"DESCANSO";205;10;20;235
2009;"DIONISIO CERQUEIRA (SC)";"SC";"DIONISIO CERQUEIRA";125;14;19;158
2009;"DONA EMMA (SC)";"SC";"DONA EMMA";96;8;8;112
2009;"DOUTOR PEDRINHO (SC)";"SC";"DOUTOR PEDRINHO";111;7;7;125
2009;"ENTRE RIOS (SC)";"SC";"ENTRE RIOS";17;4;9;30
2009;"ERMO (SC)";"SC";"ERMO";54;3;6;63
2009;"ERVAL VELHO (SC)";"SC";"ERVAL VELHO";89;6;23;118
2009;"FAXINAL DOS GUEDES (SC)";"SC";"FAXINAL DOS GUEDES";347;15;24;386
2009;"FLOR DO SERTAO (SC)";"SC";"FLOR DO SERTAO";17;4;15;36
2009;"FLORIANOPOLIS (SC)";"SC";"FLORIANOPOLIS";3176;776;1568;5520
2009;"FORMOSA DO SUL (SC)";"SC";"FORMOSA DO SUL";52;5;15;72
2009;"FORQUILHINHA (SC)";"SC";"FORQUILHINHA";478;16;38;532
2009;"FRAIBURGO (SC)";"SC";"FRAIBURGO";752;43;207;1002
2009;"FREI ROGERIO (SC)";"SC";"FREI ROGERIO";61;6;10;77
2009;"GALVAO (SC)";"SC";"GALVAO";73;3;12;88
2009;"GAROPABA (SC)";"SC";"GAROPABA";207;14;29;250
2009;"GARUVA (SC)";"SC";"GARUVA";316;22;18;356
2009;"GASPAR (SC)";"SC";"GASPAR";1160;54;79;1293
2009;"GOVERNADOR CELSO RAMOS (SC)";"SC";"GOVERNADOR CELSO RAMOS";151;14;11;176
2009;"GRAO PARA (SC)";"SC";"GRAO PARA";220;11;9;240
2009;"GRAVATAL (SC)";"SC";"GRAVATAL";237;9;15;261
2009;"GUABIRUBA (SC)";"SC";"GUABIRUBA";283;10;11;304
2009;"GUARACIABA (SC)";"SC";"GUARACIABA";198;7;37;242
2009;"GUARAMIRIM (SC)";"SC";"GUARAMIRIM";891;30;21;942
2009;"GUARUJA DO SUL (SC)";"SC";"GUARUJA DO SUL";143;9;13;165
2009;"GUATAMBU (SC)";"SC";"GUATAMBU";66;8;17;91
2009;"HERVAL D OESTE (SC)";"SC";"HERVAL D OESTE";276;33;51;360
2009;"IBIAM (SC)";"SC";"IBIAM";60;2;12;74
2009;"IBICARE (SC)";"SC";"IBICARE";123;11;8;142
2009;"IBIRAMA (SC)";"SC";"IBIRAMA";360;35;69;464
2009;"ICARA (SC)";"SC";"ICARA";1405;66;115;1586
2009;"ILHOTA (SC)";"SC";"ILHOTA";284;17;14;315
2009;"IMARUI (SC)";"SC";"IMARUI";91;14;21;126
2009;"IMBITUBA (SC)";"SC";"IMBITUBA";503;63;63;629
2009;"IMBUIA (SC)";"SC";"IMBUIA";155;6;17;178
2009;"INDAIAL (SC)";"SC";"INDAIAL";1161;60;76;1297
2009;"IOMERE (SC)";"SC";"IOMERE";134;7;11;152
2009;"IPIRA (SC)";"SC";"IPIRA";93;6;11;110
2009;"IPORA DO OESTE (SC)";"SC";"IPORA DO OESTE";220;14;35;269
2009;"IPUACU (SC)";"SC";"IPUACU";81;9;17;107
2009;"IPUMIRIM (SC)";"SC";"IPUMIRIM";208;15;19;242
2009;"IRACEMINHA (SC)";"SC";"IRACEMINHA";86;7;17;110
2009;"IRANI (SC)";"SC";"IRANI";278;20;48;346
2009;"IRATI (SC)";"SC";"IRATI";26;6;9;41
2009;"IRINEOPOLIS (SC)";"SC";"IRINEOPOLIS";200;2;7;209
2009;"ITA (SC)";"SC";"ITA";79;18;26;123
2009;"ITAIOPOLIS (SC)";"SC";"ITAIOPOLIS";528;19;63;610
2009;"ITAJAI (SC)";"SC";"ITAJAI";3827;266;303;4396
2009;"ITAPEMA (SC)";"SC";"ITAPEMA";457;46;37;540
2009;"ITAPIRANGA (SC)";"SC";"ITAPIRANGA";255;19;49;323
2009;"ITAPOA (SC)";"SC";"ITAPOA";138;6;6;150
2009;"ITUPORANGA (SC)";"SC";"ITUPORANGA";593;19;38;650
2009;"JABORA (SC)";"SC";"JABORA";114;10;15;139
2009;"JACINTO MACHADO (SC)";"SC";"JACINTO MACHADO";372;6;31;409
2009;"JAGUARUNA (SC)";"SC";"JAGUARUNA";389;14;41;444
2009;"JARAGUA DO SUL (SC)";"SC";"JARAGUA DO SUL";2149;178;288;2615
2009;"JARDINOPOLIS (SC)";"SC";"JARDINOPOLIS";17;4;4;25
2009;"JOACABA (SC)";"SC";"JOACABA";775;50;34;859
2009;"JOINVILLE (SC)";"SC";"JOINVILLE";7222;574;799;8595
2009;"JOSE BOITEUX (SC)";"SC";"JOSE BOITEUX";101;17;8;126
2009;"JUPIA (SC)";"SC";"JUPIA";37;3;6;46
2009;"LACERDOPOLIS (SC)";"SC";"LACERDOPOLIS";104;8;5;117
2009;"LAGEADO GRANDE (SC)";"SC";"LAGEADO GRANDE";32;1;4;37
2009;"LAGES (SC)";"SC";"LAGES";3251;202;331;3784
2009;"LAGUNA (SC)";"SC";"LAGUNA";500;75;81;656
2009;"LAURENTINO (SC)";"SC";"LAURENTINO";258;4;4;266
2009;"LAURO MULLER (SC)";"SC";"LAURO MULLER";385;16;33;434
2009;"LEBON REGIS (SC)";"SC";"LEBON REGIS";189;13;31;233
2009;"LEOBERTO LEAL (SC)";"SC";"LEOBERTO LEAL";107;10;5;122
2009;"LINDOIA DO SUL (SC)";"SC";"LINDOIA DO SUL";122;10;41;173
2009;"LONTRAS (SC)";"SC";"LONTRAS";272;19;26;317
2009;"LUIZ ALVES (SC)";"SC";"LUIZ ALVES";423;11;18;452
2009;"LUZERNA (SC)";"SC";"LUZERNA";119;10;14;143
2009;"MACIEIRA (SC)";"SC";"MACIEIRA";55;6;10;71
2009;"MAFRA (SC)";"SC";"MAFRA";1158;87;130;1375
2009;"MAJOR GERCINO (SC)";"SC";"MAJOR GERCINO";117;11;9;137
2009;"MAJOR VIEIRA (SC)";"SC";"MAJOR VIEIRA";154;5;7;166
2009;"MARACAJA (SC)";"SC";"MARACAJA";194;1;7;202
2009;"MARAVILHA (SC)";"SC";"MARAVILHA";583;59;51;693
2009;"MAREMA (SC)";"SC";"MAREMA";55;8;8;71
2009;"MASSARANDUBA (SC)";"SC";"MASSARANDUBA";483;13;33;529
2009;"MATOS COSTA (SC)";"SC";"MATOS COSTA";33;5;9;47
2009;"MELEIRO (SC)";"SC";"MELEIRO";223;3;21;247
2009;"MIRIM DOCE (SC)";"SC";"MIRIM DOCE";48;2;9;59
2009;"MODELO (SC)";"SC";"MODELO";94;6;10;110
2009;"MONDAI (SC)";"SC";"MONDAI";178;8;35;221
2009;"MONTE CARLO (SC)";"SC";"MONTE CARLO";161;12;84;257
2009;"MONTE CASTELO (SC)";"SC";"MONTE CASTELO";159;7;14;180
2009;"MORRO DA FUMACA (SC)";"SC";"MORRO DA FUMACA";739;23;25;787
2009;"MORRO GRANDE (SC)";"SC";"MORRO GRANDE";88;1;7;96
2009;"NAVEGANTES (SC)";"SC";"NAVEGANTES";551;53;44;648
2009;"NOVA ERECHIM (SC)";"SC";"NOVA ERECHIM";82;5;9;96
2009;"NOVA ITABERABA (SC)";"SC";"NOVA ITABERABA";70;3;13;86
2009;"NOVA TRENTO (SC)";"SC";"NOVA TRENTO";234;13;30;277
2009;"NOVA VENEZA (SC)";"SC";"NOVA VENEZA";385;31;22;438
2009;"NOVO HORIZONTE (SC)";"SC";"NOVO HORIZONTE";55;10;9;74
2009;"ORLEANS (SC)";"SC";"ORLEANS";797;11;45;853
2009;"OTACILIO COSTA (SC)";"SC";"OTACILIO COSTA";381;27;37;445
2009;"OURO (SC)";"SC";"OURO";208;18;27;253
2009;"OURO VERDE (SC)";"SC";"OURO VERDE";74;2;8;84
2009;"PAIAL (SC)";"SC";"PAIAL";9;5;20;34
2009;"PAINEL (SC)";"SC";"PAINEL";25;3;7;35
2009;"PALHOCA (SC)";"SC";"PALHOCA";1770;107;326;2203
2009;"PALMA SOLA (SC)";"SC";"PALMA SOLA";165;5;23;193
2009;"PALMEIRA (SC)";"SC";"PALMEIRA";70;3;2;75
2009;"PALMITOS (SC)";"SC";"PALMITOS";327;26;61;414
2009;"PAPANDUVA (SC)";"SC";"PAPANDUVA";484;18;62;564
2009;"PARAISO (SC)";"SC";"PARAISO";50;5;7;62
2009;"PASSO DE TORRES (SC)";"SC";"PASSO DE TORRES";99;7;13;119
2009;"PASSOS MAIA (SC)";"SC";"PASSOS MAIA";96;3;21;120
2009;"PAULO LOPES (SC)";"SC";"PAULO LOPES";224;13;9;246
2009;"PEDRAS GRANDES (SC)";"SC";"PEDRAS GRANDES";230;12;13;255
2009;"PENHA (SC)";"SC";"PENHA";313;19;42;374
2009;"PERITIBA (SC)";"SC";"PERITIBA";72;4;12;88
2009;"PETROLANDIA (SC)";"SC";"PETROLANDIA";137;10;20;167
2009;"PICARRAS (SC)";"SC";"PICARRAS";269;23;22;314
2009;"PINHALZINHO (SC)";"SC";"PINHALZINHO";367;14;43;424
2009;"PINHEIRO PRETO (SC)";"SC";"PINHEIRO PRETO";252;4;10;266
2009;"PIRATUBA (SC)";"SC";"PIRATUBA";79;10;26;115
2009;"PLANALTO ALEGRE (SC)";"SC";"PLANALTO ALEGRE";46;4;4;54
2009;"POMERODE (SC)";"SC";"POMERODE";543;29;94;666
2009;"PONTE ALTA (SC)";"SC";"PONTE ALTA";106;6;12;124
2009;"PONTE ALTA DO NORTE (SC)";"SC";"PONTE ALTA DO NORTE";67;4;12;83
2009;"PONTE SERRADA (SC)";"SC";"PONTE SERRADA";285;20;55;360
2009;"PORTO BELO (SC)";"SC";"PORTO BELO";179;26;24;229
2009;"PORTO UNIAO (SC)";"SC";"PORTO UNIAO";529;15;30;574
2009;"POUSO REDONDO (SC)";"SC";"POUSO REDONDO";395;14;29;438
2009;"PRAIA GRANDE (SC)";"SC";"PRAIA GRANDE";192;12;16;220
2009;"PRESIDENTE CASTELO BRANCO (SC)";"SC";"PRESIDENTE CASTELO BRANCO";34;5;7;46
2009;"PRESIDENTE GETULIO (SC)";"SC";"PRESIDENTE GETULIO";290;27;58;375
2009;"PRESIDENTE NEREU (SC)";"SC";"PRESIDENTE NEREU";22;9;5;36
2009;"PRINCESA (SC)";"SC";"PRINCESA";44;2;10;56
2009;"QUILOMBO (SC)";"SC";"QUILOMBO";179;16;32;227
2009;"RANCHO QUEIMADO (SC)";"SC";"RANCHO QUEIMADO";108;2;3;113
2009;"RIO DAS ANTAS (SC)";"SC";"RIO DAS ANTAS";166;8;24;198
2009;"RIO DO CAMPO (SC)";"SC";"RIO DO CAMPO";147;11;15;173
2009;"RIO DO OESTE (SC)";"SC";"RIO DO OESTE";161;11;18;190
2009;"RIO DO SUL (SC)";"SC";"RIO DO SUL";1318;77;101;1496
2009;"RIO DOS CEDROS (SC)";"SC";"RIO DOS CEDROS";220;19;26;265
2009;"RIO FORTUNA (SC)";"SC";"RIO FORTUNA";235;11;15;261
2009;"RIO NEGRINHO (SC)";"SC";"RIO NEGRINHO";844;55;67;966
2009;"RIO RUFINO (SC)";"SC";"RIO RUFINO";39;4;14;57
2009;"RIQUEZA (SC)";"SC";"RIQUEZA";97;3;19;119
2009;"RODEIO (SC)";"SC";"RODEIO";202;9;12;223
2009;"ROMELANDIA (SC)";"SC";"ROMELANDIA";82;5;19;106
2009;"SALETE (SC)";"SC";"SALETE";151;12;14;177
2009;"SALTINHO (SC)";"SC";"SALTINHO";41;3;22;66
2009;"SALTO VELOSO (SC)";"SC";"SALTO VELOSO";126;4;5;135
2009;"SANGAO (SC)";"SC";"SANGAO";382;10;14;406
2009;"SANTA CECILIA (SC)";"SC";"SANTA CECILIA";321;27;44;392
2009;"SANTA HELENA (SC)";"SC";"SANTA HELENA";52;11;10;73
2009;"SANTA ROSA DE LIMA (SC)";"SC";"SANTA ROSA DE LIMA";96;8;8;112
2009;"SANTA ROSA DO SUL (SC)";"SC";"SANTA ROSA DO SUL";249;8;15;272
2009;"SANTA TEREZINHA (SC)";"SC";"SANTA TEREZINHA";146;12;24;182
2009;"SANTA TEREZINHA DO PROGRESSO (SC)";"SC";"SANTA TEREZINHA DO PROGRESSO";41;5;7;53
2009;"SANTIAGO DO SUL (SC)";"SC";"SANTIAGO DO SUL";36;5;4;45
2009;"SANTO AMARO DA IMPERATRIZ (SC)";"SC";"SANTO AMARO DA IMPERATRIZ";550;21;66;637
2009;"SAO BENTO DO SUL (SC)";"SC";"SAO BENTO DO SUL";1306;105;127;1538
2009;"SAO BERNARDINO (SC)";"SC";"SAO BERNARDINO";36;2;18;56
2009;"SAO BONIFACIO (SC)";"SC";"SAO BONIFACIO";115;6;10;131
2009;"SAO CARLOS (SC)";"SC";"SAO CARLOS";182;16;37;235
2009;"SAO CRISTOVAO DO SUL (SC)";"SC";"SAO CRISTOVAO DO SUL";178;5;13;196
2009;"SAO DOMINGOS (SC)";"SC";"SAO DOMINGOS";256;15;34;305
2009;"SAO FRANCISCO DO SUL (SC)";"SC";"SAO FRANCISCO DO SUL";530;47;67;644
2009;"SAO JOAO BATISTA (SC)";"SC";"SAO JOAO BATISTA";501;14;38;553
2009;"SAO JOAO DO ITAPERIU (SC)";"SC";"SAO JOAO DO ITAPERIU";186;2;6;194
2009;"SAO JOAO DO OESTE (SC)";"SC";"SAO JOAO DO OESTE";149;10;12;171
2009;"SAO JOAO DO SUL (SC)";"SC";"SAO JOAO DO SUL";183;3;10;196
2009;"SAO JOAQUIM (SC)";"SC";"SAO JOAQUIM";724;54;152;930
2009;"SAO JOSE (SC)";"SC";"SAO JOSE";3200;226;205;3631
2009;"SAO JOSE DO CEDRO (SC)";"SC";"SAO JOSE DO CEDRO";355;19;71;445
2009;"SAO JOSE DO CERRITO (SC)";"SC";"SAO JOSE DO CERRITO";144;4;34;182
2009;"SAO LOURENCO D OESTE (SC)";"SC";"SAO LOURENCO D OESTE";725;40;56;821
2009;"SAO LUDGERO (SC)";"SC";"SAO LUDGERO";518;10;19;547
2009;"SAO MARTINHO (SC)";"SC";"SAO MARTINHO";120;7;4;131
2009;"SAO MIGUEL D OESTE (SC)";"SC";"SAO MIGUEL D OESTE";946;34;100;1080
2009;"SAO MIGUEL DA BOA VISTA (SC)";"SC";"SAO MIGUEL DA BOA VISTA";17;3;10;30
2009;"SAO PEDRO DE ALCANTARA (SC)";"SC";"SAO PEDRO DE ALCANTARA";112;5;4;121
2009;"SAUDADES (SC)";"SC";"SAUDADES";165;9;32;206
2009;"SCHROEDER (SC)";"SC";"SCHROEDER";173;3;17;193
2009;"SEARA (SC)";"SC";"SEARA";382;42;62;486
2009;"SERRA ALTA (SC)";"SC";"SERRA ALTA";52;10;15;77
2009;"SIDEROPOLIS (SC)";"SC";"SIDEROPOLIS";382;20;60;462
2009;"SOMBRIO (SC)";"SC";"SOMBRIO";665;48;32;745
2009;"SUL BRASIL (SC)";"SC";"SUL BRASIL";38;3;10;51
2009;"TAIO (SC)";"SC";"TAIO";498;15;36;549
2009;"TANGARA (SC)";"SC";"TANGARA";365;10;36;411
2009;"TIGRINHOS (SC)";"SC";"TIGRINHOS";20;2;15;37
2009;"TIJUCAS (SC)";"SC";"TIJUCAS";779;39;43;861
2009;"TIMBE DO SUL (SC)";"SC";"TIMBE DO SUL";147;8;9;164
2009;"TIMBO (SC)";"SC";"TIMBO";583;38;48;669
2009;"TIMBO GRANDE (SC)";"SC";"TIMBO GRANDE";131;3;14;148
2009;"TRES BARRAS (SC)";"SC";"TRES BARRAS";248;22;46;316
2009;"TREVISO (SC)";"SC";"TREVISO";96;8;7;111
2009;"TREZE DE MAIO (SC)";"SC";"TREZE DE MAIO";368;7;17;392
2009;"TREZE TILIAS (SC)";"SC";"TREZE TILIAS";221;12;17;250
2009;"TROMBUDO CENTRAL (SC)";"SC";"TROMBUDO CENTRAL";204;18;15;237
2009;"TUBARAO (SC)";"SC";"TUBARAO";2143;71;364;2578
2009;"TUNAPOLIS (SC)";"SC";"TUNAPOLIS";76;6;22;104
2009;"TURVO (SC)";"SC";"TURVO";368;17;33;418
2009;"UNIAO DO OESTE (SC)";"SC";"UNIAO DO OESTE";51;4;14;69
2009;"URUBICI (SC)";"SC";"URUBICI";201;8;36;245
2009;"URUPEMA (SC)";"SC";"URUPEMA";43;7;9;59
2009;"URUSSANGA (SC)";"SC";"URUSSANGA";389;31;80;500
2009;"VARGEAO (SC)";"SC";"VARGEAO";112;1;11;124
2009;"VARGEM (SC)";"SC";"VARGEM";42;5;12;59
2009;"VARGEM BONITA (SC)";"SC";"VARGEM BONITA";136;8;25;169
2009;"VIDAL RAMOS (SC)";"SC";"VIDAL RAMOS";137;11;10;158
2009;"VIDEIRA (SC)";"SC";"VIDEIRA";1460;91;111;1662
2009;"VITOR MEIRELES (SC)";"SC";"VITOR MEIRELES";81;10;13;104
2009;"WITMARSUM (SC)";"SC";"WITMARSUM";91;11;6;108
2009;"XANXERE (SC)";"SC";"XANXERE";1147;95;113;1355
2009;"XAVANTINA (SC)";"SC";"XAVANTINA";148;17;4;169
2009;"XAXIM (SC)";"SC";"XAXIM";605;38;105;748
2009;"ZORTEA (SC)";"SC";"ZORTEA";34;6;3;43
2009;"AMPARO DE SAO FRANCISCO (SE)";"SE";"AMPARO DE SAO FRANCISCO";4;6;3;13
2009;"AQUIDABA (SE)";"SE";"AQUIDABA";111;9;43;163
2009;"ARACAJU (SE)";"SE";"ARACAJU";4793;817;1657;7267
2009;"ARAUA (SE)";"SE";"ARAUA";44;18;14;76
2009;"AREIA BRANCA (SE)";"SE";"AREIA BRANCA";118;7;18;143
2009;"BARRA DOS COQUEIROS (SE)";"SE";"BARRA DOS COQUEIROS";37;10;23;70
2009;"BOQUIM (SE)";"SE";"BOQUIM";168;13;21;202
2009;"BREJO GRANDE (SE)";"SE";"BREJO GRANDE";5;5;7;17
2009;"CAMPO DO BRITO (SE)";"SE";"CAMPO DO BRITO";260;22;55;337
2009;"CANHOBA (SE)";"SE";"CANHOBA";6;3;4;13
2009;"CANINDE DE SAO FRANCISCO (SE)";"SE";"CANINDE DE SAO FRANCISCO";109;26;20;155
2009;"CAPELA (SE)";"SE";"CAPELA";78;17;36;131
2009;"CARIRA (SE)";"SE";"CARIRA";183;35;68;286
2009;"CARMOPOLIS (SE)";"SE";"CARMOPOLIS";106;43;39;188
2009;"CEDRO DE SAO JOAO (SE)";"SE";"CEDRO DE SAO JOAO";21;6;3;30
2009;"CRISTINAPOLIS (SE)";"SE";"CRISTINAPOLIS";47;19;28;94
2009;"CUMBE (SE)";"SE";"CUMBE";15;8;6;29
2009;"DIVINA PASTORA (SE)";"SE";"DIVINA PASTORA";8;5;6;19
2009;"ESTANCIA (SE)";"SE";"ESTANCIA";361;131;131;623
2009;"FEIRA NOVA (SE)";"SE";"FEIRA NOVA";15;6;2;23
2009;"FREI PAULO (SE)";"SE";"FREI PAULO";90;24;28;142
2009;"GARARU (SE)";"SE";"GARARU";26;4;20;50
2009;"GENERAL MAYNARD (SE)";"SE";"GENERAL MAYNARD";8;15;17;40
2009;"GRACCHO CARDOSO (SE)";"SE";"GRACCHO CARDOSO";16;5;6;27
2009;"ILHA DAS FLORES (SE)";"SE";"ILHA DAS FLORES";9;8;7;24
2009;"INDIAROBA (SE)";"SE";"INDIAROBA";31;16;12;59
2009;"ITABAIANA (SE)";"SE";"ITABAIANA";2426;100;111;2637
2009;"ITABAIANINHA (SE)";"SE";"ITABAIANINHA";417;51;35;503
2009;"ITABI (SE)";"SE";"ITABI";15;4;6;25
2009;"ITAPORANGA D AJUDA (SE)";"SE";"ITAPORANGA D AJUDA";166;23;34;223
2009;"JAPARATUBA (SE)";"SE";"JAPARATUBA";35;15;31;81
2009;"JAPOATA (SE)";"SE";"JAPOATA";40;6;24;70
2009;"LAGARTO (SE)";"SE";"LAGARTO";766;133;146;1045
2009;"LARANJEIRAS (SE)";"SE";"LARANJEIRAS";90;29;34;153
2009;"MACAMBIRA (SE)";"SE";"MACAMBIRA";26;10;6;42
2009;"MALHADA DOS BOIS (SE)";"SE";"MALHADA DOS BOIS";12;7;3;22
2009;"MALHADOR (SE)";"SE";"MALHADOR";151;20;36;207
2009;"MARUIM (SE)";"SE";"MARUIM";38;11;18;67
2009;"MOITA BONITA (SE)";"SE";"MOITA BONITA";334;24;12;370
2009;"MONTE ALEGRE DE SERGIPE (SE)";"SE";"MONTE ALEGRE DE SERGIPE";93;17;18;128
2009;"MURIBECA (SE)";"SE";"MURIBECA";17;12;21;50
2009;"NEOPOLIS (SE)";"SE";"NEOPOLIS";37;11;14;62
2009;"NOSSA SENHORA APARECIDA (SE)";"SE";"NOSSA SENHORA APARECIDA";104;14;9;127
2009;"NOSSA SENHORA DA GLORIA (SE)";"SE";"NOSSA SENHORA DA GLORIA";339;28;79;446
2009;"NOSSA SENHORA DAS DORES (SE)";"SE";"NOSSA SENHORA DAS DORES";156;15;58;229
2009;"NOSSA SENHORA DE LOURDES (SE)";"SE";"NOSSA SENHORA DE LOURDES";17;2;8;27
2009;"NOSSA SENHORA DO SOCORRO (SE)";"SE";"NOSSA SENHORA DO SOCORRO";609;56;123;788
2009;"PACATUBA (SE)";"SE";"PACATUBA";28;5;26;59
2009;"PEDRA MOLE (SE)";"SE";"PEDRA MOLE";6;1;6;13
2009;"PEDRINHAS (SE)";"SE";"PEDRINHAS";49;3;9;61
2009;"PINHAO (SE)";"SE";"PINHAO";26;15;3;44
2009;"PIRAMBU (SE)";"SE";"PIRAMBU";13;4;12;29
2009;"POCO REDONDO (SE)";"SE";"POCO REDONDO";88;25;34;147
2009;"POCO VERDE (SE)";"SE";"POCO VERDE";66;20;87;173
2009;"PORTO DA FOLHA (SE)";"SE";"PORTO DA FOLHA";73;29;27;129
2009;"PROPRIA (SE)";"SE";"PROPRIA";185;30;47;262
2009;"RIACHAO DO DANTAS (SE)";"SE";"RIACHAO DO DANTAS";24;6;11;41
2009;"RIACHUELO (SE)";"SE";"RIACHUELO";30;6;12;48
2009;"RIBEIROPOLIS (SE)";"SE";"RIBEIROPOLIS";240;46;54;340
2009;"ROSARIO DO CATETE (SE)";"SE";"ROSARIO DO CATETE";27;21;13;61
2009;"SALGADO (SE)";"SE";"SALGADO";83;12;59;154
2009;"SANTA LUZIA DO ITANHY (SE)";"SE";"SANTA LUZIA DO ITANHY";16;8;6;30
2009;"SANTA ROSA DE LIMA (SE)";"SE";"SANTA ROSA DE LIMA";16;7;5;28
2009;"SANTANA DO SAO FRANCISCO (SE)";"SE";"SANTANA DO SAO FRANCISCO";11;3;5;19
2009;"SANTO AMARO DAS BROTAS (SE)";"SE";"SANTO AMARO DAS BROTAS";13;6;13;32
2009;"SAO CRISTOVAO (SE)";"SE";"SAO CRISTOVAO";283;65;104;452
2009;"SAO DOMINGOS (SE)";"SE";"SAO DOMINGOS";114;13;16;143
2009;"SAO FRANCISCO (SE)";"SE";"SAO FRANCISCO";14;4;22;40
2009;"SAO MIGUEL DO ALEIXO (SE)";"SE";"SAO MIGUEL DO ALEIXO";26;4;10;40
2009;"SIMAO DIAS (SE)";"SE";"SIMAO DIAS";191;50;155;396
2009;"SIRIRI (SE)";"SE";"SIRIRI";30;7;29;66
2009;"TELHA (SE)";"SE";"TELHA";9;5;3;17
2009;"TOBIAS BARRETO (SE)";"SE";"TOBIAS BARRETO";196;48;121;365
2009;"TOMAR DO GERU (SE)";"SE";"TOMAR DO GERU";36;8;8;52
2009;"UMBAUBA (SE)";"SE";"UMBAUBA";236;38;29;303
2009;"ADAMANTINA (SP)";"SP";"ADAMANTINA";658;47;65;770
2009;"ADOLFO (SP)";"SP";"ADOLFO";68;3;22;93
2009;"AGUAI (SP)";"SP";"AGUAI";737;69;112;918
2009;"AGUAS DA PRATA (SP)";"SP";"AGUAS DA PRATA";113;12;10;135
2009;"AGUAS DE LINDOIA (SP)";"SP";"AGUAS DE LINDOIA";151;52;43;246
2009;"AGUAS DE SANTA BARBARA (SP)";"SP";"AGUAS DE SANTA BARBARA";84;12;14;110
2009;"AGUAS DE SAO PEDRO (SP)";"SP";"AGUAS DE SAO PEDRO";23;5;3;31
2009;"AGUDOS (SP)";"SP";"AGUDOS";504;63;73;640
2009;"ALAMBARI (SP)";"SP";"ALAMBARI";74;12;6;92
2009;"ALFREDO MARCONDES (SP)";"SP";"ALFREDO MARCONDES";53;7;8;68
2009;"ALTAIR (SP)";"SP";"ALTAIR";62;6;29;97
2009;"ALTINOPOLIS (SP)";"SP";"ALTINOPOLIS";314;35;84;433
2009;"ALTO ALEGRE (SP)";"SP";"ALTO ALEGRE";72;3;35;110
2009;"ALUMINIO (SP)";"SP";"ALUMINIO";201;29;37;267
2009;"ALVARES FLORENCE (SP)";"SP";"ALVARES FLORENCE";59;5;15;79
2009;"ALVARES MACHADO (SP)";"SP";"ALVARES MACHADO";375;9;34;418
2009;"ALVARO DE CARVALHO (SP)";"SP";"ALVARO DE CARVALHO";17;2;20;39
2009;"ALVINLANDIA (SP)";"SP";"ALVINLANDIA";35;2;13;50
2009;"AMERICANA (SP)";"SP";"AMERICANA";3082;377;705;4164
2009;"AMERICO BRASILIENSE (SP)";"SP";"AMERICO BRASILIENSE";596;44;222;862
2009;"AMERICO DE CAMPOS (SP)";"SP";"AMERICO DE CAMPOS";134;6;26;166
2009;"AMPARO (SP)";"SP";"AMPARO";1247;183;118;1548
2009;"ANALANDIA (SP)";"SP";"ANALANDIA";57;12;10;79
2009;"ANDRADINA (SP)";"SP";"ANDRADINA";1160;47;116;1323
2009;"ANGATUBA (SP)";"SP";"ANGATUBA";345;41;75;461
2009;"ANHEMBI (SP)";"SP";"ANHEMBI";67;15;10;92
2009;"ANHUMAS (SP)";"SP";"ANHUMAS";61;6;7;74
2009;"APARECIDA (SP)";"SP";"APARECIDA";780;50;564;1394
2009;"APARECIDA D OESTE (SP)";"SP";"APARECIDA D OESTE";91;9;21;121
2009;"APIAI (SP)";"SP";"APIAI";254;37;48;339
2009;"ARACARIGUAMA (SP)";"SP";"ARACARIGUAMA";437;50;40;527
2009;"ARACATUBA (SP)";"SP";"ARACATUBA";3113;212;618;3943
2009;"ARACOIABA DA SERRA (SP)";"SP";"ARACOIABA DA SERRA";380;55;17;452
2009;"ARAMINA (SP)";"SP";"ARAMINA";61;6;19;86
2009;"ARANDU (SP)";"SP";"ARANDU";51;6;18;75
2009;"ARAPEI (SP)";"SP";"ARAPEI";38;7;10;55
2009;"ARARAQUARA (SP)";"SP";"ARARAQUARA";3054;338;857;4249
2009;"ARARAS (SP)";"SP";"ARARAS";2000;193;232;2425
2009;"ARCO IRIS (SP)";"SP";"ARCO IRIS";49;5;9;63
2009;"AREALVA (SP)";"SP";"AREALVA";144;6;19;169
2009;"AREIAS (SP)";"SP";"AREIAS";41;5;5;51
2009;"AREIOPOLIS (SP)";"SP";"AREIOPOLIS";108;15;63;186
2009;"ARIRANHA (SP)";"SP";"ARIRANHA";251;21;96;368
2009;"ARTUR NOGUEIRA (SP)";"SP";"ARTUR NOGUEIRA";872;86;137;1095
2009;"ARUJA (SP)";"SP";"ARUJA";2082;212;299;2593
2009;"ASPASIA (SP)";"SP";"ASPASIA";30;5;4;39
2009;"ASSIS (SP)";"SP";"ASSIS";1457;128;324;1909
2009;"ATIBAIA (SP)";"SP";"ATIBAIA";1911;239;274;2424
2009;"AURIFLAMA (SP)";"SP";"AURIFLAMA";291;17;38;346
2009;"AVAI (SP)";"SP";"AVAI";58;11;16;85
2009;"AVANHANDAVA (SP)";"SP";"AVANHANDAVA";120;8;34;162
2009;"AVARE (SP)";"SP";"AVARE";1115;100;245;1460
2009;"BADY BASSITT (SP)";"SP";"BADY BASSITT";302;24;53;379
2009;"BALBINOS (SP)";"SP";"BALBINOS";15;1;6;22
2009;"BALSAMO (SP)";"SP";"BALSAMO";150;4;14;168
2009;"BANANAL (SP)";"SP";"BANANAL";104;12;22;138
2009;"BARAO DE ANTONINA (SP)";"SP";"BARAO DE ANTONINA";22;2;12;36
2009;"BARBOSA (SP)";"SP";"BARBOSA";95;4;27;126
2009;"BARIRI (SP)";"SP";"BARIRI";733;50;86;869
2009;"BARRA BONITA (SP)";"SP";"BARRA BONITA";1081;64;187;1332
2009;"BARRA DO CHAPEU (SP)";"SP";"BARRA DO CHAPEU";30;3;8;41
2009;"BARRA DO TURVO (SP)";"SP";"BARRA DO TURVO";49;6;36;91
2009;"BARRETOS (SP)";"SP";"BARRETOS";1671;134;456;2261
2009;"BARRINHA (SP)";"SP";"BARRINHA";390;27;147;564
2009;"BARUERI (SP)";"SP";"BARUERI";4660;591;908;6159
2009;"BASTOS (SP)";"SP";"BASTOS";637;22;61;720
2009;"BATATAIS (SP)";"SP";"BATATAIS";969;71;130;1170
2009;"BAURU (SP)";"SP";"BAURU";4610;419;1004;6033
2009;"BEBEDOURO (SP)";"SP";"BEBEDOURO";1457;113;220;1790
2009;"BENTO DE ABREU (SP)";"SP";"BENTO DE ABREU";79;7;11;97
2009;"BERNARDINO DE CAMPOS (SP)";"SP";"BERNARDINO DE CAMPOS";291;16;28;335
2009;"BERTIOGA (SP)";"SP";"BERTIOGA";389;53;94;536
2009;"BILAC (SP)";"SP";"BILAC";132;9;25;166
2009;"BIRIGUI (SP)";"SP";"BIRIGUI";1463;60;110;1633
2009;"BIRITIBA MIRIM (SP)";"SP";"BIRITIBA MIRIM";274;17;19;310
2009;"BOA ESPERANCA DO SUL (SP)";"SP";"BOA ESPERANCA DO SUL";341;24;89;454
2009;"BOCAINA (SP)";"SP";"BOCAINA";219;19;31;269
2009;"BOFETE (SP)";"SP";"BOFETE";143;19;47;209
2009;"BOITUVA (SP)";"SP";"BOITUVA";927;70;98;1095
2009;"BOM JESUS DOS PERDOES (SP)";"SP";"BOM JESUS DOS PERDOES";357;49;27;433
2009;"BOM SUCESSO DE ITARARE (SP)";"SP";"BOM SUCESSO DE ITARARE";54;8;9;71
2009;"BORA (SP)";"SP";"BORA";29;1;6;36
2009;"BORACEIA (SP)";"SP";"BORACEIA";208;4;16;228
2009;"BORBOREMA (SP)";"SP";"BORBOREMA";273;10;67;350
2009;"BOREBI (SP)";"SP";"BOREBI";39;9;7;55
2009;"BOTUCATU (SP)";"SP";"BOTUCATU";1409;214;386;2009
2009;"BRAGANCA PAULISTA (SP)";"SP";"BRAGANCA PAULISTA";2254;247;274;2775
2009;"BRAUNA (SP)";"SP";"BRAUNA";72;1;51;124
2009;"BREJO ALEGRE (SP)";"SP";"BREJO ALEGRE";167;1;20;188
2009;"BRODOSQUI (SP)";"SP";"BRODOSQUI";473;20;31;524
2009;"BROTAS (SP)";"SP";"BROTAS";441;37;116;594
2009;"BURI (SP)";"SP";"BURI";344;25;44;413
2009;"BURITAMA (SP)";"SP";"BURITAMA";284;21;47;352
2009;"BURITIZAL (SP)";"SP";"BURITIZAL";95;9;34;138
2009;"CABRALIA PAULISTA (SP)";"SP";"CABRALIA PAULISTA";107;3;9;119
2009;"CABREUVA (SP)";"SP";"CABREUVA";838;84;65;987
2009;"CACAPAVA (SP)";"SP";"CACAPAVA";732;198;103;1033
2009;"CACHOEIRA PAULISTA (SP)";"SP";"CACHOEIRA PAULISTA";281;52;19;352
2009;"CACONDE (SP)";"SP";"CACONDE";193;24;63;280
2009;"CAFELANDIA (SP)";"SP";"CAFELANDIA";237;10;62;309
2009;"CAIABU (SP)";"SP";"CAIABU";35;2;34;71
2009;"CAIEIRAS (SP)";"SP";"CAIEIRAS";856;156;328;1340
2009;"CAIUA (SP)";"SP";"CAIUA";54;10;16;80
2009;"CAJAMAR (SP)";"SP";"CAJAMAR";1119;100;145;1364
2009;"CAJATI (SP)";"SP";"CAJATI";420;45;66;531
2009;"CAJOBI (SP)";"SP";"CAJOBI";276;6;70;352
2009;"CAJURU (SP)";"SP";"CAJURU";403;17;91;511
2009;"CAMPINA DO MONTE ALEGRE (SP)";"SP";"CAMPINA DO MONTE ALEGRE";68;15;24;107
2009;"CAMPINAS (SP)";"SP";"CAMPINAS";16091;2884;4316;23291
2009;"CAMPO LIMPO PAULISTA (SP)";"SP";"CAMPO LIMPO PAULISTA";494;89;29;612
2009;"CAMPOS DO JORDAO (SP)";"SP";"CAMPOS DO JORDAO";541;141;58;740
2009;"CAMPOS NOVOS PAULISTA (SP)";"SP";"CAMPOS NOVOS PAULISTA";77;4;24;105
2009;"CANANEIA (SP)";"SP";"CANANEIA";69;2;8;79
2009;"CANAS (SP)";"SP";"CANAS";52;6;6;64
2009;"CANDIDO MOTA (SP)";"SP";"CANDIDO MOTA";734;23;52;809
2009;"CANDIDO RODRIGUES (SP)";"SP";"CANDIDO RODRIGUES";106;7;5;118
2009;"CANITAR (SP)";"SP";"CANITAR";49;13;20;82
2009;"CAPAO BONITO (SP)";"SP";"CAPAO BONITO";776;72;137;985
2009;"CAPELA DO ALTO (SP)";"SP";"CAPELA DO ALTO";353;28;26;407
2009;"CAPIVARI (SP)";"SP";"CAPIVARI";1085;77;178;1340
2009;"CARAGUATATUBA (SP)";"SP";"CARAGUATATUBA";1122;129;113;1364
2009;"CARAPICUIBA (SP)";"SP";"CARAPICUIBA";2618;554;764;3936
2009;"CARDOSO (SP)";"SP";"CARDOSO";154;7;39;200
2009;"CASA BRANCA (SP)";"SP";"CASA BRANCA";443;45;70;558
2009;"CASSIA DOS COQUEIROS (SP)";"SP";"CASSIA DOS COQUEIROS";16;3;10;29
2009;"CASTILHO (SP)";"SP";"CASTILHO";202;24;79;305
2009;"CATANDUVA (SP)";"SP";"CATANDUVA";2738;185;465;3388
2009;"CATIGUA (SP)";"SP";"CATIGUA";106;13;29;148
2009;"CEDRAL (SP)";"SP";"CEDRAL";192;12;14;218
2009;"CERQUEIRA CESAR (SP)";"SP";"CERQUEIRA CESAR";259;35;94;388
2009;"CERQUILHO (SP)";"SP";"CERQUILHO";817;78;83;978
2009;"CESARIO LANGE (SP)";"SP";"CESARIO LANGE";287;39;38;364
2009;"CHARQUEADA (SP)";"SP";"CHARQUEADA";407;23;76;506
2009;"CHAVANTES (SP)";"SP";"CHAVANTES";144;12;43;199
2009;"CLEMENTINA (SP)";"SP";"CLEMENTINA";216;8;57;281
2009;"COLINA (SP)";"SP";"COLINA";334;18;68;420
2009;"COLOMBIA (SP)";"SP";"COLOMBIA";112;26;68;206
2009;"CONCHAL (SP)";"SP";"CONCHAL";659;35;199;893
2009;"CONCHAS (SP)";"SP";"CONCHAS";266;26;25;317
2009;"CORDEIROPOLIS (SP)";"SP";"CORDEIROPOLIS";565;57;33;655
2009;"COROADOS (SP)";"SP";"COROADOS";67;4;16;87
2009;"CORONEL MACEDO (SP)";"SP";"CORONEL MACEDO";52;10;24;86
2009;"CORUMBATAI (SP)";"SP";"CORUMBATAI";127;12;8;147
2009;"COSMOPOLIS (SP)";"SP";"COSMOPOLIS";631;217;231;1079
2009;"COSMORAMA (SP)";"SP";"COSMORAMA";121;3;36;160
2009;"COTIA (SP)";"SP";"COTIA";2244;670;433;3347
2009;"CRAVINHOS (SP)";"SP";"CRAVINHOS";795;42;136;973
2009;"CRISTAIS PAULISTA (SP)";"SP";"CRISTAIS PAULISTA";87;2;23;112
2009;"CRUZALIA (SP)";"SP";"CRUZALIA";63;9;4;76
2009;"CRUZEIRO (SP)";"SP";"CRUZEIRO";597;91;41;729
2009;"CUBATAO (SP)";"SP";"CUBATAO";2619;324;398;3341
2009;"CUNHA (SP)";"SP";"CUNHA";221;22;24;267
2009;"DESCALVADO (SP)";"SP";"DESCALVADO";822;55;154;1031
2009;"DIADEMA (SP)";"SP";"DIADEMA";3563;591;516;4670
2009;"DIRCE REIS (SP)";"SP";"DIRCE REIS";52;5;7;64
2009;"DIVINOLANDIA (SP)";"SP";"DIVINOLANDIA";390;18;29;437
2009;"DOBRADA (SP)";"SP";"DOBRADA";60;6;67;133
2009;"DOIS CORREGOS (SP)";"SP";"DOIS CORREGOS";617;50;119;786
2009;"DOLCINOPOLIS (SP)";"SP";"DOLCINOPOLIS";24;4;8;36
2009;"DOURADO (SP)";"SP";"DOURADO";170;21;50;241
2009;"DRACENA (SP)";"SP";"DRACENA";927;33;120;1080
2009;"DUARTINA (SP)";"SP";"DUARTINA";252;29;47;328
2009;"DUMONT (SP)";"SP";"DUMONT";276;9;52;337
2009;"ECHAPORA (SP)";"SP";"ECHAPORA";104;1;16;121
2009;"ELDORADO (SP)";"SP";"ELDORADO";186;10;48;244
2009;"ELIAS FAUSTO (SP)";"SP";"ELIAS FAUSTO";292;15;60;367
2009;"ELISIARIO (SP)";"SP";"ELISIARIO";48;4;6;58
2009;"EMBAUBA (SP)";"SP";"EMBAUBA";70;2;27;99
2009;"EMBU (SP)";"SP";"EMBU";1748;453;534;2735
2009;"EMBU GUACU (SP)";"SP";"EMBU GUACU";1180;133;215;1528
2009;"EMILIANOPOLIS (SP)";"SP";"EMILIANOPOLIS";53;3;18;74
2009;"ENGENHEIRO COELHO (SP)";"SP";"ENGENHEIRO COELHO";286;28;127;441
2009;"ESPIRITO SANTO DO PINHAL (SP)";"SP";"ESPIRITO SANTO DO PINHAL";556;101;70;727
2009;"ESPIRITO SANTO DO TURVO (SP)";"SP";"ESPIRITO SANTO DO TURVO";138;18;33;189
2009;"ESTIVA GERBI (SP)";"SP";"ESTIVA GERBI";239;7;20;266
2009;"ESTRELA D OESTE (SP)";"SP";"ESTRELA D OESTE";246;7;17;270
2009;"ESTRELA DO NORTE (SP)";"SP";"ESTRELA DO NORTE";25;2;9;36
2009;"EUCLIDES DA CUNHA PAULISTA (SP)";"SP";"EUCLIDES DA CUNHA PAULISTA";77;6;38;121
2009;"FARTURA (SP)";"SP";"FARTURA";211;18;22;251
2009;"FERNANDO PRESTES (SP)";"SP";"FERNANDO PRESTES";208;6;16;230
2009;"FERNANDOPOLIS (SP)";"SP";"FERNANDOPOLIS";1161;51;149;1361
2009;"FERNAO (SP)";"SP";"FERNAO";22;3;7;32
2009;"FERRAZ DE VASCONCELOS (SP)";"SP";"FERRAZ DE VASCONCELOS";1070;156;176;1402
2009;"FLORA RICA (SP)";"SP";"FLORA RICA";13;1;9;23
2009;"FLOREAL (SP)";"SP";"FLOREAL";47;11;5;63
2009;"FLORIDA PAULISTA (SP)";"SP";"FLORIDA PAULISTA";291;7;105;403
2009;"FLORINEA (SP)";"SP";"FLORINEA";39;4;6;49
2009;"FRANCA (SP)";"SP";"FRANCA";2700;283;502;3485
2009;"FRANCISCO MORATO (SP)";"SP";"FRANCISCO MORATO";435;140;154;729
2009;"FRANCO DA ROCHA (SP)";"SP";"FRANCO DA ROCHA";565;128;156;849
2009;"GABRIEL MONTEIRO (SP)";"SP";"GABRIEL MONTEIRO";52;2;10;64
2009;"GALIA (SP)";"SP";"GALIA";122;11;31;164
2009;"GARCA (SP)";"SP";"GARCA";667;40;102;809
2009;"GASTAO VIDIGAL (SP)";"SP";"GASTAO VIDIGAL";63;8;45;116
2009;"GAVIAO PEIXOTO (SP)";"SP";"GAVIAO PEIXOTO";52;7;20;79
2009;"GENERAL SALGADO (SP)";"SP";"GENERAL SALGADO";274;12;78;364
2009;"GETULINA (SP)";"SP";"GETULINA";130;4;59;193
2009;"GLICERIO (SP)";"SP";"GLICERIO";99;1;19;119
2009;"GUAICARA (SP)";"SP";"GUAICARA";71;5;22;98
2009;"GUAIMBE (SP)";"SP";"GUAIMBE";106;3;21;130
2009;"GUAIRA (SP)";"SP";"GUAIRA";1032;34;137;1203
2009;"GUAPIACU (SP)";"SP";"GUAPIACU";381;22;60;463
2009;"GUAPIARA (SP)";"SP";"GUAPIARA";299;28;40;367
2009;"GUARA (SP)";"SP";"GUARA";191;22;135;348
2009;"GUARACAI (SP)";"SP";"GUARACAI";285;17;27;329
2009;"GUARACI (SP)";"SP";"GUARACI";132;6;59;197
2009;"GUARANI D OESTE (SP)";"SP";"GUARANI D OESTE";24;2;5;31
2009;"GUARANTA (SP)";"SP";"GUARANTA";80;1;36;117
2009;"GUARARAPES (SP)";"SP";"GUARARAPES";649;38;129;816
2009;"GUARAREMA (SP)";"SP";"GUARAREMA";323;56;46;425
2009;"GUARATINGUETA (SP)";"SP";"GUARATINGUETA";983;246;150;1379
2009;"GUAREI (SP)";"SP";"GUAREI";215;19;44;278
2009;"GUARIBA (SP)";"SP";"GUARIBA";808;50;249;1107
2009;"GUARUJA (SP)";"SP";"GUARUJA";1821;382;347;2550
2009;"GUARULHOS (SP)";"SP";"GUARULHOS";16744;3267;2886;22897
2009;"GUATAPARA (SP)";"SP";"GUATAPARA";129;8;39;176
2009;"GUZOLANDIA (SP)";"SP";"GUZOLANDIA";57;4;36;97
2009;"HERCULANDIA (SP)";"SP";"HERCULANDIA";388;3;20;411
2009;"HOLAMBRA (SP)";"SP";"HOLAMBRA";364;28;59;451
2009;"HORTOLANDIA (SP)";"SP";"HORTOLANDIA";1252;258;256;1766
2009;"IACANGA (SP)";"SP";"IACANGA";163;11;28;202
2009;"IACRI (SP)";"SP";"IACRI";125;2;14;141
2009;"IARAS (SP)";"SP";"IARAS";39;17;22;78
2009;"IBATE (SP)";"SP";"IBATE";461;68;201;730
2009;"IBIRA (SP)";"SP";"IBIRA";162;17;58;237
2009;"IBIRAREMA (SP)";"SP";"IBIRAREMA";123;10;29;162
2009;"IBITINGA (SP)";"SP";"IBITINGA";734;57;130;921
2009;"IBIUNA (SP)";"SP";"IBIUNA";1546;119;98;1763
2009;"ICEM (SP)";"SP";"ICEM";183;6;76;265
2009;"IEPE (SP)";"SP";"IEPE";137;6;25;168
2009;"IGARACU DO TIETE (SP)";"SP";"IGARACU DO TIETE";354;17;67;438
2009;"IGARAPAVA (SP)";"SP";"IGARAPAVA";401;33;104;538
2009;"IGARATA (SP)";"SP";"IGARATA";100;16;11;127
2009;"IGUAPE (SP)";"SP";"IGUAPE";180;22;24;226
2009;"ILHA COMPRIDA (SP)";"SP";"ILHA COMPRIDA";108;14;56;178
2009;"ILHA SOLTEIRA (SP)";"SP";"ILHA SOLTEIRA";215;30;74;319
2009;"ILHABELA (SP)";"SP";"ILHABELA";241;55;43;339
2009;"INDAIATUBA (SP)";"SP";"INDAIATUBA";2490;386;214;3090
2009;"INDIANA (SP)";"SP";"INDIANA";107;4;11;122
2009;"INDIAPORA (SP)";"SP";"INDIAPORA";54;6;16;76
2009;"INUBIA PAULISTA (SP)";"SP";"INUBIA PAULISTA";54;6;13;73
2009;"IPAUCU (SP)";"SP";"IPAUCU";154;18;40;212
2009;"IPERO (SP)";"SP";"IPERO";187;12;40;239
2009;"IPEUNA (SP)";"SP";"IPEUNA";127;23;25;175
2009;"IPIGUA (SP)";"SP";"IPIGUA";25;1;7;33
2009;"IPORANGA (SP)";"SP";"IPORANGA";25;4;8;37
2009;"IPUA (SP)";"SP";"IPUA";249;11;71;331
2009;"IRACEMAPOLIS (SP)";"SP";"IRACEMAPOLIS";503;42;71;616
2009;"IRAPUA (SP)";"SP";"IRAPUA";139;4;72;215
2009;"IRAPURU (SP)";"SP";"IRAPURU";104;10;25;139
2009;"ITABERA (SP)";"SP";"ITABERA";194;14;24;232
2009;"ITAI (SP)";"SP";"ITAI";429;35;112;576
2009;"ITAJOBI (SP)";"SP";"ITAJOBI";440;13;43;496
2009;"ITAJU (SP)";"SP";"ITAJU";66;2;15;83
2009;"ITANHAEM (SP)";"SP";"ITANHAEM";612;110;99;821
2009;"ITAOCA (SP)";"SP";"ITAOCA";19;8;7;34
2009;"ITAPECERICA DA SERRA (SP)";"SP";"ITAPECERICA DA SERRA";1850;490;495;2835
2009;"ITAPETININGA (SP)";"SP";"ITAPETININGA";2206;291;294;2791
2009;"ITAPEVA (SP)";"SP";"ITAPEVA";1606;208;304;2118
2009;"ITAPEVI (SP)";"SP";"ITAPEVI";1272;173;109;1554
2009;"ITAPIRA (SP)";"SP";"ITAPIRA";1519;116;202;1837
2009;"ITAPIRAPUA PAULISTA (SP)";"SP";"ITAPIRAPUA PAULISTA";33;16;9;58
2009;"ITAPOLIS (SP)";"SP";"ITAPOLIS";1161;45;156;1362
2009;"ITAPORANGA (SP)";"SP";"ITAPORANGA";199;16;59;274
2009;"ITAPUI (SP)";"SP";"ITAPUI";386;23;63;472
2009;"ITAPURA (SP)";"SP";"ITAPURA";25;3;10;38
2009;"ITAQUAQUECETUBA (SP)";"SP";"ITAQUAQUECETUBA";1732;244;306;2282
2009;"ITARARE (SP)";"SP";"ITARARE";838;62;260;1160
2009;"ITARIRI (SP)";"SP";"ITARIRI";263;20;19;302
2009;"ITATIBA (SP)";"SP";"ITATIBA";2117;164;245;2526
2009;"ITATINGA (SP)";"SP";"ITATINGA";179;30;102;311
2009;"ITIRAPINA (SP)";"SP";"ITIRAPINA";204;21;51;276
2009;"ITIRAPUA (SP)";"SP";"ITIRAPUA";52;5;19;76
2009;"ITOBI (SP)";"SP";"ITOBI";120;9;70;199
2009;"ITU (SP)";"SP";"ITU";2471;280;476;3227
2009;"ITUPEVA (SP)";"SP";"ITUPEVA";832;88;89;1009
2009;"ITUVERAVA (SP)";"SP";"ITUVERAVA";627;36;124;787
2009;"JABORANDI (SP)";"SP";"JABORANDI";149;8;43;200
2009;"JABOTICABAL (SP)";"SP";"JABOTICABAL";1558;89;203;1850
2009;"JACAREI (SP)";"SP";"JACAREI";2262;463;324;3049
2009;"JACI (SP)";"SP";"JACI";162;9;13;184
2009;"JACUPIRANGA (SP)";"SP";"JACUPIRANGA";359;25;293;677
2009;"JAGUARIUNA (SP)";"SP";"JAGUARIUNA";983;83;145;1211
2009;"JALES (SP)";"SP";"JALES";1081;29;63;1173
2009;"JAMBEIRO (SP)";"SP";"JAMBEIRO";42;21;8;71
2009;"JANDIRA (SP)";"SP";"JANDIRA";1054;178;123;1355
2009;"JARDINOPOLIS (SP)";"SP";"JARDINOPOLIS";826;67;97;990
2009;"JARINU (SP)";"SP";"JARINU";482;28;41;551
2009;"JAU (SP)";"SP";"JAU";1984;232;315;2531
2009;"JERIQUARA (SP)";"SP";"JERIQUARA";46;3;9;58
2009;"JOANOPOLIS (SP)";"SP";"JOANOPOLIS";280;14;13;307
2009;"JOAO RAMALHO (SP)";"SP";"JOAO RAMALHO";26;4;20;50
2009;"JOSE BONIFACIO (SP)";"SP";"JOSE BONIFACIO";752;42;85;879
2009;"JULIO MESQUITA (SP)";"SP";"JULIO MESQUITA";44;3;22;69
2009;"JUMIRIM (SP)";"SP";"JUMIRIM";83;5;6;94
2009;"JUNDIAI (SP)";"SP";"JUNDIAI";6379;754;1000;8133
2009;"JUNQUEIROPOLIS (SP)";"SP";"JUNQUEIROPOLIS";404;17;141;562
2009;"JUQUIA (SP)";"SP";"JUQUIA";355;19;17;391
2009;"JUQUITIBA (SP)";"SP";"JUQUITIBA";505;62;80;647
2009;"LAGOINHA (SP)";"SP";"LAGOINHA";87;10;17;114
2009;"LARANJAL PAULISTA (SP)";"SP";"LARANJAL PAULISTA";563;33;120;716
2009;"LAVINIA (SP)";"SP";"LAVINIA";77;9;10;96
2009;"LAVRINHAS (SP)";"SP";"LAVRINHAS";88;19;12;119
2009;"LEME (SP)";"SP";"LEME";2117;108;424;2649
2009;"LENCOIS PAULISTA (SP)";"SP";"LENCOIS PAULISTA";1200;121;205;1526
2009;"LIMEIRA (SP)";"SP";"LIMEIRA";4342;628;585;5555
2009;"LINDOIA (SP)";"SP";"LINDOIA";122;19;12;153
2009;"LINS (SP)";"SP";"LINS";1326;74;137;1537
2009;"LORENA (SP)";"SP";"LORENA";755;124;31;910
2009;"LOURDES (SP)";"SP";"LOURDES";23;5;12;40
2009;"LOUVEIRA (SP)";"SP";"LOUVEIRA";825;87;47;959
2009;"LUCELIA (SP)";"SP";"LUCELIA";358;26;162;546
2009;"LUCIANOPOLIS (SP)";"SP";"LUCIANOPOLIS";44;5;11;60
2009;"LUIS ANTONIO (SP)";"SP";"LUIS ANTONIO";269;23;125;417
2009;"LUIZIANIA (SP)";"SP";"LUIZIANIA";54;3;23;80
2009;"LUPERCIO (SP)";"SP";"LUPERCIO";65;3;29;97
2009;"LUTECIA (SP)";"SP";"LUTECIA";45;8;11;64
2009;"MACATUBA (SP)";"SP";"MACATUBA";484;20;66;570
2009;"MACAUBAL (SP)";"SP";"MACAUBAL";126;12;20;158
2009;"MACEDONIA (SP)";"SP";"MACEDONIA";38;3;11;52
2009;"MAGDA (SP)";"SP";"MAGDA";82;9;10;101
2009;"MAIRINQUE (SP)";"SP";"MAIRINQUE";456;70;85;611
2009;"MAIRIPORA (SP)";"SP";"MAIRIPORA";1101;171;125;1397
2009;"MANDURI (SP)";"SP";"MANDURI";158;17;58;233
2009;"MARABA PAULISTA (SP)";"SP";"MARABA PAULISTA";26;2;12;40
2009;"MARACAI (SP)";"SP";"MARACAI";302;50;46;398
2009;"MARAPOAMA (SP)";"SP";"MARAPOAMA";142;11;12;165
2009;"MARIAPOLIS (SP)";"SP";"MARIAPOLIS";36;0;22;58
2009;"MARILIA (SP)";"SP";"MARILIA";2751;213;387;3351
2009;"MARINOPOLIS (SP)";"SP";"MARINOPOLIS";59;3;5;67
2009;"MARTINOPOLIS (SP)";"SP";"MARTINOPOLIS";365;30;77;472
2009;"MATAO (SP)";"SP";"MATAO";1402;68;247;1717
2009;"MAUA (SP)";"SP";"MAUA";2954;972;868;4794
2009;"MENDONCA (SP)";"SP";"MENDONCA";91;4;17;112
2009;"MERIDIANO (SP)";"SP";"MERIDIANO";87;7;15;109
2009;"MESOPOLIS (SP)";"SP";"MESOPOLIS";19;3;10;32
2009;"MIGUELOPOLIS (SP)";"SP";"MIGUELOPOLIS";290;11;89;390
2009;"MINEIROS DO TIETE (SP)";"SP";"MINEIROS DO TIETE";234;8;36;278
2009;"MIRA ESTRELA (SP)";"SP";"MIRA ESTRELA";29;5;21;55
2009;"MIRACATU (SP)";"SP";"MIRACATU";520;48;21;589
2009;"MIRANDOPOLIS (SP)";"SP";"MIRANDOPOLIS";528;25;147;700
2009;"MIRANTE DO PARANAPANEMA (SP)";"SP";"MIRANTE DO PARANAPANEMA";183;20;70;273
2009;"MIRASSOL (SP)";"SP";"MIRASSOL";1005;40;57;1102
2009;"MIRASSOLANDIA (SP)";"SP";"MIRASSOLANDIA";34;11;11;56
2009;"MOCOCA (SP)";"SP";"MOCOCA";956;92;251;1299
2009;"MOGI DAS CRUZES (SP)";"SP";"MOGI DAS CRUZES";4824;615;1078;6517
2009;"MOGI GUACU (SP)";"SP";"MOGI GUACU";1893;334;339;2566
2009;"MOGI MIRIM (SP)";"SP";"MOGI MIRIM";1781;181;431;2393
2009;"MOMBUCA (SP)";"SP";"MOMBUCA";82;3;15;100
2009;"MONCOES (SP)";"SP";"MONCOES";58;8;11;77
2009;"MONGAGUA (SP)";"SP";"MONGAGUA";406;60;44;510
2009;"MONTE ALEGRE DO SUL (SP)";"SP";"MONTE ALEGRE DO SUL";196;34;36;266
2009;"MONTE ALTO (SP)";"SP";"MONTE ALTO";1374;48;99;1521
2009;"MONTE APRAZIVEL (SP)";"SP";"MONTE APRAZIVEL";553;21;128;702
2009;"MONTE AZUL PAULISTA (SP)";"SP";"MONTE AZUL PAULISTA";483;22;119;624
2009;"MONTE CASTELO (SP)";"SP";"MONTE CASTELO";74;4;12;90
2009;"MONTE MOR (SP)";"SP";"MONTE MOR";584;67;127;778
2009;"MONTEIRO LOBATO (SP)";"SP";"MONTEIRO LOBATO";196;32;12;240
2009;"MORRO AGUDO (SP)";"SP";"MORRO AGUDO";672;25;168;865
2009;"MORUNGABA (SP)";"SP";"MORUNGABA";329;48;21;398
2009;"MOTUCA (SP)";"SP";"MOTUCA";138;6;30;174
2009;"MUNICIPIO NAO INFORMADO (SP)";"SP";"MUNICIPIO NAO INFORMADO";0;0;0;0
2009;"MURUTINGA DO SUL (SP)";"SP";"MURUTINGA DO SUL";75;8;8;91
2009;"NANTES (SP)";"SP";"NANTES";15;1;20;36
2009;"NARANDIBA (SP)";"SP";"NARANDIBA";83;6;19;108
2009;"NATIVIDADE DA SERRA (SP)";"SP";"NATIVIDADE DA SERRA";56;22;9;87
2009;"NAZARE PAULISTA (SP)";"SP";"NAZARE PAULISTA";460;14;23;497
2009;"NEVES PAULISTA (SP)";"SP";"NEVES PAULISTA";194;7;30;231
2009;"NHANDEARA (SP)";"SP";"NHANDEARA";178;10;31;219
2009;"NIPOA (SP)";"SP";"NIPOA";99;3;20;122
2009;"NOVA ALIANCA (SP)";"SP";"NOVA ALIANCA";109;9;17;135
2009;"NOVA CAMPINA (SP)";"SP";"NOVA CAMPINA";60;10;12;82
2009;"NOVA CANAA PAULISTA (SP)";"SP";"NOVA CANAA PAULISTA";24;5;6;35
2009;"NOVA CASTILHO (SP)";"SP";"NOVA CASTILHO";13;5;10;28
2009;"NOVA EUROPA (SP)";"SP";"NOVA EUROPA";151;4;94;249
2009;"NOVA GRANADA (SP)";"SP";"NOVA GRANADA";285;27;86;398
2009;"NOVA GUATAPORANGA (SP)";"SP";"NOVA GUATAPORANGA";25;2;15;42
2009;"NOVA INDEPENDENCIA (SP)";"SP";"NOVA INDEPENDENCIA";32;8;6;46
2009;"NOVA LUZITANIA (SP)";"SP";"NOVA LUZITANIA";37;2;25;64
2009;"NOVA ODESSA (SP)";"SP";"NOVA ODESSA";746;105;119;970
2009;"NOVAIS (SP)";"SP";"NOVAIS";107;9;38;154
2009;"NOVO HORIZONTE (SP)";"SP";"NOVO HORIZONTE";979;23;191;1193
2009;"NUPORANGA (SP)";"SP";"NUPORANGA";184;14;52;250
2009;"OCAUCU (SP)";"SP";"OCAUCU";91;4;13;108
2009;"OLEO (SP)";"SP";"OLEO";21;9;6;36
2009;"OLIMPIA (SP)";"SP";"OLIMPIA";906;81;157;1144
2009;"ONDA VERDE (SP)";"SP";"ONDA VERDE";78;6;20;104
2009;"ORIENTE (SP)";"SP";"ORIENTE";60;4;18;82
2009;"ORINDIUVA (SP)";"SP";"ORINDIUVA";144;14;84;242
2009;"ORLANDIA (SP)";"SP";"ORLANDIA";856;43;249;1148
2009;"OSASCO (SP)";"SP";"OSASCO";8183;1421;2327;11931
2009;"OSCAR BRESSANE (SP)";"SP";"OSCAR BRESSANE";43;5;9;57
2009;"OSVALDO CRUZ (SP)";"SP";"OSVALDO CRUZ";534;27;96;657
2009;"OURINHOS (SP)";"SP";"OURINHOS";1943;107;373;2423
2009;"OURO VERDE (SP)";"SP";"OURO VERDE";113;4;55;172
2009;"OUROESTE (SP)";"SP";"OUROESTE";100;12;31;143
2009;"PACAEMBU (SP)";"SP";"PACAEMBU";160;20;48;228
2009;"PALESTINA (SP)";"SP";"PALESTINA";150;11;38;199
2009;"PALMARES PAULISTA (SP)";"SP";"PALMARES PAULISTA";65;9;93;167
2009;"PALMEIRA D OESTE (SP)";"SP";"PALMEIRA D OESTE";223;6;32;261
2009;"PALMITAL (SP)";"SP";"PALMITAL";575;32;67;674
2009;"PANORAMA (SP)";"SP";"PANORAMA";272;8;17;297
2009;"PARAGUACU PAULISTA (SP)";"SP";"PARAGUACU PAULISTA";609;95;86;790
2009;"PARAIBUNA (SP)";"SP";"PARAIBUNA";189;55;39;283
2009;"PARAISO (SP)";"SP";"PARAISO";185;8;59;252
2009;"PARANAPANEMA (SP)";"SP";"PARANAPANEMA";471;24;57;552
2009;"PARANAPUA (SP)";"SP";"PARANAPUA";60;6;11;77
2009;"PARAPUA (SP)";"SP";"PARAPUA";257;3;48;308
2009;"PARDINHO (SP)";"SP";"PARDINHO";110;12;18;140
2009;"PARIQUERA ACU (SP)";"SP";"PARIQUERA ACU";308;14;14;336
2009;"PARISI (SP)";"SP";"PARISI";27;5;8;40
2009;"PATROCINIO PAULISTA (SP)";"SP";"PATROCINIO PAULISTA";204;8;39;251
2009;"PAULICEIA (SP)";"SP";"PAULICEIA";220;7;19;246
2009;"PAULINIA (SP)";"SP";"PAULINIA";1670;150;330;2150
2009;"PAULISTANIA (SP)";"SP";"PAULISTANIA";22;6;7;35
2009;"PAULO DE FARIA (SP)";"SP";"PAULO DE FARIA";101;16;42;159
2009;"PEDERNEIRAS (SP)";"SP";"PEDERNEIRAS";854;72;184;1110
2009;"PEDRA BELA (SP)";"SP";"PEDRA BELA";153;7;13;173
2009;"PEDRANOPOLIS (SP)";"SP";"PEDRANOPOLIS";42;1;16;59
2009;"PEDREGULHO (SP)";"SP";"PEDREGULHO";242;19;86;347
2009;"PEDREIRA (SP)";"SP";"PEDREIRA";641;88;63;792
2009;"PEDRINHAS PAULISTA (SP)";"SP";"PEDRINHAS PAULISTA";127;4;11;142
2009;"PEDRO DE TOLEDO (SP)";"SP";"PEDRO DE TOLEDO";119;13;7;139
2009;"PENAPOLIS (SP)";"SP";"PENAPOLIS";1225;45;234;1504
2009;"PEREIRA BARRETO (SP)";"SP";"PEREIRA BARRETO";344;24;116;484
2009;"PEREIRAS (SP)";"SP";"PEREIRAS";208;11;27;246
2009;"PERUIBE (SP)";"SP";"PERUIBE";507;137;80;724
2009;"PIACATU (SP)";"SP";"PIACATU";74;1;13;88
2009;"PIEDADE (SP)";"SP";"PIEDADE";1184;96;74;1354
2009;"PILAR DO SUL (SP)";"SP";"PILAR DO SUL";669;46;64;779
2009;"PINDAMONHANGABA (SP)";"SP";"PINDAMONHANGABA";1438;255;171;1864
2009;"PINDORAMA (SP)";"SP";"PINDORAMA";251;13;60;324
2009;"PINHALZINHO (SP)";"SP";"PINHALZINHO";329;27;9;365
2009;"PIQUEROBI (SP)";"SP";"PIQUEROBI";30;5;6;41
2009;"PIQUETE (SP)";"SP";"PIQUETE";144;41;19;204
2009;"PIRACAIA (SP)";"SP";"PIRACAIA";406;51;22;479
2009;"PIRACICABA (SP)";"SP";"PIRACICABA";6546;676;1149;8371
2009;"PIRAJU (SP)";"SP";"PIRAJU";379;44;64;487
2009;"PIRAJUI (SP)";"SP";"PIRAJUI";304;16;66;386
2009;"PIRANGI (SP)";"SP";"PIRANGI";364;18;56;438
2009;"PIRAPORA DO BOM JESUS (SP)";"SP";"PIRAPORA DO BOM JESUS";198;17;14;229
2009;"PIRAPOZINHO (SP)";"SP";"PIRAPOZINHO";384;23;40;447
2009;"PIRASSUNUNGA (SP)";"SP";"PIRASSUNUNGA";937;136;221;1294
2009;"PIRATININGA (SP)";"SP";"PIRATININGA";199;24;38;261
2009;"PITANGUEIRAS (SP)";"SP";"PITANGUEIRAS";790;30;229;1049
2009;"PLANALTO (SP)";"SP";"PLANALTO";75;8;21;104
2009;"PLATINA (SP)";"SP";"PLATINA";46;11;12;69
2009;"POA (SP)";"SP";"POA";735;110;103;948
2009;"POLONI (SP)";"SP";"POLONI";153;5;38;196
2009;"POMPEIA (SP)";"SP";"POMPEIA";244;13;43;300
2009;"PONGAI (SP)";"SP";"PONGAI";44;5;15;64
2009;"PONTAL (SP)";"SP";"PONTAL";861;27;398;1286
2009;"PONTALINDA (SP)";"SP";"PONTALINDA";36;3;18;57
2009;"PONTES GESTAL (SP)";"SP";"PONTES GESTAL";51;1;22;74
2009;"POPULINA (SP)";"SP";"POPULINA";61;5;20;86
2009;"PORANGABA (SP)";"SP";"PORANGABA";104;11;9;124
2009;"PORTO FELIZ (SP)";"SP";"PORTO FELIZ";1120;71;165;1356
2009;"PORTO FERREIRA (SP)";"SP";"PORTO FERREIRA";976;71;140;1187
2009;"POTIM (SP)";"SP";"POTIM";50;39;16;105
2009;"POTIRENDABA (SP)";"SP";"POTIRENDABA";416;15;59;490
2009;"PRACINHA (SP)";"SP";"PRACINHA";11;1;14;26
2009;"PRADOPOLIS (SP)";"SP";"PRADOPOLIS";366;15;171;552
2009;"PRAIA GRANDE (SP)";"SP";"PRAIA GRANDE";1627;246;232;2105
2009;"PRATANIA (SP)";"SP";"PRATANIA";100;11;31;142
2009;"PRESIDENTE ALVES (SP)";"SP";"PRESIDENTE ALVES";80;4;35;119
2009;"PRESIDENTE BERNARDES (SP)";"SP";"PRESIDENTE BERNARDES";211;18;28;257
2009;"PRESIDENTE EPITACIO (SP)";"SP";"PRESIDENTE EPITACIO";430;41;88;559
2009;"PRESIDENTE PRUDENTE (SP)";"SP";"PRESIDENTE PRUDENTE";3327;272;743;4342
2009;"PRESIDENTE VENCESLAU (SP)";"SP";"PRESIDENTE VENCESLAU";563;35;52;650
2009;"PROMISSAO (SP)";"SP";"PROMISSAO";653;46;167;866
2009;"QUADRA (SP)";"SP";"QUADRA";45;5;13;63
2009;"QUATA (SP)";"SP";"QUATA";192;14;56;262
2009;"QUEIROZ (SP)";"SP";"QUEIROZ";20;4;9;33
2009;"QUELUZ (SP)";"SP";"QUELUZ";101;24;7;132
2009;"QUINTANA (SP)";"SP";"QUINTANA";90;8;16;114
2009;"RAFARD (SP)";"SP";"RAFARD";246;16;25;287
2009;"RANCHARIA (SP)";"SP";"RANCHARIA";525;56;74;655
2009;"REDENCAO DA SERRA (SP)";"SP";"REDENCAO DA SERRA";55;13;20;88
2009;"REGENTE FEIJO (SP)";"SP";"REGENTE FEIJO";337;29;26;392
2009;"REGINOPOLIS (SP)";"SP";"REGINOPOLIS";80;6;18;104
2009;"REGISTRO (SP)";"SP";"REGISTRO";956;71;265;1292
2009;"RESTINGA (SP)";"SP";"RESTINGA";46;5;16;67
2009;"RIBEIRA (SP)";"SP";"RIBEIRA";23;6;5;34
2009;"RIBEIRAO BONITO (SP)";"SP";"RIBEIRAO BONITO";276;24;78;378
2009;"RIBEIRAO BRANCO (SP)";"SP";"RIBEIRAO BRANCO";128;20;28;176
2009;"RIBEIRAO CORRENTE (SP)";"SP";"RIBEIRAO CORRENTE";52;6;28;86
2009;"RIBEIRAO DO SUL (SP)";"SP";"RIBEIRAO DO SUL";104;9;13;126
2009;"RIBEIRAO DOS INDIOS (SP)";"SP";"RIBEIRAO DOS INDIOS";19;2;12;33
2009;"RIBEIRAO GRANDE (SP)";"SP";"RIBEIRAO GRANDE";66;11;12;89
2009;"RIBEIRAO PIRES (SP)";"SP";"RIBEIRAO PIRES";1895;351;328;2574
2009;"RIBEIRAO PRETO (SP)";"SP";"RIBEIRAO PRETO";8587;777;1336;10700
2009;"RIFAINA (SP)";"SP";"RIFAINA";36;3;9;48
2009;"RINCAO (SP)";"SP";"RINCAO";236;10;46;292
2009;"RINOPOLIS (SP)";"SP";"RINOPOLIS";171;5;53;229
2009;"RIO CLARO (SP)";"SP";"RIO CLARO";2853;278;368;3499
2009;"RIO DAS PEDRAS (SP)";"SP";"RIO DAS PEDRAS";631;60;164;855
2009;"RIO GRANDE DA SERRA (SP)";"SP";"RIO GRANDE DA SERRA";219;73;42;334
2009;"RIOLANDIA (SP)";"SP";"RIOLANDIA";86;6;48;140
2009;"RIVERSUL (SP)";"SP";"RIVERSUL";56;10;24;90
2009;"ROSANA (SP)";"SP";"ROSANA";153;9;42;204
2009;"ROSEIRA (SP)";"SP";"ROSEIRA";121;42;12;175
2009;"RUBIACEA (SP)";"SP";"RUBIACEA";32;2;9;43
2009;"RUBINEIA (SP)";"SP";"RUBINEIA";21;6;6;33
2009;"SABINO (SP)";"SP";"SABINO";56;5;11;72
2009;"SAGRES (SP)";"SP";"SAGRES";13;2;6;21
2009;"SALES (SP)";"SP";"SALES";70;3;27;100
2009;"SALES OLIVEIRA (SP)";"SP";"SALES OLIVEIRA";219;7;41;267
2009;"SALESOPOLIS (SP)";"SP";"SALESOPOLIS";548;65;41;654
2009;"SALMOURAO (SP)";"SP";"SALMOURAO";29;1;30;60
2009;"SALTINHO (SP)";"SP";"SALTINHO";307;12;5;324
2009;"SALTO (SP)";"SP";"SALTO";1782;201;188;2171
2009;"SALTO DE PIRAPORA (SP)";"SP";"SALTO DE PIRAPORA";531;35;47;613
2009;"SALTO GRANDE (SP)";"SP";"SALTO GRANDE";127;10;29;166
2009;"SANDOVALINA (SP)";"SP";"SANDOVALINA";26;3;9;38
2009;"SANTA ADELIA (SP)";"SP";"SANTA ADELIA";512;28;75;615
2009;"SANTA ALBERTINA (SP)";"SP";"SANTA ALBERTINA";117;6;22;145
2009;"SANTA BARBARA D OESTE (SP)";"SP";"SANTA BARBARA D OESTE";2218;330;259;2807
2009;"SANTA BRANCA (SP)";"SP";"SANTA BRANCA";115;25;32;172
2009;"SANTA CLARA D OESTE (SP)";"SP";"SANTA CLARA D OESTE";22;1;3;26
2009;"SANTA CRUZ DA CONCEICAO (SP)";"SP";"SANTA CRUZ DA CONCEICAO";121;11;11;143
2009;"SANTA CRUZ DA ESPERANCA (SP)";"SP";"SANTA CRUZ DA ESPERANCA";21;1;5;27
2009;"SANTA CRUZ DAS PALMEIRAS (SP)";"SP";"SANTA CRUZ DAS PALMEIRAS";590;29;190;809
2009;"SANTA CRUZ DO RIO PARDO (SP)";"SP";"SANTA CRUZ DO RIO PARDO";1072;84;67;1223
2009;"SANTA ERNESTINA (SP)";"SP";"SANTA ERNESTINA";84;9;47;140
2009;"SANTA FE DO SUL (SP)";"SP";"SANTA FE DO SUL";591;18;37;646
2009;"SANTA GERTRUDES (SP)";"SP";"SANTA GERTRUDES";500;44;23;567
2009;"SANTA ISABEL (SP)";"SP";"SANTA ISABEL";926;50;92;1068
2009;"SANTA LUCIA (SP)";"SP";"SANTA LUCIA";125;20;49;194
2009;"SANTA MARIA DA SERRA (SP)";"SP";"SANTA MARIA DA SERRA";196;21;30;247
2009;"SANTA MERCEDES (SP)";"SP";"SANTA MERCEDES";43;6;9;58
2009;"SANTA RITA D OESTE (SP)";"SP";"SANTA RITA D OESTE";27;1;6;34
2009;"SANTA RITA DO PASSA QUATRO (SP)";"SP";"SANTA RITA DO PASSA QUATRO";523;49;43;615
2009;"SANTA ROSA DE VITERBO (SP)";"SP";"SANTA ROSA DE VITERBO";359;31;81;471
2009;"SANTA SALETE (SP)";"SP";"SANTA SALETE";41;5;7;53
2009;"SANTANA DA PONTE PENSA (SP)";"SP";"SANTANA DA PONTE PENSA";24;2;2;28
2009;"SANTANA DE PARNAIBA (SP)";"SP";"SANTANA DE PARNAIBA";1409;229;142;1780
2009;"SANTO ANASTACIO (SP)";"SP";"SANTO ANASTACIO";419;16;54;489
2009;"SANTO ANDRE (SP)";"SP";"SANTO ANDRE";8359;1581;1697;11637
2009;"SANTO ANTONIO DA ALEGRIA (SP)";"SP";"SANTO ANTONIO DA ALEGRIA";89;6;21;116
2009;"SANTO ANTONIO DE POSSE (SP)";"SP";"SANTO ANTONIO DE POSSE";624;41;104;769
2009;"SANTO ANTONIO DO ARACANGUA (SP)";"SP";"SANTO ANTONIO DO ARACANGUA";195;18;83;296
2009;"SANTO ANTONIO DO JARDIM (SP)";"SP";"SANTO ANTONIO DO JARDIM";188;14;11;213
2009;"SANTO ANTONIO DO PINHAL (SP)";"SP";"SANTO ANTONIO DO PINHAL";97;22;6;125
2009;"SANTO EXPEDITO (SP)";"SP";"SANTO EXPEDITO";24;2;7;33
2009;"SANTOPOLIS DO AGUAPEI (SP)";"SP";"SANTOPOLIS DO AGUAPEI";68;3;30;101
2009;"SANTOS (SP)";"SP";"SANTOS";4996;756;617;6369
2009;"SAO BENTO DO SAPUCAI (SP)";"SP";"SAO BENTO DO SAPUCAI";110;32;9;151
2009;"SAO BERNARDO DO CAMPO (SP)";"SP";"SAO BERNARDO DO CAMPO";10303;1824;2592;14719
2009;"SAO CAETANO DO SUL (SP)";"SP";"SAO CAETANO DO SUL";2679;515;462;3656
2009;"SAO CARLOS (SP)";"SP";"SAO CARLOS";3270;333;387;3990
2009;"SAO FRANCISCO (SP)";"SP";"SAO FRANCISCO";25;4;13;42
2009;"SAO JOAO DA BOA VISTA (SP)";"SP";"SAO JOAO DA BOA VISTA";1632;206;88;1926
2009;"SAO JOAO DAS DUAS PONTES (SP)";"SP";"SAO JOAO DAS DUAS PONTES";16;6;7;29
2009;"SAO JOAO DE IRACEMA (SP)";"SP";"SAO JOAO DE IRACEMA";21;5;11;37
2009;"SAO JOAO DO PAU D ALHO (SP)";"SP";"SAO JOAO DO PAU D ALHO";33;5;6;44
2009;"SAO JOAQUIM DA BARRA (SP)";"SP";"SAO JOAQUIM DA BARRA";743;42;171;956
2009;"SAO JOSE DA BELA VISTA (SP)";"SP";"SAO JOSE DA BELA VISTA";69;9;44;122
2009;"SAO JOSE DO BARREIRO (SP)";"SP";"SAO JOSE DO BARREIRO";28;12;6;46
2009;"SAO JOSE DO RIO PARDO (SP)";"SP";"SAO JOSE DO RIO PARDO";1083;63;109;1255
2009;"SAO JOSE DO RIO PRETO (SP)";"SP";"SAO JOSE DO RIO PRETO";6958;508;1206;8672
2009;"SAO JOSE DOS CAMPOS (SP)";"SP";"SAO JOSE DOS CAMPOS";5896;1503;1433;8832
2009;"SAO LOURENCO DA SERRA (SP)";"SP";"SAO LOURENCO DA SERRA";226;16;17;259
2009;"SAO LUIZ DO PARAITINGA (SP)";"SP";"SAO LUIZ DO PARAITINGA";118;22;22;162
2009;"SAO MANUEL (SP)";"SP";"SAO MANUEL";718;74;163;955
2009;"SAO MIGUEL ARCANJO (SP)";"SP";"SAO MIGUEL ARCANJO";605;67;57;729
2009;"SAO PAULO (SP)";"SP";"SAO PAULO";133978;30087;39049;203114
2009;"SAO PEDRO (SP)";"SP";"SAO PEDRO";508;57;72;637
2009;"SAO PEDRO DO TURVO (SP)";"SP";"SAO PEDRO DO TURVO";146;12;29;187
2009;"SAO ROQUE (SP)";"SP";"SAO ROQUE";867;166;186;1219
2009;"SAO SEBASTIAO (SP)";"SP";"SAO SEBASTIAO";543;81;178;802
2009;"SAO SEBASTIAO DA GRAMA (SP)";"SP";"SAO SEBASTIAO DA GRAMA";222;22;25;269
2009;"SAO SIMAO (SP)";"SP";"SAO SIMAO";312;16;34;362
2009;"SAO VICENTE (SP)";"SP";"SAO VICENTE";1615;617;868;3100
2009;"SARAPUI (SP)";"SP";"SARAPUI";133;9;9;151
2009;"SARUTAIA (SP)";"SP";"SARUTAIA";29;11;20;60
2009;"SEBASTIANOPOLIS DO SUL (SP)";"SP";"SEBASTIANOPOLIS DO SUL";143;5;15;163
2009;"SERRA AZUL (SP)";"SP";"SERRA AZUL";131;13;83;227
2009;"SERRA NEGRA (SP)";"SP";"SERRA NEGRA";390;47;26;463
2009;"SERRANA (SP)";"SP";"SERRANA";594;94;219;907
2009;"SERTAOZINHO (SP)";"SP";"SERTAOZINHO";2411;120;392;2923
2009;"SETE BARRAS (SP)";"SP";"SETE BARRAS";169;6;29;204
2009;"SEVERINIA (SP)";"SP";"SEVERINIA";308;13;167;488
2009;"SILVEIRAS (SP)";"SP";"SILVEIRAS";62;14;6;82
2009;"SOCORRO (SP)";"SP";"SOCORRO";695;94;43;832
2009;"SOROCABA (SP)";"SP";"SOROCABA";6753;1005;1353;9111
2009;"SUD MENUCCI (SP)";"SP";"SUD MENUCCI";138;14;54;206
2009;"SUMARE (SP)";"SP";"SUMARE";2171;479;402;3052
2009;"SUZANO (SP)";"SP";"SUZANO";2348;352;383;3083
2009;"SUZANOPOLIS (SP)";"SP";"SUZANOPOLIS";45;6;15;66
2009;"TABAPUA (SP)";"SP";"TABAPUA";146;16;47;209
2009;"TABATINGA (SP)";"SP";"TABATINGA";332;12;120;464
2009;"TABOAO DA SERRA (SP)";"SP";"TABOAO DA SERRA";2017;567;510;3094
2009;"TACIBA (SP)";"SP";"TACIBA";75;4;18;97
2009;"TAGUAI (SP)";"SP";"TAGUAI";145;4;20;169
2009;"TAIACU (SP)";"SP";"TAIACU";130;4;17;151
2009;"TAIUVA (SP)";"SP";"TAIUVA";136;5;22;163
2009;"TAMBAU (SP)";"SP";"TAMBAU";465;34;47;546
2009;"TANABI (SP)";"SP";"TANABI";440;40;87;567
2009;"TAPIRAI (SP)";"SP";"TAPIRAI";161;8;10;179
2009;"TAPIRATIBA (SP)";"SP";"TAPIRATIBA";317;13;58;388
2009;"TAQUARAL (SP)";"SP";"TAQUARAL";52;6;17;75
2009;"TAQUARITINGA (SP)";"SP";"TAQUARITINGA";1403;55;292;1750
2009;"TAQUARITUBA (SP)";"SP";"TAQUARITUBA";573;35;67;675
2009;"TAQUARIVAI (SP)";"SP";"TAQUARIVAI";45;10;12;67
2009;"TARABAI (SP)";"SP";"TARABAI";86;6;27;119
2009;"TARUMA (SP)";"SP";"TARUMA";352;14;267;633
2009;"TATUI (SP)";"SP";"TATUI";1724;104;616;2444
2009;"TAUBATE (SP)";"SP";"TAUBATE";2723;656;652;4031
2009;"TEJUPA (SP)";"SP";"TEJUPA";43;9;6;58
2009;"TEODORO SAMPAIO (SP)";"SP";"TEODORO SAMPAIO";243;14;284;541
2009;"TERRA ROXA (SP)";"SP";"TERRA ROXA";156;11;58;225
2009;"TIETE (SP)";"SP";"TIETE";1135;41;141;1317
2009;"TIMBURI (SP)";"SP";"TIMBURI";26;3;7;36
2009;"TORRE DE PEDRA (SP)";"SP";"TORRE DE PEDRA";41;4;6;51
2009;"TORRINHA (SP)";"SP";"TORRINHA";359;18;36;413
2009;"TRABIJU (SP)";"SP";"TRABIJU";43;10;7;60
2009;"TREMEMBE (SP)";"SP";"TREMEMBE";349;52;9;410
2009;"TRES FRONTEIRAS (SP)";"SP";"TRES FRONTEIRAS";55;4;8;67
2009;"TUIUTI (SP)";"SP";"TUIUTI";88;16;13;117
2009;"TUPA (SP)";"SP";"TUPA";1287;46;174;1507
2009;"TUPI PAULISTA (SP)";"SP";"TUPI PAULISTA";277;11;23;311
2009;"TURIUBA (SP)";"SP";"TURIUBA";17;1;7;25
2009;"TURMALINA (SP)";"SP";"TURMALINA";26;4;9;39
2009;"UBARANA (SP)";"SP";"UBARANA";113;4;27;144
2009;"UBATUBA (SP)";"SP";"UBATUBA";568;68;57;693
2009;"UBIRAJARA (SP)";"SP";"UBIRAJARA";89;8;22;119
2009;"UCHOA (SP)";"SP";"UCHOA";134;9;39;182
2009;"UNIAO PAULISTA (SP)";"SP";"UNIAO PAULISTA";41;2;7;50
2009;"URANIA (SP)";"SP";"URANIA";128;13;29;170
2009;"URU (SP)";"SP";"URU";10;8;8;26
2009;"URUPES (SP)";"SP";"URUPES";317;19;46;382
2009;"VALENTIM GENTIL (SP)";"SP";"VALENTIM GENTIL";204;16;26;246
2009;"VALINHOS (SP)";"SP";"VALINHOS";1881;396;1381;3658
2009;"VALPARAISO (SP)";"SP";"VALPARAISO";398;28;144;570
2009;"VARGEM (SP)";"SP";"VARGEM";235;13;15;263
2009;"VARGEM GRANDE DO SUL (SP)";"SP";"VARGEM GRANDE DO SUL";1015;70;180;1265
2009;"VARGEM GRANDE PAULISTA (SP)";"SP";"VARGEM GRANDE PAULISTA";744;74;52;870
2009;"VARZEA PAULISTA (SP)";"SP";"VARZEA PAULISTA";871;281;172;1324
2009;"VERA CRUZ (SP)";"SP";"VERA CRUZ";127;17;25;169
2009;"VINHEDO (SP)";"SP";"VINHEDO";1247;117;96;1460
2009;"VIRADOURO (SP)";"SP";"VIRADOURO";344;16;69;429
2009;"VISTA ALEGRE DO ALTO (SP)";"SP";"VISTA ALEGRE DO ALTO";295;18;105;418
2009;"VITORIA BRASIL (SP)";"SP";"VITORIA BRASIL";16;1;9;26
2009;"VOTORANTIM (SP)";"SP";"VOTORANTIM";1049;226;149;1424
2009;"VOTUPORANGA (SP)";"SP";"VOTUPORANGA";1700;76;150;1926
2009;"ZACARIAS (SP)";"SP";"ZACARIAS";36;6;12;54
2009;"ABREULANDIA (TO)";"TO";"ABREULANDIA";9;1;0;10
2009;"AGUIARNOPOLIS (TO)";"TO";"AGUIARNOPOLIS";37;3;8;48
2009;"ALIANCA DO TOCANTINS (TO)";"TO";"ALIANCA DO TOCANTINS";65;8;6;79
2009;"ALMAS (TO)";"TO";"ALMAS";42;0;2;44
2009;"ALVORADA (TO)";"TO";"ALVORADA";136;0;3;139
2009;"ANANAS (TO)";"TO";"ANANAS";51;6;18;75
2009;"ANGICO (TO)";"TO";"ANGICO";11;2;2;15
2009;"APARECIDA DO RIO NEGRO (TO)";"TO";"APARECIDA DO RIO NEGRO";54;11;2;67
2009;"ARAGOMINAS (TO)";"TO";"ARAGOMINAS";88;3;14;105
2009;"ARAGUACEMA (TO)";"TO";"ARAGUACEMA";22;1;5;28
2009;"ARAGUACU (TO)";"TO";"ARAGUACU";73;8;6;87
2009;"ARAGUAINA (TO)";"TO";"ARAGUAINA";3237;108;308;3653
2009;"ARAGUANA (TO)";"TO";"ARAGUANA";224;13;47;284
2009;"ARAGUATINS (TO)";"TO";"ARAGUATINS";368;41;58;467
2009;"ARAPOEMA (TO)";"TO";"ARAPOEMA";38;4;10;52
2009;"ARRAIAS (TO)";"TO";"ARRAIAS";30;1;5;36
2009;"AUGUSTINOPOLIS (TO)";"TO";"AUGUSTINOPOLIS";126;28;10;164
2009;"AURORA DO TOCANTINS (TO)";"TO";"AURORA DO TOCANTINS";4;0;2;6
2009;"AXIXA DO TOCANTINS (TO)";"TO";"AXIXA DO TOCANTINS";30;16;4;50
2009;"BABACULANDIA (TO)";"TO";"BABACULANDIA";534;17;23;574
2009;"BANDEIRANTES DO TOCANTINS (TO)";"TO";"BANDEIRANTES DO TOCANTINS";19;1;3;23
2009;"BARRA DO OURO (TO)";"TO";"BARRA DO OURO";3;0;0;3
2009;"BARROLANDIA (TO)";"TO";"BARROLANDIA";43;4;3;50
2009;"BERNARDO SAYAO (TO)";"TO";"BERNARDO SAYAO";34;1;8;43
2009;"BOM JESUS DO TOCANTINS (TO)";"TO";"BOM JESUS DO TOCANTINS";6;1;0;7
2009;"BRASILANDIA DO TOCANTINS (TO)";"TO";"BRASILANDIA DO TOCANTINS";12;1;1;14
2009;"BREJINHO DE NAZARE (TO)";"TO";"BREJINHO DE NAZARE";39;1;5;45
2009;"BURITI DO TOCANTINS (TO)";"TO";"BURITI DO TOCANTINS";44;12;4;60
2009;"CACHOEIRINHA (TO)";"TO";"CACHOEIRINHA";4;1;0;5
2009;"CAMPOS LINDOS (TO)";"TO";"CAMPOS LINDOS";34;1;1;36
2009;"CARIRI DO TOCANTINS (TO)";"TO";"CARIRI DO TOCANTINS";32;2;7;41
2009;"CARMOLANDIA (TO)";"TO";"CARMOLANDIA";526;36;154;716
2009;"CARRASCO BONITO (TO)";"TO";"CARRASCO BONITO";4;4;1;9
2009;"CASEARA (TO)";"TO";"CASEARA";25;2;2;29
2009;"CENTENARIO (TO)";"TO";"CENTENARIO";3;0;1;4
2009;"CHAPADA DA NATIVIDADE (TO)";"TO";"CHAPADA DA NATIVIDADE";14;0;4;18
2009;"CHAPADA DE AREIA (TO)";"TO";"CHAPADA DE AREIA";2;0;2;4
2009;"COLINAS DO TOCANTINS (TO)";"TO";"COLINAS DO TOCANTINS";465;9;49;523
2009;"COLMEIA (TO)";"TO";"COLMEIA";110;7;12;129
2009;"COMBINADO (TO)";"TO";"COMBINADO";16;2;6;24
2009;"CONCEICAO DO TOCANTINS (TO)";"TO";"CONCEICAO DO TOCANTINS";11;0;0;11
2009;"COUTO DE MAGALHAES (TO)";"TO";"COUTO DE MAGALHAES";7;6;5;18
2009;"CRISTALANDIA (TO)";"TO";"CRISTALANDIA";81;0;2;83
2009;"CRIXAS DO TOCANTINS (TO)";"TO";"CRIXAS DO TOCANTINS";4;1;1;6
2009;"DARCINOPOLIS (TO)";"TO";"DARCINOPOLIS";104;11;4;119
2009;"DIANOPOLIS (TO)";"TO";"DIANOPOLIS";117;7;29;153
2009;"DIVINOPOLIS DO TOCANTINS (TO)";"TO";"DIVINOPOLIS DO TOCANTINS";52;3;4;59
2009;"DOIS IRMAOS DO TOCANTINS (TO)";"TO";"DOIS IRMAOS DO TOCANTINS";33;3;6;42
2009;"DUERE (TO)";"TO";"DUERE";23;4;4;31
2009;"ESPERANTINA (TO)";"TO";"ESPERANTINA";15;12;5;32
2009;"FATIMA (TO)";"TO";"FATIMA";24;2;2;28
2009;"FIGUEIROPOLIS (TO)";"TO";"FIGUEIROPOLIS";42;3;4;49
2009;"FILADELFIA (TO)";"TO";"FILADELFIA";46;9;7;62
2009;"FORMOSO DO ARAGUAIA (TO)";"TO";"FORMOSO DO ARAGUAIA";160;5;18;183
2009;"FORTALEZA DO TABOCAO (TO)";"TO";"FORTALEZA DO TABOCAO";22;5;4;31
2009;"GOIANORTE (TO)";"TO";"GOIANORTE";22;4;4;30
2009;"GOIATINS (TO)";"TO";"GOIATINS";90;7;13;110
2009;"GUARAI (TO)";"TO";"GUARAI";309;9;25;343
2009;"GURUPI (TO)";"TO";"GURUPI";1256;24;166;1446
2009;"IPUEIRAS (TO)";"TO";"IPUEIRAS";4;0;2;6
2009;"ITACAJA (TO)";"TO";"ITACAJA";27;1;0;28
2009;"ITAGUATINS (TO)";"TO";"ITAGUATINS";44;5;20;69
2009;"ITAPIRATINS (TO)";"TO";"ITAPIRATINS";10;1;7;18
2009;"ITAPORA DO TOCANTINS (TO)";"TO";"ITAPORA DO TOCANTINS";17;4;4;25
2009;"JAU DO TOCANTINS (TO)";"TO";"JAU DO TOCANTINS";14;1;7;22
2009;"JUARINA (TO)";"TO";"JUARINA";11;1;1;13
2009;"LAGOA DA CONFUSAO (TO)";"TO";"LAGOA DA CONFUSAO";81;2;7;90
2009;"LAGOA DO TOCANTINS (TO)";"TO";"LAGOA DO TOCANTINS";5;2;3;10
2009;"LAJEADO (TO)";"TO";"LAJEADO";21;0;10;31
2009;"LAVANDEIRA (TO)";"TO";"LAVANDEIRA";3;1;1;5
2009;"LIZARDA (TO)";"TO";"LIZARDA";13;1;0;14
2009;"LUZINOPOLIS (TO)";"TO";"LUZINOPOLIS";6;3;0;9
2009;"MARIANOPOLIS DO TOCANTINS (TO)";"TO";"MARIANOPOLIS DO TOCANTINS";25;0;5;30
2009;"MATEIROS (TO)";"TO";"MATEIROS";15;0;2;17
2009;"MAURILANDIA DO TOCANTINS (TO)";"TO";"MAURILANDIA DO TOCANTINS";9;3;2;14
2009;"MIRACEMA DO TOCANTINS (TO)";"TO";"MIRACEMA DO TOCANTINS";186;14;39;239
2009;"MIRANORTE (TO)";"TO";"MIRANORTE";198;12;7;217
2009;"MONTE DO CARMO (TO)";"TO";"MONTE DO CARMO";9;0;4;13
2009;"MONTE SANTO DO TOCANTINS (TO)";"TO";"MONTE SANTO DO TOCANTINS";39;3;2;44
2009;"MURICILANDIA (TO)";"TO";"MURICILANDIA";15;2;2;19
2009;"NATIVIDADE (TO)";"TO";"NATIVIDADE";48;2;1;51
2009;"NAZARE (TO)";"TO";"NAZARE";19;5;1;25
2009;"NOVA OLINDA (TO)";"TO";"NOVA OLINDA";78;4;12;94
2009;"NOVA ROSALANDIA (TO)";"TO";"NOVA ROSALANDIA";19;0;2;21
2009;"NOVO ACORDO (TO)";"TO";"NOVO ACORDO";15;0;1;16
2009;"NOVO ALEGRE (TO)";"TO";"NOVO ALEGRE";5;2;2;9
2009;"NOVO JARDIM (TO)";"TO";"NOVO JARDIM";12;0;2;14
2009;"OLIVEIRA DE FATIMA (TO)";"TO";"OLIVEIRA DE FATIMA";7;0;3;10
2009;"PALMAS (TO)";"TO";"PALMAS";3236;215;674;4125
2009;"PALMEIRANTE (TO)";"TO";"PALMEIRANTE";10;4;2;16
2009;"PALMEIRAS DO TOCANTINS (TO)";"TO";"PALMEIRAS DO TOCANTINS";31;7;2;40
2009;"PALMEIROPOLIS (TO)";"TO";"PALMEIROPOLIS";85;2;9;96
2009;"PARAISO DO TOCANTINS (TO)";"TO";"PARAISO DO TOCANTINS";963;25;92;1080
2009;"PARANA (TO)";"TO";"PARANA";12;4;1;17
2009;"PAU D ARCO (TO)";"TO";"PAU D ARCO";11;1;2;14
2009;"PEDRO AFONSO (TO)";"TO";"PEDRO AFONSO";117;1;20;138
2009;"PEIXE (TO)";"TO";"PEIXE";51;6;50;107
2009;"PEQUIZEIRO (TO)";"TO";"PEQUIZEIRO";23;0;5;28
2009;"PINDORAMA DO TOCANTINS (TO)";"TO";"PINDORAMA DO TOCANTINS";25;0;2;27
2009;"PIRAQUE (TO)";"TO";"PIRAQUE";3;0;4;7
2009;"PIUM (TO)";"TO";"PIUM";30;3;8;41
2009;"PONTE ALTA DO BOM JESUS (TO)";"TO";"PONTE ALTA DO BOM JESUS";10;0;0;10
2009;"PONTE ALTA DO TOCANTINS (TO)";"TO";"PONTE ALTA DO TOCANTINS";24;2;1;27
2009;"PORTO ALEGRE DO TOCANTINS (TO)";"TO";"PORTO ALEGRE DO TOCANTINS";7;0;4;11
2009;"PORTO NACIONAL (TO)";"TO";"PORTO NACIONAL";543;23;85;651
2009;"PRAIA NORTE (TO)";"TO";"PRAIA NORTE";6;7;2;15
2009;"PRESIDENTE KENNEDY (TO)";"TO";"PRESIDENTE KENNEDY";28;4;1;33
2009;"PUGMIL (TO)";"TO";"PUGMIL";9;1;1;11
2009;"RECURSOLANDIA (TO)";"TO";"RECURSOLANDIA";7;0;0;7
2009;"RIACHINHO (TO)";"TO";"RIACHINHO";131;14;45;190
2009;"RIO DA CONCEICAO (TO)";"TO";"RIO DA CONCEICAO";4;1;1;6
2009;"RIO DOS BOIS (TO)";"TO";"RIO DOS BOIS";5;0;3;8
2009;"RIO SONO (TO)";"TO";"RIO SONO";12;1;4;17
2009;"SAMPAIO (TO)";"TO";"SAMPAIO";90;3;4;97
2009;"SANDOLANDIA (TO)";"TO";"SANDOLANDIA";11;3;1;15
2009;"SANTA FE DO ARAGUAIA (TO)";"TO";"SANTA FE DO ARAGUAIA";76;10;12;98
2009;"SANTA MARIA DO TOCANTINS (TO)";"TO";"SANTA MARIA DO TOCANTINS";10;3;0;13
2009;"SANTA RITA DO TOCANTINS (TO)";"TO";"SANTA RITA DO TOCANTINS";10;2;2;14
2009;"SANTA ROSA DO TOCANTINS (TO)";"TO";"SANTA ROSA DO TOCANTINS";20;0;3;23
2009;"SANTA TEREZA DO TOCANTINS (TO)";"TO";"SANTA TEREZA DO TOCANTINS";9;1;0;10
2009;"SANTA TEREZINHA DO TOCANTINS (TO)";"TO";"SANTA TEREZINHA DO TOCANTINS";6;2;2;10
2009;"SAO BENTO DO TOCANTINS (TO)";"TO";"SAO BENTO DO TOCANTINS";14;5;10;29
2009;"SAO FELIX DO TOCANTINS (TO)";"TO";"SAO FELIX DO TOCANTINS";3;1;0;4
2009;"SAO MIGUEL DO TOCANTINS (TO)";"TO";"SAO MIGUEL DO TOCANTINS";127;21;48;196
2009;"SAO SALVADOR DO TOCANTINS (TO)";"TO";"SAO SALVADOR DO TOCANTINS";28;0;1;29
2009;"SAO SEBASTIAO DO TOCANTINS (TO)";"TO";"SAO SEBASTIAO DO TOCANTINS";6;2;2;10
2009;"SAO VALERIO DA NATIVIDADE (TO)";"TO";"SAO VALERIO DA NATIVIDADE";35;1;4;40
2009;"SILVANOPOLIS (TO)";"TO";"SILVANOPOLIS";26;1;1;28
2009;"SITIO NOVO DO TOCANTINS (TO)";"TO";"SITIO NOVO DO TOCANTINS";37;5;15;57
2009;"SUCUPIRA (TO)";"TO";"SUCUPIRA";12;0;6;18
2009;"TAGUATINGA (TO)";"TO";"TAGUATINGA";51;6;17;74
2009;"TAIPAS DO TOCANTINS (TO)";"TO";"TAIPAS DO TOCANTINS";4;1;0;5
2009;"TALISMA (TO)";"TO";"TALISMA";11;4;0;15
2009;"TOCANTINIA (TO)";"TO";"TOCANTINIA";19;0;3;22
2009;"TOCANTINOPOLIS (TO)";"TO";"TOCANTINOPOLIS";1546;199;249;1994
2009;"TUPIRAMA (TO)";"TO";"TUPIRAMA";17;2;1;20
2009;"TUPIRATINS (TO)";"TO";"TUPIRATINS";8;0;5;13
2009;"WANDERLANDIA (TO)";"TO";"WANDERLANDIA";41;4;4;49
2009;"XAMBIOA (TO)";"TO";"XAMBIOA";91;3;12;106
