"ano";"chave";"UF";"MUNICIPIO";"CAMINHAO";"MICRO_ONIBUS";"ONIBUS";"total"
2003;"ACRELANDIA (AC)";"AC";"ACRELANDIA";33;0;7;40
2003;"ASSIS BRASIL (AC)";"AC";"ASSIS BRASIL";8;0;0;8
2003;"BRASILEIA (AC)";"AC";"BRASILEIA";68;0;3;71
2003;"BUJARI (AC)";"AC";"BUJARI";24;2;2;28
2003;"CAPIXABA (AC)";"AC";"CAPIXABA";7;1;2;10
2003;"CRUZEIRO DO SUL (AC)";"AC";"CRUZEIRO DO SUL";209;16;17;242
2003;"EPITACIOLANDIA (AC)";"AC";"EPITACIOLANDIA";51;0;5;56
2003;"FEIJO (AC)";"AC";"FEIJO";23;0;0;23
2003;"MANCIO LIMA (AC)";"AC";"MANCIO LIMA";14;1;3;18
2003;"MANOEL URBANO (AC)";"AC";"MANOEL URBANO";3;0;0;3
2003;"PLACIDO DE CASTRO (AC)";"AC";"PLACIDO DE CASTRO";31;1;1;33
2003;"PORTO ACRE (AC)";"AC";"PORTO ACRE";20;1;0;21
2003;"RIO BRANCO (AC)";"AC";"RIO BRANCO";2415;77;320;2812
2003;"SANTA ROSA (AC)";"AC";"SANTA ROSA";0;0;0;0
2003;"SENA MADUREIRA (AC)";"AC";"SENA MADUREIRA";32;1;1;34
2003;"SENADOR GUIOMARD (AC)";"AC";"SENADOR GUIOMARD";73;0;4;77
2003;"TARAUACA (AC)";"AC";"TARAUACA";20;0;0;20
2003;"XAPURI (AC)";"AC";"XAPURI";14;0;0;14
2003;"ARAPIRACA (AL)";"AL";"ARAPIRACA";1810;271;216;2297
2003;"ATALAIA (AL)";"AL";"ATALAIA";429;107;97;633
2003;"CAJUEIRO (AL)";"AL";"CAJUEIRO";0;0;0;0
2003;"CAMPO GRANDE (AL)";"AL";"CAMPO GRANDE";0;0;0;0
2003;"CORURIPE (AL)";"AL";"CORURIPE";319;51;149;519
2003;"DELMIRO GOUVEIA (AL)";"AL";"DELMIRO GOUVEIA";419;131;25;575
2003;"GIRAU DO PONCIANO (AL)";"AL";"GIRAU DO PONCIANO";156;33;41;230
2003;"MACEIO (AL)";"AL";"MACEIO";4081;555;1355;5991
2003;"MATRIZ DE CAMARAGIBE (AL)";"AL";"MATRIZ DE CAMARAGIBE";644;190;141;975
2003;"PALMEIRA DOS INDIOS (AL)";"AL";"PALMEIRA DOS INDIOS";506;151;86;743
2003;"PENEDO (AL)";"AL";"PENEDO";472;77;164;713
2003;"PORTO DE PEDRAS (AL)";"AL";"PORTO DE PEDRAS";1;0;0;1
2003;"QUEBRANGULO (AL)";"AL";"QUEBRANGULO";0;0;0;0
2003;"SANTANA DO IPANEMA (AL)";"AL";"SANTANA DO IPANEMA";610;92;52;754
2003;"SAO MIGUEL DOS CAMPOS (AL)";"AL";"SAO MIGUEL DOS CAMPOS";764;155;216;1135
2003;"TRAIPU (AL)";"AL";"TRAIPU";0;0;0;0
2003;"UNIAO DOS PALMARES (AL)";"AL";"UNIAO DOS PALMARES";620;141;107;868
2003;"VICOSA (AL)";"AL";"VICOSA";202;33;30;265
2003;"ALVARAES (AM)";"AM";"ALVARAES";0;0;1;1
2003;"AMATURA (AM)";"AM";"AMATURA";0;0;0;0
2003;"ANAMA (AM)";"AM";"ANAMA";0;0;0;0
2003;"ANORI (AM)";"AM";"ANORI";1;0;0;1
2003;"APUI (AM)";"AM";"APUI";15;0;1;16
2003;"ATALAIA DO NORTE (AM)";"AM";"ATALAIA DO NORTE";1;0;0;1
2003;"AUTAZES (AM)";"AM";"AUTAZES";3;0;0;3
2003;"BARCELOS (AM)";"AM";"BARCELOS";4;0;0;4
2003;"BARREIRINHA (AM)";"AM";"BARREIRINHA";0;0;0;0
2003;"BENJAMIN CONSTANT (AM)";"AM";"BENJAMIN CONSTANT";0;1;0;1
2003;"BERURI (AM)";"AM";"BERURI";0;0;0;0
2003;"BOA VISTA DO RAMOS (AM)";"AM";"BOA VISTA DO RAMOS";1;0;0;1
2003;"BOCA DO ACRE (AM)";"AM";"BOCA DO ACRE";14;2;1;17
2003;"BORBA (AM)";"AM";"BORBA";2;0;0;2
2003;"CAAPIRANGA (AM)";"AM";"CAAPIRANGA";4;1;0;5
2003;"CANUTAMA (AM)";"AM";"CANUTAMA";0;0;0;0
2003;"CARAUARI (AM)";"AM";"CARAUARI";6;1;0;7
2003;"CAREIRO (AM)";"AM";"CAREIRO";13;2;21;36
2003;"CAREIRO DA VARZEA (AM)";"AM";"CAREIRO DA VARZEA";4;2;2;8
2003;"COARI (AM)";"AM";"COARI";27;1;1;29
2003;"CODAJAS (AM)";"AM";"CODAJAS";2;0;0;2
2003;"EIRUNEPE (AM)";"AM";"EIRUNEPE";8;0;0;8
2003;"ENVIRA (AM)";"AM";"ENVIRA";3;0;1;4
2003;"FONTE BOA (AM)";"AM";"FONTE BOA";9;0;0;9
2003;"GUAJARA (AM)";"AM";"GUAJARA";0;0;0;0
2003;"HUMAITA (AM)";"AM";"HUMAITA";49;0;6;55
2003;"IPIXUNA (AM)";"AM";"IPIXUNA";1;0;0;1
2003;"IRANDUBA (AM)";"AM";"IRANDUBA";53;2;11;66
2003;"ITACOATIARA (AM)";"AM";"ITACOATIARA";189;14;36;239
2003;"ITAMARATI (AM)";"AM";"ITAMARATI";2;0;0;2
2003;"ITAPIRANGA (AM)";"AM";"ITAPIRANGA";1;0;0;1
2003;"JAPURA (AM)";"AM";"JAPURA";2;0;0;2
2003;"JURUA (AM)";"AM";"JURUA";3;0;0;3
2003;"JUTAI (AM)";"AM";"JUTAI";0;0;0;0
2003;"LABREA (AM)";"AM";"LABREA";8;0;1;9
2003;"MANACAPURU (AM)";"AM";"MANACAPURU";101;6;39;146
2003;"MANAQUIRI (AM)";"AM";"MANAQUIRI";1;0;0;1
2003;"MANAUS (AM)";"AM";"MANAUS";9067;1081;3367;13515
2003;"MANICORE (AM)";"AM";"MANICORE";5;1;0;6
2003;"MARAA (AM)";"AM";"MARAA";0;0;0;0
2003;"MAUES (AM)";"AM";"MAUES";18;0;2;20
2003;"NHAMUNDA (AM)";"AM";"NHAMUNDA";2;0;0;2
2003;"NOVA OLINDA DO NORTE (AM)";"AM";"NOVA OLINDA DO NORTE";3;0;2;5
2003;"NOVO AIRAO (AM)";"AM";"NOVO AIRAO";8;0;1;9
2003;"NOVO ARIPUANA (AM)";"AM";"NOVO ARIPUANA";4;0;4;8
2003;"PARINTINS (AM)";"AM";"PARINTINS";71;2;3;76
2003;"PAUINI (AM)";"AM";"PAUINI";4;1;0;5
2003;"PRESIDENTE FIGUEIREDO (AM)";"AM";"PRESIDENTE FIGUEIREDO";106;14;26;146
2003;"RIO PRETO DA EVA (AM)";"AM";"RIO PRETO DA EVA";30;2;10;42
2003;"SANTA ISABEL DO RIO NEGRO (AM)";"AM";"SANTA ISABEL DO RIO NEGRO";6;2;1;9
2003;"SANTO ANTONIO DO ICA (AM)";"AM";"SANTO ANTONIO DO ICA";3;0;0;3
2003;"SAO GABRIEL DA CACHOEIRA (AM)";"AM";"SAO GABRIEL DA CACHOEIRA";55;6;4;65
2003;"SAO PAULO DE OLIVENCA (AM)";"AM";"SAO PAULO DE OLIVENCA";1;0;0;1
2003;"SAO SEBASTIAO DO UATUMA (AM)";"AM";"SAO SEBASTIAO DO UATUMA";1;0;0;1
2003;"SILVES (AM)";"AM";"SILVES";5;2;1;8
2003;"TABATINGA (AM)";"AM";"TABATINGA";25;2;1;28
2003;"TAPAUA (AM)";"AM";"TAPAUA";1;0;1;2
2003;"TEFE (AM)";"AM";"TEFE";24;0;0;24
2003;"TONANTINS (AM)";"AM";"TONANTINS";0;0;0;0
2003;"UARINI (AM)";"AM";"UARINI";0;0;0;0
2003;"URUCARA (AM)";"AM";"URUCARA";3;0;1;4
2003;"URUCURITUBA (AM)";"AM";"URUCURITUBA";2;0;0;2
2003;"AMAPA (AP)";"AP";"AMAPA";4;1;0;5
2003;"CALCOENE (AP)";"AP";"CALCOENE";0;0;0;0
2003;"CUTIAS (AP)";"AP";"CUTIAS";1;0;0;1
2003;"FERREIRA GOMES (AP)";"AP";"FERREIRA GOMES";0;0;0;0
2003;"ITAUBAL (AP)";"AP";"ITAUBAL";0;0;2;2
2003;"LARANJAL DO JARI (AP)";"AP";"LARANJAL DO JARI";29;4;6;39
2003;"MACAPA (AP)";"AP";"MACAPA";1549;106;354;2009
2003;"MAZAGAO (AP)";"AP";"MAZAGAO";6;1;1;8
2003;"OIAPOQUE (AP)";"AP";"OIAPOQUE";22;1;1;24
2003;"PORTO GRANDE (AP)";"AP";"PORTO GRANDE";15;0;1;16
2003;"PRACUUBA (AP)";"AP";"PRACUUBA";0;0;0;0
2003;"SANTANA (AP)";"AP";"SANTANA";372;21;31;424
2003;"SERRA DO NAVIO (AP)";"AP";"SERRA DO NAVIO";0;0;0;0
2003;"TARTARUGALZINHO (AP)";"AP";"TARTARUGALZINHO";4;0;0;4
2003;"VITORIA DO JARI (AP)";"AP";"VITORIA DO JARI";0;0;1;1
2003;"ABAIRA (BA)";"BA";"ABAIRA";26;5;10;41
2003;"ABARE (BA)";"BA";"ABARE";12;2;8;22
2003;"ACAJUTIBA (BA)";"BA";"ACAJUTIBA";26;3;3;32
2003;"ADUSTINA (BA)";"BA";"ADUSTINA";12;5;1;18
2003;"AGUA FRIA (BA)";"BA";"AGUA FRIA";9;5;7;21
2003;"AIQUARA (BA)";"BA";"AIQUARA";5;1;0;6
2003;"ALAGOINHAS (BA)";"BA";"ALAGOINHAS";712;88;221;1021
2003;"ALCOBACA (BA)";"BA";"ALCOBACA";16;1;6;23
2003;"ALMADINA (BA)";"BA";"ALMADINA";7;1;1;9
2003;"AMARGOSA (BA)";"BA";"AMARGOSA";145;7;27;179
2003;"AMELIA RODRIGUES (BA)";"BA";"AMELIA RODRIGUES";115;21;14;150
2003;"AMERICA DOURADA (BA)";"BA";"AMERICA DOURADA";10;3;2;15
2003;"ANAGE (BA)";"BA";"ANAGE";37;8;16;61
2003;"ANDARAI (BA)";"BA";"ANDARAI";14;1;3;18
2003;"ANDORINHA (BA)";"BA";"ANDORINHA";31;2;16;49
2003;"ANGICAL (BA)";"BA";"ANGICAL";6;7;2;15
2003;"ANGUERA (BA)";"BA";"ANGUERA";10;5;5;20
2003;"ANTAS (BA)";"BA";"ANTAS";17;3;5;25
2003;"ANTONIO CARDOSO (BA)";"BA";"ANTONIO CARDOSO";0;11;8;19
2003;"ANTONIO GONCALVES (BA)";"BA";"ANTONIO GONCALVES";13;2;3;18
2003;"APORA (BA)";"BA";"APORA";15;5;7;27
2003;"APUAREMA (BA)";"BA";"APUAREMA";16;0;4;20
2003;"ARACAS (BA)";"BA";"ARACAS";25;11;9;45
2003;"ARACATU (BA)";"BA";"ARACATU";41;3;9;53
2003;"ARACI (BA)";"BA";"ARACI";88;4;25;117
2003;"ARAMARI (BA)";"BA";"ARAMARI";8;1;2;11
2003;"ARATACA (BA)";"BA";"ARATACA";9;0;2;11
2003;"ARATUIPE (BA)";"BA";"ARATUIPE";10;0;5;15
2003;"AURELINO LEAL (BA)";"BA";"AURELINO LEAL";32;3;4;39
2003;"BAIANOPOLIS (BA)";"BA";"BAIANOPOLIS";23;3;4;30
2003;"BAIXA GRANDE (BA)";"BA";"BAIXA GRANDE";34;5;11;50
2003;"BANZAE (BA)";"BA";"BANZAE";12;2;16;30
2003;"BARRA (BA)";"BA";"BARRA";17;3;6;26
2003;"BARRA DA ESTIVA (BA)";"BA";"BARRA DA ESTIVA";83;6;14;103
2003;"BARRA DO CHOCA (BA)";"BA";"BARRA DO CHOCA";56;26;8;90
2003;"BARRA DO MENDES (BA)";"BA";"BARRA DO MENDES";25;3;2;30
2003;"BARRA DO ROCHA (BA)";"BA";"BARRA DO ROCHA";5;1;0;6
2003;"BARREIRAS (BA)";"BA";"BARREIRAS";1396;40;164;1600
2003;"BARRO ALTO (BA)";"BA";"BARRO ALTO";27;1;5;33
2003;"BARRO PRETO (BA)";"BA";"BARRO PRETO";13;1;5;19
2003;"BARROCAS (BA)";"BA";"BARROCAS";45;1;3;49
2003;"BELMONTE (BA)";"BA";"BELMONTE";23;0;2;25
2003;"BELO CAMPO (BA)";"BA";"BELO CAMPO";45;7;9;61
2003;"BIRITINGA (BA)";"BA";"BIRITINGA";10;6;15;31
2003;"BOA NOVA (BA)";"BA";"BOA NOVA";12;6;9;27
2003;"BOA VISTA DO TUPIM (BA)";"BA";"BOA VISTA DO TUPIM";33;1;5;39
2003;"BOM JESUS DA LAPA (BA)";"BA";"BOM JESUS DA LAPA";237;18;45;300
2003;"BOM JESUS DA SERRA (BA)";"BA";"BOM JESUS DA SERRA";8;14;9;31
2003;"BONINAL (BA)";"BA";"BONINAL";43;5;10;58
2003;"BONITO (BA)";"BA";"BONITO";21;0;3;24
2003;"BOQUIRA (BA)";"BA";"BOQUIRA";55;6;26;87
2003;"BOTUPORA (BA)";"BA";"BOTUPORA";15;2;10;27
2003;"BREJOES (BA)";"BA";"BREJOES";54;1;8;63
2003;"BREJOLANDIA (BA)";"BA";"BREJOLANDIA";15;2;4;21
2003;"BROTAS DE MACAUBAS (BA)";"BA";"BROTAS DE MACAUBAS";10;5;5;20
2003;"BRUMADO (BA)";"BA";"BRUMADO";683;56;111;850
2003;"BUERAREMA (BA)";"BA";"BUERAREMA";71;2;8;81
2003;"BURITIRAMA (BA)";"BA";"BURITIRAMA";5;1;6;12
2003;"CAATIBA (BA)";"BA";"CAATIBA";3;0;0;3
2003;"CABACEIRAS DO PARAGUACU (BA)";"BA";"CABACEIRAS DO PARAGUACU";26;3;9;38
2003;"CACHOEIRA (BA)";"BA";"CACHOEIRA";56;28;43;127
2003;"CACULE (BA)";"BA";"CACULE";171;9;10;190
2003;"CAEM (BA)";"BA";"CAEM";11;3;6;20
2003;"CAETANOS (BA)";"BA";"CAETANOS";8;2;1;11
2003;"CAETITE (BA)";"BA";"CAETITE";304;19;35;358
2003;"CAFARNAUM (BA)";"BA";"CAFARNAUM";21;0;5;26
2003;"CAIRU (BA)";"BA";"CAIRU";4;0;1;5
2003;"CALDEIRAO GRANDE (BA)";"BA";"CALDEIRAO GRANDE";15;1;6;22
2003;"CAMACAN (BA)";"BA";"CAMACAN";141;4;28;173
2003;"CAMACARI (BA)";"BA";"CAMACARI";900;188;316;1404
2003;"CAMAMU (BA)";"BA";"CAMAMU";54;8;8;70
2003;"CAMPO ALEGRE DE LOURDES (BA)";"BA";"CAMPO ALEGRE DE LOURDES";21;3;0;24
2003;"CAMPO FORMOSO (BA)";"BA";"CAMPO FORMOSO";109;9;47;165
2003;"CANAPOLIS (BA)";"BA";"CANAPOLIS";5;4;6;15
2003;"CANARANA (BA)";"BA";"CANARANA";77;3;4;84
2003;"CANAVIEIRAS (BA)";"BA";"CANAVIEIRAS";45;5;3;53
2003;"CANDEAL (BA)";"BA";"CANDEAL";16;6;2;24
2003;"CANDEIAS (BA)";"BA";"CANDEIAS";383;105;159;647
2003;"CANDIBA (BA)";"BA";"CANDIBA";33;1;6;40
2003;"CANDIDO SALES (BA)";"BA";"CANDIDO SALES";187;13;14;214
2003;"CANSANCAO (BA)";"BA";"CANSANCAO";75;4;12;91
2003;"CANUDOS (BA)";"BA";"CANUDOS";20;6;12;38
2003;"CAPELA DO ALTO ALEGRE (BA)";"BA";"CAPELA DO ALTO ALEGRE";37;4;14;55
2003;"CAPIM GROSSO (BA)";"BA";"CAPIM GROSSO";279;15;17;311
2003;"CARAIBAS (BA)";"BA";"CARAIBAS";19;7;8;34
2003;"CARAVELAS (BA)";"BA";"CARAVELAS";13;4;27;44
2003;"CARDEAL DA SILVA (BA)";"BA";"CARDEAL DA SILVA";10;3;2;15
2003;"CARINHANHA (BA)";"BA";"CARINHANHA";60;4;10;74
2003;"CASA NOVA (BA)";"BA";"CASA NOVA";139;71;44;254
2003;"CASTRO ALVES (BA)";"BA";"CASTRO ALVES";82;3;26;111
2003;"CATOLANDIA (BA)";"BA";"CATOLANDIA";3;2;2;7
2003;"CATU (BA)";"BA";"CATU";239;45;55;339
2003;"CATURAMA (BA)";"BA";"CATURAMA";5;0;5;10
2003;"CENTRAL (BA)";"BA";"CENTRAL";48;1;3;52
2003;"CHORROCHO (BA)";"BA";"CHORROCHO";3;0;3;6
2003;"CICERO DANTAS (BA)";"BA";"CICERO DANTAS";60;7;19;86
2003;"CIPO (BA)";"BA";"CIPO";31;3;0;34
2003;"COARACI (BA)";"BA";"COARACI";70;3;12;85
2003;"COCOS (BA)";"BA";"COCOS";35;2;11;48
2003;"CONCEICAO DA FEIRA (BA)";"BA";"CONCEICAO DA FEIRA";97;31;10;138
2003;"CONCEICAO DO ALMEIDA (BA)";"BA";"CONCEICAO DO ALMEIDA";52;14;7;73
2003;"CONCEICAO DO COITE (BA)";"BA";"CONCEICAO DO COITE";278;39;26;343
2003;"CONCEICAO DO JACUIPE (BA)";"BA";"CONCEICAO DO JACUIPE";118;69;8;195
2003;"CONDE (BA)";"BA";"CONDE";20;4;0;24
2003;"CONDEUBA (BA)";"BA";"CONDEUBA";71;13;23;107
2003;"CONTENDAS DO SINCORA (BA)";"BA";"CONTENDAS DO SINCORA";1;3;0;4
2003;"CORACAO DE MARIA (BA)";"BA";"CORACAO DE MARIA";64;18;23;105
2003;"CORDEIROS (BA)";"BA";"CORDEIROS";15;8;7;30
2003;"CORIBE (BA)";"BA";"CORIBE";20;7;7;34
2003;"CORONEL JOAO SA (BA)";"BA";"CORONEL JOAO SA";26;0;9;35
2003;"CORRENTINA (BA)";"BA";"CORRENTINA";71;3;25;99
2003;"COTEGIPE (BA)";"BA";"COTEGIPE";12;4;2;18
2003;"CRAVOLANDIA (BA)";"BA";"CRAVOLANDIA";12;2;1;15
2003;"CRISOPOLIS (BA)";"BA";"CRISOPOLIS";37;3;13;53
2003;"CRISTOPOLIS (BA)";"BA";"CRISTOPOLIS";33;1;4;38
2003;"CRUZ DAS ALMAS (BA)";"BA";"CRUZ DAS ALMAS";489;66;35;590
2003;"CURACA (BA)";"BA";"CURACA";24;17;14;55
2003;"DARIO MEIRA (BA)";"BA";"DARIO MEIRA";10;2;2;14
2003;"DIAS D AVILA (BA)";"BA";"DIAS D AVILA";274;35;179;488
2003;"DOM BASILIO (BA)";"BA";"DOM BASILIO";122;2;8;132
2003;"DOM MACEDO COSTA (BA)";"BA";"DOM MACEDO COSTA";10;5;2;17
2003;"ELISIO MEDRADO (BA)";"BA";"ELISIO MEDRADO";15;3;9;27
2003;"ENCRUZILHADA (BA)";"BA";"ENCRUZILHADA";31;9;4;44
2003;"ENTRE RIOS (BA)";"BA";"ENTRE RIOS";94;22;22;138
2003;"ERICO CARDOSO (BA)";"BA";"ERICO CARDOSO";12;1;2;15
2003;"ESPLANADA (BA)";"BA";"ESPLANADA";59;12;16;87
2003;"EUCLIDES DA CUNHA (BA)";"BA";"EUCLIDES DA CUNHA";171;8;73;252
2003;"EUNAPOLIS (BA)";"BA";"EUNAPOLIS";883;28;192;1103
2003;"FATIMA (BA)";"BA";"FATIMA";3;4;4;11
2003;"FEIRA DA MATA (BA)";"BA";"FEIRA DA MATA";6;0;3;9
2003;"FEIRA DE SANTANA (BA)";"BA";"FEIRA DE SANTANA";4749;468;708;5925
2003;"FILADELFIA (BA)";"BA";"FILADELFIA";44;3;8;55
2003;"FIRMINO ALVES (BA)";"BA";"FIRMINO ALVES";6;1;0;7
2003;"FLORESTA AZUL (BA)";"BA";"FLORESTA AZUL";11;1;0;12
2003;"FORMOSA DO RIO PRETO (BA)";"BA";"FORMOSA DO RIO PRETO";22;0;4;26
2003;"GANDU (BA)";"BA";"GANDU";193;5;13;211
2003;"GAVIAO (BA)";"BA";"GAVIAO";16;4;1;21
2003;"GENTIO DO OURO (BA)";"BA";"GENTIO DO OURO";11;1;1;13
2003;"GLORIA (BA)";"BA";"GLORIA";34;9;20;63
2003;"GONGOGI (BA)";"BA";"GONGOGI";6;0;1;7
2003;"GOVERNADOR MANGABEIRA (BA)";"BA";"GOVERNADOR MANGABEIRA";121;15;22;158
2003;"GUAJERU (BA)";"BA";"GUAJERU";4;5;1;10
2003;"GUANAMBI (BA)";"BA";"GUANAMBI";775;35;93;903
2003;"GUARATINGA (BA)";"BA";"GUARATINGA";47;4;13;64
2003;"HELIOPOLIS (BA)";"BA";"HELIOPOLIS";18;0;1;19
2003;"IACU (BA)";"BA";"IACU";76;4;4;84
2003;"IBIASSUCE (BA)";"BA";"IBIASSUCE";39;6;2;47
2003;"IBICARAI (BA)";"BA";"IBICARAI";87;8;7;102
2003;"IBICOARA (BA)";"BA";"IBICOARA";69;5;14;88
2003;"IBICUI (BA)";"BA";"IBICUI";27;5;3;35
2003;"IBIPEBA (BA)";"BA";"IBIPEBA";19;3;3;25
2003;"IBIPITANGA (BA)";"BA";"IBIPITANGA";35;4;18;57
2003;"IBIQUERA (BA)";"BA";"IBIQUERA";4;0;0;4
2003;"IBIRAPITANGA (BA)";"BA";"IBIRAPITANGA";30;1;3;34
2003;"IBIRAPUA (BA)";"BA";"IBIRAPUA";3;1;1;5
2003;"IBIRATAIA (BA)";"BA";"IBIRATAIA";54;11;3;68
2003;"IBITIARA (BA)";"BA";"IBITIARA";50;5;12;67
2003;"IBITITA (BA)";"BA";"IBITITA";24;0;5;29
2003;"IBOTIRAMA (BA)";"BA";"IBOTIRAMA";116;16;9;141
2003;"ICHU (BA)";"BA";"ICHU";11;2;2;15
2003;"IGAPORA (BA)";"BA";"IGAPORA";69;6;8;83
2003;"IGRAPIUNA (BA)";"BA";"IGRAPIUNA";17;1;7;25
2003;"IGUAI (BA)";"BA";"IGUAI";32;7;14;53
2003;"ILHEUS (BA)";"BA";"ILHEUS";390;75;196;661
2003;"INHAMBUPE (BA)";"BA";"INHAMBUPE";80;25;26;131
2003;"IPECAETA (BA)";"BA";"IPECAETA";8;1;18;27
2003;"IPIAU (BA)";"BA";"IPIAU";271;18;12;301
2003;"IPIRA (BA)";"BA";"IPIRA";234;13;44;291
2003;"IPUPIARA (BA)";"BA";"IPUPIARA";14;3;0;17
2003;"IRAJUBA (BA)";"BA";"IRAJUBA";10;1;8;19
2003;"IRAMAIA (BA)";"BA";"IRAMAIA";18;1;5;24
2003;"IRAQUARA (BA)";"BA";"IRAQUARA";65;9;8;82
2003;"IRARA (BA)";"BA";"IRARA";61;15;18;94
2003;"IRECE (BA)";"BA";"IRECE";461;20;31;512
2003;"ITABELA (BA)";"BA";"ITABELA";163;3;34;200
2003;"ITABERABA (BA)";"BA";"ITABERABA";271;22;19;312
2003;"ITABUNA (BA)";"BA";"ITABUNA";1195;45;509;1749
2003;"ITACARE (BA)";"BA";"ITACARE";3;5;1;9
2003;"ITAETE (BA)";"BA";"ITAETE";43;0;8;51
2003;"ITAGI (BA)";"BA";"ITAGI";15;1;2;18
2003;"ITAGIBA (BA)";"BA";"ITAGIBA";12;4;3;19
2003;"ITAGIMIRIM (BA)";"BA";"ITAGIMIRIM";33;0;3;36
2003;"ITAGUACU DA BAHIA (BA)";"BA";"ITAGUACU DA BAHIA";8;0;6;14
2003;"ITAJU DO COLONIA (BA)";"BA";"ITAJU DO COLONIA";7;0;4;11
2003;"ITAJUIPE (BA)";"BA";"ITAJUIPE";56;1;7;64
2003;"ITAMARAJU (BA)";"BA";"ITAMARAJU";296;7;75;378
2003;"ITAMARI (BA)";"BA";"ITAMARI";29;0;0;29
2003;"ITAMBE (BA)";"BA";"ITAMBE";35;6;5;46
2003;"ITANAGRA (BA)";"BA";"ITANAGRA";7;0;0;7
2003;"ITANHEM (BA)";"BA";"ITANHEM";17;1;9;27
2003;"ITAPARICA (BA)";"BA";"ITAPARICA";18;24;15;57
2003;"ITAPE (BA)";"BA";"ITAPE";15;0;0;15
2003;"ITAPEBI (BA)";"BA";"ITAPEBI";38;0;2;40
2003;"ITAPETINGA (BA)";"BA";"ITAPETINGA";372;22;55;449
2003;"ITAPICURU (BA)";"BA";"ITAPICURU";13;9;13;35
2003;"ITAPITANGA (BA)";"BA";"ITAPITANGA";5;1;0;6
2003;"ITAQUARA (BA)";"BA";"ITAQUARA";12;1;0;13
2003;"ITARANTIM (BA)";"BA";"ITARANTIM";44;1;2;47
2003;"ITATIM (BA)";"BA";"ITATIM";68;2;15;85
2003;"ITIRUCU (BA)";"BA";"ITIRUCU";98;2;6;106
2003;"ITIUBA (BA)";"BA";"ITIUBA";40;6;23;69
2003;"ITORORO (BA)";"BA";"ITORORO";53;6;9;68
2003;"ITUACU (BA)";"BA";"ITUACU";76;3;5;84
2003;"ITUBERA (BA)";"BA";"ITUBERA";79;6;18;103
2003;"IUIU (BA)";"BA";"IUIU";10;2;0;12
2003;"JABORANDI (BA)";"BA";"JABORANDI";24;1;13;38
2003;"JACARACI (BA)";"BA";"JACARACI";20;7;9;36
2003;"JACOBINA (BA)";"BA";"JACOBINA";505;30;73;608
2003;"JAGUAQUARA (BA)";"BA";"JAGUAQUARA";327;4;29;360
2003;"JAGUARARI (BA)";"BA";"JAGUARARI";88;13;31;132
2003;"JAGUARIPE (BA)";"BA";"JAGUARIPE";14;3;9;26
2003;"JANDAIRA (BA)";"BA";"JANDAIRA";11;2;1;14
2003;"JEQUIE (BA)";"BA";"JEQUIE";1030;34;221;1285
2003;"JEREMOABO (BA)";"BA";"JEREMOABO";72;8;14;94
2003;"JIQUIRICA (BA)";"BA";"JIQUIRICA";33;3;7;43
2003;"JITAUNA (BA)";"BA";"JITAUNA";28;5;3;36
2003;"JOAO DOURADO (BA)";"BA";"JOAO DOURADO";48;0;10;58
2003;"JUAZEIRO (BA)";"BA";"JUAZEIRO";1733;234;356;2323
2003;"JUCURUCU (BA)";"BA";"JUCURUCU";8;1;1;10
2003;"JUSSARA (BA)";"BA";"JUSSARA";20;1;7;28
2003;"JUSSARI (BA)";"BA";"JUSSARI";11;0;0;11
2003;"JUSSIAPE (BA)";"BA";"JUSSIAPE";30;4;2;36
2003;"LAFAIETE COUTINHO (BA)";"BA";"LAFAIETE COUTINHO";6;0;2;8
2003;"LAGEDO DO TABOCAL (BA)";"BA";"LAGEDO DO TABOCAL";17;0;4;21
2003;"LAGOA REAL (BA)";"BA";"LAGOA REAL";13;4;9;26
2003;"LAJE (BA)";"BA";"LAJE";82;2;16;100
2003;"LAJEDAO (BA)";"BA";"LAJEDAO";7;0;4;11
2003;"LAJEDINHO (BA)";"BA";"LAJEDINHO";8;0;0;8
2003;"LAMARAO (BA)";"BA";"LAMARAO";2;1;1;4
2003;"LAPAO (BA)";"BA";"LAPAO";56;6;12;74
2003;"LAURO DE FREITAS (BA)";"BA";"LAURO DE FREITAS";1234;229;145;1608
2003;"LENCOIS (BA)";"BA";"LENCOIS";7;8;0;15
2003;"LICINIO DE ALMEIDA (BA)";"BA";"LICINIO DE ALMEIDA";75;4;8;87
2003;"LIVRAMENTO DO BRUMADO (BA)";"BA";"LIVRAMENTO DO BRUMADO";184;21;26;231
2003;"LUIZ EDUARDO MAGALHAES (BA)";"BA";"LUIZ EDUARDO MAGALHAES";255;11;16;282
2003;"MACAJUBA (BA)";"BA";"MACAJUBA";7;4;14;25
2003;"MACAUBAS (BA)";"BA";"MACAUBAS";128;10;158;296
2003;"MACURURE (BA)";"BA";"MACURURE";5;2;2;9
2003;"MADRE DE DEUS (BA)";"BA";"MADRE DE DEUS";45;4;21;70
2003;"MAETINGA (BA)";"BA";"MAETINGA";13;1;6;20
2003;"MAIQUINIQUE (BA)";"BA";"MAIQUINIQUE";25;2;3;30
2003;"MAIRI (BA)";"BA";"MAIRI";42;4;15;61
2003;"MALHADA (BA)";"BA";"MALHADA";11;3;4;18
2003;"MALHADA DAS PEDRAS (BA)";"BA";"MALHADA DAS PEDRAS";36;8;7;51
2003;"MANOEL VITORINO (BA)";"BA";"MANOEL VITORINO";26;0;2;28
2003;"MANSIDAO (BA)";"BA";"MANSIDAO";2;0;0;2
2003;"MARACANI (BA)";"BA";"MARACANI";36;2;6;44
2003;"MARACAS (BA)";"BA";"MARACAS";144;3;24;171
2003;"MARAGOGIPE (BA)";"BA";"MARAGOGIPE";97;3;12;112
2003;"MARAU (BA)";"BA";"MARAU";3;0;0;3
2003;"MARCIONILIO SOUZA (BA)";"BA";"MARCIONILIO SOUZA";15;3;6;24
2003;"MASCOTE (BA)";"BA";"MASCOTE";16;1;2;19
2003;"MATA DE SAO JOAO (BA)";"BA";"MATA DE SAO JOAO";102;11;20;133
2003;"MATINA (BA)";"BA";"MATINA";10;0;2;12
2003;"MEDEIROS NETO (BA)";"BA";"MEDEIROS NETO";44;0;11;55
2003;"MIGUEL CALMON (BA)";"BA";"MIGUEL CALMON";65;1;18;84
2003;"MILAGRES (BA)";"BA";"MILAGRES";105;5;9;119
2003;"MIRANGABA (BA)";"BA";"MIRANGABA";21;6;13;40
2003;"MIRANTE (BA)";"BA";"MIRANTE";13;6;9;28
2003;"MONTE SANTO (BA)";"BA";"MONTE SANTO";59;7;40;106
2003;"MORPARA (BA)";"BA";"MORPARA";3;1;0;4
2003;"MORRO DO CHAPEU (BA)";"BA";"MORRO DO CHAPEU";68;8;13;89
2003;"MORTUGABA (BA)";"BA";"MORTUGABA";21;3;4;28
2003;"MUCUGE (BA)";"BA";"MUCUGE";39;2;6;47
2003;"MUCURI (BA)";"BA";"MUCURI";44;5;9;58
2003;"MULUNGU DO MORRO (BA)";"BA";"MULUNGU DO MORRO";18;0;0;18
2003;"MUNDO NOVO (BA)";"BA";"MUNDO NOVO";43;4;17;64
2003;"MUNIZ FERREIRA (BA)";"BA";"MUNIZ FERREIRA";38;18;4;60
2003;"MUQUEM DO SAO FRANCISCO (BA)";"BA";"MUQUEM DO SAO FRANCISCO";6;5;6;17
2003;"MURITIBA (BA)";"BA";"MURITIBA";313;13;10;336
2003;"MUTUIPE (BA)";"BA";"MUTUIPE";79;12;20;111
2003;"NAZARE (BA)";"BA";"NAZARE";146;22;11;179
2003;"NILO PECANHA (BA)";"BA";"NILO PECANHA";18;2;5;25
2003;"NORDESTINA (BA)";"BA";"NORDESTINA";14;2;8;24
2003;"NOVA CANAA (BA)";"BA";"NOVA CANAA";25;1;3;29
2003;"NOVA FATIMA (BA)";"BA";"NOVA FATIMA";29;0;3;32
2003;"NOVA IBIA (BA)";"BA";"NOVA IBIA";15;0;1;16
2003;"NOVA ITARANA (BA)";"BA";"NOVA ITARANA";15;3;1;19
2003;"NOVA REDENCAO (BA)";"BA";"NOVA REDENCAO";8;5;1;14
2003;"NOVA SOURE (BA)";"BA";"NOVA SOURE";26;1;11;38
2003;"NOVA VICOSA (BA)";"BA";"NOVA VICOSA";51;3;28;82
2003;"NOVO HORIZONTE (BA)";"BA";"NOVO HORIZONTE";13;1;5;19
2003;"NOVO TRIUNFO (BA)";"BA";"NOVO TRIUNFO";3;1;1;5
2003;"OLINDINA (BA)";"BA";"OLINDINA";67;13;22;102
2003;"OLIVEIRA DOS BREJINHOS (BA)";"BA";"OLIVEIRA DOS BREJINHOS";31;3;3;37
2003;"OURICANGAS (BA)";"BA";"OURICANGAS";14;2;6;22
2003;"OUROLANDIA (BA)";"BA";"OUROLANDIA";15;4;1;20
2003;"PALMAS DE MONTE ALTO (BA)";"BA";"PALMAS DE MONTE ALTO";25;2;4;31
2003;"PALMEIRAS (BA)";"BA";"PALMEIRAS";21;5;1;27
2003;"PARAMIRIM (BA)";"BA";"PARAMIRIM";87;1;32;120
2003;"PARATINGA (BA)";"BA";"PARATINGA";20;11;25;56
2003;"PARIPIRANGA (BA)";"BA";"PARIPIRANGA";64;5;17;86
2003;"PAU BRASIL (BA)";"BA";"PAU BRASIL";23;2;0;25
2003;"PAULO AFONSO (BA)";"BA";"PAULO AFONSO";589;124;171;884
2003;"PE DE SERRA (BA)";"BA";"PE DE SERRA";14;0;8;22
2003;"PEDRAO (BA)";"BA";"PEDRAO";11;5;1;17
2003;"PEDRO ALEXANDRE (BA)";"BA";"PEDRO ALEXANDRE";1;1;1;3
2003;"PIATA (BA)";"BA";"PIATA";55;8;9;72
2003;"PILAO ARCADO (BA)";"BA";"PILAO ARCADO";26;8;3;37
2003;"PINDAI (BA)";"BA";"PINDAI";16;6;10;32
2003;"PINDOBACU (BA)";"BA";"PINDOBACU";23;10;12;45
2003;"PINTADAS (BA)";"BA";"PINTADAS";27;7;17;51
2003;"PIRAI DO NORTE (BA)";"BA";"PIRAI DO NORTE";2;1;0;3
2003;"PIRIPA (BA)";"BA";"PIRIPA";32;9;8;49
2003;"PIRITIBA (BA)";"BA";"PIRITIBA";36;4;11;51
2003;"PLANALTINO (BA)";"BA";"PLANALTINO";11;1;5;17
2003;"PLANALTO (BA)";"BA";"PLANALTO";60;6;29;95
2003;"POCOES (BA)";"BA";"POCOES";214;46;33;293
2003;"POJUCA (BA)";"BA";"POJUCA";202;30;39;271
2003;"PONTO NOVO (BA)";"BA";"PONTO NOVO";22;1;6;29
2003;"PORTO SEGURO (BA)";"BA";"PORTO SEGURO";305;63;268;636
2003;"POTIRIGUA (BA)";"BA";"POTIRIGUA";10;2;2;14
2003;"PRADO (BA)";"BA";"PRADO";33;8;10;51
2003;"PRESIDENTE DUTRA (BA)";"BA";"PRESIDENTE DUTRA";24;3;2;29
2003;"PRESIDENTE JANIO QUADROS (BA)";"BA";"PRESIDENTE JANIO QUADROS";11;8;2;21
2003;"PRESIDENTE TANCREDO NEVES (BA)";"BA";"PRESIDENTE TANCREDO NEVES";31;6;4;41
2003;"QUEIMADAS (BA)";"BA";"QUEIMADAS";61;4;63;128
2003;"QUIJINGUE (BA)";"BA";"QUIJINGUE";28;2;24;54
2003;"QUIXABEIRA (BA)";"BA";"QUIXABEIRA";12;2;6;20
2003;"RAFAEL JAMBEIRO (BA)";"BA";"RAFAEL JAMBEIRO";24;7;17;48
2003;"REMANSO (BA)";"BA";"REMANSO";107;14;11;132
2003;"RETIROLANDIA (BA)";"BA";"RETIROLANDIA";34;2;6;42
2003;"RIACHAO DAS NEVES (BA)";"BA";"RIACHAO DAS NEVES";20;4;4;28
2003;"RIACHAO DO JACUIPE (BA)";"BA";"RIACHAO DO JACUIPE";141;9;12;162
2003;"RIACHO DE SANTANA (BA)";"BA";"RIACHO DE SANTANA";116;7;23;146
2003;"RIBEIRA DO AMPARO (BA)";"BA";"RIBEIRA DO AMPARO";8;5;11;24
2003;"RIBEIRA DO POMBAL (BA)";"BA";"RIBEIRA DO POMBAL";183;16;46;245
2003;"RIBEIRAO DO LARGO (BA)";"BA";"RIBEIRAO DO LARGO";13;3;3;19
2003;"RIO DE CONTAS (BA)";"BA";"RIO DE CONTAS";52;7;8;67
2003;"RIO DO ANTONIO (BA)";"BA";"RIO DO ANTONIO";32;5;1;38
2003;"RIO DO PIRES (BA)";"BA";"RIO DO PIRES";32;2;5;39
2003;"RIO REAL (BA)";"BA";"RIO REAL";106;5;20;131
2003;"RODELAS (BA)";"BA";"RODELAS";6;1;1;8
2003;"RUY BARBOSA (BA)";"BA";"RUY BARBOSA";62;6;20;88
2003;"SALINAS DA MARGARIDA (BA)";"BA";"SALINAS DA MARGARIDA";12;1;3;16
2003;"SALVADOR (BA)";"BA";"SALVADOR";10669;2780;5403;18852
2003;"SANTA BARBARA (BA)";"BA";"SANTA BARBARA";19;4;8;31
2003;"SANTA BRIGIDA (BA)";"BA";"SANTA BRIGIDA";5;6;4;15
2003;"SANTA CRUZ CABRALIA (BA)";"BA";"SANTA CRUZ CABRALIA";43;5;10;58
2003;"SANTA CRUZ DA VITORIA (BA)";"BA";"SANTA CRUZ DA VITORIA";8;1;1;10
2003;"SANTA INES (BA)";"BA";"SANTA INES";40;1;1;42
2003;"SANTA LUZIA (BA)";"BA";"SANTA LUZIA";20;1;2;23
2003;"SANTA MARIA DA VITORIA (BA)";"BA";"SANTA MARIA DA VITORIA";178;22;25;225
2003;"SANTA RITA DE CASSIA (BA)";"BA";"SANTA RITA DE CASSIA";29;1;3;33
2003;"SANTA TERESINHA (BA)";"BA";"SANTA TERESINHA";17;0;8;25
2003;"SANTALUZ (BA)";"BA";"SANTALUZ";108;6;11;125
2003;"SANTANA (BA)";"BA";"SANTANA";87;6;27;120
2003;"SANTANOPOLIS (BA)";"BA";"SANTANOPOLIS";9;2;4;15
2003;"SANTO AMARO (BA)";"BA";"SANTO AMARO";153;57;222;432
2003;"SANTO ANTONIO DE JESUS (BA)";"BA";"SANTO ANTONIO DE JESUS";1412;49;95;1556
2003;"SANTO ESTEVAO (BA)";"BA";"SANTO ESTEVAO";124;54;26;204
2003;"SAO DESIDERIO (BA)";"BA";"SAO DESIDERIO";72;6;12;90
2003;"SAO DOMINGOS (BA)";"BA";"SAO DOMINGOS";20;3;4;27
2003;"SAO FELIPE (BA)";"BA";"SAO FELIPE";113;11;16;140
2003;"SAO FELIX (BA)";"BA";"SAO FELIX";42;9;6;57
2003;"SAO FELIX DO CORIBE (BA)";"BA";"SAO FELIX DO CORIBE";60;6;12;78
2003;"SAO FRANCISCO DO CONDE (BA)";"BA";"SAO FRANCISCO DO CONDE";70;17;29;116
2003;"SAO GABRIEL (BA)";"BA";"SAO GABRIEL";14;2;3;19
2003;"SAO GONCALO DOS CAMPOS (BA)";"BA";"SAO GONCALO DOS CAMPOS";40;66;20;126
2003;"SAO JOSE DA VITORIA (BA)";"BA";"SAO JOSE DA VITORIA";7;0;1;8
2003;"SAO JOSE DO JACUIPE (BA)";"BA";"SAO JOSE DO JACUIPE";42;2;4;48
2003;"SAO MIGUEL DAS MATAS (BA)";"BA";"SAO MIGUEL DAS MATAS";21;2;2;25
2003;"SAO SEBASTIAO DO PASSE (BA)";"BA";"SAO SEBASTIAO DO PASSE";104;15;70;189
2003;"SAPEACU (BA)";"BA";"SAPEACU";42;12;14;68
2003;"SATIRO DIAS (BA)";"BA";"SATIRO DIAS";9;6;3;18
2003;"SAUBARA (BA)";"BA";"SAUBARA";9;5;1;15
2003;"SAUDE (BA)";"BA";"SAUDE";19;6;5;30
2003;"SEABRA (BA)";"BA";"SEABRA";192;28;44;264
2003;"SEBASTIAO LARANJEIRAS (BA)";"BA";"SEBASTIAO LARANJEIRAS";4;2;7;13
2003;"SENHOR DO BONFIM (BA)";"BA";"SENHOR DO BONFIM";408;35;126;569
2003;"SENTO SE (BA)";"BA";"SENTO SE";30;4;4;38
2003;"SERRA DO RAMALHO (BA)";"BA";"SERRA DO RAMALHO";32;17;10;59
2003;"SERRA DOURADA (BA)";"BA";"SERRA DOURADA";27;4;7;38
2003;"SERRA PRETA (BA)";"BA";"SERRA PRETA";21;10;20;51
2003;"SERRINHA (BA)";"BA";"SERRINHA";364;18;83;465
2003;"SERROLANDIA (BA)";"BA";"SERROLANDIA";28;12;9;49
2003;"SIMOES FILHO (BA)";"BA";"SIMOES FILHO";1038;175;317;1530
2003;"SITIO DO MATO (BA)";"BA";"SITIO DO MATO";13;4;7;24
2003;"SITIO DO QUINTO (BA)";"BA";"SITIO DO QUINTO";10;0;4;14
2003;"SOBRADINHO (BA)";"BA";"SOBRADINHO";54;7;10;71
2003;"SOUTO SOARES (BA)";"BA";"SOUTO SOARES";42;0;6;48
2003;"TABOCAS DO BREJO VELHO (BA)";"BA";"TABOCAS DO BREJO VELHO";7;1;6;14
2003;"TANHACU (BA)";"BA";"TANHACU";65;8;12;85
2003;"TANQUE NOVO (BA)";"BA";"TANQUE NOVO";114;4;12;130
2003;"TANQUINHO (BA)";"BA";"TANQUINHO";16;6;4;26
2003;"TAPEROA (BA)";"BA";"TAPEROA";61;17;5;83
2003;"TAPIRAMUTA (BA)";"BA";"TAPIRAMUTA";18;2;2;22
2003;"TEIXEIRA DE FREITAS (BA)";"BA";"TEIXEIRA DE FREITAS";703;34;150;887
2003;"TEODORO SAMPAIO (BA)";"BA";"TEODORO SAMPAIO";9;3;7;19
2003;"TEOFILANDIA (BA)";"BA";"TEOFILANDIA";64;3;12;79
2003;"TEOLANDIA (BA)";"BA";"TEOLANDIA";74;3;2;79
2003;"TERRA NOVA (BA)";"BA";"TERRA NOVA";3;2;9;14
2003;"TREMEDAL (BA)";"BA";"TREMEDAL";14;2;8;24
2003;"TUCANO (BA)";"BA";"TUCANO";158;14;44;216
2003;"UAUA (BA)";"BA";"UAUA";59;2;11;72
2003;"UBAIRA (BA)";"BA";"UBAIRA";54;4;21;79
2003;"UBAITABA (BA)";"BA";"UBAITABA";115;6;10;131
2003;"UBATA (BA)";"BA";"UBATA";150;7;3;160
2003;"UIBAI (BA)";"BA";"UIBAI";30;0;0;30
2003;"UMBURANAS (BA)";"BA";"UMBURANAS";3;2;2;7
2003;"UNA (BA)";"BA";"UNA";30;3;10;43
2003;"URANDI (BA)";"BA";"URANDI";60;1;7;68
2003;"URUCUCA (BA)";"BA";"URUCUCA";49;1;2;52
2003;"UTINGA (BA)";"BA";"UTINGA";29;5;1;35
2003;"VALENCA (BA)";"BA";"VALENCA";385;33;39;457
2003;"VALENTE (BA)";"BA";"VALENTE";87;4;11;102
2003;"VARZEA DA ROCA (BA)";"BA";"VARZEA DA ROCA";20;6;7;33
2003;"VARZEA DO POCO (BA)";"BA";"VARZEA DO POCO";31;4;4;39
2003;"VARZEA NOVA (BA)";"BA";"VARZEA NOVA";47;2;9;58
2003;"VARZEDO (BA)";"BA";"VARZEDO";27;1;3;31
2003;"VERA CRUZ (BA)";"BA";"VERA CRUZ";85;72;15;172
2003;"VEREDA (BA)";"BA";"VEREDA";6;0;1;7
2003;"VITORIA DA CONQUISTA (BA)";"BA";"VITORIA DA CONQUISTA";2323;146;660;3129
2003;"WAGNER (BA)";"BA";"WAGNER";12;0;4;16
2003;"WANDERLEY (BA)";"BA";"WANDERLEY";22;4;6;32
2003;"WENCESLAU GUIMARAES (BA)";"BA";"WENCESLAU GUIMARAES";56;6;2;64
2003;"XIQUE XIQUE (BA)";"BA";"XIQUE XIQUE";67;5;7;79
2003;"ABAIARA (CE)";"CE";"ABAIARA";7;11;2;20
2003;"ACARAPE (CE)";"CE";"ACARAPE";64;20;4;88
2003;"ACARAU (CE)";"CE";"ACARAU";113;8;18;139
2003;"ACOPIARA (CE)";"CE";"ACOPIARA";145;7;19;171
2003;"AIUABA (CE)";"CE";"AIUABA";12;0;0;12
2003;"ALCANTARAS (CE)";"CE";"ALCANTARAS";28;0;3;31
2003;"ALTANEIRA (CE)";"CE";"ALTANEIRA";10;3;1;14
2003;"ALTO SANTO (CE)";"CE";"ALTO SANTO";80;5;11;96
2003;"AMONTADA (CE)";"CE";"AMONTADA";104;8;5;117
2003;"ANTONINA DO NORTE (CE)";"CE";"ANTONINA DO NORTE";21;0;0;21
2003;"APUIARES (CE)";"CE";"APUIARES";27;9;2;38
2003;"AQUIRAZ (CE)";"CE";"AQUIRAZ";226;53;20;299
2003;"ARACATI (CE)";"CE";"ARACATI";317;26;44;387
2003;"ARACOIABA (CE)";"CE";"ARACOIABA";57;7;9;73
2003;"ARARENDA (CE)";"CE";"ARARENDA";8;0;1;9
2003;"ARARIPE (CE)";"CE";"ARARIPE";30;24;6;60
2003;"ARATUBA (CE)";"CE";"ARATUBA";18;2;3;23
2003;"ARNEIROZ (CE)";"CE";"ARNEIROZ";14;1;0;15
2003;"ASSARE (CE)";"CE";"ASSARE";43;6;0;49
2003;"AURORA (CE)";"CE";"AURORA";45;6;2;53
2003;"BAIXIO (CE)";"CE";"BAIXIO";4;5;1;10
2003;"BANABUIU (CE)";"CE";"BANABUIU";46;5;12;63
2003;"BARBALHA (CE)";"CE";"BARBALHA";128;9;35;172
2003;"BARREIRA (CE)";"CE";"BARREIRA";61;3;10;74
2003;"BARRO (CE)";"CE";"BARRO";25;6;7;38
2003;"BARROQUINHA (CE)";"CE";"BARROQUINHA";15;3;0;18
2003;"BATURITE (CE)";"CE";"BATURITE";141;23;15;179
2003;"BEBERIBE (CE)";"CE";"BEBERIBE";96;20;24;140
2003;"BELA CRUZ (CE)";"CE";"BELA CRUZ";48;5;4;57
2003;"BOA VIAGEM (CE)";"CE";"BOA VIAGEM";212;16;28;256
2003;"BREJO SANTO (CE)";"CE";"BREJO SANTO";168;22;15;205
2003;"CAMOCIM (CE)";"CE";"CAMOCIM";83;13;10;106
2003;"CAMPOS SALES (CE)";"CE";"CAMPOS SALES";112;9;14;135
2003;"CANINDE (CE)";"CE";"CANINDE";251;11;38;300
2003;"CAPISTRANO (CE)";"CE";"CAPISTRANO";32;7;11;50
2003;"CARIDADE (CE)";"CE";"CARIDADE";33;3;3;39
2003;"CARIRE (CE)";"CE";"CARIRE";16;4;3;23
2003;"CARIRIACU (CE)";"CE";"CARIRIACU";34;8;2;44
2003;"CARIUS (CE)";"CE";"CARIUS";30;2;2;34
2003;"CARNAUBAL (CE)";"CE";"CARNAUBAL";41;9;5;55
2003;"CASCAVEL (CE)";"CE";"CASCAVEL";232;26;34;292
2003;"CATARINA (CE)";"CE";"CATARINA";22;3;0;25
2003;"CATUNDA (CE)";"CE";"CATUNDA";19;3;1;23
2003;"CAUCAIA (CE)";"CE";"CAUCAIA";697;48;245;990
2003;"CEDRO (CE)";"CE";"CEDRO";61;20;18;99
2003;"CHAVAL (CE)";"CE";"CHAVAL";13;6;1;20
2003;"CHORO (CE)";"CE";"CHORO";20;4;9;33
2003;"CHOROZINHO (CE)";"CE";"CHOROZINHO";57;8;24;89
2003;"COREAU (CE)";"CE";"COREAU";57;10;7;74
2003;"CRATEUS (CE)";"CE";"CRATEUS";187;11;26;224
2003;"CRATO (CE)";"CE";"CRATO";553;28;72;653
2003;"CROATA (CE)";"CE";"CROATA";30;2;0;32
2003;"CRUZ (CE)";"CE";"CRUZ";77;16;15;108
2003;"DEPUTADO IRAPUAN PINHEIRO (CE)";"CE";"DEPUTADO IRAPUAN PINHEIRO";9;4;3;16
2003;"ERERE (CE)";"CE";"ERERE";4;2;1;7
2003;"EUSEBIO (CE)";"CE";"EUSEBIO";454;6;43;503
2003;"FARIAS BRITO (CE)";"CE";"FARIAS BRITO";44;25;4;73
2003;"FORQUILHA (CE)";"CE";"FORQUILHA";62;14;7;83
2003;"FORTALEZA (CE)";"CE";"FORTALEZA";15323;1775;3847;20945
2003;"FORTIM (CE)";"CE";"FORTIM";21;25;6;52
2003;"FRECHEIRINHA (CE)";"CE";"FRECHEIRINHA";37;14;9;60
2003;"GENERAL SAMPAIO (CE)";"CE";"GENERAL SAMPAIO";9;3;1;13
2003;"GRACA (CE)";"CE";"GRACA";12;5;4;21
2003;"GRANJA (CE)";"CE";"GRANJA";106;16;11;133
2003;"GRANJEIRO (CE)";"CE";"GRANJEIRO";4;1;0;5
2003;"GROAIRAS (CE)";"CE";"GROAIRAS";34;17;2;53
2003;"GUAIUBA (CE)";"CE";"GUAIUBA";31;22;5;58
2003;"GUARACIABA DO NORTE (CE)";"CE";"GUARACIABA DO NORTE";177;4;6;187
2003;"GUARAMIRANGA (CE)";"CE";"GUARAMIRANGA";11;1;1;13
2003;"HIDROLANDIA (CE)";"CE";"HIDROLANDIA";57;6;7;70
2003;"HORIZONTE (CE)";"CE";"HORIZONTE";182;32;63;277
2003;"IBARETAMA (CE)";"CE";"IBARETAMA";30;4;5;39
2003;"IBIAPINA (CE)";"CE";"IBIAPINA";81;9;7;97
2003;"IBICUITINGA (CE)";"CE";"IBICUITINGA";26;1;4;31
2003;"ICAPUI (CE)";"CE";"ICAPUI";48;8;26;82
2003;"ICO (CE)";"CE";"ICO";173;30;25;228
2003;"IGUATU (CE)";"CE";"IGUATU";529;25;76;630
2003;"INDEPENDENCIA (CE)";"CE";"INDEPENDENCIA";119;2;8;129
2003;"IPAPORANGA (CE)";"CE";"IPAPORANGA";12;0;0;12
2003;"IPAUMIRIM (CE)";"CE";"IPAUMIRIM";110;7;14;131
2003;"IPU (CE)";"CE";"IPU";197;22;11;230
2003;"IPUEIRAS (CE)";"CE";"IPUEIRAS";46;6;2;54
2003;"IRACEMA (CE)";"CE";"IRACEMA";41;7;3;51
2003;"IRAUCUBA (CE)";"CE";"IRAUCUBA";49;4;6;59
2003;"ITAICABA (CE)";"CE";"ITAICABA";21;3;4;28
2003;"ITAITINGA (CE)";"CE";"ITAITINGA";109;22;7;138
2003;"ITAPAGE (CE)";"CE";"ITAPAGE";173;25;8;206
2003;"ITAPIPOCA (CE)";"CE";"ITAPIPOCA";378;28;16;422
2003;"ITAPIUNA (CE)";"CE";"ITAPIUNA";34;6;5;45
2003;"ITAREMA (CE)";"CE";"ITAREMA";65;13;13;91
2003;"ITATIRA (CE)";"CE";"ITATIRA";49;4;4;57
2003;"JAGUARETAMA (CE)";"CE";"JAGUARETAMA";50;1;1;52
2003;"JAGUARIBARA (CE)";"CE";"JAGUARIBARA";37;3;3;43
2003;"JAGUARIBE (CE)";"CE";"JAGUARIBE";231;20;12;263
2003;"JAGUARUANA (CE)";"CE";"JAGUARUANA";130;11;4;145
2003;"JARDIM (CE)";"CE";"JARDIM";39;11;5;55
2003;"JATI (CE)";"CE";"JATI";2;2;0;4
2003;"JIJOCA DE JERICOACOARA (CE)";"CE";"JIJOCA DE JERICOACOARA";32;4;1;37
2003;"JUAZEIRO DO NORTE (CE)";"CE";"JUAZEIRO DO NORTE";984;73;178;1235
2003;"JUCAS (CE)";"CE";"JUCAS";26;3;10;39
2003;"LAVRAS DA MANGABEIRA (CE)";"CE";"LAVRAS DA MANGABEIRA";39;6;13;58
2003;"LIMOEIRO DO NORTE (CE)";"CE";"LIMOEIRO DO NORTE";420;15;44;479
2003;"MADALENA (CE)";"CE";"MADALENA";35;1;7;43
2003;"MARACANAU (CE)";"CE";"MARACANAU";602;102;142;846
2003;"MARANGUAPE (CE)";"CE";"MARANGUAPE";371;22;87;480
2003;"MARCO (CE)";"CE";"MARCO";102;4;6;112
2003;"MARTINOPOLE (CE)";"CE";"MARTINOPOLE";5;5;1;11
2003;"MASSAPE (CE)";"CE";"MASSAPE";40;4;17;61
2003;"MAURITI (CE)";"CE";"MAURITI";45;9;5;59
2003;"MERUOCA (CE)";"CE";"MERUOCA";21;0;4;25
2003;"MILAGRES (CE)";"CE";"MILAGRES";58;3;7;68
2003;"MILHA (CE)";"CE";"MILHA";35;0;6;41
2003;"MIRAIMA (CE)";"CE";"MIRAIMA";23;0;2;25
2003;"MISSAO VELHA (CE)";"CE";"MISSAO VELHA";50;12;8;70
2003;"MOMBACA (CE)";"CE";"MOMBACA";131;4;4;139
2003;"MONSENHOR TABOSA (CE)";"CE";"MONSENHOR TABOSA";29;2;0;31
2003;"MORADA NOVA (CE)";"CE";"MORADA NOVA";236;22;34;292
2003;"MORAUJO (CE)";"CE";"MORAUJO";7;2;4;13
2003;"MORRINHOS (CE)";"CE";"MORRINHOS";34;5;3;42
2003;"MUCAMBO (CE)";"CE";"MUCAMBO";19;17;5;41
2003;"MULUNGU (CE)";"CE";"MULUNGU";29;4;1;34
2003;"NOVA OLINDA (CE)";"CE";"NOVA OLINDA";48;11;3;62
2003;"NOVA RUSSAS (CE)";"CE";"NOVA RUSSAS";133;5;5;143
2003;"NOVO ORIENTE (CE)";"CE";"NOVO ORIENTE";33;0;3;36
2003;"OCARA (CE)";"CE";"OCARA";53;16;10;79
2003;"OROS (CE)";"CE";"OROS";59;16;13;88
2003;"PACAJUS (CE)";"CE";"PACAJUS";372;22;17;411
2003;"PACATUBA (CE)";"CE";"PACATUBA";74;45;6;125
2003;"PACOTI (CE)";"CE";"PACOTI";54;4;4;62
2003;"PACUJA (CE)";"CE";"PACUJA";21;5;7;33
2003;"PALHANO (CE)";"CE";"PALHANO";33;4;7;44
2003;"PALMACIA (CE)";"CE";"PALMACIA";27;8;4;39
2003;"PARACURU (CE)";"CE";"PARACURU";97;9;5;111
2003;"PARAIPABA (CE)";"CE";"PARAIPABA";85;9;12;106
2003;"PARAMBU (CE)";"CE";"PARAMBU";121;3;0;124
2003;"PARAMOTI (CE)";"CE";"PARAMOTI";23;1;5;29
2003;"PEDRA BRANCA (CE)";"CE";"PEDRA BRANCA";130;9;9;148
2003;"PENAFORTE (CE)";"CE";"PENAFORTE";13;1;9;23
2003;"PENTECOSTE (CE)";"CE";"PENTECOSTE";126;13;4;143
2003;"PEREIRO (CE)";"CE";"PEREIRO";66;11;6;83
2003;"PINDORETAMA (CE)";"CE";"PINDORETAMA";74;6;6;86
2003;"PIQUET CARNEIRO (CE)";"CE";"PIQUET CARNEIRO";9;2;4;15
2003;"PIRES FERREIRA (CE)";"CE";"PIRES FERREIRA";16;2;1;19
2003;"PORANGA (CE)";"CE";"PORANGA";8;1;1;10
2003;"PORTEIRAS (CE)";"CE";"PORTEIRAS";12;4;3;19
2003;"POTENGI (CE)";"CE";"POTENGI";17;5;0;22
2003;"POTIRETAMA (CE)";"CE";"POTIRETAMA";18;1;4;23
2003;"QUITERIANOPOLIS (CE)";"CE";"QUITERIANOPOLIS";19;2;2;23
2003;"QUIXADA (CE)";"CE";"QUIXADA";393;41;65;499
2003;"QUIXELO (CE)";"CE";"QUIXELO";22;5;12;39
2003;"QUIXERAMOBIM (CE)";"CE";"QUIXERAMOBIM";242;15;46;303
2003;"QUIXERE (CE)";"CE";"QUIXERE";96;11;21;128
2003;"REDENCAO (CE)";"CE";"REDENCAO";124;9;17;150
2003;"RERIUTABA (CE)";"CE";"RERIUTABA";42;16;15;73
2003;"RUSSAS (CE)";"CE";"RUSSAS";414;18;39;471
2003;"SABOEIRO (CE)";"CE";"SABOEIRO";16;1;3;20
2003;"SALITRE (CE)";"CE";"SALITRE";15;2;4;21
2003;"SANTA QUITERIA (CE)";"CE";"SANTA QUITERIA";141;8;6;155
2003;"SANTANA DO ACARAU (CE)";"CE";"SANTANA DO ACARAU";61;8;10;79
2003;"SANTANA DO CARIRI (CE)";"CE";"SANTANA DO CARIRI";33;3;3;39
2003;"SAO BENEDITO (CE)";"CE";"SAO BENEDITO";248;26;28;302
2003;"SAO GONCALO DO AMARANTE (CE)";"CE";"SAO GONCALO DO AMARANTE";126;12;16;154
2003;"SAO JOAO DO JAGUARIBE (CE)";"CE";"SAO JOAO DO JAGUARIBE";34;5;2;41
2003;"SAO LUIS DO CURU (CE)";"CE";"SAO LUIS DO CURU";27;8;7;42
2003;"SENADOR POMPEU (CE)";"CE";"SENADOR POMPEU";98;7;23;128
2003;"SENADOR SA (CE)";"CE";"SENADOR SA";19;0;3;22
2003;"SOBRAL (CE)";"CE";"SOBRAL";1083;82;130;1295
2003;"SOLONOPOLE (CE)";"CE";"SOLONOPOLE";51;4;7;62
2003;"TABULEIRO DO NORTE (CE)";"CE";"TABULEIRO DO NORTE";214;14;26;254
2003;"TAMBORIL (CE)";"CE";"TAMBORIL";43;2;9;54
2003;"TARRAFAS (CE)";"CE";"TARRAFAS";12;2;1;15
2003;"TAUA (CE)";"CE";"TAUA";237;2;15;254
2003;"TEJUCUOCA (CE)";"CE";"TEJUCUOCA";38;0;2;40
2003;"TIANGUA (CE)";"CE";"TIANGUA";682;38;36;756
2003;"TRAIRI (CE)";"CE";"TRAIRI";95;10;8;113
2003;"TURURU (CE)";"CE";"TURURU";31;2;2;35
2003;"UBAJARA (CE)";"CE";"UBAJARA";125;7;9;141
2003;"UMARI (CE)";"CE";"UMARI";4;0;3;7
2003;"UMIRIM (CE)";"CE";"UMIRIM";30;36;5;71
2003;"URUBURETAMA (CE)";"CE";"URUBURETAMA";52;6;1;59
2003;"URUOCA (CE)";"CE";"URUOCA";17;5;5;27
2003;"VARJOTA (CE)";"CE";"VARJOTA";71;23;3;97
2003;"VARZEA ALEGRE (CE)";"CE";"VARZEA ALEGRE";119;9;21;149
2003;"VICOSA DO CEARA (CE)";"CE";"VICOSA DO CEARA";168;7;11;186
2003;"BRASILIA (DF)";"DF";"BRASILIA";14342;4524;6030;24896
2003;"AFONSO CLAUDIO (ES)";"ES";"AFONSO CLAUDIO";380;12;89;481
2003;"AGUA DOCE DO NORTE (ES)";"ES";"AGUA DOCE DO NORTE";45;3;11;59
2003;"AGUIA BRANCA (ES)";"ES";"AGUIA BRANCA";82;1;20;103
2003;"ALEGRE (ES)";"ES";"ALEGRE";132;6;9;147
2003;"ALFREDO CHAVES (ES)";"ES";"ALFREDO CHAVES";273;5;25;303
2003;"ALTO RIO NOVO (ES)";"ES";"ALTO RIO NOVO";59;4;6;69
2003;"ANCHIETA (ES)";"ES";"ANCHIETA";146;22;19;187
2003;"APIACA (ES)";"ES";"APIACA";22;5;2;29
2003;"ARACRUZ (ES)";"ES";"ARACRUZ";713;68;218;999
2003;"ATILIO VIVACQUA (ES)";"ES";"ATILIO VIVACQUA";125;4;13;142
2003;"BAIXO GUANDU (ES)";"ES";"BAIXO GUANDU";285;7;79;371
2003;"BARRA DE SAO FRANCISCO (ES)";"ES";"BARRA DE SAO FRANCISCO";319;6;52;377
2003;"BOA ESPERANCA (ES)";"ES";"BOA ESPERANCA";145;3;22;170
2003;"BOM JESUS DO NORTE (ES)";"ES";"BOM JESUS DO NORTE";111;10;18;139
2003;"BREJETUBA (ES)";"ES";"BREJETUBA";89;4;18;111
2003;"CACHOEIRO DE ITAPEMIRIM (ES)";"ES";"CACHOEIRO DE ITAPEMIRIM";3723;99;1828;5650
2003;"CARIACICA (ES)";"ES";"CARIACICA";3435;262;1228;4925
2003;"CASTELO (ES)";"ES";"CASTELO";1000;33;38;1071
2003;"COLATINA (ES)";"ES";"COLATINA";1777;41;350;2168
2003;"CONCEICAO DA BARRA (ES)";"ES";"CONCEICAO DA BARRA";123;6;77;206
2003;"CONCEICAO DO CASTELO (ES)";"ES";"CONCEICAO DO CASTELO";133;8;23;164
2003;"DIVINO DE SAO LOURENCO (ES)";"ES";"DIVINO DE SAO LOURENCO";29;2;4;35
2003;"DOMINGOS MARTINS (ES)";"ES";"DOMINGOS MARTINS";625;33;40;698
2003;"DORES DO RIO PRETO (ES)";"ES";"DORES DO RIO PRETO";65;1;7;73
2003;"ECOPORANGA (ES)";"ES";"ECOPORANGA";79;4;43;126
2003;"FUNDAO (ES)";"ES";"FUNDAO";166;8;13;187
2003;"GOVERNADOR LINDENBERG (ES)";"ES";"GOVERNADOR LINDENBERG";77;2;1;80
2003;"GUACUI (ES)";"ES";"GUACUI";260;19;22;301
2003;"GUARAPARI (ES)";"ES";"GUARAPARI";649;85;120;854
2003;"IBATIBA (ES)";"ES";"IBATIBA";195;9;15;219
2003;"IBIRACU (ES)";"ES";"IBIRACU";271;14;26;311
2003;"IBITIRAMA (ES)";"ES";"IBITIRAMA";55;1;4;60
2003;"ICONHA (ES)";"ES";"ICONHA";521;3;11;535
2003;"IRUPI (ES)";"ES";"IRUPI";89;7;9;105
2003;"ITAGUACU (ES)";"ES";"ITAGUACU";156;4;46;206
2003;"ITAPEMIRIM (ES)";"ES";"ITAPEMIRIM";245;6;34;285
2003;"ITARANA (ES)";"ES";"ITARANA";212;13;32;257
2003;"IUNA (ES)";"ES";"IUNA";229;5;42;276
2003;"JAGUARE (ES)";"ES";"JAGUARE";251;7;33;291
2003;"JERONIMO MONTEIRO (ES)";"ES";"JERONIMO MONTEIRO";57;3;7;67
2003;"JOAO NEIVA (ES)";"ES";"JOAO NEIVA";200;7;27;234
2003;"LARANJA DA TERRA (ES)";"ES";"LARANJA DA TERRA";177;1;19;197
2003;"LINHARES (ES)";"ES";"LINHARES";2078;38;216;2332
2003;"MANTENOPOLIS (ES)";"ES";"MANTENOPOLIS";92;1;13;106
2003;"MARATAIZES (ES)";"ES";"MARATAIZES";418;9;31;458
2003;"MARECHAL FLORIANO (ES)";"ES";"MARECHAL FLORIANO";425;9;5;439
2003;"MARILANDIA (ES)";"ES";"MARILANDIA";224;4;16;244
2003;"MIMOSO DO SUL (ES)";"ES";"MIMOSO DO SUL";146;7;26;179
2003;"MONTANHA (ES)";"ES";"MONTANHA";115;6;15;136
2003;"MUCURICI (ES)";"ES";"MUCURICI";29;6;12;47
2003;"MUNIZ FREIRE (ES)";"ES";"MUNIZ FREIRE";103;9;24;136
2003;"MUQUI (ES)";"ES";"MUQUI";93;5;14;112
2003;"NOVA VENECIA (ES)";"ES";"NOVA VENECIA";569;15;119;703
2003;"PANCAS (ES)";"ES";"PANCAS";150;6;6;162
2003;"PEDRO CANARIO (ES)";"ES";"PEDRO CANARIO";232;8;116;356
2003;"PINHEIROS (ES)";"ES";"PINHEIROS";162;6;56;224
2003;"PIUMA (ES)";"ES";"PIUMA";114;35;11;160
2003;"PONTO BELO (ES)";"ES";"PONTO BELO";24;1;3;28
2003;"PRESIDENTE KENNEDY (ES)";"ES";"PRESIDENTE KENNEDY";115;5;10;130
2003;"RIO BANANAL (ES)";"ES";"RIO BANANAL";369;4;19;392
2003;"RIO NOVO DO SUL (ES)";"ES";"RIO NOVO DO SUL";178;2;12;192
2003;"SANTA LEOPOLDINA (ES)";"ES";"SANTA LEOPOLDINA";203;9;17;229
2003;"SANTA MARIA DE JETIBA (ES)";"ES";"SANTA MARIA DE JETIBA";1024;24;39;1087
2003;"SANTA TERESA (ES)";"ES";"SANTA TERESA";476;12;31;519
2003;"SAO DOMINGOS DO NORTE (ES)";"ES";"SAO DOMINGOS DO NORTE";114;2;6;122
2003;"SAO GABRIEL DA PALHA (ES)";"ES";"SAO GABRIEL DA PALHA";439;9;52;500
2003;"SAO JOSE DO CALCADO (ES)";"ES";"SAO JOSE DO CALCADO";52;1;10;63
2003;"SAO MATEUS (ES)";"ES";"SAO MATEUS";673;44;217;934
2003;"SAO ROQUE DO CANAA (ES)";"ES";"SAO ROQUE DO CANAA";178;4;9;191
2003;"SERRA (ES)";"ES";"SERRA";4395;191;1179;5765
2003;"SOORETAMA (ES)";"ES";"SOORETAMA";163;5;36;204
2003;"VARGEM ALTA (ES)";"ES";"VARGEM ALTA";242;4;21;267
2003;"VENDA NOVA DO IMIGRANTE (ES)";"ES";"VENDA NOVA DO IMIGRANTE";469;11;74;554
2003;"VIANA (ES)";"ES";"VIANA";545;20;154;719
2003;"VILA PAVAO (ES)";"ES";"VILA PAVAO";77;1;9;87
2003;"VILA VALERIO (ES)";"ES";"VILA VALERIO";211;3;16;230
2003;"VILA VELHA (ES)";"ES";"VILA VELHA";3223;482;702;4407
2003;"VITORIA (ES)";"ES";"VITORIA";2544;571;761;3876
2003;"ABADIA DE GOIAS (GO)";"GO";"ABADIA DE GOIAS";18;1;2;21
2003;"ABADIANIA (GO)";"GO";"ABADIANIA";118;7;12;137
2003;"ACREUNA (GO)";"GO";"ACREUNA";296;4;36;336
2003;"ADELANDIA (GO)";"GO";"ADELANDIA";8;0;0;8
2003;"AGUA FRIA DE GOIAS (GO)";"GO";"AGUA FRIA DE GOIAS";21;1;2;24
2003;"AGUA LIMPA (GO)";"GO";"AGUA LIMPA";13;0;1;14
2003;"AGUAS LINDAS DE GOIAS (GO)";"GO";"AGUAS LINDAS DE GOIAS";157;17;184;358
2003;"ALEXANIA (GO)";"GO";"ALEXANIA";269;10;15;294
2003;"ALOANDIA (GO)";"GO";"ALOANDIA";19;3;1;23
2003;"ALTO HORIZONTE (GO)";"GO";"ALTO HORIZONTE";9;0;2;11
2003;"ALTO PARAISO DE GOIAS (GO)";"GO";"ALTO PARAISO DE GOIAS";33;6;3;42
2003;"ALVORADA DO NORTE (GO)";"GO";"ALVORADA DO NORTE";68;2;2;72
2003;"AMARALINA (GO)";"GO";"AMARALINA";3;1;4;8
2003;"AMERICANO DO BRASIL (GO)";"GO";"AMERICANO DO BRASIL";17;0;6;23
2003;"AMORINOPOLIS (GO)";"GO";"AMORINOPOLIS";13;0;6;19
2003;"ANAPOLIS (GO)";"GO";"ANAPOLIS";6650;136;1045;7831
2003;"ANHANGUERA (GO)";"GO";"ANHANGUERA";5;0;1;6
2003;"ANICUNS (GO)";"GO";"ANICUNS";182;11;30;223
2003;"APARECIDA DE GOIANIA (GO)";"GO";"APARECIDA DE GOIANIA";2132;99;416;2647
2003;"APARECIDA DO RIO DOCE (GO)";"GO";"APARECIDA DO RIO DOCE";37;0;5;42
2003;"APORE (GO)";"GO";"APORE";37;4;5;46
2003;"ARACU (GO)";"GO";"ARACU";10;0;1;11
2003;"ARAGARCAS (GO)";"GO";"ARAGARCAS";319;4;4;327
2003;"ARAGOIANIA (GO)";"GO";"ARAGOIANIA";32;1;2;35
2003;"ARAGUAPAZ (GO)";"GO";"ARAGUAPAZ";48;2;3;53
2003;"ARENOPOLIS (GO)";"GO";"ARENOPOLIS";7;0;2;9
2003;"ARUANA (GO)";"GO";"ARUANA";17;1;5;23
2003;"AURILANDIA (GO)";"GO";"AURILANDIA";18;3;1;22
2003;"AVELINOPOLIS (GO)";"GO";"AVELINOPOLIS";19;1;1;21
2003;"BALIZA (GO)";"GO";"BALIZA";2;1;2;5
2003;"BARRO ALTO (GO)";"GO";"BARRO ALTO";44;3;8;55
2003;"BELA VISTA DE GOIAS (GO)";"GO";"BELA VISTA DE GOIAS";177;5;25;207
2003;"BOM JARDIM DE GOIAS (GO)";"GO";"BOM JARDIM DE GOIAS";59;4;6;69
2003;"BOM JESUS DE GOIAS (GO)";"GO";"BOM JESUS DE GOIAS";324;5;17;346
2003;"BONFINOPOLIS (GO)";"GO";"BONFINOPOLIS";21;1;9;31
2003;"BONOPOLIS (GO)";"GO";"BONOPOLIS";6;1;2;9
2003;"BRAZABRANTES (GO)";"GO";"BRAZABRANTES";14;3;2;19
2003;"BRITANIA (GO)";"GO";"BRITANIA";46;1;1;48
2003;"BURITI ALEGRE (GO)";"GO";"BURITI ALEGRE";122;5;1;128
2003;"BURITI DE GOIAS (GO)";"GO";"BURITI DE GOIAS";11;4;0;15
2003;"BURITINOPOLIS (GO)";"GO";"BURITINOPOLIS";9;0;3;12
2003;"CABECEIRAS (GO)";"GO";"CABECEIRAS";35;2;12;49
2003;"CACHOEIRA ALTA (GO)";"GO";"CACHOEIRA ALTA";87;7;8;102
2003;"CACHOEIRA DE GOIAS (GO)";"GO";"CACHOEIRA DE GOIAS";4;1;0;5
2003;"CACHOEIRA DOURADA (GO)";"GO";"CACHOEIRA DOURADA";61;5;11;77
2003;"CACU (GO)";"GO";"CACU";161;2;15;178
2003;"CAIAPONIA (GO)";"GO";"CAIAPONIA";85;1;3;89
2003;"CALDAS NOVAS (GO)";"GO";"CALDAS NOVAS";393;26;57;476
2003;"CALDAZINHA (GO)";"GO";"CALDAZINHA";22;1;2;25
2003;"CAMPESTRE DE GOIAS (GO)";"GO";"CAMPESTRE DE GOIAS";15;1;2;18
2003;"CAMPINACU (GO)";"GO";"CAMPINACU";1;0;1;2
2003;"CAMPINORTE (GO)";"GO";"CAMPINORTE";74;1;8;83
2003;"CAMPO ALEGRE DE GOIAS (GO)";"GO";"CAMPO ALEGRE DE GOIAS";71;0;9;80
2003;"CAMPO LIMPO DE GOIAS (GO)";"GO";"CAMPO LIMPO DE GOIAS";34;0;2;36
2003;"CAMPOS BELOS (GO)";"GO";"CAMPOS BELOS";114;2;15;131
2003;"CAMPOS VERDES (GO)";"GO";"CAMPOS VERDES";18;2;1;21
2003;"CARMO DO RIO VERDE (GO)";"GO";"CARMO DO RIO VERDE";46;3;24;73
2003;"CASTELANDIA (GO)";"GO";"CASTELANDIA";45;2;4;51
2003;"CATALAO (GO)";"GO";"CATALAO";1143;31;167;1341
2003;"CATURAI (GO)";"GO";"CATURAI";19;0;3;22
2003;"CAVALCANTE (GO)";"GO";"CAVALCANTE";10;1;2;13
2003;"CERES (GO)";"GO";"CERES";403;7;20;430
2003;"CEZARINA (GO)";"GO";"CEZARINA";65;2;5;72
2003;"CHAPADAO DO CEU (GO)";"GO";"CHAPADAO DO CEU";93;1;7;101
2003;"CIDADE OCIDENTAL (GO)";"GO";"CIDADE OCIDENTAL";58;4;35;97
2003;"COCALZINHO DE GOIAS (GO)";"GO";"COCALZINHO DE GOIAS";110;11;15;136
2003;"COLINAS DO SUL (GO)";"GO";"COLINAS DO SUL";3;1;2;6
2003;"CORREGO DO OURO (GO)";"GO";"CORREGO DO OURO";9;2;1;12
2003;"CORUMBA DE GOIAS (GO)";"GO";"CORUMBA DE GOIAS";57;3;9;69
2003;"CORUMBAIBA (GO)";"GO";"CORUMBAIBA";79;2;6;87
2003;"CRISTALINA (GO)";"GO";"CRISTALINA";468;7;76;551
2003;"CRISTIANOPOLIS (GO)";"GO";"CRISTIANOPOLIS";20;3;1;24
2003;"CRIXAS (GO)";"GO";"CRIXAS";54;3;16;73
2003;"CROMINIA (GO)";"GO";"CROMINIA";18;1;2;21
2003;"CUMARI (GO)";"GO";"CUMARI";10;1;0;11
2003;"DAMIANOPOLIS (GO)";"GO";"DAMIANOPOLIS";4;0;2;6
2003;"DAMOLANDIA (GO)";"GO";"DAMOLANDIA";15;1;3;19
2003;"DAVINOPOLIS (GO)";"GO";"DAVINOPOLIS";21;3;3;27
2003;"DIORAMA (GO)";"GO";"DIORAMA";7;0;4;11
2003;"DIVINOPOLIS DE GOIAS (GO)";"GO";"DIVINOPOLIS DE GOIAS";11;0;1;12
2003;"DOVERLANDIA (GO)";"GO";"DOVERLANDIA";70;2;15;87
2003;"EDEALINA (GO)";"GO";"EDEALINA";49;2;5;56
2003;"EDEIA (GO)";"GO";"EDEIA";122;1;7;130
2003;"ESTRELA DO NORTE (GO)";"GO";"ESTRELA DO NORTE";15;4;1;20
2003;"FAINA (GO)";"GO";"FAINA";21;0;4;25
2003;"FAZENDA NOVA (GO)";"GO";"FAZENDA NOVA";19;2;5;26
2003;"FIRMINOPOLIS (GO)";"GO";"FIRMINOPOLIS";50;1;4;55
2003;"FLORES DE GOIAS (GO)";"GO";"FLORES DE GOIAS";17;2;5;24
2003;"FORMOSA (GO)";"GO";"FORMOSA";1449;39;204;1692
2003;"FORMOSO (GO)";"GO";"FORMOSO";24;0;3;27
2003;"GAMELEIRA DE GOIAS (GO)";"GO";"GAMELEIRA DE GOIAS";12;4;7;23
2003;"GOIANAPOLIS (GO)";"GO";"GOIANAPOLIS";114;1;5;120
2003;"GOIANDIRA (GO)";"GO";"GOIANDIRA";29;2;2;33
2003;"GOIANESIA (GO)";"GO";"GOIANESIA";627;15;87;729
2003;"GOIANIA (GO)";"GO";"GOIANIA";20355;1471;4625;26451
2003;"GOIANIRA (GO)";"GO";"GOIANIRA";121;1;52;174
2003;"GOIAS (GO)";"GO";"GOIAS";168;3;22;193
2003;"GOIATUBA (GO)";"GO";"GOIATUBA";499;8;41;548
2003;"GOUVELANDIA (GO)";"GO";"GOUVELANDIA";40;2;5;47
2003;"GUAPO (GO)";"GO";"GUAPO";76;3;2;81
2003;"GUARAITA (GO)";"GO";"GUARAITA";11;0;0;11
2003;"GUARANI DE GOIAS (GO)";"GO";"GUARANI DE GOIAS";4;1;5;10
2003;"GUARINOS (GO)";"GO";"GUARINOS";3;2;1;6
2003;"HEITORAI (GO)";"GO";"HEITORAI";10;0;2;12
2003;"HIDROLANDIA (GO)";"GO";"HIDROLANDIA";123;10;7;140
2003;"HIDROLINA (GO)";"GO";"HIDROLINA";9;1;2;12
2003;"IACIARA (GO)";"GO";"IACIARA";84;3;5;92
2003;"INACIOLANDIA (GO)";"GO";"INACIOLANDIA";46;4;2;52
2003;"INDIARA (GO)";"GO";"INDIARA";100;6;17;123
2003;"INHUMAS (GO)";"GO";"INHUMAS";683;14;84;781
2003;"IPAMERI (GO)";"GO";"IPAMERI";162;4;28;194
2003;"IPIRANGA DE GOIAS (GO)";"GO";"IPIRANGA DE GOIAS";11;1;3;15
2003;"IPORA (GO)";"GO";"IPORA";280;5;21;306
2003;"ISRAELANDIA (GO)";"GO";"ISRAELANDIA";5;1;5;11
2003;"ITABERAI (GO)";"GO";"ITABERAI";347;10;25;382
2003;"ITAGUARI (GO)";"GO";"ITAGUARI";29;3;8;40
2003;"ITAGUARU (GO)";"GO";"ITAGUARU";39;7;6;52
2003;"ITAJA (GO)";"GO";"ITAJA";57;1;8;66
2003;"ITAPACI (GO)";"GO";"ITAPACI";131;3;24;158
2003;"ITAPIRAPUA (GO)";"GO";"ITAPIRAPUA";32;0;7;39
2003;"ITAPURANGA (GO)";"GO";"ITAPURANGA";210;6;27;243
2003;"ITARUMA (GO)";"GO";"ITARUMA";53;3;4;60
2003;"ITAUCU (GO)";"GO";"ITAUCU";48;2;5;55
2003;"ITUMBIARA (GO)";"GO";"ITUMBIARA";1471;69;123;1663
2003;"IVOLANDIA (GO)";"GO";"IVOLANDIA";6;2;3;11
2003;"JANDAIA (GO)";"GO";"JANDAIA";45;5;9;59
2003;"JARAGUA (GO)";"GO";"JARAGUA";174;6;19;199
2003;"JATAI (GO)";"GO";"JATAI";1304;21;100;1425
2003;"JAUPACI (GO)";"GO";"JAUPACI";12;1;2;15
2003;"JESUPOLIS (GO)";"GO";"JESUPOLIS";11;1;5;17
2003;"JOVIANIA (GO)";"GO";"JOVIANIA";117;4;5;126
2003;"JUSSARA (GO)";"GO";"JUSSARA";195;4;13;212
2003;"LAGOA SANTA (GO)";"GO";"LAGOA SANTA";2;1;0;3
2003;"LEOPOLDO DE BULHOES (GO)";"GO";"LEOPOLDO DE BULHOES";52;2;5;59
2003;"LUZIANIA (GO)";"GO";"LUZIANIA";1651;41;322;2014
2003;"MAIRIPOTABA (GO)";"GO";"MAIRIPOTABA";12;0;2;14
2003;"MAMBAI (GO)";"GO";"MAMBAI";29;1;1;31
2003;"MARA ROSA (GO)";"GO";"MARA ROSA";63;0;5;68
2003;"MARZAGAO (GO)";"GO";"MARZAGAO";22;1;1;24
2003;"MATRINCHA (GO)";"GO";"MATRINCHA";24;3;7;34
2003;"MAURILANDIA (GO)";"GO";"MAURILANDIA";206;2;36;244
2003;"MIMOSO DE GOIAS (GO)";"GO";"MIMOSO DE GOIAS";1;0;1;2
2003;"MINACU (GO)";"GO";"MINACU";226;15;24;265
2003;"MINEIROS (GO)";"GO";"MINEIROS";989;12;45;1046
2003;"MOIPORA (GO)";"GO";"MOIPORA";4;2;2;8
2003;"MONTE ALEGRE DE GOIAS (GO)";"GO";"MONTE ALEGRE DE GOIAS";8;0;3;11
2003;"MONTES CLAROS DE GOIAS (GO)";"GO";"MONTES CLAROS DE GOIAS";37;1;7;45
2003;"MONTIVIDIU (GO)";"GO";"MONTIVIDIU";191;1;22;214
2003;"MONTIVIDIU DO NORTE (GO)";"GO";"MONTIVIDIU DO NORTE";6;2;3;11
2003;"MORRINHOS (GO)";"GO";"MORRINHOS";490;23;44;557
2003;"MORRO AGUDO DE GOIAS (GO)";"GO";"MORRO AGUDO DE GOIAS";5;2;1;8
2003;"MOSSAMEDES (GO)";"GO";"MOSSAMEDES";16;0;1;17
2003;"MOZARLANDIA (GO)";"GO";"MOZARLANDIA";98;1;14;113
2003;"MUNDO NOVO (GO)";"GO";"MUNDO NOVO";20;3;5;28
2003;"MUTUNOPOLIS (GO)";"GO";"MUTUNOPOLIS";15;1;3;19
2003;"NAZARIO (GO)";"GO";"NAZARIO";67;0;4;71
2003;"NEROPOLIS (GO)";"GO";"NEROPOLIS";259;13;15;287
2003;"NIQUELANDIA (GO)";"GO";"NIQUELANDIA";336;15;66;417
2003;"NOVA AMERICA (GO)";"GO";"NOVA AMERICA";10;2;3;15
2003;"NOVA AURORA (GO)";"GO";"NOVA AURORA";13;1;1;15
2003;"NOVA CRIXAS (GO)";"GO";"NOVA CRIXAS";37;1;10;48
2003;"NOVA GLORIA (GO)";"GO";"NOVA GLORIA";51;1;10;62
2003;"NOVA IGUACU DE GOIAS (GO)";"GO";"NOVA IGUACU DE GOIAS";7;1;4;12
2003;"NOVA ROMA (GO)";"GO";"NOVA ROMA";1;0;1;2
2003;"NOVA VENEZA (GO)";"GO";"NOVA VENEZA";172;2;11;185
2003;"NOVO BRASIL (GO)";"GO";"NOVO BRASIL";8;2;0;10
2003;"NOVO GAMA (GO)";"GO";"NOVO GAMA";132;16;41;189
2003;"NOVO PLANALTO (GO)";"GO";"NOVO PLANALTO";20;2;1;23
2003;"ORIZONA (GO)";"GO";"ORIZONA";97;3;21;121
2003;"OURO VERDE DE GOIAS (GO)";"GO";"OURO VERDE DE GOIAS";52;0;6;58
2003;"OUVIDOR (GO)";"GO";"OUVIDOR";69;4;7;80
2003;"PADRE BERNARDO (GO)";"GO";"PADRE BERNARDO";142;2;29;173
2003;"PALESTINA DE GOIAS (GO)";"GO";"PALESTINA DE GOIAS";13;1;2;16
2003;"PALMEIRAS DE GOIAS (GO)";"GO";"PALMEIRAS DE GOIAS";172;1;25;198
2003;"PALMELO (GO)";"GO";"PALMELO";11;3;1;15
2003;"PALMINOPOLIS (GO)";"GO";"PALMINOPOLIS";17;0;2;19
2003;"PANAMA (GO)";"GO";"PANAMA";14;0;4;18
2003;"PARANAIGUARA (GO)";"GO";"PARANAIGUARA";78;2;4;84
2003;"PARAUNA (GO)";"GO";"PARAUNA";114;5;12;131
2003;"PEROLANDIA (GO)";"GO";"PEROLANDIA";16;0;4;20
2003;"PETROLINA DE GOIAS (GO)";"GO";"PETROLINA DE GOIAS";86;2;12;100
2003;"PILAR DE GOIAS (GO)";"GO";"PILAR DE GOIAS";6;2;1;9
2003;"PIRACANJUBA (GO)";"GO";"PIRACANJUBA";222;7;17;246
2003;"PIRANHAS (GO)";"GO";"PIRANHAS";155;1;11;167
2003;"PIRENOPOLIS (GO)";"GO";"PIRENOPOLIS";178;4;15;197
2003;"PIRES DO RIO (GO)";"GO";"PIRES DO RIO";328;8;25;361
2003;"PLANALTINA (GO)";"GO";"PLANALTINA";194;11;296;501
2003;"PONTALINA (GO)";"GO";"PONTALINA";180;2;18;200
2003;"PORANGATU (GO)";"GO";"PORANGATU";380;2;30;412
2003;"PORTEIRAO (GO)";"GO";"PORTEIRAO";45;1;2;48
2003;"PORTELANDIA (GO)";"GO";"PORTELANDIA";34;8;1;43
2003;"POSSE (GO)";"GO";"POSSE";288;5;28;321
2003;"PROFESSOR JAMIL (GO)";"GO";"PROFESSOR JAMIL";19;0;2;21
2003;"QUIRINOPOLIS (GO)";"GO";"QUIRINOPOLIS";575;4;18;597
2003;"RIALMA (GO)";"GO";"RIALMA";215;4;18;237
2003;"RIANAPOLIS (GO)";"GO";"RIANAPOLIS";79;1;6;86
2003;"RIO QUENTE (GO)";"GO";"RIO QUENTE";24;8;5;37
2003;"RIO VERDE (GO)";"GO";"RIO VERDE";2046;77;245;2368
2003;"RUBIATABA (GO)";"GO";"RUBIATABA";181;3;24;208
2003;"SANCLERLANDIA (GO)";"GO";"SANCLERLANDIA";44;3;3;50
2003;"SANTA BARBARA DE GOIAS (GO)";"GO";"SANTA BARBARA DE GOIAS";58;1;5;64
2003;"SANTA CRUZ DE GOIAS (GO)";"GO";"SANTA CRUZ DE GOIAS";3;0;2;5
2003;"SANTA FE DE GOIAS (GO)";"GO";"SANTA FE DE GOIAS";19;0;2;21
2003;"SANTA HELENA DE GOIAS (GO)";"GO";"SANTA HELENA DE GOIAS";584;12;107;703
2003;"SANTA ISABEL (GO)";"GO";"SANTA ISABEL";4;0;1;5
2003;"SANTA RITA DO ARAGUAIA (GO)";"GO";"SANTA RITA DO ARAGUAIA";86;5;4;95
2003;"SANTA RITA DO NOVO DESTINO (GO)";"GO";"SANTA RITA DO NOVO DESTINO";11;0;12;23
2003;"SANTA ROSA DE GOIAS (GO)";"GO";"SANTA ROSA DE GOIAS";12;1;0;13
2003;"SANTA TEREZA DE GOIAS (GO)";"GO";"SANTA TEREZA DE GOIAS";25;1;2;28
2003;"SANTA TEREZINHA DE GOIAS (GO)";"GO";"SANTA TEREZINHA DE GOIAS";54;4;15;73
2003;"SANTO ANTONIO DA BARRA (GO)";"GO";"SANTO ANTONIO DA BARRA";13;0;6;19
2003;"SANTO ANTONIO DE GOIAS (GO)";"GO";"SANTO ANTONIO DE GOIAS";27;1;8;36
2003;"SANTO ANTONIO DO DESCOBERTO (GO)";"GO";"SANTO ANTONIO DO DESCOBERTO";160;16;126;302
2003;"SAO DOMINGOS (GO)";"GO";"SAO DOMINGOS";15;4;2;21
2003;"SAO FRANCISCO DE GOIAS (GO)";"GO";"SAO FRANCISCO DE GOIAS";25;2;5;32
2003;"SAO JOAO D ALIANCA (GO)";"GO";"SAO JOAO D ALIANCA";85;1;6;92
2003;"SAO JOAO DA PARAUNA (GO)";"GO";"SAO JOAO DA PARAUNA";10;0;3;13
2003;"SAO LUIS DE MONTES BELOS (GO)";"GO";"SAO LUIS DE MONTES BELOS";271;6;29;306
2003;"SAO LUIZ DO NORTE (GO)";"GO";"SAO LUIZ DO NORTE";16;2;2;20
2003;"SAO MIGUEL DO ARAGUAIA (GO)";"GO";"SAO MIGUEL DO ARAGUAIA";209;2;20;231
2003;"SAO MIGUEL DO PASSA QUATRO (GO)";"GO";"SAO MIGUEL DO PASSA QUATRO";16;0;3;19
2003;"SAO PATRICIO (GO)";"GO";"SAO PATRICIO";5;0;3;8
2003;"SAO SIMAO (GO)";"GO";"SAO SIMAO";94;7;18;119
2003;"SENADOR CANEDO (GO)";"GO";"SENADOR CANEDO";307;4;11;322
2003;"SERRANOPOLIS (GO)";"GO";"SERRANOPOLIS";63;1;6;70
2003;"SILVANIA (GO)";"GO";"SILVANIA";187;0;22;209
2003;"SIMOLANDIA (GO)";"GO";"SIMOLANDIA";55;0;5;60
2003;"SITIO D ABADIA (GO)";"GO";"SITIO D ABADIA";7;0;2;9
2003;"TAQUARAL DE GOIAS (GO)";"GO";"TAQUARAL DE GOIAS";13;1;3;17
2003;"TERESINA DE GOIAS (GO)";"GO";"TERESINA DE GOIAS";5;1;1;7
2003;"TEREZOPOLIS DE GOIAS (GO)";"GO";"TEREZOPOLIS DE GOIAS";32;1;7;40
2003;"TRES RANCHOS (GO)";"GO";"TRES RANCHOS";27;2;3;32
2003;"TRINDADE (GO)";"GO";"TRINDADE";529;22;96;647
2003;"TROMBAS (GO)";"GO";"TROMBAS";21;3;3;27
2003;"TURVANIA (GO)";"GO";"TURVANIA";32;2;2;36
2003;"TURVELANDIA (GO)";"GO";"TURVELANDIA";35;0;14;49
2003;"UIRAPURU (GO)";"GO";"UIRAPURU";6;2;2;10
2003;"URUACU (GO)";"GO";"URUACU";273;9;40;322
2003;"URUANA (GO)";"GO";"URUANA";193;0;4;197
2003;"URUTAI (GO)";"GO";"URUTAI";10;1;4;15
2003;"VALPARAISO DE GOIAS (GO)";"GO";"VALPARAISO DE GOIAS";284;128;65;477
2003;"VARJAO (GO)";"GO";"VARJAO";25;0;6;31
2003;"VIANOPOLIS (GO)";"GO";"VIANOPOLIS";243;4;7;254
2003;"VICENTINOPOLIS (GO)";"GO";"VICENTINOPOLIS";113;1;12;126
2003;"VILA BOA (GO)";"GO";"VILA BOA";7;2;1;10
2003;"VILA PROPICIO (GO)";"GO";"VILA PROPICIO";4;1;8;13
2003;"ACAILANDIA (MA)";"MA";"ACAILANDIA";574;16;107;697
2003;"AFONSO CUNHA (MA)";"MA";"AFONSO CUNHA";0;0;0;0
2003;"AGUA DOCE DO MARANHAO (MA)";"MA";"AGUA DOCE DO MARANHAO";2;1;0;3
2003;"ALCANTARA (MA)";"MA";"ALCANTARA";14;1;4;19
2003;"ALDEIAS ALTAS (MA)";"MA";"ALDEIAS ALTAS";7;2;2;11
2003;"ALTAMIRA DO MARANHAO (MA)";"MA";"ALTAMIRA DO MARANHAO";13;2;1;16
2003;"ALTO ALEGRE DO MARANHAO (MA)";"MA";"ALTO ALEGRE DO MARANHAO";10;5;0;15
2003;"ALTO ALEGRE DO PINDARE (MA)";"MA";"ALTO ALEGRE DO PINDARE";13;2;2;17
2003;"ALTO PARNAIBA (MA)";"MA";"ALTO PARNAIBA";9;1;2;12
2003;"AMAPA DO MARANHAO (MA)";"MA";"AMAPA DO MARANHAO";4;1;0;5
2003;"AMARANTE DO MARANHAO (MA)";"MA";"AMARANTE DO MARANHAO";32;1;4;37
2003;"ANAJATUBA (MA)";"MA";"ANAJATUBA";10;3;2;15
2003;"ANAPURUS (MA)";"MA";"ANAPURUS";9;1;0;10
2003;"APICUM ACU (MA)";"MA";"APICUM ACU";1;1;0;2
2003;"ARAGUANA (MA)";"MA";"ARAGUANA";5;1;1;7
2003;"ARAIOSES (MA)";"MA";"ARAIOSES";11;3;6;20
2003;"ARAME (MA)";"MA";"ARAME";58;4;0;62
2003;"ARARI (MA)";"MA";"ARARI";41;6;4;51
2003;"AXIXA (MA)";"MA";"AXIXA";8;2;2;12
2003;"BACABAL (MA)";"MA";"BACABAL";433;32;34;499
2003;"BACABEIRA (MA)";"MA";"BACABEIRA";30;1;1;32
2003;"BACURI (MA)";"MA";"BACURI";4;2;1;7
2003;"BACURITUBA (MA)";"MA";"BACURITUBA";3;1;0;4
2003;"BALSAS (MA)";"MA";"BALSAS";542;23;34;599
2003;"BARAO DE GRAJAU (MA)";"MA";"BARAO DE GRAJAU";11;1;1;13
2003;"BARRA DO CORDA (MA)";"MA";"BARRA DO CORDA";214;7;4;225
2003;"BARREIRINHAS (MA)";"MA";"BARREIRINHAS";16;4;7;27
2003;"BELA VISTA DO MARANHAO (MA)";"MA";"BELA VISTA DO MARANHAO";9;0;0;9
2003;"BELAGUA (MA)";"MA";"BELAGUA";1;2;2;5
2003;"BENEDITO LEITE (MA)";"MA";"BENEDITO LEITE";0;0;0;0
2003;"BEQUIMAO (MA)";"MA";"BEQUIMAO";28;4;5;37
2003;"BERNARDO DO MEARIM (MA)";"MA";"BERNARDO DO MEARIM";6;1;0;7
2003;"BOA VISTA DO GURUPI (MA)";"MA";"BOA VISTA DO GURUPI";2;1;1;4
2003;"BOM JARDIM (MA)";"MA";"BOM JARDIM";32;1;3;36
2003;"BOM JESUS DAS SELVAS (MA)";"MA";"BOM JESUS DAS SELVAS";40;2;1;43
2003;"BOM LUGAR (MA)";"MA";"BOM LUGAR";8;2;5;15
2003;"BREJO (MA)";"MA";"BREJO";32;5;3;40
2003;"BREJO DE AREIA (MA)";"MA";"BREJO DE AREIA";8;3;1;12
2003;"BURITI (MA)";"MA";"BURITI";4;1;1;6
2003;"BURITI BRAVO (MA)";"MA";"BURITI BRAVO";12;1;0;13
2003;"BURITICUPU (MA)";"MA";"BURITICUPU";110;9;6;125
2003;"BURITIRANA (MA)";"MA";"BURITIRANA";10;0;0;10
2003;"CACHOEIRA GRANDE (MA)";"MA";"CACHOEIRA GRANDE";2;1;0;3
2003;"CAJAPIO (MA)";"MA";"CAJAPIO";4;1;2;7
2003;"CAJARI (MA)";"MA";"CAJARI";0;0;0;0
2003;"CAMPESTRE DO MARANHAO (MA)";"MA";"CAMPESTRE DO MARANHAO";6;3;1;10
2003;"CANDIDO MENDES (MA)";"MA";"CANDIDO MENDES";3;0;0;3
2003;"CANTANHEDE (MA)";"MA";"CANTANHEDE";10;0;0;10
2003;"CAPINZAL DO NORTE (MA)";"MA";"CAPINZAL DO NORTE";10;12;1;23
2003;"CAROLINA (MA)";"MA";"CAROLINA";33;2;3;38
2003;"CARUTAPERA (MA)";"MA";"CARUTAPERA";11;2;3;16
2003;"CAXIAS (MA)";"MA";"CAXIAS";311;13;31;355
2003;"CEDRAL (MA)";"MA";"CEDRAL";3;0;3;6
2003;"CENTRAL DO MARANHAO (MA)";"MA";"CENTRAL DO MARANHAO";3;0;0;3
2003;"CENTRO DO GUILHERME (MA)";"MA";"CENTRO DO GUILHERME";2;1;0;3
2003;"CENTRO NOVO DO MARANHAO (MA)";"MA";"CENTRO NOVO DO MARANHAO";5;1;1;7
2003;"CHAPADINHA (MA)";"MA";"CHAPADINHA";139;17;4;160
2003;"CIDELANDIA (MA)";"MA";"CIDELANDIA";13;4;3;20
2003;"CODO (MA)";"MA";"CODO";296;8;7;311
2003;"COELHO NETO (MA)";"MA";"COELHO NETO";53;5;5;63
2003;"COLINAS (MA)";"MA";"COLINAS";51;5;2;58
2003;"CONCEICAO DO LAGO ACU (MA)";"MA";"CONCEICAO DO LAGO ACU";2;0;0;2
2003;"COROATA (MA)";"MA";"COROATA";91;12;5;108
2003;"CURURUPU (MA)";"MA";"CURURUPU";14;2;2;18
2003;"DAVINOPOLIS (MA)";"MA";"DAVINOPOLIS";4;0;0;4
2003;"DOM PEDRO (MA)";"MA";"DOM PEDRO";145;5;10;160
2003;"DUQUE BACELAR (MA)";"MA";"DUQUE BACELAR";0;2;2;4
2003;"ESPERANTINOPOLIS (MA)";"MA";"ESPERANTINOPOLIS";26;1;0;27
2003;"ESTREITO (MA)";"MA";"ESTREITO";28;2;1;31
2003;"FEIRA NOVA DO MARANHAO (MA)";"MA";"FEIRA NOVA DO MARANHAO";0;0;0;0
2003;"FERNANDO FALCAO (MA)";"MA";"FERNANDO FALCAO";12;1;2;15
2003;"FORMOSA DA SERRA NEGRA (MA)";"MA";"FORMOSA DA SERRA NEGRA";6;0;0;6
2003;"FORTALEZA DOS NOGUEIRAS (MA)";"MA";"FORTALEZA DOS NOGUEIRAS";8;1;1;10
2003;"FORTUNA (MA)";"MA";"FORTUNA";8;1;0;9
2003;"GODOFREDO VIANA (MA)";"MA";"GODOFREDO VIANA";3;1;2;6
2003;"GONCALVES DIAS (MA)";"MA";"GONCALVES DIAS";8;2;2;12
2003;"GOVERNADOR ARCHER (MA)";"MA";"GOVERNADOR ARCHER";9;3;2;14
2003;"GOVERNADOR EDISON LOBAO (MA)";"MA";"GOVERNADOR EDISON LOBAO";12;1;2;15
2003;"GOVERNADOR EUGENIO BARROS (MA)";"MA";"GOVERNADOR EUGENIO BARROS";11;2;4;17
2003;"GOVERNADOR LUIZ ROCHA (MA)";"MA";"GOVERNADOR LUIZ ROCHA";2;1;0;3
2003;"GOVERNADOR NEWTON BELLO (MA)";"MA";"GOVERNADOR NEWTON BELLO";9;0;1;10
2003;"GOVERNADOR NUNES FREIRE (MA)";"MA";"GOVERNADOR NUNES FREIRE";17;2;0;19
2003;"GRACA ARANHA (MA)";"MA";"GRACA ARANHA";10;3;1;14
2003;"GRAJAU (MA)";"MA";"GRAJAU";166;5;8;179
2003;"GUIMARAES (MA)";"MA";"GUIMARAES";5;2;1;8
2003;"HUMBERTO DE CAMPOS (MA)";"MA";"HUMBERTO DE CAMPOS";5;10;3;18
2003;"ICATU (MA)";"MA";"ICATU";6;1;3;10
2003;"IGARAPE DO MEIO (MA)";"MA";"IGARAPE DO MEIO";4;1;2;7
2003;"IGARAPE GRANDE (MA)";"MA";"IGARAPE GRANDE";31;10;5;46
2003;"IMPERATRIZ (MA)";"MA";"IMPERATRIZ";1721;51;222;1994
2003;"ITAIPAVA DO GRAJAU (MA)";"MA";"ITAIPAVA DO GRAJAU";5;1;0;6
2003;"ITAPECURU MIRIM (MA)";"MA";"ITAPECURU MIRIM";125;5;11;141
2003;"ITINGA DO MARANHAO (MA)";"MA";"ITINGA DO MARANHAO";65;5;1;71
2003;"JATOBA (MA)";"MA";"JATOBA";0;2;0;2
2003;"JENIPAPO DOS VIEIRAS (MA)";"MA";"JENIPAPO DOS VIEIRAS";15;0;1;16
2003;"JOAO LISBOA (MA)";"MA";"JOAO LISBOA";51;2;1;54
2003;"JOSELANDIA (MA)";"MA";"JOSELANDIA";23;3;3;29
2003;"JUNCO DO MARANHAO (MA)";"MA";"JUNCO DO MARANHAO";4;11;0;15
2003;"LAGO DA PEDRA (MA)";"MA";"LAGO DA PEDRA";106;9;2;117
2003;"LAGO DO JUNCO (MA)";"MA";"LAGO DO JUNCO";7;1;2;10
2003;"LAGO DOS RODRIGUES (MA)";"MA";"LAGO DOS RODRIGUES";15;2;2;19
2003;"LAGO VERDE (MA)";"MA";"LAGO VERDE";11;0;2;13
2003;"LAGOA DO MATO (MA)";"MA";"LAGOA DO MATO";2;0;1;3
2003;"LAGOA GRANDE DO MARANHAO (MA)";"MA";"LAGOA GRANDE DO MARANHAO";7;2;0;9
2003;"LAJEADO NOVO (MA)";"MA";"LAJEADO NOVO";0;2;0;2
2003;"LIMA CAMPOS (MA)";"MA";"LIMA CAMPOS";26;4;1;31
2003;"LORETO (MA)";"MA";"LORETO";1;1;1;3
2003;"LUIS DOMINGUES (MA)";"MA";"LUIS DOMINGUES";0;0;1;1
2003;"MAGALHAES DE ALMEIDA (MA)";"MA";"MAGALHAES DE ALMEIDA";2;1;1;4
2003;"MARACACUME (MA)";"MA";"MARACACUME";18;11;0;29
2003;"MARAJA DO SENA (MA)";"MA";"MARAJA DO SENA";4;2;0;6
2003;"MARANHAOZINHO (MA)";"MA";"MARANHAOZINHO";5;1;1;7
2003;"MATA ROMA (MA)";"MA";"MATA ROMA";14;1;3;18
2003;"MATINHA (MA)";"MA";"MATINHA";13;4;0;17
2003;"MATOES (MA)";"MA";"MATOES";7;1;3;11
2003;"MATOES DO NORTE (MA)";"MA";"MATOES DO NORTE";6;2;0;8
2003;"MILAGRES DO MARANHAO (MA)";"MA";"MILAGRES DO MARANHAO";3;2;1;6
2003;"MIRADOR (MA)";"MA";"MIRADOR";6;0;1;7
2003;"MIRANDA DO NORTE (MA)";"MA";"MIRANDA DO NORTE";45;3;4;52
2003;"MIRINZAL (MA)";"MA";"MIRINZAL";10;2;2;14
2003;"MONCAO (MA)";"MA";"MONCAO";3;5;1;9
2003;"MONTES ALTOS (MA)";"MA";"MONTES ALTOS";12;0;2;14
2003;"MORROS (MA)";"MA";"MORROS";2;2;2;6
2003;"NINA RODRIGUES (MA)";"MA";"NINA RODRIGUES";4;2;0;6
2003;"NOVA COLINAS (MA)";"MA";"NOVA COLINAS";1;0;1;2
2003;"NOVA IORQUE (MA)";"MA";"NOVA IORQUE";2;0;0;2
2003;"NOVA OLINDA DO MARANHAO (MA)";"MA";"NOVA OLINDA DO MARANHAO";15;11;0;26
2003;"OLHO D AGUA DAS CUNHAS (MA)";"MA";"OLHO D AGUA DAS CUNHAS";31;3;4;38
2003;"OLINDA NOVA DO MARANHAO (MA)";"MA";"OLINDA NOVA DO MARANHAO";6;3;0;9
2003;"PACO DO LUMIAR (MA)";"MA";"PACO DO LUMIAR";124;70;33;227
2003;"PALMEIRANDIA (MA)";"MA";"PALMEIRANDIA";4;1;4;9
2003;"PARAIBANO (MA)";"MA";"PARAIBANO";21;1;1;23
2003;"PARNARAMA (MA)";"MA";"PARNARAMA";11;0;0;11
2003;"PASSAGEM FRANCA (MA)";"MA";"PASSAGEM FRANCA";10;1;0;11
2003;"PASTOS BONS (MA)";"MA";"PASTOS BONS";29;4;1;34
2003;"PAULINO NEVES (MA)";"MA";"PAULINO NEVES";0;0;0;0
2003;"PAULO RAMOS (MA)";"MA";"PAULO RAMOS";33;2;0;35
2003;"PEDREIRAS (MA)";"MA";"PEDREIRAS";217;25;21;263
2003;"PEDRO DO ROSARIO (MA)";"MA";"PEDRO DO ROSARIO";9;0;1;10
2003;"PENALVA (MA)";"MA";"PENALVA";2;6;1;9
2003;"PERI MIRIM (MA)";"MA";"PERI MIRIM";7;5;3;15
2003;"PERITORO (MA)";"MA";"PERITORO";11;20;3;34
2003;"PINDARE MIRIM (MA)";"MA";"PINDARE MIRIM";43;4;10;57
2003;"PINHEIRO (MA)";"MA";"PINHEIRO";185;11;31;227
2003;"PIO XII (MA)";"MA";"PIO XII";47;4;1;52
2003;"PIRAPEMAS (MA)";"MA";"PIRAPEMAS";6;3;1;10
2003;"POCAO DE PEDRAS (MA)";"MA";"POCAO DE PEDRAS";23;5;3;31
2003;"PORTO FRANCO (MA)";"MA";"PORTO FRANCO";20;0;3;23
2003;"PORTO RICO DO MARANHAO (MA)";"MA";"PORTO RICO DO MARANHAO";1;0;1;2
2003;"PRESIDENTE DUTRA (MA)";"MA";"PRESIDENTE DUTRA";141;13;4;158
2003;"PRESIDENTE JUSCELINO (MA)";"MA";"PRESIDENTE JUSCELINO";4;0;1;5
2003;"PRESIDENTE MEDICI (MA)";"MA";"PRESIDENTE MEDICI";1;7;0;8
2003;"PRESIDENTE SARNEY (MA)";"MA";"PRESIDENTE SARNEY";0;0;1;1
2003;"PRESIDENTE VARGAS (MA)";"MA";"PRESIDENTE VARGAS";4;3;0;7
2003;"PRIMEIRA CRUZ (MA)";"MA";"PRIMEIRA CRUZ";0;1;0;1
2003;"RAPOSA (MA)";"MA";"RAPOSA";19;1;18;38
2003;"RIACHAO (MA)";"MA";"RIACHAO";10;1;3;14
2003;"RIBAMAR FIQUENE (MA)";"MA";"RIBAMAR FIQUENE";5;1;1;7
2003;"ROSARIO (MA)";"MA";"ROSARIO";98;5;7;110
2003;"SAMBAIBA (MA)";"MA";"SAMBAIBA";2;0;0;2
2003;"SANTA FILOMENA DO MARANHAO (MA)";"MA";"SANTA FILOMENA DO MARANHAO";3;2;0;5
2003;"SANTA HELENA (MA)";"MA";"SANTA HELENA";25;3;2;30
2003;"SANTA INES (MA)";"MA";"SANTA INES";299;51;55;405
2003;"SANTA LUZIA (MA)";"MA";"SANTA LUZIA";128;63;10;201
2003;"SANTA LUZIA DO PARUA (MA)";"MA";"SANTA LUZIA DO PARUA";43;9;2;54
2003;"SANTA QUITERIA DO MARANHAO (MA)";"MA";"SANTA QUITERIA DO MARANHAO";7;1;4;12
2003;"SANTA RITA (MA)";"MA";"SANTA RITA";38;3;1;42
2003;"SANTANA DO MARANHAO (MA)";"MA";"SANTANA DO MARANHAO";3;1;3;7
2003;"SANTO AMARO DO MARANHAO (MA)";"MA";"SANTO AMARO DO MARANHAO";0;2;0;2
2003;"SANTO ANTONIO DOS LOPES (MA)";"MA";"SANTO ANTONIO DOS LOPES";44;5;0;49
2003;"SAO BENEDITO DO RIO PRETO (MA)";"MA";"SAO BENEDITO DO RIO PRETO";5;5;1;11
2003;"SAO BENTO (MA)";"MA";"SAO BENTO";43;4;4;51
2003;"SAO BERNARDO (MA)";"MA";"SAO BERNARDO";27;0;6;33
2003;"SAO DOMINGOS DO AZEITAO (MA)";"MA";"SAO DOMINGOS DO AZEITAO";8;0;1;9
2003;"SAO DOMINGOS DO MARANHAO (MA)";"MA";"SAO DOMINGOS DO MARANHAO";64;3;1;68
2003;"SAO FELIX DE BALSAS (MA)";"MA";"SAO FELIX DE BALSAS";0;0;0;0
2003;"SAO FRANCISCO DO BREJAO (MA)";"MA";"SAO FRANCISCO DO BREJAO";20;1;1;22
2003;"SAO FRANCISCO DO MARANHAO (MA)";"MA";"SAO FRANCISCO DO MARANHAO";2;0;0;2
2003;"SAO JOAO BATISTA (MA)";"MA";"SAO JOAO BATISTA";14;3;4;21
2003;"SAO JOAO DO CARU (MA)";"MA";"SAO JOAO DO CARU";3;1;0;4
2003;"SAO JOAO DO PARAISO (MA)";"MA";"SAO JOAO DO PARAISO";3;1;0;4
2003;"SAO JOAO DO SOTER (MA)";"MA";"SAO JOAO DO SOTER";6;0;0;6
2003;"SAO JOAO DOS PATOS (MA)";"MA";"SAO JOAO DOS PATOS";60;1;1;62
2003;"SAO JOSE DE RIBAMAR (MA)";"MA";"SAO JOSE DE RIBAMAR";222;58;47;327
2003;"SAO JOSE DOS BASILIOS (MA)";"MA";"SAO JOSE DOS BASILIOS";3;0;1;4
2003;"SAO LUIS (MA)";"MA";"SAO LUIS";4433;647;2117;7197
2003;"SAO LUIS GONZAGA DO MARANHAO (MA)";"MA";"SAO LUIS GONZAGA DO MARANHAO";18;3;2;23
2003;"SAO MATEUS DO MARANHAO (MA)";"MA";"SAO MATEUS DO MARANHAO";53;28;8;89
2003;"SAO PEDRO DA AGUA BRANCA (MA)";"MA";"SAO PEDRO DA AGUA BRANCA";5;0;0;5
2003;"SAO PEDRO DOS CRENTES (MA)";"MA";"SAO PEDRO DOS CRENTES";0;0;0;0
2003;"SAO RAIMUNDO DAS MANGABEIRAS (MA)";"MA";"SAO RAIMUNDO DAS MANGABEIRAS";18;1;10;29
2003;"SAO RAIMUNDO DO DOCA BEZERRA (MA)";"MA";"SAO RAIMUNDO DO DOCA BEZERRA";6;0;0;6
2003;"SAO ROBERTO (MA)";"MA";"SAO ROBERTO";2;2;0;4
2003;"SAO VICENTE FERRER (MA)";"MA";"SAO VICENTE FERRER";11;3;2;16
2003;"SATUBINHA (MA)";"MA";"SATUBINHA";7;1;0;8
2003;"SENADOR ALEXANDRE COSTA (MA)";"MA";"SENADOR ALEXANDRE COSTA";7;1;0;8
2003;"SENADOR LA ROCQUE (MA)";"MA";"SENADOR LA ROCQUE";22;0;1;23
2003;"SERRANO DO MARANHAO (MA)";"MA";"SERRANO DO MARANHAO";0;0;0;0
2003;"SITIO NOVO (MA)";"MA";"SITIO NOVO";11;0;1;12
2003;"SUCUPIRA DO NORTE (MA)";"MA";"SUCUPIRA DO NORTE";7;1;1;9
2003;"SUCUPIRA DO RIACHAO (MA)";"MA";"SUCUPIRA DO RIACHAO";2;1;1;4
2003;"TASSO FRAGOSO (MA)";"MA";"TASSO FRAGOSO";10;1;1;12
2003;"TIMBIRAS (MA)";"MA";"TIMBIRAS";12;2;0;14
2003;"TIMON (MA)";"MA";"TIMON";250;31;29;310
2003;"TRIZIDELA DO VALE (MA)";"MA";"TRIZIDELA DO VALE";45;6;2;53
2003;"TUFILANDIA (MA)";"MA";"TUFILANDIA";2;4;0;6
2003;"TUNTUM (MA)";"MA";"TUNTUM";37;3;4;44
2003;"TURIACU (MA)";"MA";"TURIACU";7;1;1;9
2003;"TURILANDIA (MA)";"MA";"TURILANDIA";4;3;0;7
2003;"TUTOIA (MA)";"MA";"TUTOIA";7;1;3;11
2003;"URBANO SANTOS (MA)";"MA";"URBANO SANTOS";22;2;2;26
2003;"VARGEM GRANDE (MA)";"MA";"VARGEM GRANDE";43;1;2;46
2003;"VIANA (MA)";"MA";"VIANA";67;5;2;74
2003;"VILA NOVA DOS MARTIRIOS (MA)";"MA";"VILA NOVA DOS MARTIRIOS";3;1;0;4
2003;"VITORIA DO MEARIM (MA)";"MA";"VITORIA DO MEARIM";22;8;4;34
2003;"VITORINO FREIRE (MA)";"MA";"VITORINO FREIRE";77;5;3;85
2003;"ZE DOCA (MA)";"MA";"ZE DOCA";89;13;5;107
2003;"ABADIA DOS DOURADOS (MG)";"MG";"ABADIA DOS DOURADOS";67;15;4;86
2003;"ABAETE (MG)";"MG";"ABAETE";315;5;122;442
2003;"ABRE CAMPO (MG)";"MG";"ABRE CAMPO";88;8;34;130
2003;"ACAIACA (MG)";"MG";"ACAIACA";15;2;6;23
2003;"ACUCENA (MG)";"MG";"ACUCENA";23;2;18;43
2003;"AGUA BOA (MG)";"MG";"AGUA BOA";26;0;13;39
2003;"AGUA COMPRIDA (MG)";"MG";"AGUA COMPRIDA";25;5;3;33
2003;"AGUANIL (MG)";"MG";"AGUANIL";21;3;7;31
2003;"AGUAS FORMOSAS (MG)";"MG";"AGUAS FORMOSAS";58;6;8;72
2003;"AGUAS VERMELHAS (MG)";"MG";"AGUAS VERMELHAS";51;4;10;65
2003;"AIMORES (MG)";"MG";"AIMORES";136;6;17;159
2003;"AIURUOCA (MG)";"MG";"AIURUOCA";67;4;0;71
2003;"ALAGOA (MG)";"MG";"ALAGOA";11;0;6;17
2003;"ALBERTINA (MG)";"MG";"ALBERTINA";28;1;3;32
2003;"ALEM PARAIBA (MG)";"MG";"ALEM PARAIBA";1059;32;45;1136
2003;"ALFENAS (MG)";"MG";"ALFENAS";781;36;120;937
2003;"ALFREDO VASCONCELOS (MG)";"MG";"ALFREDO VASCONCELOS";89;5;12;106
2003;"ALMENARA (MG)";"MG";"ALMENARA";128;11;48;187
2003;"ALPERCATA (MG)";"MG";"ALPERCATA";28;1;4;33
2003;"ALPINOPOLIS (MG)";"MG";"ALPINOPOLIS";309;7;21;337
2003;"ALTEROSA (MG)";"MG";"ALTEROSA";161;4;17;182
2003;"ALTO CAPARAO (MG)";"MG";"ALTO CAPARAO";39;4;2;45
2003;"ALTO JEQUITIBA (MG)";"MG";"ALTO JEQUITIBA";51;1;5;57
2003;"ALTO RIO DOCE (MG)";"MG";"ALTO RIO DOCE";59;5;12;76
2003;"ALVARENGA (MG)";"MG";"ALVARENGA";12;0;4;16
2003;"ALVINOPOLIS (MG)";"MG";"ALVINOPOLIS";97;8;17;122
2003;"ALVORADA DE MINAS (MG)";"MG";"ALVORADA DE MINAS";3;1;6;10
2003;"AMPARO DA SERRA (MG)";"MG";"AMPARO DA SERRA";21;1;7;29
2003;"ANDRADAS (MG)";"MG";"ANDRADAS";782;40;48;870
2003;"ANDRELANDIA (MG)";"MG";"ANDRELANDIA";97;5;3;105
2003;"ANGELANDIA (MG)";"MG";"ANGELANDIA";26;0;7;33
2003;"ANTONIO CARLOS (MG)";"MG";"ANTONIO CARLOS";93;5;7;105
2003;"ANTONIO DIAS (MG)";"MG";"ANTONIO DIAS";39;4;32;75
2003;"ANTONIO PRADO DE MINAS (MG)";"MG";"ANTONIO PRADO DE MINAS";8;0;3;11
2003;"ARACAI (MG)";"MG";"ARACAI";9;1;5;15
2003;"ARACITABA (MG)";"MG";"ARACITABA";10;2;1;13
2003;"ARACUAI (MG)";"MG";"ARACUAI";132;8;43;183
2003;"ARAGUARI (MG)";"MG";"ARAGUARI";1482;173;166;1821
2003;"ARANTINA (MG)";"MG";"ARANTINA";21;0;2;23
2003;"ARAPONGA (MG)";"MG";"ARAPONGA";25;0;7;32
2003;"ARAPORA (MG)";"MG";"ARAPORA";131;6;34;171
2003;"ARAPUA (MG)";"MG";"ARAPUA";27;1;9;37
2003;"ARAUJOS (MG)";"MG";"ARAUJOS";79;3;2;84
2003;"ARAXA (MG)";"MG";"ARAXA";1148;62;186;1396
2003;"ARCEBURGO (MG)";"MG";"ARCEBURGO";81;10;22;113
2003;"ARCOS (MG)";"MG";"ARCOS";699;23;78;800
2003;"AREADO (MG)";"MG";"AREADO";159;6;40;205
2003;"ARGIRITA (MG)";"MG";"ARGIRITA";14;2;2;18
2003;"ARICANDUVA (MG)";"MG";"ARICANDUVA";6;0;8;14
2003;"ARINOS (MG)";"MG";"ARINOS";82;5;29;116
2003;"ASTOLFO DUTRA (MG)";"MG";"ASTOLFO DUTRA";158;7;11;176
2003;"ATALEIA (MG)";"MG";"ATALEIA";52;8;12;72
2003;"AUGUSTO DE LIMA (MG)";"MG";"AUGUSTO DE LIMA";21;1;10;32
2003;"BAEPENDI (MG)";"MG";"BAEPENDI";279;12;15;306
2003;"BALDIM (MG)";"MG";"BALDIM";67;4;5;76
2003;"BAMBUI (MG)";"MG";"BAMBUI";316;8;61;385
2003;"BANDEIRA (MG)";"MG";"BANDEIRA";2;3;1;6
2003;"BANDEIRA DO SUL (MG)";"MG";"BANDEIRA DO SUL";97;14;3;114
2003;"BARAO DE COCAIS (MG)";"MG";"BARAO DE COCAIS";226;18;50;294
2003;"BARAO DE MONTE ALTO (MG)";"MG";"BARAO DE MONTE ALTO";10;6;3;19
2003;"BARBACENA (MG)";"MG";"BARBACENA";1259;166;152;1577
2003;"BARRA LONGA (MG)";"MG";"BARRA LONGA";35;1;4;40
2003;"BARROSO (MG)";"MG";"BARROSO";272;10;8;290
2003;"BELA VISTA DE MINAS (MG)";"MG";"BELA VISTA DE MINAS";70;12;7;89
2003;"BELMIRO BRAGA (MG)";"MG";"BELMIRO BRAGA";42;2;4;48
2003;"BELO HORIZONTE (MG)";"MG";"BELO HORIZONTE";23976;2752;5802;32530
2003;"BELO ORIENTE (MG)";"MG";"BELO ORIENTE";162;8;51;221
2003;"BELO VALE (MG)";"MG";"BELO VALE";50;4;12;66
2003;"BERILO (MG)";"MG";"BERILO";40;1;24;65
2003;"BERIZAL (MG)";"MG";"BERIZAL";1;1;3;5
2003;"BERTOPOLIS (MG)";"MG";"BERTOPOLIS";7;0;1;8
2003;"BETIM (MG)";"MG";"BETIM";2185;341;579;3105
2003;"BIAS FORTES (MG)";"MG";"BIAS FORTES";24;1;2;27
2003;"BICAS (MG)";"MG";"BICAS";168;11;15;194
2003;"BIQUINHAS (MG)";"MG";"BIQUINHAS";25;5;2;32
2003;"BOA ESPERANCA (MG)";"MG";"BOA ESPERANCA";405;12;87;504
2003;"BOCAINA DE MINAS (MG)";"MG";"BOCAINA DE MINAS";34;4;5;43
2003;"BOCAIUVA (MG)";"MG";"BOCAIUVA";231;10;45;286
2003;"BOM DESPACHO (MG)";"MG";"BOM DESPACHO";693;19;104;816
2003;"BOM JARDIM DE MINAS (MG)";"MG";"BOM JARDIM DE MINAS";65;8;10;83
2003;"BOM JESUS DA PENHA (MG)";"MG";"BOM JESUS DA PENHA";72;1;5;78
2003;"BOM JESUS DO AMPARO (MG)";"MG";"BOM JESUS DO AMPARO";38;2;4;44
2003;"BOM JESUS DO GALHO (MG)";"MG";"BOM JESUS DO GALHO";62;5;9;76
2003;"BOM REPOUSO (MG)";"MG";"BOM REPOUSO";142;2;5;149
2003;"BOM SUCESSO (MG)";"MG";"BOM SUCESSO";205;5;24;234
2003;"BONFIM (MG)";"MG";"BONFIM";66;3;12;81
2003;"BONFINOPOLIS DE MINAS (MG)";"MG";"BONFINOPOLIS DE MINAS";53;1;13;67
2003;"BONITO DE MINAS (MG)";"MG";"BONITO DE MINAS";12;2;7;21
2003;"BORDA DA MATA (MG)";"MG";"BORDA DA MATA";212;8;43;263
2003;"BOTELHOS (MG)";"MG";"BOTELHOS";192;24;21;237
2003;"BOTUMIRIM (MG)";"MG";"BOTUMIRIM";2;1;4;7
2003;"BRAS PIRES (MG)";"MG";"BRAS PIRES";26;5;3;34
2003;"BRASILANDIA DE MINAS (MG)";"MG";"BRASILANDIA DE MINAS";137;2;53;192
2003;"BRASILIA DE MINAS (MG)";"MG";"BRASILIA DE MINAS";110;4;48;162
2003;"BRASOPOLIS (MG)";"MG";"BRASOPOLIS";143;8;21;172
2003;"BRAUNAS (MG)";"MG";"BRAUNAS";5;2;6;13
2003;"BRUMADINHO (MG)";"MG";"BRUMADINHO";455;48;64;567
2003;"BUENO BRANDAO (MG)";"MG";"BUENO BRANDAO";119;9;12;140
2003;"BUENOPOLIS (MG)";"MG";"BUENOPOLIS";69;1;12;82
2003;"BUGRE (MG)";"MG";"BUGRE";11;0;5;16
2003;"BURITIS (MG)";"MG";"BURITIS";206;3;56;265
2003;"BURITIZEIRO (MG)";"MG";"BURITIZEIRO";110;3;24;137
2003;"CABECEIRA GRANDE (MG)";"MG";"CABECEIRA GRANDE";19;4;8;31
2003;"CABO VERDE (MG)";"MG";"CABO VERDE";138;7;15;160
2003;"CACHOEIRA DA PRATA (MG)";"MG";"CACHOEIRA DA PRATA";41;6;2;49
2003;"CACHOEIRA DE MINAS (MG)";"MG";"CACHOEIRA DE MINAS";96;16;8;120
2003;"CACHOEIRA DE PAJEU (MG)";"MG";"CACHOEIRA DE PAJEU";29;5;9;43
2003;"CACHOEIRA DOURADA (MG)";"MG";"CACHOEIRA DOURADA";13;5;3;21
2003;"CAETANOPOLIS (MG)";"MG";"CAETANOPOLIS";58;6;20;84
2003;"CAETE (MG)";"MG";"CAETE";333;36;48;417
2003;"CAIANA (MG)";"MG";"CAIANA";23;0;6;29
2003;"CAJURI (MG)";"MG";"CAJURI";25;2;6;33
2003;"CALDAS (MG)";"MG";"CALDAS";178;9;16;203
2003;"CAMACHO (MG)";"MG";"CAMACHO";42;3;4;49
2003;"CAMANDUCAIA (MG)";"MG";"CAMANDUCAIA";385;19;26;430
2003;"CAMBUI (MG)";"MG";"CAMBUI";361;12;77;450
2003;"CAMBUQUIRA (MG)";"MG";"CAMBUQUIRA";91;12;9;112
2003;"CAMPANARIO (MG)";"MG";"CAMPANARIO";5;2;2;9
2003;"CAMPANHA (MG)";"MG";"CAMPANHA";158;7;15;180
2003;"CAMPESTRE (MG)";"MG";"CAMPESTRE";313;16;31;360
2003;"CAMPINA VERDE (MG)";"MG";"CAMPINA VERDE";224;13;28;265
2003;"CAMPO AZUL (MG)";"MG";"CAMPO AZUL";2;0;4;6
2003;"CAMPO BELO (MG)";"MG";"CAMPO BELO";857;21;97;975
2003;"CAMPO DO MEIO (MG)";"MG";"CAMPO DO MEIO";76;4;39;119
2003;"CAMPO FLORIDO (MG)";"MG";"CAMPO FLORIDO";75;6;23;104
2003;"CAMPOS ALTOS (MG)";"MG";"CAMPOS ALTOS";237;11;30;278
2003;"CAMPOS GERAIS (MG)";"MG";"CAMPOS GERAIS";202;8;33;243
2003;"CANA VERDE (MG)";"MG";"CANA VERDE";42;5;4;51
2003;"CANAA (MG)";"MG";"CANAA";34;1;5;40
2003;"CANAPOLIS (MG)";"MG";"CANAPOLIS";175;6;68;249
2003;"CANDEIAS (MG)";"MG";"CANDEIAS";169;8;18;195
2003;"CANTAGALO (MG)";"MG";"CANTAGALO";5;0;2;7
2003;"CAPARAO (MG)";"MG";"CAPARAO";30;1;3;34
2003;"CAPELA NOVA (MG)";"MG";"CAPELA NOVA";12;6;2;20
2003;"CAPELINHA (MG)";"MG";"CAPELINHA";350;7;71;428
2003;"CAPETINGA (MG)";"MG";"CAPETINGA";136;5;26;167
2003;"CAPIM BRANCO (MG)";"MG";"CAPIM BRANCO";48;6;9;63
2003;"CAPINOPOLIS (MG)";"MG";"CAPINOPOLIS";205;14;24;243
2003;"CAPITAO ANDRADE (MG)";"MG";"CAPITAO ANDRADE";14;1;2;17
2003;"CAPITAO ENEAS (MG)";"MG";"CAPITAO ENEAS";38;0;11;49
2003;"CAPITOLIO (MG)";"MG";"CAPITOLIO";118;9;9;136
2003;"CAPUTIRA (MG)";"MG";"CAPUTIRA";48;5;15;68
2003;"CARAI (MG)";"MG";"CARAI";27;10;18;55
2003;"CARANAIBA (MG)";"MG";"CARANAIBA";10;0;5;15
2003;"CARANDAI (MG)";"MG";"CARANDAI";349;13;63;425
2003;"CARANGOLA (MG)";"MG";"CARANGOLA";274;20;31;325
2003;"CARATINGA (MG)";"MG";"CARATINGA";902;22;1266;2190
2003;"CARBONITA (MG)";"MG";"CARBONITA";102;2;30;134
2003;"CAREACU (MG)";"MG";"CAREACU";57;4;4;65
2003;"CARLOS CHAGAS (MG)";"MG";"CARLOS CHAGAS";111;10;25;146
2003;"CARMESIA (MG)";"MG";"CARMESIA";31;6;826;863
2003;"CARMO DA CACHOEIRA (MG)";"MG";"CARMO DA CACHOEIRA";115;6;30;151
2003;"CARMO DA MATA (MG)";"MG";"CARMO DA MATA";85;8;25;118
2003;"CARMO DE MINAS (MG)";"MG";"CARMO DE MINAS";80;9;9;98
2003;"CARMO DO CAJURU (MG)";"MG";"CARMO DO CAJURU";203;7;40;250
2003;"CARMO DO PARANAIBA (MG)";"MG";"CARMO DO PARANAIBA";433;16;70;519
2003;"CARMO DO RIO CLARO (MG)";"MG";"CARMO DO RIO CLARO";237;17;53;307
2003;"CARMOPOLIS DE MINAS (MG)";"MG";"CARMOPOLIS DE MINAS";353;3;25;381
2003;"CARNEIRINHO (MG)";"MG";"CARNEIRINHO";120;20;37;177
2003;"CARRANCAS (MG)";"MG";"CARRANCAS";35;3;10;48
2003;"CARVALHOPOLIS (MG)";"MG";"CARVALHOPOLIS";31;7;1;39
2003;"CARVALHOS (MG)";"MG";"CARVALHOS";30;1;3;34
2003;"CASA GRANDE (MG)";"MG";"CASA GRANDE";18;1;0;19
2003;"CASCALHO RICO (MG)";"MG";"CASCALHO RICO";41;9;3;53
2003;"CASSIA (MG)";"MG";"CASSIA";327;11;22;360
2003;"CATAGUASES (MG)";"MG";"CATAGUASES";549;29;107;685
2003;"CATAS ALTAS (MG)";"MG";"CATAS ALTAS";70;9;4;83
2003;"CATAS ALTAS DA NORUEGA (MG)";"MG";"CATAS ALTAS DA NORUEGA";23;0;5;28
2003;"CATUJI (MG)";"MG";"CATUJI";18;5;3;26
2003;"CATUTI (MG)";"MG";"CATUTI";2;2;10;14
2003;"CAXAMBU (MG)";"MG";"CAXAMBU";162;17;18;197
2003;"CEDRO DO ABAETE (MG)";"MG";"CEDRO DO ABAETE";9;1;1;11
2003;"CENTRAL DE MINAS (MG)";"MG";"CENTRAL DE MINAS";47;3;9;59
2003;"CENTRALINA (MG)";"MG";"CENTRALINA";98;1;11;110
2003;"CHACARA (MG)";"MG";"CHACARA";20;3;1;24
2003;"CHALE (MG)";"MG";"CHALE";25;4;4;33
2003;"CHAPADA DO NORTE (MG)";"MG";"CHAPADA DO NORTE";22;6;11;39
2003;"CHAPADA GAUCHA (MG)";"MG";"CHAPADA GAUCHA";28;3;4;35
2003;"CHIADOR (MG)";"MG";"CHIADOR";20;1;5;26
2003;"CIPOTANEA (MG)";"MG";"CIPOTANEA";25;2;6;33
2003;"CLARAVAL (MG)";"MG";"CLARAVAL";222;3;18;243
2003;"CLARO DOS POCOES (MG)";"MG";"CLARO DOS POCOES";7;0;7;14
2003;"CLAUDIO (MG)";"MG";"CLAUDIO";432;14;33;479
2003;"COIMBRA (MG)";"MG";"COIMBRA";71;1;7;79
2003;"COLUNA (MG)";"MG";"COLUNA";14;1;9;24
2003;"COMENDADOR GOMES (MG)";"MG";"COMENDADOR GOMES";26;2;4;32
2003;"COMERCINHO (MG)";"MG";"COMERCINHO";16;1;7;24
2003;"CONCEICAO DA APARECIDA (MG)";"MG";"CONCEICAO DA APARECIDA";95;2;6;103
2003;"CONCEICAO DA BARRA DE MINAS (MG)";"MG";"CONCEICAO DA BARRA DE MINAS";22;2;3;27
2003;"CONCEICAO DAS ALAGOAS (MG)";"MG";"CONCEICAO DAS ALAGOAS";353;13;40;406
2003;"CONCEICAO DAS PEDRAS (MG)";"MG";"CONCEICAO DAS PEDRAS";17;3;2;22
2003;"CONCEICAO DE IPANEMA (MG)";"MG";"CONCEICAO DE IPANEMA";18;4;2;24
2003;"CONCEICAO DO MATO DENTRO (MG)";"MG";"CONCEICAO DO MATO DENTRO";67;4;27;98
2003;"CONCEICAO DO PARA (MG)";"MG";"CONCEICAO DO PARA";38;6;9;53
2003;"CONCEICAO DO RIO VERDE (MG)";"MG";"CONCEICAO DO RIO VERDE";149;17;11;177
2003;"CONCEICAO DOS OUROS (MG)";"MG";"CONCEICAO DOS OUROS";161;16;2;179
2003;"CONEGO MARINHO (MG)";"MG";"CONEGO MARINHO";4;3;3;10
2003;"CONFINS (MG)";"MG";"CONFINS";74;7;3;84
2003;"CONGONHAL (MG)";"MG";"CONGONHAL";148;3;9;160
2003;"CONGONHAS (MG)";"MG";"CONGONHAS";476;49;71;596
2003;"CONGONHAS DO NORTE (MG)";"MG";"CONGONHAS DO NORTE";13;2;1;16
2003;"CONQUISTA (MG)";"MG";"CONQUISTA";137;7;21;165
2003;"CONSELHEIRO LAFAIETE (MG)";"MG";"CONSELHEIRO LAFAIETE";895;110;296;1301
2003;"CONSELHEIRO PENA (MG)";"MG";"CONSELHEIRO PENA";160;4;37;201
2003;"CONSOLACAO (MG)";"MG";"CONSOLACAO";8;2;0;10
2003;"CONTAGEM (MG)";"MG";"CONTAGEM";8218;625;1462;10305
2003;"COQUEIRAL (MG)";"MG";"COQUEIRAL";70;3;10;83
2003;"CORACAO DE JESUS (MG)";"MG";"CORACAO DE JESUS";103;1;72;176
2003;"CORDISBURGO (MG)";"MG";"CORDISBURGO";53;2;7;62
2003;"CORDISLANDIA (MG)";"MG";"CORDISLANDIA";30;2;2;34
2003;"CORINTO (MG)";"MG";"CORINTO";197;1;43;241
2003;"COROACI (MG)";"MG";"COROACI";15;1;5;21
2003;"COROMANDEL (MG)";"MG";"COROMANDEL";387;11;65;463
2003;"CORONEL FABRICIANO (MG)";"MG";"CORONEL FABRICIANO";748;87;286;1121
2003;"CORONEL MURTA (MG)";"MG";"CORONEL MURTA";7;0;5;12
2003;"CORONEL PACHECO (MG)";"MG";"CORONEL PACHECO";23;5;5;33
2003;"CORONEL XAVIER CHAVES (MG)";"MG";"CORONEL XAVIER CHAVES";66;1;2;69
2003;"CORREGO DANTA (MG)";"MG";"CORREGO DANTA";23;2;5;30
2003;"CORREGO DO BOM JESUS (MG)";"MG";"CORREGO DO BOM JESUS";26;3;6;35
2003;"CORREGO FUNDO (MG)";"MG";"CORREGO FUNDO";227;5;13;245
2003;"CORREGO NOVO (MG)";"MG";"CORREGO NOVO";9;1;3;13
2003;"COUTO DE MAGALHAES DE MINAS (MG)";"MG";"COUTO DE MAGALHAES DE MINAS";29;0;6;35
2003;"CRISOLITA (MG)";"MG";"CRISOLITA";6;2;5;13
2003;"CRISTAIS (MG)";"MG";"CRISTAIS";97;4;8;109
2003;"CRISTALIA (MG)";"MG";"CRISTALIA";7;0;8;15
2003;"CRISTIANO OTONI (MG)";"MG";"CRISTIANO OTONI";68;4;7;79
2003;"CRISTINA (MG)";"MG";"CRISTINA";73;9;10;92
2003;"CRUCILANDIA (MG)";"MG";"CRUCILANDIA";71;2;6;79
2003;"CRUZEIRO DA FORTALEZA (MG)";"MG";"CRUZEIRO DA FORTALEZA";39;2;2;43
2003;"CRUZILIA (MG)";"MG";"CRUZILIA";239;7;8;254
2003;"CUPARAQUE (MG)";"MG";"CUPARAQUE";31;4;4;39
2003;"CURRAL DE DENTRO (MG)";"MG";"CURRAL DE DENTRO";28;4;2;34
2003;"CURVELO (MG)";"MG";"CURVELO";730;14;131;875
2003;"DATAS (MG)";"MG";"DATAS";13;2;7;22
2003;"DELFIM MOREIRA (MG)";"MG";"DELFIM MOREIRA";60;2;12;74
2003;"DELFINOPOLIS (MG)";"MG";"DELFINOPOLIS";60;10;4;74
2003;"DELTA (MG)";"MG";"DELTA";249;10;69;328
2003;"DESCOBERTO (MG)";"MG";"DESCOBERTO";28;2;1;31
2003;"DESTERRO DE ENTRE RIOS (MG)";"MG";"DESTERRO DE ENTRE RIOS";59;4;13;76
2003;"DESTERRO DO MELO (MG)";"MG";"DESTERRO DO MELO";18;2;6;26
2003;"DIAMANTINA (MG)";"MG";"DIAMANTINA";222;27;171;420
2003;"DIOGO DE VASCONCELOS (MG)";"MG";"DIOGO DE VASCONCELOS";11;1;5;17
2003;"DIONISIO (MG)";"MG";"DIONISIO";33;3;12;48
2003;"DIVINESIA (MG)";"MG";"DIVINESIA";24;3;2;29
2003;"DIVINO (MG)";"MG";"DIVINO";194;7;20;221
2003;"DIVINO DAS LARANJEIRAS (MG)";"MG";"DIVINO DAS LARANJEIRAS";19;0;4;23
2003;"DIVINOLANDIA DE MINAS (MG)";"MG";"DIVINOLANDIA DE MINAS";25;3;10;38
2003;"DIVINOPOLIS (MG)";"MG";"DIVINOPOLIS";2420;134;570;3124
2003;"DIVISA ALEGRE (MG)";"MG";"DIVISA ALEGRE";35;0;3;38
2003;"DIVISA NOVA (MG)";"MG";"DIVISA NOVA";38;5;9;52
2003;"DIVISOPOLIS (MG)";"MG";"DIVISOPOLIS";8;5;3;16
2003;"DOM BOSCO (MG)";"MG";"DOM BOSCO";9;2;7;18
2003;"DOM CAVATI (MG)";"MG";"DOM CAVATI";96;2;2;100
2003;"DOM JOAQUIM (MG)";"MG";"DOM JOAQUIM";5;2;5;12
2003;"DOM SILVERIO (MG)";"MG";"DOM SILVERIO";40;5;3;48
2003;"DOM VICOSO (MG)";"MG";"DOM VICOSO";15;11;5;31
2003;"DONA EUZEBIA (MG)";"MG";"DONA EUZEBIA";231;2;2;235
2003;"DORES DE CAMPOS (MG)";"MG";"DORES DE CAMPOS";48;4;14;66
2003;"DORES DE GUANHAES (MG)";"MG";"DORES DE GUANHAES";42;0;12;54
2003;"DORES DO INDAIA (MG)";"MG";"DORES DO INDAIA";183;8;6;197
2003;"DORES DO TURVO (MG)";"MG";"DORES DO TURVO";24;2;11;37
2003;"DORESOPOLIS (MG)";"MG";"DORESOPOLIS";7;6;1;14
2003;"DOURADOQUARA (MG)";"MG";"DOURADOQUARA";17;5;0;22
2003;"DURANDE (MG)";"MG";"DURANDE";44;1;9;54
2003;"ELOI MENDES (MG)";"MG";"ELOI MENDES";360;18;21;399
2003;"ENGENHEIRO CALDAS (MG)";"MG";"ENGENHEIRO CALDAS";86;4;2;92
2003;"ENGENHEIRO NAVARRO (MG)";"MG";"ENGENHEIRO NAVARRO";25;0;11;36
2003;"ENTRE RIOS DE MINAS (MG)";"MG";"ENTRE RIOS DE MINAS";157;9;24;190
2003;"ENTRE FOLHAS (MG)";"MG";"ENTRE FOLHAS";48;2;1;51
2003;"ERVALIA (MG)";"MG";"ERVALIA";180;4;17;201
2003;"ESMERALDAS (MG)";"MG";"ESMERALDAS";244;7;108;359
2003;"ESPERA FELIZ (MG)";"MG";"ESPERA FELIZ";226;14;21;261
2003;"ESPINOSA (MG)";"MG";"ESPINOSA";238;5;32;275
2003;"ESPIRITO SANTO DO DOURADO (MG)";"MG";"ESPIRITO SANTO DO DOURADO";49;0;4;53
2003;"ESTIVA (MG)";"MG";"ESTIVA";210;1;11;222
2003;"ESTRELA DALVA (MG)";"MG";"ESTRELA DALVA";20;1;0;21
2003;"ESTRELA DO INDAIA (MG)";"MG";"ESTRELA DO INDAIA";32;3;2;37
2003;"ESTRELA DO SUL (MG)";"MG";"ESTRELA DO SUL";66;2;10;78
2003;"EUGENOPOLIS (MG)";"MG";"EUGENOPOLIS";46;6;10;62
2003;"EWBANK DA CAMARA (MG)";"MG";"EWBANK DA CAMARA";32;1;4;37
2003;"EXTREMA (MG)";"MG";"EXTREMA";326;29;37;392
2003;"FAMA (MG)";"MG";"FAMA";6;5;1;12
2003;"FARIA LEMOS (MG)";"MG";"FARIA LEMOS";15;4;0;19
2003;"FELICIO DOS SANTOS (MG)";"MG";"FELICIO DOS SANTOS";10;5;11;26
2003;"FELISBURGO (MG)";"MG";"FELISBURGO";8;3;4;15
2003;"FELIXLANDIA (MG)";"MG";"FELIXLANDIA";132;3;31;166
2003;"FERNANDES TOURINHO (MG)";"MG";"FERNANDES TOURINHO";5;1;4;10
2003;"FERROS (MG)";"MG";"FERROS";55;2;22;79
2003;"FERVEDOURO (MG)";"MG";"FERVEDOURO";45;4;5;54
2003;"FLORESTAL (MG)";"MG";"FLORESTAL";43;2;12;57
2003;"FORMIGA (MG)";"MG";"FORMIGA";1081;33;178;1292
2003;"FORMOSO (MG)";"MG";"FORMOSO";26;0;12;38
2003;"FORTALEZA DE MINAS (MG)";"MG";"FORTALEZA DE MINAS";46;5;4;55
2003;"FORTUNA DE MINAS (MG)";"MG";"FORTUNA DE MINAS";14;3;5;22
2003;"FRANCISCO BADARO (MG)";"MG";"FRANCISCO BADARO";23;1;10;34
2003;"FRANCISCO DUMONT (MG)";"MG";"FRANCISCO DUMONT";24;1;12;37
2003;"FRANCISCO SA (MG)";"MG";"FRANCISCO SA";78;3;24;105
2003;"FRANCISCOPOLIS (MG)";"MG";"FRANCISCOPOLIS";7;1;2;10
2003;"FREI GASPAR (MG)";"MG";"FREI GASPAR";10;0;5;15
2003;"FREI INOCENCIO (MG)";"MG";"FREI INOCENCIO";125;5;13;143
2003;"FREI LAGONEGRO (MG)";"MG";"FREI LAGONEGRO";3;2;1;6
2003;"FRONTEIRA (MG)";"MG";"FRONTEIRA";195;15;30;240
2003;"FRONTEIRA DOS VALES (MG)";"MG";"FRONTEIRA DOS VALES";5;1;1;7
2003;"FRUTA DE LEITE (MG)";"MG";"FRUTA DE LEITE";12;1;12;25
2003;"FRUTAL (MG)";"MG";"FRUTAL";1051;51;96;1198
2003;"FUNILANDIA (MG)";"MG";"FUNILANDIA";25;1;7;33
2003;"GALILEIA (MG)";"MG";"GALILEIA";45;0;6;51
2003;"GAMELEIRAS (MG)";"MG";"GAMELEIRAS";15;0;8;23
2003;"GLAUCILANDIA (MG)";"MG";"GLAUCILANDIA";1;1;3;5
2003;"GOIABEIRA (MG)";"MG";"GOIABEIRA";15;5;3;23
2003;"GOIANA (MG)";"MG";"GOIANA";11;3;1;15
2003;"GONCALVES (MG)";"MG";"GONCALVES";53;12;4;69
2003;"GONZAGA (MG)";"MG";"GONZAGA";16;1;3;20
2003;"GOUVEA (MG)";"MG";"GOUVEA";92;3;14;109
2003;"GOVERNADOR VALADARES (MG)";"MG";"GOVERNADOR VALADARES";2392;147;285;2824
2003;"GRAO MOGOL (MG)";"MG";"GRAO MOGOL";31;0;36;67
2003;"GRUPIARA (MG)";"MG";"GRUPIARA";8;0;1;9
2003;"GUANHAES (MG)";"MG";"GUANHAES";268;21;77;366
2003;"GUAPE (MG)";"MG";"GUAPE";123;5;29;157
2003;"GUARACIABA (MG)";"MG";"GUARACIABA";41;2;14;57
2003;"GUARACIAMA (MG)";"MG";"GUARACIAMA";9;0;5;14
2003;"GUARANESIA (MG)";"MG";"GUARANESIA";235;11;57;303
2003;"GUARANI (MG)";"MG";"GUARANI";80;5;8;93
2003;"GUARARA (MG)";"MG";"GUARARA";38;8;1;47
2003;"GUARDA MOR (MG)";"MG";"GUARDA MOR";58;8;8;74
2003;"GUAXUPE (MG)";"MG";"GUAXUPE";627;33;70;730
2003;"GUIDOVAL (MG)";"MG";"GUIDOVAL";87;0;3;90
2003;"GUIMARANIA (MG)";"MG";"GUIMARANIA";102;3;10;115
2003;"GUIRICEMA (MG)";"MG";"GUIRICEMA";137;4;12;153
2003;"GURINHATA (MG)";"MG";"GURINHATA";75;4;12;91
2003;"HELIODORA (MG)";"MG";"HELIODORA";42;3;5;50
2003;"IAPU (MG)";"MG";"IAPU";79;7;11;97
2003;"IBERTIOGA (MG)";"MG";"IBERTIOGA";31;5;1;37
2003;"IBIA (MG)";"MG";"IBIA";286;14;48;348
2003;"IBIAI (MG)";"MG";"IBIAI";41;1;3;45
2003;"IBIRACATU (MG)";"MG";"IBIRACATU";3;2;4;9
2003;"IBIRACI (MG)";"MG";"IBIRACI";249;16;24;289
2003;"IBIRITE (MG)";"MG";"IBIRITE";519;56;166;741
2003;"IBITIURA DE MINAS (MG)";"MG";"IBITIURA DE MINAS";59;1;2;62
2003;"IBITURUNA (MG)";"MG";"IBITURUNA";20;3;1;24
2003;"ICARAI DE MINAS (MG)";"MG";"ICARAI DE MINAS";6;2;1;9
2003;"IGARAPE (MG)";"MG";"IGARAPE";425;23;83;531
2003;"IGARATINGA (MG)";"MG";"IGARATINGA";199;5;9;213
2003;"IGUATAMA (MG)";"MG";"IGUATAMA";105;3;14;122
2003;"IJACI (MG)";"MG";"IJACI";79;2;7;88
2003;"ILICINEA (MG)";"MG";"ILICINEA";134;3;21;158
2003;"IMBE DE MINAS (MG)";"MG";"IMBE DE MINAS";23;1;4;28
2003;"INCONFIDENTES (MG)";"MG";"INCONFIDENTES";66;6;7;79
2003;"INDAIABIRA (MG)";"MG";"INDAIABIRA";19;4;14;37
2003;"INDIANOPOLIS (MG)";"MG";"INDIANOPOLIS";40;19;10;69
2003;"INGAI (MG)";"MG";"INGAI";14;4;2;20
2003;"INHAPIM (MG)";"MG";"INHAPIM";188;6;33;227
2003;"INHAUMA (MG)";"MG";"INHAUMA";51;2;10;63
2003;"INIMUTABA (MG)";"MG";"INIMUTABA";12;3;3;18
2003;"IPABA (MG)";"MG";"IPABA";37;5;14;56
2003;"IPANEMA (MG)";"MG";"IPANEMA";134;7;16;157
2003;"IPATINGA (MG)";"MG";"IPATINGA";2138;291;387;2816
2003;"IPIACU (MG)";"MG";"IPIACU";36;3;4;43
2003;"IPUIUNA (MG)";"MG";"IPUIUNA";274;10;7;291
2003;"IRAI DE MINAS (MG)";"MG";"IRAI DE MINAS";137;10;12;159
2003;"ITABIRA (MG)";"MG";"ITABIRA";889;92;211;1192
2003;"ITABIRINHA DE MANTENA (MG)";"MG";"ITABIRINHA DE MANTENA";76;1;15;92
2003;"ITABIRITO (MG)";"MG";"ITABIRITO";525;37;125;687
2003;"ITACAMBIRA (MG)";"MG";"ITACAMBIRA";8;0;5;13
2003;"ITACARAMBI (MG)";"MG";"ITACARAMBI";51;4;15;70
2003;"ITAGUARA (MG)";"MG";"ITAGUARA";264;4;26;294
2003;"ITAIPE (MG)";"MG";"ITAIPE";31;3;10;44
2003;"ITAJUBA (MG)";"MG";"ITAJUBA";755;68;124;947
2003;"ITAMARANDIBA (MG)";"MG";"ITAMARANDIBA";306;7;50;363
2003;"ITAMARATI DE MINAS (MG)";"MG";"ITAMARATI DE MINAS";54;4;6;64
2003;"ITAMBACURI (MG)";"MG";"ITAMBACURI";114;4;23;141
2003;"ITAMBE DO MATO DENTRO (MG)";"MG";"ITAMBE DO MATO DENTRO";11;1;2;14
2003;"ITAMOGI (MG)";"MG";"ITAMOGI";156;8;17;181
2003;"ITAMONTE (MG)";"MG";"ITAMONTE";219;14;20;253
2003;"ITANHANDU (MG)";"MG";"ITANHANDU";223;18;21;262
2003;"ITANHOMI (MG)";"MG";"ITANHOMI";65;0;12;77
2003;"ITAOBIM (MG)";"MG";"ITAOBIM";143;13;17;173
2003;"ITAPAGIPE (MG)";"MG";"ITAPAGIPE";185;1;14;200
2003;"ITAPECERICA (MG)";"MG";"ITAPECERICA";231;11;46;288
2003;"ITAPEVA (MG)";"MG";"ITAPEVA";187;3;5;195
2003;"ITATIAIUCU (MG)";"MG";"ITATIAIUCU";172;7;11;190
2003;"ITAU DE MINAS (MG)";"MG";"ITAU DE MINAS";256;8;27;291
2003;"ITAUNA (MG)";"MG";"ITAUNA";1038;56;143;1237
2003;"ITAVERAVA (MG)";"MG";"ITAVERAVA";23;0;6;29
2003;"ITINGA (MG)";"MG";"ITINGA";23;5;10;38
2003;"ITUETA (MG)";"MG";"ITUETA";37;0;10;47
2003;"ITUIUTABA (MG)";"MG";"ITUIUTABA";1114;93;142;1349
2003;"ITUMIRIM (MG)";"MG";"ITUMIRIM";50;3;4;57
2003;"ITURAMA (MG)";"MG";"ITURAMA";526;26;118;670
2003;"ITUTINGA (MG)";"MG";"ITUTINGA";33;5;2;40
2003;"JABOTICATUBAS (MG)";"MG";"JABOTICATUBAS";105;6;25;136
2003;"JACINTO (MG)";"MG";"JACINTO";16;3;11;30
2003;"JACUI (MG)";"MG";"JACUI";78;7;10;95
2003;"JACUTINGA (MG)";"MG";"JACUTINGA";254;19;28;301
2003;"JAGUARACU (MG)";"MG";"JAGUARACU";15;1;3;19
2003;"JAIBA (MG)";"MG";"JAIBA";145;3;24;172
2003;"JAMPRUCA (MG)";"MG";"JAMPRUCA";5;1;10;16
2003;"JANAUBA (MG)";"MG";"JANAUBA";492;9;55;556
2003;"JANUARIA (MG)";"MG";"JANUARIA";194;5;51;250
2003;"JAPARAIBA (MG)";"MG";"JAPARAIBA";40;2;16;58
2003;"JAPONVAR (MG)";"MG";"JAPONVAR";3;0;8;11
2003;"JECEABA (MG)";"MG";"JECEABA";21;6;5;32
2003;"JENIPAPO DE MINAS (MG)";"MG";"JENIPAPO DE MINAS";10;2;9;21
2003;"JEQUERI (MG)";"MG";"JEQUERI";40;5;15;60
2003;"JEQUITAI (MG)";"MG";"JEQUITAI";38;2;8;48
2003;"JEQUITIBA (MG)";"MG";"JEQUITIBA";28;2;16;46
2003;"JEQUITINHONHA (MG)";"MG";"JEQUITINHONHA";43;5;9;57
2003;"JESUANIA (MG)";"MG";"JESUANIA";50;4;4;58
2003;"JOAIMA (MG)";"MG";"JOAIMA";40;3;10;53
2003;"JOANESIA (MG)";"MG";"JOANESIA";8;3;5;16
2003;"JOAO MONLEVADE (MG)";"MG";"JOAO MONLEVADE";701;46;148;895
2003;"JOAO PINHEIRO (MG)";"MG";"JOAO PINHEIRO";562;7;108;677
2003;"JOAQUIM FELICIO (MG)";"MG";"JOAQUIM FELICIO";21;1;5;27
2003;"JORDANIA (MG)";"MG";"JORDANIA";9;8;6;23
2003;"JOSE GONCALVES DE MINAS (MG)";"MG";"JOSE GONCALVES DE MINAS";19;4;3;26
2003;"JOSE RAYDAN (MG)";"MG";"JOSE RAYDAN";13;1;6;20
2003;"JOSENOPOLIS (MG)";"MG";"JOSENOPOLIS";10;2;3;15
2003;"JUATUBA (MG)";"MG";"JUATUBA";131;19;46;196
2003;"JUIZ DE FORA (MG)";"MG";"JUIZ DE FORA";3766;357;1129;5252
2003;"JURAMENTO (MG)";"MG";"JURAMENTO";9;1;5;15
2003;"JURUAIA (MG)";"MG";"JURUAIA";41;7;14;62
2003;"JUVENILIA (MG)";"MG";"JUVENILIA";4;2;7;13
2003;"LADAINHA (MG)";"MG";"LADAINHA";24;5;10;39
2003;"LAGAMAR (MG)";"MG";"LAGAMAR";54;6;11;71
2003;"LAGOA DA PRATA (MG)";"MG";"LAGOA DA PRATA";478;20;141;639
2003;"LAGOA DOS PATOS (MG)";"MG";"LAGOA DOS PATOS";22;1;6;29
2003;"LAGOA DOURADA (MG)";"MG";"LAGOA DOURADA";192;4;29;225
2003;"LAGOA FORMOSA (MG)";"MG";"LAGOA FORMOSA";160;5;55;220
2003;"LAGOA GRANDE (MG)";"MG";"LAGOA GRANDE";56;1;33;90
2003;"LAGOA SANTA (MG)";"MG";"LAGOA SANTA";565;47;75;687
2003;"LAJINHA (MG)";"MG";"LAJINHA";141;6;25;172
2003;"LAMBARI (MG)";"MG";"LAMBARI";210;17;21;248
2003;"LAMIM (MG)";"MG";"LAMIM";22;2;2;26
2003;"LARANJAL (MG)";"MG";"LARANJAL";114;2;2;118
2003;"LASSANCE (MG)";"MG";"LASSANCE";28;1;4;33
2003;"LAVRAS (MG)";"MG";"LAVRAS";809;74;144;1027
2003;"LEANDRO FERREIRA (MG)";"MG";"LEANDRO FERREIRA";32;1;3;36
2003;"LEME DO PRADO (MG)";"MG";"LEME DO PRADO";18;4;14;36
2003;"LEOPOLDINA (MG)";"MG";"LEOPOLDINA";510;29;49;588
2003;"LIBERDADE (MG)";"MG";"LIBERDADE";57;1;4;62
2003;"LIMA DUARTE (MG)";"MG";"LIMA DUARTE";146;4;25;175
2003;"LIMEIRA DO OESTE (MG)";"MG";"LIMEIRA DO OESTE";72;2;19;93
2003;"LONTRA (MG)";"MG";"LONTRA";5;1;3;9
2003;"LUISBURGO (MG)";"MG";"LUISBURGO";15;1;19;35
2003;"LUISLANDIA (MG)";"MG";"LUISLANDIA";1;2;2;5
2003;"LUMINARIAS (MG)";"MG";"LUMINARIAS";78;4;15;97
2003;"LUZ (MG)";"MG";"LUZ";220;26;18;264
2003;"MACHACALIS (MG)";"MG";"MACHACALIS";17;1;5;23
2003;"MACHADO (MG)";"MG";"MACHADO";589;38;63;690
2003;"MADRE DE DEUS DE MINAS (MG)";"MG";"MADRE DE DEUS DE MINAS";49;2;4;55
2003;"MALACACHETA (MG)";"MG";"MALACACHETA";66;2;25;93
2003;"MAMONAS (MG)";"MG";"MAMONAS";39;1;6;46
2003;"MANGA (MG)";"MG";"MANGA";82;5;23;110
2003;"MANHUACU (MG)";"MG";"MANHUACU";951;30;80;1061
2003;"MANHUMIRIM (MG)";"MG";"MANHUMIRIM";220;16;23;259
2003;"MANTENA (MG)";"MG";"MANTENA";433;10;52;495
2003;"MAR DE ESPANHA (MG)";"MG";"MAR DE ESPANHA";122;8;6;136
2003;"MARAVILHAS (MG)";"MG";"MARAVILHAS";118;5;3;126
2003;"MARIA DA FE (MG)";"MG";"MARIA DA FE";194;8;18;220
2003;"MARIANA (MG)";"MG";"MARIANA";296;57;145;498
2003;"MARILAC (MG)";"MG";"MARILAC";4;1;2;7
2003;"MARIO CAMPOS (MG)";"MG";"MARIO CAMPOS";127;4;7;138
2003;"MARIPA DE MINAS (MG)";"MG";"MARIPA DE MINAS";25;3;2;30
2003;"MARLIERIA (MG)";"MG";"MARLIERIA";20;2;7;29
2003;"MARMELOPOLIS (MG)";"MG";"MARMELOPOLIS";16;4;5;25
2003;"MARTINHO CAMPOS (MG)";"MG";"MARTINHO CAMPOS";218;11;41;270
2003;"MARTINS SOARES (MG)";"MG";"MARTINS SOARES";37;2;7;46
2003;"MATA VERDE (MG)";"MG";"MATA VERDE";9;2;2;13
2003;"MATERLANDIA (MG)";"MG";"MATERLANDIA";7;1;4;12
2003;"MATEUS LEME (MG)";"MG";"MATEUS LEME";275;32;46;353
2003;"MATHIAS LOBATO (MG)";"MG";"MATHIAS LOBATO";25;2;3;30
2003;"MATIAS BARBOSA (MG)";"MG";"MATIAS BARBOSA";234;11;23;268
2003;"MATIAS CARDOSO (MG)";"MG";"MATIAS CARDOSO";7;1;2;10
2003;"MATIPO (MG)";"MG";"MATIPO";175;7;14;196
2003;"MATO VERDE (MG)";"MG";"MATO VERDE";98;2;14;114
2003;"MATOZINHOS (MG)";"MG";"MATOZINHOS";223;25;65;313
2003;"MATUTINA (MG)";"MG";"MATUTINA";56;5;4;65
2003;"MEDEIROS (MG)";"MG";"MEDEIROS";15;1;3;19
2003;"MEDINA (MG)";"MG";"MEDINA";80;9;19;108
2003;"MENDES PIMENTEL (MG)";"MG";"MENDES PIMENTEL";23;2;10;35
2003;"MERCES (MG)";"MG";"MERCES";77;5;10;92
2003;"MESQUITA (MG)";"MG";"MESQUITA";18;1;5;24
2003;"MINAS NOVAS (MG)";"MG";"MINAS NOVAS";64;12;47;123
2003;"MINDURI (MG)";"MG";"MINDURI";34;2;5;41
2003;"MIRABELA (MG)";"MG";"MIRABELA";58;1;14;73
2003;"MIRADOURO (MG)";"MG";"MIRADOURO";65;3;14;82
2003;"MIRAI (MG)";"MG";"MIRAI";107;10;12;129
2003;"MIRAVANIA (MG)";"MG";"MIRAVANIA";6;0;5;11
2003;"MOEDA (MG)";"MG";"MOEDA";42;2;7;51
2003;"MOEMA (MG)";"MG";"MOEMA";100;4;90;194
2003;"MONJOLOS (MG)";"MG";"MONJOLOS";2;1;5;8
2003;"MONSENHOR PAULO (MG)";"MG";"MONSENHOR PAULO";104;6;5;115
2003;"MONTALVANIA (MG)";"MG";"MONTALVANIA";60;2;29;91
2003;"MONTE ALEGRE DE MINAS (MG)";"MG";"MONTE ALEGRE DE MINAS";382;7;22;411
2003;"MONTE AZUL (MG)";"MG";"MONTE AZUL";115;3;23;141
2003;"MONTE BELO (MG)";"MG";"MONTE BELO";171;8;32;211
2003;"MONTE CARMELO (MG)";"MG";"MONTE CARMELO";913;29;68;1010
2003;"MONTE FORMOSO (MG)";"MG";"MONTE FORMOSO";3;1;6;10
2003;"MONTE SANTO DE MINAS (MG)";"MG";"MONTE SANTO DE MINAS";356;8;56;420
2003;"MONTE SIAO (MG)";"MG";"MONTE SIAO";182;17;28;227
2003;"MONTES CLAROS (MG)";"MG";"MONTES CLAROS";2915;109;744;3768
2003;"MONTEZUMA (MG)";"MG";"MONTEZUMA";19;2;14;35
2003;"MORADA NOVA DE MINAS (MG)";"MG";"MORADA NOVA DE MINAS";71;6;11;88
2003;"MORRO DA GARCA (MG)";"MG";"MORRO DA GARCA";31;2;12;45
2003;"MORRO DO PILAR (MG)";"MG";"MORRO DO PILAR";19;3;1;23
2003;"MUNHOZ (MG)";"MG";"MUNHOZ";62;3;7;72
2003;"MURIAE (MG)";"MG";"MURIAE";993;50;128;1171
2003;"MUTUM (MG)";"MG";"MUTUM";110;7;25;142
2003;"MUZAMBINHO (MG)";"MG";"MUZAMBINHO";258;19;23;300
2003;"NACIP RAYDAN (MG)";"MG";"NACIP RAYDAN";2;1;2;5
2003;"NANUQUE (MG)";"MG";"NANUQUE";456;23;105;584
2003;"NAQUE (MG)";"MG";"NAQUE";16;0;16;32
2003;"NATALANDIA (MG)";"MG";"NATALANDIA";7;3;8;18
2003;"NATERCIA (MG)";"MG";"NATERCIA";59;4;9;72
2003;"NAZARENO (MG)";"MG";"NAZARENO";103;8;12;123
2003;"NEPOMUCENO (MG)";"MG";"NEPOMUCENO";313;6;39;358
2003;"NINHEIRA (MG)";"MG";"NINHEIRA";12;2;10;24
2003;"NOVA BELEM (MG)";"MG";"NOVA BELEM";18;3;4;25
2003;"NOVA ERA (MG)";"MG";"NOVA ERA";147;12;57;216
2003;"NOVA LIMA (MG)";"MG";"NOVA LIMA";509;112;131;752
2003;"NOVA MODICA (MG)";"MG";"NOVA MODICA";12;2;7;21
2003;"NOVA PONTE (MG)";"MG";"NOVA PONTE";125;33;35;193
2003;"NOVA PORTEIRINHA (MG)";"MG";"NOVA PORTEIRINHA";19;2;10;31
2003;"NOVA RESENDE (MG)";"MG";"NOVA RESENDE";212;3;23;238
2003;"NOVA SERRANA (MG)";"MG";"NOVA SERRANA";235;15;32;282
2003;"NOVA UNIAO (MG)";"MG";"NOVA UNIAO";83;5;10;98
2003;"NOVO CRUZEIRO (MG)";"MG";"NOVO CRUZEIRO";70;10;41;121
2003;"NOVO ORIENTE DE MINAS (MG)";"MG";"NOVO ORIENTE DE MINAS";19;5;8;32
2003;"NOVORIZONTE (MG)";"MG";"NOVORIZONTE";22;0;8;30
2003;"OLARIA (MG)";"MG";"OLARIA";12;4;3;19
2003;"OLHOS D AGUA (MG)";"MG";"OLHOS D AGUA";17;3;21;41
2003;"OLIMPIO NORONHA (MG)";"MG";"OLIMPIO NORONHA";20;6;3;29
2003;"OLIVEIRA (MG)";"MG";"OLIVEIRA";544;25;52;621
2003;"OLIVEIRA FORTES (MG)";"MG";"OLIVEIRA FORTES";14;0;2;16
2003;"ONCA DE PITANGUI (MG)";"MG";"ONCA DE PITANGUI";14;2;8;24
2003;"ORATORIOS (MG)";"MG";"ORATORIOS";23;1;15;39
2003;"ORIZANIA (MG)";"MG";"ORIZANIA";21;3;5;29
2003;"OURO BRANCO (MG)";"MG";"OURO BRANCO";294;44;117;455
2003;"OURO FINO (MG)";"MG";"OURO FINO";377;12;63;452
2003;"OURO PRETO (MG)";"MG";"OURO PRETO";635;77;255;967
2003;"OURO VERDE DE MINAS (MG)";"MG";"OURO VERDE DE MINAS";12;1;3;16
2003;"PADRE CARVALHO (MG)";"MG";"PADRE CARVALHO";6;1;2;9
2003;"PADRE PARAISO (MG)";"MG";"PADRE PARAISO";70;43;25;138
2003;"PAI PEDRO (MG)";"MG";"PAI PEDRO";9;3;13;25
2003;"PAINEIRAS (MG)";"MG";"PAINEIRAS";69;8;7;84
2003;"PAINS (MG)";"MG";"PAINS";167;8;14;189
2003;"PAIVA (MG)";"MG";"PAIVA";12;1;2;15
2003;"PALMA (MG)";"MG";"PALMA";61;2;3;66
2003;"PALMOPOLIS (MG)";"MG";"PALMOPOLIS";7;3;2;12
2003;"PAPAGAIOS (MG)";"MG";"PAPAGAIOS";421;7;36;464
2003;"PARA DE MINAS (MG)";"MG";"PARA DE MINAS";1337;72;165;1574
2003;"PARACATU (MG)";"MG";"PARACATU";815;24;204;1043
2003;"PARAGUACU (MG)";"MG";"PARAGUACU";213;19;17;249
2003;"PARAISOPOLIS (MG)";"MG";"PARAISOPOLIS";251;29;13;293
2003;"PARAOPEBA (MG)";"MG";"PARAOPEBA";303;14;29;346
2003;"PASSA QUATRO (MG)";"MG";"PASSA QUATRO";244;13;13;270
2003;"PASSA TEMPO (MG)";"MG";"PASSA TEMPO";103;6;12;121
2003;"PASSA VINTE (MG)";"MG";"PASSA VINTE";15;5;5;25
2003;"PASSABEM (MG)";"MG";"PASSABEM";5;0;1;6
2003;"PASSOS (MG)";"MG";"PASSOS";1263;53;236;1552
2003;"PATIS (MG)";"MG";"PATIS";0;0;7;7
2003;"PATOS DE MINAS (MG)";"MG";"PATOS DE MINAS";1823;59;1484;3366
2003;"PATROCINIO (MG)";"MG";"PATROCINIO";1077;27;311;1415
2003;"PATROCINIO DO MURIAE (MG)";"MG";"PATROCINIO DO MURIAE";41;4;4;49
2003;"PAULA CANDIDO (MG)";"MG";"PAULA CANDIDO";40;2;8;50
2003;"PAULISTAS (MG)";"MG";"PAULISTAS";12;2;8;22
2003;"PAVAO (MG)";"MG";"PAVAO";23;3;7;33
2003;"PECANHA (MG)";"MG";"PECANHA";80;3;35;118
2003;"PEDRA AZUL (MG)";"MG";"PEDRA AZUL";133;6;30;169
2003;"PEDRA BONITA (MG)";"MG";"PEDRA BONITA";11;6;5;22
2003;"PEDRA DO ANTA (MG)";"MG";"PEDRA DO ANTA";12;1;11;24
2003;"PEDRA DO INDAIA (MG)";"MG";"PEDRA DO INDAIA";41;0;4;45
2003;"PEDRA DOURADA (MG)";"MG";"PEDRA DOURADA";9;2;2;13
2003;"PEDRALVA (MG)";"MG";"PEDRALVA";120;5;14;139
2003;"PEDRAS DE MARIA DA CRUZ (MG)";"MG";"PEDRAS DE MARIA DA CRUZ";7;2;15;24
2003;"PEDRINOPOLIS (MG)";"MG";"PEDRINOPOLIS";48;6;6;60
2003;"PEDRO LEOPOLDO (MG)";"MG";"PEDRO LEOPOLDO";683;71;119;873
2003;"PEDRO TEIXEIRA (MG)";"MG";"PEDRO TEIXEIRA";16;2;0;18
2003;"PEQUERI (MG)";"MG";"PEQUERI";50;10;2;62
2003;"PEQUI (MG)";"MG";"PEQUI";31;1;6;38
2003;"PERDIGAO (MG)";"MG";"PERDIGAO";92;9;2;103
2003;"PERDIZES (MG)";"MG";"PERDIZES";176;15;15;206
2003;"PERDOES (MG)";"MG";"PERDOES";355;13;35;403
2003;"PERIQUITO (MG)";"MG";"PERIQUITO";22;1;16;39
2003;"PESCADOR (MG)";"MG";"PESCADOR";8;3;4;15
2003;"PIAU (MG)";"MG";"PIAU";28;2;3;33
2003;"PIEDADE DE CARATINGA (MG)";"MG";"PIEDADE DE CARATINGA";61;4;3;68
2003;"PIEDADE DE PONTE NOVA (MG)";"MG";"PIEDADE DE PONTE NOVA";29;1;4;34
2003;"PIEDADE DO RIO GRANDE (MG)";"MG";"PIEDADE DO RIO GRANDE";36;1;6;43
2003;"PIEDADE DOS GERAIS (MG)";"MG";"PIEDADE DOS GERAIS";40;2;10;52
2003;"PIMENTA (MG)";"MG";"PIMENTA";140;6;11;157
2003;"PINGO D AGUA (MG)";"MG";"PINGO D AGUA";13;2;3;18
2003;"PINTOPOLIS (MG)";"MG";"PINTOPOLIS";7;1;3;11
2003;"PIRACEMA (MG)";"MG";"PIRACEMA";49;3;9;61
2003;"PIRAJUBA (MG)";"MG";"PIRAJUBA";67;0;3;70
2003;"PIRANGA (MG)";"MG";"PIRANGA";77;12;29;118
2003;"PIRANGUCU (MG)";"MG";"PIRANGUCU";27;9;39;75
2003;"PIRANGUINHO (MG)";"MG";"PIRANGUINHO";67;2;6;75
2003;"PIRAPETINGA (MG)";"MG";"PIRAPETINGA";231;8;14;253
2003;"PIRAPORA (MG)";"MG";"PIRAPORA";362;13;70;445
2003;"PIRAUBA (MG)";"MG";"PIRAUBA";90;7;8;105
2003;"PITANGUI (MG)";"MG";"PITANGUI";499;17;49;565
2003;"PIUI (MG)";"MG";"PIUI";483;22;41;546
2003;"PLANURA (MG)";"MG";"PLANURA";134;3;31;168
2003;"POCO FUNDO (MG)";"MG";"POCO FUNDO";189;20;11;220
2003;"POCOS DE CALDAS (MG)";"MG";"POCOS DE CALDAS";2324;272;284;2880
2003;"POCRANE (MG)";"MG";"POCRANE";42;4;7;53
2003;"POMPEU (MG)";"MG";"POMPEU";341;10;50;401
2003;"PONTE NOVA (MG)";"MG";"PONTE NOVA";668;10;81;759
2003;"PONTO CHIQUE (MG)";"MG";"PONTO CHIQUE";3;0;8;11
2003;"PONTO DOS VOLANTES (MG)";"MG";"PONTO DOS VOLANTES";10;5;16;31
2003;"PORTEIRINHA (MG)";"MG";"PORTEIRINHA";228;4;77;309
2003;"PORTO FIRME (MG)";"MG";"PORTO FIRME";18;4;8;30
2003;"POTE (MG)";"MG";"POTE";35;2;7;44
2003;"POUSO ALEGRE (MG)";"MG";"POUSO ALEGRE";1599;113;377;2089
2003;"POUSO ALTO (MG)";"MG";"POUSO ALTO";73;6;2;81
2003;"PRADOS (MG)";"MG";"PRADOS";47;4;4;55
2003;"PRATA (MG)";"MG";"PRATA";295;34;51;380
2003;"PRATAPOLIS (MG)";"MG";"PRATAPOLIS";162;8;7;177
2003;"PRATINHA (MG)";"MG";"PRATINHA";44;3;4;51
2003;"PRESIDENTE BERNARDES (MG)";"MG";"PRESIDENTE BERNARDES";11;2;5;18
2003;"PRESIDENTE JUSCELINO (MG)";"MG";"PRESIDENTE JUSCELINO";20;1;7;28
2003;"PRESIDENTE KUBITSCHEK (MG)";"MG";"PRESIDENTE KUBITSCHEK";9;3;2;14
2003;"PRESIDENTE OLEGARIO (MG)";"MG";"PRESIDENTE OLEGARIO";168;7;69;244
2003;"PRUDENTE DE MORAIS (MG)";"MG";"PRUDENTE DE MORAIS";103;5;7;115
2003;"QUARTEL GERAL (MG)";"MG";"QUARTEL GERAL";25;5;0;30
2003;"QUELUZITA (MG)";"MG";"QUELUZITA";14;4;0;18
2003;"RAPOSOS (MG)";"MG";"RAPOSOS";42;13;21;76
2003;"RAUL SOARES (MG)";"MG";"RAUL SOARES";120;8;33;161
2003;"RECREIO (MG)";"MG";"RECREIO";128;6;11;145
2003;"REDUTO (MG)";"MG";"REDUTO";31;2;3;36
2003;"RESENDE COSTA (MG)";"MG";"RESENDE COSTA";111;5;7;123
2003;"RESPLENDOR (MG)";"MG";"RESPLENDOR";143;5;27;175
2003;"RESSAQUINHA (MG)";"MG";"RESSAQUINHA";72;1;9;82
2003;"RIACHINHO (MG)";"MG";"RIACHINHO";32;1;11;44
2003;"RIACHO DOS MACHADOS (MG)";"MG";"RIACHO DOS MACHADOS";39;3;17;59
2003;"RIBEIRAO DAS NEVES (MG)";"MG";"RIBEIRAO DAS NEVES";1644;161;439;2244
2003;"RIBEIRAO VERMELHO (MG)";"MG";"RIBEIRAO VERMELHO";16;5;2;23
2003;"RIO ACIMA (MG)";"MG";"RIO ACIMA";71;5;11;87
2003;"RIO CASCA (MG)";"MG";"RIO CASCA";186;4;25;215
2003;"RIO DO PRADO (MG)";"MG";"RIO DO PRADO";9;3;4;16
2003;"RIO DOCE (MG)";"MG";"RIO DOCE";19;2;3;24
2003;"RIO ESPERA (MG)";"MG";"RIO ESPERA";14;0;4;18
2003;"RIO MANSO (MG)";"MG";"RIO MANSO";71;2;10;83
2003;"RIO NOVO (MG)";"MG";"RIO NOVO";101;4;12;117
2003;"RIO PARANAIBA (MG)";"MG";"RIO PARANAIBA";93;6;27;126
2003;"RIO PARDO DE MINAS (MG)";"MG";"RIO PARDO DE MINAS";88;3;56;147
2003;"RIO PIRACICABA (MG)";"MG";"RIO PIRACICABA";147;15;22;184
2003;"RIO POMBA (MG)";"MG";"RIO POMBA";159;13;28;200
2003;"RIO PRETO (MG)";"MG";"RIO PRETO";125;30;22;177
2003;"RIO VERMELHO (MG)";"MG";"RIO VERMELHO";34;10;21;65
2003;"RITAPOLIS (MG)";"MG";"RITAPOLIS";17;1;4;22
2003;"ROCHEDO DE MINAS (MG)";"MG";"ROCHEDO DE MINAS";19;0;2;21
2003;"RODEIRO (MG)";"MG";"RODEIRO";99;3;5;107
2003;"ROMARIA (MG)";"MG";"ROMARIA";24;3;2;29
2003;"ROSARIO DA LIMEIRA (MG)";"MG";"ROSARIO DA LIMEIRA";26;1;10;37
2003;"RUBELITA (MG)";"MG";"RUBELITA";8;3;7;18
2003;"RUBIM (MG)";"MG";"RUBIM";18;4;10;32
2003;"SABARA (MG)";"MG";"SABARA";409;86;205;700
2003;"SABINOPOLIS (MG)";"MG";"SABINOPOLIS";65;4;22;91
2003;"SACRAMENTO (MG)";"MG";"SACRAMENTO";358;23;40;421
2003;"SALINAS (MG)";"MG";"SALINAS";244;16;69;329
2003;"SALTO DA DIVISA (MG)";"MG";"SALTO DA DIVISA";6;2;2;10
2003;"SANTA BARBARA (MG)";"MG";"SANTA BARBARA";238;26;61;325
2003;"SANTA BARBARA DO LESTE (MG)";"MG";"SANTA BARBARA DO LESTE";115;5;1;121
2003;"SANTA BARBARA DO MONTE VERDE (MG)";"MG";"SANTA BARBARA DO MONTE VERDE";37;45;12;94
2003;"SANTA BARBARA DO TUGURIO (MG)";"MG";"SANTA BARBARA DO TUGURIO";31;2;4;37
2003;"SANTA CRUZ DE MINAS (MG)";"MG";"SANTA CRUZ DE MINAS";34;4;1;39
2003;"SANTA CRUZ DE SALINAS (MG)";"MG";"SANTA CRUZ DE SALINAS";8;1;11;20
2003;"SANTA CRUZ DO ESCALVADO (MG)";"MG";"SANTA CRUZ DO ESCALVADO";20;1;12;33
2003;"SANTA EFIGENIA DE MINAS (MG)";"MG";"SANTA EFIGENIA DE MINAS";15;3;0;18
2003;"SANTA FE DE MINAS (MG)";"MG";"SANTA FE DE MINAS";6;2;1;9
2003;"SANTA HELENA DE MINAS (MG)";"MG";"SANTA HELENA DE MINAS";4;1;3;8
2003;"SANTA JULIANA (MG)";"MG";"SANTA JULIANA";195;10;24;229
2003;"SANTA LUZIA (MG)";"MG";"SANTA LUZIA";901;95;459;1455
2003;"SANTA MARGARIDA (MG)";"MG";"SANTA MARGARIDA";123;6;10;139
2003;"SANTA MARIA DE ITABIRA (MG)";"MG";"SANTA MARIA DE ITABIRA";71;5;22;98
2003;"SANTA MARIA DO SALTO (MG)";"MG";"SANTA MARIA DO SALTO";10;2;3;15
2003;"SANTA MARIA DO SUACUI (MG)";"MG";"SANTA MARIA DO SUACUI";50;0;21;71
2003;"SANTA RITA DE CALDAS (MG)";"MG";"SANTA RITA DE CALDAS";215;6;4;225
2003;"SANTA RITA DE JACUTINGA (MG)";"MG";"SANTA RITA DE JACUTINGA";32;7;4;43
2003;"SANTA RITA DE MINAS (MG)";"MG";"SANTA RITA DE MINAS";93;3;5;101
2003;"SANTA RITA DO IBITIPOCA (MG)";"MG";"SANTA RITA DO IBITIPOCA";26;0;3;29
2003;"SANTA RITA DO ITUETO (MG)";"MG";"SANTA RITA DO ITUETO";50;2;8;60
2003;"SANTA RITA DO SAPUCAI (MG)";"MG";"SANTA RITA DO SAPUCAI";281;25;35;341
2003;"SANTA ROSA DA SERRA (MG)";"MG";"SANTA ROSA DA SERRA";26;2;6;34
2003;"SANTA VITORIA (MG)";"MG";"SANTA VITORIA";218;10;13;241
2003;"SANTANA DA VARGEM (MG)";"MG";"SANTANA DA VARGEM";55;4;18;77
2003;"SANTANA DE CATAGUASES (MG)";"MG";"SANTANA DE CATAGUASES";27;5;6;38
2003;"SANTANA DE PIRAPAMA (MG)";"MG";"SANTANA DE PIRAPAMA";46;4;17;67
2003;"SANTANA DO DESERTO (MG)";"MG";"SANTANA DO DESERTO";33;2;5;40
2003;"SANTANA DO GARAMBEU (MG)";"MG";"SANTANA DO GARAMBEU";11;2;2;15
2003;"SANTANA DO JACARE (MG)";"MG";"SANTANA DO JACARE";31;3;3;37
2003;"SANTANA DO MANHUACU (MG)";"MG";"SANTANA DO MANHUACU";60;4;8;72
2003;"SANTANA DO PARAISO (MG)";"MG";"SANTANA DO PARAISO";55;3;20;78
2003;"SANTANA DO RIACHO (MG)";"MG";"SANTANA DO RIACHO";6;5;2;13
2003;"SANTANA DOS MONTES (MG)";"MG";"SANTANA DOS MONTES";21;4;5;30
2003;"SANTO ANTONIO DO AMPARO (MG)";"MG";"SANTO ANTONIO DO AMPARO";166;6;9;181
2003;"SANTO ANTONIO DO AVENTUREIRO (MG)";"MG";"SANTO ANTONIO DO AVENTUREIRO";33;1;2;36
2003;"SANTO ANTONIO DO GRAMA (MG)";"MG";"SANTO ANTONIO DO GRAMA";35;0;6;41
2003;"SANTO ANTONIO DO ITAMBE (MG)";"MG";"SANTO ANTONIO DO ITAMBE";7;2;4;13
2003;"SANTO ANTONIO DO JACINTO (MG)";"MG";"SANTO ANTONIO DO JACINTO";19;5;12;36
2003;"SANTO ANTONIO DO MONTE (MG)";"MG";"SANTO ANTONIO DO MONTE";343;15;71;429
2003;"SANTO ANTONIO DO RETIRO (MG)";"MG";"SANTO ANTONIO DO RETIRO";18;1;10;29
2003;"SANTO ANTONIO DO RIO ABAIXO (MG)";"MG";"SANTO ANTONIO DO RIO ABAIXO";7;2;2;11
2003;"SANTO HIPOLITO (MG)";"MG";"SANTO HIPOLITO";9;0;2;11
2003;"SANTOS DUMONT (MG)";"MG";"SANTOS DUMONT";300;11;92;403
2003;"SAO BENTO ABADE (MG)";"MG";"SAO BENTO ABADE";31;4;3;38
2003;"SAO BRAS DO SUACUI (MG)";"MG";"SAO BRAS DO SUACUI";22;4;3;29
2003;"SAO DOMINGOS DAS DORES (MG)";"MG";"SAO DOMINGOS DAS DORES";47;1;1;49
2003;"SAO DOMINGOS DO PRATA (MG)";"MG";"SAO DOMINGOS DO PRATA";135;5;37;177
2003;"SAO FELIX DE MINAS (MG)";"MG";"SAO FELIX DE MINAS";7;2;5;14
2003;"SAO FRANCISCO (MG)";"MG";"SAO FRANCISCO";121;2;51;174
2003;"SAO FRANCISCO DE PAULA (MG)";"MG";"SAO FRANCISCO DE PAULA";56;3;18;77
2003;"SAO FRANCISCO DE SALES (MG)";"MG";"SAO FRANCISCO DE SALES";61;3;13;77
2003;"SAO FRANCISCO DO GLORIA (MG)";"MG";"SAO FRANCISCO DO GLORIA";36;4;3;43
2003;"SAO GERALDO (MG)";"MG";"SAO GERALDO";91;4;3;98
2003;"SAO GERALDO DA PIEDADE (MG)";"MG";"SAO GERALDO DA PIEDADE";7;1;4;12
2003;"SAO GERALDO DO BAIXIO (MG)";"MG";"SAO GERALDO DO BAIXIO";8;1;4;13
2003;"SAO GONCALO DO ABAETE (MG)";"MG";"SAO GONCALO DO ABAETE";62;2;8;72
2003;"SAO GONCALO DO PARA (MG)";"MG";"SAO GONCALO DO PARA";107;4;7;118
2003;"SAO GONCALO DO RIO ABAIXO (MG)";"MG";"SAO GONCALO DO RIO ABAIXO";45;8;8;61
2003;"SAO GONCALO DO RIO PRETO (MG)";"MG";"SAO GONCALO DO RIO PRETO";12;3;3;18
2003;"SAO GONCALO DO SAPUCAI (MG)";"MG";"SAO GONCALO DO SAPUCAI";320;11;48;379
2003;"SAO GOTARDO (MG)";"MG";"SAO GOTARDO";612;20;95;727
2003;"SAO JOAO BATISTA DO GLORIA (MG)";"MG";"SAO JOAO BATISTA DO GLORIA";67;6;5;78
2003;"SAO JOAO DA LAGOA (MG)";"MG";"SAO JOAO DA LAGOA";14;1;6;21
2003;"SAO JOAO DA MATA (MG)";"MG";"SAO JOAO DA MATA";33;5;1;39
2003;"SAO JOAO DA PONTE (MG)";"MG";"SAO JOAO DA PONTE";33;0;25;58
2003;"SAO JOAO DAS MISSOES (MG)";"MG";"SAO JOAO DAS MISSOES";10;3;4;17
2003;"SAO JOAO DEL REI (MG)";"MG";"SAO JOAO DEL REI";803;65;169;1037
2003;"SAO JOAO DO MANHUACU (MG)";"MG";"SAO JOAO DO MANHUACU";101;4;9;114
2003;"SAO JOAO DO MANTENINHA (MG)";"MG";"SAO JOAO DO MANTENINHA";44;5;3;52
2003;"SAO JOAO DO ORIENTE (MG)";"MG";"SAO JOAO DO ORIENTE";63;4;4;71
2003;"SAO JOAO DO PACUI (MG)";"MG";"SAO JOAO DO PACUI";1;0;1;2
2003;"SAO JOAO DO PARAISO (MG)";"MG";"SAO JOAO DO PARAISO";69;4;36;109
2003;"SAO JOAO EVANGELISTA (MG)";"MG";"SAO JOAO EVANGELISTA";61;4;20;85
2003;"SAO JOAO NEPOMUCENO (MG)";"MG";"SAO JOAO NEPOMUCENO";209;12;34;255
2003;"SAO JOAQUIM DE BICAS (MG)";"MG";"SAO JOAQUIM DE BICAS";150;21;28;199
2003;"SAO JOSE DA BARRA (MG)";"MG";"SAO JOSE DA BARRA";42;0;14;56
2003;"SAO JOSE DA LAPA (MG)";"MG";"SAO JOSE DA LAPA";152;11;24;187
2003;"SAO JOSE DA SAFIRA (MG)";"MG";"SAO JOSE DA SAFIRA";1;1;1;3
2003;"SAO JOSE DA VARGINHA (MG)";"MG";"SAO JOSE DA VARGINHA";28;0;5;33
2003;"SAO JOSE DO ALEGRE (MG)";"MG";"SAO JOSE DO ALEGRE";29;5;1;35
2003;"SAO JOSE DO DIVINO (MG)";"MG";"SAO JOSE DO DIVINO";8;2;5;15
2003;"SAO JOSE DO GOIABAL (MG)";"MG";"SAO JOSE DO GOIABAL";43;8;22;73
2003;"SAO JOSE DO JACURI (MG)";"MG";"SAO JOSE DO JACURI";8;2;3;13
2003;"SAO JOSE DO MANTIMENTO (MG)";"MG";"SAO JOSE DO MANTIMENTO";3;1;2;6
2003;"SAO LOURENCO (MG)";"MG";"SAO LOURENCO";352;34;20;406
2003;"SAO MIGUEL DO ANTA (MG)";"MG";"SAO MIGUEL DO ANTA";52;2;5;59
2003;"SAO PEDRO DA UNIAO (MG)";"MG";"SAO PEDRO DA UNIAO";64;5;8;77
2003;"SAO PEDRO DO SUACUI (MG)";"MG";"SAO PEDRO DO SUACUI";15;2;6;23
2003;"SAO PEDRO DOS FERROS (MG)";"MG";"SAO PEDRO DOS FERROS";81;1;18;100
2003;"SAO ROMAO (MG)";"MG";"SAO ROMAO";14;1;7;22
2003;"SAO ROQUE DE MINAS (MG)";"MG";"SAO ROQUE DE MINAS";75;3;22;100
2003;"SAO SEBASTIAO DA BELA VISTA (MG)";"MG";"SAO SEBASTIAO DA BELA VISTA";25;3;6;34
2003;"SAO SEBASTIAO DA VARGEM ALEGRE (MG)";"MG";"SAO SEBASTIAO DA VARGEM ALEGRE";11;2;4;17
2003;"SAO SEBASTIAO DO ANTA (MG)";"MG";"SAO SEBASTIAO DO ANTA";26;2;1;29
2003;"SAO SEBASTIAO DO MARANHAO (MG)";"MG";"SAO SEBASTIAO DO MARANHAO";15;3;9;27
2003;"SAO SEBASTIAO DO OESTE (MG)";"MG";"SAO SEBASTIAO DO OESTE";56;3;10;69
2003;"SAO SEBASTIAO DO PARAISO (MG)";"MG";"SAO SEBASTIAO DO PARAISO";1076;47;101;1224
2003;"SAO SEBASTIAO DO RIO PRETO (MG)";"MG";"SAO SEBASTIAO DO RIO PRETO";5;3;1;9
2003;"SAO SEBASTIAO DO RIO VERDE (MG)";"MG";"SAO SEBASTIAO DO RIO VERDE";6;1;2;9
2003;"SAO TIAGO (MG)";"MG";"SAO TIAGO";75;3;9;87
2003;"SAO TOMAS DE AQUINO (MG)";"MG";"SAO TOMAS DE AQUINO";64;9;4;77
2003;"SAO TOME DAS LETRAS (MG)";"MG";"SAO TOME DAS LETRAS";69;4;7;80
2003;"SAO VICENTE DE MINAS (MG)";"MG";"SAO VICENTE DE MINAS";50;5;1;56
2003;"SAPUCAI MIRIM (MG)";"MG";"SAPUCAI MIRIM";118;9;9;136
2003;"SARDOA (MG)";"MG";"SARDOA";7;1;6;14
2003;"SARZEDO (MG)";"MG";"SARZEDO";180;7;17;204
2003;"SEM PEIXE (MG)";"MG";"SEM PEIXE";7;1;4;12
2003;"SENADOR AMARAL (MG)";"MG";"SENADOR AMARAL";69;3;2;74
2003;"SENADOR CORTES (MG)";"MG";"SENADOR CORTES";7;3;4;14
2003;"SENADOR FIRMINO (MG)";"MG";"SENADOR FIRMINO";55;3;6;64
2003;"SENADOR JOSE BENTO (MG)";"MG";"SENADOR JOSE BENTO";11;1;7;19
2003;"SENADOR MODESTINO GONCALVES (MG)";"MG";"SENADOR MODESTINO GONCALVES";20;5;6;31
2003;"SENHORA DE OLIVEIRA (MG)";"MG";"SENHORA DE OLIVEIRA";34;1;4;39
2003;"SENHORA DO PORTO (MG)";"MG";"SENHORA DO PORTO";12;2;5;19
2003;"SENHORA DOS REMEDIOS (MG)";"MG";"SENHORA DOS REMEDIOS";46;4;10;60
2003;"SERICITA (MG)";"MG";"SERICITA";39;0;2;41
2003;"SERITINGA (MG)";"MG";"SERITINGA";12;2;1;15
2003;"SERRA AZUL DE MINAS (MG)";"MG";"SERRA AZUL DE MINAS";9;1;5;15
2003;"SERRA DA SAUDADE (MG)";"MG";"SERRA DA SAUDADE";5;3;0;8
2003;"SERRA DO SALITRE (MG)";"MG";"SERRA DO SALITRE";150;1;31;182
2003;"SERRA DOS AIMORES (MG)";"MG";"SERRA DOS AIMORES";48;2;13;63
2003;"SERRANIA (MG)";"MG";"SERRANIA";86;9;8;103
2003;"SERRANOPOLIS DE MINAS (MG)";"MG";"SERRANOPOLIS DE MINAS";4;2;5;11
2003;"SERRANOS (MG)";"MG";"SERRANOS";8;1;1;10
2003;"SERRO (MG)";"MG";"SERRO";95;4;20;119
2003;"SETE LAGOAS (MG)";"MG";"SETE LAGOAS";2137;244;358;2739
2003;"SETUBINHA (MG)";"MG";"SETUBINHA";9;2;14;25
2003;"SILVEIRANIA (MG)";"MG";"SILVEIRANIA";4;1;4;9
2003;"SILVIANOPOLIS (MG)";"MG";"SILVIANOPOLIS";58;5;4;67
2003;"SIMAO PEREIRA (MG)";"MG";"SIMAO PEREIRA";29;6;2;37
2003;"SIMONESIA (MG)";"MG";"SIMONESIA";124;7;24;155
2003;"SOBRALIA (MG)";"MG";"SOBRALIA";20;1;5;26
2003;"SOLEDADE DE MINAS (MG)";"MG";"SOLEDADE DE MINAS";19;3;0;22
2003;"TABULEIRO (MG)";"MG";"TABULEIRO";45;1;8;54
2003;"TAIOBEIRAS (MG)";"MG";"TAIOBEIRAS";355;4;52;411
2003;"TAPARUBA (MG)";"MG";"TAPARUBA";16;2;4;22
2003;"TAPIRA (MG)";"MG";"TAPIRA";25;2;4;31
2003;"TAPIRAI (MG)";"MG";"TAPIRAI";7;2;2;11
2003;"TAQUARACU DE MINAS (MG)";"MG";"TAQUARACU DE MINAS";33;1;5;39
2003;"TARUMIRIM (MG)";"MG";"TARUMIRIM";87;7;20;114
2003;"TEIXEIRAS (MG)";"MG";"TEIXEIRAS";91;3;6;100
2003;"TEOFILO OTONI (MG)";"MG";"TEOFILO OTONI";1063;68;97;1228
2003;"TIMOTEO (MG)";"MG";"TIMOTEO";618;102;93;813
2003;"TIRADENTES (MG)";"MG";"TIRADENTES";45;6;6;57
2003;"TIROS (MG)";"MG";"TIROS";109;14;5;128
2003;"TOCANTINS (MG)";"MG";"TOCANTINS";173;3;3;179
2003;"TOCOS DO MOJI (MG)";"MG";"TOCOS DO MOJI";25;2;6;33
2003;"TOLEDO (MG)";"MG";"TOLEDO";31;2;6;39
2003;"TOMBOS (MG)";"MG";"TOMBOS";83;9;15;107
2003;"TRES CORACOES (MG)";"MG";"TRES CORACOES";714;51;100;865
2003;"TRES MARIAS (MG)";"MG";"TRES MARIAS";207;14;40;261
2003;"TRES PONTAS (MG)";"MG";"TRES PONTAS";656;27;96;779
2003;"TUMIRITINGA (MG)";"MG";"TUMIRITINGA";19;1;2;22
2003;"TUPACIGUARA (MG)";"MG";"TUPACIGUARA";354;23;39;416
2003;"TURMALINA (MG)";"MG";"TURMALINA";151;5;27;183
2003;"TURVOLANDIA (MG)";"MG";"TURVOLANDIA";83;7;3;93
2003;"UBA (MG)";"MG";"UBA";1204;24;76;1304
2003;"UBAI (MG)";"MG";"UBAI";12;2;7;21
2003;"UBAPORANGA (MG)";"MG";"UBAPORANGA";77;2;7;86
2003;"UBERABA (MG)";"MG";"UBERABA";3161;364;511;4036
2003;"UBERLANDIA (MG)";"MG";"UBERLANDIA";8475;681;928;10084
2003;"UMBURATIBA (MG)";"MG";"UMBURATIBA";6;1;1;8
2003;"UNAI (MG)";"MG";"UNAI";1082;22;219;1323
2003;"UNIAO DE MINAS (MG)";"MG";"UNIAO DE MINAS";35;1;12;48
2003;"URUANA DE MINAS (MG)";"MG";"URUANA DE MINAS";12;1;6;19
2003;"URUCANIA (MG)";"MG";"URUCANIA";90;2;22;114
2003;"URUCUIA (MG)";"MG";"URUCUIA";24;1;8;33
2003;"VARGEM ALEGRE (MG)";"MG";"VARGEM ALEGRE";43;4;6;53
2003;"VARGEM BONITA (MG)";"MG";"VARGEM BONITA";7;4;3;14
2003;"VARGEM GRANDE DO RIO PARDO (MG)";"MG";"VARGEM GRANDE DO RIO PARDO";21;0;5;26
2003;"VARGINHA (MG)";"MG";"VARGINHA";1398;59;154;1611
2003;"VARJAO DE MINAS (MG)";"MG";"VARJAO DE MINAS";49;2;21;72
2003;"VARZEA DA PALMA (MG)";"MG";"VARZEA DA PALMA";284;8;62;354
2003;"VARZELANDIA (MG)";"MG";"VARZELANDIA";30;2;14;46
2003;"VAZANTE (MG)";"MG";"VAZANTE";221;6;76;303
2003;"VERDELANDIA (MG)";"MG";"VERDELANDIA";8;1;2;11
2003;"VEREDINHA (MG)";"MG";"VEREDINHA";12;0;10;22
2003;"VERISSIMO (MG)";"MG";"VERISSIMO";26;17;3;46
2003;"VERMELHO NOVO (MG)";"MG";"VERMELHO NOVO";34;2;10;46
2003;"VESPASIANO (MG)";"MG";"VESPASIANO";362;33;112;507
2003;"VICOSA (MG)";"MG";"VICOSA";505;56;123;684
2003;"VIEIRAS (MG)";"MG";"VIEIRAS";21;3;2;26
2003;"VIRGEM DA LAPA (MG)";"MG";"VIRGEM DA LAPA";38;2;13;53
2003;"VIRGINIA (MG)";"MG";"VIRGINIA";82;5;3;90
2003;"VIRGINOPOLIS (MG)";"MG";"VIRGINOPOLIS";57;5;6;68
2003;"VIRGOLANDIA (MG)";"MG";"VIRGOLANDIA";13;2;5;20
2003;"VISCONDE DO RIO BRANCO (MG)";"MG";"VISCONDE DO RIO BRANCO";578;23;39;640
2003;"VOLTA GRANDE (MG)";"MG";"VOLTA GRANDE";21;3;3;27
2003;"WENCESLAU BRAZ (MG)";"MG";"WENCESLAU BRAZ";31;2;4;37
2003;"AGUA CLARA (MS)";"MS";"AGUA CLARA";240;7;31;278
2003;"ALCINOPOLIS (MS)";"MS";"ALCINOPOLIS";46;3;8;57
2003;"AMAMBAI (MS)";"MS";"AMAMBAI";515;8;25;548
2003;"ANASTACIO (MS)";"MS";"ANASTACIO";220;6;13;239
2003;"ANAURILANDIA (MS)";"MS";"ANAURILANDIA";64;4;18;86
2003;"ANGELICA (MS)";"MS";"ANGELICA";114;1;13;128
2003;"ANTONIO JOAO (MS)";"MS";"ANTONIO JOAO";64;2;8;74
2003;"APARECIDA DO TABOADO (MS)";"MS";"APARECIDA DO TABOADO";287;7;27;321
2003;"AQUIDAUANA (MS)";"MS";"AQUIDAUANA";252;11;32;295
2003;"ARAL MOREIRA (MS)";"MS";"ARAL MOREIRA";98;8;9;115
2003;"BANDEIRANTES (MS)";"MS";"BANDEIRANTES";68;6;6;80
2003;"BATAGUASSU (MS)";"MS";"BATAGUASSU";443;11;85;539
2003;"BATAYPORA (MS)";"MS";"BATAYPORA";123;1;17;141
2003;"BELA VISTA (MS)";"MS";"BELA VISTA";128;11;15;154
2003;"BODOQUENA (MS)";"MS";"BODOQUENA";42;2;17;61
2003;"BONITO (MS)";"MS";"BONITO";160;42;34;236
2003;"BRASILANDIA (MS)";"MS";"BRASILANDIA";160;7;32;199
2003;"CAARAPO (MS)";"MS";"CAARAPO";371;5;52;428
2003;"CAMAPUA (MS)";"MS";"CAMAPUA";261;16;16;293
2003;"CAMPO GRANDE (MS)";"MS";"CAMPO GRANDE";9137;544;1226;10907
2003;"CARACOL (MS)";"MS";"CARACOL";19;6;3;28
2003;"CASSILANDIA (MS)";"MS";"CASSILANDIA";405;6;18;429
2003;"CHAPADAO DO SUL (MS)";"MS";"CHAPADAO DO SUL";438;7;26;471
2003;"CORGUINHO (MS)";"MS";"CORGUINHO";36;2;10;48
2003;"CORONEL SAPUCAIA (MS)";"MS";"CORONEL SAPUCAIA";154;1;9;164
2003;"CORUMBA (MS)";"MS";"CORUMBA";520;35;78;633
2003;"COSTA RICA (MS)";"MS";"COSTA RICA";339;6;25;370
2003;"COXIM (MS)";"MS";"COXIM";418;6;41;465
2003;"DEODAPOLIS (MS)";"MS";"DEODAPOLIS";170;2;21;193
2003;"DOIS IRMAOS DO BURITI (MS)";"MS";"DOIS IRMAOS DO BURITI";72;7;13;92
2003;"DOURADINA (MS)";"MS";"DOURADINA";151;0;8;159
2003;"DOURADOS (MS)";"MS";"DOURADOS";2815;95;198;3108
2003;"ELDORADO (MS)";"MS";"ELDORADO";135;3;16;154
2003;"FATIMA DO SUL (MS)";"MS";"FATIMA DO SUL";333;3;13;349
2003;"GLORIA DE DOURADOS (MS)";"MS";"GLORIA DE DOURADOS";167;3;15;185
2003;"GUIA LOPES DA LAGUNA (MS)";"MS";"GUIA LOPES DA LAGUNA";87;8;7;102
2003;"IGUATEMI (MS)";"MS";"IGUATEMI";155;3;26;184
2003;"INOCENCIA (MS)";"MS";"INOCENCIA";128;1;16;145
2003;"ITAPORA (MS)";"MS";"ITAPORA";298;5;30;333
2003;"ITAQUIRAI (MS)";"MS";"ITAQUIRAI";134;3;39;176
2003;"IVINHEMA (MS)";"MS";"IVINHEMA";399;7;147;553
2003;"JAPORA (MS)";"MS";"JAPORA";8;2;6;16
2003;"JARAGUARI (MS)";"MS";"JARAGUARI";39;2;5;46
2003;"JARDIM (MS)";"MS";"JARDIM";311;15;18;344
2003;"JATEI (MS)";"MS";"JATEI";30;2;11;43
2003;"JUTI (MS)";"MS";"JUTI";32;2;10;44
2003;"LADARIO (MS)";"MS";"LADARIO";97;12;11;120
2003;"LAGUNA CARAPA (MS)";"MS";"LAGUNA CARAPA";108;1;14;123
2003;"MARACAJU (MS)";"MS";"MARACAJU";591;13;40;644
2003;"MIRANDA (MS)";"MS";"MIRANDA";183;8;26;217
2003;"MUNDO NOVO (MS)";"MS";"MUNDO NOVO";217;5;24;246
2003;"NAVIRAI (MS)";"MS";"NAVIRAI";608;9;92;709
2003;"NIOAQUE (MS)";"MS";"NIOAQUE";82;9;19;110
2003;"NOVA ALVORADA DO SUL (MS)";"MS";"NOVA ALVORADA DO SUL";151;5;26;182
2003;"NOVA ANDRADINA (MS)";"MS";"NOVA ANDRADINA";726;6;58;790
2003;"NOVO HORIZONTE DO SUL (MS)";"MS";"NOVO HORIZONTE DO SUL";41;2;11;54
2003;"PARANAIBA (MS)";"MS";"PARANAIBA";671;8;45;724
2003;"PARANHOS (MS)";"MS";"PARANHOS";59;4;12;75
2003;"PEDRO GOMES (MS)";"MS";"PEDRO GOMES";64;4;5;73
2003;"PONTA PORA (MS)";"MS";"PONTA PORA";1170;27;90;1287
2003;"PORTO MURTINHO (MS)";"MS";"PORTO MURTINHO";27;7;4;38
2003;"RIBAS DO RIO PARDO (MS)";"MS";"RIBAS DO RIO PARDO";338;9;17;364
2003;"RIO BRILHANTE (MS)";"MS";"RIO BRILHANTE";428;10;79;517
2003;"RIO NEGRO (MS)";"MS";"RIO NEGRO";48;1;7;56
2003;"RIO VERDE DE MATO GROSSO (MS)";"MS";"RIO VERDE DE MATO GROSSO";244;11;11;266
2003;"ROCHEDO (MS)";"MS";"ROCHEDO";31;6;8;45
2003;"SANTA RITA DO PARDO (MS)";"MS";"SANTA RITA DO PARDO";79;5;22;106
2003;"SAO GABRIEL DO OESTE (MS)";"MS";"SAO GABRIEL DO OESTE";557;13;29;599
2003;"SELVIRIA (MS)";"MS";"SELVIRIA";68;2;13;83
2003;"SETE QUEDAS (MS)";"MS";"SETE QUEDAS";175;4;18;197
2003;"SIDROLANDIA (MS)";"MS";"SIDROLANDIA";414;11;77;502
2003;"SONORA (MS)";"MS";"SONORA";198;11;39;248
2003;"TACURU (MS)";"MS";"TACURU";63;0;8;71
2003;"TAQUARUSSU (MS)";"MS";"TAQUARUSSU";34;1;10;45
2003;"TERENOS (MS)";"MS";"TERENOS";172;4;8;184
2003;"TRES LAGOAS (MS)";"MS";"TRES LAGOAS";1205;27;191;1423
2003;"VICENTINA (MS)";"MS";"VICENTINA";77;1;15;93
2003;"ACORIZAL (MT)";"MT";"ACORIZAL";7;1;1;9
2003;"AGUA BOA (MT)";"MT";"AGUA BOA";288;5;14;307
2003;"ALTA FLORESTA (MT)";"MT";"ALTA FLORESTA";875;8;62;945
2003;"ALTO ARAGUAIA (MT)";"MT";"ALTO ARAGUAIA";83;4;9;96
2003;"ALTO BOA VISTA (MT)";"MT";"ALTO BOA VISTA";10;0;1;11
2003;"ALTO GARCAS (MT)";"MT";"ALTO GARCAS";242;3;25;270
2003;"ALTO PARAGUAI (MT)";"MT";"ALTO PARAGUAI";16;6;3;25
2003;"ALTO TAQUARI (MT)";"MT";"ALTO TAQUARI";96;4;6;106
2003;"APIACAS (MT)";"MT";"APIACAS";38;0;2;40
2003;"ARAGUAIANA (MT)";"MT";"ARAGUAIANA";7;0;2;9
2003;"ARAGUAINHA (MT)";"MT";"ARAGUAINHA";5;2;0;7
2003;"ARAPUTANGA (MT)";"MT";"ARAPUTANGA";216;4;13;233
2003;"ARENAPOLIS (MT)";"MT";"ARENAPOLIS";146;11;25;182
2003;"ARIPUANA (MT)";"MT";"ARIPUANA";143;5;10;158
2003;"BARAO DE MELGACO (MT)";"MT";"BARAO DE MELGACO";3;1;0;4
2003;"BARRA DO BUGRES (MT)";"MT";"BARRA DO BUGRES";358;10;82;450
2003;"BARRA DO GARCAS (MT)";"MT";"BARRA DO GARCAS";719;22;170;911
2003;"BOM JESUS DO ARAGUAIA (MT)";"MT";"BOM JESUS DO ARAGUAIA";0;0;1;1
2003;"BRASNORTE (MT)";"MT";"BRASNORTE";120;1;5;126
2003;"CACERES (MT)";"MT";"CACERES";600;33;100;733
2003;"CAMPINAPOLIS (MT)";"MT";"CAMPINAPOLIS";49;0;10;59
2003;"CAMPO NOVO DO PARECIS (MT)";"MT";"CAMPO NOVO DO PARECIS";523;10;36;569
2003;"CAMPO VERDE (MT)";"MT";"CAMPO VERDE";488;11;41;540
2003;"CAMPOS DE JULIO (MT)";"MT";"CAMPOS DE JULIO";100;3;7;110
2003;"CANABRAVA DO NORTE (MT)";"MT";"CANABRAVA DO NORTE";7;0;1;8
2003;"CANARANA (MT)";"MT";"CANARANA";312;0;23;335
2003;"CARLINDA (MT)";"MT";"CARLINDA";65;0;12;77
2003;"CASTANHEIRA (MT)";"MT";"CASTANHEIRA";63;1;7;71
2003;"CHAPADA DOS GUIMARAES (MT)";"MT";"CHAPADA DOS GUIMARAES";163;8;31;202
2003;"CLAUDIA (MT)";"MT";"CLAUDIA";310;2;10;322
2003;"COCALINHO (MT)";"MT";"COCALINHO";10;1;3;14
2003;"COLIDER (MT)";"MT";"COLIDER";574;9;55;638
2003;"COLNIZA (MT)";"MT";"COLNIZA";25;0;0;25
2003;"COMODORO (MT)";"MT";"COMODORO";215;1;31;247
2003;"CONFRESA (MT)";"MT";"CONFRESA";33;0;4;37
2003;"CONQUISTA D OESTE (MT)";"MT";"CONQUISTA D OESTE";11;2;6;19
2003;"COTRIGUACU (MT)";"MT";"COTRIGUACU";64;0;13;77
2003;"CUIABA (MT)";"MT";"CUIABA";5151;577;1320;7048
2003;"CURVELANDIA (MT)";"MT";"CURVELANDIA";35;0;5;40
2003;"DENISE (MT)";"MT";"DENISE";49;4;19;72
2003;"DIAMANTINO (MT)";"MT";"DIAMANTINO";350;16;39;405
2003;"DOM AQUINO (MT)";"MT";"DOM AQUINO";72;8;8;88
2003;"FELIZ NATAL (MT)";"MT";"FELIZ NATAL";114;0;6;120
2003;"FIGUEIROPOLIS D OESTE (MT)";"MT";"FIGUEIROPOLIS D OESTE";35;1;8;44
2003;"GAUCHA DO NORTE (MT)";"MT";"GAUCHA DO NORTE";26;2;1;29
2003;"GENERAL CARNEIRO (MT)";"MT";"GENERAL CARNEIRO";11;1;3;15
2003;"GLORIA D OESTE (MT)";"MT";"GLORIA D OESTE";24;3;5;32
2003;"GUARANTA DO NORTE (MT)";"MT";"GUARANTA DO NORTE";603;1;16;620
2003;"GUIRATINGA (MT)";"MT";"GUIRATINGA";87;8;3;98
2003;"INDIAVAI (MT)";"MT";"INDIAVAI";16;1;6;23
2003;"ITAUBA (MT)";"MT";"ITAUBA";87;3;4;94
2003;"ITIQUIRA (MT)";"MT";"ITIQUIRA";41;4;16;61
2003;"JACIARA (MT)";"MT";"JACIARA";390;12;60;462
2003;"JANGADA (MT)";"MT";"JANGADA";32;2;8;42
2003;"JAURU (MT)";"MT";"JAURU";127;1;16;144
2003;"JUARA (MT)";"MT";"JUARA";471;10;21;502
2003;"JUINA (MT)";"MT";"JUINA";530;3;24;557
2003;"JURUENA (MT)";"MT";"JURUENA";79;0;5;84
2003;"JUSCIMEIRA (MT)";"MT";"JUSCIMEIRA";75;2;31;108
2003;"LAMBARI D OESTE (MT)";"MT";"LAMBARI D OESTE";37;0;8;45
2003;"LUCAS DO RIO VERDE (MT)";"MT";"LUCAS DO RIO VERDE";824;16;36;876
2003;"LUCIARA (MT)";"MT";"LUCIARA";5;0;2;7
2003;"MARCELANDIA (MT)";"MT";"MARCELANDIA";280;4;10;294
2003;"MATUPA (MT)";"MT";"MATUPA";226;5;17;248
2003;"MIRASSOL D OESTE (MT)";"MT";"MIRASSOL D OESTE";470;6;27;503
2003;"NOBRES (MT)";"MT";"NOBRES";165;6;23;194
2003;"NORTELANDIA (MT)";"MT";"NORTELANDIA";43;8;10;61
2003;"NOSSA SENHORA DO LIVRAMENTO (MT)";"MT";"NOSSA SENHORA DO LIVRAMENTO";23;4;14;41
2003;"NOVA BANDEIRANTES (MT)";"MT";"NOVA BANDEIRANTES";49;3;10;62
2003;"NOVA BRASILANDIA (MT)";"MT";"NOVA BRASILANDIA";23;1;8;32
2003;"NOVA CANAA DO NORTE (MT)";"MT";"NOVA CANAA DO NORTE";132;1;15;148
2003;"NOVA GUARITA (MT)";"MT";"NOVA GUARITA";49;2;2;53
2003;"NOVA LACERDA (MT)";"MT";"NOVA LACERDA";16;1;9;26
2003;"NOVA MARILANDIA (MT)";"MT";"NOVA MARILANDIA";9;2;3;14
2003;"NOVA MARINGA (MT)";"MT";"NOVA MARINGA";35;1;3;39
2003;"NOVA MONTE VERDE (MT)";"MT";"NOVA MONTE VERDE";54;1;0;55
2003;"NOVA MUTUM (MT)";"MT";"NOVA MUTUM";435;5;8;448
2003;"NOVA NAZARE (MT)";"MT";"NOVA NAZARE";0;0;1;1
2003;"NOVA OLIMPIA (MT)";"MT";"NOVA OLIMPIA";186;11;65;262
2003;"NOVA SANTA HELENA (MT)";"MT";"NOVA SANTA HELENA";26;1;5;32
2003;"NOVA UBIRATA (MT)";"MT";"NOVA UBIRATA";49;4;1;54
2003;"NOVA XAVANTINA (MT)";"MT";"NOVA XAVANTINA";213;5;19;237
2003;"NOVO HORIZONTE DO NORTE (MT)";"MT";"NOVO HORIZONTE DO NORTE";22;0;4;26
2003;"NOVO MUNDO (MT)";"MT";"NOVO MUNDO";38;2;3;43
2003;"NOVO SANTO ANTONIO (MT)";"MT";"NOVO SANTO ANTONIO";0;0;1;1
2003;"NOVO SAO JOAQUIM (MT)";"MT";"NOVO SAO JOAQUIM";29;0;7;36
2003;"PARANAITA (MT)";"MT";"PARANAITA";141;2;12;155
2003;"PARANATINGA (MT)";"MT";"PARANATINGA";243;3;19;265
2003;"PEDRA PRETA (MT)";"MT";"PEDRA PRETA";175;16;13;204
2003;"PEIXOTO DE AZEVEDO (MT)";"MT";"PEIXOTO DE AZEVEDO";170;8;15;193
2003;"PLANALTO DA SERRA (MT)";"MT";"PLANALTO DA SERRA";5;1;2;8
2003;"POCONE (MT)";"MT";"POCONE";213;14;20;247
2003;"PONTAL DO ARAGUAIA (MT)";"MT";"PONTAL DO ARAGUAIA";11;0;1;12
2003;"PONTE BRANCA (MT)";"MT";"PONTE BRANCA";4;1;0;5
2003;"PONTES E LACERDA (MT)";"MT";"PONTES E LACERDA";626;11;46;683
2003;"PORTO ALEGRE DO NORTE (MT)";"MT";"PORTO ALEGRE DO NORTE";17;3;9;29
2003;"PORTO DOS GAUCHOS (MT)";"MT";"PORTO DOS GAUCHOS";57;1;3;61
2003;"PORTO ESPERIDIAO (MT)";"MT";"PORTO ESPERIDIAO";54;3;20;77
2003;"PORTO ESTRELA (MT)";"MT";"PORTO ESTRELA";17;4;3;24
2003;"POXOREO (MT)";"MT";"POXOREO";68;11;19;98
2003;"PRIMAVERA DO LESTE (MT)";"MT";"PRIMAVERA DO LESTE";1078;22;41;1141
2003;"QUERENCIA (MT)";"MT";"QUERENCIA";109;0;5;114
2003;"RESERVA DO CABACAL (MT)";"MT";"RESERVA DO CABACAL";14;1;4;19
2003;"RIBEIRAO CASCALHEIRA (MT)";"MT";"RIBEIRAO CASCALHEIRA";31;2;3;36
2003;"RIBEIRAOZINHO (MT)";"MT";"RIBEIRAOZINHO";6;1;3;10
2003;"RIO BRANCO (MT)";"MT";"RIO BRANCO";75;5;7;87
2003;"RONDOLANDIA (MT)";"MT";"RONDOLANDIA";1;0;3;4
2003;"RONDONOPOLIS (MT)";"MT";"RONDONOPOLIS";2498;84;188;2770
2003;"ROSARIO OESTE (MT)";"MT";"ROSARIO OESTE";89;6;8;103
2003;"SALTO DO CEU (MT)";"MT";"SALTO DO CEU";27;0;3;30
2003;"SANTA CARMEN (MT)";"MT";"SANTA CARMEN";96;1;4;101
2003;"SANTA CRUZ DO XINGU (MT)";"MT";"SANTA CRUZ DO XINGU";0;0;1;1
2003;"SANTA RITA DO TRIVELATO (MT)";"MT";"SANTA RITA DO TRIVELATO";23;0;0;23
2003;"SANTA TEREZINHA (MT)";"MT";"SANTA TEREZINHA";6;2;4;12
2003;"SANTO AFONSO (MT)";"MT";"SANTO AFONSO";18;0;5;23
2003;"SANTO ANTONIO DO LESTE (MT)";"MT";"SANTO ANTONIO DO LESTE";50;1;11;62
2003;"SANTO ANTONIO DO LEVERGER (MT)";"MT";"SANTO ANTONIO DO LEVERGER";40;7;8;55
2003;"SAO FELIX DO ARAGUAIA (MT)";"MT";"SAO FELIX DO ARAGUAIA";25;0;5;30
2003;"SAO JOSE DO POVO (MT)";"MT";"SAO JOSE DO POVO";11;0;2;13
2003;"SAO JOSE DO RIO CLARO (MT)";"MT";"SAO JOSE DO RIO CLARO";184;6;18;208
2003;"SAO JOSE DO XINGU (MT)";"MT";"SAO JOSE DO XINGU";6;1;4;11
2003;"SAO JOSE DOS QUATRO MARCOS (MT)";"MT";"SAO JOSE DOS QUATRO MARCOS";323;8;32;363
2003;"SAO PEDRO DA CIPA (MT)";"MT";"SAO PEDRO DA CIPA";12;2;14;28
2003;"SAPEZAL (MT)";"MT";"SAPEZAL";185;3;9;197
2003;"SERRA NOVA DOURADA (MT)";"MT";"SERRA NOVA DOURADA";1;0;0;1
2003;"SINOP (MT)";"MT";"SINOP";2076;26;108;2210
2003;"SORRISO (MT)";"MT";"SORRISO";1340;21;46;1407
2003;"TABAPORA (MT)";"MT";"TABAPORA";65;3;9;77
2003;"TANGARA DA SERRA (MT)";"MT";"TANGARA DA SERRA";1343;62;92;1497
2003;"TAPURAH (MT)";"MT";"TAPURAH";186;9;7;202
2003;"TERRA NOVA DO NORTE (MT)";"MT";"TERRA NOVA DO NORTE";200;2;16;218
2003;"TESOURO (MT)";"MT";"TESOURO";3;2;2;7
2003;"TORIXOREU (MT)";"MT";"TORIXOREU";14;0;3;17
2003;"UNIAO DO SUL (MT)";"MT";"UNIAO DO SUL";56;0;3;59
2003;"VALE DE SAO DOMINGOS (MT)";"MT";"VALE DE SAO DOMINGOS";5;0;6;11
2003;"VARZEA GRANDE (MT)";"MT";"VARZEA GRANDE";2783;149;270;3202
2003;"VERA (MT)";"MT";"VERA";212;2;7;221
2003;"VILA BELA DA SANTISSIMA TRINDA (MT)";"MT";"VILA BELA DA SANTISSIMA TRINDA";39;2;10;51
2003;"VILA RICA (MT)";"MT";"VILA RICA";117;2;8;127
2003;"ABAETETUBA (PA)";"PA";"ABAETETUBA";162;4;78;244
2003;"ABEL FIGUEIREDO (PA)";"PA";"ABEL FIGUEIREDO";25;4;3;32
2003;"ACARA (PA)";"PA";"ACARA";35;2;9;46
2003;"AFUA (PA)";"PA";"AFUA";0;0;0;0
2003;"AGUA AZUL DO NORTE (PA)";"PA";"AGUA AZUL DO NORTE";11;2;2;15
2003;"ALENQUER (PA)";"PA";"ALENQUER";72;2;20;94
2003;"ALMEIRIM (PA)";"PA";"ALMEIRIM";168;4;49;221
2003;"ALTAMIRA (PA)";"PA";"ALTAMIRA";557;41;28;626
2003;"ANAJAS (PA)";"PA";"ANAJAS";0;0;0;0
2003;"ANANINDEUA (PA)";"PA";"ANANINDEUA";2137;102;705;2944
2003;"ANAPU (PA)";"PA";"ANAPU";19;2;1;22
2003;"AUGUSTO CORREA (PA)";"PA";"AUGUSTO CORREA";17;2;18;37
2003;"AURORA DO PARA (PA)";"PA";"AURORA DO PARA";17;0;27;44
2003;"AVEIRO (PA)";"PA";"AVEIRO";0;0;0;0
2003;"BAGRE (PA)";"PA";"BAGRE";0;0;0;0
2003;"BAIAO (PA)";"PA";"BAIAO";10;0;3;13
2003;"BANNACH (PA)";"PA";"BANNACH";9;0;0;9
2003;"BARCARENA (PA)";"PA";"BARCARENA";295;80;236;611
2003;"BELEM (PA)";"PA";"BELEM";5383;604;2170;8157
2003;"BELTERRA (PA)";"PA";"BELTERRA";13;0;4;17
2003;"BENEVIDES (PA)";"PA";"BENEVIDES";162;9;36;207
2003;"BOM JESUS DO TOCANTINS (PA)";"PA";"BOM JESUS DO TOCANTINS";33;23;4;60
2003;"BONITO (PA)";"PA";"BONITO";16;0;15;31
2003;"BRAGANCA (PA)";"PA";"BRAGANCA";226;23;88;337
2003;"BRASIL NOVO (PA)";"PA";"BRASIL NOVO";36;23;1;60
2003;"BREJO GRANDE DO ARAGUAIA (PA)";"PA";"BREJO GRANDE DO ARAGUAIA";6;3;4;13
2003;"BREU BRANCO (PA)";"PA";"BREU BRANCO";106;8;19;133
2003;"BREVES (PA)";"PA";"BREVES";9;0;2;11
2003;"BUJARU (PA)";"PA";"BUJARU";15;2;4;21
2003;"CACHOEIRA DO ARARI (PA)";"PA";"CACHOEIRA DO ARARI";2;1;1;4
2003;"CACHOEIRA DO PIRIA (PA)";"PA";"CACHOEIRA DO PIRIA";8;2;6;16
2003;"CAMETA (PA)";"PA";"CAMETA";49;4;14;67
2003;"CANAA DOS CARAJAS (PA)";"PA";"CANAA DOS CARAJAS";42;13;9;64
2003;"CAPANEMA (PA)";"PA";"CAPANEMA";446;12;65;523
2003;"CAPITAO POCO (PA)";"PA";"CAPITAO POCO";204;11;32;247
2003;"CASTANHAL (PA)";"PA";"CASTANHAL";1481;78;178;1737
2003;"CHAVES (PA)";"PA";"CHAVES";0;0;0;0
2003;"COLARES (PA)";"PA";"COLARES";1;0;1;2
2003;"CONCEICAO DO ARAGUAIA (PA)";"PA";"CONCEICAO DO ARAGUAIA";222;18;39;279
2003;"CONCORDIA DO PARA (PA)";"PA";"CONCORDIA DO PARA";53;0;6;59
2003;"CUMARU DO NORTE (PA)";"PA";"CUMARU DO NORTE";7;0;3;10
2003;"CURIONOPOLIS (PA)";"PA";"CURIONOPOLIS";34;60;0;94
2003;"CURRALINHO (PA)";"PA";"CURRALINHO";1;0;0;1
2003;"CURUA (PA)";"PA";"CURUA";0;0;0;0
2003;"CURUCA (PA)";"PA";"CURUCA";13;3;4;20
2003;"DOM ELISEU (PA)";"PA";"DOM ELISEU";249;21;9;279
2003;"ELDORADO DOS CARAJAS (PA)";"PA";"ELDORADO DOS CARAJAS";52;4;2;58
2003;"FARO (PA)";"PA";"FARO";2;1;0;3
2003;"FLORESTA DO ARAGUAIA (PA)";"PA";"FLORESTA DO ARAGUAIA";29;0;2;31
2003;"GARRAFAO DO NORTE (PA)";"PA";"GARRAFAO DO NORTE";36;0;2;38
2003;"GOIANESIA DO PARA (PA)";"PA";"GOIANESIA DO PARA";86;5;12;103
2003;"GURUPA (PA)";"PA";"GURUPA";2;0;0;2
2003;"IGARAPE ACU (PA)";"PA";"IGARAPE ACU";81;33;29;143
2003;"IGARAPE MIRI (PA)";"PA";"IGARAPE MIRI";32;9;8;49
2003;"INHANGAPI (PA)";"PA";"INHANGAPI";10;0;14;24
2003;"IPIXUNA DO PARA (PA)";"PA";"IPIXUNA DO PARA";55;2;5;62
2003;"IRITUIA (PA)";"PA";"IRITUIA";44;2;15;61
2003;"ITAITUBA (PA)";"PA";"ITAITUBA";379;31;34;444
2003;"ITUPIRANGA (PA)";"PA";"ITUPIRANGA";41;34;6;81
2003;"JACAREACANGA (PA)";"PA";"JACAREACANGA";3;0;0;3
2003;"JACUNDA (PA)";"PA";"JACUNDA";277;5;24;306
2003;"JURUTI (PA)";"PA";"JURUTI";7;1;0;8
2003;"LIMOEIRO DO AJURU (PA)";"PA";"LIMOEIRO DO AJURU";0;0;0;0
2003;"MAE DO RIO (PA)";"PA";"MAE DO RIO";205;6;24;235
2003;"MAGALHAES BARATA (PA)";"PA";"MAGALHAES BARATA";5;1;2;8
2003;"MARABA (PA)";"PA";"MARABA";1514;150;179;1843
2003;"MARACANA (PA)";"PA";"MARACANA";6;3;6;15
2003;"MARAPANIM (PA)";"PA";"MARAPANIM";18;8;9;35
2003;"MARITUBA (PA)";"PA";"MARITUBA";246;8;72;326
2003;"MEDICILANDIA (PA)";"PA";"MEDICILANDIA";95;7;6;108
2003;"MELGACO (PA)";"PA";"MELGACO";1;0;0;1
2003;"MOCAJUBA (PA)";"PA";"MOCAJUBA";2;1;1;4
2003;"MOJU (PA)";"PA";"MOJU";72;2;40;114
2003;"MONTE ALEGRE (PA)";"PA";"MONTE ALEGRE";131;1;60;192
2003;"MUANA (PA)";"PA";"MUANA";0;1;0;1
2003;"NOVA ESPERANCA DO PIRIA (PA)";"PA";"NOVA ESPERANCA DO PIRIA";19;1;3;23
2003;"NOVA IPIXUNA (PA)";"PA";"NOVA IPIXUNA";50;4;11;65
2003;"NOVA TIMBOTEUA (PA)";"PA";"NOVA TIMBOTEUA";30;3;5;38
2003;"NOVO PROGRESSO (PA)";"PA";"NOVO PROGRESSO";29;1;1;31
2003;"NOVO REPARTIMENTO (PA)";"PA";"NOVO REPARTIMENTO";118;5;7;130
2003;"OBIDOS (PA)";"PA";"OBIDOS";96;0;15;111
2003;"OEIRAS DO PARA (PA)";"PA";"OEIRAS DO PARA";3;1;0;4
2003;"ORIXIMINA (PA)";"PA";"ORIXIMINA";146;5;11;162
2003;"OUREM (PA)";"PA";"OUREM";40;2;7;49
2003;"OURILANDIA DO NORTE (PA)";"PA";"OURILANDIA DO NORTE";41;0;5;46
2003;"PACAJA (PA)";"PA";"PACAJA";43;4;3;50
2003;"PALESTINA DO PARA (PA)";"PA";"PALESTINA DO PARA";8;1;0;9
2003;"PARAGOMINAS (PA)";"PA";"PARAGOMINAS";715;12;35;762
2003;"PARAUAPEBAS (PA)";"PA";"PARAUAPEBAS";445;228;78;751
2003;"PAU D ARCO (PA)";"PA";"PAU D ARCO";5;1;0;6
2003;"PEIXE BOI (PA)";"PA";"PEIXE BOI";10;1;7;18
2003;"PICARRA (PA)";"PA";"PICARRA";3;0;0;3
2003;"PLACAS (PA)";"PA";"PLACAS";12;2;1;15
2003;"PONTA DE PEDRAS (PA)";"PA";"PONTA DE PEDRAS";1;0;0;1
2003;"PORTEL (PA)";"PA";"PORTEL";7;0;0;7
2003;"PORTO DE MOZ (PA)";"PA";"PORTO DE MOZ";8;0;0;8
2003;"PRAINHA (PA)";"PA";"PRAINHA";11;0;0;11
2003;"PRIMAVERA (PA)";"PA";"PRIMAVERA";10;1;6;17
2003;"QUATIPURU (PA)";"PA";"QUATIPURU";3;3;10;16
2003;"REDENCAO (PA)";"PA";"REDENCAO";495;26;13;534
2003;"RIO MARIA (PA)";"PA";"RIO MARIA";114;22;5;141
2003;"RONDON DO PARA (PA)";"PA";"RONDON DO PARA";263;29;5;297
2003;"RUROPOLIS (PA)";"PA";"RUROPOLIS";63;2;4;69
2003;"SALINOPOLIS (PA)";"PA";"SALINOPOLIS";79;12;23;114
2003;"SALVATERRA (PA)";"PA";"SALVATERRA";13;8;5;26
2003;"SANTA BARBARA DO PARA (PA)";"PA";"SANTA BARBARA DO PARA";21;6;1;28
2003;"SANTA CRUZ DO ARARI (PA)";"PA";"SANTA CRUZ DO ARARI";1;0;0;1
2003;"SANTA ISABEL DO PARA (PA)";"PA";"SANTA ISABEL DO PARA";376;9;52;437
2003;"SANTA LUZIA DO PARA (PA)";"PA";"SANTA LUZIA DO PARA";67;1;18;86
2003;"SANTA MARIA DAS BARREIRAS (PA)";"PA";"SANTA MARIA DAS BARREIRAS";8;0;1;9
2003;"SANTA MARIA DO PARA (PA)";"PA";"SANTA MARIA DO PARA";148;16;25;189
2003;"SANTANA DO ARAGUAIA (PA)";"PA";"SANTANA DO ARAGUAIA";57;5;11;73
2003;"SANTAREM (PA)";"PA";"SANTAREM";1423;38;354;1815
2003;"SANTAREM NOVO (PA)";"PA";"SANTAREM NOVO";6;3;6;15
2003;"SANTO ANTONIO DO TAUA (PA)";"PA";"SANTO ANTONIO DO TAUA";45;5;37;87
2003;"SAO CAETANO DE ODIVELAS (PA)";"PA";"SAO CAETANO DE ODIVELAS";13;1;0;14
2003;"SAO DOMINGOS DO ARAGUAIA (PA)";"PA";"SAO DOMINGOS DO ARAGUAIA";46;13;11;70
2003;"SAO DOMINGOS DO CAPIM (PA)";"PA";"SAO DOMINGOS DO CAPIM";19;0;8;27
2003;"SAO FELIX DO XINGU (PA)";"PA";"SAO FELIX DO XINGU";37;1;6;44
2003;"SAO FRANCISCO DO PARA (PA)";"PA";"SAO FRANCISCO DO PARA";20;19;11;50
2003;"SAO GERALDO DO ARAGUAIA (PA)";"PA";"SAO GERALDO DO ARAGUAIA";44;3;8;55
2003;"SAO JOAO DA PONTA (PA)";"PA";"SAO JOAO DA PONTA";1;2;2;5
2003;"SAO JOAO DE PIRABAS (PA)";"PA";"SAO JOAO DE PIRABAS";11;7;8;26
2003;"SAO JOAO DO ARAGUAIA (PA)";"PA";"SAO JOAO DO ARAGUAIA";6;4;5;15
2003;"SAO MIGUEL DO GUAMA (PA)";"PA";"SAO MIGUEL DO GUAMA";242;12;37;291
2003;"SAO SEBASTIAO DA BOA VISTA (PA)";"PA";"SAO SEBASTIAO DA BOA VISTA";0;0;0;0
2003;"SAPUCAIA (PA)";"PA";"SAPUCAIA";15;2;1;18
2003;"SENADOR JOSE PORFIRIO (PA)";"PA";"SENADOR JOSE PORFIRIO";7;0;0;7
2003;"SOURE (PA)";"PA";"SOURE";13;2;6;21
2003;"TAILANDIA (PA)";"PA";"TAILANDIA";263;6;13;282
2003;"TERRA ALTA (PA)";"PA";"TERRA ALTA";11;6;6;23
2003;"TERRA SANTA (PA)";"PA";"TERRA SANTA";4;1;1;6
2003;"TOME ACU (PA)";"PA";"TOME ACU";240;7;37;284
2003;"TRACUATEUA (PA)";"PA";"TRACUATEUA";12;3;27;42
2003;"TRAIRAO (PA)";"PA";"TRAIRAO";34;0;0;34
2003;"TUCUMA (PA)";"PA";"TUCUMA";152;5;13;170
2003;"TUCURUI (PA)";"PA";"TUCURUI";425;48;92;565
2003;"ULIANOPOLIS (PA)";"PA";"ULIANOPOLIS";89;11;8;108
2003;"URUARA (PA)";"PA";"URUARA";189;1;6;196
2003;"VIGIA (PA)";"PA";"VIGIA";78;1;17;96
2003;"VISEU (PA)";"PA";"VISEU";19;4;11;34
2003;"VITORIA DO XINGU (PA)";"PA";"VITORIA DO XINGU";5;9;3;17
2003;"XINGUARA (PA)";"PA";"XINGUARA";378;13;74;465
2003;"AGUA BRANCA (PB)";"PB";"AGUA BRANCA";1;0;2;3
2003;"AGUIAR (PB)";"PB";"AGUIAR";4;0;1;5
2003;"ALAGOA GRANDE (PB)";"PB";"ALAGOA GRANDE";68;7;22;97
2003;"ALAGOA NOVA (PB)";"PB";"ALAGOA NOVA";49;4;11;64
2003;"ALAGOINHA (PB)";"PB";"ALAGOINHA";35;2;8;45
2003;"ALCANTIL (PB)";"PB";"ALCANTIL";14;1;4;19
2003;"ALGODAO DE JANDAIRA (PB)";"PB";"ALGODAO DE JANDAIRA";8;0;1;9
2003;"ALHANDRA (PB)";"PB";"ALHANDRA";38;9;7;54
2003;"AMPARO (PB)";"PB";"AMPARO";0;1;3;4
2003;"APARECIDA (PB)";"PB";"APARECIDA";11;1;1;13
2003;"ARACAGI (PB)";"PB";"ARACAGI";37;0;12;49
2003;"ARARA (PB)";"PB";"ARARA";33;1;14;48
2003;"ARARUNA (PB)";"PB";"ARARUNA";57;8;15;80
2003;"AREIA (PB)";"PB";"AREIA";85;11;8;104
2003;"AREIA DE BARAUNAS (PB)";"PB";"AREIA DE BARAUNAS";1;1;1;3
2003;"AREIAL (PB)";"PB";"AREIAL";7;0;4;11
2003;"AROEIRAS (PB)";"PB";"AROEIRAS";11;1;3;15
2003;"ASSUNCAO (PB)";"PB";"ASSUNCAO";3;2;1;6
2003;"BAIA DA TRAICAO (PB)";"PB";"BAIA DA TRAICAO";3;2;3;8
2003;"BANANEIRAS (PB)";"PB";"BANANEIRAS";44;2;14;60
2003;"BARAUNA (PB)";"PB";"BARAUNA";7;1;0;8
2003;"BARRA DE SANTA ROSA (PB)";"PB";"BARRA DE SANTA ROSA";27;0;9;36
2003;"BARRA DE SANTANA (PB)";"PB";"BARRA DE SANTANA";24;0;2;26
2003;"BARRA DE SAO MIGUEL (PB)";"PB";"BARRA DE SAO MIGUEL";1;0;2;3
2003;"BAYEUX (PB)";"PB";"BAYEUX";308;21;121;450
2003;"BELEM (PB)";"PB";"BELEM";88;1;11;100
2003;"BELEM DO BREJO DO CRUZ (PB)";"PB";"BELEM DO BREJO DO CRUZ";6;8;1;15
2003;"BERNARDINO BATISTA (PB)";"PB";"BERNARDINO BATISTA";0;0;0;0
2003;"BOA VENTURA (PB)";"PB";"BOA VENTURA";6;4;0;10
2003;"BOA VISTA (PB)";"PB";"BOA VISTA";37;1;4;42
2003;"BOM JESUS (PB)";"PB";"BOM JESUS";2;1;0;3
2003;"BOM SUCESSO (PB)";"PB";"BOM SUCESSO";6;1;2;9
2003;"BONITO DE SANTA FE (PB)";"PB";"BONITO DE SANTA FE";11;1;0;12
2003;"BOQUEIRAO (PB)";"PB";"BOQUEIRAO";95;2;13;110
2003;"BORBOREMA (PB)";"PB";"BORBOREMA";17;3;0;20
2003;"BREJO DO CRUZ (PB)";"PB";"BREJO DO CRUZ";37;4;2;43
2003;"BREJO DOS SANTOS (PB)";"PB";"BREJO DOS SANTOS";11;2;1;14
2003;"CAAPORA (PB)";"PB";"CAAPORA";13;11;1;25
2003;"CABACEIRAS (PB)";"PB";"CABACEIRAS";16;6;13;35
2003;"CABEDELO (PB)";"PB";"CABEDELO";182;16;20;218
2003;"CACHOEIRA DOS INDIOS (PB)";"PB";"CACHOEIRA DOS INDIOS";5;0;2;7
2003;"CACIMBA DE AREIA (PB)";"PB";"CACIMBA DE AREIA";9;0;2;11
2003;"CACIMBA DE DENTRO (PB)";"PB";"CACIMBA DE DENTRO";29;5;25;59
2003;"CACIMBAS (PB)";"PB";"CACIMBAS";3;0;2;5
2003;"CAICARA (PB)";"PB";"CAICARA";11;2;2;15
2003;"CAJAZEIRAS (PB)";"PB";"CAJAZEIRAS";405;11;23;439
2003;"CAJAZEIRINHAS (PB)";"PB";"CAJAZEIRINHAS";3;1;0;4
2003;"CALDAS BRANDAO (PB)";"PB";"CALDAS BRANDAO";6;1;1;8
2003;"CAMALAU (PB)";"PB";"CAMALAU";12;2;6;20
2003;"CAMPINA GRANDE (PB)";"PB";"CAMPINA GRANDE";3347;124;598;4069
2003;"CAPIM (PB)";"PB";"CAPIM";6;0;2;8
2003;"CARAUBAS (PB)";"PB";"CARAUBAS";0;0;0;0
2003;"CARRAPATEIRA (PB)";"PB";"CARRAPATEIRA";0;2;0;2
2003;"CASSERENGUE (PB)";"PB";"CASSERENGUE";8;0;6;14
2003;"CATINGUEIRA (PB)";"PB";"CATINGUEIRA";5;2;1;8
2003;"CATOLE DO ROCHA (PB)";"PB";"CATOLE DO ROCHA";245;10;12;267
2003;"CATURITE (PB)";"PB";"CATURITE";17;1;3;21
2003;"CONCEICAO (PB)";"PB";"CONCEICAO";69;6;6;81
2003;"CONDADO (PB)";"PB";"CONDADO";15;1;1;17
2003;"CONDE (PB)";"PB";"CONDE";22;4;6;32
2003;"CONGO (PB)";"PB";"CONGO";12;2;0;14
2003;"COREMAS (PB)";"PB";"COREMAS";26;2;4;32
2003;"COXIXOLA (PB)";"PB";"COXIXOLA";2;0;0;2
2003;"CRUZ DO ESPIRITO SANTO (PB)";"PB";"CRUZ DO ESPIRITO SANTO";7;1;3;11
2003;"CUBATI (PB)";"PB";"CUBATI";8;1;0;9
2003;"CUITE (PB)";"PB";"CUITE";74;0;9;83
2003;"CUITE DE MAMANGUAPE (PB)";"PB";"CUITE DE MAMANGUAPE";6;3;10;19
2003;"CUITEGI (PB)";"PB";"CUITEGI";7;2;1;10
2003;"CURRAL DE CIMA (PB)";"PB";"CURRAL DE CIMA";12;1;5;18
2003;"CURRAL VELHO (PB)";"PB";"CURRAL VELHO";1;1;1;3
2003;"DAMIAO (PB)";"PB";"DAMIAO";9;0;3;12
2003;"DESTERRO (PB)";"PB";"DESTERRO";11;0;2;13
2003;"DIAMANTE (PB)";"PB";"DIAMANTE";3;2;0;5
2003;"DONA INES (PB)";"PB";"DONA INES";12;0;5;17
2003;"DUAS ESTRADAS (PB)";"PB";"DUAS ESTRADAS";4;4;1;9
2003;"EMAS (PB)";"PB";"EMAS";3;0;2;5
2003;"ESPERANCA (PB)";"PB";"ESPERANCA";245;13;57;315
2003;"FAGUNDES (PB)";"PB";"FAGUNDES";16;3;11;30
2003;"FREI MARTINHO (PB)";"PB";"FREI MARTINHO";6;2;1;9
2003;"GADO BRAVO (PB)";"PB";"GADO BRAVO";11;2;3;16
2003;"GUARABIRA (PB)";"PB";"GUARABIRA";303;15;103;421
2003;"GURINHEM (PB)";"PB";"GURINHEM";12;1;8;21
2003;"GURJAO (PB)";"PB";"GURJAO";2;1;0;3
2003;"IBIARA (PB)";"PB";"IBIARA";3;0;1;4
2003;"IGARACY (PB)";"PB";"IGARACY";8;3;1;12
2003;"IMACULADA (PB)";"PB";"IMACULADA";5;0;0;5
2003;"INGA (PB)";"PB";"INGA";102;0;20;122
2003;"ITABAIANA (PB)";"PB";"ITABAIANA";193;9;17;219
2003;"ITAPORANGA (PB)";"PB";"ITAPORANGA";61;8;7;76
2003;"ITAPOROROCA (PB)";"PB";"ITAPOROROCA";44;1;5;50
2003;"ITATUBA (PB)";"PB";"ITATUBA";12;2;1;15
2003;"JACARAU (PB)";"PB";"JACARAU";30;2;8;40
2003;"JERICO (PB)";"PB";"JERICO";26;1;0;27
2003;"JOAO PESSOA (PB)";"PB";"JOAO PESSOA";3279;442;826;4547
2003;"JUAREZ TAVORA (PB)";"PB";"JUAREZ TAVORA";9;2;8;19
2003;"JUAZEIRINHO (PB)";"PB";"JUAZEIRINHO";37;3;3;43
2003;"JUNCO DO SERIDO (PB)";"PB";"JUNCO DO SERIDO";22;1;1;24
2003;"JURIPIRANGA (PB)";"PB";"JURIPIRANGA";26;1;15;42
2003;"JURU (PB)";"PB";"JURU";8;2;0;10
2003;"LAGOA (PB)";"PB";"LAGOA";6;2;3;11
2003;"LAGOA DE DENTRO (PB)";"PB";"LAGOA DE DENTRO";12;0;5;17
2003;"LAGOA SECA (PB)";"PB";"LAGOA SECA";70;6;11;87
2003;"LASTRO (PB)";"PB";"LASTRO";7;1;0;8
2003;"LIVRAMENTO (PB)";"PB";"LIVRAMENTO";20;2;1;23
2003;"LOGRADOURO (PB)";"PB";"LOGRADOURO";0;1;3;4
2003;"LUCENA (PB)";"PB";"LUCENA";12;3;7;22
2003;"MAE D AGUA (PB)";"PB";"MAE D AGUA";1;1;4;6
2003;"MALTA (PB)";"PB";"MALTA";2;2;1;5
2003;"MAMANGUAPE (PB)";"PB";"MAMANGUAPE";246;7;48;301
2003;"MANAIRA (PB)";"PB";"MANAIRA";5;0;1;6
2003;"MARCACAO (PB)";"PB";"MARCACAO";0;3;2;5
2003;"MARI (PB)";"PB";"MARI";47;4;22;73
2003;"MARIZOPOLIS (PB)";"PB";"MARIZOPOLIS";7;2;0;9
2003;"MASSARANDUBA (PB)";"PB";"MASSARANDUBA";14;0;3;17
2003;"MATARACA (PB)";"PB";"MATARACA";21;2;6;29
2003;"MATINHAS (PB)";"PB";"MATINHAS";1;0;0;1
2003;"MATO GROSSO (PB)";"PB";"MATO GROSSO";9;1;1;11
2003;"MATUREIA (PB)";"PB";"MATUREIA";11;0;0;11
2003;"MOGEIRO (PB)";"PB";"MOGEIRO";12;2;2;16
2003;"MONTADAS (PB)";"PB";"MONTADAS";7;0;4;11
2003;"MONTE HOREBE (PB)";"PB";"MONTE HOREBE";4;0;2;6
2003;"MONTEIRO (PB)";"PB";"MONTEIRO";207;25;20;252
2003;"MULUNGU (PB)";"PB";"MULUNGU";20;0;5;25
2003;"NATUBA (PB)";"PB";"NATUBA";6;1;0;7
2003;"NAZAREZINHO (PB)";"PB";"NAZAREZINHO";14;0;2;16
2003;"NOVA FLORESTA (PB)";"PB";"NOVA FLORESTA";21;1;5;27
2003;"NOVA OLINDA (PB)";"PB";"NOVA OLINDA";4;1;1;6
2003;"NOVA PALMEIRA (PB)";"PB";"NOVA PALMEIRA";8;1;2;11
2003;"OLHO D AGUA (PB)";"PB";"OLHO D AGUA";4;3;3;10
2003;"OLIVEDOS (PB)";"PB";"OLIVEDOS";16;2;4;22
2003;"OURO VELHO (PB)";"PB";"OURO VELHO";8;5;0;13
2003;"PARARI (PB)";"PB";"PARARI";0;1;0;1
2003;"PASSAGEM (PB)";"PB";"PASSAGEM";8;0;1;9
2003;"PATOS (PB)";"PB";"PATOS";697;20;30;747
2003;"PAULISTA (PB)";"PB";"PAULISTA";31;3;2;36
2003;"PEDRA BRANCA (PB)";"PB";"PEDRA BRANCA";5;0;3;8
2003;"PEDRA LAVRADA (PB)";"PB";"PEDRA LAVRADA";8;1;2;11
2003;"PEDRAS DE FOGO (PB)";"PB";"PEDRAS DE FOGO";196;11;41;248
2003;"PEDRO REGIS (PB)";"PB";"PEDRO REGIS";11;1;2;14
2003;"PIANCO (PB)";"PB";"PIANCO";52;5;3;60
2003;"PICUI (PB)";"PB";"PICUI";54;1;9;64
2003;"PILAR (PB)";"PB";"PILAR";11;1;9;21
2003;"PILOES (PB)";"PB";"PILOES";7;1;3;11
2003;"PILOEZINHOS (PB)";"PB";"PILOEZINHOS";6;2;2;10
2003;"PIRPIRITUBA (PB)";"PB";"PIRPIRITUBA";15;1;5;21
2003;"PITIMBU (PB)";"PB";"PITIMBU";9;5;3;17
2003;"POCINHOS (PB)";"PB";"POCINHOS";57;3;10;70
2003;"POCO DANTAS (PB)";"PB";"POCO DANTAS";3;0;1;4
2003;"POCO DE JOSE DE MOURA (PB)";"PB";"POCO DE JOSE DE MOURA";3;0;0;3
2003;"POMBAL (PB)";"PB";"POMBAL";247;2;10;259
2003;"PRATA (PB)";"PB";"PRATA";10;1;1;12
2003;"PRINCESA ISABEL (PB)";"PB";"PRINCESA ISABEL";78;16;1;95
2003;"PUXINANA (PB)";"PB";"PUXINANA";36;2;3;41
2003;"QUEIMADAS (PB)";"PB";"QUEIMADAS";186;20;46;252
2003;"QUIXABA (PB)";"PB";"QUIXABA";3;0;2;5
2003;"REMIGIO (PB)";"PB";"REMIGIO";142;2;11;155
2003;"RIACHAO (PB)";"PB";"RIACHAO";3;0;2;5
2003;"RIACHAO DO BACAMARTE (PB)";"PB";"RIACHAO DO BACAMARTE";2;0;2;4
2003;"RIACHAO DO POCO (PB)";"PB";"RIACHAO DO POCO";1;0;5;6
2003;"RIACHO DOS CAVALOS (PB)";"PB";"RIACHO DOS CAVALOS";6;0;2;8
2003;"RIO TINTO (PB)";"PB";"RIO TINTO";39;1;10;50
2003;"SALGADINHO (PB)";"PB";"SALGADINHO";4;0;0;4
2003;"SALGADO DE SAO FELIX (PB)";"PB";"SALGADO DE SAO FELIX";13;2;0;15
2003;"SANTA CECILIA (PB)";"PB";"SANTA CECILIA";1;0;2;3
2003;"SANTA CRUZ (PB)";"PB";"SANTA CRUZ";8;2;4;14
2003;"SANTA HELENA (PB)";"PB";"SANTA HELENA";6;0;3;9
2003;"SANTA INES (PB)";"PB";"SANTA INES";7;0;0;7
2003;"SANTA LUZIA (PB)";"PB";"SANTA LUZIA";215;9;13;237
2003;"SANTA RITA (PB)";"PB";"SANTA RITA";374;25;116;515
2003;"SANTA TERESINHA (PB)";"PB";"SANTA TERESINHA";19;0;5;24
2003;"SANTANA DE MANGUEIRA (PB)";"PB";"SANTANA DE MANGUEIRA";4;0;0;4
2003;"SANTANA DOS GARROTES (PB)";"PB";"SANTANA DOS GARROTES";11;1;0;12
2003;"SANTAREM (PB)";"PB";"SANTAREM";3;0;0;3
2003;"SANTO ANDRE (PB)";"PB";"SANTO ANDRE";7;0;0;7
2003;"SAO BENTO (PB)";"PB";"SAO BENTO";202;12;7;221
2003;"SAO BENTO DE POMBAL (PB)";"PB";"SAO BENTO DE POMBAL";3;2;1;6
2003;"SAO DOMINGOS DE POMBAL (PB)";"PB";"SAO DOMINGOS DE POMBAL";1;0;2;3
2003;"SAO DOMINGOS DO CARIRI (PB)";"PB";"SAO DOMINGOS DO CARIRI";1;0;1;2
2003;"SAO FRANCISCO (PB)";"PB";"SAO FRANCISCO";9;0;1;10
2003;"SAO JOAO DO CARIRI (PB)";"PB";"SAO JOAO DO CARIRI";0;2;2;4
2003;"SAO JOAO DO RIO DO PEIXE (PB)";"PB";"SAO JOAO DO RIO DO PEIXE";26;3;4;33
2003;"SAO JOAO DO TIGRE (PB)";"PB";"SAO JOAO DO TIGRE";7;0;1;8
2003;"SAO JOSE DA LAGOA TAPADA (PB)";"PB";"SAO JOSE DA LAGOA TAPADA";7;0;0;7
2003;"SAO JOSE DE CAIANA (PB)";"PB";"SAO JOSE DE CAIANA";5;1;1;7
2003;"SAO JOSE DE ESPINHARAS (PB)";"PB";"SAO JOSE DE ESPINHARAS";10;0;1;11
2003;"SAO JOSE DE PIRANHAS (PB)";"PB";"SAO JOSE DE PIRANHAS";20;3;1;24
2003;"SAO JOSE DE PRINCESA (PB)";"PB";"SAO JOSE DE PRINCESA";2;0;0;2
2003;"SAO JOSE DO BONFIM (PB)";"PB";"SAO JOSE DO BONFIM";4;0;1;5
2003;"SAO JOSE DO BREJO DO CRUZ (PB)";"PB";"SAO JOSE DO BREJO DO CRUZ";0;0;0;0
2003;"SAO JOSE DO SABUGI (PB)";"PB";"SAO JOSE DO SABUGI";12;2;1;15
2003;"SAO JOSE DOS CORDEIROS (PB)";"PB";"SAO JOSE DOS CORDEIROS";1;2;0;3
2003;"SAO JOSE DOS RAMOS (PB)";"PB";"SAO JOSE DOS RAMOS";23;2;3;28
2003;"SAO MAMEDE (PB)";"PB";"SAO MAMEDE";14;2;1;17
2003;"SAO MIGUEL DE TAIPU (PB)";"PB";"SAO MIGUEL DE TAIPU";10;0;2;12
2003;"SAO SEBASTIAO DE LAGOA DE ROCA (PB)";"PB";"SAO SEBASTIAO DE LAGOA DE ROCA";12;1;4;17
2003;"SAO SEBASTIAO DO UMBUZEIRO (PB)";"PB";"SAO SEBASTIAO DO UMBUZEIRO";5;0;1;6
2003;"SAPE (PB)";"PB";"SAPE";332;8;52;392
2003;"SERIDO (PB)";"PB";"SERIDO";8;1;2;11
2003;"SERRA BRANCA (PB)";"PB";"SERRA BRANCA";50;6;2;58
2003;"SERRA DA RAIZ (PB)";"PB";"SERRA DA RAIZ";2;0;3;5
2003;"SERRA GRANDE (PB)";"PB";"SERRA GRANDE";4;0;0;4
2003;"SERRA REDONDA (PB)";"PB";"SERRA REDONDA";6;0;2;8
2003;"SERRARIA (PB)";"PB";"SERRARIA";12;4;3;19
2003;"SERTAOZINHO (PB)";"PB";"SERTAOZINHO";5;1;0;6
2003;"SOBRADO (PB)";"PB";"SOBRADO";9;1;1;11
2003;"SOLANEA (PB)";"PB";"SOLANEA";116;8;25;149
2003;"SOLEDADE (PB)";"PB";"SOLEDADE";63;2;5;70
2003;"SOSSEGO (PB)";"PB";"SOSSEGO";10;1;2;13
2003;"SOUSA (PB)";"PB";"SOUSA";493;11;38;542
2003;"SUME (PB)";"PB";"SUME";53;6;9;68
2003;"TACIMA (PB)";"PB";"TACIMA";19;1;8;28
2003;"TAPEROA (PB)";"PB";"TAPEROA";27;2;3;32
2003;"TAVARES (PB)";"PB";"TAVARES";19;4;2;25
2003;"TEIXEIRA (PB)";"PB";"TEIXEIRA";90;5;11;106
2003;"TENORIO (PB)";"PB";"TENORIO";2;0;0;2
2003;"TRIUNFO (PB)";"PB";"TRIUNFO";4;1;0;5
2003;"UIRAUNA (PB)";"PB";"UIRAUNA";56;3;3;62
2003;"UMBUZEIRO (PB)";"PB";"UMBUZEIRO";27;6;12;45
2003;"VARZEA (PB)";"PB";"VARZEA";4;2;1;7
2003;"VIEIROPOLIS (PB)";"PB";"VIEIROPOLIS";6;0;2;8
2003;"VISTA SERRANA (PB)";"PB";"VISTA SERRANA";5;0;2;7
2003;"ZABELE (PB)";"PB";"ZABELE";3;0;0;3
2003;"ABREU E LIMA (PE)";"PE";"ABREU E LIMA";346;54;184;584
2003;"AFOGADOS DA INGAZEIRA (PE)";"PE";"AFOGADOS DA INGAZEIRA";184;15;9;208
2003;"AFRANIO (PE)";"PE";"AFRANIO";39;6;6;51
2003;"AGRESTINA (PE)";"PE";"AGRESTINA";75;3;7;85
2003;"AGUA PRETA (PE)";"PE";"AGUA PRETA";107;20;22;149
2003;"AGUAS BELAS (PE)";"PE";"AGUAS BELAS";154;23;22;199
2003;"ALAGOINHA (PE)";"PE";"ALAGOINHA";54;7;6;67
2003;"ALIANCA (PE)";"PE";"ALIANCA";66;2;38;106
2003;"ALTINHO (PE)";"PE";"ALTINHO";35;5;15;55
2003;"AMARAJI (PE)";"PE";"AMARAJI";36;4;9;49
2003;"ANGELIM (PE)";"PE";"ANGELIM";17;2;2;21
2003;"ARACOIABA (PE)";"PE";"ARACOIABA";32;14;30;76
2003;"ARARIPINA (PE)";"PE";"ARARIPINA";585;20;31;636
2003;"ARCOVERDE (PE)";"PE";"ARCOVERDE";859;47;51;957
2003;"BARRA DE GUABIRABA (PE)";"PE";"BARRA DE GUABIRABA";39;2;9;50
2003;"BARREIROS (PE)";"PE";"BARREIROS";213;5;16;234
2003;"BELEM DE MARIA (PE)";"PE";"BELEM DE MARIA";50;7;3;60
2003;"BELEM DE SAO FRANCISCO (PE)";"PE";"BELEM DE SAO FRANCISCO";60;4;4;68
2003;"BELO JARDIM (PE)";"PE";"BELO JARDIM";369;18;36;423
2003;"BETANIA (PE)";"PE";"BETANIA";17;3;2;22
2003;"BEZERROS (PE)";"PE";"BEZERROS";430;17;39;486
2003;"BODOCO (PE)";"PE";"BODOCO";97;3;9;109
2003;"BOM CONSELHO (PE)";"PE";"BOM CONSELHO";253;26;19;298
2003;"BOM JARDIM (PE)";"PE";"BOM JARDIM";77;4;13;94
2003;"BONITO (PE)";"PE";"BONITO";166;8;17;191
2003;"BREJAO (PE)";"PE";"BREJAO";19;0;5;24
2003;"BREJINHO (PE)";"PE";"BREJINHO";10;4;2;16
2003;"BREJO DA MADRE DE DEUS (PE)";"PE";"BREJO DA MADRE DE DEUS";97;2;5;104
2003;"BUENOS AIRES (PE)";"PE";"BUENOS AIRES";34;0;2;36
2003;"BUIQUE (PE)";"PE";"BUIQUE";138;9;16;163
2003;"CABO DE SANTO AGOSTINHO (PE)";"PE";"CABO DE SANTO AGOSTINHO";629;74;214;917
2003;"CABROBO (PE)";"PE";"CABROBO";136;8;4;148
2003;"CACHOEIRINHA (PE)";"PE";"CACHOEIRINHA";78;4;7;89
2003;"CAETES (PE)";"PE";"CAETES";139;8;4;151
2003;"CALCADO (PE)";"PE";"CALCADO";24;2;10;36
2003;"CALUMBI (PE)";"PE";"CALUMBI";45;1;2;48
2003;"CAMARAGIBE (PE)";"PE";"CAMARAGIBE";478;54;160;692
2003;"CAMOCIM DE SAO FELIX (PE)";"PE";"CAMOCIM DE SAO FELIX";104;6;2;112
2003;"CAMUTANGA (PE)";"PE";"CAMUTANGA";64;0;10;74
2003;"CANHOTINHO (PE)";"PE";"CANHOTINHO";119;10;4;133
2003;"CAPOEIRAS (PE)";"PE";"CAPOEIRAS";115;14;3;132
2003;"CARNAIBA (PE)";"PE";"CARNAIBA";26;7;2;35
2003;"CARNAUBEIRA DA PENHA (PE)";"PE";"CARNAUBEIRA DA PENHA";16;2;0;18
2003;"CARPINA (PE)";"PE";"CARPINA";573;71;47;691
2003;"CARUARU (PE)";"PE";"CARUARU";2656;169;342;3167
2003;"CASINHAS (PE)";"PE";"CASINHAS";11;2;3;16
2003;"CATENDE (PE)";"PE";"CATENDE";129;7;25;161
2003;"CEDRO (PE)";"PE";"CEDRO";23;3;7;33
2003;"CHA DE ALEGRIA (PE)";"PE";"CHA DE ALEGRIA";27;6;9;42
2003;"CHA GRANDE (PE)";"PE";"CHA GRANDE";117;8;9;134
2003;"CONDADO (PE)";"PE";"CONDADO";95;5;41;141
2003;"CORRENTES (PE)";"PE";"CORRENTES";57;16;2;75
2003;"CORTES (PE)";"PE";"CORTES";48;5;10;63
2003;"CUMARU (PE)";"PE";"CUMARU";57;3;2;62
2003;"CUPIRA (PE)";"PE";"CUPIRA";169;13;11;193
2003;"CUSTODIA (PE)";"PE";"CUSTODIA";188;12;14;214
2003;"DORMENTES (PE)";"PE";"DORMENTES";30;4;1;35
2003;"ESCADA (PE)";"PE";"ESCADA";305;25;82;412
2003;"EXU (PE)";"PE";"EXU";205;3;12;220
2003;"FEIRA NOVA (PE)";"PE";"FEIRA NOVA";99;11;5;115
2003;"FERNANDO DE NORONHA (PE)";"PE";"FERNANDO DE NORONHA";8;10;5;23
2003;"FERREIROS (PE)";"PE";"FERREIROS";36;2;15;53
2003;"FLORES (PE)";"PE";"FLORES";27;2;3;32
2003;"FLORESTA (PE)";"PE";"FLORESTA";203;3;3;209
2003;"FREI MIGUELINHO (PE)";"PE";"FREI MIGUELINHO";74;1;14;89
2003;"GAMELEIRA (PE)";"PE";"GAMELEIRA";48;8;14;70
2003;"GARANHUNS (PE)";"PE";"GARANHUNS";1182;71;60;1313
2003;"GLORIA DO GOITA (PE)";"PE";"GLORIA DO GOITA";80;18;1;99
2003;"GOIANA (PE)";"PE";"GOIANA";646;36;82;764
2003;"GRANITO (PE)";"PE";"GRANITO";10;0;2;12
2003;"GRAVATA (PE)";"PE";"GRAVATA";555;29;31;615
2003;"IATI (PE)";"PE";"IATI";16;6;6;28
2003;"IBIMIRIM (PE)";"PE";"IBIMIRIM";92;7;6;105
2003;"IBIRAJUBA (PE)";"PE";"IBIRAJUBA";24;0;1;25
2003;"IGARASSU (PE)";"PE";"IGARASSU";549;40;298;887
2003;"IGUARACI (PE)";"PE";"IGUARACI";51;3;8;62
2003;"INAJA (PE)";"PE";"INAJA";31;3;3;37
2003;"INGAZEIRA (PE)";"PE";"INGAZEIRA";4;2;1;7
2003;"IPOJUCA (PE)";"PE";"IPOJUCA";289;114;72;475
2003;"IPUBI (PE)";"PE";"IPUBI";86;4;13;103
2003;"ITACURUBA (PE)";"PE";"ITACURUBA";9;0;2;11
2003;"ITAIBA (PE)";"PE";"ITAIBA";52;6;2;60
2003;"ITAMARACA (PE)";"PE";"ITAMARACA";38;19;5;62
2003;"ITAMBE (PE)";"PE";"ITAMBE";275;7;53;335
2003;"ITAPETIM (PE)";"PE";"ITAPETIM";31;2;4;37
2003;"ITAPISSUMA (PE)";"PE";"ITAPISSUMA";32;101;4;137
2003;"ITAQUITINGA (PE)";"PE";"ITAQUITINGA";14;2;11;27
2003;"JABOATAO DOS GUARARAPES (PE)";"PE";"JABOATAO DOS GUARARAPES";3107;628;1434;5169
2003;"JAQUEIRA (PE)";"PE";"JAQUEIRA";27;2;3;32
2003;"JATAUBA (PE)";"PE";"JATAUBA";34;2;4;40
2003;"JATOBA (PE)";"PE";"JATOBA";12;2;2;16
2003;"JOAO ALFREDO (PE)";"PE";"JOAO ALFREDO";102;9;6;117
2003;"JOAQUIM NABUCO (PE)";"PE";"JOAQUIM NABUCO";80;7;7;94
2003;"JUCATI (PE)";"PE";"JUCATI";59;1;7;67
2003;"JUPI (PE)";"PE";"JUPI";91;4;6;101
2003;"JUREMA (PE)";"PE";"JUREMA";41;5;2;48
2003;"LAGOA DO CARRO (PE)";"PE";"LAGOA DO CARRO";37;14;4;55
2003;"LAGOA DO ITAENGA (PE)";"PE";"LAGOA DO ITAENGA";147;4;21;172
2003;"LAGOA DO OURO (PE)";"PE";"LAGOA DO OURO";27;7;2;36
2003;"LAGOA DOS GATOS (PE)";"PE";"LAGOA DOS GATOS";68;1;2;71
2003;"LAGOA GRANDE (PE)";"PE";"LAGOA GRANDE";35;4;13;52
2003;"LAJEDO (PE)";"PE";"LAJEDO";337;17;23;377
2003;"LIMOEIRO (PE)";"PE";"LIMOEIRO";299;21;38;358
2003;"MACAPARANA (PE)";"PE";"MACAPARANA";100;8;18;126
2003;"MACHADOS (PE)";"PE";"MACHADOS";69;1;2;72
2003;"MANARI (PE)";"PE";"MANARI";10;2;2;14
2003;"MARAIAL (PE)";"PE";"MARAIAL";96;1;10;107
2003;"MIRANDIBA (PE)";"PE";"MIRANDIBA";52;1;1;54
2003;"MOREILANDIA (PE)";"PE";"MOREILANDIA";11;0;3;14
2003;"MORENO (PE)";"PE";"MORENO";296;33;51;380
2003;"NAZARE DA MATA (PE)";"PE";"NAZARE DA MATA";155;10;13;178
2003;"OLINDA (PE)";"PE";"OLINDA";1872;281;918;3071
2003;"OROBO (PE)";"PE";"OROBO";40;3;11;54
2003;"OROCO (PE)";"PE";"OROCO";34;1;3;38
2003;"OURICURI (PE)";"PE";"OURICURI";364;12;49;425
2003;"PALMARES (PE)";"PE";"PALMARES";491;34;125;650
2003;"PALMEIRINA (PE)";"PE";"PALMEIRINA";10;6;0;16
2003;"PANELAS (PE)";"PE";"PANELAS";61;5;6;72
2003;"PARANATAMA (PE)";"PE";"PARANATAMA";23;2;6;31
2003;"PARNAMIRIM (PE)";"PE";"PARNAMIRIM";70;0;7;77
2003;"PASSIRA (PE)";"PE";"PASSIRA";102;5;11;118
2003;"PAUDALHO (PE)";"PE";"PAUDALHO";236;18;25;279
2003;"PAULISTA (PE)";"PE";"PAULISTA";843;189;163;1195
2003;"PEDRA (PE)";"PE";"PEDRA";54;3;9;66
2003;"PESQUEIRA (PE)";"PE";"PESQUEIRA";373;17;57;447
2003;"PETROLANDIA (PE)";"PE";"PETROLANDIA";180;3;8;191
2003;"PETROLINA (PE)";"PE";"PETROLINA";1721;183;252;2156
2003;"POCAO (PE)";"PE";"POCAO";37;5;2;44
2003;"POMBOS (PE)";"PE";"POMBOS";164;3;13;180
2003;"PRIMAVERA (PE)";"PE";"PRIMAVERA";41;3;17;61
2003;"QUIPAPA (PE)";"PE";"QUIPAPA";32;8;8;48
2003;"QUIXABA (PE)";"PE";"QUIXABA";9;1;1;11
2003;"RECIFE (PE)";"PE";"RECIFE";10584;1209;2425;14218
2003;"RIACHO DAS ALMAS (PE)";"PE";"RIACHO DAS ALMAS";139;2;23;164
2003;"RIBEIRAO (PE)";"PE";"RIBEIRAO";175;25;42;242
2003;"RIO FORMOSO (PE)";"PE";"RIO FORMOSO";77;2;24;103
2003;"SAIRE (PE)";"PE";"SAIRE";53;3;15;71
2003;"SALGADINHO (PE)";"PE";"SALGADINHO";5;2;2;9
2003;"SALGUEIRO (PE)";"PE";"SALGUEIRO";329;23;25;377
2003;"SALOA (PE)";"PE";"SALOA";36;8;1;45
2003;"SANHARO (PE)";"PE";"SANHARO";59;1;11;71
2003;"SANTA CRUZ (PE)";"PE";"SANTA CRUZ";38;2;7;47
2003;"SANTA CRUZ DA BAIXA VERDE (PE)";"PE";"SANTA CRUZ DA BAIXA VERDE";129;1;1;131
2003;"SANTA CRUZ DO CAPIBARIBE (PE)";"PE";"SANTA CRUZ DO CAPIBARIBE";400;17;22;439
2003;"SANTA FILOMENA (PE)";"PE";"SANTA FILOMENA";16;0;10;26
2003;"SANTA MARIA DA BOA VISTA (PE)";"PE";"SANTA MARIA DA BOA VISTA";89;7;18;114
2003;"SANTA MARIA DO CAMBUCA (PE)";"PE";"SANTA MARIA DO CAMBUCA";88;5;8;101
2003;"SANTA TEREZINHA (PE)";"PE";"SANTA TEREZINHA";19;3;2;24
2003;"SAO BENEDITO DO SUL (PE)";"PE";"SAO BENEDITO DO SUL";17;3;4;24
2003;"SAO BENTO DO UNA (PE)";"PE";"SAO BENTO DO UNA";391;10;34;435
2003;"SAO CAITANO (PE)";"PE";"SAO CAITANO";166;5;18;189
2003;"SAO JOAO (PE)";"PE";"SAO JOAO";48;7;5;60
2003;"SAO JOAQUIM DO MONTE (PE)";"PE";"SAO JOAQUIM DO MONTE";45;3;11;59
2003;"SAO JOSE DA COROA GRANDE (PE)";"PE";"SAO JOSE DA COROA GRANDE";36;2;4;42
2003;"SAO JOSE DO BELMONTE (PE)";"PE";"SAO JOSE DO BELMONTE";175;3;22;200
2003;"SAO JOSE DO EGITO (PE)";"PE";"SAO JOSE DO EGITO";284;14;22;320
2003;"SAO LOURENCO DA MATA (PE)";"PE";"SAO LOURENCO DA MATA";208;42;151;401
2003;"SAO VICENTE FERRER (PE)";"PE";"SAO VICENTE FERRER";71;2;5;78
2003;"SERRA TALHADA (PE)";"PE";"SERRA TALHADA";943;25;28;996
2003;"SERRITA (PE)";"PE";"SERRITA";46;1;4;51
2003;"SERTANIA (PE)";"PE";"SERTANIA";254;10;18;282
2003;"SIRINHAEM (PE)";"PE";"SIRINHAEM";138;6;19;163
2003;"SOLIDAO (PE)";"PE";"SOLIDAO";7;0;1;8
2003;"SURUBIM (PE)";"PE";"SURUBIM";411;13;37;461
2003;"TABIRA (PE)";"PE";"TABIRA";90;5;7;102
2003;"TACAIMBO (PE)";"PE";"TACAIMBO";38;0;7;45
2003;"TACARATU (PE)";"PE";"TACARATU";22;5;3;30
2003;"TAMANDARE (PE)";"PE";"TAMANDARE";35;5;7;47
2003;"TAQUARITINGA DO NORTE (PE)";"PE";"TAQUARITINGA DO NORTE";92;8;7;107
2003;"TEREZINHA (PE)";"PE";"TEREZINHA";8;4;2;14
2003;"TERRA NOVA (PE)";"PE";"TERRA NOVA";53;1;3;57
2003;"TIMBAUBA (PE)";"PE";"TIMBAUBA";521;13;40;574
2003;"TORITAMA (PE)";"PE";"TORITAMA";132;7;7;146
2003;"TRACUNHAEM (PE)";"PE";"TRACUNHAEM";24;14;11;49
2003;"TRINDADE (PE)";"PE";"TRINDADE";152;4;6;162
2003;"TRIUNFO (PE)";"PE";"TRIUNFO";120;3;4;127
2003;"TUPANATINGA (PE)";"PE";"TUPANATINGA";67;2;2;71
2003;"TUPARETAMA (PE)";"PE";"TUPARETAMA";58;6;7;71
2003;"VENTUROSA (PE)";"PE";"VENTUROSA";72;6;4;82
2003;"VERDEJANTE (PE)";"PE";"VERDEJANTE";33;1;9;43
2003;"VERTENTE DO LERIO (PE)";"PE";"VERTENTE DO LERIO";34;0;3;37
2003;"VERTENTES (PE)";"PE";"VERTENTES";86;5;13;104
2003;"VICENCIA (PE)";"PE";"VICENCIA";200;6;37;243
2003;"VITORIA DE SANTO ANTAO (PE)";"PE";"VITORIA DE SANTO ANTAO";1839;47;205;2091
2003;"XEXEU (PE)";"PE";"XEXEU";23;5;5;33
2003;"ACAUA (PI)";"PI";"ACAUA";5;1;0;6
2003;"AGRICOLANDIA (PI)";"PI";"AGRICOLANDIA";6;0;3;9
2003;"AGUA BRANCA (PI)";"PI";"AGUA BRANCA";35;1;2;38
2003;"ALAGOINHA DO PIAUI (PI)";"PI";"ALAGOINHA DO PIAUI";6;0;2;8
2003;"ALEGRETE DO PIAUI (PI)";"PI";"ALEGRETE DO PIAUI";4;3;1;8
2003;"ALTO LONGA (PI)";"PI";"ALTO LONGA";9;1;2;12
2003;"ALTOS (PI)";"PI";"ALTOS";86;2;7;95
2003;"ALVORADA DO GURGUEIA (PI)";"PI";"ALVORADA DO GURGUEIA";3;0;0;3
2003;"AMARANTE (PI)";"PI";"AMARANTE";15;0;1;16
2003;"ANGICAL DO PIAUI (PI)";"PI";"ANGICAL DO PIAUI";5;0;1;6
2003;"ANISIO DE ABREU (PI)";"PI";"ANISIO DE ABREU";3;0;0;3
2003;"ANTONIO ALMEIDA (PI)";"PI";"ANTONIO ALMEIDA";4;1;1;6
2003;"AROAZES (PI)";"PI";"AROAZES";0;1;1;2
2003;"ARRAIAL (PI)";"PI";"ARRAIAL";0;0;0;0
2003;"ASSUNCAO DO PIAUI (PI)";"PI";"ASSUNCAO DO PIAUI";3;0;0;3
2003;"AVELINO LOPES (PI)";"PI";"AVELINO LOPES";8;2;1;11
2003;"BAIXA GRANDE DO RIBEIRO (PI)";"PI";"BAIXA GRANDE DO RIBEIRO";1;0;0;1
2003;"BARRA D ALCANTARA (PI)";"PI";"BARRA D ALCANTARA";4;1;0;5
2003;"BARRAS (PI)";"PI";"BARRAS";52;1;7;60
2003;"BARREIRAS DO PIAUI (PI)";"PI";"BARREIRAS DO PIAUI";1;0;0;1
2003;"BARRO DURO (PI)";"PI";"BARRO DURO";33;2;1;36
2003;"BATALHA (PI)";"PI";"BATALHA";23;1;3;27
2003;"BELA VISTA DO PIAUI (PI)";"PI";"BELA VISTA DO PIAUI";2;0;0;2
2003;"BELEM DO PIAUI (PI)";"PI";"BELEM DO PIAUI";1;0;0;1
2003;"BENEDITINOS (PI)";"PI";"BENEDITINOS";9;1;2;12
2003;"BERTOLINIA (PI)";"PI";"BERTOLINIA";3;2;0;5
2003;"BETANIA DO PIAUI (PI)";"PI";"BETANIA DO PIAUI";0;3;1;4
2003;"BOA HORA (PI)";"PI";"BOA HORA";0;0;0;0
2003;"BOCAINA (PI)";"PI";"BOCAINA";4;3;1;8
2003;"BOM JESUS (PI)";"PI";"BOM JESUS";68;0;3;71
2003;"BOM PRINCIPIO DO PIAUI (PI)";"PI";"BOM PRINCIPIO DO PIAUI";1;0;1;2
2003;"BONFIM DO PIAUI (PI)";"PI";"BONFIM DO PIAUI";5;0;1;6
2003;"BOQUEIRAO DO PIAUI (PI)";"PI";"BOQUEIRAO DO PIAUI";0;0;0;0
2003;"BRASILEIRA (PI)";"PI";"BRASILEIRA";2;0;1;3
2003;"BREJO DO PIAUI (PI)";"PI";"BREJO DO PIAUI";2;0;0;2
2003;"BURITI DOS LOPES (PI)";"PI";"BURITI DOS LOPES";6;0;3;9
2003;"BURITI DOS MONTES (PI)";"PI";"BURITI DOS MONTES";2;1;0;3
2003;"CABECEIRAS DO PIAUI (PI)";"PI";"CABECEIRAS DO PIAUI";2;0;1;3
2003;"CAJAZEIRAS DO PIAUI (PI)";"PI";"CAJAZEIRAS DO PIAUI";0;0;0;0
2003;"CAJUEIRO DA PRAIA (PI)";"PI";"CAJUEIRO DA PRAIA";4;0;0;4
2003;"CALDEIRAO GRANDE DO PIAUI (PI)";"PI";"CALDEIRAO GRANDE DO PIAUI";1;0;1;2
2003;"CAMPINAS DO PIAUI (PI)";"PI";"CAMPINAS DO PIAUI";0;0;1;1
2003;"CAMPO ALEGRE DO FIDALGO (PI)";"PI";"CAMPO ALEGRE DO FIDALGO";0;1;0;1
2003;"CAMPO GRANDE DO PIAUI (PI)";"PI";"CAMPO GRANDE DO PIAUI";5;0;0;5
2003;"CAMPO LARGO DO PIAUI (PI)";"PI";"CAMPO LARGO DO PIAUI";0;2;0;2
2003;"CAMPO MAIOR (PI)";"PI";"CAMPO MAIOR";223;10;25;258
2003;"CANTO DO BURITI (PI)";"PI";"CANTO DO BURITI";37;2;4;43
2003;"CAPITAO DE CAMPOS (PI)";"PI";"CAPITAO DE CAMPOS";3;0;4;7
2003;"CAPITAO GERVASIO OLIVEIRA (PI)";"PI";"CAPITAO GERVASIO OLIVEIRA";1;0;2;3
2003;"CARACOL (PI)";"PI";"CARACOL";11;1;0;12
2003;"CARAUBAS DO PIAUI (PI)";"PI";"CARAUBAS DO PIAUI";4;0;0;4
2003;"CARIDADE DO PIAUI (PI)";"PI";"CARIDADE DO PIAUI";3;0;0;3
2003;"CASTELO DO PIAUI (PI)";"PI";"CASTELO DO PIAUI";14;0;3;17
2003;"CAXINGO (PI)";"PI";"CAXINGO";3;1;0;4
2003;"COCAL (PI)";"PI";"COCAL";24;1;2;27
2003;"COCAL DE TELHA (PI)";"PI";"COCAL DE TELHA";1;1;0;2
2003;"COCAL DOS ALVES (PI)";"PI";"COCAL DOS ALVES";0;2;0;2
2003;"COIVARAS (PI)";"PI";"COIVARAS";1;0;1;2
2003;"COLONIA DO GURGUEIA (PI)";"PI";"COLONIA DO GURGUEIA";2;2;0;4
2003;"COLONIA DO PIAUI (PI)";"PI";"COLONIA DO PIAUI";3;0;0;3
2003;"CONCEICAO DO CANINDE (PI)";"PI";"CONCEICAO DO CANINDE";1;1;0;2
2003;"CORONEL JOSE DIAS (PI)";"PI";"CORONEL JOSE DIAS";3;0;1;4
2003;"CORRENTE (PI)";"PI";"CORRENTE";38;2;0;40
2003;"CRISTALANDIA DO PIAUI (PI)";"PI";"CRISTALANDIA DO PIAUI";1;0;1;2
2003;"CRISTINO CASTRO (PI)";"PI";"CRISTINO CASTRO";16;1;4;21
2003;"CURIMATA (PI)";"PI";"CURIMATA";4;0;1;5
2003;"CURRAIS (PI)";"PI";"CURRAIS";1;2;0;3
2003;"CURRAL NOVO DO PIAUI (PI)";"PI";"CURRAL NOVO DO PIAUI";0;1;0;1
2003;"CURRALINHOS (PI)";"PI";"CURRALINHOS";0;0;0;0
2003;"DEMERVAL LOBAO (PI)";"PI";"DEMERVAL LOBAO";12;2;0;14
2003;"DIRCEU ARCOVERDE (PI)";"PI";"DIRCEU ARCOVERDE";4;0;0;4
2003;"DOM EXPEDITO LOPES (PI)";"PI";"DOM EXPEDITO LOPES";34;2;1;37
2003;"DOM INOCENCIO (PI)";"PI";"DOM INOCENCIO";4;1;3;8
2003;"DOMINGOS MOURAO (PI)";"PI";"DOMINGOS MOURAO";1;0;0;1
2003;"ELESBAO VELOSO (PI)";"PI";"ELESBAO VELOSO";26;2;3;31
2003;"ELISEU MARTINS (PI)";"PI";"ELISEU MARTINS";3;1;0;4
2003;"ESPERANTINA (PI)";"PI";"ESPERANTINA";79;9;9;97
2003;"FARTURA DO PIAUI (PI)";"PI";"FARTURA DO PIAUI";3;0;0;3
2003;"FLORES DO PIAUI (PI)";"PI";"FLORES DO PIAUI";3;0;0;3
2003;"FLORESTA DO PIAUI (PI)";"PI";"FLORESTA DO PIAUI";0;1;0;1
2003;"FLORIANO (PI)";"PI";"FLORIANO";663;41;19;723
2003;"FRANCINOPOLIS (PI)";"PI";"FRANCINOPOLIS";4;3;0;7
2003;"FRANCISCO AYRES (PI)";"PI";"FRANCISCO AYRES";2;0;1;3
2003;"FRANCISCO MACEDO (PI)";"PI";"FRANCISCO MACEDO";1;1;0;2
2003;"FRANCISCO SANTOS (PI)";"PI";"FRANCISCO SANTOS";29;2;1;32
2003;"FRONTEIRAS (PI)";"PI";"FRONTEIRAS";54;6;3;63
2003;"GEMINIANO (PI)";"PI";"GEMINIANO";5;1;4;10
2003;"GILBUES (PI)";"PI";"GILBUES";2;0;1;3
2003;"GUADALUPE (PI)";"PI";"GUADALUPE";26;4;1;31
2003;"GUARIBAS (PI)";"PI";"GUARIBAS";1;0;0;1
2003;"HUGO NAPOLEAO (PI)";"PI";"HUGO NAPOLEAO";4;0;0;4
2003;"ILHA GRANDE (PI)";"PI";"ILHA GRANDE";0;2;0;2
2003;"INHUMA (PI)";"PI";"INHUMA";49;6;6;61
2003;"IPIRANGA DO PIAUI (PI)";"PI";"IPIRANGA DO PIAUI";16;2;4;22
2003;"ISAIAS COELHO (PI)";"PI";"ISAIAS COELHO";1;0;2;3
2003;"ITAINOPOLIS (PI)";"PI";"ITAINOPOLIS";8;3;3;14
2003;"ITAUEIRA (PI)";"PI";"ITAUEIRA";13;2;0;15
2003;"JACOBINA DO PIAUI (PI)";"PI";"JACOBINA DO PIAUI";8;1;0;9
2003;"JAICOS (PI)";"PI";"JAICOS";46;5;1;52
2003;"JARDIM DO MULATO (PI)";"PI";"JARDIM DO MULATO";2;0;0;2
2003;"JATOBA DO PIAUI (PI)";"PI";"JATOBA DO PIAUI";3;0;0;3
2003;"JERUMENHA (PI)";"PI";"JERUMENHA";2;0;0;2
2003;"JOAO COSTA (PI)";"PI";"JOAO COSTA";1;0;0;1
2003;"JOAQUIM PIRES (PI)";"PI";"JOAQUIM PIRES";3;0;0;3
2003;"JOCA MARQUES (PI)";"PI";"JOCA MARQUES";1;0;1;2
2003;"JOSE DE FREITAS (PI)";"PI";"JOSE DE FREITAS";36;0;8;44
2003;"JUAZEIRO DO PIAUI (PI)";"PI";"JUAZEIRO DO PIAUI";0;0;0;0
2003;"JULIO BORGES (PI)";"PI";"JULIO BORGES";1;1;0;2
2003;"JUREMA (PI)";"PI";"JUREMA";0;0;1;1
2003;"LAGOA ALEGRE (PI)";"PI";"LAGOA ALEGRE";2;0;1;3
2003;"LAGOA DE SAO FRANCISCO (PI)";"PI";"LAGOA DE SAO FRANCISCO";0;0;0;0
2003;"LAGOA DO BARRO DO PIAUI (PI)";"PI";"LAGOA DO BARRO DO PIAUI";1;1;4;6
2003;"LAGOA DO PIAUI (PI)";"PI";"LAGOA DO PIAUI";3;0;0;3
2003;"LAGOA DO SITIO (PI)";"PI";"LAGOA DO SITIO";6;1;1;8
2003;"LAGOINHA DO PIAUI (PI)";"PI";"LAGOINHA DO PIAUI";2;2;1;5
2003;"LANDRI SALES (PI)";"PI";"LANDRI SALES";2;1;0;3
2003;"LUIS CORREIA (PI)";"PI";"LUIS CORREIA";12;3;2;17
2003;"LUZILANDIA (PI)";"PI";"LUZILANDIA";8;0;5;13
2003;"MADEIRO (PI)";"PI";"MADEIRO";3;1;1;5
2003;"MANOEL EMIDIO (PI)";"PI";"MANOEL EMIDIO";1;0;1;2
2003;"MARCOLANDIA (PI)";"PI";"MARCOLANDIA";54;8;1;63
2003;"MARCOS PARENTE (PI)";"PI";"MARCOS PARENTE";2;1;0;3
2003;"MASSAPE DO PIAUI (PI)";"PI";"MASSAPE DO PIAUI";1;1;0;2
2003;"MATIAS OLIMPIO (PI)";"PI";"MATIAS OLIMPIO";1;1;0;2
2003;"MIGUEL ALVES (PI)";"PI";"MIGUEL ALVES";6;1;2;9
2003;"MIGUEL LEAO (PI)";"PI";"MIGUEL LEAO";2;0;0;2
2003;"MILTON BRANDAO (PI)";"PI";"MILTON BRANDAO";0;0;0;0
2003;"MONSENHOR GIL (PI)";"PI";"MONSENHOR GIL";2;2;0;4
2003;"MONSENHOR HIPOLITO (PI)";"PI";"MONSENHOR HIPOLITO";7;4;1;12
2003;"MONTE ALEGRE DO PIAUI (PI)";"PI";"MONTE ALEGRE DO PIAUI";3;2;1;6
2003;"MORRO DO CHAPEU DO PIAUI (PI)";"PI";"MORRO DO CHAPEU DO PIAUI";0;1;1;2
2003;"MURICI DOS PORTELAS (PI)";"PI";"MURICI DOS PORTELAS";0;0;0;0
2003;"NAZARE DO PIAUI (PI)";"PI";"NAZARE DO PIAUI";2;0;1;3
2003;"NOSSA SENHORA DE NAZARE (PI)";"PI";"NOSSA SENHORA DE NAZARE";0;0;0;0
2003;"NOSSA SENHORA DOS REMEDIOS (PI)";"PI";"NOSSA SENHORA DOS REMEDIOS";1;0;0;1
2003;"NOVA SANTA RITA (PI)";"PI";"NOVA SANTA RITA";0;2;0;2
2003;"NOVO ORIENTE DO PIAUI (PI)";"PI";"NOVO ORIENTE DO PIAUI";6;0;2;8
2003;"NOVO SANTO ANTONIO (PI)";"PI";"NOVO SANTO ANTONIO";0;0;0;0
2003;"OEIRAS (PI)";"PI";"OEIRAS";151;9;8;168
2003;"OLHO D AGUA DO PIAUI (PI)";"PI";"OLHO D AGUA DO PIAUI";2;1;0;3
2003;"PADRE MARCOS (PI)";"PI";"PADRE MARCOS";6;3;0;9
2003;"PAES LANDIM (PI)";"PI";"PAES LANDIM";1;1;0;2
2003;"PAJEU DO PIAUI (PI)";"PI";"PAJEU DO PIAUI";0;1;0;1
2003;"PALMEIRA DO PIAUI (PI)";"PI";"PALMEIRA DO PIAUI";5;1;0;6
2003;"PALMEIRAIS (PI)";"PI";"PALMEIRAIS";2;1;0;3
2003;"PAQUETA (PI)";"PI";"PAQUETA";3;2;1;6
2003;"PARNAGUA (PI)";"PI";"PARNAGUA";1;0;0;1
2003;"PARNAIBA (PI)";"PI";"PARNAIBA";629;59;107;795
2003;"PASSAGEM FRANCA DO PIAUI (PI)";"PI";"PASSAGEM FRANCA DO PIAUI";1;0;0;1
2003;"PATOS DO PIAUI (PI)";"PI";"PATOS DO PIAUI";4;1;1;6
2003;"PAU D ARCO DO PIAUI (PI)";"PI";"PAU D ARCO DO PIAUI";2;0;1;3
2003;"PAULISTANA (PI)";"PI";"PAULISTANA";63;5;5;73
2003;"PAVUSSU (PI)";"PI";"PAVUSSU";1;0;0;1
2003;"PEDRO II (PI)";"PI";"PEDRO II";42;5;3;50
2003;"PEDRO LAURENTINO (PI)";"PI";"PEDRO LAURENTINO";0;0;0;0
2003;"PICOS (PI)";"PI";"PICOS";1115;76;32;1223
2003;"PIMENTEIRAS (PI)";"PI";"PIMENTEIRAS";17;3;1;21
2003;"PIO IX (PI)";"PI";"PIO IX";20;2;1;23
2003;"PIRACURUCA (PI)";"PI";"PIRACURUCA";72;4;13;89
2003;"PIRIPIRI (PI)";"PI";"PIRIPIRI";185;7;41;233
2003;"PORTO (PI)";"PI";"PORTO";2;1;0;3
2003;"PORTO ALEGRE DO PIAUI (PI)";"PI";"PORTO ALEGRE DO PIAUI";2;2;0;4
2003;"PRATA DO PIAUI (PI)";"PI";"PRATA DO PIAUI";2;1;1;4
2003;"QUEIMADA NOVA (PI)";"PI";"QUEIMADA NOVA";4;2;2;8
2003;"REDENCAO DO GURGUEIA (PI)";"PI";"REDENCAO DO GURGUEIA";1;0;4;5
2003;"REGENERACAO (PI)";"PI";"REGENERACAO";34;4;1;39
2003;"RIACHO FRIO (PI)";"PI";"RIACHO FRIO";0;1;0;1
2003;"RIBEIRA DO PIAUI (PI)";"PI";"RIBEIRA DO PIAUI";0;0;0;0
2003;"RIBEIRO GONCALVES (PI)";"PI";"RIBEIRO GONCALVES";5;0;0;5
2003;"RIO GRANDE DO PIAUI (PI)";"PI";"RIO GRANDE DO PIAUI";4;0;2;6
2003;"SANTA CRUZ DO PIAUI (PI)";"PI";"SANTA CRUZ DO PIAUI";6;4;0;10
2003;"SANTA CRUZ DOS MILAGRES (PI)";"PI";"SANTA CRUZ DOS MILAGRES";1;0;0;1
2003;"SANTA FILOMENA (PI)";"PI";"SANTA FILOMENA";3;1;1;5
2003;"SANTA LUZ (PI)";"PI";"SANTA LUZ";5;0;0;5
2003;"SANTA ROSA DO PIAUI (PI)";"PI";"SANTA ROSA DO PIAUI";0;0;2;2
2003;"SANTANA DO PIAUI (PI)";"PI";"SANTANA DO PIAUI";12;3;3;18
2003;"SANTO ANTONIO DE LISBOA (PI)";"PI";"SANTO ANTONIO DE LISBOA";14;6;2;22
2003;"SANTO ANTONIO DOS MILAGRES (PI)";"PI";"SANTO ANTONIO DOS MILAGRES";0;2;0;2
2003;"SANTO INACIO DO PIAUI (PI)";"PI";"SANTO INACIO DO PIAUI";1;3;1;5
2003;"SAO BRAZ DO PIAUI (PI)";"PI";"SAO BRAZ DO PIAUI";0;0;0;0
2003;"SAO FELIX DO PIAUI (PI)";"PI";"SAO FELIX DO PIAUI";0;0;2;2
2003;"SAO FRANCISCO DE ASSIS DO PIAU (PI)";"PI";"SAO FRANCISCO DE ASSIS DO PIAU";1;0;0;1
2003;"SAO FRANCISCO DO PIAUI (PI)";"PI";"SAO FRANCISCO DO PIAUI";1;1;1;3
2003;"SAO GONCALO DO GURGUEIA (PI)";"PI";"SAO GONCALO DO GURGUEIA";1;2;0;3
2003;"SAO GONCALO DO PIAUI (PI)";"PI";"SAO GONCALO DO PIAUI";4;2;5;11
2003;"SAO JOAO DA CANABRAVA (PI)";"PI";"SAO JOAO DA CANABRAVA";6;1;1;8
2003;"SAO JOAO DA FRONTEIRA (PI)";"PI";"SAO JOAO DA FRONTEIRA";0;1;3;4
2003;"SAO JOAO DA SERRA (PI)";"PI";"SAO JOAO DA SERRA";1;0;0;1
2003;"SAO JOAO DA VARJOTA (PI)";"PI";"SAO JOAO DA VARJOTA";1;0;0;1
2003;"SAO JOAO DO ARRAIAL (PI)";"PI";"SAO JOAO DO ARRAIAL";2;1;0;3
2003;"SAO JOAO DO PIAUI (PI)";"PI";"SAO JOAO DO PIAUI";35;6;2;43
2003;"SAO JOSE DO DIVINO (PI)";"PI";"SAO JOSE DO DIVINO";4;1;0;5
2003;"SAO JOSE DO PEIXE (PI)";"PI";"SAO JOSE DO PEIXE";1;1;0;2
2003;"SAO JOSE DO PIAUI (PI)";"PI";"SAO JOSE DO PIAUI";8;0;0;8
2003;"SAO JULIAO (PI)";"PI";"SAO JULIAO";9;1;1;11
2003;"SAO LOURENCO DO PIAUI (PI)";"PI";"SAO LOURENCO DO PIAUI";0;0;1;1
2003;"SAO LUIS DO PIAUI (PI)";"PI";"SAO LUIS DO PIAUI";4;1;0;5
2003;"SAO MIGUEL DA BAIXA GRANDE (PI)";"PI";"SAO MIGUEL DA BAIXA GRANDE";1;0;0;1
2003;"SAO MIGUEL DO FIDALGO (PI)";"PI";"SAO MIGUEL DO FIDALGO";2;1;1;4
2003;"SAO MIGUEL DO TAPUIO (PI)";"PI";"SAO MIGUEL DO TAPUIO";2;0;2;4
2003;"SAO PEDRO DO PIAUI (PI)";"PI";"SAO PEDRO DO PIAUI";17;1;0;18
2003;"SAO RAIMUNDO NONATO (PI)";"PI";"SAO RAIMUNDO NONATO";134;3;12;149
2003;"SEBASTIAO BARROS (PI)";"PI";"SEBASTIAO BARROS";0;2;0;2
2003;"SEBASTIAO LEAL (PI)";"PI";"SEBASTIAO LEAL";1;1;0;2
2003;"SIGEFREDO PACHECO (PI)";"PI";"SIGEFREDO PACHECO";0;0;0;0
2003;"SIMOES (PI)";"PI";"SIMOES";34;4;1;39
2003;"SIMPLICIO MENDES (PI)";"PI";"SIMPLICIO MENDES";22;4;2;28
2003;"SOCORRO DO PIAUI (PI)";"PI";"SOCORRO DO PIAUI";0;0;0;0
2003;"SUSSUAPARA (PI)";"PI";"SUSSUAPARA";9;4;1;14
2003;"TAMBORIL DO PIAUI (PI)";"PI";"TAMBORIL DO PIAUI";0;0;0;0
2003;"TANQUE DO PIAUI (PI)";"PI";"TANQUE DO PIAUI";3;0;1;4
2003;"TERESINA (PI)";"PI";"TERESINA";6682;554;1644;8880
2003;"UNIAO (PI)";"PI";"UNIAO";41;8;5;54
2003;"URUCUI (PI)";"PI";"URUCUI";24;1;4;29
2003;"VALENCA DO PIAUI (PI)";"PI";"VALENCA DO PIAUI";58;9;6;73
2003;"VARZEA BRANCA (PI)";"PI";"VARZEA BRANCA";1;0;3;4
2003;"VARZEA GRANDE (PI)";"PI";"VARZEA GRANDE";2;2;2;6
2003;"VERA MENDES (PI)";"PI";"VERA MENDES";0;2;0;2
2003;"VILA NOVA DO PIAUI (PI)";"PI";"VILA NOVA DO PIAUI";4;0;0;4
2003;"WALL FERRAZ (PI)";"PI";"WALL FERRAZ";3;2;0;5
2003;"ABATIA (PR)";"PR";"ABATIA";89;2;18;109
2003;"ADRIANOPOLIS (PR)";"PR";"ADRIANOPOLIS";49;2;11;62
2003;"AGUDOS DO SUL (PR)";"PR";"AGUDOS DO SUL";196;3;10;209
2003;"ALMIRANTE TAMANDARE (PR)";"PR";"ALMIRANTE TAMANDARE";757;37;171;965
2003;"ALTAMIRA DO PARANA (PR)";"PR";"ALTAMIRA DO PARANA";20;2;10;32
2003;"ALTO PARANA (PR)";"PR";"ALTO PARANA";164;3;33;200
2003;"ALTO PIQUIRI (PR)";"PR";"ALTO PIQUIRI";155;5;17;177
2003;"ALTONIA (PR)";"PR";"ALTONIA";304;5;27;336
2003;"ALVORADA DO SUL (PR)";"PR";"ALVORADA DO SUL";213;3;40;256
2003;"AMAPORA (PR)";"PR";"AMAPORA";60;2;17;79
2003;"AMPERE (PR)";"PR";"AMPERE";239;9;15;263
2003;"ANAHY (PR)";"PR";"ANAHY";38;1;5;44
2003;"ANDIRA (PR)";"PR";"ANDIRA";428;6;55;489
2003;"ANGULO (PR)";"PR";"ANGULO";58;1;3;62
2003;"ANTONINA (PR)";"PR";"ANTONINA";61;10;22;93
2003;"ANTONIO OLINTO (PR)";"PR";"ANTONIO OLINTO";76;2;12;90
2003;"APUCARANA (PR)";"PR";"APUCARANA";1851;118;179;2148
2003;"ARAPONGAS (PR)";"PR";"ARAPONGAS";2477;79;78;2634
2003;"ARAPOTI (PR)";"PR";"ARAPOTI";362;13;46;421
2003;"ARAPUA (PR)";"PR";"ARAPUA";64;0;12;76
2003;"ARARUNA (PR)";"PR";"ARARUNA";283;7;14;304
2003;"ARAUCARIA (PR)";"PR";"ARAUCARIA";1575;149;320;2044
2003;"ARIRANHA DO IVAI (PR)";"PR";"ARIRANHA DO IVAI";18;1;12;31
2003;"ASSAI (PR)";"PR";"ASSAI";407;8;30;445
2003;"ASSIS CHATEAUBRIAND (PR)";"PR";"ASSIS CHATEAUBRIAND";982;11;60;1053
2003;"ASTORGA (PR)";"PR";"ASTORGA";483;17;55;555
2003;"ATALAIA (PR)";"PR";"ATALAIA";75;8;14;97
2003;"BALSA NOVA (PR)";"PR";"BALSA NOVA";169;6;25;200
2003;"BANDEIRANTES (PR)";"PR";"BANDEIRANTES";741;17;74;832
2003;"BARBOSA FERRAZ (PR)";"PR";"BARBOSA FERRAZ";113;6;16;135
2003;"BARRA DO JACARE (PR)";"PR";"BARRA DO JACARE";39;2;6;47
2003;"BARRACAO (PR)";"PR";"BARRACAO";154;7;22;183
2003;"BELA VISTA DO CAROBA (PR)";"PR";"BELA VISTA DO CAROBA";38;1;8;47
2003;"BELA VISTA DO PARAISO (PR)";"PR";"BELA VISTA DO PARAISO";315;9;44;368
2003;"BITURUNA (PR)";"PR";"BITURUNA";280;10;34;324
2003;"BOA ESPERANCA (PR)";"PR";"BOA ESPERANCA";134;3;8;145
2003;"BOA ESPERANCA DO IGUACU (PR)";"PR";"BOA ESPERANCA DO IGUACU";38;1;7;46
2003;"BOA VENTURA DE SAO ROQUE (PR)";"PR";"BOA VENTURA DE SAO ROQUE";115;1;16;132
2003;"BOA VISTA DA APARECIDA (PR)";"PR";"BOA VISTA DA APARECIDA";102;4;17;123
2003;"BOCAIUVA DO SUL (PR)";"PR";"BOCAIUVA DO SUL";178;5;13;196
2003;"BOM JESUS DO SUL (PR)";"PR";"BOM JESUS DO SUL";22;2;3;27
2003;"BOM SUCESSO (PR)";"PR";"BOM SUCESSO";78;2;20;100
2003;"BOM SUCESSO DO SUL (PR)";"PR";"BOM SUCESSO DO SUL";69;7;6;82
2003;"BORRAZOPOLIS (PR)";"PR";"BORRAZOPOLIS";180;2;7;189
2003;"BRAGANEY (PR)";"PR";"BRAGANEY";113;2;9;124
2003;"BRASILANDIA DO SUL (PR)";"PR";"BRASILANDIA DO SUL";37;1;7;45
2003;"CAFEARA (PR)";"PR";"CAFEARA";23;0;7;30
2003;"CAFELANDIA (PR)";"PR";"CAFELANDIA";383;8;23;414
2003;"CAFEZAL DO SUL (PR)";"PR";"CAFEZAL DO SUL";85;1;16;102
2003;"CALIFORNIA (PR)";"PR";"CALIFORNIA";146;2;9;157
2003;"CAMBARA (PR)";"PR";"CAMBARA";620;14;47;681
2003;"CAMBE (PR)";"PR";"CAMBE";1215;89;88;1392
2003;"CAMBIRA (PR)";"PR";"CAMBIRA";157;1;7;165
2003;"CAMPINA DA LAGOA (PR)";"PR";"CAMPINA DA LAGOA";257;7;26;290
2003;"CAMPINA DO SIMAO (PR)";"PR";"CAMPINA DO SIMAO";49;2;13;64
2003;"CAMPINA GRANDE DO SUL (PR)";"PR";"CAMPINA GRANDE DO SUL";438;20;44;502
2003;"CAMPO BONITO (PR)";"PR";"CAMPO BONITO";73;1;6;80
2003;"CAMPO DO TENENTE (PR)";"PR";"CAMPO DO TENENTE";85;1;21;107
2003;"CAMPO LARGO (PR)";"PR";"CAMPO LARGO";1764;104;247;2115
2003;"CAMPO MAGRO (PR)";"PR";"CAMPO MAGRO";204;18;14;236
2003;"CAMPO MOURAO (PR)";"PR";"CAMPO MOURAO";1689;26;380;2095
2003;"CANDIDO DE ABREU (PR)";"PR";"CANDIDO DE ABREU";142;3;27;172
2003;"CANDOI (PR)";"PR";"CANDOI";256;2;50;308
2003;"CANTAGALO (PR)";"PR";"CANTAGALO";183;5;21;209
2003;"CAPANEMA (PR)";"PR";"CAPANEMA";287;10;32;329
2003;"CAPITAO LEONIDAS MARQUES (PR)";"PR";"CAPITAO LEONIDAS MARQUES";285;12;17;314
2003;"CARAMBEI (PR)";"PR";"CARAMBEI";349;13;32;394
2003;"CARLOPOLIS (PR)";"PR";"CARLOPOLIS";223;11;22;256
2003;"CASCAVEL (PR)";"PR";"CASCAVEL";5394;197;603;6194
2003;"CASTRO (PR)";"PR";"CASTRO";1210;43;154;1407
2003;"CATANDUVAS (PR)";"PR";"CATANDUVAS";146;3;21;170
2003;"CENTENARIO DO SUL (PR)";"PR";"CENTENARIO DO SUL";93;9;32;134
2003;"CERRO AZUL (PR)";"PR";"CERRO AZUL";259;4;33;296
2003;"CEU AZUL (PR)";"PR";"CEU AZUL";245;9;34;288
2003;"CHOPINZINHO (PR)";"PR";"CHOPINZINHO";388;11;50;449
2003;"CIANORTE (PR)";"PR";"CIANORTE";1136;20;133;1289
2003;"CIDADE GAUCHA (PR)";"PR";"CIDADE GAUCHA";158;5;53;216
2003;"CLEVELANDIA (PR)";"PR";"CLEVELANDIA";402;19;27;448
2003;"COLOMBO (PR)";"PR";"COLOMBO";2518;78;339;2935
2003;"COLORADO (PR)";"PR";"COLORADO";502;26;62;590
2003;"CONGONHINHAS (PR)";"PR";"CONGONHINHAS";82;5;16;103
2003;"CONSELHEIRO MAIRINCK (PR)";"PR";"CONSELHEIRO MAIRINCK";24;0;5;29
2003;"CONTENDA (PR)";"PR";"CONTENDA";525;14;31;570
2003;"CORBELIA (PR)";"PR";"CORBELIA";542;13;25;580
2003;"CORNELIO PROCOPIO (PR)";"PR";"CORNELIO PROCOPIO";822;66;89;977
2003;"CORONEL DOMINGOS SOARES (PR)";"PR";"CORONEL DOMINGOS SOARES";41;3;9;53
2003;"CORONEL VIVIDA (PR)";"PR";"CORONEL VIVIDA";558;14;64;636
2003;"CORUMBATAI DO SUL (PR)";"PR";"CORUMBATAI DO SUL";31;1;9;41
2003;"CRUZ MACHADO (PR)";"PR";"CRUZ MACHADO";250;7;30;287
2003;"CRUZEIRO DO IGUACU (PR)";"PR";"CRUZEIRO DO IGUACU";53;0;10;63
2003;"CRUZEIRO DO OESTE (PR)";"PR";"CRUZEIRO DO OESTE";312;3;45;360
2003;"CRUZEIRO DO SUL (PR)";"PR";"CRUZEIRO DO SUL";73;2;14;89
2003;"CRUZMALTINA (PR)";"PR";"CRUZMALTINA";42;0;4;46
2003;"CURITIBA (PR)";"PR";"CURITIBA";26786;2560;4913;34259
2003;"CURIUVA (PR)";"PR";"CURIUVA";142;8;35;185
2003;"DIAMANTE D OESTE (PR)";"PR";"DIAMANTE D OESTE";50;7;10;67
2003;"DIAMANTE DO NORTE (PR)";"PR";"DIAMANTE DO NORTE";65;0;11;76
2003;"DIAMANTE DO SUL (PR)";"PR";"DIAMANTE DO SUL";27;2;2;31
2003;"DOIS VIZINHOS (PR)";"PR";"DOIS VIZINHOS";641;17;69;727
2003;"DOURADINA (PR)";"PR";"DOURADINA";140;2;7;149
2003;"DOUTOR CAMARGO (PR)";"PR";"DOUTOR CAMARGO";146;2;33;181
2003;"DOUTOR ULYSSES (PR)";"PR";"DOUTOR ULYSSES";25;3;4;32
2003;"ENEAS MARQUES (PR)";"PR";"ENEAS MARQUES";96;3;12;111
2003;"ENGENHEIRO BELTRAO (PR)";"PR";"ENGENHEIRO BELTRAO";362;3;47;412
2003;"ENTRE RIOS DO OESTE (PR)";"PR";"ENTRE RIOS DO OESTE";91;2;6;99
2003;"ESPERANCA NOVA (PR)";"PR";"ESPERANCA NOVA";18;3;4;25
2003;"ESPIGAO ALTO DO IGUACU (PR)";"PR";"ESPIGAO ALTO DO IGUACU";47;2;2;51
2003;"FAROL (PR)";"PR";"FAROL";53;0;7;60
2003;"FAXINAL (PR)";"PR";"FAXINAL";272;2;9;283
2003;"FAZENDA RIO GRANDE (PR)";"PR";"FAZENDA RIO GRANDE";614;19;137;770
2003;"FENIX (PR)";"PR";"FENIX";85;1;5;91
2003;"FERNANDES PINHEIRO (PR)";"PR";"FERNANDES PINHEIRO";68;4;9;81
2003;"FIGUEIRA (PR)";"PR";"FIGUEIRA";89;3;17;109
2003;"FLOR DA SERRA DO SUL (PR)";"PR";"FLOR DA SERRA DO SUL";64;3;14;81
2003;"FLORAI (PR)";"PR";"FLORAI";133;3;15;151
2003;"FLORESTA (PR)";"PR";"FLORESTA";180;3;10;193
2003;"FLORESTOPOLIS (PR)";"PR";"FLORESTOPOLIS";135;2;54;191
2003;"FLORIDA (PR)";"PR";"FLORIDA";38;3;8;49
2003;"FORMOSA DO OESTE (PR)";"PR";"FORMOSA DO OESTE";144;4;17;165
2003;"FOZ DO IGUACU (PR)";"PR";"FOZ DO IGUACU";2493;583;690;3766
2003;"FOZ DO JORDAO (PR)";"PR";"FOZ DO JORDAO";47;1;6;54
2003;"FRANCISCO ALVES (PR)";"PR";"FRANCISCO ALVES";124;1;11;136
2003;"FRANCISCO BELTRAO (PR)";"PR";"FRANCISCO BELTRAO";1326;47;130;1503
2003;"GENERAL CARNEIRO (PR)";"PR";"GENERAL CARNEIRO";328;3;29;360
2003;"GODOY MOREIRA (PR)";"PR";"GODOY MOREIRA";26;0;7;33
2003;"GOIO ERE (PR)";"PR";"GOIO ERE";647;6;55;708
2003;"GOIOXIM (PR)";"PR";"GOIOXIM";51;2;10;63
2003;"GRANDES RIOS (PR)";"PR";"GRANDES RIOS";61;4;11;76
2003;"GUAIRA (PR)";"PR";"GUAIRA";1121;18;88;1227
2003;"GUAIRACA (PR)";"PR";"GUAIRACA";123;0;12;135
2003;"GUAMIRANGA (PR)";"PR";"GUAMIRANGA";101;2;7;110
2003;"GUAPIRAMA (PR)";"PR";"GUAPIRAMA";69;2;16;87
2003;"GUAPOREMA (PR)";"PR";"GUAPOREMA";35;0;4;39
2003;"GUARACI (PR)";"PR";"GUARACI";62;0;7;69
2003;"GUARANIACU (PR)";"PR";"GUARANIACU";271;7;40;318
2003;"GUARAPUAVA (PR)";"PR";"GUARAPUAVA";3332;117;261;3710
2003;"GUARAQUECABA (PR)";"PR";"GUARAQUECABA";14;2;1;17
2003;"GUARATUBA (PR)";"PR";"GUARATUBA";176;12;41;229
2003;"HONORIO SERPA (PR)";"PR";"HONORIO SERPA";98;3;14;115
2003;"IBAITI (PR)";"PR";"IBAITI";384;13;110;507
2003;"IBEMA (PR)";"PR";"IBEMA";99;4;6;109
2003;"IBIPORA (PR)";"PR";"IBIPORA";664;18;65;747
2003;"ICARAIMA (PR)";"PR";"ICARAIMA";86;1;26;113
2003;"IGUARACU (PR)";"PR";"IGUARACU";52;4;12;68
2003;"IGUATU (PR)";"PR";"IGUATU";32;1;6;39
2003;"IMBAU (PR)";"PR";"IMBAU";115;5;20;140
2003;"IMBITUVA (PR)";"PR";"IMBITUVA";558;8;36;602
2003;"INACIO MARTINS (PR)";"PR";"INACIO MARTINS";181;4;15;200
2003;"INAJA (PR)";"PR";"INAJA";28;0;15;43
2003;"INDIANOPOLIS (PR)";"PR";"INDIANOPOLIS";87;1;6;94
2003;"IPIRANGA (PR)";"PR";"IPIRANGA";241;5;19;265
2003;"IPORA (PR)";"PR";"IPORA";277;6;27;310
2003;"IRACEMA DO OESTE (PR)";"PR";"IRACEMA DO OESTE";51;5;3;59
2003;"IRATI (PR)";"PR";"IRATI";1163;31;110;1304
2003;"IRETAMA (PR)";"PR";"IRETAMA";102;3;12;117
2003;"ITAGUAJE (PR)";"PR";"ITAGUAJE";78;1;16;95
2003;"ITAIPULANDIA (PR)";"PR";"ITAIPULANDIA";137;12;19;168
2003;"ITAMBARACA (PR)";"PR";"ITAMBARACA";115;4;18;137
2003;"ITAMBE (PR)";"PR";"ITAMBE";157;2;18;177
2003;"ITAPEJARA D OESTE (PR)";"PR";"ITAPEJARA D OESTE";191;2;12;205
2003;"ITAPERUCU (PR)";"PR";"ITAPERUCU";272;16;31;319
2003;"ITAUNA DO SUL (PR)";"PR";"ITAUNA DO SUL";41;0;6;47
2003;"IVAI (PR)";"PR";"IVAI";193;6;18;217
2003;"IVAIPORA (PR)";"PR";"IVAIPORA";613;13;60;686
2003;"IVATE (PR)";"PR";"IVATE";103;1;24;128
2003;"IVATUBA (PR)";"PR";"IVATUBA";42;2;7;51
2003;"JABOTI (PR)";"PR";"JABOTI";51;3;7;61
2003;"JACAREZINHO (PR)";"PR";"JACAREZINHO";406;15;94;515
2003;"JAGUAPITA (PR)";"PR";"JAGUAPITA";214;8;32;254
2003;"JAGUARIAIVA (PR)";"PR";"JAGUARIAIVA";447;10;66;523
2003;"JANDAIA DO SUL (PR)";"PR";"JANDAIA DO SUL";382;16;74;472
2003;"JANIOPOLIS (PR)";"PR";"JANIOPOLIS";92;5;15;112
2003;"JAPIRA (PR)";"PR";"JAPIRA";35;0;3;38
2003;"JAPURA (PR)";"PR";"JAPURA";174;2;12;188
2003;"JARDIM ALEGRE (PR)";"PR";"JARDIM ALEGRE";153;4;13;170
2003;"JARDIM OLINDA (PR)";"PR";"JARDIM OLINDA";32;2;3;37
2003;"JATAIZINHO (PR)";"PR";"JATAIZINHO";252;16;13;281
2003;"JESUITAS (PR)";"PR";"JESUITAS";201;7;15;223
2003;"JOAQUIM TAVORA (PR)";"PR";"JOAQUIM TAVORA";157;8;8;173
2003;"JUNDIAI DO SUL (PR)";"PR";"JUNDIAI DO SUL";12;1;6;19
2003;"JURANDA (PR)";"PR";"JURANDA";253;4;7;264
2003;"JUSSARA (PR)";"PR";"JUSSARA";143;2;15;160
2003;"KALORE (PR)";"PR";"KALORE";107;4;12;123
2003;"LAPA (PR)";"PR";"LAPA";865;28;86;979
2003;"LARANJAL (PR)";"PR";"LARANJAL";27;2;3;32
2003;"LARANJEIRAS DO SUL (PR)";"PR";"LARANJEIRAS DO SUL";508;8;57;573
2003;"LEOPOLIS (PR)";"PR";"LEOPOLIS";53;3;3;59
2003;"LIDIANOPOLIS (PR)";"PR";"LIDIANOPOLIS";52;3;9;64
2003;"LINDOESTE (PR)";"PR";"LINDOESTE";62;3;12;77
2003;"LOANDA (PR)";"PR";"LOANDA";291;7;29;327
2003;"LOBATO (PR)";"PR";"LOBATO";129;2;13;144
2003;"LONDRINA (PR)";"PR";"LONDRINA";6875;368;1440;8683
2003;"LUIZIANA (PR)";"PR";"LUIZIANA";118;1;11;130
2003;"LUNARDELLI (PR)";"PR";"LUNARDELLI";66;4;5;75
2003;"LUPIONOPOLIS (PR)";"PR";"LUPIONOPOLIS";52;1;11;64
2003;"MALLET (PR)";"PR";"MALLET";229;9;23;261
2003;"MAMBORE (PR)";"PR";"MAMBORE";456;3;25;484
2003;"MANDAGUACU (PR)";"PR";"MANDAGUACU";318;4;32;354
2003;"MANDAGUARI (PR)";"PR";"MANDAGUARI";528;12;44;584
2003;"MANDIRITUBA (PR)";"PR";"MANDIRITUBA";542;15;37;594
2003;"MANFRINOPOLIS (PR)";"PR";"MANFRINOPOLIS";16;2;10;28
2003;"MANGUEIRINHA (PR)";"PR";"MANGUEIRINHA";340;8;34;382
2003;"MANOEL RIBAS (PR)";"PR";"MANOEL RIBAS";241;6;15;262
2003;"MARECHAL CANDIDO RONDON (PR)";"PR";"MARECHAL CANDIDO RONDON";1057;33;96;1186
2003;"MARIA HELENA (PR)";"PR";"MARIA HELENA";56;2;10;68
2003;"MARIALVA (PR)";"PR";"MARIALVA";647;15;33;695
2003;"MARILANDIA DO SUL (PR)";"PR";"MARILANDIA DO SUL";171;1;7;179
2003;"MARILENA (PR)";"PR";"MARILENA";74;2;42;118
2003;"MARILUZ (PR)";"PR";"MARILUZ";157;3;33;193
2003;"MARINGA (PR)";"PR";"MARINGA";6358;242;717;7317
2003;"MARIOPOLIS (PR)";"PR";"MARIOPOLIS";162;3;10;175
2003;"MARIPA (PR)";"PR";"MARIPA";234;4;10;248
2003;"MARMELEIRO (PR)";"PR";"MARMELEIRO";225;7;27;259
2003;"MARQUINHO (PR)";"PR";"MARQUINHO";39;1;9;49
2003;"MARUMBI (PR)";"PR";"MARUMBI";56;4;11;71
2003;"MATELANDIA (PR)";"PR";"MATELANDIA";292;3;28;323
2003;"MATINHOS (PR)";"PR";"MATINHOS";174;11;16;201
2003;"MATO RICO (PR)";"PR";"MATO RICO";25;1;5;31
2003;"MAUA DA SERRA (PR)";"PR";"MAUA DA SERRA";157;3;13;173
2003;"MEDIANEIRA (PR)";"PR";"MEDIANEIRA";807;17;75;899
2003;"MERCEDES (PR)";"PR";"MERCEDES";143;4;12;159
2003;"MIRADOR (PR)";"PR";"MIRADOR";10;1;4;15
2003;"MIRASELVA (PR)";"PR";"MIRASELVA";19;3;9;31
2003;"MISSAL (PR)";"PR";"MISSAL";250;8;27;285
2003;"MOREIRA SALES (PR)";"PR";"MOREIRA SALES";134;5;37;176
2003;"MORRETES (PR)";"PR";"MORRETES";97;5;15;117
2003;"MUNHOZ DE MELO (PR)";"PR";"MUNHOZ DE MELO";44;2;3;49
2003;"NOSSA SENHORA DAS GRACAS (PR)";"PR";"NOSSA SENHORA DAS GRACAS";13;4;13;30
2003;"NOVA ALIANCA DO IVAI (PR)";"PR";"NOVA ALIANCA DO IVAI";15;4;3;22
2003;"NOVA AMERICA DA COLINA (PR)";"PR";"NOVA AMERICA DA COLINA";74;2;11;87
2003;"NOVA AURORA (PR)";"PR";"NOVA AURORA";369;1;19;389
2003;"NOVA CANTU (PR)";"PR";"NOVA CANTU";76;1;14;91
2003;"NOVA ESPERANCA (PR)";"PR";"NOVA ESPERANCA";663;19;30;712
2003;"NOVA ESPERANCA DO SUDOESTE (PR)";"PR";"NOVA ESPERANCA DO SUDOESTE";40;3;8;51
2003;"NOVA FATIMA (PR)";"PR";"NOVA FATIMA";176;3;18;197
2003;"NOVA LARANJEIRAS (PR)";"PR";"NOVA LARANJEIRAS";101;4;19;124
2003;"NOVA LONDRINA (PR)";"PR";"NOVA LONDRINA";319;11;28;358
2003;"NOVA OLIMPIA (PR)";"PR";"NOVA OLIMPIA";84;3;11;98
2003;"NOVA PRATA DO IGUACU (PR)";"PR";"NOVA PRATA DO IGUACU";155;2;24;181
2003;"NOVA SANTA BARBARA (PR)";"PR";"NOVA SANTA BARBARA";84;2;5;91
2003;"NOVA SANTA ROSA (PR)";"PR";"NOVA SANTA ROSA";235;5;7;247
2003;"NOVA TEBAS (PR)";"PR";"NOVA TEBAS";61;0;10;71
2003;"NOVO ITACOLOMI (PR)";"PR";"NOVO ITACOLOMI";53;1;5;59
2003;"ORTIGUEIRA (PR)";"PR";"ORTIGUEIRA";159;3;33;195
2003;"OURIZONA (PR)";"PR";"OURIZONA";62;2;18;82
2003;"OURO VERDE DO OESTE (PR)";"PR";"OURO VERDE DO OESTE";98;1;7;106
2003;"PAICANDU (PR)";"PR";"PAICANDU";305;5;18;328
2003;"PALMAS (PR)";"PR";"PALMAS";678;23;43;744
2003;"PALMEIRA (PR)";"PR";"PALMEIRA";701;29;41;771
2003;"PALMITAL (PR)";"PR";"PALMITAL";164;6;33;203
2003;"PALOTINA (PR)";"PR";"PALOTINA";884;11;45;940
2003;"PARAISO DO NORTE (PR)";"PR";"PARAISO DO NORTE";166;7;31;204
2003;"PARANACITY (PR)";"PR";"PARANACITY";128;10;21;159
2003;"PARANAGUA (PR)";"PR";"PARANAGUA";1237;105;91;1433
2003;"PARANAPOEMA (PR)";"PR";"PARANAPOEMA";24;0;5;29
2003;"PARANAVAI (PR)";"PR";"PARANAVAI";1411;28;117;1556
2003;"PATO BRAGADO (PR)";"PR";"PATO BRAGADO";85;2;10;97
2003;"PATO BRANCO (PR)";"PR";"PATO BRANCO";1342;69;293;1704
2003;"PAULA FREITAS (PR)";"PR";"PAULA FREITAS";90;2;10;102
2003;"PAULO FRONTIN (PR)";"PR";"PAULO FRONTIN";96;0;9;105
2003;"PEABIRU (PR)";"PR";"PEABIRU";222;6;7;235
2003;"PEROBAL (PR)";"PR";"PEROBAL";77;2;20;99
2003;"PEROLA (PR)";"PR";"PEROLA";171;3;10;184
2003;"PEROLA D OESTE (PR)";"PR";"PEROLA D OESTE";99;4;18;121
2003;"PIEN (PR)";"PR";"PIEN";233;13;20;266
2003;"PINHAIS (PR)";"PR";"PINHAIS";1208;69;195;1472
2003;"PINHAL DO SAO BENTO (PR)";"PR";"PINHAL DO SAO BENTO";26;1;5;32
2003;"PINHALAO (PR)";"PR";"PINHALAO";53;3;7;63
2003;"PINHAO (PR)";"PR";"PINHAO";267;4;50;321
2003;"PIRAI DO SUL (PR)";"PR";"PIRAI DO SUL";306;9;45;360
2003;"PIRAQUARA (PR)";"PR";"PIRAQUARA";294;26;75;395
2003;"PITANGA (PR)";"PR";"PITANGA";578;15;84;677
2003;"PITANGUEIRAS (PR)";"PR";"PITANGUEIRAS";51;2;13;66
2003;"PLANALTINA DO PARANA (PR)";"PR";"PLANALTINA DO PARANA";65;4;7;76
2003;"PLANALTO (PR)";"PR";"PLANALTO";232;7;18;257
2003;"PONTA GROSSA (PR)";"PR";"PONTA GROSSA";4469;269;800;5538
2003;"PONTAL DO PARANA (PR)";"PR";"PONTAL DO PARANA";99;6;18;123
2003;"PORECATU (PR)";"PR";"PORECATU";279;7;71;357
2003;"PORTO AMAZONAS (PR)";"PR";"PORTO AMAZONAS";42;4;7;53
2003;"PORTO BARREIRO (PR)";"PR";"PORTO BARREIRO";50;1;16;67
2003;"PORTO RICO (PR)";"PR";"PORTO RICO";9;1;6;16
2003;"PORTO VITORIA (PR)";"PR";"PORTO VITORIA";112;1;4;117
2003;"PRADO FERREIRA (PR)";"PR";"PRADO FERREIRA";58;3;6;67
2003;"PRANCHITA (PR)";"PR";"PRANCHITA";170;0;9;179
2003;"PRESIDENTE CASTELO BRANCO (PR)";"PR";"PRESIDENTE CASTELO BRANCO";63;1;14;78
2003;"PRIMEIRO DE MAIO (PR)";"PR";"PRIMEIRO DE MAIO";236;5;17;258
2003;"PRUDENTOPOLIS (PR)";"PR";"PRUDENTOPOLIS";764;17;67;848
2003;"QUARTO CENTENARIO (PR)";"PR";"QUARTO CENTENARIO";96;3;7;106
2003;"QUATIGUA (PR)";"PR";"QUATIGUA";268;5;5;278
2003;"QUATRO BARRAS (PR)";"PR";"QUATRO BARRAS";396;20;78;494
2003;"QUATRO PONTES (PR)";"PR";"QUATRO PONTES";138;3;5;146
2003;"QUEDAS DO IGUACU (PR)";"PR";"QUEDAS DO IGUACU";442;10;69;521
2003;"QUERENCIA DO NORTE (PR)";"PR";"QUERENCIA DO NORTE";136;5;18;159
2003;"QUINTA DO SOL (PR)";"PR";"QUINTA DO SOL";104;3;11;118
2003;"QUITANDINHA (PR)";"PR";"QUITANDINHA";339;3;32;374
2003;"RAMILANDIA (PR)";"PR";"RAMILANDIA";33;1;7;41
2003;"RANCHO ALEGRE (PR)";"PR";"RANCHO ALEGRE";96;1;10;107
2003;"RANCHO ALEGRE D OESTE (PR)";"PR";"RANCHO ALEGRE D OESTE";62;0;6;68
2003;"REALEZA (PR)";"PR";"REALEZA";366;10;24;400
2003;"REBOUCAS (PR)";"PR";"REBOUCAS";166;4;17;187
2003;"RENASCENCA (PR)";"PR";"RENASCENCA";150;6;16;172
2003;"RESERVA (PR)";"PR";"RESERVA";338;8;22;368
2003;"RESERVA DO IGUACU (PR)";"PR";"RESERVA DO IGUACU";54;2;14;70
2003;"RIBEIRAO CLARO (PR)";"PR";"RIBEIRAO CLARO";127;13;13;153
2003;"RIBEIRAO DO PINHAL (PR)";"PR";"RIBEIRAO DO PINHAL";174;30;10;214
2003;"RIO AZUL (PR)";"PR";"RIO AZUL";178;4;22;204
2003;"RIO BOM (PR)";"PR";"RIO BOM";51;2;2;55
2003;"RIO BONITO DO IGUACU (PR)";"PR";"RIO BONITO DO IGUACU";149;4;44;197
2003;"RIO BRANCO DO IVAI (PR)";"PR";"RIO BRANCO DO IVAI";24;0;6;30
2003;"RIO BRANCO DO SUL (PR)";"PR";"RIO BRANCO DO SUL";499;32;70;601
2003;"RIO NEGRO (PR)";"PR";"RIO NEGRO";678;47;45;770
2003;"ROLANDIA (PR)";"PR";"ROLANDIA";1289;26;81;1396
2003;"RONCADOR (PR)";"PR";"RONCADOR";192;2;18;212
2003;"RONDON (PR)";"PR";"RONDON";216;2;32;250
2003;"ROSARIO DO IVAI (PR)";"PR";"ROSARIO DO IVAI";33;2;12;47
2003;"SABAUDIA (PR)";"PR";"SABAUDIA";111;4;8;123
2003;"SALGADO FILHO (PR)";"PR";"SALGADO FILHO";110;4;9;123
2003;"SALTO DO ITARARE (PR)";"PR";"SALTO DO ITARARE";81;3;19;103
2003;"SALTO DO LONTRA (PR)";"PR";"SALTO DO LONTRA";169;6;23;198
2003;"SANTA AMELIA (PR)";"PR";"SANTA AMELIA";53;2;9;64
2003;"SANTA CECILIA DO PAVAO (PR)";"PR";"SANTA CECILIA DO PAVAO";58;2;5;65
2003;"SANTA CRUZ DO MONTE CASTELO (PR)";"PR";"SANTA CRUZ DO MONTE CASTELO";151;3;18;172
2003;"SANTA FE (PR)";"PR";"SANTA FE";132;10;20;162
2003;"SANTA HELENA (PR)";"PR";"SANTA HELENA";479;21;60;560
2003;"SANTA INES (PR)";"PR";"SANTA INES";11;1;5;17
2003;"SANTA ISABEL DO IVAI (PR)";"PR";"SANTA ISABEL DO IVAI";134;2;14;150
2003;"SANTA IZABEL DO OESTE (PR)";"PR";"SANTA IZABEL DO OESTE";191;12;17;220
2003;"SANTA LUCIA (PR)";"PR";"SANTA LUCIA";54;1;7;62
2003;"SANTA MARIA DO OESTE (PR)";"PR";"SANTA MARIA DO OESTE";96;3;16;115
2003;"SANTA MARIANA (PR)";"PR";"SANTA MARIANA";269;9;27;305
2003;"SANTA MONICA (PR)";"PR";"SANTA MONICA";30;2;5;37
2003;"SANTA TEREZA DO OESTE (PR)";"PR";"SANTA TEREZA DO OESTE";116;6;2;124
2003;"SANTA TEREZINHA DE ITAIPU (PR)";"PR";"SANTA TEREZINHA DE ITAIPU";322;16;25;363
2003;"SANTANA DO ITARARE (PR)";"PR";"SANTANA DO ITARARE";83;2;8;93
2003;"SANTO ANTONIO DA PLATINA (PR)";"PR";"SANTO ANTONIO DA PLATINA";505;22;212;739
2003;"SANTO ANTONIO DO CAIUA (PR)";"PR";"SANTO ANTONIO DO CAIUA";15;2;9;26
2003;"SANTO ANTONIO DO PARAISO (PR)";"PR";"SANTO ANTONIO DO PARAISO";53;2;6;61
2003;"SANTO ANTONIO DO SUDOESTE (PR)";"PR";"SANTO ANTONIO DO SUDOESTE";267;4;29;300
2003;"SANTO INACIO (PR)";"PR";"SANTO INACIO";56;3;7;66
2003;"SAO CARLOS DO IVAI (PR)";"PR";"SAO CARLOS DO IVAI";190;4;14;208
2003;"SAO JERONIMO DA SERRA (PR)";"PR";"SAO JERONIMO DA SERRA";86;3;14;103
2003;"SAO JOAO (PR)";"PR";"SAO JOAO";241;11;24;276
2003;"SAO JOAO DO CAIUA (PR)";"PR";"SAO JOAO DO CAIUA";39;3;10;52
2003;"SAO JOAO DO IVAI (PR)";"PR";"SAO JOAO DO IVAI";210;9;31;250
2003;"SAO JOAO DO TRIUNFO (PR)";"PR";"SAO JOAO DO TRIUNFO";140;4;25;169
2003;"SAO JORGE D OESTE (PR)";"PR";"SAO JORGE D OESTE";136;4;18;158
2003;"SAO JORGE DO IVAI (PR)";"PR";"SAO JORGE DO IVAI";239;8;12;259
2003;"SAO JORGE DO PATROCINIO (PR)";"PR";"SAO JORGE DO PATROCINIO";71;1;7;79
2003;"SAO JOSE DA BOA VISTA (PR)";"PR";"SAO JOSE DA BOA VISTA";88;1;13;102
2003;"SAO JOSE DAS PALMEIRAS (PR)";"PR";"SAO JOSE DAS PALMEIRAS";50;5;5;60
2003;"SAO JOSE DOS PINHAIS (PR)";"PR";"SAO JOSE DOS PINHAIS";4146;242;403;4791
2003;"SAO MANOEL DO PARANA (PR)";"PR";"SAO MANOEL DO PARANA";24;2;6;32
2003;"SAO MATEUS DO SUL (PR)";"PR";"SAO MATEUS DO SUL";626;21;85;732
2003;"SAO MIGUEL DO IGUACU (PR)";"PR";"SAO MIGUEL DO IGUACU";637;12;57;706
2003;"SAO PEDRO DO IGUACU (PR)";"PR";"SAO PEDRO DO IGUACU";115;8;11;134
2003;"SAO PEDRO DO IVAI (PR)";"PR";"SAO PEDRO DO IVAI";201;2;36;239
2003;"SAO PEDRO DO PARANA (PR)";"PR";"SAO PEDRO DO PARANA";25;0;4;29
2003;"SAO SEBASTIAO DA AMOREIRA (PR)";"PR";"SAO SEBASTIAO DA AMOREIRA";157;5;17;179
2003;"SAO TOME (PR)";"PR";"SAO TOME";69;2;18;89
2003;"SAPOPEMA (PR)";"PR";"SAPOPEMA";57;1;7;65
2003;"SARANDI (PR)";"PR";"SARANDI";604;13;92;709
2003;"SAUDADE DO IGUACU (PR)";"PR";"SAUDADE DO IGUACU";47;5;7;59
2003;"SENGES (PR)";"PR";"SENGES";383;15;39;437
2003;"SERRANOPOLIS DO IGUACU (PR)";"PR";"SERRANOPOLIS DO IGUACU";113;8;8;129
2003;"SERTANEJA (PR)";"PR";"SERTANEJA";185;5;16;206
2003;"SERTANOPOLIS (PR)";"PR";"SERTANOPOLIS";425;6;21;452
2003;"SIQUEIRA CAMPOS (PR)";"PR";"SIQUEIRA CAMPOS";280;5;30;315
2003;"SULINA (PR)";"PR";"SULINA";62;4;9;75
2003;"TAMARANA (PR)";"PR";"TAMARANA";186;3;24;213
2003;"TAMBOARA (PR)";"PR";"TAMBOARA";51;0;7;58
2003;"TAPEJARA (PR)";"PR";"TAPEJARA";240;6;38;284
2003;"TAPIRA (PR)";"PR";"TAPIRA";111;2;4;117
2003;"TEIXEIRA SOARES (PR)";"PR";"TEIXEIRA SOARES";161;4;17;182
2003;"TELEMACO BORBA (PR)";"PR";"TELEMACO BORBA";913;96;182;1191
2003;"TERRA BOA (PR)";"PR";"TERRA BOA";249;6;35;290
2003;"TERRA RICA (PR)";"PR";"TERRA RICA";236;2;20;258
2003;"TERRA ROXA (PR)";"PR";"TERRA ROXA";385;9;18;412
2003;"TIBAGI (PR)";"PR";"TIBAGI";204;13;32;249
2003;"TIJUCAS DO SUL (PR)";"PR";"TIJUCAS DO SUL";199;5;24;228
2003;"TOLEDO (PR)";"PR";"TOLEDO";2142;94;175;2411
2003;"TOMAZINA (PR)";"PR";"TOMAZINA";51;3;13;67
2003;"TRES BARRAS DO PARANA (PR)";"PR";"TRES BARRAS DO PARANA";237;3;17;257
2003;"TUNAS DO PARANA (PR)";"PR";"TUNAS DO PARANA";38;3;6;47
2003;"TUNEIRAS DO OESTE (PR)";"PR";"TUNEIRAS DO OESTE";88;2;20;110
2003;"TUPASSI (PR)";"PR";"TUPASSI";269;4;10;283
2003;"TURVO (PR)";"PR";"TURVO";234;5;25;264
2003;"UBIRATA (PR)";"PR";"UBIRATA";478;13;30;521
2003;"UMUARAMA (PR)";"PR";"UMUARAMA";1796;30;159;1985
2003;"UNIAO DA VITORIA (PR)";"PR";"UNIAO DA VITORIA";1018;23;55;1096
2003;"UNIFLOR (PR)";"PR";"UNIFLOR";13;3;5;21
2003;"URAI (PR)";"PR";"URAI";244;6;14;264
2003;"VENTANIA (PR)";"PR";"VENTANIA";85;2;15;102
2003;"VERA CRUZ DO OESTE (PR)";"PR";"VERA CRUZ DO OESTE";219;7;8;234
2003;"VERE (PR)";"PR";"VERE";146;5;13;164
2003;"VILA ALTA (PR)";"PR";"VILA ALTA";34;1;8;43
2003;"VIRMOND (PR)";"PR";"VIRMOND";76;1;9;86
2003;"VITORINO (PR)";"PR";"VITORINO";205;3;8;216
2003;"WENCESLAU BRAZ (PR)";"PR";"WENCESLAU BRAZ";314;14;49;377
2003;"XAMBRE (PR)";"PR";"XAMBRE";61;5;6;72
2003;"ANGRA DOS REIS (RJ)";"RJ";"ANGRA DOS REIS";885;152;244;1281
2003;"APERIBE (RJ)";"RJ";"APERIBE";59;7;4;70
2003;"ARARUAMA (RJ)";"RJ";"ARARUAMA";955;151;44;1150
2003;"AREAL (RJ)";"RJ";"AREAL";79;4;13;96
2003;"ARMACAO DE BUZIOS (RJ)";"RJ";"ARMACAO DE BUZIOS";164;117;12;293
2003;"ARRAIAL DO CABO (RJ)";"RJ";"ARRAIAL DO CABO";113;37;11;161
2003;"BARRA DO PIRAI (RJ)";"RJ";"BARRA DO PIRAI";1933;91;195;2219
2003;"BARRA MANSA (RJ)";"RJ";"BARRA MANSA";1373;72;392;1837
2003;"BELFORD ROXO (RJ)";"RJ";"BELFORD ROXO";660;197;410;1267
2003;"BOM JARDIM (RJ)";"RJ";"BOM JARDIM";281;10;10;301
2003;"BOM JESUS DO ITABAPOANA (RJ)";"RJ";"BOM JESUS DO ITABAPOANA";301;17;27;345
2003;"CABO FRIO (RJ)";"RJ";"CABO FRIO";1470;165;282;1917
2003;"CACHOEIRAS DE MACACU (RJ)";"RJ";"CACHOEIRAS DE MACACU";551;80;25;656
2003;"CAMBUCI (RJ)";"RJ";"CAMBUCI";62;6;6;74
2003;"CAMPOS DOS GOITACAZES (RJ)";"RJ";"CAMPOS DOS GOITACAZES";4152;249;764;5165
2003;"CANTAGALO (RJ)";"RJ";"CANTAGALO";92;13;20;125
2003;"CARAPEBUS (RJ)";"RJ";"CARAPEBUS";40;15;3;58
2003;"CARDOSO MOREIRA (RJ)";"RJ";"CARDOSO MOREIRA";114;3;9;126
2003;"CARMO (RJ)";"RJ";"CARMO";87;12;20;119
2003;"CASIMIRO DE ABREU (RJ)";"RJ";"CASIMIRO DE ABREU";358;34;19;411
2003;"COMENDADOR LEVY GASPARIAN (RJ)";"RJ";"COMENDADOR LEVY GASPARIAN";76;21;12;109
2003;"CONCEICAO DE MACABU (RJ)";"RJ";"CONCEICAO DE MACABU";111;24;40;175
2003;"CORDEIRO (RJ)";"RJ";"CORDEIRO";190;30;37;257
2003;"DUAS BARRAS (RJ)";"RJ";"DUAS BARRAS";37;15;5;57
2003;"DUQUE DE CAXIAS (RJ)";"RJ";"DUQUE DE CAXIAS";5766;592;2192;8550
2003;"ENGENHEIRO PAULO DE FRONTIN (RJ)";"RJ";"ENGENHEIRO PAULO DE FRONTIN";184;17;20;221
2003;"GUAPIMIRIM (RJ)";"RJ";"GUAPIMIRIM";235;42;27;304
2003;"IGUABA GRANDE (RJ)";"RJ";"IGUABA GRANDE";68;71;5;144
2003;"ITABORAI (RJ)";"RJ";"ITABORAI";1852;591;621;3064
2003;"ITAGUAI (RJ)";"RJ";"ITAGUAI";1016;219;138;1373
2003;"ITALVA (RJ)";"RJ";"ITALVA";130;8;13;151
2003;"ITAOCARA (RJ)";"RJ";"ITAOCARA";225;25;18;268
2003;"ITAPERUNA (RJ)";"RJ";"ITAPERUNA";846;65;72;983
2003;"ITATIAIA (RJ)";"RJ";"ITATIAIA";170;55;23;248
2003;"JAPERI (RJ)";"RJ";"JAPERI";96;25;10;131
2003;"LAJE DO MURIAE (RJ)";"RJ";"LAJE DO MURIAE";34;3;4;41
2003;"MACAE (RJ)";"RJ";"MACAE";1479;342;396;2217
2003;"MACUCO (RJ)";"RJ";"MACUCO";69;3;3;75
2003;"MAGE (RJ)";"RJ";"MAGE";907;180;195;1282
2003;"MANGARATIBA (RJ)";"RJ";"MANGARATIBA";109;73;125;307
2003;"MARICA (RJ)";"RJ";"MARICA";391;169;142;702
2003;"MENDES (RJ)";"RJ";"MENDES";276;28;20;324
2003;"MESQUITA (RJ)";"RJ";"MESQUITA";164;51;154;369
2003;"MIGUEL PEREIRA (RJ)";"RJ";"MIGUEL PEREIRA";162;34;12;208
2003;"MIRACEMA (RJ)";"RJ";"MIRACEMA";167;6;17;190
2003;"NATIVIDADE (RJ)";"RJ";"NATIVIDADE";60;8;14;82
2003;"NILOPOLIS (RJ)";"RJ";"NILOPOLIS";435;112;263;810
2003;"NITEROI (RJ)";"RJ";"NITEROI";2028;1177;1514;4719
2003;"NOVA FRIBURGO (RJ)";"RJ";"NOVA FRIBURGO";3701;166;282;4149
2003;"NOVA IGUACU (RJ)";"RJ";"NOVA IGUACU";4289;659;1560;6508
2003;"PARACAMBI (RJ)";"RJ";"PARACAMBI";121;25;29;175
2003;"PARAIBA DO SUL (RJ)";"RJ";"PARAIBA DO SUL";325;40;230;595
2003;"PARATI (RJ)";"RJ";"PARATI";128;42;29;199
2003;"PATY DO ALFERES (RJ)";"RJ";"PATY DO ALFERES";361;27;39;427
2003;"PETROPOLIS (RJ)";"RJ";"PETROPOLIS";2750;511;653;3914
2003;"PINHEIRAL (RJ)";"RJ";"PINHEIRAL";99;28;23;150
2003;"PIRAI (RJ)";"RJ";"PIRAI";570;27;74;671
2003;"PORCIUNCULA (RJ)";"RJ";"PORCIUNCULA";54;1;7;62
2003;"PORTO REAL (RJ)";"RJ";"PORTO REAL";280;23;21;324
2003;"QUATIS (RJ)";"RJ";"QUATIS";197;143;26;366
2003;"QUEIMADOS (RJ)";"RJ";"QUEIMADOS";278;146;88;512
2003;"QUISSAMA (RJ)";"RJ";"QUISSAMA";105;5;31;141
2003;"RESENDE (RJ)";"RJ";"RESENDE";648;100;208;956
2003;"RIO BONITO (RJ)";"RJ";"RIO BONITO";3043;213;179;3435
2003;"RIO CLARO (RJ)";"RJ";"RIO CLARO";65;7;6;78
2003;"RIO DAS FLORES (RJ)";"RJ";"RIO DAS FLORES";48;8;4;60
2003;"RIO DAS OSTRAS (RJ)";"RJ";"RIO DAS OSTRAS";413;83;21;517
2003;"RIO DE JANEIRO (RJ)";"RJ";"RIO DE JANEIRO";26937;10345;10334;47616
2003;"SANTA MARIA MADALENA (RJ)";"RJ";"SANTA MARIA MADALENA";33;6;2;41
2003;"SANTO ANTONIO DE PADUA (RJ)";"RJ";"SANTO ANTONIO DE PADUA";407;36;18;461
2003;"SAO FIDELIS (RJ)";"RJ";"SAO FIDELIS";313;19;44;376
2003;"SAO FRANCISCO DE ITABAPOANA (RJ)";"RJ";"SAO FRANCISCO DE ITABAPOANA";192;20;17;229
2003;"SAO GONCALO (RJ)";"RJ";"SAO GONCALO";2283;1055;1426;4764
2003;"SAO JOAO DA BARRA (RJ)";"RJ";"SAO JOAO DA BARRA";223;21;18;262
2003;"SAO JOAO DE MERITI (RJ)";"RJ";"SAO JOAO DE MERITI";2112;251;1105;3468
2003;"SAO JOSE DE UBA (RJ)";"RJ";"SAO JOSE DE UBA";9;0;1;10
2003;"SAO JOSE DO VALE DO RIO PRETO (RJ)";"RJ";"SAO JOSE DO VALE DO RIO PRETO";452;40;20;512
2003;"SAO PEDRO DA ALDEIA (RJ)";"RJ";"SAO PEDRO DA ALDEIA";376;46;39;461
2003;"SAO SEBASTIAO DO ALTO (RJ)";"RJ";"SAO SEBASTIAO DO ALTO";41;2;2;45
2003;"SAPUCAIA (RJ)";"RJ";"SAPUCAIA";115;5;8;128
2003;"SAQUAREMA (RJ)";"RJ";"SAQUAREMA";334;62;42;438
2003;"SEROPEDICA (RJ)";"RJ";"SEROPEDICA";316;30;115;461
2003;"SILVA JARDIM (RJ)";"RJ";"SILVA JARDIM";225;30;13;268
2003;"SUMIDOURO (RJ)";"RJ";"SUMIDOURO";208;7;12;227
2003;"TANGUA (RJ)";"RJ";"TANGUA";125;10;12;147
2003;"TERESOPOLIS (RJ)";"RJ";"TERESOPOLIS";1354;139;240;1733
2003;"TRAJANO DE MORAIS (RJ)";"RJ";"TRAJANO DE MORAIS";35;3;4;42
2003;"TRES RIOS (RJ)";"RJ";"TRES RIOS";665;54;201;920
2003;"VALENCA (RJ)";"RJ";"VALENCA";217;42;43;302
2003;"VARRE SAI (RJ)";"RJ";"VARRE SAI";27;1;1;29
2003;"VASSOURAS (RJ)";"RJ";"VASSOURAS";406;33;49;488
2003;"VOLTA REDONDA (RJ)";"RJ";"VOLTA REDONDA";1630;166;420;2216
2003;"ACARI (RN)";"RN";"ACARI";51;6;3;60
2003;"AFONSO BEZERRA (RN)";"RN";"AFONSO BEZERRA";16;2;0;18
2003;"AGUA NOVA (RN)";"RN";"AGUA NOVA";2;3;0;5
2003;"ALEXANDRIA (RN)";"RN";"ALEXANDRIA";28;6;6;40
2003;"ALMINO AFONSO (RN)";"RN";"ALMINO AFONSO";4;4;0;8
2003;"ALTO DO RODRIGUES (RN)";"RN";"ALTO DO RODRIGUES";57;4;11;72
2003;"ANGICOS (RN)";"RN";"ANGICOS";70;4;6;80
2003;"ANTONIO MARTINS (RN)";"RN";"ANTONIO MARTINS";6;6;0;12
2003;"APODI (RN)";"RN";"APODI";115;15;12;142
2003;"AREIA BRANCA (RN)";"RN";"AREIA BRANCA";72;30;24;126
2003;"ARES (RN)";"RN";"ARES";72;3;7;82
2003;"ASSU (RN)";"RN";"ASSU";334;20;17;371
2003;"BAIA FORMOSA (RN)";"RN";"BAIA FORMOSA";33;2;3;38
2003;"BARAUNA (RN)";"RN";"BARAUNA";92;17;3;112
2003;"BARCELONA (RN)";"RN";"BARCELONA";20;4;1;25
2003;"BENTO FERNANDES (RN)";"RN";"BENTO FERNANDES";7;4;0;11
2003;"BOA SAUDE (RN)";"RN";"BOA SAUDE";23;4;0;27
2003;"BODO (RN)";"RN";"BODO";8;7;1;16
2003;"BOM JESUS (RN)";"RN";"BOM JESUS";25;1;2;28
2003;"BREJINHO (RN)";"RN";"BREJINHO";40;6;7;53
2003;"CAICARA DO NORTE (RN)";"RN";"CAICARA DO NORTE";5;0;2;7
2003;"CAICARA DO RIO DO VENTO (RN)";"RN";"CAICARA DO RIO DO VENTO";12;2;1;15
2003;"CAICO (RN)";"RN";"CAICO";751;38;27;816
2003;"CAMPO GRANDE (RN)";"RN";"CAMPO GRANDE";22;5;0;27
2003;"CAMPO REDONDO (RN)";"RN";"CAMPO REDONDO";21;6;1;28
2003;"CANGUARETAMA (RN)";"RN";"CANGUARETAMA";98;16;16;130
2003;"CARAUBAS (RN)";"RN";"CARAUBAS";67;14;0;81
2003;"CARNAUBA DOS DANTAS (RN)";"RN";"CARNAUBA DOS DANTAS";80;2;3;85
2003;"CARNAUBAIS (RN)";"RN";"CARNAUBAIS";35;9;8;52
2003;"CEARA MIRIM (RN)";"RN";"CEARA MIRIM";207;22;35;264
2003;"CERRO CORA (RN)";"RN";"CERRO CORA";45;5;3;53
2003;"CORONEL EZEQUIEL (RN)";"RN";"CORONEL EZEQUIEL";11;3;2;16
2003;"CORONEL JOAO PESSOA (RN)";"RN";"CORONEL JOAO PESSOA";7;1;0;8
2003;"CRUZETA (RN)";"RN";"CRUZETA";41;5;1;47
2003;"CURRAIS NOVOS (RN)";"RN";"CURRAIS NOVOS";429;15;29;473
2003;"DOUTOR SEVERIANO (RN)";"RN";"DOUTOR SEVERIANO";2;5;1;8
2003;"ENCANTO (RN)";"RN";"ENCANTO";6;0;1;7
2003;"EQUADOR (RN)";"RN";"EQUADOR";30;1;1;32
2003;"ESPIRITO SANTO (RN)";"RN";"ESPIRITO SANTO";14;3;4;21
2003;"ESPIRITO SANTO DO OESTE (RN)";"RN";"ESPIRITO SANTO DO OESTE";12;1;1;14
2003;"EXTREMOZ (RN)";"RN";"EXTREMOZ";26;15;65;106
2003;"FELIPE GUERRA (RN)";"RN";"FELIPE GUERRA";12;5;1;18
2003;"FERNANDO PEDROZA (RN)";"RN";"FERNANDO PEDROZA";11;0;0;11
2003;"FLORANIA (RN)";"RN";"FLORANIA";33;4;2;39
2003;"FRANCISCO DANTAS (RN)";"RN";"FRANCISCO DANTAS";8;2;1;11
2003;"FRUTUOSO GOMES (RN)";"RN";"FRUTUOSO GOMES";12;3;0;15
2003;"GALINHOS (RN)";"RN";"GALINHOS";6;1;1;8
2003;"GOIANINHA (RN)";"RN";"GOIANINHA";75;20;20;115
2003;"GOVERNADOR DIX SEPT ROSADO (RN)";"RN";"GOVERNADOR DIX SEPT ROSADO";68;2;4;74
2003;"GROSSOS (RN)";"RN";"GROSSOS";16;3;2;21
2003;"GUAMARE (RN)";"RN";"GUAMARE";19;4;12;35
2003;"IELMO MARINHO (RN)";"RN";"IELMO MARINHO";22;2;2;26
2003;"IPANGUACU (RN)";"RN";"IPANGUACU";36;8;29;73
2003;"IPUEIRA (RN)";"RN";"IPUEIRA";11;7;4;22
2003;"ITAJA (RN)";"RN";"ITAJA";35;0;2;37
2003;"ITAU (RN)";"RN";"ITAU";12;2;1;15
2003;"JACANA (RN)";"RN";"JACANA";40;10;11;61
2003;"JANDAIRA (RN)";"RN";"JANDAIRA";25;2;2;29
2003;"JANDUIS (RN)";"RN";"JANDUIS";10;0;0;10
2003;"JAPI (RN)";"RN";"JAPI";22;1;6;29
2003;"JARDIM DE ANGICOS (RN)";"RN";"JARDIM DE ANGICOS";5;0;1;6
2003;"JARDIM DE PIRANHAS (RN)";"RN";"JARDIM DE PIRANHAS";40;10;6;56
2003;"JARDIM DO SERIDO (RN)";"RN";"JARDIM DO SERIDO";98;3;56;157
2003;"JOAO CAMARA (RN)";"RN";"JOAO CAMARA";165;9;13;187
2003;"JOAO DIAS (RN)";"RN";"JOAO DIAS";3;0;0;3
2003;"JOSE DA PENHA (RN)";"RN";"JOSE DA PENHA";11;5;1;17
2003;"JUCURUTU (RN)";"RN";"JUCURUTU";66;11;4;81
2003;"JUNDIA (RN)";"RN";"JUNDIA";2;0;2;4
2003;"LAGOA DANTA (RN)";"RN";"LAGOA DANTA";21;2;3;26
2003;"LAGOA DE PEDRAS (RN)";"RN";"LAGOA DE PEDRAS";17;2;2;21
2003;"LAGOA DE VELHOS (RN)";"RN";"LAGOA DE VELHOS";6;0;0;6
2003;"LAGOA NOVA (RN)";"RN";"LAGOA NOVA";38;5;2;45
2003;"LAGOA SALGADA (RN)";"RN";"LAGOA SALGADA";25;6;0;31
2003;"LAJES (RN)";"RN";"LAJES";38;3;3;44
2003;"LAJES PINTADAS (RN)";"RN";"LAJES PINTADAS";13;6;4;23
2003;"LUCRECIA (RN)";"RN";"LUCRECIA";10;1;1;12
2003;"LUIS GOMES (RN)";"RN";"LUIS GOMES";5;4;2;11
2003;"MACAIBA (RN)";"RN";"MACAIBA";227;21;18;266
2003;"MACAU (RN)";"RN";"MACAU";72;25;24;121
2003;"MAJOR SALES (RN)";"RN";"MAJOR SALES";2;2;0;4
2003;"MARCELINO VIEIRA (RN)";"RN";"MARCELINO VIEIRA";10;7;1;18
2003;"MARTINS (RN)";"RN";"MARTINS";24;3;2;29
2003;"MAXARANGUAPE (RN)";"RN";"MAXARANGUAPE";13;7;4;24
2003;"MESSIAS TARGINO (RN)";"RN";"MESSIAS TARGINO";16;3;1;20
2003;"MONTANHAS (RN)";"RN";"MONTANHAS";15;4;4;23
2003;"MONTE ALEGRE (RN)";"RN";"MONTE ALEGRE";56;5;7;68
2003;"MONTE DAS GAMELEIRAS (RN)";"RN";"MONTE DAS GAMELEIRAS";6;3;4;13
2003;"MOSSORO (RN)";"RN";"MOSSORO";2225;111;102;2438
2003;"NATAL (RN)";"RN";"NATAL";4927;953;1645;7525
2003;"NISIA FLORESTA (RN)";"RN";"NISIA FLORESTA";48;19;48;115
2003;"NOVA CRUZ (RN)";"RN";"NOVA CRUZ";184;13;17;214
2003;"OLHO D AGUA DO BORGES (RN)";"RN";"OLHO D AGUA DO BORGES";12;0;0;12
2003;"OURO BRANCO (RN)";"RN";"OURO BRANCO";30;3;4;37
2003;"PARANA (RN)";"RN";"PARANA";5;2;1;8
2003;"PARAZINHO (RN)";"RN";"PARAZINHO";10;0;4;14
2003;"PARELHAS (RN)";"RN";"PARELHAS";174;5;16;195
2003;"PARNAMIRIM (RN)";"RN";"PARNAMIRIM";772;184;111;1067
2003;"PASSA E FICA (RN)";"RN";"PASSA E FICA";44;7;4;55
2003;"PASSAGEM (RN)";"RN";"PASSAGEM";14;5;0;19
2003;"PATU (RN)";"RN";"PATU";58;14;2;74
2003;"PAU DOS FERROS (RN)";"RN";"PAU DOS FERROS";184;16;6;206
2003;"PEDRA GRANDE (RN)";"RN";"PEDRA GRANDE";10;2;2;14
2003;"PEDRA PRETA (RN)";"RN";"PEDRA PRETA";21;1;2;24
2003;"PEDRO AVELINO (RN)";"RN";"PEDRO AVELINO";23;1;0;24
2003;"PEDRO VELHO (RN)";"RN";"PEDRO VELHO";27;1;5;33
2003;"PENDENCIAS (RN)";"RN";"PENDENCIAS";31;8;4;43
2003;"PILOES (RN)";"RN";"PILOES";3;0;0;3
2003;"POCO BRANCO (RN)";"RN";"POCO BRANCO";22;3;1;26
2003;"PORTALEGRE (RN)";"RN";"PORTALEGRE";23;4;1;28
2003;"PORTO DO MANGUE (RN)";"RN";"PORTO DO MANGUE";28;6;2;36
2003;"PUREZA (RN)";"RN";"PUREZA";29;0;5;34
2003;"RAFAEL FERNANDES (RN)";"RN";"RAFAEL FERNANDES";6;3;1;10
2003;"RAFAEL GODEIRO (RN)";"RN";"RAFAEL GODEIRO";9;3;0;12
2003;"RIACHO DA CRUZ (RN)";"RN";"RIACHO DA CRUZ";2;2;0;4
2003;"RIACHO DE SANTANA (RN)";"RN";"RIACHO DE SANTANA";2;4;0;6
2003;"RIACHUELO (RN)";"RN";"RIACHUELO";16;2;0;18
2003;"RIO DO FOGO (RN)";"RN";"RIO DO FOGO";11;1;1;13
2003;"RODOLFO FERNANDES (RN)";"RN";"RODOLFO FERNANDES";15;4;0;19
2003;"RUY BARBOSA (RN)";"RN";"RUY BARBOSA";10;1;1;12
2003;"SANTA CRUZ (RN)";"RN";"SANTA CRUZ";226;7;13;246
2003;"SANTA MARIA (RN)";"RN";"SANTA MARIA";20;0;1;21
2003;"SANTANA DO MATOS (RN)";"RN";"SANTANA DO MATOS";40;7;1;48
2003;"SANTANA DO SERIDO (RN)";"RN";"SANTANA DO SERIDO";17;1;0;18
2003;"SANTO ANTONIO (RN)";"RN";"SANTO ANTONIO";89;24;9;122
2003;"SAO BENTO DO NORTE (RN)";"RN";"SAO BENTO DO NORTE";7;2;1;10
2003;"SAO BENTO DO TRAIRI (RN)";"RN";"SAO BENTO DO TRAIRI";9;2;2;13
2003;"SAO FERNANDO (RN)";"RN";"SAO FERNANDO";4;2;1;7
2003;"SAO FRANCISCO DO OESTE (RN)";"RN";"SAO FRANCISCO DO OESTE";7;1;2;10
2003;"SAO GONCALO DO AMARANTE (RN)";"RN";"SAO GONCALO DO AMARANTE";153;21;16;190
2003;"SAO JOAO DO SABUGI (RN)";"RN";"SAO JOAO DO SABUGI";20;0;2;22
2003;"SAO JOSE DE MIPIBU (RN)";"RN";"SAO JOSE DE MIPIBU";148;24;19;191
2003;"SAO JOSE DO CAMPESTRE (RN)";"RN";"SAO JOSE DO CAMPESTRE";44;4;3;51
2003;"SAO JOSE DO SERIDO (RN)";"RN";"SAO JOSE DO SERIDO";16;5;1;22
2003;"SAO MIGUEL (RN)";"RN";"SAO MIGUEL";71;13;16;100
2003;"SAO MIGUEL DE TOUROS (RN)";"RN";"SAO MIGUEL DE TOUROS";9;1;2;12
2003;"SAO PAULO DO POTENGI (RN)";"RN";"SAO PAULO DO POTENGI";75;3;5;83
2003;"SAO PEDRO (RN)";"RN";"SAO PEDRO";19;2;1;22
2003;"SAO RAFAEL (RN)";"RN";"SAO RAFAEL";16;6;0;22
2003;"SAO TOME (RN)";"RN";"SAO TOME";29;3;14;46
2003;"SAO VICENTE (RN)";"RN";"SAO VICENTE";33;0;0;33
2003;"SENADOR ELOI DE SOUZA (RN)";"RN";"SENADOR ELOI DE SOUZA";11;3;2;16
2003;"SENADOR GEORGINO AVELINO (RN)";"RN";"SENADOR GEORGINO AVELINO";5;1;1;7
2003;"SERRA CAIADA (RN)";"RN";"SERRA CAIADA";17;4;5;26
2003;"SERRA DE SAO BENTO (RN)";"RN";"SERRA DE SAO BENTO";16;2;3;21
2003;"SERRA DO MEL (RN)";"RN";"SERRA DO MEL";34;6;3;43
2003;"SERRA NEGRA DO NORTE (RN)";"RN";"SERRA NEGRA DO NORTE";55;7;3;65
2003;"SERRINHA (RN)";"RN";"SERRINHA";9;3;1;13
2003;"SERRINHA DOS PINTOS (RN)";"RN";"SERRINHA DOS PINTOS";17;1;0;18
2003;"SEVERIANO MELO (RN)";"RN";"SEVERIANO MELO";19;5;3;27
2003;"SITIO NOVO (RN)";"RN";"SITIO NOVO";11;1;0;12
2003;"TABOLEIRO GRANDE (RN)";"RN";"TABOLEIRO GRANDE";4;2;0;6
2003;"TAIPU (RN)";"RN";"TAIPU";30;1;4;35
2003;"TANGARA (RN)";"RN";"TANGARA";52;3;10;65
2003;"TENENTE ANANIAS (RN)";"RN";"TENENTE ANANIAS";15;3;0;18
2003;"TENENTE LAURENTINO CRUZ (RN)";"RN";"TENENTE LAURENTINO CRUZ";26;8;2;36
2003;"TIBAU (RN)";"RN";"TIBAU";11;12;5;28
2003;"TIBAU DO SUL (RN)";"RN";"TIBAU DO SUL";21;27;6;54
2003;"TIMBAUBA DOS BATISTAS (RN)";"RN";"TIMBAUBA DOS BATISTAS";9;6;2;17
2003;"TOUROS (RN)";"RN";"TOUROS";86;15;14;115
2003;"TRIUNFO POTIGUAR (RN)";"RN";"TRIUNFO POTIGUAR";8;4;0;12
2003;"UMARIZAL (RN)";"RN";"UMARIZAL";32;8;2;42
2003;"UPANEMA (RN)";"RN";"UPANEMA";23;11;4;38
2003;"VARZEA (RN)";"RN";"VARZEA";13;1;2;16
2003;"VENHA VER (RN)";"RN";"VENHA VER";8;2;0;10
2003;"VERA CRUZ (RN)";"RN";"VERA CRUZ";73;3;10;86
2003;"VICOSA (RN)";"RN";"VICOSA";4;3;0;7
2003;"VILA FLOR (RN)";"RN";"VILA FLOR";4;2;1;7
2003;"ALTA FLORESTA D OESTE (RO)";"RO";"ALTA FLORESTA D OESTE";292;5;16;313
2003;"ALTO ALEGRE DOS PARECIS (RO)";"RO";"ALTO ALEGRE DOS PARECIS";36;1;4;41
2003;"ALTO PARAISO (RO)";"RO";"ALTO PARAISO";49;1;8;58
2003;"ALVORADA D OESTE (RO)";"RO";"ALVORADA D OESTE";186;3;14;203
2003;"ARIQUEMES (RO)";"RO";"ARIQUEMES";1324;13;98;1435
2003;"BURITIS (RO)";"RO";"BURITIS";146;1;8;155
2003;"CABIXI (RO)";"RO";"CABIXI";45;1;5;51
2003;"CACAULANDIA (RO)";"RO";"CACAULANDIA";15;0;5;20
2003;"CACOAL (RO)";"RO";"CACOAL";1142;14;125;1281
2003;"CAMPO NOVO DE RONDONIA (RO)";"RO";"CAMPO NOVO DE RONDONIA";15;0;4;19
2003;"CANDEIAS DO JAMARI (RO)";"RO";"CANDEIAS DO JAMARI";47;1;5;53
2003;"CASTANHEIRAS (RO)";"RO";"CASTANHEIRAS";15;2;4;21
2003;"CEREJEIRAS (RO)";"RO";"CEREJEIRAS";299;9;23;331
2003;"CHUPINGUAIA (RO)";"RO";"CHUPINGUAIA";22;1;8;31
2003;"COLORADO DO OESTE (RO)";"RO";"COLORADO DO OESTE";267;5;25;297
2003;"CORUMBIARA (RO)";"RO";"CORUMBIARA";19;2;3;24
2003;"COSTA MARQUES (RO)";"RO";"COSTA MARQUES";25;2;0;27
2003;"CUJUBIM (RO)";"RO";"CUJUBIM";14;0;3;17
2003;"ESPIGAO D OESTE (RO)";"RO";"ESPIGAO D OESTE";328;3;36;367
2003;"GOVERNADOR JORGE TEIXEIRA (RO)";"RO";"GOVERNADOR JORGE TEIXEIRA";19;0;7;26
2003;"GUAJARA MIRIM (RO)";"RO";"GUAJARA MIRIM";249;4;7;260
2003;"JAMARI (RO)";"RO";"JAMARI";32;0;6;38
2003;"JARU (RO)";"RO";"JARU";781;11;78;870
2003;"JI PARANA (RO)";"RO";"JI PARANA";1759;34;514;2307
2003;"MACHADINHO D OESTE (RO)";"RO";"MACHADINHO D OESTE";123;0;17;140
2003;"MINISTRO ANDREAZZA (RO)";"RO";"MINISTRO ANDREAZZA";78;2;7;87
2003;"MIRANTE DA SERRA (RO)";"RO";"MIRANTE DA SERRA";99;1;7;107
2003;"MONTE NEGRO (RO)";"RO";"MONTE NEGRO";124;1;24;149
2003;"NOVA BRASILANDIA D OESTE (RO)";"RO";"NOVA BRASILANDIA D OESTE";148;2;13;163
2003;"NOVA UNIAO (RO)";"RO";"NOVA UNIAO";7;1;0;8
2003;"NOVO HORIZONTE DO OESTE (RO)";"RO";"NOVO HORIZONTE DO OESTE";32;1;5;38
2003;"OURO PRETO DO OESTE (RO)";"RO";"OURO PRETO DO OESTE";587;19;76;682
2003;"PARECIS (RO)";"RO";"PARECIS";9;0;3;12
2003;"PIMENTA BUENO (RO)";"RO";"PIMENTA BUENO";562;5;34;601
2003;"PIMENTEIRAS DO OESTE (RO)";"RO";"PIMENTEIRAS DO OESTE";6;0;5;11
2003;"PORTO VELHO (RO)";"RO";"PORTO VELHO";2716;142;502;3360
2003;"PRESIDENTE MEDICI (RO)";"RO";"PRESIDENTE MEDICI";199;1;28;228
2003;"PRIMAVERA DE RONDONIA (RO)";"RO";"PRIMAVERA DE RONDONIA";24;1;5;30
2003;"RIO CRESPO (RO)";"RO";"RIO CRESPO";14;0;2;16
2003;"ROLIM DE MOURA (RO)";"RO";"ROLIM DE MOURA";825;15;51;891
2003;"SANTA LUZIA D OESTE (RO)";"RO";"SANTA LUZIA D OESTE";85;2;29;116
2003;"SAO FELIPE D OESTE (RO)";"RO";"SAO FELIPE D OESTE";20;0;7;27
2003;"SAO FRANCISCO DO GUAPORE (RO)";"RO";"SAO FRANCISCO DO GUAPORE";97;0;5;102
2003;"SAO MIGUEL DO GUAPORE (RO)";"RO";"SAO MIGUEL DO GUAPORE";115;1;11;127
2003;"SERINGUEIRAS (RO)";"RO";"SERINGUEIRAS";33;2;5;40
2003;"TEIXEIROPOLIS (RO)";"RO";"TEIXEIROPOLIS";4;0;4;8
2003;"THEOBROMA (RO)";"RO";"THEOBROMA";19;0;16;35
2003;"URUPA (RO)";"RO";"URUPA";51;1;4;56
2003;"VALE DO ANARI (RO)";"RO";"VALE DO ANARI";13;1;1;15
2003;"VALE DO PARAISO (RO)";"RO";"VALE DO PARAISO";21;0;2;23
2003;"VILA NOVA DO MAMORE (RO)";"RO";"VILA NOVA DO MAMORE";86;0;7;93
2003;"VILHENA (RO)";"RO";"VILHENA";934;19;74;1027
2003;"ALTO ALEGRE (RR)";"RR";"ALTO ALEGRE";8;1;1;10
2003;"AMAJARI (RR)";"RR";"AMAJARI";4;1;0;5
2003;"BOA VISTA (RR)";"RR";"BOA VISTA";2084;160;275;2519
2003;"BONFIM (RR)";"RR";"BONFIM";3;0;0;3
2003;"CANTA (RR)";"RR";"CANTA";6;0;0;6
2003;"CARACARAI (RR)";"RR";"CARACARAI";24;1;0;25
2003;"CAROEBE (RR)";"RR";"CAROEBE";11;2;2;15
2003;"IRACEMA (RR)";"RR";"IRACEMA";0;1;0;1
2003;"MUCAJAI (RR)";"RR";"MUCAJAI";37;11;0;48
2003;"NORMANDIA (RR)";"RR";"NORMANDIA";4;0;0;4
2003;"PACARAIMA (RR)";"RR";"PACARAIMA";8;0;1;9
2003;"RORAINOPOLIS (RR)";"RR";"RORAINOPOLIS";19;3;2;24
2003;"SAO JOAO DA BALIZA (RR)";"RR";"SAO JOAO DA BALIZA";11;1;0;12
2003;"SAO LUIZ (RR)";"RR";"SAO LUIZ";7;1;0;8
2003;"UIRAMUTA (RR)";"RR";"UIRAMUTA";1;0;0;1
2003;"ACEGUA (RS)";"RS";"ACEGUA";35;7;3;45
2003;"AGUA SANTA (RS)";"RS";"AGUA SANTA";105;1;11;117
2003;"AGUDO (RS)";"RS";"AGUDO";216;7;41;264
2003;"AJURICABA (RS)";"RS";"AJURICABA";253;10;20;283
2003;"ALECRIM (RS)";"RS";"ALECRIM";72;3;17;92
2003;"ALEGRETE (RS)";"RS";"ALEGRETE";778;18;125;921
2003;"ALEGRIA (RS)";"RS";"ALEGRIA";66;3;10;79
2003;"ALMIRANTE TAMANDARE DO SUL (RS)";"RS";"ALMIRANTE TAMANDARE DO SUL";50;4;1;55
2003;"ALPESTRE (RS)";"RS";"ALPESTRE";83;9;26;118
2003;"ALTO ALEGRE (RS)";"RS";"ALTO ALEGRE";53;3;6;62
2003;"ALTO FELIZ (RS)";"RS";"ALTO FELIZ";70;5;11;86
2003;"ALVORADA (RS)";"RS";"ALVORADA";918;77;439;1434
2003;"AMARAL FERRADOR (RS)";"RS";"AMARAL FERRADOR";81;2;8;91
2003;"AMETISTA DO SUL (RS)";"RS";"AMETISTA DO SUL";37;2;12;51
2003;"ANDRE DA ROCHA (RS)";"RS";"ANDRE DA ROCHA";37;3;0;40
2003;"ANTA GORDA (RS)";"RS";"ANTA GORDA";140;8;15;163
2003;"ANTONIO PRADO (RS)";"RS";"ANTONIO PRADO";557;16;36;609
2003;"ARAMBARE (RS)";"RS";"ARAMBARE";25;2;6;33
2003;"ARARICA (RS)";"RS";"ARARICA";41;6;3;50
2003;"ARATIBA (RS)";"RS";"ARATIBA";113;17;16;146
2003;"ARROIO DO MEIO (RS)";"RS";"ARROIO DO MEIO";351;11;36;398
2003;"ARROIO DO PADRE (RS)";"RS";"ARROIO DO PADRE";52;4;8;64
2003;"ARROIO DO SAL (RS)";"RS";"ARROIO DO SAL";50;4;8;62
2003;"ARROIO DO TIGRE (RS)";"RS";"ARROIO DO TIGRE";212;13;27;252
2003;"ARROIO DOS RATOS (RS)";"RS";"ARROIO DOS RATOS";171;6;39;216
2003;"ARROIO GRANDE (RS)";"RS";"ARROIO GRANDE";176;8;25;209
2003;"ARVOREZINHA (RS)";"RS";"ARVOREZINHA";306;27;36;369
2003;"AUGUSTO PESTANA (RS)";"RS";"AUGUSTO PESTANA";283;7;18;308
2003;"AUREA (RS)";"RS";"AUREA";71;7;4;82
2003;"BAGE (RS)";"RS";"BAGE";854;68;221;1143
2003;"BALNEARIO PINHAL (RS)";"RS";"BALNEARIO PINHAL";69;5;6;80
2003;"BARAO (RS)";"RS";"BARAO";154;11;38;203
2003;"BARAO DE COTEGIPE (RS)";"RS";"BARAO DE COTEGIPE";145;8;12;165
2003;"BARAO DO TRIUNFO (RS)";"RS";"BARAO DO TRIUNFO";119;5;14;138
2003;"BARRA DO GUARITA (RS)";"RS";"BARRA DO GUARITA";13;1;3;17
2003;"BARRA DO QUARAI (RS)";"RS";"BARRA DO QUARAI";18;0;5;23
2003;"BARRA DO RIBEIRO (RS)";"RS";"BARRA DO RIBEIRO";122;8;28;158
2003;"BARRA DO RIO AZUL (RS)";"RS";"BARRA DO RIO AZUL";28;9;7;44
2003;"BARRA FUNDA (RS)";"RS";"BARRA FUNDA";105;3;9;117
2003;"BARRACAO (RS)";"RS";"BARRACAO";91;6;10;107
2003;"BARROS CASSAL (RS)";"RS";"BARROS CASSAL";118;4;26;148
2003;"BENJAMIN CONSTANT DO SUL (RS)";"RS";"BENJAMIN CONSTANT DO SUL";18;4;5;27
2003;"BENTO GONCALVES (RS)";"RS";"BENTO GONCALVES";2585;137;254;2976
2003;"BOA VISTA DAS MISSOES (RS)";"RS";"BOA VISTA DAS MISSOES";86;3;5;94
2003;"BOA VISTA DO BURICA (RS)";"RS";"BOA VISTA DO BURICA";115;5;18;138
2003;"BOA VISTA DO CADEADO (RS)";"RS";"BOA VISTA DO CADEADO";30;4;5;39
2003;"BOA VISTA DO INCRA (RS)";"RS";"BOA VISTA DO INCRA";30;1;6;37
2003;"BOA VISTA DO SUL (RS)";"RS";"BOA VISTA DO SUL";238;6;6;250
2003;"BOM JESUS (RS)";"RS";"BOM JESUS";216;8;23;247
2003;"BOM PRINCIPIO (RS)";"RS";"BOM PRINCIPIO";273;21;27;321
2003;"BOM PROGRESSO (RS)";"RS";"BOM PROGRESSO";24;3;4;31
2003;"BOM RETIRO DO SUL (RS)";"RS";"BOM RETIRO DO SUL";119;8;26;153
2003;"BOQUEIRAO DO LEAO (RS)";"RS";"BOQUEIRAO DO LEAO";121;5;18;144
2003;"BOSSOROCA (RS)";"RS";"BOSSOROCA";131;5;11;147
2003;"BOZANO (RS)";"RS";"BOZANO";83;2;5;90
2003;"BRAGA (RS)";"RS";"BRAGA";48;0;8;56
2003;"BROCHIER (RS)";"RS";"BROCHIER";169;13;15;197
2003;"BUTIA (RS)";"RS";"BUTIA";240;8;49;297
2003;"CACAPAVA DO SUL (RS)";"RS";"CACAPAVA DO SUL";440;13;64;517
2003;"CACEQUI (RS)";"RS";"CACEQUI";126;3;16;145
2003;"CACHOEIRA DO SUL (RS)";"RS";"CACHOEIRA DO SUL";873;31;176;1080
2003;"CACHOEIRINHA (RS)";"RS";"CACHOEIRINHA";1429;127;361;1917
2003;"CACIQUE DOBLE (RS)";"RS";"CACIQUE DOBLE";60;3;7;70
2003;"CAIBATE (RS)";"RS";"CAIBATE";110;4;3;117
2003;"CAICARA (RS)";"RS";"CAICARA";60;5;14;79
2003;"CAMAQUA (RS)";"RS";"CAMAQUA";1057;26;157;1240
2003;"CAMARGO (RS)";"RS";"CAMARGO";78;2;14;94
2003;"CAMBARA DO SUL (RS)";"RS";"CAMBARA DO SUL";259;11;22;292
2003;"CAMPESTRE DA SERRA (RS)";"RS";"CAMPESTRE DA SERRA";114;6;4;124
2003;"CAMPINA DAS MISSOES (RS)";"RS";"CAMPINA DAS MISSOES";98;8;17;123
2003;"CAMPINAS DO SUL (RS)";"RS";"CAMPINAS DO SUL";154;10;13;177
2003;"CAMPO BOM (RS)";"RS";"CAMPO BOM";513;74;102;689
2003;"CAMPO NOVO (RS)";"RS";"CAMPO NOVO";130;10;12;152
2003;"CAMPOS BORGES (RS)";"RS";"CAMPOS BORGES";76;4;8;88
2003;"CANDELARIA (RS)";"RS";"CANDELARIA";276;20;55;351
2003;"CANDIDO GODOI (RS)";"RS";"CANDIDO GODOI";148;13;15;176
2003;"CANDIOTA (RS)";"RS";"CANDIOTA";73;11;23;107
2003;"CANELA (RS)";"RS";"CANELA";408;52;88;548
2003;"CANGUCU (RS)";"RS";"CANGUCU";779;11;100;890
2003;"CANOAS (RS)";"RS";"CANOAS";3151;261;771;4183
2003;"CANUDOS DO VALE (RS)";"RS";"CANUDOS DO VALE";16;6;0;22
2003;"CAPAO BONITO DO SUL (RS)";"RS";"CAPAO BONITO DO SUL";16;0;0;16
2003;"CAPAO DA CANOA (RS)";"RS";"CAPAO DA CANOA";317;51;61;429
2003;"CAPAO DO CIPO (RS)";"RS";"CAPAO DO CIPO";31;3;3;37
2003;"CAPAO DO LEAO (RS)";"RS";"CAPAO DO LEAO";195;4;26;225
2003;"CAPELA DE SANTANA (RS)";"RS";"CAPELA DE SANTANA";76;3;19;98
2003;"CAPITAO (RS)";"RS";"CAPITAO";45;8;6;59
2003;"CAPIVARI DO SUL (RS)";"RS";"CAPIVARI DO SUL";78;4;7;89
2003;"CARAA (RS)";"RS";"CARAA";55;1;8;64
2003;"CARAZINHO (RS)";"RS";"CARAZINHO";1146;46;184;1376
2003;"CARLOS BARBOSA (RS)";"RS";"CARLOS BARBOSA";520;33;56;609
2003;"CARLOS GOMES (RS)";"RS";"CARLOS GOMES";24;2;5;31
2003;"CASCA (RS)";"RS";"CASCA";276;10;11;297
2003;"CASEIROS (RS)";"RS";"CASEIROS";90;3;8;101
2003;"CATUIPE (RS)";"RS";"CATUIPE";253;6;18;277
2003;"CAXIAS DO SUL (RS)";"RS";"CAXIAS DO SUL";6140;818;1002;7960
2003;"CENTENARIO (RS)";"RS";"CENTENARIO";63;5;2;70
2003;"CERRITO (RS)";"RS";"CERRITO";72;1;5;78
2003;"CERRO BRANCO (RS)";"RS";"CERRO BRANCO";58;4;13;75
2003;"CERRO GRANDE (RS)";"RS";"CERRO GRANDE";58;1;7;66
2003;"CERRO GRANDE DO SUL (RS)";"RS";"CERRO GRANDE DO SUL";188;6;12;206
2003;"CERRO LARGO (RS)";"RS";"CERRO LARGO";227;9;38;274
2003;"CHAPADA (RS)";"RS";"CHAPADA";230;30;24;284
2003;"CHARQUEADAS (RS)";"RS";"CHARQUEADAS";208;38;47;293
2003;"CHARRUA (RS)";"RS";"CHARRUA";62;2;6;70
2003;"CHIAPETTA (RS)";"RS";"CHIAPETTA";97;4;11;112
2003;"CHUI (RS)";"RS";"CHUI";146;11;13;170
2003;"CHUVISCA (RS)";"RS";"CHUVISCA";78;3;16;97
2003;"CIDREIRA (RS)";"RS";"CIDREIRA";62;10;20;92
2003;"CIRIACO (RS)";"RS";"CIRIACO";96;5;14;115
2003;"COLINAS (RS)";"RS";"COLINAS";55;5;9;69
2003;"COLORADO (RS)";"RS";"COLORADO";168;7;12;187
2003;"CONDOR (RS)";"RS";"CONDOR";162;5;18;185
2003;"CONSTANTINA (RS)";"RS";"CONSTANTINA";221;21;53;295
2003;"COQUEIRO BAIXO (RS)";"RS";"COQUEIRO BAIXO";12;6;2;20
2003;"COQUEIROS DO SUL (RS)";"RS";"COQUEIROS DO SUL";71;1;10;82
2003;"CORONEL BARROS (RS)";"RS";"CORONEL BARROS";61;1;6;68
2003;"CORONEL BICACO (RS)";"RS";"CORONEL BICACO";133;11;9;153
2003;"CORONEL PILAR (RS)";"RS";"CORONEL PILAR";116;5;3;124
2003;"COTIPORA (RS)";"RS";"COTIPORA";125;10;8;143
2003;"COXILHA (RS)";"RS";"COXILHA";87;4;7;98
2003;"CRISSIUMAL (RS)";"RS";"CRISSIUMAL";231;9;28;268
2003;"CRISTAL (RS)";"RS";"CRISTAL";143;1;15;159
2003;"CRISTAL DO SUL (RS)";"RS";"CRISTAL DO SUL";13;2;10;25
2003;"CRUZ ALTA (RS)";"RS";"CRUZ ALTA";1067;40;111;1218
2003;"CRUZALTENSE (RS)";"RS";"CRUZALTENSE";50;1;5;56
2003;"CRUZEIRO DO SUL (RS)";"RS";"CRUZEIRO DO SUL";215;4;11;230
2003;"DAVID CANABARRO (RS)";"RS";"DAVID CANABARRO";135;5;16;156
2003;"DERRUBADAS (RS)";"RS";"DERRUBADAS";57;6;0;63
2003;"DEZESSEIS DE NOVEMBRO (RS)";"RS";"DEZESSEIS DE NOVEMBRO";39;1;4;44
2003;"DILERMANDO DE AGUIAR (RS)";"RS";"DILERMANDO DE AGUIAR";17;1;16;34
2003;"DOIS IRMAOS (RS)";"RS";"DOIS IRMAOS";322;16;87;425
2003;"DOIS IRMAOS DAS MISSOES (RS)";"RS";"DOIS IRMAOS DAS MISSOES";31;1;5;37
2003;"DOIS LAJEADOS (RS)";"RS";"DOIS LAJEADOS";90;1;7;98
2003;"DOM FELICIANO (RS)";"RS";"DOM FELICIANO";174;4;48;226
2003;"DOM PEDRITO (RS)";"RS";"DOM PEDRITO";434;17;30;481
2003;"DOM PEDRO DE ALCANTARA (RS)";"RS";"DOM PEDRO DE ALCANTARA";52;3;5;60
2003;"DONA FRANCISCA (RS)";"RS";"DONA FRANCISCA";34;0;6;40
2003;"DOUTOR MAURICIO CARDOSO (RS)";"RS";"DOUTOR MAURICIO CARDOSO";140;19;18;177
2003;"DOUTOR RICARDO (RS)";"RS";"DOUTOR RICARDO";44;1;6;51
2003;"ELDORADO DO SUL (RS)";"RS";"ELDORADO DO SUL";290;11;26;327
2003;"ENCANTADO (RS)";"RS";"ENCANTADO";471;17;82;570
2003;"ENCRUZILHADA DO SUL (RS)";"RS";"ENCRUZILHADA DO SUL";240;7;64;311
2003;"ENGENHO VELHO (RS)";"RS";"ENGENHO VELHO";19;1;6;26
2003;"ENTRE IJUIS (RS)";"RS";"ENTRE IJUIS";218;8;32;258
2003;"ENTRE RIOS DO SUL (RS)";"RS";"ENTRE RIOS DO SUL";35;10;9;54
2003;"EREBANGO (RS)";"RS";"EREBANGO";86;2;3;91
2003;"ERECHIM (RS)";"RS";"ERECHIM";1365;176;593;2134
2003;"ERNESTINA (RS)";"RS";"ERNESTINA";102;6;11;119
2003;"ERVAL GRANDE (RS)";"RS";"ERVAL GRANDE";72;7;6;85
2003;"ERVAL SECO (RS)";"RS";"ERVAL SECO";112;3;17;132
2003;"ESMERALDA (RS)";"RS";"ESMERALDA";60;3;8;71
2003;"ESPERANCA DO SUL (RS)";"RS";"ESPERANCA DO SUL";35;2;4;41
2003;"ESPUMOSO (RS)";"RS";"ESPUMOSO";461;23;54;538
2003;"ESTACAO (RS)";"RS";"ESTACAO";150;4;4;158
2003;"ESTANCIA VELHA (RS)";"RS";"ESTANCIA VELHA";686;37;130;853
2003;"ESTEIO (RS)";"RS";"ESTEIO";1173;107;213;1493
2003;"ESTRELA (RS)";"RS";"ESTRELA";549;23;78;650
2003;"ESTRELA VELHA (RS)";"RS";"ESTRELA VELHA";73;3;6;82
2003;"EUGENIO DE CASTRO (RS)";"RS";"EUGENIO DE CASTRO";69;2;4;75
2003;"FAGUNDES VARELA (RS)";"RS";"FAGUNDES VARELA";71;8;8;87
2003;"FARROUPILHA (RS)";"RS";"FARROUPILHA";1700;173;145;2018
2003;"FAXINAL DO SOTURNO (RS)";"RS";"FAXINAL DO SOTURNO";103;5;4;112
2003;"FAXINALZINHO (RS)";"RS";"FAXINALZINHO";53;2;6;61
2003;"FAZENDA VILANOVA (RS)";"RS";"FAZENDA VILANOVA";90;7;10;107
2003;"FELIZ (RS)";"RS";"FELIZ";337;19;69;425
2003;"FLORES DA CUNHA (RS)";"RS";"FLORES DA CUNHA";1074;45;89;1208
2003;"FLORIANO PEIXOTO (RS)";"RS";"FLORIANO PEIXOTO";36;4;4;44
2003;"FONTOURA XAVIER (RS)";"RS";"FONTOURA XAVIER";110;7;20;137
2003;"FORMIGUEIRO (RS)";"RS";"FORMIGUEIRO";75;4;11;90
2003;"FORQUETINHA (RS)";"RS";"FORQUETINHA";31;2;1;34
2003;"FORTALEZA DOS VALOS (RS)";"RS";"FORTALEZA DOS VALOS";230;1;11;242
2003;"FREDERICO WESTPHALEN (RS)";"RS";"FREDERICO WESTPHALEN";468;23;52;543
2003;"GARIBALDI (RS)";"RS";"GARIBALDI";1067;55;76;1198
2003;"GARRUCHOS (RS)";"RS";"GARRUCHOS";20;4;9;33
2003;"GAURAMA (RS)";"RS";"GAURAMA";127;4;9;140
2003;"GENERAL CAMARA (RS)";"RS";"GENERAL CAMARA";62;6;9;77
2003;"GENTIL (RS)";"RS";"GENTIL";77;5;9;91
2003;"GETULIO VARGAS (RS)";"RS";"GETULIO VARGAS";377;14;29;420
2003;"GIRUA (RS)";"RS";"GIRUA";413;15;29;457
2003;"GLORINHA (RS)";"RS";"GLORINHA";133;11;9;153
2003;"GRAMADO (RS)";"RS";"GRAMADO";528;68;91;687
2003;"GRAMADO DOS LOUREIROS (RS)";"RS";"GRAMADO DOS LOUREIROS";20;3;8;31
2003;"GRAMADO XAVIER (RS)";"RS";"GRAMADO XAVIER";39;2;7;48
2003;"GRAVATAI (RS)";"RS";"GRAVATAI";2127;265;414;2806
2003;"GUABIJU (RS)";"RS";"GUABIJU";42;2;6;50
2003;"GUAIBA (RS)";"RS";"GUAIBA";854;80;379;1313
2003;"GUAPORE (RS)";"RS";"GUAPORE";301;31;38;370
2003;"GUARANI DAS MISSOES (RS)";"RS";"GUARANI DAS MISSOES";164;3;12;179
2003;"HARMONIA (RS)";"RS";"HARMONIA";165;5;6;176
2003;"HERVAL (RS)";"RS";"HERVAL";64;2;5;71
2003;"HERVEIRAS (RS)";"RS";"HERVEIRAS";33;3;2;38
2003;"HORIZONTINA (RS)";"RS";"HORIZONTINA";267;37;47;351
2003;"HULHA NEGRA (RS)";"RS";"HULHA NEGRA";19;2;7;28
2003;"HUMAITA (RS)";"RS";"HUMAITA";86;6;9;101
2003;"IBARAMA (RS)";"RS";"IBARAMA";70;4;12;86
2003;"IBIACA (RS)";"RS";"IBIACA";196;2;13;211
2003;"IBIRAIARAS (RS)";"RS";"IBIRAIARAS";350;5;19;374
2003;"IBIRAPUITA (RS)";"RS";"IBIRAPUITA";78;2;9;89
2003;"IBIRUBA (RS)";"RS";"IBIRUBA";696;23;43;762
2003;"IGREJINHA (RS)";"RS";"IGREJINHA";268;26;57;351
2003;"IJUI (RS)";"RS";"IJUI";1456;59;110;1625
2003;"ILOPOLIS (RS)";"RS";"ILOPOLIS";112;9;5;126
2003;"IMBE (RS)";"RS";"IMBE";128;11;29;168
2003;"IMIGRANTE (RS)";"RS";"IMIGRANTE";86;12;20;118
2003;"INDEPENDENCIA (RS)";"RS";"INDEPENDENCIA";148;16;30;194
2003;"INHACORA (RS)";"RS";"INHACORA";48;4;4;56
2003;"IPE (RS)";"RS";"IPE";183;16;19;218
2003;"IPIRANGA DO SUL (RS)";"RS";"IPIRANGA DO SUL";76;5;4;85
2003;"IRAI (RS)";"RS";"IRAI";87;14;12;113
2003;"ITAARA (RS)";"RS";"ITAARA";120;3;9;132
2003;"ITACURUBI (RS)";"RS";"ITACURUBI";23;4;6;33
2003;"ITAPUCA (RS)";"RS";"ITAPUCA";30;4;3;37
2003;"ITAQUI (RS)";"RS";"ITAQUI";516;9;41;566
2003;"ITATI (RS)";"RS";"ITATI";46;3;3;52
2003;"ITATIBA DO SUL (RS)";"RS";"ITATIBA DO SUL";57;4;5;66
2003;"IVORA (RS)";"RS";"IVORA";48;4;2;54
2003;"IVOTI (RS)";"RS";"IVOTI";422;32;93;547
2003;"JABOTICABA (RS)";"RS";"JABOTICABA";60;2;12;74
2003;"JACUIZINHO (RS)";"RS";"JACUIZINHO";26;1;2;29
2003;"JACUTINGA (RS)";"RS";"JACUTINGA";87;6;5;98
2003;"JAGUARAO (RS)";"RS";"JAGUARAO";290;9;23;322
2003;"JAGUARI (RS)";"RS";"JAGUARI";169;18;36;223
2003;"JAQUIRANA (RS)";"RS";"JAQUIRANA";116;4;6;126
2003;"JARI (RS)";"RS";"JARI";31;1;9;41
2003;"JOIA (RS)";"RS";"JOIA";241;5;24;270
2003;"JULIO DE CASTILHOS (RS)";"RS";"JULIO DE CASTILHOS";463;12;38;513
2003;"LAGOA BONITA DO SUL (RS)";"RS";"LAGOA BONITA DO SUL";21;1;13;35
2003;"LAGOA DOS TRES CANTOS (RS)";"RS";"LAGOA DOS TRES CANTOS";62;9;7;78
2003;"LAGOA VERMELHA (RS)";"RS";"LAGOA VERMELHA";485;21;64;570
2003;"LAGOAO (RS)";"RS";"LAGOAO";38;0;12;50
2003;"LAJEADO (RS)";"RS";"LAJEADO";1370;84;223;1677
2003;"LAJEADO DO BUGRE (RS)";"RS";"LAJEADO DO BUGRE";15;2;4;21
2003;"LAVRAS DO SUL (RS)";"RS";"LAVRAS DO SUL";54;5;12;71
2003;"LIBERATO SALZANO (RS)";"RS";"LIBERATO SALZANO";78;8;16;102
2003;"LINDOLFO COLLOR (RS)";"RS";"LINDOLFO COLLOR";84;5;9;98
2003;"LINHA NOVA (RS)";"RS";"LINHA NOVA";56;5;5;66
2003;"MACAMBARA (RS)";"RS";"MACAMBARA";18;0;17;35
2003;"MACHADINHO (RS)";"RS";"MACHADINHO";80;2;15;97
2003;"MAMPITUBA (RS)";"RS";"MAMPITUBA";15;0;4;19
2003;"MANOEL VIANA (RS)";"RS";"MANOEL VIANA";96;4;7;107
2003;"MAQUINE (RS)";"RS";"MAQUINE";199;12;10;221
2003;"MARATA (RS)";"RS";"MARATA";67;7;19;93
2003;"MARAU (RS)";"RS";"MARAU";690;46;111;847
2003;"MARCELINO RAMOS (RS)";"RS";"MARCELINO RAMOS";114;14;13;141
2003;"MARIANA PIMENTEL (RS)";"RS";"MARIANA PIMENTEL";84;4;11;99
2003;"MARIANO MORO (RS)";"RS";"MARIANO MORO";53;7;4;64
2003;"MARQUES DE SOUZA (RS)";"RS";"MARQUES DE SOUZA";92;8;17;117
2003;"MATA (RS)";"RS";"MATA";63;5;12;80
2003;"MATO CASTELHANO (RS)";"RS";"MATO CASTELHANO";91;2;9;102
2003;"MATO LEITAO (RS)";"RS";"MATO LEITAO";115;6;9;130
2003;"MATO QUEIMADO (RS)";"RS";"MATO QUEIMADO";25;2;4;31
2003;"MAXIMILIANO DE ALMEIDA (RS)";"RS";"MAXIMILIANO DE ALMEIDA";127;7;49;183
2003;"MINAS DO LEAO (RS)";"RS";"MINAS DO LEAO";73;4;17;94
2003;"MIRAGUAI (RS)";"RS";"MIRAGUAI";48;2;14;64
2003;"MONTAURI (RS)";"RS";"MONTAURI";36;5;3;44
2003;"MONTE ALEGRE DOS CAMPOS (RS)";"RS";"MONTE ALEGRE DOS CAMPOS";42;0;17;59
2003;"MONTE BELO DO SUL (RS)";"RS";"MONTE BELO DO SUL";153;2;10;165
2003;"MONTENEGRO (RS)";"RS";"MONTENEGRO";940;105;178;1223
2003;"MORMACO (RS)";"RS";"MORMACO";42;5;10;57
2003;"MORRINHOS DO SUL (RS)";"RS";"MORRINHOS DO SUL";110;1;4;115
2003;"MORRO REDONDO (RS)";"RS";"MORRO REDONDO";178;3;17;198
2003;"MORRO REUTER (RS)";"RS";"MORRO REUTER";117;5;27;149
2003;"MOSTARDAS (RS)";"RS";"MOSTARDAS";164;6;40;210
2003;"MUCUM (RS)";"RS";"MUCUM";95;8;19;122
2003;"MUITOS CAPOES (RS)";"RS";"MUITOS CAPOES";32;1;4;37
2003;"MULITERNO (RS)";"RS";"MULITERNO";63;2;5;70
2003;"NAO ME TOQUE (RS)";"RS";"NAO ME TOQUE";408;18;40;466
2003;"NICOLAU VERGUEIRO (RS)";"RS";"NICOLAU VERGUEIRO";66;3;7;76
2003;"NONOAI (RS)";"RS";"NONOAI";149;11;31;191
2003;"NOVA ALVORADA (RS)";"RS";"NOVA ALVORADA";91;2;6;99
2003;"NOVA ARACA (RS)";"RS";"NOVA ARACA";134;11;15;160
2003;"NOVA BASSANO (RS)";"RS";"NOVA BASSANO";302;19;20;341
2003;"NOVA BOA VISTA (RS)";"RS";"NOVA BOA VISTA";50;3;7;60
2003;"NOVA BRESCIA (RS)";"RS";"NOVA BRESCIA";81;9;5;95
2003;"NOVA CANDELARIA (RS)";"RS";"NOVA CANDELARIA";47;2;10;59
2003;"NOVA ESPERANCA DO SUL (RS)";"RS";"NOVA ESPERANCA DO SUL";38;9;21;68
2003;"NOVA HARTZ (RS)";"RS";"NOVA HARTZ";90;16;49;155
2003;"NOVA PADUA (RS)";"RS";"NOVA PADUA";218;5;4;227
2003;"NOVA PALMA (RS)";"RS";"NOVA PALMA";171;4;20;195
2003;"NOVA PETROPOLIS (RS)";"RS";"NOVA PETROPOLIS";429;35;73;537
2003;"NOVA PRATA (RS)";"RS";"NOVA PRATA";398;22;39;459
2003;"NOVA RAMADA (RS)";"RS";"NOVA RAMADA";58;1;7;66
2003;"NOVA ROMA DO SUL (RS)";"RS";"NOVA ROMA DO SUL";149;8;13;170
2003;"NOVA SANTA RITA (RS)";"RS";"NOVA SANTA RITA";316;31;27;374
2003;"NOVO BARREIRO (RS)";"RS";"NOVO BARREIRO";62;9;7;78
2003;"NOVO CABRAIS (RS)";"RS";"NOVO CABRAIS";45;2;5;52
2003;"NOVO HAMBURGO (RS)";"RS";"NOVO HAMBURGO";2098;195;436;2729
2003;"NOVO MACHADO (RS)";"RS";"NOVO MACHADO";113;16;8;137
2003;"NOVO TIRADENTES (RS)";"RS";"NOVO TIRADENTES";17;0;7;24
2003;"NOVO XINGU (RS)";"RS";"NOVO XINGU";14;4;5;23
2003;"OSORIO (RS)";"RS";"OSORIO";654;32;110;796
2003;"PAIM FILHO (RS)";"RS";"PAIM FILHO";91;4;10;105
2003;"PALMARES DO SUL (RS)";"RS";"PALMARES DO SUL";143;13;32;188
2003;"PALMEIRA DAS MISSOES (RS)";"RS";"PALMEIRA DAS MISSOES";629;12;52;693
2003;"PALMITINHO (RS)";"RS";"PALMITINHO";111;2;21;134
2003;"PANAMBI (RS)";"RS";"PANAMBI";747;24;91;862
2003;"PANTANO GRANDE (RS)";"RS";"PANTANO GRANDE";246;6;14;266
2003;"PARAI (RS)";"RS";"PARAI";210;10;22;242
2003;"PARAISO DO SUL (RS)";"RS";"PARAISO DO SUL";65;3;6;74
2003;"PARECI NOVO (RS)";"RS";"PARECI NOVO";402;5;29;436
2003;"PAROBE (RS)";"RS";"PAROBE";364;35;119;518
2003;"PASSA SETE (RS)";"RS";"PASSA SETE";38;2;14;54
2003;"PASSO DO SOBRADO (RS)";"RS";"PASSO DO SOBRADO";95;5;32;132
2003;"PASSO FUNDO (RS)";"RS";"PASSO FUNDO";2328;111;307;2746
2003;"PAULO BENTO (RS)";"RS";"PAULO BENTO";40;8;4;52
2003;"PAVERAMA (RS)";"RS";"PAVERAMA";118;15;37;170
2003;"PEDRAS ALTAS (RS)";"RS";"PEDRAS ALTAS";10;2;0;12
2003;"PEDRO OSORIO (RS)";"RS";"PEDRO OSORIO";98;4;18;120
2003;"PEJUCARA (RS)";"RS";"PEJUCARA";200;2;14;216
2003;"PELOTAS (RS)";"RS";"PELOTAS";4140;153;838;5131
2003;"PICADA CAFE (RS)";"RS";"PICADA CAFE";78;14;27;119
2003;"PINHAL (RS)";"RS";"PINHAL";38;1;7;46
2003;"PINHAL DA SERRA (RS)";"RS";"PINHAL DA SERRA";19;2;6;27
2003;"PINHAL GRANDE (RS)";"RS";"PINHAL GRANDE";71;5;11;87
2003;"PINHEIRINHO DO VALE (RS)";"RS";"PINHEIRINHO DO VALE";36;0;13;49
2003;"PINHEIRO MACHADO (RS)";"RS";"PINHEIRO MACHADO";114;6;25;145
2003;"PINTO BANDEIRA (RS)";"RS";"PINTO BANDEIRA";130;3;3;136
2003;"PIRAPO (RS)";"RS";"PIRAPO";21;1;3;25
2003;"PIRATINI (RS)";"RS";"PIRATINI";201;12;69;282
2003;"PLANALTO (RS)";"RS";"PLANALTO";148;7;28;183
2003;"POCO DAS ANTAS (RS)";"RS";"POCO DAS ANTAS";57;7;11;75
2003;"PONTAO (RS)";"RS";"PONTAO";61;0;12;73
2003;"PONTE PRETA (RS)";"RS";"PONTE PRETA";45;7;4;56
2003;"PORTAO (RS)";"RS";"PORTAO";950;59;67;1076
2003;"PORTO ALEGRE (RS)";"RS";"PORTO ALEGRE";12110;1894;3316;17320
2003;"PORTO LUCENA (RS)";"RS";"PORTO LUCENA";66;5;14;85
2003;"PORTO MAUA (RS)";"RS";"PORTO MAUA";28;6;4;38
2003;"PORTO VERA CRUZ (RS)";"RS";"PORTO VERA CRUZ";7;1;3;11
2003;"PORTO XAVIER (RS)";"RS";"PORTO XAVIER";156;5;23;184
2003;"POUSO NOVO (RS)";"RS";"POUSO NOVO";22;1;5;28
2003;"PRESIDENTE LUCENA (RS)";"RS";"PRESIDENTE LUCENA";79;4;1;84
2003;"PROGRESSO (RS)";"RS";"PROGRESSO";94;7;12;113
2003;"PROTASIO ALVES (RS)";"RS";"PROTASIO ALVES";46;0;6;52
2003;"PUTINGA (RS)";"RS";"PUTINGA";64;4;4;72
2003;"QUARAI (RS)";"RS";"QUARAI";131;6;33;170
2003;"QUATRO IRMAOS (RS)";"RS";"QUATRO IRMAOS";28;8;3;39
2003;"QUEVEDOS (RS)";"RS";"QUEVEDOS";13;0;4;17
2003;"QUINZE DE NOVEMBRO (RS)";"RS";"QUINZE DE NOVEMBRO";146;8;12;166
2003;"REDENTORA (RS)";"RS";"REDENTORA";66;4;13;83
2003;"RELVADO (RS)";"RS";"RELVADO";32;4;2;38
2003;"RESTINGA SECA (RS)";"RS";"RESTINGA SECA";213;4;39;256
2003;"RIO DOS INDIOS (RS)";"RS";"RIO DOS INDIOS";41;2;10;53
2003;"RIO GRANDE (RS)";"RS";"RIO GRANDE";1287;83;324;1694
2003;"RIO PARDO (RS)";"RS";"RIO PARDO";327;13;57;397
2003;"RIOZINHO (RS)";"RS";"RIOZINHO";36;5;25;66
2003;"ROCA SALES (RS)";"RS";"ROCA SALES";123;14;29;166
2003;"RODEIO BONITO (RS)";"RS";"RODEIO BONITO";70;3;28;101
2003;"ROLADOR (RS)";"RS";"ROLADOR";25;0;5;30
2003;"ROLANTE (RS)";"RS";"ROLANTE";160;11;42;213
2003;"RONDA ALTA (RS)";"RS";"RONDA ALTA";204;10;20;234
2003;"RONDINHA (RS)";"RS";"RONDINHA";119;10;17;146
2003;"ROQUE GONZALES (RS)";"RS";"ROQUE GONZALES";95;2;15;112
2003;"ROSARIO DO SUL (RS)";"RS";"ROSARIO DO SUL";367;15;35;417
2003;"SAGRADA FAMILIA (RS)";"RS";"SAGRADA FAMILIA";14;3;5;22
2003;"SALDANHA MARINHO (RS)";"RS";"SALDANHA MARINHO";116;6;8;130
2003;"SALTO DO JACUI (RS)";"RS";"SALTO DO JACUI";151;11;19;181
2003;"SALVADOR DAS MISSOES (RS)";"RS";"SALVADOR DAS MISSOES";66;0;5;71
2003;"SALVADOR DO SUL (RS)";"RS";"SALVADOR DO SUL";188;15;21;224
2003;"SANANDUVA (RS)";"RS";"SANANDUVA";465;8;35;508
2003;"SANTA BARBARA DO SUL (RS)";"RS";"SANTA BARBARA DO SUL";294;12;24;330
2003;"SANTA CECILIA DO SUL (RS)";"RS";"SANTA CECILIA DO SUL";26;1;8;35
2003;"SANTA CLARA DO SUL (RS)";"RS";"SANTA CLARA DO SUL";91;13;6;110
2003;"SANTA CRUZ DO SUL (RS)";"RS";"SANTA CRUZ DO SUL";1366;116;396;1878
2003;"SANTA MARGARIDA DO SUL (RS)";"RS";"SANTA MARGARIDA DO SUL";23;3;1;27
2003;"SANTA MARIA (RS)";"RS";"SANTA MARIA";2312;203;792;3307
2003;"SANTA MARIA DO HERVAL (RS)";"RS";"SANTA MARIA DO HERVAL";151;8;43;202
2003;"SANTA ROSA (RS)";"RS";"SANTA ROSA";1151;68;140;1359
2003;"SANTA TEREZA (RS)";"RS";"SANTA TEREZA";52;4;4;60
2003;"SANTA VITORIA DO PALMAR (RS)";"RS";"SANTA VITORIA DO PALMAR";436;9;63;508
2003;"SANTANA DA BOA VISTA (RS)";"RS";"SANTANA DA BOA VISTA";48;4;21;73
2003;"SANTANA DO LIVRAMENTO (RS)";"RS";"SANTANA DO LIVRAMENTO";642;31;107;780
2003;"SANTIAGO (RS)";"RS";"SANTIAGO";622;31;67;720
2003;"SANTO ANGELO (RS)";"RS";"SANTO ANGELO";896;61;86;1043
2003;"SANTO ANTONIO DA PATRULHA (RS)";"RS";"SANTO ANTONIO DA PATRULHA";598;27;124;749
2003;"SANTO ANTONIO DAS MISSOES (RS)";"RS";"SANTO ANTONIO DAS MISSOES";130;11;16;157
2003;"SANTO ANTONIO DO PALMA (RS)";"RS";"SANTO ANTONIO DO PALMA";31;2;6;39
2003;"SANTO ANTONIO DO PLANALTO (RS)";"RS";"SANTO ANTONIO DO PLANALTO";68;1;4;73
2003;"SANTO AUGUSTO (RS)";"RS";"SANTO AUGUSTO";391;18;17;426
2003;"SANTO CRISTO (RS)";"RS";"SANTO CRISTO";290;15;42;347
2003;"SANTO EXPEDITO DO SUL (RS)";"RS";"SANTO EXPEDITO DO SUL";70;3;8;81
2003;"SAO BORJA (RS)";"RS";"SAO BORJA";896;20;69;985
2003;"SAO DOMINGOS DO SUL (RS)";"RS";"SAO DOMINGOS DO SUL";64;4;3;71
2003;"SAO FRANCISCO DE ASSIS (RS)";"RS";"SAO FRANCISCO DE ASSIS";203;5;59;267
2003;"SAO FRANCISCO DE PAULA (RS)";"RS";"SAO FRANCISCO DE PAULA";397;18;36;451
2003;"SAO GABRIEL (RS)";"RS";"SAO GABRIEL";694;13;69;776
2003;"SAO JERONIMO (RS)";"RS";"SAO JERONIMO";224;12;84;320
2003;"SAO JOAO DA URTIGA (RS)";"RS";"SAO JOAO DA URTIGA";116;1;14;131
2003;"SAO JOAO DO POLESINE (RS)";"RS";"SAO JOAO DO POLESINE";49;0;5;54
2003;"SAO JORGE (RS)";"RS";"SAO JORGE";116;6;13;135
2003;"SAO JOSE DAS MISSOES (RS)";"RS";"SAO JOSE DAS MISSOES";21;1;6;28
2003;"SAO JOSE DO HERVAL (RS)";"RS";"SAO JOSE DO HERVAL";44;2;11;57
2003;"SAO JOSE DO HORTENCIO (RS)";"RS";"SAO JOSE DO HORTENCIO";171;5;35;211
2003;"SAO JOSE DO INHACORA (RS)";"RS";"SAO JOSE DO INHACORA";31;5;6;42
2003;"SAO JOSE DO NORTE (RS)";"RS";"SAO JOSE DO NORTE";240;3;27;270
2003;"SAO JOSE DO OURO (RS)";"RS";"SAO JOSE DO OURO";219;4;14;237
2003;"SAO JOSE DO SUL (RS)";"RS";"SAO JOSE DO SUL";64;8;2;74
2003;"SAO JOSE DOS AUSENTES (RS)";"RS";"SAO JOSE DOS AUSENTES";57;2;8;67
2003;"SAO LEOPOLDO (RS)";"RS";"SAO LEOPOLDO";1479;164;459;2102
2003;"SAO LOURENCO DO SUL (RS)";"RS";"SAO LOURENCO DO SUL";795;26;91;912
2003;"SAO LUIZ GONZAGA (RS)";"RS";"SAO LUIZ GONZAGA";431;32;60;523
2003;"SAO MARCOS (RS)";"RS";"SAO MARCOS";569;9;65;643
2003;"SAO MARTINHO (RS)";"RS";"SAO MARTINHO";149;4;9;162
2003;"SAO MARTINHO DA SERRA (RS)";"RS";"SAO MARTINHO DA SERRA";29;1;4;34
2003;"SAO MIGUEL DAS MISSOES (RS)";"RS";"SAO MIGUEL DAS MISSOES";157;13;29;199
2003;"SAO NICOLAU (RS)";"RS";"SAO NICOLAU";40;5;7;52
2003;"SAO PAULO DAS MISSOES (RS)";"RS";"SAO PAULO DAS MISSOES";83;3;18;104
2003;"SAO PEDRO DA SERRA (RS)";"RS";"SAO PEDRO DA SERRA";94;4;15;113
2003;"SAO PEDRO DAS MISSOES (RS)";"RS";"SAO PEDRO DAS MISSOES";18;1;4;23
2003;"SAO PEDRO DO BUTIA (RS)";"RS";"SAO PEDRO DO BUTIA";74;1;7;82
2003;"SAO PEDRO DO SUL (RS)";"RS";"SAO PEDRO DO SUL";185;16;33;234
2003;"SAO SEBASTIAO DO CAI (RS)";"RS";"SAO SEBASTIAO DO CAI";625;24;57;706
2003;"SAO SEPE (RS)";"RS";"SAO SEPE";331;2;46;379
2003;"SAO VALENTIM (RS)";"RS";"SAO VALENTIM";58;3;5;66
2003;"SAO VALENTIM DO SUL (RS)";"RS";"SAO VALENTIM DO SUL";55;4;6;65
2003;"SAO VALERIO DO SUL (RS)";"RS";"SAO VALERIO DO SUL";33;3;4;40
2003;"SAO VENDELINO (RS)";"RS";"SAO VENDELINO";71;7;2;80
2003;"SAO VICENTE DO SUL (RS)";"RS";"SAO VICENTE DO SUL";81;3;19;103
2003;"SAPIRANGA (RS)";"RS";"SAPIRANGA";868;93;160;1121
2003;"SAPUCAIA DO SUL (RS)";"RS";"SAPUCAIA DO SUL";1248;122;174;1544
2003;"SARANDI (RS)";"RS";"SARANDI";479;14;49;542
2003;"SEBERI (RS)";"RS";"SEBERI";184;6;23;213
2003;"SEDE NOVA (RS)";"RS";"SEDE NOVA";57;4;7;68
2003;"SEGREDO (RS)";"RS";"SEGREDO";75;4;18;97
2003;"SELBACH (RS)";"RS";"SELBACH";225;6;11;242
2003;"SENADOR SALGADO FILHO (RS)";"RS";"SENADOR SALGADO FILHO";73;3;10;86
2003;"SENTINELA DO SUL (RS)";"RS";"SENTINELA DO SUL";87;4;3;94
2003;"SERAFINA CORREA (RS)";"RS";"SERAFINA CORREA";207;18;30;255
2003;"SERIO (RS)";"RS";"SERIO";53;7;4;64
2003;"SERTAO (RS)";"RS";"SERTAO";190;6;18;214
2003;"SERTAO SANTANA (RS)";"RS";"SERTAO SANTANA";118;7;14;139
2003;"SETE DE SETEMBRO (RS)";"RS";"SETE DE SETEMBRO";44;0;6;50
2003;"SEVERIANO DE ALMEIDA (RS)";"RS";"SEVERIANO DE ALMEIDA";76;6;10;92
2003;"SILVEIRA MARTINS (RS)";"RS";"SILVEIRA MARTINS";97;1;5;103
2003;"SINIMBU (RS)";"RS";"SINIMBU";92;3;4;99
2003;"SOBRADINHO (RS)";"RS";"SOBRADINHO";222;11;48;281
2003;"SOLEDADE (RS)";"RS";"SOLEDADE";391;13;74;478
2003;"TABAI (RS)";"RS";"TABAI";83;7;6;96
2003;"TAPEJARA (RS)";"RS";"TAPEJARA";502;13;41;556
2003;"TAPERA (RS)";"RS";"TAPERA";318;18;28;364
2003;"TAPES (RS)";"RS";"TAPES";243;11;18;272
2003;"TAQUARA (RS)";"RS";"TAQUARA";577;46;208;831
2003;"TAQUARI (RS)";"RS";"TAQUARI";331;33;96;460
2003;"TAQUARUCU DO SUL (RS)";"RS";"TAQUARUCU DO SUL";45;2;7;54
2003;"TAVARES (RS)";"RS";"TAVARES";72;5;6;83
2003;"TENENTE PORTELA (RS)";"RS";"TENENTE PORTELA";209;6;25;240
2003;"TERRA DE AREIA (RS)";"RS";"TERRA DE AREIA";273;13;18;304
2003;"TEUTONIA (RS)";"RS";"TEUTONIA";409;29;57;495
2003;"TIO HUGO (RS)";"RS";"TIO HUGO";45;2;1;48
2003;"TIRADENTES DO SUL (RS)";"RS";"TIRADENTES DO SUL";72;4;6;82
2003;"TOROPI (RS)";"RS";"TOROPI";31;2;13;46
2003;"TORRES (RS)";"RS";"TORRES";300;22;41;363
2003;"TRAMANDAI (RS)";"RS";"TRAMANDAI";470;47;106;623
2003;"TRAVESSEIRO (RS)";"RS";"TRAVESSEIRO";30;4;4;38
2003;"TRES ARROIOS (RS)";"RS";"TRES ARROIOS";53;4;3;60
2003;"TRES CACHOEIRAS (RS)";"RS";"TRES CACHOEIRAS";516;9;8;533
2003;"TRES COROAS (RS)";"RS";"TRES COROAS";160;25;48;233
2003;"TRES DE MAIO (RS)";"RS";"TRES DE MAIO";567;49;67;683
2003;"TRES FORQUILHAS (RS)";"RS";"TRES FORQUILHAS";65;3;3;71
2003;"TRES PALMEIRAS (RS)";"RS";"TRES PALMEIRAS";53;3;9;65
2003;"TRES PASSOS (RS)";"RS";"TRES PASSOS";365;17;99;481
2003;"TRINDADE DO SUL (RS)";"RS";"TRINDADE DO SUL";79;3;12;94
2003;"TRIUNFO (RS)";"RS";"TRIUNFO";300;54;91;445
2003;"TUCUNDUVA (RS)";"RS";"TUCUNDUVA";186;8;12;206
2003;"TUNAS (RS)";"RS";"TUNAS";28;1;10;39
2003;"TUPANCI DO SUL (RS)";"RS";"TUPANCI DO SUL";47;1;7;55
2003;"TUPANCIRETA (RS)";"RS";"TUPANCIRETA";415;20;33;468
2003;"TUPANDI (RS)";"RS";"TUPANDI";53;7;21;81
2003;"TUPARENDI (RS)";"RS";"TUPARENDI";168;8;18;194
2003;"TURUCU (RS)";"RS";"TURUCU";63;3;4;70
2003;"UBIRETAMA (RS)";"RS";"UBIRETAMA";53;2;3;58
2003;"UNIAO DA SERRA (RS)";"RS";"UNIAO DA SERRA";38;2;9;49
2003;"UNISTALDA (RS)";"RS";"UNISTALDA";16;0;7;23
2003;"URUGUAIANA (RS)";"RS";"URUGUAIANA";1463;50;135;1648
2003;"VACARIA (RS)";"RS";"VACARIA";1286;69;261;1616
2003;"VALE DO SOL (RS)";"RS";"VALE DO SOL";145;6;19;170
2003;"VALE REAL (RS)";"RS";"VALE REAL";210;12;13;235
2003;"VALE VERDE (RS)";"RS";"VALE VERDE";28;2;4;34
2003;"VANINI (RS)";"RS";"VANINI";62;8;9;79
2003;"VENANCIO AIRES (RS)";"RS";"VENANCIO AIRES";862;44;153;1059
2003;"VERA CRUZ (RS)";"RS";"VERA CRUZ";259;12;62;333
2003;"VERANOPOLIS (RS)";"RS";"VERANOPOLIS";726;24;57;807
2003;"VESPASIANO CORREA (RS)";"RS";"VESPASIANO CORREA";51;3;11;65
2003;"VIADUTOS (RS)";"RS";"VIADUTOS";108;6;11;125
2003;"VIAMAO (RS)";"RS";"VIAMAO";1321;159;409;1889
2003;"VICENTE DUTRA (RS)";"RS";"VICENTE DUTRA";34;1;9;44
2003;"VICTOR GRAEFF (RS)";"RS";"VICTOR GRAEFF";131;15;4;150
2003;"VILA FLORES (RS)";"RS";"VILA FLORES";133;13;8;154
2003;"VILA LANGARO (RS)";"RS";"VILA LANGARO";63;3;9;75
2003;"VILA MARIA (RS)";"RS";"VILA MARIA";183;7;27;217
2003;"VILA NOVA DO SUL (RS)";"RS";"VILA NOVA DO SUL";59;1;8;68
2003;"VISTA ALEGRE (RS)";"RS";"VISTA ALEGRE";39;0;10;49
2003;"VISTA ALEGRE DO PRATA (RS)";"RS";"VISTA ALEGRE DO PRATA";25;5;4;34
2003;"VISTA GAUCHA (RS)";"RS";"VISTA GAUCHA";40;0;8;48
2003;"VITORIA DAS MISSOES (RS)";"RS";"VITORIA DAS MISSOES";70;3;10;83
2003;"WESTFALIA (RS)";"RS";"WESTFALIA";68;11;6;85
2003;"XANGRI LA (RS)";"RS";"XANGRI LA";96;6;3;105
2003;"ABDON BATISTA (SC)";"SC";"ABDON BATISTA";30;2;6;38
2003;"ABELARDO LUZ (SC)";"SC";"ABELARDO LUZ";282;7;35;324
2003;"AGROLANDIA (SC)";"SC";"AGROLANDIA";162;10;8;180
2003;"AGRONOMICA (SC)";"SC";"AGRONOMICA";103;1;9;113
2003;"AGUA DOCE (SC)";"SC";"AGUA DOCE";129;5;13;147
2003;"AGUAS DE CHAPECO (SC)";"SC";"AGUAS DE CHAPECO";52;4;9;65
2003;"AGUAS FRIAS (SC)";"SC";"AGUAS FRIAS";21;0;6;27
2003;"AGUAS MORNAS (SC)";"SC";"AGUAS MORNAS";171;3;6;180
2003;"ALFREDO WAGNER (SC)";"SC";"ALFREDO WAGNER";178;9;7;194
2003;"ALTO BELA VISTA (SC)";"SC";"ALTO BELA VISTA";34;3;6;43
2003;"ANCHIETA (SC)";"SC";"ANCHIETA";105;6;13;124
2003;"ANGELINA (SC)";"SC";"ANGELINA";119;8;4;131
2003;"ANITA GARIBALDI (SC)";"SC";"ANITA GARIBALDI";80;7;14;101
2003;"ANITAPOLIS (SC)";"SC";"ANITAPOLIS";62;3;6;71
2003;"ANTONIO CARLOS (SC)";"SC";"ANTONIO CARLOS";402;2;5;409
2003;"APIUNA (SC)";"SC";"APIUNA";107;8;11;126
2003;"ARABUTA (SC)";"SC";"ARABUTA";69;4;16;89
2003;"ARAQUARI (SC)";"SC";"ARAQUARI";202;4;12;218
2003;"ARARANGUA (SC)";"SC";"ARARANGUA";996;38;132;1166
2003;"ARMAZEM (SC)";"SC";"ARMAZEM";189;10;4;203
2003;"ARROIO TRINTA (SC)";"SC";"ARROIO TRINTA";109;5;5;119
2003;"ARVOREDO (SC)";"SC";"ARVOREDO";24;5;7;36
2003;"ASCURRA (SC)";"SC";"ASCURRA";155;9;20;184
2003;"ATALANTA (SC)";"SC";"ATALANTA";69;2;5;76
2003;"AURORA (SC)";"SC";"AURORA";124;3;4;131
2003;"BALNEARIO ARROIO DO SILVA (SC)";"SC";"BALNEARIO ARROIO DO SILVA";41;9;7;57
2003;"BALNEARIO CAMBORIU (SC)";"SC";"BALNEARIO CAMBORIU";649;142;138;929
2003;"BALNEARIO GAIVOTA (SC)";"SC";"BALNEARIO GAIVOTA";93;3;8;104
2003;"BANDEIRANTE (SC)";"SC";"BANDEIRANTE";13;1;12;26
2003;"BARRA BONITA (SC)";"SC";"BARRA BONITA";22;1;8;31
2003;"BARRA DO SUL (SC)";"SC";"BARRA DO SUL";53;1;1;55
2003;"BARRA VELHA (SC)";"SC";"BARRA VELHA";190;9;14;213
2003;"BELA VISTA DO TOLDO (SC)";"SC";"BELA VISTA DO TOLDO";57;1;8;66
2003;"BELMONTE (SC)";"SC";"BELMONTE";41;1;3;45
2003;"BENEDITO NOVO (SC)";"SC";"BENEDITO NOVO";206;16;12;234
2003;"BIGUACU (SC)";"SC";"BIGUACU";583;29;168;780
2003;"BLUMENAU (SC)";"SC";"BLUMENAU";3484;281;801;4566
2003;"BOCAINA DO SUL (SC)";"SC";"BOCAINA DO SUL";32;5;11;48
2003;"BOM JARDIM DA SERRA (SC)";"SC";"BOM JARDIM DA SERRA";59;0;10;69
2003;"BOM JESUS (SC)";"SC";"BOM JESUS";46;0;6;52
2003;"BOM JESUS DO OESTE (SC)";"SC";"BOM JESUS DO OESTE";27;1;7;35
2003;"BOM RETIRO (SC)";"SC";"BOM RETIRO";121;10;12;143
2003;"BOMBINHAS (SC)";"SC";"BOMBINHAS";60;9;11;80
2003;"BOTUVERA (SC)";"SC";"BOTUVERA";135;1;7;143
2003;"BRACO DO NORTE (SC)";"SC";"BRACO DO NORTE";677;29;42;748
2003;"BRACO DO TROMBUDO (SC)";"SC";"BRACO DO TROMBUDO";90;3;5;98
2003;"BRUNOPOLIS (SC)";"SC";"BRUNOPOLIS";38;2;6;46
2003;"BRUSQUE (SC)";"SC";"BRUSQUE";1363;67;135;1565
2003;"CACADOR (SC)";"SC";"CACADOR";1592;76;707;2375
2003;"CAIBI (SC)";"SC";"CAIBI";110;4;15;129
2003;"CALMON (SC)";"SC";"CALMON";28;2;15;45
2003;"CAMBORIU (SC)";"SC";"CAMBORIU";562;22;27;611
2003;"CAMPO ALEGRE (SC)";"SC";"CAMPO ALEGRE";274;8;5;287
2003;"CAMPO BELO DO SUL (SC)";"SC";"CAMPO BELO DO SUL";137;5;10;152
2003;"CAMPO ERE (SC)";"SC";"CAMPO ERE";183;8;23;214
2003;"CAMPOS NOVOS (SC)";"SC";"CAMPOS NOVOS";721;23;90;834
2003;"CANELINHA (SC)";"SC";"CANELINHA";351;4;6;361
2003;"CANOINHAS (SC)";"SC";"CANOINHAS";932;30;91;1053
2003;"CAPAO ALTO (SC)";"SC";"CAPAO ALTO";26;2;4;32
2003;"CAPINZAL (SC)";"SC";"CAPINZAL";331;19;21;371
2003;"CAPIVARI DE BAIXO (SC)";"SC";"CAPIVARI DE BAIXO";204;8;24;236
2003;"CATANDUVAS (SC)";"SC";"CATANDUVAS";237;9;18;264
2003;"CAXAMBU DO SUL (SC)";"SC";"CAXAMBU DO SUL";56;1;10;67
2003;"CELSO RAMOS (SC)";"SC";"CELSO RAMOS";33;2;2;37
2003;"CERRO NEGRO (SC)";"SC";"CERRO NEGRO";17;1;10;28
2003;"CHAPADAO DO LAGEADO (SC)";"SC";"CHAPADAO DO LAGEADO";28;1;3;32
2003;"CHAPECO (SC)";"SC";"CHAPECO";2488;112;213;2813
2003;"COCAL DO SUL (SC)";"SC";"COCAL DO SUL";181;9;8;198
2003;"CONCORDIA (SC)";"SC";"CONCORDIA";1384;77;139;1600
2003;"CORDILHEIRA ALTA (SC)";"SC";"CORDILHEIRA ALTA";147;7;4;158
2003;"CORONEL FREITAS (SC)";"SC";"CORONEL FREITAS";201;4;22;227
2003;"CORONEL MARTINS (SC)";"SC";"CORONEL MARTINS";26;3;3;32
2003;"CORREIA PINTO (SC)";"SC";"CORREIA PINTO";260;12;35;307
2003;"CORUPA (SC)";"SC";"CORUPA";298;8;25;331
2003;"CRICIUMA (SC)";"SC";"CRICIUMA";2745;224;303;3272
2003;"CUNHA PORA (SC)";"SC";"CUNHA PORA";244;12;35;291
2003;"CUNHATAI (SC)";"SC";"CUNHATAI";16;1;5;22
2003;"CURITIBANOS (SC)";"SC";"CURITIBANOS";814;17;69;900
2003;"DESCANSO (SC)";"SC";"DESCANSO";169;6;19;194
2003;"DIONISIO CERQUEIRA (SC)";"SC";"DIONISIO CERQUEIRA";89;5;17;111
2003;"DONA EMMA (SC)";"SC";"DONA EMMA";59;2;5;66
2003;"DOUTOR PEDRINHO (SC)";"SC";"DOUTOR PEDRINHO";81;6;9;96
2003;"ENTRE RIOS (SC)";"SC";"ENTRE RIOS";26;1;5;32
2003;"ERMO (SC)";"SC";"ERMO";50;0;3;53
2003;"ERVAL VELHO (SC)";"SC";"ERVAL VELHO";80;7;12;99
2003;"FAXINAL DOS GUEDES (SC)";"SC";"FAXINAL DOS GUEDES";261;6;19;286
2003;"FLOR DO SERTAO (SC)";"SC";"FLOR DO SERTAO";15;3;5;23
2003;"FLORIANOPOLIS (SC)";"SC";"FLORIANOPOLIS";3015;837;1059;4911
2003;"FORMOSA DO SUL (SC)";"SC";"FORMOSA DO SUL";49;3;11;63
2003;"FORQUILHINHA (SC)";"SC";"FORQUILHINHA";368;7;22;397
2003;"FRAIBURGO (SC)";"SC";"FRAIBURGO";646;35;144;825
2003;"FREI ROGERIO (SC)";"SC";"FREI ROGERIO";52;0;13;65
2003;"GALVAO (SC)";"SC";"GALVAO";67;3;5;75
2003;"GAROPABA (SC)";"SC";"GAROPABA";135;16;28;179
2003;"GARUVA (SC)";"SC";"GARUVA";223;12;11;246
2003;"GASPAR (SC)";"SC";"GASPAR";855;42;57;954
2003;"GOVERNADOR CELSO RAMOS (SC)";"SC";"GOVERNADOR CELSO RAMOS";91;13;8;112
2003;"GRAO PARA (SC)";"SC";"GRAO PARA";164;3;9;176
2003;"GRAVATAL (SC)";"SC";"GRAVATAL";159;8;10;177
2003;"GUABIRUBA (SC)";"SC";"GUABIRUBA";188;7;8;203
2003;"GUARACIABA (SC)";"SC";"GUARACIABA";151;4;25;180
2003;"GUARAMIRIM (SC)";"SC";"GUARAMIRIM";657;16;13;686
2003;"GUARUJA DO SUL (SC)";"SC";"GUARUJA DO SUL";124;6;9;139
2003;"GUATAMBU (SC)";"SC";"GUATAMBU";46;1;18;65
2003;"HERVAL D OESTE (SC)";"SC";"HERVAL D OESTE";225;24;46;295
2003;"IBIAM (SC)";"SC";"IBIAM";40;3;6;49
2003;"IBICARE (SC)";"SC";"IBICARE";84;2;4;90
2003;"IBIRAMA (SC)";"SC";"IBIRAMA";247;19;43;309
2003;"ICARA (SC)";"SC";"ICARA";901;32;83;1016
2003;"ILHOTA (SC)";"SC";"ILHOTA";196;9;12;217
2003;"IMARUI (SC)";"SC";"IMARUI";69;8;17;94
2003;"IMBITUBA (SC)";"SC";"IMBITUBA";403;44;51;498
2003;"IMBUIA (SC)";"SC";"IMBUIA";124;3;11;138
2003;"INDAIAL (SC)";"SC";"INDAIAL";787;32;60;879
2003;"IOMERE (SC)";"SC";"IOMERE";104;5;4;113
2003;"IPIRA (SC)";"SC";"IPIRA";61;7;11;79
2003;"IPORA DO OESTE (SC)";"SC";"IPORA DO OESTE";142;3;23;168
2003;"IPUACU (SC)";"SC";"IPUACU";61;3;17;81
2003;"IPUMIRIM (SC)";"SC";"IPUMIRIM";166;2;9;177
2003;"IRACEMINHA (SC)";"SC";"IRACEMINHA";65;4;16;85
2003;"IRANI (SC)";"SC";"IRANI";167;7;35;209
2003;"IRATI (SC)";"SC";"IRATI";22;2;3;27
2003;"IRINEOPOLIS (SC)";"SC";"IRINEOPOLIS";172;1;11;184
2003;"ITA (SC)";"SC";"ITA";67;11;17;95
2003;"ITAIOPOLIS (SC)";"SC";"ITAIOPOLIS";361;9;40;410
2003;"ITAJAI (SC)";"SC";"ITAJAI";2676;235;248;3159
2003;"ITAPEMA (SC)";"SC";"ITAPEMA";270;32;31;333
2003;"ITAPIRANGA (SC)";"SC";"ITAPIRANGA";180;13;40;233
2003;"ITAPOA (SC)";"SC";"ITAPOA";83;6;4;93
2003;"ITUPORANGA (SC)";"SC";"ITUPORANGA";455;11;32;498
2003;"JABORA (SC)";"SC";"JABORA";88;5;12;105
2003;"JACINTO MACHADO (SC)";"SC";"JACINTO MACHADO";304;2;17;323
2003;"JAGUARUNA (SC)";"SC";"JAGUARUNA";347;8;18;373
2003;"JARAGUA DO SUL (SC)";"SC";"JARAGUA DO SUL";1713;154;221;2088
2003;"JARDINOPOLIS (SC)";"SC";"JARDINOPOLIS";20;1;3;24
2003;"JOACABA (SC)";"SC";"JOACABA";584;38;26;648
2003;"JOINVILLE (SC)";"SC";"JOINVILLE";5749;525;685;6959
2003;"JOSE BOITEUX (SC)";"SC";"JOSE BOITEUX";65;5;7;77
2003;"JUPIA (SC)";"SC";"JUPIA";31;2;4;37
2003;"LACERDOPOLIS (SC)";"SC";"LACERDOPOLIS";87;3;5;95
2003;"LAGEADO GRANDE (SC)";"SC";"LAGEADO GRANDE";32;2;5;39
2003;"LAGES (SC)";"SC";"LAGES";2722;129;226;3077
2003;"LAGUNA (SC)";"SC";"LAGUNA";342;30;65;437
2003;"LAURENTINO (SC)";"SC";"LAURENTINO";199;4;5;208
2003;"LAURO MULLER (SC)";"SC";"LAURO MULLER";246;10;23;279
2003;"LEBON REGIS (SC)";"SC";"LEBON REGIS";151;3;27;181
2003;"LEOBERTO LEAL (SC)";"SC";"LEOBERTO LEAL";84;3;5;92
2003;"LINDOIA DO SUL (SC)";"SC";"LINDOIA DO SUL";92;9;33;134
2003;"LONTRAS (SC)";"SC";"LONTRAS";183;8;7;198
2003;"LUIZ ALVES (SC)";"SC";"LUIZ ALVES";273;3;10;286
2003;"LUZERNA (SC)";"SC";"LUZERNA";69;5;15;89
2003;"MACIEIRA (SC)";"SC";"MACIEIRA";40;1;10;51
2003;"MAFRA (SC)";"SC";"MAFRA";917;37;88;1042
2003;"MAJOR GERCINO (SC)";"SC";"MAJOR GERCINO";77;4;3;84
2003;"MAJOR VIEIRA (SC)";"SC";"MAJOR VIEIRA";114;4;8;126
2003;"MARACAJA (SC)";"SC";"MARACAJA";154;2;5;161
2003;"MARAVILHA (SC)";"SC";"MARAVILHA";391;19;43;453
2003;"MAREMA (SC)";"SC";"MAREMA";48;6;4;58
2003;"MASSARANDUBA (SC)";"SC";"MASSARANDUBA";328;9;22;359
2003;"MATOS COSTA (SC)";"SC";"MATOS COSTA";25;1;7;33
2003;"MELEIRO (SC)";"SC";"MELEIRO";151;3;11;165
2003;"MIRIM DOCE (SC)";"SC";"MIRIM DOCE";39;2;5;46
2003;"MODELO (SC)";"SC";"MODELO";63;3;7;73
2003;"MONDAI (SC)";"SC";"MONDAI";124;2;27;153
2003;"MONTE CARLO (SC)";"SC";"MONTE CARLO";168;4;40;212
2003;"MONTE CASTELO (SC)";"SC";"MONTE CASTELO";129;6;11;146
2003;"MORRO DA FUMACA (SC)";"SC";"MORRO DA FUMACA";587;25;23;635
2003;"MORRO GRANDE (SC)";"SC";"MORRO GRANDE";69;0;4;73
2003;"NAVEGANTES (SC)";"SC";"NAVEGANTES";374;30;24;428
2003;"NOVA ERECHIM (SC)";"SC";"NOVA ERECHIM";61;0;9;70
2003;"NOVA ITABERABA (SC)";"SC";"NOVA ITABERABA";42;2;10;54
2003;"NOVA TRENTO (SC)";"SC";"NOVA TRENTO";156;9;23;188
2003;"NOVA VENEZA (SC)";"SC";"NOVA VENEZA";306;15;12;333
2003;"NOVO HORIZONTE (SC)";"SC";"NOVO HORIZONTE";47;3;9;59
2003;"ORLEANS (SC)";"SC";"ORLEANS";642;5;41;688
2003;"OTACILIO COSTA (SC)";"SC";"OTACILIO COSTA";288;20;19;327
2003;"OURO (SC)";"SC";"OURO";163;10;16;189
2003;"OURO VERDE (SC)";"SC";"OURO VERDE";63;2;4;69
2003;"PAIAL (SC)";"SC";"PAIAL";10;3;7;20
2003;"PAINEL (SC)";"SC";"PAINEL";22;2;6;30
2003;"PALHOCA (SC)";"SC";"PALHOCA";1219;72;177;1468
2003;"PALMA SOLA (SC)";"SC";"PALMA SOLA";138;4;20;162
2003;"PALMEIRA (SC)";"SC";"PALMEIRA";32;3;1;36
2003;"PALMITOS (SC)";"SC";"PALMITOS";240;8;41;289
2003;"PAPANDUVA (SC)";"SC";"PAPANDUVA";359;6;37;402
2003;"PARAISO (SC)";"SC";"PARAISO";48;0;1;49
2003;"PASSO DE TORRES (SC)";"SC";"PASSO DE TORRES";81;3;9;93
2003;"PASSOS MAIA (SC)";"SC";"PASSOS MAIA";72;0;14;86
2003;"PAULO LOPES (SC)";"SC";"PAULO LOPES";136;7;9;152
2003;"PEDRAS GRANDES (SC)";"SC";"PEDRAS GRANDES";185;7;4;196
2003;"PENHA (SC)";"SC";"PENHA";188;5;27;220
2003;"PERITIBA (SC)";"SC";"PERITIBA";60;3;10;73
2003;"PETROLANDIA (SC)";"SC";"PETROLANDIA";134;2;17;153
2003;"PICARRAS (SC)";"SC";"PICARRAS";159;12;11;182
2003;"PINHALZINHO (SC)";"SC";"PINHALZINHO";291;6;33;330
2003;"PINHEIRO PRETO (SC)";"SC";"PINHEIRO PRETO";197;6;4;207
2003;"PIRATUBA (SC)";"SC";"PIRATUBA";57;7;13;77
2003;"PLANALTO ALEGRE (SC)";"SC";"PLANALTO ALEGRE";44;2;3;49
2003;"POMERODE (SC)";"SC";"POMERODE";390;19;83;492
2003;"PONTE ALTA (SC)";"SC";"PONTE ALTA";91;4;7;102
2003;"PONTE ALTA DO NORTE (SC)";"SC";"PONTE ALTA DO NORTE";50;2;5;57
2003;"PONTE SERRADA (SC)";"SC";"PONTE SERRADA";206;12;30;248
2003;"PORTO BELO (SC)";"SC";"PORTO BELO";119;9;13;141
2003;"PORTO UNIAO (SC)";"SC";"PORTO UNIAO";422;11;29;462
2003;"POUSO REDONDO (SC)";"SC";"POUSO REDONDO";278;7;19;304
2003;"PRAIA GRANDE (SC)";"SC";"PRAIA GRANDE";159;5;21;185
2003;"PRESIDENTE CASTELO BRANCO (SC)";"SC";"PRESIDENTE CASTELO BRANCO";35;1;6;42
2003;"PRESIDENTE GETULIO (SC)";"SC";"PRESIDENTE GETULIO";195;12;47;254
2003;"PRESIDENTE NEREU (SC)";"SC";"PRESIDENTE NEREU";17;3;4;24
2003;"PRINCESA (SC)";"SC";"PRINCESA";28;1;6;35
2003;"QUILOMBO (SC)";"SC";"QUILOMBO";140;6;22;168
2003;"RANCHO QUEIMADO (SC)";"SC";"RANCHO QUEIMADO";102;6;3;111
2003;"RIO DAS ANTAS (SC)";"SC";"RIO DAS ANTAS";150;6;17;173
2003;"RIO DO CAMPO (SC)";"SC";"RIO DO CAMPO";112;5;14;131
2003;"RIO DO OESTE (SC)";"SC";"RIO DO OESTE";136;10;13;159
2003;"RIO DO SUL (SC)";"SC";"RIO DO SUL";1046;49;105;1200
2003;"RIO DOS CEDROS (SC)";"SC";"RIO DOS CEDROS";172;9;23;204
2003;"RIO FORTUNA (SC)";"SC";"RIO FORTUNA";165;5;9;179
2003;"RIO NEGRINHO (SC)";"SC";"RIO NEGRINHO";703;41;45;789
2003;"RIO RUFINO (SC)";"SC";"RIO RUFINO";22;2;6;30
2003;"RIQUEZA (SC)";"SC";"RIQUEZA";63;0;14;77
2003;"RODEIO (SC)";"SC";"RODEIO";141;4;12;157
2003;"ROMELANDIA (SC)";"SC";"ROMELANDIA";64;1;10;75
2003;"SALETE (SC)";"SC";"SALETE";124;4;12;140
2003;"SALTINHO (SC)";"SC";"SALTINHO";34;1;12;47
2003;"SALTO VELOSO (SC)";"SC";"SALTO VELOSO";86;4;3;93
2003;"SANGAO (SC)";"SC";"SANGAO";287;6;9;302
2003;"SANTA CECILIA (SC)";"SC";"SANTA CECILIA";296;14;22;332
2003;"SANTA HELENA (SC)";"SC";"SANTA HELENA";38;5;5;48
2003;"SANTA ROSA DE LIMA (SC)";"SC";"SANTA ROSA DE LIMA";66;1;5;72
2003;"SANTA ROSA DO SUL (SC)";"SC";"SANTA ROSA DO SUL";192;8;10;210
2003;"SANTA TEREZINHA (SC)";"SC";"SANTA TEREZINHA";94;3;16;113
2003;"SANTA TEREZINHA DO PROGRESSO (SC)";"SC";"SANTA TEREZINHA DO PROGRESSO";36;3;8;47
2003;"SANTIAGO DO SUL (SC)";"SC";"SANTIAGO DO SUL";24;0;3;27
2003;"SANTO AMARO DA IMPERATRIZ (SC)";"SC";"SANTO AMARO DA IMPERATRIZ";386;19;62;467
2003;"SAO BENTO DO SUL (SC)";"SC";"SAO BENTO DO SUL";1016;79;124;1219
2003;"SAO BERNARDINO (SC)";"SC";"SAO BERNARDINO";28;0;13;41
2003;"SAO BONIFACIO (SC)";"SC";"SAO BONIFACIO";87;2;8;97
2003;"SAO CARLOS (SC)";"SC";"SAO CARLOS";127;7;33;167
2003;"SAO CRISTOVAO DO SUL (SC)";"SC";"SAO CRISTOVAO DO SUL";95;1;7;103
2003;"SAO DOMINGOS (SC)";"SC";"SAO DOMINGOS";234;7;25;266
2003;"SAO FRANCISCO DO SUL (SC)";"SC";"SAO FRANCISCO DO SUL";362;26;54;442
2003;"SAO JOAO BATISTA (SC)";"SC";"SAO JOAO BATISTA";317;9;14;340
2003;"SAO JOAO DO ITAPERIU (SC)";"SC";"SAO JOAO DO ITAPERIU";124;0;4;128
2003;"SAO JOAO DO OESTE (SC)";"SC";"SAO JOAO DO OESTE";95;2;7;104
2003;"SAO JOAO DO SUL (SC)";"SC";"SAO JOAO DO SUL";151;5;6;162
2003;"SAO JOAQUIM (SC)";"SC";"SAO JOAQUIM";584;24;125;733
2003;"SAO JOSE (SC)";"SC";"SAO JOSE";2737;197;144;3078
2003;"SAO JOSE DO CEDRO (SC)";"SC";"SAO JOSE DO CEDRO";267;7;105;379
2003;"SAO JOSE DO CERRITO (SC)";"SC";"SAO JOSE DO CERRITO";86;0;22;108
2003;"SAO LOURENCO D OESTE (SC)";"SC";"SAO LOURENCO D OESTE";564;16;42;622
2003;"SAO LUDGERO (SC)";"SC";"SAO LUDGERO";400;5;15;420
2003;"SAO MARTINHO (SC)";"SC";"SAO MARTINHO";89;6;6;101
2003;"SAO MIGUEL D OESTE (SC)";"SC";"SAO MIGUEL D OESTE";672;19;80;771
2003;"SAO MIGUEL DA BOA VISTA (SC)";"SC";"SAO MIGUEL DA BOA VISTA";13;2;5;20
2003;"SAO PEDRO DE ALCANTARA (SC)";"SC";"SAO PEDRO DE ALCANTARA";90;3;3;96
2003;"SAUDADES (SC)";"SC";"SAUDADES";108;6;24;138
2003;"SCHROEDER (SC)";"SC";"SCHROEDER";130;4;18;152
2003;"SEARA (SC)";"SC";"SEARA";262;8;48;318
2003;"SERRA ALTA (SC)";"SC";"SERRA ALTA";44;4;7;55
2003;"SIDEROPOLIS (SC)";"SC";"SIDEROPOLIS";286;11;43;340
2003;"SOMBRIO (SC)";"SC";"SOMBRIO";596;16;25;637
2003;"SUL BRASIL (SC)";"SC";"SUL BRASIL";25;1;9;35
2003;"TAIO (SC)";"SC";"TAIO";368;10;24;402
2003;"TANGARA (SC)";"SC";"TANGARA";284;3;24;311
2003;"TIGRINHOS (SC)";"SC";"TIGRINHOS";15;1;11;27
2003;"TIJUCAS (SC)";"SC";"TIJUCAS";545;25;33;603
2003;"TIMBE DO SUL (SC)";"SC";"TIMBE DO SUL";131;1;6;138
2003;"TIMBO (SC)";"SC";"TIMBO";488;36;30;554
2003;"TIMBO GRANDE (SC)";"SC";"TIMBO GRANDE";99;1;8;108
2003;"TRES BARRAS (SC)";"SC";"TRES BARRAS";201;6;33;240
2003;"TREVISO (SC)";"SC";"TREVISO";54;2;4;60
2003;"TREZE DE MAIO (SC)";"SC";"TREZE DE MAIO";321;5;12;338
2003;"TREZE TILIAS (SC)";"SC";"TREZE TILIAS";177;8;13;198
2003;"TROMBUDO CENTRAL (SC)";"SC";"TROMBUDO CENTRAL";171;4;5;180
2003;"TUBARAO (SC)";"SC";"TUBARAO";1797;81;337;2215
2003;"TUNAPOLIS (SC)";"SC";"TUNAPOLIS";58;4;11;73
2003;"TURVO (SC)";"SC";"TURVO";258;7;26;291
2003;"UNIAO DO OESTE (SC)";"SC";"UNIAO DO OESTE";49;0;7;56
2003;"URUBICI (SC)";"SC";"URUBICI";167;7;21;195
2003;"URUPEMA (SC)";"SC";"URUPEMA";37;3;6;46
2003;"URUSSANGA (SC)";"SC";"URUSSANGA";283;24;77;384
2003;"VARGEAO (SC)";"SC";"VARGEAO";103;1;6;110
2003;"VARGEM (SC)";"SC";"VARGEM";33;3;6;42
2003;"VARGEM BONITA (SC)";"SC";"VARGEM BONITA";113;13;18;144
2003;"VIDAL RAMOS (SC)";"SC";"VIDAL RAMOS";101;4;7;112
2003;"VIDEIRA (SC)";"SC";"VIDEIRA";1089;63;96;1248
2003;"VITOR MEIRELES (SC)";"SC";"VITOR MEIRELES";57;7;9;73
2003;"WITMARSUM (SC)";"SC";"WITMARSUM";59;1;5;65
2003;"XANXERE (SC)";"SC";"XANXERE";866;48;78;992
2003;"XAVANTINA (SC)";"SC";"XAVANTINA";102;10;5;117
2003;"XAXIM (SC)";"SC";"XAXIM";504;13;78;595
2003;"ZORTEA (SC)";"SC";"ZORTEA";25;4;2;31
2003;"AMPARO DE SAO FRANCISCO (SE)";"SE";"AMPARO DE SAO FRANCISCO";1;0;1;2
2003;"AQUIDABA (SE)";"SE";"AQUIDABA";48;3;12;63
2003;"ARACAJU (SE)";"SE";"ARACAJU";7655;986;2026;10667
2003;"ARAUA (SE)";"SE";"ARAUA";26;3;6;35
2003;"AREIA BRANCA (SE)";"SE";"AREIA BRANCA";40;3;3;46
2003;"BARRA DOS COQUEIROS (SE)";"SE";"BARRA DOS COQUEIROS";16;2;2;20
2003;"BOQUIM (SE)";"SE";"BOQUIM";85;5;7;97
2003;"BREJO GRANDE (SE)";"SE";"BREJO GRANDE";3;2;3;8
2003;"CAMPO DO BRITO (SE)";"SE";"CAMPO DO BRITO";115;7;10;132
2003;"CANHOBA (SE)";"SE";"CANHOBA";1;1;1;3
2003;"CANINDE DE SAO FRANCISCO (SE)";"SE";"CANINDE DE SAO FRANCISCO";45;7;3;55
2003;"CAPELA (SE)";"SE";"CAPELA";20;7;6;33
2003;"CARIRA (SE)";"SE";"CARIRA";85;24;16;125
2003;"CARMOPOLIS (SE)";"SE";"CARMOPOLIS";20;4;6;30
2003;"CEDRO DE SAO JOAO (SE)";"SE";"CEDRO DE SAO JOAO";10;1;1;12
2003;"CRISTINAPOLIS (SE)";"SE";"CRISTINAPOLIS";27;14;6;47
2003;"CUMBE (SE)";"SE";"CUMBE";7;0;0;7
2003;"DIVINA PASTORA (SE)";"SE";"DIVINA PASTORA";1;0;3;4
2003;"ESTANCIA (SE)";"SE";"ESTANCIA";138;46;30;214
2003;"FEIRA NOVA (SE)";"SE";"FEIRA NOVA";7;3;1;11
2003;"FREI PAULO (SE)";"SE";"FREI PAULO";26;15;4;45
2003;"GARARU (SE)";"SE";"GARARU";10;2;4;16
2003;"GENERAL MAYNARD (SE)";"SE";"GENERAL MAYNARD";1;6;6;13
2003;"GRACCHO CARDOSO (SE)";"SE";"GRACCHO CARDOSO";5;0;1;6
2003;"ILHA DAS FLORES (SE)";"SE";"ILHA DAS FLORES";5;3;2;10
2003;"INDIAROBA (SE)";"SE";"INDIAROBA";7;5;1;13
2003;"ITABAIANA (SE)";"SE";"ITABAIANA";1045;82;33;1160
2003;"ITABAIANINHA (SE)";"SE";"ITABAIANINHA";129;15;16;160
2003;"ITABI (SE)";"SE";"ITABI";9;1;2;12
2003;"ITAPORANGA D AJUDA (SE)";"SE";"ITAPORANGA D AJUDA";31;4;7;42
2003;"JAPARATUBA (SE)";"SE";"JAPARATUBA";21;4;10;35
2003;"JAPOATA (SE)";"SE";"JAPOATA";11;2;7;20
2003;"LAGARTO (SE)";"SE";"LAGARTO";366;31;51;448
2003;"LARANJEIRAS (SE)";"SE";"LARANJEIRAS";29;2;5;36
2003;"MACAMBIRA (SE)";"SE";"MACAMBIRA";13;11;1;25
2003;"MALHADA DOS BOIS (SE)";"SE";"MALHADA DOS BOIS";10;2;1;13
2003;"MALHADOR (SE)";"SE";"MALHADOR";54;12;8;74
2003;"MARUIM (SE)";"SE";"MARUIM";11;9;8;28
2003;"MOITA BONITA (SE)";"SE";"MOITA BONITA";153;13;4;170
2003;"MONTE ALEGRE DE SERGIPE (SE)";"SE";"MONTE ALEGRE DE SERGIPE";39;8;4;51
2003;"MURIBECA (SE)";"SE";"MURIBECA";6;4;3;13
2003;"NEOPOLIS (SE)";"SE";"NEOPOLIS";11;5;1;17
2003;"NOSSA SENHORA APARECIDA (SE)";"SE";"NOSSA SENHORA APARECIDA";50;6;2;58
2003;"NOSSA SENHORA DA GLORIA (SE)";"SE";"NOSSA SENHORA DA GLORIA";133;6;26;165
2003;"NOSSA SENHORA DAS DORES (SE)";"SE";"NOSSA SENHORA DAS DORES";54;11;13;78
2003;"NOSSA SENHORA DE LOURDES (SE)";"SE";"NOSSA SENHORA DE LOURDES";9;0;0;9
2003;"NOSSA SENHORA DO SOCORRO (SE)";"SE";"NOSSA SENHORA DO SOCORRO";253;17;33;303
2003;"PACATUBA (SE)";"SE";"PACATUBA";1;2;4;7
2003;"PEDRA MOLE (SE)";"SE";"PEDRA MOLE";2;1;0;3
2003;"PEDRINHAS (SE)";"SE";"PEDRINHAS";28;5;1;34
2003;"PINHAO (SE)";"SE";"PINHAO";6;9;1;16
2003;"PIRAMBU (SE)";"SE";"PIRAMBU";5;6;5;16
2003;"POCO REDONDO (SE)";"SE";"POCO REDONDO";35;3;11;49
2003;"POCO VERDE (SE)";"SE";"POCO VERDE";23;5;18;46
2003;"PORTO DA FOLHA (SE)";"SE";"PORTO DA FOLHA";31;4;9;44
2003;"PROPRIA (SE)";"SE";"PROPRIA";81;7;20;108
2003;"RIACHAO DO DANTAS (SE)";"SE";"RIACHAO DO DANTAS";7;0;4;11
2003;"RIACHUELO (SE)";"SE";"RIACHUELO";8;0;4;12
2003;"RIBEIROPOLIS (SE)";"SE";"RIBEIROPOLIS";119;30;6;155
2003;"ROSARIO DO CATETE (SE)";"SE";"ROSARIO DO CATETE";14;12;5;31
2003;"SALGADO (SE)";"SE";"SALGADO";40;4;13;57
2003;"SANTA LUZIA DO ITANHY (SE)";"SE";"SANTA LUZIA DO ITANHY";5;0;3;8
2003;"SANTA ROSA DE LIMA (SE)";"SE";"SANTA ROSA DE LIMA";3;1;2;6
2003;"SANTANA DO SAO FRANCISCO (SE)";"SE";"SANTANA DO SAO FRANCISCO";0;0;0;0
2003;"SANTO AMARO DAS BROTAS (SE)";"SE";"SANTO AMARO DAS BROTAS";7;1;2;10
2003;"SAO CRISTOVAO (SE)";"SE";"SAO CRISTOVAO";98;20;15;133
2003;"SAO DOMINGOS (SE)";"SE";"SAO DOMINGOS";35;2;3;40
2003;"SAO FRANCISCO (SE)";"SE";"SAO FRANCISCO";2;0;1;3
2003;"SAO MIGUEL DO ALEIXO (SE)";"SE";"SAO MIGUEL DO ALEIXO";3;2;1;6
2003;"SIMAO DIAS (SE)";"SE";"SIMAO DIAS";73;16;57;146
2003;"SIRIRI (SE)";"SE";"SIRIRI";11;0;3;14
2003;"TELHA (SE)";"SE";"TELHA";3;0;0;3
2003;"TOBIAS BARRETO (SE)";"SE";"TOBIAS BARRETO";78;20;19;117
2003;"TOMAR DO GERU (SE)";"SE";"TOMAR DO GERU";13;4;1;18
2003;"UMBAUBA (SE)";"SE";"UMBAUBA";89;26;13;128
2003;"ADAMANTINA (SP)";"SP";"ADAMANTINA";612;40;102;754
2003;"ADOLFO (SP)";"SP";"ADOLFO";60;2;18;80
2003;"AGUAI (SP)";"SP";"AGUAI";601;17;94;712
2003;"AGUAS DA PRATA (SP)";"SP";"AGUAS DA PRATA";94;5;3;102
2003;"AGUAS DE LINDOIA (SP)";"SP";"AGUAS DE LINDOIA";143;27;26;196
2003;"AGUAS DE SANTA BARBARA (SP)";"SP";"AGUAS DE SANTA BARBARA";82;5;12;99
2003;"AGUAS DE SAO PEDRO (SP)";"SP";"AGUAS DE SAO PEDRO";19;10;1;30
2003;"AGUDOS (SP)";"SP";"AGUDOS";366;19;58;443
2003;"ALAMBARI (SP)";"SP";"ALAMBARI";50;9;1;60
2003;"ALFREDO MARCONDES (SP)";"SP";"ALFREDO MARCONDES";36;2;6;44
2003;"ALTAIR (SP)";"SP";"ALTAIR";59;3;19;81
2003;"ALTINOPOLIS (SP)";"SP";"ALTINOPOLIS";275;11;66;352
2003;"ALTO ALEGRE (SP)";"SP";"ALTO ALEGRE";64;1;27;92
2003;"ALUMINIO (SP)";"SP";"ALUMINIO";141;15;25;181
2003;"ALVARES FLORENCE (SP)";"SP";"ALVARES FLORENCE";43;0;5;48
2003;"ALVARES MACHADO (SP)";"SP";"ALVARES MACHADO";342;10;16;368
2003;"ALVARO DE CARVALHO (SP)";"SP";"ALVARO DE CARVALHO";17;1;12;30
2003;"ALVINLANDIA (SP)";"SP";"ALVINLANDIA";25;1;6;32
2003;"AMERICANA (SP)";"SP";"AMERICANA";2371;299;728;3398
2003;"AMERICO BRASILIENSE (SP)";"SP";"AMERICO BRASILIENSE";535;14;170;719
2003;"AMERICO DE CAMPOS (SP)";"SP";"AMERICO DE CAMPOS";109;3;16;128
2003;"AMPARO (SP)";"SP";"AMPARO";1043;112;69;1224
2003;"ANALANDIA (SP)";"SP";"ANALANDIA";54;4;11;69
2003;"ANDRADINA (SP)";"SP";"ANDRADINA";691;27;70;788
2003;"ANGATUBA (SP)";"SP";"ANGATUBA";299;19;45;363
2003;"ANHEMBI (SP)";"SP";"ANHEMBI";46;6;6;58
2003;"ANHUMAS (SP)";"SP";"ANHUMAS";49;5;3;57
2003;"APARECIDA (SP)";"SP";"APARECIDA";719;49;230;998
2003;"APARECIDA D OESTE (SP)";"SP";"APARECIDA D OESTE";72;2;17;91
2003;"APIAI (SP)";"SP";"APIAI";208;23;34;265
2003;"ARACARIGUAMA (SP)";"SP";"ARACARIGUAMA";299;16;24;339
2003;"ARACATUBA (SP)";"SP";"ARACATUBA";2371;132;481;2984
2003;"ARACOIABA DA SERRA (SP)";"SP";"ARACOIABA DA SERRA";307;37;16;360
2003;"ARAMINA (SP)";"SP";"ARAMINA";61;5;13;79
2003;"ARANDU (SP)";"SP";"ARANDU";41;7;9;57
2003;"ARAPEI (SP)";"SP";"ARAPEI";12;2;0;14
2003;"ARARAQUARA (SP)";"SP";"ARARAQUARA";2474;249;706;3429
2003;"ARARAS (SP)";"SP";"ARARAS";1759;151;181;2091
2003;"ARCO IRIS (SP)";"SP";"ARCO IRIS";23;1;11;35
2003;"AREALVA (SP)";"SP";"AREALVA";129;5;12;146
2003;"AREIAS (SP)";"SP";"AREIAS";35;2;0;37
2003;"AREIOPOLIS (SP)";"SP";"AREIOPOLIS";96;8;33;137
2003;"ARIRANHA (SP)";"SP";"ARIRANHA";214;13;79;306
2003;"ARTUR NOGUEIRA (SP)";"SP";"ARTUR NOGUEIRA";635;53;101;789
2003;"ARUJA (SP)";"SP";"ARUJA";1685;136;261;2082
2003;"ASPASIA (SP)";"SP";"ASPASIA";26;1;3;30
2003;"ASSIS (SP)";"SP";"ASSIS";1244;74;223;1541
2003;"ATIBAIA (SP)";"SP";"ATIBAIA";1657;175;178;2010
2003;"AURIFLAMA (SP)";"SP";"AURIFLAMA";284;8;30;322
2003;"AVAI (SP)";"SP";"AVAI";47;6;12;65
2003;"AVANHANDAVA (SP)";"SP";"AVANHANDAVA";104;4;21;129
2003;"AVARE (SP)";"SP";"AVARE";996;53;218;1267
2003;"BADY BASSITT (SP)";"SP";"BADY BASSITT";180;9;16;205
2003;"BALBINOS (SP)";"SP";"BALBINOS";8;1;3;12
2003;"BALSAMO (SP)";"SP";"BALSAMO";142;6;9;157
2003;"BANANAL (SP)";"SP";"BANANAL";65;9;17;91
2003;"BARAO DE ANTONINA (SP)";"SP";"BARAO DE ANTONINA";14;4;6;24
2003;"BARBOSA (SP)";"SP";"BARBOSA";63;4;9;76
2003;"BARIRI (SP)";"SP";"BARIRI";609;19;60;688
2003;"BARRA BONITA (SP)";"SP";"BARRA BONITA";927;44;160;1131
2003;"BARRA DO CHAPEU (SP)";"SP";"BARRA DO CHAPEU";22;3;5;30
2003;"BARRA DO TURVO (SP)";"SP";"BARRA DO TURVO";33;2;17;52
2003;"BARRETOS (SP)";"SP";"BARRETOS";1623;63;316;2002
2003;"BARRINHA (SP)";"SP";"BARRINHA";248;17;96;361
2003;"BARUERI (SP)";"SP";"BARUERI";2722;357;604;3683
2003;"BASTOS (SP)";"SP";"BASTOS";516;18;47;581
2003;"BATATAIS (SP)";"SP";"BATATAIS";800;26;108;934
2003;"BAURU (SP)";"SP";"BAURU";3695;317;900;4912
2003;"BEBEDOURO (SP)";"SP";"BEBEDOURO";1396;71;167;1634
2003;"BENTO DE ABREU (SP)";"SP";"BENTO DE ABREU";67;3;8;78
2003;"BERNARDINO DE CAMPOS (SP)";"SP";"BERNARDINO DE CAMPOS";218;9;17;244
2003;"BERTIOGA (SP)";"SP";"BERTIOGA";323;35;53;411
2003;"BILAC (SP)";"SP";"BILAC";95;5;14;114
2003;"BIRIGUI (SP)";"SP";"BIRIGUI";1145;37;102;1284
2003;"BIRITIBA MIRIM (SP)";"SP";"BIRITIBA MIRIM";201;8;18;227
2003;"BOA ESPERANCA DO SUL (SP)";"SP";"BOA ESPERANCA DO SUL";328;8;56;392
2003;"BOCAINA (SP)";"SP";"BOCAINA";147;20;20;187
2003;"BOFETE (SP)";"SP";"BOFETE";134;8;19;161
2003;"BOITUVA (SP)";"SP";"BOITUVA";732;41;74;847
2003;"BOM JESUS DOS PERDOES (SP)";"SP";"BOM JESUS DOS PERDOES";241;20;23;284
2003;"BOM SUCESSO DE ITARARE (SP)";"SP";"BOM SUCESSO DE ITARARE";45;5;2;52
2003;"BORA (SP)";"SP";"BORA";12;0;3;15
2003;"BORACEIA (SP)";"SP";"BORACEIA";132;7;6;145
2003;"BORBOREMA (SP)";"SP";"BORBOREMA";238;7;39;284
2003;"BOREBI (SP)";"SP";"BOREBI";24;3;3;30
2003;"BOTUCATU (SP)";"SP";"BOTUCATU";1191;127;388;1706
2003;"BRAGANCA PAULISTA (SP)";"SP";"BRAGANCA PAULISTA";1887;157;188;2232
2003;"BRAUNA (SP)";"SP";"BRAUNA";47;1;15;63
2003;"BREJO ALEGRE (SP)";"SP";"BREJO ALEGRE";32;1;7;40
2003;"BRODOSQUI (SP)";"SP";"BRODOSQUI";380;14;29;423
2003;"BROTAS (SP)";"SP";"BROTAS";348;25;65;438
2003;"BURI (SP)";"SP";"BURI";228;12;29;269
2003;"BURITAMA (SP)";"SP";"BURITAMA";219;8;26;253
2003;"BURITIZAL (SP)";"SP";"BURITIZAL";81;14;11;106
2003;"CABRALIA PAULISTA (SP)";"SP";"CABRALIA PAULISTA";97;3;5;105
2003;"CABREUVA (SP)";"SP";"CABREUVA";701;66;47;814
2003;"CACAPAVA (SP)";"SP";"CACAPAVA";553;94;82;729
2003;"CACHOEIRA PAULISTA (SP)";"SP";"CACHOEIRA PAULISTA";254;25;8;287
2003;"CACONDE (SP)";"SP";"CACONDE";150;14;48;212
2003;"CAFELANDIA (SP)";"SP";"CAFELANDIA";206;8;37;251
2003;"CAIABU (SP)";"SP";"CAIABU";23;3;21;47
2003;"CAIEIRAS (SP)";"SP";"CAIEIRAS";557;89;352;998
2003;"CAIUA (SP)";"SP";"CAIUA";22;4;3;29
2003;"CAJAMAR (SP)";"SP";"CAJAMAR";648;71;61;780
2003;"CAJATI (SP)";"SP";"CAJATI";260;23;50;333
2003;"CAJOBI (SP)";"SP";"CAJOBI";254;2;50;306
2003;"CAJURU (SP)";"SP";"CAJURU";351;10;75;436
2003;"CAMPINA DO MONTE ALEGRE (SP)";"SP";"CAMPINA DO MONTE ALEGRE";72;6;19;97
2003;"CAMPINAS (SP)";"SP";"CAMPINAS";12075;2148;2969;17192
2003;"CAMPO LIMPO PAULISTA (SP)";"SP";"CAMPO LIMPO PAULISTA";438;76;16;530
2003;"CAMPOS DO JORDAO (SP)";"SP";"CAMPOS DO JORDAO";439;109;31;579
2003;"CAMPOS NOVOS PAULISTA (SP)";"SP";"CAMPOS NOVOS PAULISTA";58;1;14;73
2003;"CANANEIA (SP)";"SP";"CANANEIA";56;5;10;71
2003;"CANAS (SP)";"SP";"CANAS";31;2;3;36
2003;"CANDIDO MOTA (SP)";"SP";"CANDIDO MOTA";643;7;42;692
2003;"CANDIDO RODRIGUES (SP)";"SP";"CANDIDO RODRIGUES";80;6;2;88
2003;"CANITAR (SP)";"SP";"CANITAR";52;5;16;73
2003;"CAPAO BONITO (SP)";"SP";"CAPAO BONITO";744;46;101;891
2003;"CAPELA DO ALTO (SP)";"SP";"CAPELA DO ALTO";282;7;14;303
2003;"CAPIVARI (SP)";"SP";"CAPIVARI";921;51;167;1139
2003;"CARAGUATATUBA (SP)";"SP";"CARAGUATATUBA";932;56;89;1077
2003;"CARAPICUIBA (SP)";"SP";"CARAPICUIBA";1411;291;628;2330
2003;"CARDOSO (SP)";"SP";"CARDOSO";132;5;26;163
2003;"CASA BRANCA (SP)";"SP";"CASA BRANCA";363;37;59;459
2003;"CASSIA DOS COQUEIROS (SP)";"SP";"CASSIA DOS COQUEIROS";11;4;6;21
2003;"CASTILHO (SP)";"SP";"CASTILHO";111;9;50;170
2003;"CATANDUVA (SP)";"SP";"CATANDUVA";2250;106;317;2673
2003;"CATIGUA (SP)";"SP";"CATIGUA";90;3;26;119
2003;"CEDRAL (SP)";"SP";"CEDRAL";103;6;7;116
2003;"CERQUEIRA CESAR (SP)";"SP";"CERQUEIRA CESAR";232;11;42;285
2003;"CERQUILHO (SP)";"SP";"CERQUILHO";638;47;49;734
2003;"CESARIO LANGE (SP)";"SP";"CESARIO LANGE";220;23;27;270
2003;"CHARQUEADA (SP)";"SP";"CHARQUEADA";299;16;57;372
2003;"CHAVANTES (SP)";"SP";"CHAVANTES";132;10;29;171
2003;"CLEMENTINA (SP)";"SP";"CLEMENTINA";139;2;22;163
2003;"COLINA (SP)";"SP";"COLINA";269;12;52;333
2003;"COLOMBIA (SP)";"SP";"COLOMBIA";102;4;42;148
2003;"CONCHAL (SP)";"SP";"CONCHAL";542;21;112;675
2003;"CONCHAS (SP)";"SP";"CONCHAS";245;16;20;281
2003;"CORDEIROPOLIS (SP)";"SP";"CORDEIROPOLIS";433;26;24;483
2003;"COROADOS (SP)";"SP";"COROADOS";56;3;11;70
2003;"CORONEL MACEDO (SP)";"SP";"CORONEL MACEDO";44;6;16;66
2003;"CORUMBATAI (SP)";"SP";"CORUMBATAI";118;8;5;131
2003;"COSMOPOLIS (SP)";"SP";"COSMOPOLIS";565;83;194;842
2003;"COSMORAMA (SP)";"SP";"COSMORAMA";117;5;17;139
2003;"COTIA (SP)";"SP";"COTIA";1504;484;152;2140
2003;"CRAVINHOS (SP)";"SP";"CRAVINHOS";653;50;92;795
2003;"CRISTAIS PAULISTA (SP)";"SP";"CRISTAIS PAULISTA";64;1;12;77
2003;"CRUZALIA (SP)";"SP";"CRUZALIA";65;9;3;77
2003;"CRUZEIRO (SP)";"SP";"CRUZEIRO";477;48;37;562
2003;"CUBATAO (SP)";"SP";"CUBATAO";1924;266;325;2515
2003;"CUNHA (SP)";"SP";"CUNHA";186;13;10;209
2003;"DESCALVADO (SP)";"SP";"DESCALVADO";659;36;115;810
2003;"DIADEMA (SP)";"SP";"DIADEMA";2636;423;455;3514
2003;"DIRCE REIS (SP)";"SP";"DIRCE REIS";40;2;5;47
2003;"DIVINOLANDIA (SP)";"SP";"DIVINOLANDIA";355;12;16;383
2003;"DOBRADA (SP)";"SP";"DOBRADA";62;3;44;109
2003;"DOIS CORREGOS (SP)";"SP";"DOIS CORREGOS";473;16;75;564
2003;"DOLCINOPOLIS (SP)";"SP";"DOLCINOPOLIS";19;2;4;25
2003;"DOURADO (SP)";"SP";"DOURADO";119;7;33;159
2003;"DRACENA (SP)";"SP";"DRACENA";851;22;116;989
2003;"DUARTINA (SP)";"SP";"DUARTINA";199;14;29;242
2003;"DUMONT (SP)";"SP";"DUMONT";223;8;29;260
2003;"ECHAPORA (SP)";"SP";"ECHAPORA";76;2;15;93
2003;"ELDORADO (SP)";"SP";"ELDORADO";149;4;27;180
2003;"ELIAS FAUSTO (SP)";"SP";"ELIAS FAUSTO";224;8;24;256
2003;"ELISIARIO (SP)";"SP";"ELISIARIO";43;2;6;51
2003;"EMBAUBA (SP)";"SP";"EMBAUBA";78;0;24;102
2003;"EMBU (SP)";"SP";"EMBU";1113;329;461;1903
2003;"EMBU GUACU (SP)";"SP";"EMBU GUACU";772;125;98;995
2003;"EMILIANOPOLIS (SP)";"SP";"EMILIANOPOLIS";39;1;5;45
2003;"ENGENHEIRO COELHO (SP)";"SP";"ENGENHEIRO COELHO";225;28;91;344
2003;"ESPIRITO SANTO DO PINHAL (SP)";"SP";"ESPIRITO SANTO DO PINHAL";487;71;51;609
2003;"ESPIRITO SANTO DO TURVO (SP)";"SP";"ESPIRITO SANTO DO TURVO";86;7;10;103
2003;"ESTIVA GERBI (SP)";"SP";"ESTIVA GERBI";191;7;12;210
2003;"ESTRELA D OESTE (SP)";"SP";"ESTRELA D OESTE";185;9;10;204
2003;"ESTRELA DO NORTE (SP)";"SP";"ESTRELA DO NORTE";18;2;6;26
2003;"EUCLIDES DA CUNHA PAULISTA (SP)";"SP";"EUCLIDES DA CUNHA PAULISTA";65;4;25;94
2003;"FARTURA (SP)";"SP";"FARTURA";192;15;12;219
2003;"FERNANDO PRESTES (SP)";"SP";"FERNANDO PRESTES";193;7;9;209
2003;"FERNANDOPOLIS (SP)";"SP";"FERNANDOPOLIS";1027;29;133;1189
2003;"FERNAO (SP)";"SP";"FERNAO";13;1;4;18
2003;"FERRAZ DE VASCONCELOS (SP)";"SP";"FERRAZ DE VASCONCELOS";662;58;159;879
2003;"FLORA RICA (SP)";"SP";"FLORA RICA";21;0;6;27
2003;"FLOREAL (SP)";"SP";"FLOREAL";46;3;4;53
2003;"FLORIDA PAULISTA (SP)";"SP";"FLORIDA PAULISTA";223;3;61;287
2003;"FLORINEA (SP)";"SP";"FLORINEA";33;2;5;40
2003;"FRANCA (SP)";"SP";"FRANCA";2107;160;342;2609
2003;"FRANCISCO MORATO (SP)";"SP";"FRANCISCO MORATO";327;82;87;496
2003;"FRANCO DA ROCHA (SP)";"SP";"FRANCO DA ROCHA";399;101;92;592
2003;"GABRIEL MONTEIRO (SP)";"SP";"GABRIEL MONTEIRO";39;2;7;48
2003;"GALIA (SP)";"SP";"GALIA";103;7;15;125
2003;"GARCA (SP)";"SP";"GARCA";596;34;79;709
2003;"GASTAO VIDIGAL (SP)";"SP";"GASTAO VIDIGAL";53;1;15;69
2003;"GAVIAO PEIXOTO (SP)";"SP";"GAVIAO PEIXOTO";40;3;19;62
2003;"GENERAL SALGADO (SP)";"SP";"GENERAL SALGADO";188;4;38;230
2003;"GETULINA (SP)";"SP";"GETULINA";130;6;27;163
2003;"GLICERIO (SP)";"SP";"GLICERIO";69;2;18;89
2003;"GUAICARA (SP)";"SP";"GUAICARA";56;6;10;72
2003;"GUAIMBE (SP)";"SP";"GUAIMBE";89;4;12;105
2003;"GUAIRA (SP)";"SP";"GUAIRA";785;21;72;878
2003;"GUAPIACU (SP)";"SP";"GUAPIACU";326;12;36;374
2003;"GUAPIARA (SP)";"SP";"GUAPIARA";213;7;24;244
2003;"GUARA (SP)";"SP";"GUARA";200;8;90;298
2003;"GUARACAI (SP)";"SP";"GUARACAI";256;4;14;274
2003;"GUARACI (SP)";"SP";"GUARACI";99;3;35;137
2003;"GUARANI D OESTE (SP)";"SP";"GUARANI D OESTE";21;1;6;28
2003;"GUARANTA (SP)";"SP";"GUARANTA";76;2;18;96
2003;"GUARARAPES (SP)";"SP";"GUARARAPES";560;17;87;664
2003;"GUARAREMA (SP)";"SP";"GUARAREMA";191;17;3;211
2003;"GUARATINGUETA (SP)";"SP";"GUARATINGUETA";796;111;510;1417
2003;"GUAREI (SP)";"SP";"GUAREI";152;17;21;190
2003;"GUARIBA (SP)";"SP";"GUARIBA";668;16;219;903
2003;"GUARUJA (SP)";"SP";"GUARUJA";1286;331;294;1911
2003;"GUARULHOS (SP)";"SP";"GUARULHOS";11202;2186;2161;15549
2003;"GUATAPARA (SP)";"SP";"GUATAPARA";108;5;27;140
2003;"GUZOLANDIA (SP)";"SP";"GUZOLANDIA";46;1;19;66
2003;"HERCULANDIA (SP)";"SP";"HERCULANDIA";287;2;13;302
2003;"HOLAMBRA (SP)";"SP";"HOLAMBRA";296;17;47;360
2003;"HORTOLANDIA (SP)";"SP";"HORTOLANDIA";875;198;166;1239
2003;"IACANGA (SP)";"SP";"IACANGA";134;5;25;164
2003;"IACRI (SP)";"SP";"IACRI";90;2;9;101
2003;"IARAS (SP)";"SP";"IARAS";31;13;6;50
2003;"IBATE (SP)";"SP";"IBATE";374;19;141;534
2003;"IBIRA (SP)";"SP";"IBIRA";146;15;27;188
2003;"IBIRAREMA (SP)";"SP";"IBIRAREMA";106;5;15;126
2003;"IBITINGA (SP)";"SP";"IBITINGA";576;29;85;690
2003;"IBIUNA (SP)";"SP";"IBIUNA";1157;77;80;1314
2003;"ICEM (SP)";"SP";"ICEM";144;5;47;196
2003;"IEPE (SP)";"SP";"IEPE";113;5;18;136
2003;"IGARACU DO TIETE (SP)";"SP";"IGARACU DO TIETE";317;11;32;360
2003;"IGARAPAVA (SP)";"SP";"IGARAPAVA";382;16;79;477
2003;"IGARATA (SP)";"SP";"IGARATA";77;5;5;87
2003;"IGUAPE (SP)";"SP";"IGUAPE";183;14;19;216
2003;"ILHA COMPRIDA (SP)";"SP";"ILHA COMPRIDA";80;5;27;112
2003;"ILHA SOLTEIRA (SP)";"SP";"ILHA SOLTEIRA";181;19;47;247
2003;"ILHABELA (SP)";"SP";"ILHABELA";160;16;32;208
2003;"INDAIATUBA (SP)";"SP";"INDAIATUBA";1933;187;198;2318
2003;"INDIANA (SP)";"SP";"INDIANA";100;1;5;106
2003;"INDIAPORA (SP)";"SP";"INDIAPORA";54;3;11;68
2003;"INUBIA PAULISTA (SP)";"SP";"INUBIA PAULISTA";40;2;10;52
2003;"IPAUCU (SP)";"SP";"IPAUCU";130;6;27;163
2003;"IPERO (SP)";"SP";"IPERO";167;10;29;206
2003;"IPEUNA (SP)";"SP";"IPEUNA";105;13;11;129
2003;"IPIGUA (SP)";"SP";"IPIGUA";15;1;5;21
2003;"IPORANGA (SP)";"SP";"IPORANGA";21;2;4;27
2003;"IPUA (SP)";"SP";"IPUA";242;2;43;287
2003;"IRACEMAPOLIS (SP)";"SP";"IRACEMAPOLIS";506;15;64;585
2003;"IRAPUA (SP)";"SP";"IRAPUA";142;1;42;185
2003;"IRAPURU (SP)";"SP";"IRAPURU";107;7;15;129
2003;"ITABERA (SP)";"SP";"ITABERA";169;10;19;198
2003;"ITAI (SP)";"SP";"ITAI";374;16;60;450
2003;"ITAJOBI (SP)";"SP";"ITAJOBI";411;11;33;455
2003;"ITAJU (SP)";"SP";"ITAJU";61;1;7;69
2003;"ITANHAEM (SP)";"SP";"ITANHAEM";548;59;92;699
2003;"ITAOCA (SP)";"SP";"ITAOCA";12;5;5;22
2003;"ITAPECERICA DA SERRA (SP)";"SP";"ITAPECERICA DA SERRA";1282;352;288;1922
2003;"ITAPETININGA (SP)";"SP";"ITAPETININGA";1885;171;210;2266
2003;"ITAPEVA (SP)";"SP";"ITAPEVA";1326;80;215;1621
2003;"ITAPEVI (SP)";"SP";"ITAPEVI";917;96;88;1101
2003;"ITAPIRA (SP)";"SP";"ITAPIRA";1197;59;149;1405
2003;"ITAPIRAPUA PAULISTA (SP)";"SP";"ITAPIRAPUA PAULISTA";21;4;3;28
2003;"ITAPOLIS (SP)";"SP";"ITAPOLIS";1074;21;125;1220
2003;"ITAPORANGA (SP)";"SP";"ITAPORANGA";173;6;30;209
2003;"ITAPUI (SP)";"SP";"ITAPUI";272;10;32;314
2003;"ITAPURA (SP)";"SP";"ITAPURA";13;3;7;23
2003;"ITAQUAQUECETUBA (SP)";"SP";"ITAQUAQUECETUBA";1242;182;404;1828
2003;"ITARARE (SP)";"SP";"ITARARE";775;36;240;1051
2003;"ITARIRI (SP)";"SP";"ITARIRI";246;6;15;267
2003;"ITATIBA (SP)";"SP";"ITATIBA";1698;113;135;1946
2003;"ITATINGA (SP)";"SP";"ITATINGA";145;20;56;221
2003;"ITIRAPINA (SP)";"SP";"ITIRAPINA";163;12;36;211
2003;"ITIRAPUA (SP)";"SP";"ITIRAPUA";42;4;12;58
2003;"ITOBI (SP)";"SP";"ITOBI";108;4;37;149
2003;"ITU (SP)";"SP";"ITU";2201;194;375;2770
2003;"ITUPEVA (SP)";"SP";"ITUPEVA";548;57;43;648
2003;"ITUVERAVA (SP)";"SP";"ITUVERAVA";565;21;94;680
2003;"JABORANDI (SP)";"SP";"JABORANDI";135;5;25;165
2003;"JABOTICABAL (SP)";"SP";"JABOTICABAL";1320;52;146;1518
2003;"JACAREI (SP)";"SP";"JACAREI";1944;307;279;2530
2003;"JACI (SP)";"SP";"JACI";75;5;9;89
2003;"JACUPIRANGA (SP)";"SP";"JACUPIRANGA";311;8;130;449
2003;"JAGUARIUNA (SP)";"SP";"JAGUARIUNA";770;59;57;886
2003;"JALES (SP)";"SP";"JALES";882;27;93;1002
2003;"JAMBEIRO (SP)";"SP";"JAMBEIRO";20;4;5;29
2003;"JANDIRA (SP)";"SP";"JANDIRA";837;107;93;1037
2003;"JARDINOPOLIS (SP)";"SP";"JARDINOPOLIS";651;41;60;752
2003;"JARINU (SP)";"SP";"JARINU";335;15;25;375
2003;"JAU (SP)";"SP";"JAU";1609;145;218;1972
2003;"JERIQUARA (SP)";"SP";"JERIQUARA";29;1;5;35
2003;"JOANOPOLIS (SP)";"SP";"JOANOPOLIS";193;7;3;203
2003;"JOAO RAMALHO (SP)";"SP";"JOAO RAMALHO";27;2;13;42
2003;"JOSE BONIFACIO (SP)";"SP";"JOSE BONIFACIO";568;17;55;640
2003;"JULIO MESQUITA (SP)";"SP";"JULIO MESQUITA";30;0;8;38
2003;"JUMIRIM (SP)";"SP";"JUMIRIM";58;2;2;62
2003;"JUNDIAI (SP)";"SP";"JUNDIAI";5216;721;695;6632
2003;"JUNQUEIROPOLIS (SP)";"SP";"JUNQUEIROPOLIS";327;18;52;397
2003;"JUQUIA (SP)";"SP";"JUQUIA";292;13;32;337
2003;"JUQUITIBA (SP)";"SP";"JUQUITIBA";229;49;29;307
2003;"LAGOINHA (SP)";"SP";"LAGOINHA";60;5;5;70
2003;"LARANJAL PAULISTA (SP)";"SP";"LARANJAL PAULISTA";474;28;59;561
2003;"LAVINIA (SP)";"SP";"LAVINIA";63;6;7;76
2003;"LAVRINHAS (SP)";"SP";"LAVRINHAS";105;14;7;126
2003;"LEME (SP)";"SP";"LEME";1684;66;282;2032
2003;"LENCOIS PAULISTA (SP)";"SP";"LENCOIS PAULISTA";1047;57;122;1226
2003;"LIMEIRA (SP)";"SP";"LIMEIRA";3382;378;467;4227
2003;"LINDOIA (SP)";"SP";"LINDOIA";86;8;9;103
2003;"LINS (SP)";"SP";"LINS";846;43;103;992
2003;"LORENA (SP)";"SP";"LORENA";567;61;17;645
2003;"LOURDES (SP)";"SP";"LOURDES";20;2;7;29
2003;"LOUVEIRA (SP)";"SP";"LOUVEIRA";623;46;29;698
2003;"LUCELIA (SP)";"SP";"LUCELIA";316;20;96;432
2003;"LUCIANOPOLIS (SP)";"SP";"LUCIANOPOLIS";45;3;8;56
2003;"LUIS ANTONIO (SP)";"SP";"LUIS ANTONIO";193;14;61;268
2003;"LUIZIANIA (SP)";"SP";"LUIZIANIA";52;1;10;63
2003;"LUPERCIO (SP)";"SP";"LUPERCIO";47;2;16;65
2003;"LUTECIA (SP)";"SP";"LUTECIA";30;3;4;37
2003;"MACATUBA (SP)";"SP";"MACATUBA";604;12;52;668
2003;"MACAUBAL (SP)";"SP";"MACAUBAL";114;5;11;130
2003;"MACEDONIA (SP)";"SP";"MACEDONIA";43;1;11;55
2003;"MAGDA (SP)";"SP";"MAGDA";63;4;9;76
2003;"MAIRINQUE (SP)";"SP";"MAIRINQUE";343;48;55;446
2003;"MAIRIPORA (SP)";"SP";"MAIRIPORA";786;72;114;972
2003;"MANDURI (SP)";"SP";"MANDURI";117;4;27;148
2003;"MARABA PAULISTA (SP)";"SP";"MARABA PAULISTA";29;3;10;42
2003;"MARACAI (SP)";"SP";"MARACAI";266;19;43;328
2003;"MARAPOAMA (SP)";"SP";"MARAPOAMA";93;3;7;103
2003;"MARIAPOLIS (SP)";"SP";"MARIAPOLIS";29;0;11;40
2003;"MARILIA (SP)";"SP";"MARILIA";2373;134;378;2885
2003;"MARINOPOLIS (SP)";"SP";"MARINOPOLIS";56;2;3;61
2003;"MARTINOPOLIS (SP)";"SP";"MARTINOPOLIS";332;19;58;409
2003;"MATAO (SP)";"SP";"MATAO";1200;32;199;1431
2003;"MAUA (SP)";"SP";"MAUA";2430;579;735;3744
2003;"MENDONCA (SP)";"SP";"MENDONCA";80;2;12;94
2003;"MERIDIANO (SP)";"SP";"MERIDIANO";49;0;11;60
2003;"MESOPOLIS (SP)";"SP";"MESOPOLIS";14;3;6;23
2003;"MIGUELOPOLIS (SP)";"SP";"MIGUELOPOLIS";292;7;70;369
2003;"MINEIROS DO TIETE (SP)";"SP";"MINEIROS DO TIETE";209;7;23;239
2003;"MIRA ESTRELA (SP)";"SP";"MIRA ESTRELA";32;2;7;41
2003;"MIRACATU (SP)";"SP";"MIRACATU";440;17;25;482
2003;"MIRANDOPOLIS (SP)";"SP";"MIRANDOPOLIS";373;13;78;464
2003;"MIRANTE DO PARANAPANEMA (SP)";"SP";"MIRANTE DO PARANAPANEMA";172;6;29;207
2003;"MIRASSOL (SP)";"SP";"MIRASSOL";821;29;35;885
2003;"MIRASSOLANDIA (SP)";"SP";"MIRASSOLANDIA";27;5;5;37
2003;"MOCOCA (SP)";"SP";"MOCOCA";793;39;166;998
2003;"MOGI DAS CRUZES (SP)";"SP";"MOGI DAS CRUZES";3302;369;481;4152
2003;"MOGI GUACU (SP)";"SP";"MOGI GUACU";1428;192;260;1880
2003;"MOGI MIRIM (SP)";"SP";"MOGI MIRIM";1501;119;473;2093
2003;"MOMBUCA (SP)";"SP";"MOMBUCA";63;1;13;77
2003;"MONCOES (SP)";"SP";"MONCOES";38;1;7;46
2003;"MONGAGUA (SP)";"SP";"MONGAGUA";310;43;51;404
2003;"MONTE ALEGRE DO SUL (SP)";"SP";"MONTE ALEGRE DO SUL";139;9;11;159
2003;"MONTE ALTO (SP)";"SP";"MONTE ALTO";1129;32;75;1236
2003;"MONTE APRAZIVEL (SP)";"SP";"MONTE APRAZIVEL";387;6;37;430
2003;"MONTE AZUL PAULISTA (SP)";"SP";"MONTE AZUL PAULISTA";444;21;86;551
2003;"MONTE CASTELO (SP)";"SP";"MONTE CASTELO";66;3;7;76
2003;"MONTE MOR (SP)";"SP";"MONTE MOR";451;71;89;611
2003;"MONTEIRO LOBATO (SP)";"SP";"MONTEIRO LOBATO";32;9;8;49
2003;"MORRO AGUDO (SP)";"SP";"MORRO AGUDO";502;16;78;596
2003;"MORUNGABA (SP)";"SP";"MORUNGABA";229;29;17;275
2003;"MOTUCA (SP)";"SP";"MOTUCA";125;4;37;166
2003;"MUNICIPIO NAO INFORMADO (SP)";"SP";"MUNICIPIO NAO INFORMADO";0;0;0;0
2003;"MURUTINGA DO SUL (SP)";"SP";"MURUTINGA DO SUL";73;4;3;80
2003;"NANTES (SP)";"SP";"NANTES";18;0;12;30
2003;"NARANDIBA (SP)";"SP";"NARANDIBA";20;2;10;32
2003;"NATIVIDADE DA SERRA (SP)";"SP";"NATIVIDADE DA SERRA";40;7;5;52
2003;"NAZARE PAULISTA (SP)";"SP";"NAZARE PAULISTA";322;10;44;376
2003;"NEVES PAULISTA (SP)";"SP";"NEVES PAULISTA";153;4;20;177
2003;"NHANDEARA (SP)";"SP";"NHANDEARA";175;9;20;204
2003;"NIPOA (SP)";"SP";"NIPOA";73;3;9;85
2003;"NOVA ALIANCA (SP)";"SP";"NOVA ALIANCA";85;6;13;104
2003;"NOVA CAMPINA (SP)";"SP";"NOVA CAMPINA";53;4;8;65
2003;"NOVA CANAA PAULISTA (SP)";"SP";"NOVA CANAA PAULISTA";21;1;2;24
2003;"NOVA CASTILHO (SP)";"SP";"NOVA CASTILHO";11;1;4;16
2003;"NOVA EUROPA (SP)";"SP";"NOVA EUROPA";144;3;53;200
2003;"NOVA GRANADA (SP)";"SP";"NOVA GRANADA";234;13;54;301
2003;"NOVA GUATAPORANGA (SP)";"SP";"NOVA GUATAPORANGA";23;2;8;33
2003;"NOVA INDEPENDENCIA (SP)";"SP";"NOVA INDEPENDENCIA";22;2;2;26
2003;"NOVA LUZITANIA (SP)";"SP";"NOVA LUZITANIA";37;3;15;55
2003;"NOVA ODESSA (SP)";"SP";"NOVA ODESSA";597;76;91;764
2003;"NOVAIS (SP)";"SP";"NOVAIS";104;2;22;128
2003;"NOVO HORIZONTE (SP)";"SP";"NOVO HORIZONTE";669;7;111;787
2003;"NUPORANGA (SP)";"SP";"NUPORANGA";156;5;19;180
2003;"OCAUCU (SP)";"SP";"OCAUCU";68;1;7;76
2003;"OLEO (SP)";"SP";"OLEO";15;5;3;23
2003;"OLIMPIA (SP)";"SP";"OLIMPIA";854;21;95;970
2003;"ONDA VERDE (SP)";"SP";"ONDA VERDE";67;3;13;83
2003;"ORIENTE (SP)";"SP";"ORIENTE";51;3;10;64
2003;"ORINDIUVA (SP)";"SP";"ORINDIUVA";103;10;36;149
2003;"ORLANDIA (SP)";"SP";"ORLANDIA";785;31;155;971
2003;"OSASCO (SP)";"SP";"OSASCO";5010;1009;1715;7734
2003;"OSCAR BRESSANE (SP)";"SP";"OSCAR BRESSANE";41;2;7;50
2003;"OSVALDO CRUZ (SP)";"SP";"OSVALDO CRUZ";475;9;54;538
2003;"OURINHOS (SP)";"SP";"OURINHOS";1637;62;209;1908
2003;"OURO VERDE (SP)";"SP";"OURO VERDE";96;2;17;115
2003;"OUROESTE (SP)";"SP";"OUROESTE";63;5;20;88
2003;"PACAEMBU (SP)";"SP";"PACAEMBU";153;17;24;194
2003;"PALESTINA (SP)";"SP";"PALESTINA";97;3;21;121
2003;"PALMARES PAULISTA (SP)";"SP";"PALMARES PAULISTA";67;3;53;123
2003;"PALMEIRA D OESTE (SP)";"SP";"PALMEIRA D OESTE";170;4;22;196
2003;"PALMITAL (SP)";"SP";"PALMITAL";503;21;38;562
2003;"PANORAMA (SP)";"SP";"PANORAMA";183;5;12;200
2003;"PARAGUACU PAULISTA (SP)";"SP";"PARAGUACU PAULISTA";484;18;78;580
2003;"PARAIBUNA (SP)";"SP";"PARAIBUNA";150;27;24;201
2003;"PARAISO (SP)";"SP";"PARAISO";155;6;30;191
2003;"PARANAPANEMA (SP)";"SP";"PARANAPANEMA";335;10;31;376
2003;"PARANAPUA (SP)";"SP";"PARANAPUA";49;3;5;57
2003;"PARAPUA (SP)";"SP";"PARAPUA";190;5;23;218
2003;"PARDINHO (SP)";"SP";"PARDINHO";128;8;11;147
2003;"PARIQUERA ACU (SP)";"SP";"PARIQUERA ACU";190;8;7;205
2003;"PARISI (SP)";"SP";"PARISI";18;1;6;25
2003;"PATROCINIO PAULISTA (SP)";"SP";"PATROCINIO PAULISTA";143;2;25;170
2003;"PAULICEIA (SP)";"SP";"PAULICEIA";87;3;9;99
2003;"PAULINIA (SP)";"SP";"PAULINIA";1325;94;224;1643
2003;"PAULISTANIA (SP)";"SP";"PAULISTANIA";19;6;3;28
2003;"PAULO DE FARIA (SP)";"SP";"PAULO DE FARIA";80;7;27;114
2003;"PEDERNEIRAS (SP)";"SP";"PEDERNEIRAS";690;36;135;861
2003;"PEDRA BELA (SP)";"SP";"PEDRA BELA";86;3;12;101
2003;"PEDRANOPOLIS (SP)";"SP";"PEDRANOPOLIS";36;0;5;41
2003;"PEDREGULHO (SP)";"SP";"PEDREGULHO";182;9;51;242
2003;"PEDREIRA (SP)";"SP";"PEDREIRA";502;54;49;605
2003;"PEDRINHAS PAULISTA (SP)";"SP";"PEDRINHAS PAULISTA";121;3;13;137
2003;"PEDRO DE TOLEDO (SP)";"SP";"PEDRO DE TOLEDO";134;8;4;146
2003;"PENAPOLIS (SP)";"SP";"PENAPOLIS";1045;26;173;1244
2003;"PEREIRA BARRETO (SP)";"SP";"PEREIRA BARRETO";366;16;74;456
2003;"PEREIRAS (SP)";"SP";"PEREIRAS";154;10;14;178
2003;"PERUIBE (SP)";"SP";"PERUIBE";399;93;38;530
2003;"PIACATU (SP)";"SP";"PIACATU";68;2;5;75
2003;"PIEDADE (SP)";"SP";"PIEDADE";992;68;63;1123
2003;"PILAR DO SUL (SP)";"SP";"PILAR DO SUL";565;23;56;644
2003;"PINDAMONHANGABA (SP)";"SP";"PINDAMONHANGABA";936;125;114;1175
2003;"PINDORAMA (SP)";"SP";"PINDORAMA";205;6;35;246
2003;"PINHALZINHO (SP)";"SP";"PINHALZINHO";255;8;6;269
2003;"PIQUEROBI (SP)";"SP";"PIQUEROBI";15;4;5;24
2003;"PIQUETE (SP)";"SP";"PIQUETE";94;20;15;129
2003;"PIRACAIA (SP)";"SP";"PIRACAIA";369;36;19;424
2003;"PIRACICABA (SP)";"SP";"PIRACICABA";5461;481;921;6863
2003;"PIRAJU (SP)";"SP";"PIRAJU";350;32;70;452
2003;"PIRAJUI (SP)";"SP";"PIRAJUI";258;8;39;305
2003;"PIRANGI (SP)";"SP";"PIRANGI";357;15;41;413
2003;"PIRAPORA DO BOM JESUS (SP)";"SP";"PIRAPORA DO BOM JESUS";136;12;13;161
2003;"PIRAPOZINHO (SP)";"SP";"PIRAPOZINHO";359;9;19;387
2003;"PIRASSUNUNGA (SP)";"SP";"PIRASSUNUNGA";787;86;204;1077
2003;"PIRATININGA (SP)";"SP";"PIRATININGA";172;5;22;199
2003;"PITANGUEIRAS (SP)";"SP";"PITANGUEIRAS";591;18;149;758
2003;"PLANALTO (SP)";"SP";"PLANALTO";62;2;15;79
2003;"PLATINA (SP)";"SP";"PLATINA";32;1;4;37
2003;"POA (SP)";"SP";"POA";572;74;25;671
2003;"POLONI (SP)";"SP";"POLONI";106;7;23;136
2003;"POMPEIA (SP)";"SP";"POMPEIA";221;14;33;268
2003;"PONGAI (SP)";"SP";"PONGAI";39;1;10;50
2003;"PONTAL (SP)";"SP";"PONTAL";632;9;294;935
2003;"PONTALINDA (SP)";"SP";"PONTALINDA";30;3;17;50
2003;"PONTES GESTAL (SP)";"SP";"PONTES GESTAL";33;2;7;42
2003;"POPULINA (SP)";"SP";"POPULINA";63;6;13;82
2003;"PORANGABA (SP)";"SP";"PORANGABA";76;8;8;92
2003;"PORTO FELIZ (SP)";"SP";"PORTO FELIZ";910;35;103;1048
2003;"PORTO FERREIRA (SP)";"SP";"PORTO FERREIRA";722;32;110;864
2003;"POTIM (SP)";"SP";"POTIM";43;14;9;66
2003;"POTIRENDABA (SP)";"SP";"POTIRENDABA";327;14;29;370
2003;"PRACINHA (SP)";"SP";"PRACINHA";8;3;8;19
2003;"PRADOPOLIS (SP)";"SP";"PRADOPOLIS";310;13;98;421
2003;"PRAIA GRANDE (SP)";"SP";"PRAIA GRANDE";1258;146;240;1644
2003;"PRATANIA (SP)";"SP";"PRATANIA";62;4;9;75
2003;"PRESIDENTE ALVES (SP)";"SP";"PRESIDENTE ALVES";74;2;22;98
2003;"PRESIDENTE BERNARDES (SP)";"SP";"PRESIDENTE BERNARDES";172;9;19;200
2003;"PRESIDENTE EPITACIO (SP)";"SP";"PRESIDENTE EPITACIO";313;17;58;388
2003;"PRESIDENTE PRUDENTE (SP)";"SP";"PRESIDENTE PRUDENTE";2892;183;816;3891
2003;"PRESIDENTE VENCESLAU (SP)";"SP";"PRESIDENTE VENCESLAU";500;19;40;559
2003;"PROMISSAO (SP)";"SP";"PROMISSAO";572;15;136;723
2003;"QUADRA (SP)";"SP";"QUADRA";31;8;6;45
2003;"QUATA (SP)";"SP";"QUATA";155;5;34;194
2003;"QUEIROZ (SP)";"SP";"QUEIROZ";18;1;5;24
2003;"QUELUZ (SP)";"SP";"QUELUZ";98;8;7;113
2003;"QUINTANA (SP)";"SP";"QUINTANA";60;4;5;69
2003;"RAFARD (SP)";"SP";"RAFARD";202;11;12;225
2003;"RANCHARIA (SP)";"SP";"RANCHARIA";488;29;63;580
2003;"REDENCAO DA SERRA (SP)";"SP";"REDENCAO DA SERRA";33;4;13;50
2003;"REGENTE FEIJO (SP)";"SP";"REGENTE FEIJO";271;14;14;299
2003;"REGINOPOLIS (SP)";"SP";"REGINOPOLIS";68;0;16;84
2003;"REGISTRO (SP)";"SP";"REGISTRO";761;58;191;1010
2003;"RESTINGA (SP)";"SP";"RESTINGA";37;6;10;53
2003;"RIBEIRA (SP)";"SP";"RIBEIRA";17;3;6;26
2003;"RIBEIRAO BONITO (SP)";"SP";"RIBEIRAO BONITO";220;19;38;277
2003;"RIBEIRAO BRANCO (SP)";"SP";"RIBEIRAO BRANCO";126;7;20;153
2003;"RIBEIRAO CORRENTE (SP)";"SP";"RIBEIRAO CORRENTE";29;5;13;47
2003;"RIBEIRAO DO SUL (SP)";"SP";"RIBEIRAO DO SUL";89;2;10;101
2003;"RIBEIRAO DOS INDIOS (SP)";"SP";"RIBEIRAO DOS INDIOS";19;1;5;25
2003;"RIBEIRAO GRANDE (SP)";"SP";"RIBEIRAO GRANDE";50;8;6;64
2003;"RIBEIRAO PIRES (SP)";"SP";"RIBEIRAO PIRES";952;207;236;1395
2003;"RIBEIRAO PRETO (SP)";"SP";"RIBEIRAO PRETO";6707;613;1280;8600
2003;"RIFAINA (SP)";"SP";"RIFAINA";25;2;6;33
2003;"RINCAO (SP)";"SP";"RINCAO";143;7;32;182
2003;"RINOPOLIS (SP)";"SP";"RINOPOLIS";155;6;31;192
2003;"RIO CLARO (SP)";"SP";"RIO CLARO";2295;183;375;2853
2003;"RIO DAS PEDRAS (SP)";"SP";"RIO DAS PEDRAS";568;28;113;709
2003;"RIO GRANDE DA SERRA (SP)";"SP";"RIO GRANDE DA SERRA";188;30;23;241
2003;"RIOLANDIA (SP)";"SP";"RIOLANDIA";74;5;24;103
2003;"RIVERSUL (SP)";"SP";"RIVERSUL";47;1;11;59
2003;"ROSANA (SP)";"SP";"ROSANA";119;6;53;178
2003;"ROSEIRA (SP)";"SP";"ROSEIRA";91;19;6;116
2003;"RUBIACEA (SP)";"SP";"RUBIACEA";21;1;14;36
2003;"RUBINEIA (SP)";"SP";"RUBINEIA";14;4;6;24
2003;"SABINO (SP)";"SP";"SABINO";42;4;5;51
2003;"SAGRES (SP)";"SP";"SAGRES";12;3;4;19
2003;"SALES (SP)";"SP";"SALES";62;1;14;77
2003;"SALES OLIVEIRA (SP)";"SP";"SALES OLIVEIRA";186;8;26;220
2003;"SALESOPOLIS (SP)";"SP";"SALESOPOLIS";418;23;39;480
2003;"SALMORAO (SP)";"SP";"SALMORAO";19;2;16;37
2003;"SALTINHO (SP)";"SP";"SALTINHO";274;4;4;282
2003;"SALTO (SP)";"SP";"SALTO";1257;111;155;1523
2003;"SALTO DE PIRAPORA (SP)";"SP";"SALTO DE PIRAPORA";423;18;42;483
2003;"SALTO GRANDE (SP)";"SP";"SALTO GRANDE";96;4;12;112
2003;"SANDOVALINA (SP)";"SP";"SANDOVALINA";17;2;6;25
2003;"SANTA ADELIA (SP)";"SP";"SANTA ADELIA";509;14;63;586
2003;"SANTA ALBERTINA (SP)";"SP";"SANTA ALBERTINA";63;3;8;74
2003;"SANTA BARBARA D OESTE (SP)";"SP";"SANTA BARBARA D OESTE";1884;243;161;2288
2003;"SANTA BRANCA (SP)";"SP";"SANTA BRANCA";65;7;42;114
2003;"SANTA CLARA D OESTE (SP)";"SP";"SANTA CLARA D OESTE";12;0;3;15
2003;"SANTA CRUZ DA CONCEICAO (SP)";"SP";"SANTA CRUZ DA CONCEICAO";92;6;12;110
2003;"SANTA CRUZ DA ESPERANCA (SP)";"SP";"SANTA CRUZ DA ESPERANCA";13;0;5;18
2003;"SANTA CRUZ DAS PALMEIRAS (SP)";"SP";"SANTA CRUZ DAS PALMEIRAS";637;18;152;807
2003;"SANTA CRUZ DO RIO PARDO (SP)";"SP";"SANTA CRUZ DO RIO PARDO";941;48;65;1054
2003;"SANTA ERNESTINA (SP)";"SP";"SANTA ERNESTINA";67;4;18;89
2003;"SANTA FE DO SUL (SP)";"SP";"SANTA FE DO SUL";497;9;22;528
2003;"SANTA GERTRUDES (SP)";"SP";"SANTA GERTRUDES";324;13;21;358
2003;"SANTA ISABEL (SP)";"SP";"SANTA ISABEL";550;46;41;637
2003;"SANTA LUCIA (SP)";"SP";"SANTA LUCIA";112;6;44;162
2003;"SANTA MARIA DA SERRA (SP)";"SP";"SANTA MARIA DA SERRA";141;14;14;169
2003;"SANTA MERCEDES (SP)";"SP";"SANTA MERCEDES";27;5;5;37
2003;"SANTA RITA D OESTE (SP)";"SP";"SANTA RITA D OESTE";27;1;4;32
2003;"SANTA RITA DO PASSA QUATRO (SP)";"SP";"SANTA RITA DO PASSA QUATRO";467;34;28;529
2003;"SANTA ROSA DE VITERBO (SP)";"SP";"SANTA ROSA DE VITERBO";298;29;72;399
2003;"SANTA SALETE (SP)";"SP";"SANTA SALETE";31;1;3;35
2003;"SANTANA DA PONTE PENSA (SP)";"SP";"SANTANA DA PONTE PENSA";27;1;0;28
2003;"SANTANA DE PARNAIBA (SP)";"SP";"SANTANA DE PARNAIBA";1062;133;60;1255
2003;"SANTO ANASTACIO (SP)";"SP";"SANTO ANASTACIO";369;11;41;421
2003;"SANTO ANDRE (SP)";"SP";"SANTO ANDRE";6972;1298;1330;9600
2003;"SANTO ANTONIO DA ALEGRIA (SP)";"SP";"SANTO ANTONIO DA ALEGRIA";71;6;11;88
2003;"SANTO ANTONIO DE POSSE (SP)";"SP";"SANTO ANTONIO DE POSSE";496;20;73;589
2003;"SANTO ANTONIO DO ARACANGUA (SP)";"SP";"SANTO ANTONIO DO ARACANGUA";135;6;40;181
2003;"SANTO ANTONIO DO JARDIM (SP)";"SP";"SANTO ANTONIO DO JARDIM";143;7;6;156
2003;"SANTO ANTONIO DO PINHAL (SP)";"SP";"SANTO ANTONIO DO PINHAL";82;5;2;89
2003;"SANTO EXPEDITO (SP)";"SP";"SANTO EXPEDITO";17;1;5;23
2003;"SANTOPOLIS DO AGUAPEI (SP)";"SP";"SANTOPOLIS DO AGUAPEI";62;3;27;92
2003;"SANTOS (SP)";"SP";"SANTOS";3430;628;456;4514
2003;"SAO BENTO DO SAPUCAI (SP)";"SP";"SAO BENTO DO SAPUCAI";91;24;5;120
2003;"SAO BERNARDO DO CAMPO (SP)";"SP";"SAO BERNARDO DO CAMPO";8387;1432;1907;11726
2003;"SAO CAETANO DO SUL (SP)";"SP";"SAO CAETANO DO SUL";2319;359;403;3081
2003;"SAO CARLOS (SP)";"SP";"SAO CARLOS";2609;211;287;3107
2003;"SAO FRANCISCO (SP)";"SP";"SAO FRANCISCO";28;2;6;36
2003;"SAO JOAO DA BOA VISTA (SP)";"SP";"SAO JOAO DA BOA VISTA";1570;101;61;1732
2003;"SAO JOAO DAS DUAS PONTES (SP)";"SP";"SAO JOAO DAS DUAS PONTES";16;3;6;25
2003;"SAO JOAO DE IRACEMA (SP)";"SP";"SAO JOAO DE IRACEMA";11;1;7;19
2003;"SAO JOAO DO PAU D ALHO (SP)";"SP";"SAO JOAO DO PAU D ALHO";35;5;3;43
2003;"SAO JOAQUIM DA BARRA (SP)";"SP";"SAO JOAQUIM DA BARRA";703;32;116;851
2003;"SAO JOSE DA BELA VISTA (SP)";"SP";"SAO JOSE DA BELA VISTA";57;4;26;87
2003;"SAO JOSE DO BARREIRO (SP)";"SP";"SAO JOSE DO BARREIRO";31;2;3;36
2003;"SAO JOSE DO RIO PARDO (SP)";"SP";"SAO JOSE DO RIO PARDO";1007;43;130;1180
2003;"SAO JOSE DO RIO PRETO (SP)";"SP";"SAO JOSE DO RIO PRETO";5229;352;864;6445
2003;"SAO JOSE DOS CAMPOS (SP)";"SP";"SAO JOSE DOS CAMPOS";4224;987;959;6170
2003;"SAO LOURENCO DA SERRA (SP)";"SP";"SAO LOURENCO DA SERRA";148;12;19;179
2003;"SAO LUIS DO PARAITINGA (SP)";"SP";"SAO LUIS DO PARAITINGA";105;9;12;126
2003;"SAO MANUEL (SP)";"SP";"SAO MANUEL";606;33;72;711
2003;"SAO MIGUEL ARCANJO (SP)";"SP";"SAO MIGUEL ARCANJO";502;31;29;562
2003;"SAO PAULO (SP)";"SP";"SAO PAULO";115961;26946;31149;174056
2003;"SAO PEDRO (SP)";"SP";"SAO PEDRO";421;45;59;525
2003;"SAO PEDRO DO TURVO (SP)";"SP";"SAO PEDRO DO TURVO";118;6;13;137
2003;"SAO ROQUE (SP)";"SP";"SAO ROQUE";655;81;137;873
2003;"SAO SEBASTIAO (SP)";"SP";"SAO SEBASTIAO";394;49;87;530
2003;"SAO SEBASTIAO DA GRAMA (SP)";"SP";"SAO SEBASTIAO DA GRAMA";206;9;22;237
2003;"SAO SIMAO (SP)";"SP";"SAO SIMAO";245;12;33;290
2003;"SAO VICENTE (SP)";"SP";"SAO VICENTE";1189;625;378;2192
2003;"SARAPUI (SP)";"SP";"SARAPUI";97;3;6;106
2003;"SARUTAIA (SP)";"SP";"SARUTAIA";37;5;8;50
2003;"SEBASTIANOPOLIS DO SUL (SP)";"SP";"SEBASTIANOPOLIS DO SUL";38;2;6;46
2003;"SERRA AZUL (SP)";"SP";"SERRA AZUL";102;11;41;154
2003;"SERRA NEGRA (SP)";"SP";"SERRA NEGRA";305;33;44;382
2003;"SERRANA (SP)";"SP";"SERRANA";479;87;131;697
2003;"SERTAOZINHO (SP)";"SP";"SERTAOZINHO";1884;77;285;2246
2003;"SETE BARRAS (SP)";"SP";"SETE BARRAS";151;5;23;179
2003;"SEVERINIA (SP)";"SP";"SEVERINIA";281;6;115;402
2003;"SILVEIRAS (SP)";"SP";"SILVEIRAS";56;6;2;64
2003;"SOCORRO (SP)";"SP";"SOCORRO";531;49;32;612
2003;"SOROCABA (SP)";"SP";"SOROCABA";5584;783;1006;7373
2003;"SUD MENUCCI (SP)";"SP";"SUD MENUCCI";122;5;29;156
2003;"SUMARE (SP)";"SP";"SUMARE";1744;393;280;2417
2003;"SUZANO (SP)";"SP";"SUZANO";2112;210;259;2581
2003;"SUZANOPOLIS (SP)";"SP";"SUZANOPOLIS";44;2;9;55
2003;"TABAPUA (SP)";"SP";"TABAPUA";135;8;35;178
2003;"TABATINGA (SP)";"SP";"TABATINGA";303;6;70;379
2003;"TABOAO DA SERRA (SP)";"SP";"TABOAO DA SERRA";1339;446;346;2131
2003;"TACIBA (SP)";"SP";"TACIBA";59;1;7;67
2003;"TAGUAI (SP)";"SP";"TAGUAI";111;2;12;125
2003;"TAIACU (SP)";"SP";"TAIACU";128;5;11;144
2003;"TAIUVA (SP)";"SP";"TAIUVA";144;2;22;168
2003;"TAMBAU (SP)";"SP";"TAMBAU";428;22;45;495
2003;"TANABI (SP)";"SP";"TANABI";360;14;53;427
2003;"TAPIRAI (SP)";"SP";"TAPIRAI";125;6;12;143
2003;"TAPIRATIBA (SP)";"SP";"TAPIRATIBA";234;10;40;284
2003;"TAQUARAL (SP)";"SP";"TAQUARAL";38;3;14;55
2003;"TAQUARITINGA (SP)";"SP";"TAQUARITINGA";1252;28;187;1467
2003;"TAQUARITUBA (SP)";"SP";"TAQUARITUBA";445;16;43;504
2003;"TAQUARIVAI (SP)";"SP";"TAQUARIVAI";43;5;10;58
2003;"TARABAI (SP)";"SP";"TARABAI";83;3;19;105
2003;"TARUMA (SP)";"SP";"TARUMA";200;6;81;287
2003;"TATUI (SP)";"SP";"TATUI";1263;79;281;1623
2003;"TAUBATE (SP)";"SP";"TAUBATE";2033;450;530;3013
2003;"TEJUPA (SP)";"SP";"TEJUPA";37;5;3;45
2003;"TEODORO SAMPAIO (SP)";"SP";"TEODORO SAMPAIO";145;7;26;178
2003;"TERRA ROXA (SP)";"SP";"TERRA ROXA";156;8;36;200
2003;"TIETE (SP)";"SP";"TIETE";917;24;123;1064
2003;"TIMBURI (SP)";"SP";"TIMBURI";23;3;3;29
2003;"TORRE DE PEDRA (SP)";"SP";"TORRE DE PEDRA";42;2;4;48
2003;"TORRINHA (SP)";"SP";"TORRINHA";297;8;29;334
2003;"TRABIJU (SP)";"SP";"TRABIJU";20;10;7;37
2003;"TREMEMBE (SP)";"SP";"TREMEMBE";311;42;10;363
2003;"TRES FRONTEIRAS (SP)";"SP";"TRES FRONTEIRAS";61;1;6;68
2003;"TUIUTI (SP)";"SP";"TUIUTI";47;8;7;62
2003;"TUPA (SP)";"SP";"TUPA";1101;26;154;1281
2003;"TUPI PAULISTA (SP)";"SP";"TUPI PAULISTA";237;10;11;258
2003;"TURIUBA (SP)";"SP";"TURIUBA";13;2;1;16
2003;"TURMALINA (SP)";"SP";"TURMALINA";31;5;5;41
2003;"UBARANA (SP)";"SP";"UBARANA";69;3;15;87
2003;"UBATUBA (SP)";"SP";"UBATUBA";500;49;77;626
2003;"UBIRAJARA (SP)";"SP";"UBIRAJARA";59;5;7;71
2003;"UCHOA (SP)";"SP";"UCHOA";121;4;23;148
2003;"UNIAO PAULISTA (SP)";"SP";"UNIAO PAULISTA";21;2;3;26
2003;"URANIA (SP)";"SP";"URANIA";121;8;18;147
2003;"URU (SP)";"SP";"URU";15;3;4;22
2003;"URUPES (SP)";"SP";"URUPES";284;9;37;330
2003;"VALENTIM GENTIL (SP)";"SP";"VALENTIM GENTIL";140;13;16;169
2003;"VALINHOS (SP)";"SP";"VALINHOS";1581;278;751;2610
2003;"VALPARAISO (SP)";"SP";"VALPARAISO";255;15;84;354
2003;"VARGEM (SP)";"SP";"VARGEM";147;6;11;164
2003;"VARGEM GRANDE DO SUL (SP)";"SP";"VARGEM GRANDE DO SUL";844;38;110;992
2003;"VARGEM GRANDE PAULISTA (SP)";"SP";"VARGEM GRANDE PAULISTA";647;61;32;740
2003;"VARZEA PAULISTA (SP)";"SP";"VARZEA PAULISTA";646;162;105;913
2003;"VERA CRUZ (SP)";"SP";"VERA CRUZ";118;14;12;144
2003;"VINHEDO (SP)";"SP";"VINHEDO";832;105;56;993
2003;"VIRADOURO (SP)";"SP";"VIRADOURO";325;9;50;384
2003;"VISTA ALEGRE DO ALTO (SP)";"SP";"VISTA ALEGRE DO ALTO";258;14;30;302
2003;"VITORIA BRASIL (SP)";"SP";"VITORIA BRASIL";13;0;5;18
2003;"VOTORANTIM (SP)";"SP";"VOTORANTIM";857;141;37;1035
2003;"VOTUPORANGA (SP)";"SP";"VOTUPORANGA";1326;31;123;1480
2003;"ZACARIAS (SP)";"SP";"ZACARIAS";26;6;10;42
2003;"ABREULANDIA (TO)";"TO";"ABREULANDIA";15;0;0;15
2003;"AGUIARNOPOLIS (TO)";"TO";"AGUIARNOPOLIS";15;1;3;19
2003;"ALIANCA DO TOCANTINS (TO)";"TO";"ALIANCA DO TOCANTINS";55;2;2;59
2003;"ALMAS (TO)";"TO";"ALMAS";19;0;0;19
2003;"ALVORADA (TO)";"TO";"ALVORADA";98;0;6;104
2003;"ANANAS (TO)";"TO";"ANANAS";31;4;6;41
2003;"ANGICO (TO)";"TO";"ANGICO";5;1;0;6
2003;"APARECIDA DO RIO NEGRO (TO)";"TO";"APARECIDA DO RIO NEGRO";14;1;2;17
2003;"ARAGOMINAS (TO)";"TO";"ARAGOMINAS";214;5;3;222
2003;"ARAGUACEMA (TO)";"TO";"ARAGUACEMA";9;1;2;12
2003;"ARAGUACU (TO)";"TO";"ARAGUACU";48;3;2;53
2003;"ARAGUAINA (TO)";"TO";"ARAGUAINA";2032;73;205;2310
2003;"ARAGUANA (TO)";"TO";"ARAGUANA";101;0;2;103
2003;"ARAGUATINS (TO)";"TO";"ARAGUATINS";114;24;40;178
2003;"ARAPOEMA (TO)";"TO";"ARAPOEMA";33;0;5;38
2003;"ARRAIAS (TO)";"TO";"ARRAIAS";22;0;4;26
2003;"AUGUSTINOPOLIS (TO)";"TO";"AUGUSTINOPOLIS";49;29;2;80
2003;"AURORA DO TOCANTINS (TO)";"TO";"AURORA DO TOCANTINS";1;0;0;1
2003;"AXIXA DO TOCANTINS (TO)";"TO";"AXIXA DO TOCANTINS";13;13;3;29
2003;"BABACULANDIA (TO)";"TO";"BABACULANDIA";200;11;6;217
2003;"BANDEIRANTES DO TOCANTINS (TO)";"TO";"BANDEIRANTES DO TOCANTINS";7;1;1;9
2003;"BARRA DO OURO (TO)";"TO";"BARRA DO OURO";0;0;1;1
2003;"BARROLANDIA (TO)";"TO";"BARROLANDIA";21;1;2;24
2003;"BERNARDO SAYAO (TO)";"TO";"BERNARDO SAYAO";18;2;4;24
2003;"BOM JESUS DO TOCANTINS (TO)";"TO";"BOM JESUS DO TOCANTINS";0;2;0;2
2003;"BRASILANDIA DO TOCANTINS (TO)";"TO";"BRASILANDIA DO TOCANTINS";8;1;1;10
2003;"BREJINHO DE NAZARE (TO)";"TO";"BREJINHO DE NAZARE";19;0;2;21
2003;"BURITI DO TOCANTINS (TO)";"TO";"BURITI DO TOCANTINS";11;7;1;19
2003;"CACHOEIRINHA (TO)";"TO";"CACHOEIRINHA";3;1;1;5
2003;"CAMPOS LINDOS (TO)";"TO";"CAMPOS LINDOS";18;0;1;19
2003;"CARIRI DO TOCANTINS (TO)";"TO";"CARIRI DO TOCANTINS";21;1;2;24
2003;"CARMOLANDIA (TO)";"TO";"CARMOLANDIA";347;18;13;378
2003;"CARRASCO BONITO (TO)";"TO";"CARRASCO BONITO";4;3;1;8
2003;"CASEARA (TO)";"TO";"CASEARA";9;3;2;14
2003;"CENTENARIO (TO)";"TO";"CENTENARIO";1;0;0;1
2003;"CHAPADA DA NATIVIDADE (TO)";"TO";"CHAPADA DA NATIVIDADE";8;0;3;11
2003;"CHAPADA DE AREIA (TO)";"TO";"CHAPADA DE AREIA";1;0;2;3
2003;"COLINAS DO TOCANTINS (TO)";"TO";"COLINAS DO TOCANTINS";329;12;21;362
2003;"COLMEIA (TO)";"TO";"COLMEIA";80;5;6;91
2003;"COMBINADO (TO)";"TO";"COMBINADO";6;1;1;8
2003;"CONCEICAO DO TOCANTINS (TO)";"TO";"CONCEICAO DO TOCANTINS";4;1;0;5
2003;"COUTO DE MAGALHAES (TO)";"TO";"COUTO DE MAGALHAES";4;4;0;8
2003;"CRISTALANDIA (TO)";"TO";"CRISTALANDIA";64;0;2;66
2003;"CRIXAS DO TOCANTINS (TO)";"TO";"CRIXAS DO TOCANTINS";2;3;0;5
2003;"DARCINOPOLIS (TO)";"TO";"DARCINOPOLIS";102;17;3;122
2003;"DIANOPOLIS (TO)";"TO";"DIANOPOLIS";55;0;13;68
2003;"DIVINOPOLIS DO TOCANTINS (TO)";"TO";"DIVINOPOLIS DO TOCANTINS";32;1;1;34
2003;"DOIS IRMAOS DO TOCANTINS (TO)";"TO";"DOIS IRMAOS DO TOCANTINS";25;1;2;28
2003;"DUERE (TO)";"TO";"DUERE";14;1;2;17
2003;"ESPERANTINA (TO)";"TO";"ESPERANTINA";6;5;1;12
2003;"FATIMA (TO)";"TO";"FATIMA";20;2;3;25
2003;"FIGUEIROPOLIS (TO)";"TO";"FIGUEIROPOLIS";34;5;0;39
2003;"FILADELFIA (TO)";"TO";"FILADELFIA";26;8;5;39
2003;"FORMOSO DO ARAGUAIA (TO)";"TO";"FORMOSO DO ARAGUAIA";85;3;17;105
2003;"FORTALEZA DO TABOCAO (TO)";"TO";"FORTALEZA DO TABOCAO";13;1;1;15
2003;"GOIANORTE (TO)";"TO";"GOIANORTE";9;0;2;11
2003;"GOIATINS (TO)";"TO";"GOIATINS";7;3;1;11
2003;"GUARAI (TO)";"TO";"GUARAI";200;8;7;215
2003;"GURUPI (TO)";"TO";"GURUPI";945;19;86;1050
2003;"IPUEIRAS (TO)";"TO";"IPUEIRAS";0;0;2;2
2003;"ITACAJA (TO)";"TO";"ITACAJA";12;1;0;13
2003;"ITAGUATINS (TO)";"TO";"ITAGUATINS";17;2;1;20
2003;"ITAPIRATINS (TO)";"TO";"ITAPIRATINS";4;0;4;8
2003;"ITAPORA DO TOCANTINS (TO)";"TO";"ITAPORA DO TOCANTINS";8;1;0;9
2003;"JAU DO TOCANTINS (TO)";"TO";"JAU DO TOCANTINS";7;0;4;11
2003;"JUARINA (TO)";"TO";"JUARINA";7;0;0;7
2003;"LAGOA DA CONFUSAO (TO)";"TO";"LAGOA DA CONFUSAO";23;0;2;25
2003;"LAGOA DO TOCANTINS (TO)";"TO";"LAGOA DO TOCANTINS";4;0;2;6
2003;"LAJEADO (TO)";"TO";"LAJEADO";9;0;10;19
2003;"LAVANDEIRA (TO)";"TO";"LAVANDEIRA";0;1;1;2
2003;"LIZARDA (TO)";"TO";"LIZARDA";2;1;0;3
2003;"LUZINOPOLIS (TO)";"TO";"LUZINOPOLIS";4;0;0;4
2003;"MARIANOPOLIS DO TOCANTINS (TO)";"TO";"MARIANOPOLIS DO TOCANTINS";17;0;3;20
2003;"MATEIROS (TO)";"TO";"MATEIROS";4;0;2;6
2003;"MAURILANDIA DO TOCANTINS (TO)";"TO";"MAURILANDIA DO TOCANTINS";0;0;1;1
2003;"MIRACEMA DO TOCANTINS (TO)";"TO";"MIRACEMA DO TOCANTINS";114;11;38;163
2003;"MIRANORTE (TO)";"TO";"MIRANORTE";120;7;5;132
2003;"MONTE DO CARMO (TO)";"TO";"MONTE DO CARMO";7;0;2;9
2003;"MONTE SANTO DO TOCANTINS (TO)";"TO";"MONTE SANTO DO TOCANTINS";51;2;2;55
2003;"MURICILANDIA (TO)";"TO";"MURICILANDIA";10;0;0;10
2003;"NATIVIDADE (TO)";"TO";"NATIVIDADE";32;1;1;34
2003;"NAZARE (TO)";"TO";"NAZARE";12;1;1;14
2003;"NOVA OLINDA (TO)";"TO";"NOVA OLINDA";38;4;3;45
2003;"NOVA ROSALANDIA (TO)";"TO";"NOVA ROSALANDIA";14;0;2;16
2003;"NOVO ACORDO (TO)";"TO";"NOVO ACORDO";9;0;0;9
2003;"NOVO ALEGRE (TO)";"TO";"NOVO ALEGRE";2;2;0;4
2003;"NOVO JARDIM (TO)";"TO";"NOVO JARDIM";5;0;0;5
2003;"OLIVEIRA DE FATIMA (TO)";"TO";"OLIVEIRA DE FATIMA";4;0;1;5
2003;"PALMAS (TO)";"TO";"PALMAS";1776;131;350;2257
2003;"PALMEIRANTE (TO)";"TO";"PALMEIRANTE";2;0;1;3
2003;"PALMEIRAS DO TOCANTINS (TO)";"TO";"PALMEIRAS DO TOCANTINS";11;1;1;13
2003;"PALMEIROPOLIS (TO)";"TO";"PALMEIROPOLIS";44;1;7;52
2003;"PARAISO DO TOCANTINS (TO)";"TO";"PARAISO DO TOCANTINS";695;16;57;768
2003;"PARANA (TO)";"TO";"PARANA";1;2;1;4
2003;"PAU D ARCO (TO)";"TO";"PAU D ARCO";6;1;1;8
2003;"PEDRO AFONSO (TO)";"TO";"PEDRO AFONSO";39;0;7;46
2003;"PEIXE (TO)";"TO";"PEIXE";56;4;25;85
2003;"PEQUIZEIRO (TO)";"TO";"PEQUIZEIRO";10;0;3;13
2003;"PINDORAMA DO TOCANTINS (TO)";"TO";"PINDORAMA DO TOCANTINS";15;0;2;17
2003;"PIRAQUE (TO)";"TO";"PIRAQUE";2;0;2;4
2003;"PIUM (TO)";"TO";"PIUM";14;0;1;15
2003;"PONTE ALTA DO BOM JESUS (TO)";"TO";"PONTE ALTA DO BOM JESUS";3;0;0;3
2003;"PONTE ALTA DO TOCANTINS (TO)";"TO";"PONTE ALTA DO TOCANTINS";11;3;3;17
2003;"PORTO ALEGRE DO TOCANTINS (TO)";"TO";"PORTO ALEGRE DO TOCANTINS";3;0;0;3
2003;"PORTO NACIONAL (TO)";"TO";"PORTO NACIONAL";419;10;72;501
2003;"PRAIA NORTE (TO)";"TO";"PRAIA NORTE";2;4;0;6
2003;"PRESIDENTE KENNEDY (TO)";"TO";"PRESIDENTE KENNEDY";13;0;0;13
2003;"PUGMIL (TO)";"TO";"PUGMIL";17;2;0;19
2003;"RECURSOLANDIA (TO)";"TO";"RECURSOLANDIA";4;0;0;4
2003;"RIACHINHO (TO)";"TO";"RIACHINHO";101;3;2;106
2003;"RIO DA CONCEICAO (TO)";"TO";"RIO DA CONCEICAO";2;1;1;4
2003;"RIO DOS BOIS (TO)";"TO";"RIO DOS BOIS";3;1;1;5
2003;"RIO SONO (TO)";"TO";"RIO SONO";12;1;2;15
2003;"SAMPAIO (TO)";"TO";"SAMPAIO";4;2;1;7
2003;"SANDOLANDIA (TO)";"TO";"SANDOLANDIA";3;1;1;5
2003;"SANTA FE DO ARAGUAIA (TO)";"TO";"SANTA FE DO ARAGUAIA";22;2;1;25
2003;"SANTA MARIA DO TOCANTINS (TO)";"TO";"SANTA MARIA DO TOCANTINS";2;1;0;3
2003;"SANTA RITA DO TOCANTINS (TO)";"TO";"SANTA RITA DO TOCANTINS";8;0;0;8
2003;"SANTA ROSA DO TOCANTINS (TO)";"TO";"SANTA ROSA DO TOCANTINS";7;1;2;10
2003;"SANTA TEREZA DO TOCANTINS (TO)";"TO";"SANTA TEREZA DO TOCANTINS";3;1;0;4
2003;"SANTA TEREZINHA DO TOCANTINS (TO)";"TO";"SANTA TEREZINHA DO TOCANTINS";4;0;0;4
2003;"SAO BENTO DO TOCANTINS (TO)";"TO";"SAO BENTO DO TOCANTINS";3;0;2;5
2003;"SAO FELIX DO TOCANTINS (TO)";"TO";"SAO FELIX DO TOCANTINS";0;0;0;0
2003;"SAO MIGUEL DO TOCANTINS (TO)";"TO";"SAO MIGUEL DO TOCANTINS";9;4;1;14
2003;"SAO SALVADOR DO TOCANTINS (TO)";"TO";"SAO SALVADOR DO TOCANTINS";7;0;0;7
2003;"SAO SEBASTIAO DO TOCANTINS (TO)";"TO";"SAO SEBASTIAO DO TOCANTINS";4;2;1;7
2003;"SAO VALERIO DA NATIVIDADE (TO)";"TO";"SAO VALERIO DA NATIVIDADE";18;2;3;23
2003;"SILVANOPOLIS (TO)";"TO";"SILVANOPOLIS";10;0;0;10
2003;"SITIO NOVO DO TOCANTINS (TO)";"TO";"SITIO NOVO DO TOCANTINS";22;4;2;28
2003;"SUCUPIRA (TO)";"TO";"SUCUPIRA";2;2;2;6
2003;"TAGUATINGA (TO)";"TO";"TAGUATINGA";38;2;4;44
2003;"TAIPAS DO TOCANTINS (TO)";"TO";"TAIPAS DO TOCANTINS";2;1;0;3
2003;"TALISMA (TO)";"TO";"TALISMA";3;5;0;8
2003;"TOCANTINIA (TO)";"TO";"TOCANTINIA";13;0;1;14
2003;"TOCANTINOPOLIS (TO)";"TO";"TOCANTINOPOLIS";1142;198;109;1449
2003;"TUPIRAMA (TO)";"TO";"TUPIRAMA";4;2;0;6
2003;"TUPIRATINS (TO)";"TO";"TUPIRATINS";2;0;0;2
2003;"WANDERLANDIA (TO)";"TO";"WANDERLANDIA";27;4;4;35
2003;"XAMBIOA (TO)";"TO";"XAMBIOA";36;3;0;39
