"ano";"chave";"UF";"MUNICIPIO";"CAMINHAO";"MICRO_ONIBUS";"ONIBUS";"total"
2005;"ACRELANDIA (AC)";"AC";"ACRELANDIA";54;0;11;65
2005;"ASSIS BRASIL (AC)";"AC";"ASSIS BRASIL";11;0;1;12
2005;"BRASILEIA (AC)";"AC";"BRASILEIA";96;0;3;99
2005;"BUJARI (AC)";"AC";"BUJARI";34;3;2;39
2005;"CAPIXABA (AC)";"AC";"CAPIXABA";16;0;3;19
2005;"CRUZEIRO DO SUL (AC)";"AC";"CRUZEIRO DO SUL";249;23;15;287
2005;"EPITACIOLANDIA (AC)";"AC";"EPITACIOLANDIA";78;1;6;85
2005;"FEIJO (AC)";"AC";"FEIJO";28;1;0;29
2005;"MANCIO LIMA (AC)";"AC";"MANCIO LIMA";16;1;4;21
2005;"MANOEL URBANO (AC)";"AC";"MANOEL URBANO";4;0;0;4
2005;"PLACIDO DE CASTRO (AC)";"AC";"PLACIDO DE CASTRO";45;1;1;47
2005;"PORTO ACRE (AC)";"AC";"PORTO ACRE";45;3;13;61
2005;"RIO BRANCO (AC)";"AC";"RIO BRANCO";2481;81;343;2905
2005;"RODRIGUES ALVES (AC)";"AC";"RODRIGUES ALVES";2;0;0;2
2005;"SANTA ROSA (AC)";"AC";"SANTA ROSA";0;0;0;0
2005;"SENA MADUREIRA (AC)";"AC";"SENA MADUREIRA";42;1;1;44
2005;"SENADOR GUIOMARD (AC)";"AC";"SENADOR GUIOMARD";117;0;6;123
2005;"TARAUACA (AC)";"AC";"TARAUACA";30;0;0;30
2005;"XAPURI (AC)";"AC";"XAPURI";23;0;0;23
2005;"ARAPIRACA (AL)";"AL";"ARAPIRACA";2037;300;240;2577
2005;"ATALAIA (AL)";"AL";"ATALAIA";406;115;126;647
2005;"CAJUEIRO (AL)";"AL";"CAJUEIRO";0;0;0;0
2005;"CAMPO GRANDE (AL)";"AL";"CAMPO GRANDE";0;0;0;0
2005;"CORURIPE (AL)";"AL";"CORURIPE";363;82;201;646
2005;"DELMIRO GOUVEIA (AL)";"AL";"DELMIRO GOUVEIA";483;252;35;770
2005;"GIRAU DO PONCIANO (AL)";"AL";"GIRAU DO PONCIANO";190;41;57;288
2005;"MACEIO (AL)";"AL";"MACEIO";4257;731;1497;6485
2005;"MATRIZ DE CAMARAGIBE (AL)";"AL";"MATRIZ DE CAMARAGIBE";621;230;201;1052
2005;"NOVO LINO (AL)";"AL";"NOVO LINO";0;0;0;0
2005;"PALMEIRA DOS INDIOS (AL)";"AL";"PALMEIRA DOS INDIOS";562;194;93;849
2005;"PENEDO (AL)";"AL";"PENEDO";470;90;230;790
2005;"PORTO DE PEDRAS (AL)";"AL";"PORTO DE PEDRAS";1;0;0;1
2005;"QUEBRANGULO (AL)";"AL";"QUEBRANGULO";0;0;0;0
2005;"SANTANA DO IPANEMA (AL)";"AL";"SANTANA DO IPANEMA";670;116;62;848
2005;"SAO MIGUEL DOS CAMPOS (AL)";"AL";"SAO MIGUEL DOS CAMPOS";752;207;257;1216
2005;"TRAIPU (AL)";"AL";"TRAIPU";0;0;0;0
2005;"UNIAO DOS PALMARES (AL)";"AL";"UNIAO DOS PALMARES";638;216;149;1003
2005;"VICOSA (AL)";"AL";"VICOSA";229;34;40;303
2005;"ALVARAES (AM)";"AM";"ALVARAES";0;0;1;1
2005;"AMATURA (AM)";"AM";"AMATURA";0;0;0;0
2005;"ANAMA (AM)";"AM";"ANAMA";0;0;0;0
2005;"ANORI (AM)";"AM";"ANORI";1;0;0;1
2005;"APUI (AM)";"AM";"APUI";18;1;1;20
2005;"ATALAIA DO NORTE (AM)";"AM";"ATALAIA DO NORTE";1;0;0;1
2005;"AUTAZES (AM)";"AM";"AUTAZES";3;1;2;6
2005;"BARCELOS (AM)";"AM";"BARCELOS";4;1;0;5
2005;"BARREIRINHA (AM)";"AM";"BARREIRINHA";0;0;0;0
2005;"BENJAMIN CONSTANT (AM)";"AM";"BENJAMIN CONSTANT";2;1;1;4
2005;"BERURI (AM)";"AM";"BERURI";0;0;0;0
2005;"BOA VISTA DO RAMOS (AM)";"AM";"BOA VISTA DO RAMOS";1;0;0;1
2005;"BOCA DO ACRE (AM)";"AM";"BOCA DO ACRE";16;2;0;18
2005;"BORBA (AM)";"AM";"BORBA";2;0;0;2
2005;"CAAPIRANGA (AM)";"AM";"CAAPIRANGA";4;1;1;6
2005;"CANUTAMA (AM)";"AM";"CANUTAMA";0;0;0;0
2005;"CARAUARI (AM)";"AM";"CARAUARI";7;1;0;8
2005;"CAREIRO (AM)";"AM";"CAREIRO";17;3;22;42
2005;"CAREIRO DA VARZEA (AM)";"AM";"CAREIRO DA VARZEA";6;5;7;18
2005;"COARI (AM)";"AM";"COARI";46;3;2;51
2005;"CODAJAS (AM)";"AM";"CODAJAS";2;0;0;2
2005;"EIRUNEPE (AM)";"AM";"EIRUNEPE";11;0;0;11
2005;"ENVIRA (AM)";"AM";"ENVIRA";4;0;1;5
2005;"FONTE BOA (AM)";"AM";"FONTE BOA";10;0;0;10
2005;"GUAJARA (AM)";"AM";"GUAJARA";0;0;0;0
2005;"HUMAITA (AM)";"AM";"HUMAITA";60;0;7;67
2005;"IPIXUNA (AM)";"AM";"IPIXUNA";1;0;0;1
2005;"IRANDUBA (AM)";"AM";"IRANDUBA";74;4;19;97
2005;"ITACOATIARA (AM)";"AM";"ITACOATIARA";204;14;53;271
2005;"ITAMARATI (AM)";"AM";"ITAMARATI";2;0;0;2
2005;"ITAPIRANGA (AM)";"AM";"ITAPIRANGA";1;0;0;1
2005;"JAPURA (AM)";"AM";"JAPURA";2;0;0;2
2005;"JURUA (AM)";"AM";"JURUA";3;0;0;3
2005;"JUTAI (AM)";"AM";"JUTAI";1;0;0;1
2005;"LABREA (AM)";"AM";"LABREA";9;0;1;10
2005;"MANACAPURU (AM)";"AM";"MANACAPURU";128;8;51;187
2005;"MANAQUIRI (AM)";"AM";"MANAQUIRI";2;0;0;2
2005;"MANAUS (AM)";"AM";"MANAUS";10477;1516;4042;16035
2005;"MANICORE (AM)";"AM";"MANICORE";7;1;1;9
2005;"MARAA (AM)";"AM";"MARAA";1;0;0;1
2005;"MAUES (AM)";"AM";"MAUES";20;0;2;22
2005;"NHAMUNDA (AM)";"AM";"NHAMUNDA";3;0;0;3
2005;"NOVA OLINDA DO NORTE (AM)";"AM";"NOVA OLINDA DO NORTE";4;1;2;7
2005;"NOVO AIRAO (AM)";"AM";"NOVO AIRAO";8;0;2;10
2005;"NOVO ARIPUANA (AM)";"AM";"NOVO ARIPUANA";7;0;4;11
2005;"PARINTINS (AM)";"AM";"PARINTINS";85;2;7;94
2005;"PAUINI (AM)";"AM";"PAUINI";3;1;0;4
2005;"PRESIDENTE FIGUEIREDO (AM)";"AM";"PRESIDENTE FIGUEIREDO";127;15;30;172
2005;"RIO PRETO DA EVA (AM)";"AM";"RIO PRETO DA EVA";37;4;16;57
2005;"SANTA ISABEL DO RIO NEGRO (AM)";"AM";"SANTA ISABEL DO RIO NEGRO";5;2;3;10
2005;"SANTO ANTONIO DO ICA (AM)";"AM";"SANTO ANTONIO DO ICA";5;0;0;5
2005;"SAO GABRIEL DA CACHOEIRA (AM)";"AM";"SAO GABRIEL DA CACHOEIRA";58;7;8;73
2005;"SAO PAULO DE OLIVENCA (AM)";"AM";"SAO PAULO DE OLIVENCA";1;0;0;1
2005;"SAO SEBASTIAO DO UATUMA (AM)";"AM";"SAO SEBASTIAO DO UATUMA";1;0;0;1
2005;"SILVES (AM)";"AM";"SILVES";5;2;1;8
2005;"TABATINGA (AM)";"AM";"TABATINGA";26;2;1;29
2005;"TAPAUA (AM)";"AM";"TAPAUA";1;0;1;2
2005;"TEFE (AM)";"AM";"TEFE";28;2;1;31
2005;"TONANTINS (AM)";"AM";"TONANTINS";0;1;0;1
2005;"UARINI (AM)";"AM";"UARINI";1;0;0;1
2005;"URUCARA (AM)";"AM";"URUCARA";4;1;1;6
2005;"URUCURITUBA (AM)";"AM";"URUCURITUBA";2;0;0;2
2005;"AMAPA (AP)";"AP";"AMAPA";4;1;0;5
2005;"AMAPARI (AP)";"AP";"AMAPARI";1;0;0;1
2005;"CALCOENE (AP)";"AP";"CALCOENE";0;0;1;1
2005;"CUTIAS (AP)";"AP";"CUTIAS";1;0;0;1
2005;"FERREIRA GOMES (AP)";"AP";"FERREIRA GOMES";1;0;0;1
2005;"ITAUBAL (AP)";"AP";"ITAUBAL";1;0;2;3
2005;"LARANJAL DO JARI (AP)";"AP";"LARANJAL DO JARI";38;4;4;46
2005;"MACAPA (AP)";"AP";"MACAPA";1760;141;405;2306
2005;"MAZAGAO (AP)";"AP";"MAZAGAO";7;1;6;14
2005;"OIAPOQUE (AP)";"AP";"OIAPOQUE";42;3;3;48
2005;"PORTO GRANDE (AP)";"AP";"PORTO GRANDE";15;0;6;21
2005;"PRACUUBA (AP)";"AP";"PRACUUBA";2;0;0;2
2005;"SANTANA (AP)";"AP";"SANTANA";384;19;30;433
2005;"SERRA DO NAVIO (AP)";"AP";"SERRA DO NAVIO";0;1;0;1
2005;"TARTARUGALZINHO (AP)";"AP";"TARTARUGALZINHO";4;0;0;4
2005;"VITORIA DO JARI (AP)";"AP";"VITORIA DO JARI";0;0;1;1
2005;"ABAIRA (BA)";"BA";"ABAIRA";35;6;11;52
2005;"ABARE (BA)";"BA";"ABARE";20;3;12;35
2005;"ACAJUTIBA (BA)";"BA";"ACAJUTIBA";24;6;10;40
2005;"ADUSTINA (BA)";"BA";"ADUSTINA";11;5;2;18
2005;"AGUA FRIA (BA)";"BA";"AGUA FRIA";7;4;12;23
2005;"AIQUARA (BA)";"BA";"AIQUARA";6;1;1;8
2005;"ALAGOINHAS (BA)";"BA";"ALAGOINHAS";806;97;262;1165
2005;"ALCOBACA (BA)";"BA";"ALCOBACA";18;0;4;22
2005;"ALMADINA (BA)";"BA";"ALMADINA";8;0;2;10
2005;"AMARGOSA (BA)";"BA";"AMARGOSA";168;21;34;223
2005;"AMELIA RODRIGUES (BA)";"BA";"AMELIA RODRIGUES";113;28;19;160
2005;"AMERICA DOURADA (BA)";"BA";"AMERICA DOURADA";17;3;2;22
2005;"ANAGE (BA)";"BA";"ANAGE";37;17;19;73
2005;"ANDARAI (BA)";"BA";"ANDARAI";12;1;2;15
2005;"ANDORINHA (BA)";"BA";"ANDORINHA";38;4;19;61
2005;"ANGICAL (BA)";"BA";"ANGICAL";13;5;8;26
2005;"ANGUERA (BA)";"BA";"ANGUERA";10;4;6;20
2005;"ANTAS (BA)";"BA";"ANTAS";19;4;5;28
2005;"ANTONIO CARDOSO (BA)";"BA";"ANTONIO CARDOSO";0;18;7;25
2005;"ANTONIO GONCALVES (BA)";"BA";"ANTONIO GONCALVES";12;2;6;20
2005;"APORA (BA)";"BA";"APORA";20;9;8;37
2005;"APUAREMA (BA)";"BA";"APUAREMA";18;0;6;24
2005;"ARACAS (BA)";"BA";"ARACAS";34;14;17;65
2005;"ARACATU (BA)";"BA";"ARACATU";40;6;11;57
2005;"ARACI (BA)";"BA";"ARACI";97;3;29;129
2005;"ARAMARI (BA)";"BA";"ARAMARI";10;2;4;16
2005;"ARATACA (BA)";"BA";"ARATACA";11;0;1;12
2005;"ARATUIPE (BA)";"BA";"ARATUIPE";19;0;8;27
2005;"AURELINO LEAL (BA)";"BA";"AURELINO LEAL";33;2;4;39
2005;"BAIANOPOLIS (BA)";"BA";"BAIANOPOLIS";35;2;6;43
2005;"BAIXA GRANDE (BA)";"BA";"BAIXA GRANDE";38;9;19;66
2005;"BANZAE (BA)";"BA";"BANZAE";14;3;18;35
2005;"BARRA (BA)";"BA";"BARRA";24;4;8;36
2005;"BARRA DA ESTIVA (BA)";"BA";"BARRA DA ESTIVA";116;8;21;145
2005;"BARRA DO CHOCA (BA)";"BA";"BARRA DO CHOCA";69;33;13;115
2005;"BARRA DO MENDES (BA)";"BA";"BARRA DO MENDES";30;6;4;40
2005;"BARRA DO ROCHA (BA)";"BA";"BARRA DO ROCHA";5;2;0;7
2005;"BARREIRAS (BA)";"BA";"BARREIRAS";1584;64;198;1846
2005;"BARRO ALTO (BA)";"BA";"BARRO ALTO";27;3;9;39
2005;"BARRO PRETO (BA)";"BA";"BARRO PRETO";12;1;6;19
2005;"BARROCAS (BA)";"BA";"BARROCAS";51;2;5;58
2005;"BELMONTE (BA)";"BA";"BELMONTE";32;0;2;34
2005;"BELO CAMPO (BA)";"BA";"BELO CAMPO";44;5;11;60
2005;"BIRITINGA (BA)";"BA";"BIRITINGA";13;6;16;35
2005;"BOA NOVA (BA)";"BA";"BOA NOVA";15;9;14;38
2005;"BOA VISTA DO TUPIM (BA)";"BA";"BOA VISTA DO TUPIM";37;4;6;47
2005;"BOM JESUS DA LAPA (BA)";"BA";"BOM JESUS DA LAPA";287;20;58;365
2005;"BOM JESUS DA SERRA (BA)";"BA";"BOM JESUS DA SERRA";12;14;10;36
2005;"BONINAL (BA)";"BA";"BONINAL";49;6;14;69
2005;"BONITO (BA)";"BA";"BONITO";26;1;4;31
2005;"BOQUIRA (BA)";"BA";"BOQUIRA";53;5;31;89
2005;"BOTUPORA (BA)";"BA";"BOTUPORA";21;3;13;37
2005;"BREJOES (BA)";"BA";"BREJOES";59;2;18;79
2005;"BREJOLANDIA (BA)";"BA";"BREJOLANDIA";19;3;9;31
2005;"BROTAS DE MACAUBAS (BA)";"BA";"BROTAS DE MACAUBAS";12;4;8;24
2005;"BRUMADO (BA)";"BA";"BRUMADO";769;88;138;995
2005;"BUERAREMA (BA)";"BA";"BUERAREMA";91;2;15;108
2005;"BURITIRAMA (BA)";"BA";"BURITIRAMA";7;1;8;16
2005;"CAATIBA (BA)";"BA";"CAATIBA";4;1;0;5
2005;"CABACEIRAS DO PARAGUACU (BA)";"BA";"CABACEIRAS DO PARAGUACU";24;4;19;47
2005;"CACHOEIRA (BA)";"BA";"CACHOEIRA";61;46;47;154
2005;"CACULE (BA)";"BA";"CACULE";175;14;16;205
2005;"CAEM (BA)";"BA";"CAEM";11;3;7;21
2005;"CAETANOS (BA)";"BA";"CAETANOS";19;5;5;29
2005;"CAETITE (BA)";"BA";"CAETITE";327;22;37;386
2005;"CAFARNAUM (BA)";"BA";"CAFARNAUM";32;1;7;40
2005;"CAIRU (BA)";"BA";"CAIRU";5;2;2;9
2005;"CALDEIRAO GRANDE (BA)";"BA";"CALDEIRAO GRANDE";15;3;5;23
2005;"CAMACAN (BA)";"BA";"CAMACAN";168;9;30;207
2005;"CAMACARI (BA)";"BA";"CAMACARI";1058;205;479;1742
2005;"CAMAMU (BA)";"BA";"CAMAMU";77;13;15;105
2005;"CAMPO ALEGRE DE LOURDES (BA)";"BA";"CAMPO ALEGRE DE LOURDES";29;3;0;32
2005;"CAMPO FORMOSO (BA)";"BA";"CAMPO FORMOSO";130;12;55;197
2005;"CANAPOLIS (BA)";"BA";"CANAPOLIS";9;7;11;27
2005;"CANARANA (BA)";"BA";"CANARANA";81;5;4;90
2005;"CANAVIEIRAS (BA)";"BA";"CANAVIEIRAS";50;5;4;59
2005;"CANDEAL (BA)";"BA";"CANDEAL";16;8;2;26
2005;"CANDEIAS (BA)";"BA";"CANDEIAS";426;128;176;730
2005;"CANDIBA (BA)";"BA";"CANDIBA";39;2;13;54
2005;"CANDIDO SALES (BA)";"BA";"CANDIDO SALES";257;13;24;294
2005;"CANSANCAO (BA)";"BA";"CANSANCAO";94;10;21;125
2005;"CANUDOS (BA)";"BA";"CANUDOS";23;2;16;41
2005;"CAPELA DO ALTO ALEGRE (BA)";"BA";"CAPELA DO ALTO ALEGRE";38;7;17;62
2005;"CAPIM GROSSO (BA)";"BA";"CAPIM GROSSO";353;18;24;395
2005;"CARAIBAS (BA)";"BA";"CARAIBAS";19;6;9;34
2005;"CARAVELAS (BA)";"BA";"CARAVELAS";14;4;27;45
2005;"CARDEAL DA SILVA (BA)";"BA";"CARDEAL DA SILVA";14;4;2;20
2005;"CARINHANHA (BA)";"BA";"CARINHANHA";88;2;13;103
2005;"CASA NOVA (BA)";"BA";"CASA NOVA";178;95;83;356
2005;"CASTRO ALVES (BA)";"BA";"CASTRO ALVES";91;7;26;124
2005;"CATOLANDIA (BA)";"BA";"CATOLANDIA";3;2;2;7
2005;"CATU (BA)";"BA";"CATU";257;71;71;399
2005;"CATURAMA (BA)";"BA";"CATURAMA";9;1;8;18
2005;"CENTRAL (BA)";"BA";"CENTRAL";56;3;5;64
2005;"CHORROCHO (BA)";"BA";"CHORROCHO";5;1;3;9
2005;"CICERO DANTAS (BA)";"BA";"CICERO DANTAS";59;10;19;88
2005;"CIPO (BA)";"BA";"CIPO";31;2;1;34
2005;"COARACI (BA)";"BA";"COARACI";69;2;12;83
2005;"COCOS (BA)";"BA";"COCOS";48;3;16;67
2005;"CONCEICAO DA FEIRA (BA)";"BA";"CONCEICAO DA FEIRA";147;42;13;202
2005;"CONCEICAO DO ALMEIDA (BA)";"BA";"CONCEICAO DO ALMEIDA";69;14;10;93
2005;"CONCEICAO DO COITE (BA)";"BA";"CONCEICAO DO COITE";304;39;49;392
2005;"CONCEICAO DO JACUIPE (BA)";"BA";"CONCEICAO DO JACUIPE";119;78;8;205
2005;"CONDE (BA)";"BA";"CONDE";28;7;3;38
2005;"CONDEUBA (BA)";"BA";"CONDEUBA";80;14;29;123
2005;"CONTENDAS DO SINCORA (BA)";"BA";"CONTENDAS DO SINCORA";5;3;3;11
2005;"CORACAO DE MARIA (BA)";"BA";"CORACAO DE MARIA";80;16;31;127
2005;"CORDEIROS (BA)";"BA";"CORDEIROS";18;7;9;34
2005;"CORIBE (BA)";"BA";"CORIBE";24;9;10;43
2005;"CORONEL JOAO SA (BA)";"BA";"CORONEL JOAO SA";18;2;18;38
2005;"CORRENTINA (BA)";"BA";"CORRENTINA";79;8;31;118
2005;"COTEGIPE (BA)";"BA";"COTEGIPE";17;5;6;28
2005;"CRAVOLANDIA (BA)";"BA";"CRAVOLANDIA";11;2;1;14
2005;"CRISOPOLIS (BA)";"BA";"CRISOPOLIS";46;6;12;64
2005;"CRISTOPOLIS (BA)";"BA";"CRISTOPOLIS";37;2;11;50
2005;"CRUZ DAS ALMAS (BA)";"BA";"CRUZ DAS ALMAS";620;98;33;751
2005;"CURACA (BA)";"BA";"CURACA";29;16;19;64
2005;"DARIO MEIRA (BA)";"BA";"DARIO MEIRA";10;4;3;17
2005;"DIAS D AVILA (BA)";"BA";"DIAS D AVILA";416;38;241;695
2005;"DOM BASILIO (BA)";"BA";"DOM BASILIO";149;3;13;165
2005;"DOM MACEDO COSTA (BA)";"BA";"DOM MACEDO COSTA";12;2;4;18
2005;"ELISIO MEDRADO (BA)";"BA";"ELISIO MEDRADO";15;6;8;29
2005;"ENCRUZILHADA (BA)";"BA";"ENCRUZILHADA";49;12;13;74
2005;"ENTRE RIOS (BA)";"BA";"ENTRE RIOS";131;30;44;205
2005;"ERICO CARDOSO (BA)";"BA";"ERICO CARDOSO";19;1;8;28
2005;"ESPLANADA (BA)";"BA";"ESPLANADA";70;20;29;119
2005;"EUCLIDES DA CUNHA (BA)";"BA";"EUCLIDES DA CUNHA";174;11;89;274
2005;"EUNAPOLIS (BA)";"BA";"EUNAPOLIS";845;30;201;1076
2005;"FATIMA (BA)";"BA";"FATIMA";10;2;6;18
2005;"FEIRA DA MATA (BA)";"BA";"FEIRA DA MATA";6;2;6;14
2005;"FEIRA DE SANTANA (BA)";"BA";"FEIRA DE SANTANA";5273;543;775;6591
2005;"FILADELFIA (BA)";"BA";"FILADELFIA";51;5;8;64
2005;"FIRMINO ALVES (BA)";"BA";"FIRMINO ALVES";6;0;1;7
2005;"FLORESTA AZUL (BA)";"BA";"FLORESTA AZUL";13;1;0;14
2005;"FORMOSA DO RIO PRETO (BA)";"BA";"FORMOSA DO RIO PRETO";43;1;5;49
2005;"GANDU (BA)";"BA";"GANDU";196;10;15;221
2005;"GAVIAO (BA)";"BA";"GAVIAO";13;4;2;19
2005;"GENTIO DO OURO (BA)";"BA";"GENTIO DO OURO";8;2;1;11
2005;"GLORIA (BA)";"BA";"GLORIA";39;13;24;76
2005;"GONGOGI (BA)";"BA";"GONGOGI";6;1;1;8
2005;"GOVERNADOR MANGABEIRA (BA)";"BA";"GOVERNADOR MANGABEIRA";118;18;26;162
2005;"GUAJERU (BA)";"BA";"GUAJERU";7;11;4;22
2005;"GUANAMBI (BA)";"BA";"GUANAMBI";901;44;114;1059
2005;"GUARATINGA (BA)";"BA";"GUARATINGA";45;4;12;61
2005;"HELIOPOLIS (BA)";"BA";"HELIOPOLIS";12;2;2;16
2005;"IACU (BA)";"BA";"IACU";85;4;10;99
2005;"IBIASSUCE (BA)";"BA";"IBIASSUCE";41;7;4;52
2005;"IBICARAI (BA)";"BA";"IBICARAI";106;8;14;128
2005;"IBICOARA (BA)";"BA";"IBICOARA";99;8;31;138
2005;"IBICUI (BA)";"BA";"IBICUI";29;5;6;40
2005;"IBIPEBA (BA)";"BA";"IBIPEBA";25;6;3;34
2005;"IBIPITANGA (BA)";"BA";"IBIPITANGA";38;10;22;70
2005;"IBIQUERA (BA)";"BA";"IBIQUERA";5;1;0;6
2005;"IBIRAPITANGA (BA)";"BA";"IBIRAPITANGA";34;1;4;39
2005;"IBIRAPUA (BA)";"BA";"IBIRAPUA";18;3;2;23
2005;"IBIRATAIA (BA)";"BA";"IBIRATAIA";62;16;4;82
2005;"IBITIARA (BA)";"BA";"IBITIARA";52;8;14;74
2005;"IBITITA (BA)";"BA";"IBITITA";32;1;5;38
2005;"IBOTIRAMA (BA)";"BA";"IBOTIRAMA";136;21;11;168
2005;"ICHU (BA)";"BA";"ICHU";14;6;5;25
2005;"IGAPORA (BA)";"BA";"IGAPORA";80;9;9;98
2005;"IGRAPIUNA (BA)";"BA";"IGRAPIUNA";20;4;13;37
2005;"IGUAI (BA)";"BA";"IGUAI";41;10;21;72
2005;"ILHEUS (BA)";"BA";"ILHEUS";417;88;233;738
2005;"INHAMBUPE (BA)";"BA";"INHAMBUPE";98;34;41;173
2005;"IPECAETA (BA)";"BA";"IPECAETA";4;4;21;29
2005;"IPIAU (BA)";"BA";"IPIAU";286;16;13;315
2005;"IPIRA (BA)";"BA";"IPIRA";279;20;49;348
2005;"IPUPIARA (BA)";"BA";"IPUPIARA";22;7;0;29
2005;"IRAJUBA (BA)";"BA";"IRAJUBA";17;3;9;29
2005;"IRAMAIA (BA)";"BA";"IRAMAIA";17;1;5;23
2005;"IRAQUARA (BA)";"BA";"IRAQUARA";76;5;11;92
2005;"IRARA (BA)";"BA";"IRARA";81;21;35;137
2005;"IRECE (BA)";"BA";"IRECE";497;24;31;552
2005;"ITABELA (BA)";"BA";"ITABELA";172;3;32;207
2005;"ITABERABA (BA)";"BA";"ITABERABA";301;27;27;355
2005;"ITABUNA (BA)";"BA";"ITABUNA";1269;47;559;1875
2005;"ITACARE (BA)";"BA";"ITACARE";6;14;2;22
2005;"ITAETE (BA)";"BA";"ITAETE";46;1;10;57
2005;"ITAGI (BA)";"BA";"ITAGI";16;2;3;21
2005;"ITAGIBA (BA)";"BA";"ITAGIBA";15;8;6;29
2005;"ITAGIMIRIM (BA)";"BA";"ITAGIMIRIM";32;0;4;36
2005;"ITAGUACU DA BAHIA (BA)";"BA";"ITAGUACU DA BAHIA";14;0;6;20
2005;"ITAJU DO COLONIA (BA)";"BA";"ITAJU DO COLONIA";7;0;4;11
2005;"ITAJUIPE (BA)";"BA";"ITAJUIPE";61;3;9;73
2005;"ITAMARAJU (BA)";"BA";"ITAMARAJU";312;5;83;400
2005;"ITAMARI (BA)";"BA";"ITAMARI";29;0;0;29
2005;"ITAMBE (BA)";"BA";"ITAMBE";41;6;4;51
2005;"ITANAGRA (BA)";"BA";"ITANAGRA";8;0;0;8
2005;"ITANHEM (BA)";"BA";"ITANHEM";24;2;10;36
2005;"ITAPARICA (BA)";"BA";"ITAPARICA";16;23;20;59
2005;"ITAPE (BA)";"BA";"ITAPE";15;0;0;15
2005;"ITAPEBI (BA)";"BA";"ITAPEBI";38;1;2;41
2005;"ITAPETINGA (BA)";"BA";"ITAPETINGA";412;23;61;496
2005;"ITAPICURU (BA)";"BA";"ITAPICURU";14;9;19;42
2005;"ITAPITANGA (BA)";"BA";"ITAPITANGA";7;2;0;9
2005;"ITAQUARA (BA)";"BA";"ITAQUARA";14;1;0;15
2005;"ITARANTIM (BA)";"BA";"ITARANTIM";47;1;2;50
2005;"ITATIM (BA)";"BA";"ITATIM";79;4;15;98
2005;"ITIRUCU (BA)";"BA";"ITIRUCU";98;2;5;105
2005;"ITIUBA (BA)";"BA";"ITIUBA";49;9;34;92
2005;"ITORORO (BA)";"BA";"ITORORO";68;6;12;86
2005;"ITUACU (BA)";"BA";"ITUACU";87;4;6;97
2005;"ITUBERA (BA)";"BA";"ITUBERA";96;7;12;115
2005;"IUIU (BA)";"BA";"IUIU";16;4;0;20
2005;"JABORANDI (BA)";"BA";"JABORANDI";28;2;15;45
2005;"JACARACI (BA)";"BA";"JACARACI";26;7;15;48
2005;"JACOBINA (BA)";"BA";"JACOBINA";537;40;100;677
2005;"JAGUAQUARA (BA)";"BA";"JAGUAQUARA";372;7;37;416
2005;"JAGUARARI (BA)";"BA";"JAGUARARI";106;20;38;164
2005;"JAGUARIPE (BA)";"BA";"JAGUARIPE";26;2;8;36
2005;"JANDAIRA (BA)";"BA";"JANDAIRA";13;0;4;17
2005;"JEQUIE (BA)";"BA";"JEQUIE";1102;45;245;1392
2005;"JEREMOABO (BA)";"BA";"JEREMOABO";80;9;20;109
2005;"JIQUIRICA (BA)";"BA";"JIQUIRICA";24;7;9;40
2005;"JITAUNA (BA)";"BA";"JITAUNA";27;6;3;36
2005;"JOAO DOURADO (BA)";"BA";"JOAO DOURADO";56;5;9;70
2005;"JUAZEIRO (BA)";"BA";"JUAZEIRO";2023;368;510;2901
2005;"JUCURUCU (BA)";"BA";"JUCURUCU";11;0;3;14
2005;"JUSSARA (BA)";"BA";"JUSSARA";33;4;9;46
2005;"JUSSARI (BA)";"BA";"JUSSARI";11;0;0;11
2005;"JUSSIAPE (BA)";"BA";"JUSSIAPE";34;4;4;42
2005;"LAFAIETE COUTINHO (BA)";"BA";"LAFAIETE COUTINHO";4;0;3;7
2005;"LAGEDO DO TABOCAL (BA)";"BA";"LAGEDO DO TABOCAL";19;1;5;25
2005;"LAGOA REAL (BA)";"BA";"LAGOA REAL";15;2;11;28
2005;"LAJE (BA)";"BA";"LAJE";83;14;20;117
2005;"LAJEDAO (BA)";"BA";"LAJEDAO";6;0;4;10
2005;"LAJEDINHO (BA)";"BA";"LAJEDINHO";7;1;1;9
2005;"LAMARAO (BA)";"BA";"LAMARAO";2;1;1;4
2005;"LAPAO (BA)";"BA";"LAPAO";64;7;16;87
2005;"LAURO DE FREITAS (BA)";"BA";"LAURO DE FREITAS";1314;291;246;1851
2005;"LENCOIS (BA)";"BA";"LENCOIS";9;8;0;17
2005;"LICINIO DE ALMEIDA (BA)";"BA";"LICINIO DE ALMEIDA";83;7;9;99
2005;"LIVRAMENTO DO BRUMADO (BA)";"BA";"LIVRAMENTO DO BRUMADO";232;32;43;307
2005;"LUIZ EDUARDO MAGALHAES (BA)";"BA";"LUIZ EDUARDO MAGALHAES";541;17;32;590
2005;"MACAJUBA (BA)";"BA";"MACAJUBA";12;5;14;31
2005;"MACAUBAS (BA)";"BA";"MACAUBAS";131;11;204;346
2005;"MACURURE (BA)";"BA";"MACURURE";5;2;2;9
2005;"MADRE DE DEUS (BA)";"BA";"MADRE DE DEUS";55;6;17;78
2005;"MAETINGA (BA)";"BA";"MAETINGA";14;2;6;22
2005;"MAIQUINIQUE (BA)";"BA";"MAIQUINIQUE";32;4;6;42
2005;"MAIRI (BA)";"BA";"MAIRI";44;7;22;73
2005;"MALHADA (BA)";"BA";"MALHADA";18;3;5;26
2005;"MALHADA DAS PEDRAS (BA)";"BA";"MALHADA DAS PEDRAS";38;12;11;61
2005;"MANOEL VITORINO (BA)";"BA";"MANOEL VITORINO";31;1;4;36
2005;"MANSIDAO (BA)";"BA";"MANSIDAO";2;0;0;2
2005;"MARACANI (BA)";"BA";"MARACANI";54;3;8;65
2005;"MARACAS (BA)";"BA";"MARACAS";140;6;28;174
2005;"MARAGOGIPE (BA)";"BA";"MARAGOGIPE";89;7;16;112
2005;"MARAU (BA)";"BA";"MARAU";5;0;0;5
2005;"MARCIONILIO SOUZA (BA)";"BA";"MARCIONILIO SOUZA";14;3;8;25
2005;"MASCOTE (BA)";"BA";"MASCOTE";33;2;3;38
2005;"MATA DE SAO JOAO (BA)";"BA";"MATA DE SAO JOAO";122;23;29;174
2005;"MATINA (BA)";"BA";"MATINA";10;0;5;15
2005;"MEDEIROS NETO (BA)";"BA";"MEDEIROS NETO";56;5;11;72
2005;"MIGUEL CALMON (BA)";"BA";"MIGUEL CALMON";75;4;21;100
2005;"MILAGRES (BA)";"BA";"MILAGRES";104;4;9;117
2005;"MIRANGABA (BA)";"BA";"MIRANGABA";27;6;13;46
2005;"MIRANTE (BA)";"BA";"MIRANTE";19;6;10;35
2005;"MONTE SANTO (BA)";"BA";"MONTE SANTO";68;8;51;127
2005;"MORPARA (BA)";"BA";"MORPARA";5;1;0;6
2005;"MORRO DO CHAPEU (BA)";"BA";"MORRO DO CHAPEU";72;14;15;101
2005;"MORTUGABA (BA)";"BA";"MORTUGABA";36;3;7;46
2005;"MUCUGE (BA)";"BA";"MUCUGE";61;3;13;77
2005;"MUCURI (BA)";"BA";"MUCURI";58;8;29;95
2005;"MULUNGU DO MORRO (BA)";"BA";"MULUNGU DO MORRO";21;0;1;22
2005;"MUNDO NOVO (BA)";"BA";"MUNDO NOVO";42;4;17;63
2005;"MUNIZ FERREIRA (BA)";"BA";"MUNIZ FERREIRA";43;40;4;87
2005;"MUQUEM DO SAO FRANCISCO (BA)";"BA";"MUQUEM DO SAO FRANCISCO";7;5;8;20
2005;"MURITIBA (BA)";"BA";"MURITIBA";288;25;15;328
2005;"MUTUIPE (BA)";"BA";"MUTUIPE";85;33;22;140
2005;"NAZARE (BA)";"BA";"NAZARE";157;32;12;201
2005;"NILO PECANHA (BA)";"BA";"NILO PECANHA";21;7;5;33
2005;"NORDESTINA (BA)";"BA";"NORDESTINA";19;2;11;32
2005;"NOVA CANAA (BA)";"BA";"NOVA CANAA";29;2;7;38
2005;"NOVA FATIMA (BA)";"BA";"NOVA FATIMA";35;1;5;41
2005;"NOVA IBIA (BA)";"BA";"NOVA IBIA";16;0;4;20
2005;"NOVA ITARANA (BA)";"BA";"NOVA ITARANA";14;3;3;20
2005;"NOVA REDENCAO (BA)";"BA";"NOVA REDENCAO";9;4;2;15
2005;"NOVA SOURE (BA)";"BA";"NOVA SOURE";30;2;9;41
2005;"NOVA VICOSA (BA)";"BA";"NOVA VICOSA";56;7;26;89
2005;"NOVO HORIZONTE (BA)";"BA";"NOVO HORIZONTE";17;3;5;25
2005;"NOVO TRIUNFO (BA)";"BA";"NOVO TRIUNFO";2;1;1;4
2005;"OLINDINA (BA)";"BA";"OLINDINA";69;13;29;111
2005;"OLIVEIRA DOS BREJINHOS (BA)";"BA";"OLIVEIRA DOS BREJINHOS";36;9;6;51
2005;"OURICANGAS (BA)";"BA";"OURICANGAS";15;5;12;32
2005;"OUROLANDIA (BA)";"BA";"OUROLANDIA";23;6;2;31
2005;"PALMAS DE MONTE ALTO (BA)";"BA";"PALMAS DE MONTE ALTO";32;3;10;45
2005;"PALMEIRAS (BA)";"BA";"PALMEIRAS";25;5;1;31
2005;"PARAMIRIM (BA)";"BA";"PARAMIRIM";104;2;42;148
2005;"PARATINGA (BA)";"BA";"PARATINGA";30;14;26;70
2005;"PARIPIRANGA (BA)";"BA";"PARIPIRANGA";69;3;18;90
2005;"PAU BRASIL (BA)";"BA";"PAU BRASIL";21;3;5;29
2005;"PAULO AFONSO (BA)";"BA";"PAULO AFONSO";672;151;189;1012
2005;"PE DE SERRA (BA)";"BA";"PE DE SERRA";19;2;10;31
2005;"PEDRAO (BA)";"BA";"PEDRAO";13;4;4;21
2005;"PEDRO ALEXANDRE (BA)";"BA";"PEDRO ALEXANDRE";1;1;2;4
2005;"PIATA (BA)";"BA";"PIATA";71;11;19;101
2005;"PILAO ARCADO (BA)";"BA";"PILAO ARCADO";26;11;2;39
2005;"PINDAI (BA)";"BA";"PINDAI";27;6;15;48
2005;"PINDOBACU (BA)";"BA";"PINDOBACU";25;13;13;51
2005;"PINTADAS (BA)";"BA";"PINTADAS";28;8;22;58
2005;"PIRAI DO NORTE (BA)";"BA";"PIRAI DO NORTE";11;1;0;12
2005;"PIRIPA (BA)";"BA";"PIRIPA";45;12;15;72
2005;"PIRITIBA (BA)";"BA";"PIRITIBA";33;10;14;57
2005;"PLANALTINO (BA)";"BA";"PLANALTINO";9;1;5;15
2005;"PLANALTO (BA)";"BA";"PLANALTO";77;6;31;114
2005;"POCOES (BA)";"BA";"POCOES";216;61;40;317
2005;"POJUCA (BA)";"BA";"POJUCA";216;33;55;304
2005;"PONTO NOVO (BA)";"BA";"PONTO NOVO";33;2;10;45
2005;"PORTO SEGURO (BA)";"BA";"PORTO SEGURO";456;122;468;1046
2005;"POTIRIGUA (BA)";"BA";"POTIRIGUA";18;2;4;24
2005;"PRADO (BA)";"BA";"PRADO";33;9;15;57
2005;"PRESIDENTE DUTRA (BA)";"BA";"PRESIDENTE DUTRA";32;2;3;37
2005;"PRESIDENTE JANIO QUADROS (BA)";"BA";"PRESIDENTE JANIO QUADROS";17;6;5;28
2005;"PRESIDENTE TANCREDO NEVES (BA)";"BA";"PRESIDENTE TANCREDO NEVES";41;12;6;59
2005;"QUEIMADAS (BA)";"BA";"QUEIMADAS";62;6;55;123
2005;"QUIJINGUE (BA)";"BA";"QUIJINGUE";29;4;34;67
2005;"QUIXABEIRA (BA)";"BA";"QUIXABEIRA";20;2;8;30
2005;"RAFAEL JAMBEIRO (BA)";"BA";"RAFAEL JAMBEIRO";30;10;22;62
2005;"REMANSO (BA)";"BA";"REMANSO";130;16;8;154
2005;"RETIROLANDIA (BA)";"BA";"RETIROLANDIA";38;2;6;46
2005;"RIACHAO DAS NEVES (BA)";"BA";"RIACHAO DAS NEVES";21;7;8;36
2005;"RIACHAO DO JACUIPE (BA)";"BA";"RIACHAO DO JACUIPE";161;14;25;200
2005;"RIACHO DE SANTANA (BA)";"BA";"RIACHO DE SANTANA";148;11;28;187
2005;"RIBEIRA DO AMPARO (BA)";"BA";"RIBEIRA DO AMPARO";7;5;17;29
2005;"RIBEIRA DO POMBAL (BA)";"BA";"RIBEIRA DO POMBAL";196;23;78;297
2005;"RIBEIRAO DO LARGO (BA)";"BA";"RIBEIRAO DO LARGO";14;6;3;23
2005;"RIO DE CONTAS (BA)";"BA";"RIO DE CONTAS";50;11;12;73
2005;"RIO DO ANTONIO (BA)";"BA";"RIO DO ANTONIO";34;8;2;44
2005;"RIO DO PIRES (BA)";"BA";"RIO DO PIRES";33;5;8;46
2005;"RIO REAL (BA)";"BA";"RIO REAL";112;8;32;152
2005;"RODELAS (BA)";"BA";"RODELAS";8;2;1;11
2005;"RUY BARBOSA (BA)";"BA";"RUY BARBOSA";69;9;17;95
2005;"SALINAS DA MARGARIDA (BA)";"BA";"SALINAS DA MARGARIDA";16;0;3;19
2005;"SALVADOR (BA)";"BA";"SALVADOR";10918;2728;5548;19194
2005;"SANTA BARBARA (BA)";"BA";"SANTA BARBARA";25;4;12;41
2005;"SANTA BRIGIDA (BA)";"BA";"SANTA BRIGIDA";10;9;9;28
2005;"SANTA CRUZ CABRALIA (BA)";"BA";"SANTA CRUZ CABRALIA";54;11;13;78
2005;"SANTA CRUZ DA VITORIA (BA)";"BA";"SANTA CRUZ DA VITORIA";8;1;1;10
2005;"SANTA INES (BA)";"BA";"SANTA INES";41;2;2;45
2005;"SANTA LUZIA (BA)";"BA";"SANTA LUZIA";21;1;2;24
2005;"SANTA MARIA DA VITORIA (BA)";"BA";"SANTA MARIA DA VITORIA";205;26;26;257
2005;"SANTA RITA DE CASSIA (BA)";"BA";"SANTA RITA DE CASSIA";40;3;3;46
2005;"SANTA TERESINHA (BA)";"BA";"SANTA TERESINHA";22;1;11;34
2005;"SANTALUZ (BA)";"BA";"SANTALUZ";120;7;16;143
2005;"SANTANA (BA)";"BA";"SANTANA";101;7;40;148
2005;"SANTANOPOLIS (BA)";"BA";"SANTANOPOLIS";11;4;5;20
2005;"SANTO AMARO (BA)";"BA";"SANTO AMARO";152;69;259;480
2005;"SANTO ANTONIO DE JESUS (BA)";"BA";"SANTO ANTONIO DE JESUS";1600;76;108;1784
2005;"SANTO ESTEVAO (BA)";"BA";"SANTO ESTEVAO";143;58;25;226
2005;"SAO DESIDERIO (BA)";"BA";"SAO DESIDERIO";121;6;21;148
2005;"SAO DOMINGOS (BA)";"BA";"SAO DOMINGOS";24;3;4;31
2005;"SAO FELIPE (BA)";"BA";"SAO FELIPE";137;18;19;174
2005;"SAO FELIX (BA)";"BA";"SAO FELIX";41;14;11;66
2005;"SAO FELIX DO CORIBE (BA)";"BA";"SAO FELIX DO CORIBE";77;6;12;95
2005;"SAO FRANCISCO DO CONDE (BA)";"BA";"SAO FRANCISCO DO CONDE";73;24;44;141
2005;"SAO GABRIEL (BA)";"BA";"SAO GABRIEL";21;4;4;29
2005;"SAO GONCALO DOS CAMPOS (BA)";"BA";"SAO GONCALO DOS CAMPOS";43;98;28;169
2005;"SAO JOSE DA VITORIA (BA)";"BA";"SAO JOSE DA VITORIA";7;0;3;10
2005;"SAO JOSE DO JACUIPE (BA)";"BA";"SAO JOSE DO JACUIPE";42;3;4;49
2005;"SAO MIGUEL DAS MATAS (BA)";"BA";"SAO MIGUEL DAS MATAS";25;3;2;30
2005;"SAO SEBASTIAO DO PASSE (BA)";"BA";"SAO SEBASTIAO DO PASSE";126;39;88;253
2005;"SAPEACU (BA)";"BA";"SAPEACU";61;30;16;107
2005;"SATIRO DIAS (BA)";"BA";"SATIRO DIAS";11;6;4;21
2005;"SAUBARA (BA)";"BA";"SAUBARA";13;5;1;19
2005;"SAUDE (BA)";"BA";"SAUDE";20;7;6;33
2005;"SEABRA (BA)";"BA";"SEABRA";213;41;64;318
2005;"SEBASTIAO LARANJEIRAS (BA)";"BA";"SEBASTIAO LARANJEIRAS";5;3;9;17
2005;"SENHOR DO BONFIM (BA)";"BA";"SENHOR DO BONFIM";425;63;139;627
2005;"SENTO SE (BA)";"BA";"SENTO SE";32;3;11;46
2005;"SERRA DO RAMALHO (BA)";"BA";"SERRA DO RAMALHO";24;17;11;52
2005;"SERRA DOURADA (BA)";"BA";"SERRA DOURADA";26;4;10;40
2005;"SERRA PRETA (BA)";"BA";"SERRA PRETA";21;9;31;61
2005;"SERRINHA (BA)";"BA";"SERRINHA";391;37;95;523
2005;"SERROLANDIA (BA)";"BA";"SERROLANDIA";25;14;11;50
2005;"SIMOES FILHO (BA)";"BA";"SIMOES FILHO";1366;207;410;1983
2005;"SITIO DO MATO (BA)";"BA";"SITIO DO MATO";16;5;10;31
2005;"SITIO DO QUINTO (BA)";"BA";"SITIO DO QUINTO";11;2;7;20
2005;"SOBRADINHO (BA)";"BA";"SOBRADINHO";60;9;10;79
2005;"SOUTO SOARES (BA)";"BA";"SOUTO SOARES";50;0;14;64
2005;"TABOCAS DO BREJO VELHO (BA)";"BA";"TABOCAS DO BREJO VELHO";9;1;5;15
2005;"TANHACU (BA)";"BA";"TANHACU";79;12;10;101
2005;"TANQUE NOVO (BA)";"BA";"TANQUE NOVO";160;6;22;188
2005;"TANQUINHO (BA)";"BA";"TANQUINHO";17;7;4;28
2005;"TAPEROA (BA)";"BA";"TAPEROA";71;19;7;97
2005;"TAPIRAMUTA (BA)";"BA";"TAPIRAMUTA";23;3;2;28
2005;"TEIXEIRA DE FREITAS (BA)";"BA";"TEIXEIRA DE FREITAS";802;37;194;1033
2005;"TEODORO SAMPAIO (BA)";"BA";"TEODORO SAMPAIO";8;4;6;18
2005;"TEOFILANDIA (BA)";"BA";"TEOFILANDIA";72;6;13;91
2005;"TEOLANDIA (BA)";"BA";"TEOLANDIA";80;4;2;86
2005;"TERRA NOVA (BA)";"BA";"TERRA NOVA";5;2;11;18
2005;"TREMEDAL (BA)";"BA";"TREMEDAL";21;5;10;36
2005;"TUCANO (BA)";"BA";"TUCANO";168;13;67;248
2005;"UAUA (BA)";"BA";"UAUA";62;4;10;76
2005;"UBAIRA (BA)";"BA";"UBAIRA";60;4;25;89
2005;"UBAITABA (BA)";"BA";"UBAITABA";123;5;10;138
2005;"UBATA (BA)";"BA";"UBATA";161;11;4;176
2005;"UIBAI (BA)";"BA";"UIBAI";32;0;0;32
2005;"UMBURANAS (BA)";"BA";"UMBURANAS";13;5;8;26
2005;"UNA (BA)";"BA";"UNA";34;3;10;47
2005;"URANDI (BA)";"BA";"URANDI";60;2;13;75
2005;"URUCUCA (BA)";"BA";"URUCUCA";64;2;3;69
2005;"UTINGA (BA)";"BA";"UTINGA";31;5;5;41
2005;"VALENCA (BA)";"BA";"VALENCA";444;46;51;541
2005;"VALENTE (BA)";"BA";"VALENTE";83;6;17;106
2005;"VARZEA DA ROCA (BA)";"BA";"VARZEA DA ROCA";25;7;8;40
2005;"VARZEA DO POCO (BA)";"BA";"VARZEA DO POCO";41;6;5;52
2005;"VARZEA NOVA (BA)";"BA";"VARZEA NOVA";44;3;9;56
2005;"VARZEDO (BA)";"BA";"VARZEDO";34;4;5;43
2005;"VERA CRUZ (BA)";"BA";"VERA CRUZ";90;88;21;199
2005;"VEREDA (BA)";"BA";"VEREDA";8;0;1;9
2005;"VITORIA DA CONQUISTA (BA)";"BA";"VITORIA DA CONQUISTA";2410;216;755;3381
2005;"WAGNER (BA)";"BA";"WAGNER";13;0;4;17
2005;"WANDERLEY (BA)";"BA";"WANDERLEY";24;4;11;39
2005;"WENCESLAU GUIMARAES (BA)";"BA";"WENCESLAU GUIMARAES";67;8;6;81
2005;"XIQUE XIQUE (BA)";"BA";"XIQUE XIQUE";78;5;8;91
2005;"ABAIARA (CE)";"CE";"ABAIARA";5;9;3;17
2005;"ACARAPE (CE)";"CE";"ACARAPE";60;17;7;84
2005;"ACARAU (CE)";"CE";"ACARAU";121;8;26;155
2005;"ACOPIARA (CE)";"CE";"ACOPIARA";170;8;17;195
2005;"AIUABA (CE)";"CE";"AIUABA";10;1;0;11
2005;"ALCANTARAS (CE)";"CE";"ALCANTARAS";33;1;3;37
2005;"ALTANEIRA (CE)";"CE";"ALTANEIRA";10;4;1;15
2005;"ALTO SANTO (CE)";"CE";"ALTO SANTO";92;5;11;108
2005;"AMONTADA (CE)";"CE";"AMONTADA";100;6;7;113
2005;"ANTONINA DO NORTE (CE)";"CE";"ANTONINA DO NORTE";24;1;0;25
2005;"APUIARES (CE)";"CE";"APUIARES";45;8;0;53
2005;"AQUIRAZ (CE)";"CE";"AQUIRAZ";269;65;29;363
2005;"ARACATI (CE)";"CE";"ARACATI";327;34;57;418
2005;"ARACOIABA (CE)";"CE";"ARACOIABA";70;7;10;87
2005;"ARARENDA (CE)";"CE";"ARARENDA";11;3;1;15
2005;"ARARIPE (CE)";"CE";"ARARIPE";37;26;7;70
2005;"ARATUBA (CE)";"CE";"ARATUBA";29;3;3;35
2005;"ARNEIROZ (CE)";"CE";"ARNEIROZ";19;1;0;20
2005;"ASSARE (CE)";"CE";"ASSARE";52;7;0;59
2005;"AURORA (CE)";"CE";"AURORA";50;12;5;67
2005;"BAIXIO (CE)";"CE";"BAIXIO";3;5;2;10
2005;"BANABUIU (CE)";"CE";"BANABUIU";52;7;11;70
2005;"BARBALHA (CE)";"CE";"BARBALHA";162;13;38;213
2005;"BARREIRA (CE)";"CE";"BARREIRA";75;3;6;84
2005;"BARRO (CE)";"CE";"BARRO";34;6;7;47
2005;"BARROQUINHA (CE)";"CE";"BARROQUINHA";11;3;0;14
2005;"BATURITE (CE)";"CE";"BATURITE";147;22;21;190
2005;"BEBERIBE (CE)";"CE";"BEBERIBE";108;25;25;158
2005;"BELA CRUZ (CE)";"CE";"BELA CRUZ";55;6;5;66
2005;"BOA VIAGEM (CE)";"CE";"BOA VIAGEM";261;13;24;298
2005;"BREJO SANTO (CE)";"CE";"BREJO SANTO";188;35;20;243
2005;"CAMOCIM (CE)";"CE";"CAMOCIM";92;18;11;121
2005;"CAMPOS SALES (CE)";"CE";"CAMPOS SALES";139;19;22;180
2005;"CANINDE (CE)";"CE";"CANINDE";292;15;56;363
2005;"CAPISTRANO (CE)";"CE";"CAPISTRANO";30;3;10;43
2005;"CARIDADE (CE)";"CE";"CARIDADE";39;4;4;47
2005;"CARIRE (CE)";"CE";"CARIRE";23;6;3;32
2005;"CARIRIACU (CE)";"CE";"CARIRIACU";36;5;3;44
2005;"CARIUS (CE)";"CE";"CARIUS";30;7;2;39
2005;"CARNAUBAL (CE)";"CE";"CARNAUBAL";44;15;4;63
2005;"CASCAVEL (CE)";"CE";"CASCAVEL";272;28;46;346
2005;"CATARINA (CE)";"CE";"CATARINA";25;4;0;29
2005;"CATUNDA (CE)";"CE";"CATUNDA";16;4;2;22
2005;"CAUCAIA (CE)";"CE";"CAUCAIA";744;58;285;1087
2005;"CEDRO (CE)";"CE";"CEDRO";67;16;21;104
2005;"CHAVAL (CE)";"CE";"CHAVAL";19;6;2;27
2005;"CHORO (CE)";"CE";"CHORO";24;5;8;37
2005;"CHOROZINHO (CE)";"CE";"CHOROZINHO";64;5;30;99
2005;"COREAU (CE)";"CE";"COREAU";57;11;6;74
2005;"CRATEUS (CE)";"CE";"CRATEUS";187;11;26;224
2005;"CRATO (CE)";"CE";"CRATO";569;37;62;668
2005;"CROATA (CE)";"CE";"CROATA";34;3;0;37
2005;"CRUZ (CE)";"CE";"CRUZ";79;16;27;122
2005;"DEPUTADO IRAPUAN PINHEIRO (CE)";"CE";"DEPUTADO IRAPUAN PINHEIRO";14;4;3;21
2005;"ERERE (CE)";"CE";"ERERE";3;2;0;5
2005;"EUSEBIO (CE)";"CE";"EUSEBIO";555;11;41;607
2005;"FARIAS BRITO (CE)";"CE";"FARIAS BRITO";47;26;3;76
2005;"FORQUILHA (CE)";"CE";"FORQUILHA";64;16;13;93
2005;"FORTALEZA (CE)";"CE";"FORTALEZA";15667;1855;4357;21879
2005;"FORTIM (CE)";"CE";"FORTIM";18;27;5;50
2005;"FRECHEIRINHA (CE)";"CE";"FRECHEIRINHA";45;11;14;70
2005;"GENERAL SAMPAIO (CE)";"CE";"GENERAL SAMPAIO";15;1;1;17
2005;"GRACA (CE)";"CE";"GRACA";9;6;5;20
2005;"GRANJA (CE)";"CE";"GRANJA";106;17;12;135
2005;"GRANJEIRO (CE)";"CE";"GRANJEIRO";2;1;0;3
2005;"GROAIRAS (CE)";"CE";"GROAIRAS";40;17;4;61
2005;"GUAIUBA (CE)";"CE";"GUAIUBA";40;25;6;71
2005;"GUARACIABA DO NORTE (CE)";"CE";"GUARACIABA DO NORTE";204;2;13;219
2005;"GUARAMIRANGA (CE)";"CE";"GUARAMIRANGA";15;2;1;18
2005;"HIDROLANDIA (CE)";"CE";"HIDROLANDIA";82;10;9;101
2005;"HORIZONTE (CE)";"CE";"HORIZONTE";209;35;66;310
2005;"IBARETAMA (CE)";"CE";"IBARETAMA";31;6;14;51
2005;"IBIAPINA (CE)";"CE";"IBIAPINA";92;7;11;110
2005;"IBICUITINGA (CE)";"CE";"IBICUITINGA";26;0;7;33
2005;"ICAPUI (CE)";"CE";"ICAPUI";50;13;28;91
2005;"ICO (CE)";"CE";"ICO";190;37;29;256
2005;"IGUATU (CE)";"CE";"IGUATU";565;40;71;676
2005;"INDEPENDENCIA (CE)";"CE";"INDEPENDENCIA";130;2;9;141
2005;"IPAPORANGA (CE)";"CE";"IPAPORANGA";15;0;0;15
2005;"IPAUMIRIM (CE)";"CE";"IPAUMIRIM";123;10;15;148
2005;"IPU (CE)";"CE";"IPU";214;22;19;255
2005;"IPUEIRAS (CE)";"CE";"IPUEIRAS";53;5;2;60
2005;"IRACEMA (CE)";"CE";"IRACEMA";48;6;4;58
2005;"IRAUCUBA (CE)";"CE";"IRAUCUBA";57;8;7;72
2005;"ITAICABA (CE)";"CE";"ITAICABA";22;4;5;31
2005;"ITAITINGA (CE)";"CE";"ITAITINGA";112;29;11;152
2005;"ITAPAGE (CE)";"CE";"ITAPAGE";184;21;10;215
2005;"ITAPIPOCA (CE)";"CE";"ITAPIPOCA";430;27;15;472
2005;"ITAPIUNA (CE)";"CE";"ITAPIUNA";42;6;9;57
2005;"ITAREMA (CE)";"CE";"ITAREMA";74;16;17;107
2005;"ITATIRA (CE)";"CE";"ITATIRA";58;4;4;66
2005;"JAGUARETAMA (CE)";"CE";"JAGUARETAMA";52;4;3;59
2005;"JAGUARIBARA (CE)";"CE";"JAGUARIBARA";33;5;7;45
2005;"JAGUARIBE (CE)";"CE";"JAGUARIBE";232;18;16;266
2005;"JAGUARUANA (CE)";"CE";"JAGUARUANA";147;8;5;160
2005;"JARDIM (CE)";"CE";"JARDIM";41;12;5;58
2005;"JATI (CE)";"CE";"JATI";3;2;0;5
2005;"JIJOCA DE JERICOACOARA (CE)";"CE";"JIJOCA DE JERICOACOARA";36;3;3;42
2005;"JUAZEIRO DO NORTE (CE)";"CE";"JUAZEIRO DO NORTE";1069;89;179;1337
2005;"JUCAS (CE)";"CE";"JUCAS";33;3;12;48
2005;"LAVRAS DA MANGABEIRA (CE)";"CE";"LAVRAS DA MANGABEIRA";43;7;12;62
2005;"LIMOEIRO DO NORTE (CE)";"CE";"LIMOEIRO DO NORTE";477;13;65;555
2005;"MADALENA (CE)";"CE";"MADALENA";51;3;7;61
2005;"MARACANAU (CE)";"CE";"MARACANAU";701;116;155;972
2005;"MARANGUAPE (CE)";"CE";"MARANGUAPE";405;31;87;523
2005;"MARCO (CE)";"CE";"MARCO";116;2;7;125
2005;"MARTINOPOLE (CE)";"CE";"MARTINOPOLE";9;5;1;15
2005;"MASSAPE (CE)";"CE";"MASSAPE";53;5;23;81
2005;"MAURITI (CE)";"CE";"MAURITI";47;10;5;62
2005;"MERUOCA (CE)";"CE";"MERUOCA";21;1;4;26
2005;"MILAGRES (CE)";"CE";"MILAGRES";54;9;9;72
2005;"MILHA (CE)";"CE";"MILHA";35;0;8;43
2005;"MIRAIMA (CE)";"CE";"MIRAIMA";27;1;2;30
2005;"MISSAO VELHA (CE)";"CE";"MISSAO VELHA";58;13;6;77
2005;"MOMBACA (CE)";"CE";"MOMBACA";144;5;2;151
2005;"MONSENHOR TABOSA (CE)";"CE";"MONSENHOR TABOSA";37;3;0;40
2005;"MORADA NOVA (CE)";"CE";"MORADA NOVA";270;22;33;325
2005;"MORAUJO (CE)";"CE";"MORAUJO";11;3;4;18
2005;"MORRINHOS (CE)";"CE";"MORRINHOS";32;6;4;42
2005;"MUCAMBO (CE)";"CE";"MUCAMBO";22;14;4;40
2005;"MULUNGU (CE)";"CE";"MULUNGU";38;4;2;44
2005;"NOVA OLINDA (CE)";"CE";"NOVA OLINDA";53;14;2;69
2005;"NOVA RUSSAS (CE)";"CE";"NOVA RUSSAS";132;6;6;144
2005;"NOVO ORIENTE (CE)";"CE";"NOVO ORIENTE";31;1;4;36
2005;"OCARA (CE)";"CE";"OCARA";68;21;12;101
2005;"OROS (CE)";"CE";"OROS";66;12;12;90
2005;"PACAJUS (CE)";"CE";"PACAJUS";395;27;23;445
2005;"PACATUBA (CE)";"CE";"PACATUBA";79;49;5;133
2005;"PACOTI (CE)";"CE";"PACOTI";53;4;5;62
2005;"PACUJA (CE)";"CE";"PACUJA";24;7;10;41
2005;"PALHANO (CE)";"CE";"PALHANO";34;5;7;46
2005;"PALMACIA (CE)";"CE";"PALMACIA";32;12;11;55
2005;"PARACURU (CE)";"CE";"PARACURU";119;9;7;135
2005;"PARAIPABA (CE)";"CE";"PARAIPABA";105;7;12;124
2005;"PARAMBU (CE)";"CE";"PARAMBU";116;3;1;120
2005;"PARAMOTI (CE)";"CE";"PARAMOTI";27;2;3;32
2005;"PEDRA BRANCA (CE)";"CE";"PEDRA BRANCA";139;8;5;152
2005;"PENAFORTE (CE)";"CE";"PENAFORTE";14;2;13;29
2005;"PENTECOSTE (CE)";"CE";"PENTECOSTE";142;9;4;155
2005;"PEREIRO (CE)";"CE";"PEREIRO";70;12;6;88
2005;"PINDORETAMA (CE)";"CE";"PINDORETAMA";81;6;4;91
2005;"PIQUET CARNEIRO (CE)";"CE";"PIQUET CARNEIRO";19;2;4;25
2005;"PIRES FERREIRA (CE)";"CE";"PIRES FERREIRA";14;2;1;17
2005;"PORANGA (CE)";"CE";"PORANGA";6;2;1;9
2005;"PORTEIRAS (CE)";"CE";"PORTEIRAS";15;5;3;23
2005;"POTENGI (CE)";"CE";"POTENGI";15;3;0;18
2005;"POTIRETAMA (CE)";"CE";"POTIRETAMA";20;1;5;26
2005;"QUITERIANOPOLIS (CE)";"CE";"QUITERIANOPOLIS";23;4;2;29
2005;"QUIXADA (CE)";"CE";"QUIXADA";411;36;52;499
2005;"QUIXELO (CE)";"CE";"QUIXELO";26;5;14;45
2005;"QUIXERAMOBIM (CE)";"CE";"QUIXERAMOBIM";272;23;53;348
2005;"QUIXERE (CE)";"CE";"QUIXERE";108;10;24;142
2005;"REDENCAO (CE)";"CE";"REDENCAO";137;14;17;168
2005;"RERIUTABA (CE)";"CE";"RERIUTABA";49;15;14;78
2005;"RUSSAS (CE)";"CE";"RUSSAS";453;17;44;514
2005;"SABOEIRO (CE)";"CE";"SABOEIRO";23;3;3;29
2005;"SALITRE (CE)";"CE";"SALITRE";24;3;6;33
2005;"SANTA QUITERIA (CE)";"CE";"SANTA QUITERIA";155;14;8;177
2005;"SANTANA DO ACARAU (CE)";"CE";"SANTANA DO ACARAU";82;8;10;100
2005;"SANTANA DO CARIRI (CE)";"CE";"SANTANA DO CARIRI";40;7;2;49
2005;"SAO BENEDITO (CE)";"CE";"SAO BENEDITO";294;45;30;369
2005;"SAO GONCALO DO AMARANTE (CE)";"CE";"SAO GONCALO DO AMARANTE";118;18;16;152
2005;"SAO JOAO DO JAGUARIBE (CE)";"CE";"SAO JOAO DO JAGUARIBE";34;6;6;46
2005;"SAO LUIS DO CURU (CE)";"CE";"SAO LUIS DO CURU";36;6;9;51
2005;"SENADOR POMPEU (CE)";"CE";"SENADOR POMPEU";103;6;21;130
2005;"SENADOR SA (CE)";"CE";"SENADOR SA";18;0;3;21
2005;"SOBRAL (CE)";"CE";"SOBRAL";1115;114;149;1378
2005;"SOLONOPOLE (CE)";"CE";"SOLONOPOLE";51;3;7;61
2005;"TABULEIRO DO NORTE (CE)";"CE";"TABULEIRO DO NORTE";224;24;28;276
2005;"TAMBORIL (CE)";"CE";"TAMBORIL";42;5;10;57
2005;"TARRAFAS (CE)";"CE";"TARRAFAS";11;5;1;17
2005;"TAUA (CE)";"CE";"TAUA";257;7;20;284
2005;"TEJUCUOCA (CE)";"CE";"TEJUCUOCA";48;1;3;52
2005;"TIANGUA (CE)";"CE";"TIANGUA";786;44;48;878
2005;"TRAIRI (CE)";"CE";"TRAIRI";111;6;12;129
2005;"TURURU (CE)";"CE";"TURURU";30;1;2;33
2005;"UBAJARA (CE)";"CE";"UBAJARA";138;13;13;164
2005;"UMARI (CE)";"CE";"UMARI";4;0;2;6
2005;"UMIRIM (CE)";"CE";"UMIRIM";36;36;9;81
2005;"URUBURETAMA (CE)";"CE";"URUBURETAMA";57;4;2;63
2005;"URUOCA (CE)";"CE";"URUOCA";19;5;7;31
2005;"VARJOTA (CE)";"CE";"VARJOTA";74;20;3;97
2005;"VARZEA ALEGRE (CE)";"CE";"VARZEA ALEGRE";132;16;26;174
2005;"VICOSA DO CEARA (CE)";"CE";"VICOSA DO CEARA";193;13;10;216
2005;"BRASILIA (DF)";"DF";"BRASILIA";15367;5212;6087;26666
2005;"AFONSO CLAUDIO (ES)";"ES";"AFONSO CLAUDIO";384;13;91;488
2005;"AGUA DOCE DO NORTE (ES)";"ES";"AGUA DOCE DO NORTE";51;3;13;67
2005;"AGUIA BRANCA (ES)";"ES";"AGUIA BRANCA";86;1;20;107
2005;"ALEGRE (ES)";"ES";"ALEGRE";148;10;9;167
2005;"ALFREDO CHAVES (ES)";"ES";"ALFREDO CHAVES";336;14;22;372
2005;"ALTO RIO NOVO (ES)";"ES";"ALTO RIO NOVO";63;7;8;78
2005;"ANCHIETA (ES)";"ES";"ANCHIETA";169;30;18;217
2005;"APIACA (ES)";"ES";"APIACA";35;6;2;43
2005;"ARACRUZ (ES)";"ES";"ARACRUZ";829;85;243;1157
2005;"ATILIO VIVACQUA (ES)";"ES";"ATILIO VIVACQUA";139;7;12;158
2005;"BAIXO GUANDU (ES)";"ES";"BAIXO GUANDU";336;13;82;431
2005;"BARRA DE SAO FRANCISCO (ES)";"ES";"BARRA DE SAO FRANCISCO";355;9;59;423
2005;"BOA ESPERANCA (ES)";"ES";"BOA ESPERANCA";153;6;24;183
2005;"BOM JESUS DO NORTE (ES)";"ES";"BOM JESUS DO NORTE";142;14;18;174
2005;"BREJETUBA (ES)";"ES";"BREJETUBA";114;4;20;138
2005;"CACHOEIRO DE ITAPEMIRIM (ES)";"ES";"CACHOEIRO DE ITAPEMIRIM";4064;136;1926;6126
2005;"CARIACICA (ES)";"ES";"CARIACICA";3764;311;1342;5417
2005;"CASTELO (ES)";"ES";"CASTELO";1058;36;40;1134
2005;"COLATINA (ES)";"ES";"COLATINA";1872;54;377;2303
2005;"CONCEICAO DA BARRA (ES)";"ES";"CONCEICAO DA BARRA";134;8;80;222
2005;"CONCEICAO DO CASTELO (ES)";"ES";"CONCEICAO DO CASTELO";154;13;28;195
2005;"DIVINO DE SAO LOURENCO (ES)";"ES";"DIVINO DE SAO LOURENCO";34;3;4;41
2005;"DOMINGOS MARTINS (ES)";"ES";"DOMINGOS MARTINS";696;47;49;792
2005;"DORES DO RIO PRETO (ES)";"ES";"DORES DO RIO PRETO";89;1;7;97
2005;"ECOPORANGA (ES)";"ES";"ECOPORANGA";93;7;49;149
2005;"FUNDAO (ES)";"ES";"FUNDAO";204;18;30;252
2005;"GOVERNADOR LINDENBERG (ES)";"ES";"GOVERNADOR LINDENBERG";116;5;1;122
2005;"GUACUI (ES)";"ES";"GUACUI";276;30;28;334
2005;"GUARAPARI (ES)";"ES";"GUARAPARI";733;108;135;976
2005;"IBATIBA (ES)";"ES";"IBATIBA";192;9;23;224
2005;"IBIRACU (ES)";"ES";"IBIRACU";313;17;30;360
2005;"IBITIRAMA (ES)";"ES";"IBITIRAMA";54;3;4;61
2005;"ICONHA (ES)";"ES";"ICONHA";657;13;21;691
2005;"IRUPI (ES)";"ES";"IRUPI";99;10;11;120
2005;"ITAGUACU (ES)";"ES";"ITAGUACU";188;5;41;234
2005;"ITAPEMIRIM (ES)";"ES";"ITAPEMIRIM";315;14;39;368
2005;"ITARANA (ES)";"ES";"ITARANA";234;17;29;280
2005;"IUNA (ES)";"ES";"IUNA";274;11;54;339
2005;"JAGUARE (ES)";"ES";"JAGUARE";302;6;48;356
2005;"JERONIMO MONTEIRO (ES)";"ES";"JERONIMO MONTEIRO";58;2;10;70
2005;"JOAO NEIVA (ES)";"ES";"JOAO NEIVA";265;9;27;301
2005;"LARANJA DA TERRA (ES)";"ES";"LARANJA DA TERRA";204;5;20;229
2005;"LINHARES (ES)";"ES";"LINHARES";2159;48;248;2455
2005;"MANTENOPOLIS (ES)";"ES";"MANTENOPOLIS";84;5;15;104
2005;"MARATAIZES (ES)";"ES";"MARATAIZES";490;24;28;542
2005;"MARECHAL FLORIANO (ES)";"ES";"MARECHAL FLORIANO";485;11;8;504
2005;"MARILANDIA (ES)";"ES";"MARILANDIA";247;5;16;268
2005;"MIMOSO DO SUL (ES)";"ES";"MIMOSO DO SUL";159;9;27;195
2005;"MONTANHA (ES)";"ES";"MONTANHA";129;9;16;154
2005;"MUCURICI (ES)";"ES";"MUCURICI";49;6;16;71
2005;"MUNIZ FREIRE (ES)";"ES";"MUNIZ FREIRE";116;13;29;158
2005;"MUQUI (ES)";"ES";"MUQUI";97;11;16;124
2005;"NOVA VENECIA (ES)";"ES";"NOVA VENECIA";619;13;121;753
2005;"PANCAS (ES)";"ES";"PANCAS";164;11;7;182
2005;"PEDRO CANARIO (ES)";"ES";"PEDRO CANARIO";295;11;154;460
2005;"PINHEIROS (ES)";"ES";"PINHEIROS";195;7;76;278
2005;"PIUMA (ES)";"ES";"PIUMA";133;35;11;179
2005;"PONTO BELO (ES)";"ES";"PONTO BELO";28;3;10;41
2005;"PRESIDENTE KENNEDY (ES)";"ES";"PRESIDENTE KENNEDY";193;24;14;231
2005;"RIO BANANAL (ES)";"ES";"RIO BANANAL";380;8;25;413
2005;"RIO NOVO DO SUL (ES)";"ES";"RIO NOVO DO SUL";207;4;15;226
2005;"SANTA LEOPOLDINA (ES)";"ES";"SANTA LEOPOLDINA";213;13;17;243
2005;"SANTA MARIA DE JETIBA (ES)";"ES";"SANTA MARIA DE JETIBA";1178;35;36;1249
2005;"SANTA TERESA (ES)";"ES";"SANTA TERESA";517;17;36;570
2005;"SAO DOMINGOS DO NORTE (ES)";"ES";"SAO DOMINGOS DO NORTE";135;3;10;148
2005;"SAO GABRIEL DA PALHA (ES)";"ES";"SAO GABRIEL DA PALHA";427;14;57;498
2005;"SAO JOSE DO CALCADO (ES)";"ES";"SAO JOSE DO CALCADO";62;2;11;75
2005;"SAO MATEUS (ES)";"ES";"SAO MATEUS";746;62;223;1031
2005;"SAO ROQUE DO CANAA (ES)";"ES";"SAO ROQUE DO CANAA";216;7;11;234
2005;"SERRA (ES)";"ES";"SERRA";5122;253;1340;6715
2005;"SOORETAMA (ES)";"ES";"SOORETAMA";188;3;36;227
2005;"VARGEM ALTA (ES)";"ES";"VARGEM ALTA";293;7;37;337
2005;"VENDA NOVA DO IMIGRANTE (ES)";"ES";"VENDA NOVA DO IMIGRANTE";531;10;84;625
2005;"VIANA (ES)";"ES";"VIANA";671;28;191;890
2005;"VILA PAVAO (ES)";"ES";"VILA PAVAO";88;3;9;100
2005;"VILA VALERIO (ES)";"ES";"VILA VALERIO";216;3;16;235
2005;"VILA VELHA (ES)";"ES";"VILA VELHA";2993;545;636;4174
2005;"VITORIA (ES)";"ES";"VITORIA";2732;704;851;4287
2005;"ABADIA DE GOIAS (GO)";"GO";"ABADIA DE GOIAS";29;2;3;34
2005;"ABADIANIA (GO)";"GO";"ABADIANIA";149;9;14;172
2005;"ACREUNA (GO)";"GO";"ACREUNA";330;5;49;384
2005;"ADELANDIA (GO)";"GO";"ADELANDIA";14;0;2;16
2005;"AGUA FRIA DE GOIAS (GO)";"GO";"AGUA FRIA DE GOIAS";25;2;6;33
2005;"AGUA LIMPA (GO)";"GO";"AGUA LIMPA";14;4;1;19
2005;"AGUAS LINDAS DE GOIAS (GO)";"GO";"AGUAS LINDAS DE GOIAS";253;48;224;525
2005;"ALEXANIA (GO)";"GO";"ALEXANIA";291;15;15;321
2005;"ALOANDIA (GO)";"GO";"ALOANDIA";21;3;2;26
2005;"ALTO HORIZONTE (GO)";"GO";"ALTO HORIZONTE";11;2;5;18
2005;"ALTO PARAISO DE GOIAS (GO)";"GO";"ALTO PARAISO DE GOIAS";37;5;5;47
2005;"ALVORADA DO NORTE (GO)";"GO";"ALVORADA DO NORTE";84;3;2;89
2005;"AMARALINA (GO)";"GO";"AMARALINA";5;1;6;12
2005;"AMERICANO DO BRASIL (GO)";"GO";"AMERICANO DO BRASIL";33;2;9;44
2005;"AMORINOPOLIS (GO)";"GO";"AMORINOPOLIS";16;0;6;22
2005;"ANAPOLIS (GO)";"GO";"ANAPOLIS";6972;173;1029;8174
2005;"ANHANGUERA (GO)";"GO";"ANHANGUERA";5;2;1;8
2005;"ANICUNS (GO)";"GO";"ANICUNS";220;12;44;276
2005;"APARECIDA DE GOIANIA (GO)";"GO";"APARECIDA DE GOIANIA";2669;130;389;3188
2005;"APARECIDA DO RIO DOCE (GO)";"GO";"APARECIDA DO RIO DOCE";45;2;4;51
2005;"APORE (GO)";"GO";"APORE";42;3;5;50
2005;"ARACU (GO)";"GO";"ARACU";15;2;3;20
2005;"ARAGARCAS (GO)";"GO";"ARAGARCAS";562;6;18;586
2005;"ARAGOIANIA (GO)";"GO";"ARAGOIANIA";35;0;4;39
2005;"ARAGUAPAZ (GO)";"GO";"ARAGUAPAZ";68;0;5;73
2005;"ARENOPOLIS (GO)";"GO";"ARENOPOLIS";8;3;3;14
2005;"ARUANA (GO)";"GO";"ARUANA";15;2;7;24
2005;"AURILANDIA (GO)";"GO";"AURILANDIA";16;3;1;20
2005;"AVELINOPOLIS (GO)";"GO";"AVELINOPOLIS";21;1;0;22
2005;"BALIZA (GO)";"GO";"BALIZA";1;1;2;4
2005;"BARRO ALTO (GO)";"GO";"BARRO ALTO";61;2;10;73
2005;"BELA VISTA DE GOIAS (GO)";"GO";"BELA VISTA DE GOIAS";207;7;28;242
2005;"BOM JARDIM DE GOIAS (GO)";"GO";"BOM JARDIM DE GOIAS";63;4;8;75
2005;"BOM JESUS DE GOIAS (GO)";"GO";"BOM JESUS DE GOIAS";345;6;22;373
2005;"BONFINOPOLIS (GO)";"GO";"BONFINOPOLIS";25;1;9;35
2005;"BONOPOLIS (GO)";"GO";"BONOPOLIS";6;1;2;9
2005;"BRAZABRANTES (GO)";"GO";"BRAZABRANTES";20;3;2;25
2005;"BRITANIA (GO)";"GO";"BRITANIA";52;1;5;58
2005;"BURITI ALEGRE (GO)";"GO";"BURITI ALEGRE";144;7;2;153
2005;"BURITI DE GOIAS (GO)";"GO";"BURITI DE GOIAS";10;5;0;15
2005;"BURITINOPOLIS (GO)";"GO";"BURITINOPOLIS";13;1;3;17
2005;"CABECEIRAS (GO)";"GO";"CABECEIRAS";46;2;14;62
2005;"CACHOEIRA ALTA (GO)";"GO";"CACHOEIRA ALTA";100;6;13;119
2005;"CACHOEIRA DE GOIAS (GO)";"GO";"CACHOEIRA DE GOIAS";4;1;0;5
2005;"CACHOEIRA DOURADA (GO)";"GO";"CACHOEIRA DOURADA";70;7;15;92
2005;"CACU (GO)";"GO";"CACU";156;2;17;175
2005;"CAIAPONIA (GO)";"GO";"CAIAPONIA";110;2;6;118
2005;"CALDAS NOVAS (GO)";"GO";"CALDAS NOVAS";449;37;77;563
2005;"CALDAZINHA (GO)";"GO";"CALDAZINHA";27;1;2;30
2005;"CAMPESTRE DE GOIAS (GO)";"GO";"CAMPESTRE DE GOIAS";17;2;2;21
2005;"CAMPINACU (GO)";"GO";"CAMPINACU";4;1;1;6
2005;"CAMPINORTE (GO)";"GO";"CAMPINORTE";90;2;9;101
2005;"CAMPO ALEGRE DE GOIAS (GO)";"GO";"CAMPO ALEGRE DE GOIAS";86;3;9;98
2005;"CAMPO LIMPO DE GOIAS (GO)";"GO";"CAMPO LIMPO DE GOIAS";47;0;3;50
2005;"CAMPOS BELOS (GO)";"GO";"CAMPOS BELOS";133;3;19;155
2005;"CAMPOS VERDES (GO)";"GO";"CAMPOS VERDES";22;4;2;28
2005;"CARMO DO RIO VERDE (GO)";"GO";"CARMO DO RIO VERDE";47;2;29;78
2005;"CASTELANDIA (GO)";"GO";"CASTELANDIA";37;2;6;45
2005;"CATALAO (GO)";"GO";"CATALAO";1247;57;175;1479
2005;"CATURAI (GO)";"GO";"CATURAI";20;1;6;27
2005;"CAVALCANTE (GO)";"GO";"CAVALCANTE";15;1;3;19
2005;"CERES (GO)";"GO";"CERES";418;9;23;450
2005;"CEZARINA (GO)";"GO";"CEZARINA";68;2;8;78
2005;"CHAPADAO DO CEU (GO)";"GO";"CHAPADAO DO CEU";106;2;6;114
2005;"CIDADE OCIDENTAL (GO)";"GO";"CIDADE OCIDENTAL";59;14;42;115
2005;"COCALZINHO DE GOIAS (GO)";"GO";"COCALZINHO DE GOIAS";112;13;16;141
2005;"COLINAS DO SUL (GO)";"GO";"COLINAS DO SUL";3;2;2;7
2005;"CORREGO DO OURO (GO)";"GO";"CORREGO DO OURO";12;2;1;15
2005;"CORUMBA DE GOIAS (GO)";"GO";"CORUMBA DE GOIAS";63;5;8;76
2005;"CORUMBAIBA (GO)";"GO";"CORUMBAIBA";93;4;6;103
2005;"CRISTALINA (GO)";"GO";"CRISTALINA";573;14;101;688
2005;"CRISTIANOPOLIS (GO)";"GO";"CRISTIANOPOLIS";24;4;1;29
2005;"CRIXAS (GO)";"GO";"CRIXAS";58;7;20;85
2005;"CROMINIA (GO)";"GO";"CROMINIA";25;1;2;28
2005;"CUMARI (GO)";"GO";"CUMARI";15;2;0;17
2005;"DAMIANOPOLIS (GO)";"GO";"DAMIANOPOLIS";4;0;3;7
2005;"DAMOLANDIA (GO)";"GO";"DAMOLANDIA";20;2;3;25
2005;"DAVINOPOLIS (GO)";"GO";"DAVINOPOLIS";26;2;5;33
2005;"DIORAMA (GO)";"GO";"DIORAMA";7;3;4;14
2005;"DIVINOPOLIS DE GOIAS (GO)";"GO";"DIVINOPOLIS DE GOIAS";16;0;5;21
2005;"DOVERLANDIA (GO)";"GO";"DOVERLANDIA";71;2;20;93
2005;"EDEALINA (GO)";"GO";"EDEALINA";50;1;4;55
2005;"EDEIA (GO)";"GO";"EDEIA";125;1;7;133
2005;"ESTRELA DO NORTE (GO)";"GO";"ESTRELA DO NORTE";18;3;1;22
2005;"FAINA (GO)";"GO";"FAINA";26;0;5;31
2005;"FAZENDA NOVA (GO)";"GO";"FAZENDA NOVA";25;1;7;33
2005;"FIRMINOPOLIS (GO)";"GO";"FIRMINOPOLIS";57;1;3;61
2005;"FLORES DE GOIAS (GO)";"GO";"FLORES DE GOIAS";22;3;5;30
2005;"FORMOSA (GO)";"GO";"FORMOSA";1760;57;333;2150
2005;"FORMOSO (GO)";"GO";"FORMOSO";35;1;3;39
2005;"GAMELEIRA DE GOIAS (GO)";"GO";"GAMELEIRA DE GOIAS";14;5;7;26
2005;"GOIANAPOLIS (GO)";"GO";"GOIANAPOLIS";133;3;7;143
2005;"GOIANDIRA (GO)";"GO";"GOIANDIRA";35;2;4;41
2005;"GOIANESIA (GO)";"GO";"GOIANESIA";686;17;110;813
2005;"GOIANIA (GO)";"GO";"GOIANIA";20448;1532;4878;26858
2005;"GOIANIRA (GO)";"GO";"GOIANIRA";127;0;52;179
2005;"GOIAS (GO)";"GO";"GOIAS";166;7;23;196
2005;"GOIATUBA (GO)";"GO";"GOIATUBA";463;15;53;531
2005;"GOUVELANDIA (GO)";"GO";"GOUVELANDIA";45;3;8;56
2005;"GUAPO (GO)";"GO";"GUAPO";89;5;3;97
2005;"GUARAITA (GO)";"GO";"GUARAITA";11;1;0;12
2005;"GUARANI DE GOIAS (GO)";"GO";"GUARANI DE GOIAS";4;1;8;13
2005;"GUARINOS (GO)";"GO";"GUARINOS";3;4;2;9
2005;"HEITORAI (GO)";"GO";"HEITORAI";12;1;2;15
2005;"HIDROLANDIA (GO)";"GO";"HIDROLANDIA";126;10;9;145
2005;"HIDROLINA (GO)";"GO";"HIDROLINA";14;0;4;18
2005;"IACIARA (GO)";"GO";"IACIARA";109;1;12;122
2005;"INACIOLANDIA (GO)";"GO";"INACIOLANDIA";52;6;2;60
2005;"INDIARA (GO)";"GO";"INDIARA";129;9;21;159
2005;"INHUMAS (GO)";"GO";"INHUMAS";761;16;115;892
2005;"IPAMERI (GO)";"GO";"IPAMERI";190;8;42;240
2005;"IPIRANGA DE GOIAS (GO)";"GO";"IPIRANGA DE GOIAS";7;3;3;13
2005;"IPORA (GO)";"GO";"IPORA";301;10;33;344
2005;"ISRAELANDIA (GO)";"GO";"ISRAELANDIA";5;0;3;8
2005;"ITABERAI (GO)";"GO";"ITABERAI";427;12;37;476
2005;"ITAGUARI (GO)";"GO";"ITAGUARI";39;4;4;47
2005;"ITAGUARU (GO)";"GO";"ITAGUARU";45;5;6;56
2005;"ITAJA (GO)";"GO";"ITAJA";59;3;8;70
2005;"ITAPACI (GO)";"GO";"ITAPACI";149;5;32;186
2005;"ITAPIRAPUA (GO)";"GO";"ITAPIRAPUA";45;0;7;52
2005;"ITAPURANGA (GO)";"GO";"ITAPURANGA";214;10;24;248
2005;"ITARUMA (GO)";"GO";"ITARUMA";70;3;4;77
2005;"ITAUCU (GO)";"GO";"ITAUCU";57;3;9;69
2005;"ITUMBIARA (GO)";"GO";"ITUMBIARA";1605;114;131;1850
2005;"IVOLANDIA (GO)";"GO";"IVOLANDIA";7;2;4;13
2005;"JANDAIA (GO)";"GO";"JANDAIA";46;4;10;60
2005;"JARAGUA (GO)";"GO";"JARAGUA";208;12;24;244
2005;"JATAI (GO)";"GO";"JATAI";1457;35;110;1602
2005;"JAUPACI (GO)";"GO";"JAUPACI";15;2;4;21
2005;"JESUPOLIS (GO)";"GO";"JESUPOLIS";12;1;4;17
2005;"JOVIANIA (GO)";"GO";"JOVIANIA";113;4;6;123
2005;"JUSSARA (GO)";"GO";"JUSSARA";256;4;11;271
2005;"LAGOA SANTA (GO)";"GO";"LAGOA SANTA";7;2;2;11
2005;"LEOPOLDO DE BULHOES (GO)";"GO";"LEOPOLDO DE BULHOES";61;4;6;71
2005;"LUZIANIA (GO)";"GO";"LUZIANIA";1790;82;374;2246
2005;"MAIRIPOTABA (GO)";"GO";"MAIRIPOTABA";14;0;3;17
2005;"MAMBAI (GO)";"GO";"MAMBAI";42;3;5;50
2005;"MARA ROSA (GO)";"GO";"MARA ROSA";62;1;9;72
2005;"MARZAGAO (GO)";"GO";"MARZAGAO";23;2;1;26
2005;"MATRINCHA (GO)";"GO";"MATRINCHA";22;3;7;32
2005;"MAURILANDIA (GO)";"GO";"MAURILANDIA";224;3;54;281
2005;"MIMOSO DE GOIAS (GO)";"GO";"MIMOSO DE GOIAS";1;0;2;3
2005;"MINACU (GO)";"GO";"MINACU";210;19;24;253
2005;"MINEIROS (GO)";"GO";"MINEIROS";1048;14;59;1121
2005;"MOIPORA (GO)";"GO";"MOIPORA";7;1;1;9
2005;"MONTE ALEGRE DE GOIAS (GO)";"GO";"MONTE ALEGRE DE GOIAS";12;0;4;16
2005;"MONTES CLAROS DE GOIAS (GO)";"GO";"MONTES CLAROS DE GOIAS";38;2;6;46
2005;"MONTIVIDIU (GO)";"GO";"MONTIVIDIU";186;1;29;216
2005;"MONTIVIDIU DO NORTE (GO)";"GO";"MONTIVIDIU DO NORTE";11;2;9;22
2005;"MORRINHOS (GO)";"GO";"MORRINHOS";510;20;54;584
2005;"MORRO AGUDO DE GOIAS (GO)";"GO";"MORRO AGUDO DE GOIAS";9;2;2;13
2005;"MOSSAMEDES (GO)";"GO";"MOSSAMEDES";19;1;1;21
2005;"MOZARLANDIA (GO)";"GO";"MOZARLANDIA";92;2;16;110
2005;"MUNDO NOVO (GO)";"GO";"MUNDO NOVO";20;3;5;28
2005;"MUTUNOPOLIS (GO)";"GO";"MUTUNOPOLIS";16;1;3;20
2005;"NAZARIO (GO)";"GO";"NAZARIO";84;1;6;91
2005;"NEROPOLIS (GO)";"GO";"NEROPOLIS";268;19;17;304
2005;"NIQUELANDIA (GO)";"GO";"NIQUELANDIA";378;29;84;491
2005;"NOVA AMERICA (GO)";"GO";"NOVA AMERICA";13;2;2;17
2005;"NOVA AURORA (GO)";"GO";"NOVA AURORA";15;3;1;19
2005;"NOVA CRIXAS (GO)";"GO";"NOVA CRIXAS";45;2;15;62
2005;"NOVA GLORIA (GO)";"GO";"NOVA GLORIA";56;4;11;71
2005;"NOVA IGUACU DE GOIAS (GO)";"GO";"NOVA IGUACU DE GOIAS";10;1;4;15
2005;"NOVA ROMA (GO)";"GO";"NOVA ROMA";2;1;1;4
2005;"NOVA VENEZA (GO)";"GO";"NOVA VENEZA";176;3;12;191
2005;"NOVO BRASIL (GO)";"GO";"NOVO BRASIL";11;1;1;13
2005;"NOVO GAMA (GO)";"GO";"NOVO GAMA";185;27;55;267
2005;"NOVO PLANALTO (GO)";"GO";"NOVO PLANALTO";27;2;1;30
2005;"ORIZONA (GO)";"GO";"ORIZONA";134;11;26;171
2005;"OURO VERDE DE GOIAS (GO)";"GO";"OURO VERDE DE GOIAS";64;0;7;71
2005;"OUVIDOR (GO)";"GO";"OUVIDOR";66;3;8;77
2005;"PADRE BERNARDO (GO)";"GO";"PADRE BERNARDO";177;7;32;216
2005;"PALESTINA DE GOIAS (GO)";"GO";"PALESTINA DE GOIAS";18;6;2;26
2005;"PALMEIRAS DE GOIAS (GO)";"GO";"PALMEIRAS DE GOIAS";195;6;33;234
2005;"PALMELO (GO)";"GO";"PALMELO";11;2;1;14
2005;"PALMINOPOLIS (GO)";"GO";"PALMINOPOLIS";17;0;2;19
2005;"PANAMA (GO)";"GO";"PANAMA";17;0;4;21
2005;"PARANAIGUARA (GO)";"GO";"PARANAIGUARA";75;4;3;82
2005;"PARAUNA (GO)";"GO";"PARAUNA";115;5;16;136
2005;"PEROLANDIA (GO)";"GO";"PEROLANDIA";17;0;7;24
2005;"PETROLINA DE GOIAS (GO)";"GO";"PETROLINA DE GOIAS";93;2;12;107
2005;"PILAR DE GOIAS (GO)";"GO";"PILAR DE GOIAS";7;2;2;11
2005;"PIRACANJUBA (GO)";"GO";"PIRACANJUBA";238;9;19;266
2005;"PIRANHAS (GO)";"GO";"PIRANHAS";147;4;16;167
2005;"PIRENOPOLIS (GO)";"GO";"PIRENOPOLIS";192;6;21;219
2005;"PIRES DO RIO (GO)";"GO";"PIRES DO RIO";346;11;25;382
2005;"PLANALTINA (GO)";"GO";"PLANALTINA";241;21;284;546
2005;"PONTALINA (GO)";"GO";"PONTALINA";177;5;24;206
2005;"PORANGATU (GO)";"GO";"PORANGATU";413;7;36;456
2005;"PORTEIRAO (GO)";"GO";"PORTEIRAO";57;2;4;63
2005;"PORTELANDIA (GO)";"GO";"PORTELANDIA";37;15;1;53
2005;"POSSE (GO)";"GO";"POSSE";365;15;44;424
2005;"PROFESSOR JAMIL (GO)";"GO";"PROFESSOR JAMIL";24;0;4;28
2005;"QUIRINOPOLIS (GO)";"GO";"QUIRINOPOLIS";633;6;19;658
2005;"RIALMA (GO)";"GO";"RIALMA";265;7;18;290
2005;"RIANAPOLIS (GO)";"GO";"RIANAPOLIS";76;2;4;82
2005;"RIO QUENTE (GO)";"GO";"RIO QUENTE";28;9;9;46
2005;"RIO VERDE (GO)";"GO";"RIO VERDE";2309;107;285;2701
2005;"RUBIATABA (GO)";"GO";"RUBIATABA";173;7;28;208
2005;"SANCLERLANDIA (GO)";"GO";"SANCLERLANDIA";51;4;5;60
2005;"SANTA BARBARA DE GOIAS (GO)";"GO";"SANTA BARBARA DE GOIAS";69;3;5;77
2005;"SANTA CRUZ DE GOIAS (GO)";"GO";"SANTA CRUZ DE GOIAS";5;3;2;10
2005;"SANTA FE DE GOIAS (GO)";"GO";"SANTA FE DE GOIAS";34;0;3;37
2005;"SANTA HELENA DE GOIAS (GO)";"GO";"SANTA HELENA DE GOIAS";597;12;117;726
2005;"SANTA ISABEL (GO)";"GO";"SANTA ISABEL";6;2;1;9
2005;"SANTA RITA DO ARAGUAIA (GO)";"GO";"SANTA RITA DO ARAGUAIA";106;4;2;112
2005;"SANTA RITA DO NOVO DESTINO (GO)";"GO";"SANTA RITA DO NOVO DESTINO";13;0;10;23
2005;"SANTA ROSA DE GOIAS (GO)";"GO";"SANTA ROSA DE GOIAS";16;2;2;20
2005;"SANTA TEREZA DE GOIAS (GO)";"GO";"SANTA TEREZA DE GOIAS";24;1;3;28
2005;"SANTA TEREZINHA DE GOIAS (GO)";"GO";"SANTA TEREZINHA DE GOIAS";55;4;16;75
2005;"SANTO ANTONIO DA BARRA (GO)";"GO";"SANTO ANTONIO DA BARRA";23;1;7;31
2005;"SANTO ANTONIO DE GOIAS (GO)";"GO";"SANTO ANTONIO DE GOIAS";30;3;10;43
2005;"SANTO ANTONIO DO DESCOBERTO (GO)";"GO";"SANTO ANTONIO DO DESCOBERTO";194;14;156;364
2005;"SAO DOMINGOS (GO)";"GO";"SAO DOMINGOS";27;4;5;36
2005;"SAO FRANCISCO DE GOIAS (GO)";"GO";"SAO FRANCISCO DE GOIAS";30;2;5;37
2005;"SAO JOAO D ALIANCA (GO)";"GO";"SAO JOAO D ALIANCA";88;3;8;99
2005;"SAO JOAO DA PARAUNA (GO)";"GO";"SAO JOAO DA PARAUNA";6;1;3;10
2005;"SAO LUIS DE MONTES BELOS (GO)";"GO";"SAO LUIS DE MONTES BELOS";273;11;34;318
2005;"SAO LUIZ DO NORTE (GO)";"GO";"SAO LUIZ DO NORTE";18;2;5;25
2005;"SAO MIGUEL DO ARAGUAIA (GO)";"GO";"SAO MIGUEL DO ARAGUAIA";211;4;28;243
2005;"SAO MIGUEL DO PASSA QUATRO (GO)";"GO";"SAO MIGUEL DO PASSA QUATRO";21;0;3;24
2005;"SAO PATRICIO (GO)";"GO";"SAO PATRICIO";4;0;3;7
2005;"SAO SIMAO (GO)";"GO";"SAO SIMAO";114;8;19;141
2005;"SENADOR CANEDO (GO)";"GO";"SENADOR CANEDO";334;8;20;362
2005;"SERRANOPOLIS (GO)";"GO";"SERRANOPOLIS";84;3;11;98
2005;"SILVANIA (GO)";"GO";"SILVANIA";204;4;25;233
2005;"SIMOLANDIA (GO)";"GO";"SIMOLANDIA";61;1;3;65
2005;"SITIO D ABADIA (GO)";"GO";"SITIO D ABADIA";5;0;3;8
2005;"TAQUARAL DE GOIAS (GO)";"GO";"TAQUARAL DE GOIAS";12;3;4;19
2005;"TERESINA DE GOIAS (GO)";"GO";"TERESINA DE GOIAS";6;1;1;8
2005;"TEREZOPOLIS DE GOIAS (GO)";"GO";"TEREZOPOLIS DE GOIAS";46;2;14;62
2005;"TRES RANCHOS (GO)";"GO";"TRES RANCHOS";30;5;3;38
2005;"TRINDADE (GO)";"GO";"TRINDADE";602;23;80;705
2005;"TROMBAS (GO)";"GO";"TROMBAS";21;2;4;27
2005;"TURVANIA (GO)";"GO";"TURVANIA";39;2;3;44
2005;"TURVELANDIA (GO)";"GO";"TURVELANDIA";35;0;14;49
2005;"UIRAPURU (GO)";"GO";"UIRAPURU";7;3;1;11
2005;"URUACU (GO)";"GO";"URUACU";315;12;42;369
2005;"URUANA (GO)";"GO";"URUANA";187;1;4;192
2005;"URUTAI (GO)";"GO";"URUTAI";11;2;4;17
2005;"VALPARAISO DE GOIAS (GO)";"GO";"VALPARAISO DE GOIAS";294;138;84;516
2005;"VARJAO (GO)";"GO";"VARJAO";32;0;5;37
2005;"VIANOPOLIS (GO)";"GO";"VIANOPOLIS";254;9;11;274
2005;"VICENTINOPOLIS (GO)";"GO";"VICENTINOPOLIS";108;2;14;124
2005;"VILA BOA (GO)";"GO";"VILA BOA";8;2;1;11
2005;"VILA PROPICIO (GO)";"GO";"VILA PROPICIO";4;2;10;16
2005;"ACAILANDIA (MA)";"MA";"ACAILANDIA";659;32;90;781
2005;"AFONSO CUNHA (MA)";"MA";"AFONSO CUNHA";1;1;0;2
2005;"AGUA DOCE DO MARANHAO (MA)";"MA";"AGUA DOCE DO MARANHAO";1;2;0;3
2005;"ALCANTARA (MA)";"MA";"ALCANTARA";17;4;6;27
2005;"ALDEIAS ALTAS (MA)";"MA";"ALDEIAS ALTAS";9;3;2;14
2005;"ALTAMIRA DO MARANHAO (MA)";"MA";"ALTAMIRA DO MARANHAO";15;3;1;19
2005;"ALTO ALEGRE DO MARANHAO (MA)";"MA";"ALTO ALEGRE DO MARANHAO";18;8;0;26
2005;"ALTO ALEGRE DO PINDARE (MA)";"MA";"ALTO ALEGRE DO PINDARE";13;2;2;17
2005;"ALTO PARNAIBA (MA)";"MA";"ALTO PARNAIBA";21;1;2;24
2005;"AMAPA DO MARANHAO (MA)";"MA";"AMAPA DO MARANHAO";6;0;0;6
2005;"AMARANTE DO MARANHAO (MA)";"MA";"AMARANTE DO MARANHAO";39;1;4;44
2005;"ANAJATUBA (MA)";"MA";"ANAJATUBA";16;2;3;21
2005;"ANAPURUS (MA)";"MA";"ANAPURUS";16;1;1;18
2005;"APICUM ACU (MA)";"MA";"APICUM ACU";2;2;0;4
2005;"ARAGUANA (MA)";"MA";"ARAGUANA";3;1;1;5
2005;"ARAIOSES (MA)";"MA";"ARAIOSES";11;3;7;21
2005;"ARAME (MA)";"MA";"ARAME";70;3;0;73
2005;"ARARI (MA)";"MA";"ARARI";44;6;4;54
2005;"AXIXA (MA)";"MA";"AXIXA";7;4;2;13
2005;"BACABAL (MA)";"MA";"BACABAL";472;52;36;560
2005;"BACABEIRA (MA)";"MA";"BACABEIRA";39;1;1;41
2005;"BACURI (MA)";"MA";"BACURI";4;2;2;8
2005;"BACURITUBA (MA)";"MA";"BACURITUBA";2;1;0;3
2005;"BALSAS (MA)";"MA";"BALSAS";699;28;38;765
2005;"BARAO DE GRAJAU (MA)";"MA";"BARAO DE GRAJAU";14;1;2;17
2005;"BARRA DO CORDA (MA)";"MA";"BARRA DO CORDA";272;7;6;285
2005;"BARREIRINHAS (MA)";"MA";"BARREIRINHAS";22;7;10;39
2005;"BELA VISTA DO MARANHAO (MA)";"MA";"BELA VISTA DO MARANHAO";13;1;0;14
2005;"BELAGUA (MA)";"MA";"BELAGUA";3;3;2;8
2005;"BENEDITO LEITE (MA)";"MA";"BENEDITO LEITE";0;0;0;0
2005;"BEQUIMAO (MA)";"MA";"BEQUIMAO";39;3;5;47
2005;"BERNARDO DO MEARIM (MA)";"MA";"BERNARDO DO MEARIM";7;1;0;8
2005;"BOA VISTA DO GURUPI (MA)";"MA";"BOA VISTA DO GURUPI";2;1;1;4
2005;"BOM JARDIM (MA)";"MA";"BOM JARDIM";42;4;3;49
2005;"BOM JESUS DAS SELVAS (MA)";"MA";"BOM JESUS DAS SELVAS";48;4;2;54
2005;"BOM LUGAR (MA)";"MA";"BOM LUGAR";11;3;5;19
2005;"BREJO (MA)";"MA";"BREJO";33;7;4;44
2005;"BREJO DE AREIA (MA)";"MA";"BREJO DE AREIA";17;3;1;21
2005;"BURITI (MA)";"MA";"BURITI";6;1;3;10
2005;"BURITI BRAVO (MA)";"MA";"BURITI BRAVO";15;1;0;16
2005;"BURITICUPU (MA)";"MA";"BURITICUPU";156;11;4;171
2005;"BURITIRANA (MA)";"MA";"BURITIRANA";6;0;0;6
2005;"CACHOEIRA GRANDE (MA)";"MA";"CACHOEIRA GRANDE";3;1;0;4
2005;"CAJAPIO (MA)";"MA";"CAJAPIO";5;1;2;8
2005;"CAJARI (MA)";"MA";"CAJARI";0;0;0;0
2005;"CAMPESTRE DO MARANHAO (MA)";"MA";"CAMPESTRE DO MARANHAO";6;3;0;9
2005;"CANDIDO MENDES (MA)";"MA";"CANDIDO MENDES";4;1;0;5
2005;"CANTANHEDE (MA)";"MA";"CANTANHEDE";11;2;0;13
2005;"CAPINZAL DO NORTE (MA)";"MA";"CAPINZAL DO NORTE";13;9;0;22
2005;"CAROLINA (MA)";"MA";"CAROLINA";35;2;3;40
2005;"CARUTAPERA (MA)";"MA";"CARUTAPERA";10;3;5;18
2005;"CAXIAS (MA)";"MA";"CAXIAS";384;26;46;456
2005;"CEDRAL (MA)";"MA";"CEDRAL";3;0;3;6
2005;"CENTRAL DO MARANHAO (MA)";"MA";"CENTRAL DO MARANHAO";4;0;0;4
2005;"CENTRO DO GUILHERME (MA)";"MA";"CENTRO DO GUILHERME";3;0;0;3
2005;"CENTRO NOVO DO MARANHAO (MA)";"MA";"CENTRO NOVO DO MARANHAO";6;0;1;7
2005;"CHAPADINHA (MA)";"MA";"CHAPADINHA";158;24;7;189
2005;"CIDELANDIA (MA)";"MA";"CIDELANDIA";14;4;4;22
2005;"CODO (MA)";"MA";"CODO";338;9;8;355
2005;"COELHO NETO (MA)";"MA";"COELHO NETO";56;5;7;68
2005;"COLINAS (MA)";"MA";"COLINAS";62;7;3;72
2005;"CONCEICAO DO LAGO ACU (MA)";"MA";"CONCEICAO DO LAGO ACU";3;1;0;4
2005;"COROATA (MA)";"MA";"COROATA";101;21;5;127
2005;"CURURUPU (MA)";"MA";"CURURUPU";12;0;6;18
2005;"DAVINOPOLIS (MA)";"MA";"DAVINOPOLIS";5;0;0;5
2005;"DOM PEDRO (MA)";"MA";"DOM PEDRO";158;5;13;176
2005;"DUQUE BACELAR (MA)";"MA";"DUQUE BACELAR";0;3;2;5
2005;"ESPERANTINOPOLIS (MA)";"MA";"ESPERANTINOPOLIS";29;5;0;34
2005;"ESTREITO (MA)";"MA";"ESTREITO";24;4;1;29
2005;"FEIRA NOVA DO MARANHAO (MA)";"MA";"FEIRA NOVA DO MARANHAO";0;1;0;1
2005;"FERNANDO FALCAO (MA)";"MA";"FERNANDO FALCAO";12;1;2;15
2005;"FORMOSA DA SERRA NEGRA (MA)";"MA";"FORMOSA DA SERRA NEGRA";10;0;0;10
2005;"FORTALEZA DOS NOGUEIRAS (MA)";"MA";"FORTALEZA DOS NOGUEIRAS";15;1;3;19
2005;"FORTUNA (MA)";"MA";"FORTUNA";14;1;0;15
2005;"GODOFREDO VIANA (MA)";"MA";"GODOFREDO VIANA";4;1;2;7
2005;"GONCALVES DIAS (MA)";"MA";"GONCALVES DIAS";12;2;2;16
2005;"GOVERNADOR ARCHER (MA)";"MA";"GOVERNADOR ARCHER";10;4;2;16
2005;"GOVERNADOR EDISON LOBAO (MA)";"MA";"GOVERNADOR EDISON LOBAO";13;1;2;16
2005;"GOVERNADOR EUGENIO BARROS (MA)";"MA";"GOVERNADOR EUGENIO BARROS";12;2;4;18
2005;"GOVERNADOR LUIZ ROCHA (MA)";"MA";"GOVERNADOR LUIZ ROCHA";2;1;1;4
2005;"GOVERNADOR NEWTON BELLO (MA)";"MA";"GOVERNADOR NEWTON BELLO";11;0;1;12
2005;"GOVERNADOR NUNES FREIRE (MA)";"MA";"GOVERNADOR NUNES FREIRE";18;4;0;22
2005;"GRACA ARANHA (MA)";"MA";"GRACA ARANHA";10;4;1;15
2005;"GRAJAU (MA)";"MA";"GRAJAU";195;5;8;208
2005;"GUIMARAES (MA)";"MA";"GUIMARAES";6;2;1;9
2005;"HUMBERTO DE CAMPOS (MA)";"MA";"HUMBERTO DE CAMPOS";5;8;2;15
2005;"ICATU (MA)";"MA";"ICATU";8;2;2;12
2005;"IGARAPE DO MEIO (MA)";"MA";"IGARAPE DO MEIO";6;1;3;10
2005;"IGARAPE GRANDE (MA)";"MA";"IGARAPE GRANDE";34;10;4;48
2005;"IMPERATRIZ (MA)";"MA";"IMPERATRIZ";1742;64;183;1989
2005;"ITAIPAVA DO GRAJAU (MA)";"MA";"ITAIPAVA DO GRAJAU";10;1;0;11
2005;"ITAPECURU MIRIM (MA)";"MA";"ITAPECURU MIRIM";138;6;14;158
2005;"ITINGA DO MARANHAO (MA)";"MA";"ITINGA DO MARANHAO";68;2;1;71
2005;"JATOBA (MA)";"MA";"JATOBA";0;2;0;2
2005;"JENIPAPO DOS VIEIRAS (MA)";"MA";"JENIPAPO DOS VIEIRAS";18;0;1;19
2005;"JOAO LISBOA (MA)";"MA";"JOAO LISBOA";51;1;3;55
2005;"JOSELANDIA (MA)";"MA";"JOSELANDIA";24;4;3;31
2005;"JUNCO DO MARANHAO (MA)";"MA";"JUNCO DO MARANHAO";5;12;0;17
2005;"LAGO DA PEDRA (MA)";"MA";"LAGO DA PEDRA";136;16;3;155
2005;"LAGO DO JUNCO (MA)";"MA";"LAGO DO JUNCO";7;1;3;11
2005;"LAGO DOS RODRIGUES (MA)";"MA";"LAGO DOS RODRIGUES";17;2;2;21
2005;"LAGO VERDE (MA)";"MA";"LAGO VERDE";14;0;2;16
2005;"LAGOA DO MATO (MA)";"MA";"LAGOA DO MATO";2;0;1;3
2005;"LAGOA GRANDE DO MARANHAO (MA)";"MA";"LAGOA GRANDE DO MARANHAO";7;1;0;8
2005;"LAJEADO NOVO (MA)";"MA";"LAJEADO NOVO";4;2;0;6
2005;"LIMA CAMPOS (MA)";"MA";"LIMA CAMPOS";36;3;1;40
2005;"LORETO (MA)";"MA";"LORETO";1;1;1;3
2005;"LUIS DOMINGUES (MA)";"MA";"LUIS DOMINGUES";0;0;1;1
2005;"MAGALHAES DE ALMEIDA (MA)";"MA";"MAGALHAES DE ALMEIDA";2;2;1;5
2005;"MARACACUME (MA)";"MA";"MARACACUME";31;17;1;49
2005;"MARAJA DO SENA (MA)";"MA";"MARAJA DO SENA";4;0;0;4
2005;"MARANHAOZINHO (MA)";"MA";"MARANHAOZINHO";7;1;1;9
2005;"MATA ROMA (MA)";"MA";"MATA ROMA";23;0;4;27
2005;"MATINHA (MA)";"MA";"MATINHA";16;6;0;22
2005;"MATOES (MA)";"MA";"MATOES";7;1;2;10
2005;"MATOES DO NORTE (MA)";"MA";"MATOES DO NORTE";6;2;1;9
2005;"MILAGRES DO MARANHAO (MA)";"MA";"MILAGRES DO MARANHAO";3;2;2;7
2005;"MIRADOR (MA)";"MA";"MIRADOR";6;0;1;7
2005;"MIRANDA DO NORTE (MA)";"MA";"MIRANDA DO NORTE";53;3;4;60
2005;"MIRINZAL (MA)";"MA";"MIRINZAL";13;1;3;17
2005;"MONCAO (MA)";"MA";"MONCAO";6;5;3;14
2005;"MONTES ALTOS (MA)";"MA";"MONTES ALTOS";17;0;1;18
2005;"MORROS (MA)";"MA";"MORROS";2;4;2;8
2005;"NINA RODRIGUES (MA)";"MA";"NINA RODRIGUES";4;2;0;6
2005;"NOVA COLINAS (MA)";"MA";"NOVA COLINAS";3;0;1;4
2005;"NOVA IORQUE (MA)";"MA";"NOVA IORQUE";3;0;0;3
2005;"NOVA OLINDA DO MARANHAO (MA)";"MA";"NOVA OLINDA DO MARANHAO";17;13;0;30
2005;"OLHO D AGUA DAS CUNHAS (MA)";"MA";"OLHO D AGUA DAS CUNHAS";44;5;6;55
2005;"OLINDA NOVA DO MARANHAO (MA)";"MA";"OLINDA NOVA DO MARANHAO";6;2;0;8
2005;"PACO DO LUMIAR (MA)";"MA";"PACO DO LUMIAR";190;81;49;320
2005;"PALMEIRANDIA (MA)";"MA";"PALMEIRANDIA";5;1;4;10
2005;"PARAIBANO (MA)";"MA";"PARAIBANO";18;2;1;21
2005;"PARNARAMA (MA)";"MA";"PARNARAMA";11;0;0;11
2005;"PASSAGEM FRANCA (MA)";"MA";"PASSAGEM FRANCA";11;1;1;13
2005;"PASTOS BONS (MA)";"MA";"PASTOS BONS";27;3;1;31
2005;"PAULINO NEVES (MA)";"MA";"PAULINO NEVES";0;0;0;0
2005;"PAULO RAMOS (MA)";"MA";"PAULO RAMOS";35;2;0;37
2005;"PEDREIRAS (MA)";"MA";"PEDREIRAS";209;28;22;259
2005;"PEDRO DO ROSARIO (MA)";"MA";"PEDRO DO ROSARIO";12;0;1;13
2005;"PENALVA (MA)";"MA";"PENALVA";6;4;2;12
2005;"PERI MIRIM (MA)";"MA";"PERI MIRIM";11;4;4;19
2005;"PERITORO (MA)";"MA";"PERITORO";21;23;3;47
2005;"PINDARE MIRIM (MA)";"MA";"PINDARE MIRIM";56;3;12;71
2005;"PINHEIRO (MA)";"MA";"PINHEIRO";225;14;33;272
2005;"PIO XII (MA)";"MA";"PIO XII";59;5;1;65
2005;"PIRAPEMAS (MA)";"MA";"PIRAPEMAS";9;4;1;14
2005;"POCAO DE PEDRAS (MA)";"MA";"POCAO DE PEDRAS";29;4;3;36
2005;"PORTO FRANCO (MA)";"MA";"PORTO FRANCO";22;0;3;25
2005;"PORTO RICO DO MARANHAO (MA)";"MA";"PORTO RICO DO MARANHAO";2;0;1;3
2005;"PRESIDENTE DUTRA (MA)";"MA";"PRESIDENTE DUTRA";171;10;5;186
2005;"PRESIDENTE JUSCELINO (MA)";"MA";"PRESIDENTE JUSCELINO";4;0;2;6
2005;"PRESIDENTE MEDICI (MA)";"MA";"PRESIDENTE MEDICI";3;7;0;10
2005;"PRESIDENTE SARNEY (MA)";"MA";"PRESIDENTE SARNEY";1;0;1;2
2005;"PRESIDENTE VARGAS (MA)";"MA";"PRESIDENTE VARGAS";8;3;0;11
2005;"PRIMEIRA CRUZ (MA)";"MA";"PRIMEIRA CRUZ";0;1;0;1
2005;"RAPOSA (MA)";"MA";"RAPOSA";27;0;25;52
2005;"RIACHAO (MA)";"MA";"RIACHAO";14;1;3;18
2005;"RIBAMAR FIQUENE (MA)";"MA";"RIBAMAR FIQUENE";7;1;1;9
2005;"ROSARIO (MA)";"MA";"ROSARIO";101;7;13;121
2005;"SAMBAIBA (MA)";"MA";"SAMBAIBA";8;0;0;8
2005;"SANTA FILOMENA DO MARANHAO (MA)";"MA";"SANTA FILOMENA DO MARANHAO";2;2;0;4
2005;"SANTA HELENA (MA)";"MA";"SANTA HELENA";33;4;2;39
2005;"SANTA INES (MA)";"MA";"SANTA INES";325;76;60;461
2005;"SANTA LUZIA (MA)";"MA";"SANTA LUZIA";136;58;7;201
2005;"SANTA LUZIA DO PARUA (MA)";"MA";"SANTA LUZIA DO PARUA";49;7;2;58
2005;"SANTA QUITERIA DO MARANHAO (MA)";"MA";"SANTA QUITERIA DO MARANHAO";12;0;4;16
2005;"SANTA RITA (MA)";"MA";"SANTA RITA";57;4;1;62
2005;"SANTANA DO MARANHAO (MA)";"MA";"SANTANA DO MARANHAO";4;1;3;8
2005;"SANTO AMARO DO MARANHAO (MA)";"MA";"SANTO AMARO DO MARANHAO";0;3;0;3
2005;"SANTO ANTONIO DOS LOPES (MA)";"MA";"SANTO ANTONIO DOS LOPES";41;5;0;46
2005;"SAO BENEDITO DO RIO PRETO (MA)";"MA";"SAO BENEDITO DO RIO PRETO";7;8;1;16
2005;"SAO BENTO (MA)";"MA";"SAO BENTO";44;4;5;53
2005;"SAO BERNARDO (MA)";"MA";"SAO BERNARDO";34;0;6;40
2005;"SAO DOMINGOS DO AZEITAO (MA)";"MA";"SAO DOMINGOS DO AZEITAO";9;0;1;10
2005;"SAO DOMINGOS DO MARANHAO (MA)";"MA";"SAO DOMINGOS DO MARANHAO";77;2;1;80
2005;"SAO FELIX DE BALSAS (MA)";"MA";"SAO FELIX DE BALSAS";1;0;0;1
2005;"SAO FRANCISCO DO BREJAO (MA)";"MA";"SAO FRANCISCO DO BREJAO";25;1;2;28
2005;"SAO FRANCISCO DO MARANHAO (MA)";"MA";"SAO FRANCISCO DO MARANHAO";2;0;0;2
2005;"SAO JOAO BATISTA (MA)";"MA";"SAO JOAO BATISTA";18;4;4;26
2005;"SAO JOAO DO CARU (MA)";"MA";"SAO JOAO DO CARU";3;1;0;4
2005;"SAO JOAO DO PARAISO (MA)";"MA";"SAO JOAO DO PARAISO";3;0;1;4
2005;"SAO JOAO DO SOTER (MA)";"MA";"SAO JOAO DO SOTER";6;1;0;7
2005;"SAO JOAO DOS PATOS (MA)";"MA";"SAO JOAO DOS PATOS";79;1;1;81
2005;"SAO JOSE DE RIBAMAR (MA)";"MA";"SAO JOSE DE RIBAMAR";260;86;32;378
2005;"SAO JOSE DOS BASILIOS (MA)";"MA";"SAO JOSE DOS BASILIOS";5;0;2;7
2005;"SAO LUIS (MA)";"MA";"SAO LUIS";4608;756;2258;7622
2005;"SAO LUIS GONZAGA DO MARANHAO (MA)";"MA";"SAO LUIS GONZAGA DO MARANHAO";19;4;2;25
2005;"SAO MATEUS DO MARANHAO (MA)";"MA";"SAO MATEUS DO MARANHAO";59;29;11;99
2005;"SAO PEDRO DA AGUA BRANCA (MA)";"MA";"SAO PEDRO DA AGUA BRANCA";4;0;0;4
2005;"SAO PEDRO DOS CRENTES (MA)";"MA";"SAO PEDRO DOS CRENTES";3;1;0;4
2005;"SAO RAIMUNDO DAS MANGABEIRAS (MA)";"MA";"SAO RAIMUNDO DAS MANGABEIRAS";33;1;15;49
2005;"SAO RAIMUNDO DO DOCA BEZERRA (MA)";"MA";"SAO RAIMUNDO DO DOCA BEZERRA";11;0;0;11
2005;"SAO ROBERTO (MA)";"MA";"SAO ROBERTO";3;2;0;5
2005;"SAO VICENTE FERRER (MA)";"MA";"SAO VICENTE FERRER";16;1;2;19
2005;"SATUBINHA (MA)";"MA";"SATUBINHA";8;2;0;10
2005;"SENADOR ALEXANDRE COSTA (MA)";"MA";"SENADOR ALEXANDRE COSTA";11;2;0;13
2005;"SENADOR LA ROCQUE (MA)";"MA";"SENADOR LA ROCQUE";24;0;1;25
2005;"SERRANO DO MARANHAO (MA)";"MA";"SERRANO DO MARANHAO";0;0;1;1
2005;"SITIO NOVO (MA)";"MA";"SITIO NOVO";12;0;1;13
2005;"SUCUPIRA DO NORTE (MA)";"MA";"SUCUPIRA DO NORTE";9;2;1;12
2005;"SUCUPIRA DO RIACHAO (MA)";"MA";"SUCUPIRA DO RIACHAO";1;1;1;3
2005;"TASSO FRAGOSO (MA)";"MA";"TASSO FRAGOSO";14;1;1;16
2005;"TIMBIRAS (MA)";"MA";"TIMBIRAS";16;5;0;21
2005;"TIMON (MA)";"MA";"TIMON";287;27;32;346
2005;"TRIZIDELA DO VALE (MA)";"MA";"TRIZIDELA DO VALE";66;7;3;76
2005;"TUFILANDIA (MA)";"MA";"TUFILANDIA";2;5;0;7
2005;"TUNTUM (MA)";"MA";"TUNTUM";50;5;4;59
2005;"TURIACU (MA)";"MA";"TURIACU";9;1;3;13
2005;"TURILANDIA (MA)";"MA";"TURILANDIA";5;3;1;9
2005;"TUTOIA (MA)";"MA";"TUTOIA";10;1;4;15
2005;"URBANO SANTOS (MA)";"MA";"URBANO SANTOS";22;3;2;27
2005;"VARGEM GRANDE (MA)";"MA";"VARGEM GRANDE";57;2;2;61
2005;"VIANA (MA)";"MA";"VIANA";83;7;4;94
2005;"VILA NOVA DOS MARTIRIOS (MA)";"MA";"VILA NOVA DOS MARTIRIOS";2;1;0;3
2005;"VITORIA DO MEARIM (MA)";"MA";"VITORIA DO MEARIM";33;2;3;38
2005;"VITORINO FREIRE (MA)";"MA";"VITORINO FREIRE";83;9;3;95
2005;"ZE DOCA (MA)";"MA";"ZE DOCA";94;14;6;114
2005;"ABADIA DOS DOURADOS (MG)";"MG";"ABADIA DOS DOURADOS";77;19;5;101
2005;"ABAETE (MG)";"MG";"ABAETE";373;16;121;510
2005;"ABRE CAMPO (MG)";"MG";"ABRE CAMPO";93;8;33;134
2005;"ACAIACA (MG)";"MG";"ACAIACA";15;2;6;23
2005;"ACUCENA (MG)";"MG";"ACUCENA";25;3;21;49
2005;"AGUA BOA (MG)";"MG";"AGUA BOA";35;1;14;50
2005;"AGUA COMPRIDA (MG)";"MG";"AGUA COMPRIDA";34;7;6;47
2005;"AGUANIL (MG)";"MG";"AGUANIL";26;3;6;35
2005;"AGUAS FORMOSAS (MG)";"MG";"AGUAS FORMOSAS";51;10;8;69
2005;"AGUAS VERMELHAS (MG)";"MG";"AGUAS VERMELHAS";52;5;8;65
2005;"AIMORES (MG)";"MG";"AIMORES";147;10;20;177
2005;"AIURUOCA (MG)";"MG";"AIURUOCA";65;6;6;77
2005;"ALAGOA (MG)";"MG";"ALAGOA";11;0;7;18
2005;"ALBERTINA (MG)";"MG";"ALBERTINA";30;4;5;39
2005;"ALEM PARAIBA (MG)";"MG";"ALEM PARAIBA";1093;51;45;1189
2005;"ALFENAS (MG)";"MG";"ALFENAS";823;55;206;1084
2005;"ALFREDO VASCONCELOS (MG)";"MG";"ALFREDO VASCONCELOS";115;6;15;136
2005;"ALMENARA (MG)";"MG";"ALMENARA";147;13;48;208
2005;"ALPERCATA (MG)";"MG";"ALPERCATA";39;1;5;45
2005;"ALPINOPOLIS (MG)";"MG";"ALPINOPOLIS";339;10;25;374
2005;"ALTEROSA (MG)";"MG";"ALTEROSA";171;12;21;204
2005;"ALTO CAPARAO (MG)";"MG";"ALTO CAPARAO";41;4;2;47
2005;"ALTO JEQUITIBA (MG)";"MG";"ALTO JEQUITIBA";50;4;9;63
2005;"ALTO RIO DOCE (MG)";"MG";"ALTO RIO DOCE";69;6;14;89
2005;"ALVARENGA (MG)";"MG";"ALVARENGA";17;0;8;25
2005;"ALVINOPOLIS (MG)";"MG";"ALVINOPOLIS";123;10;21;154
2005;"ALVORADA DE MINAS (MG)";"MG";"ALVORADA DE MINAS";3;0;5;8
2005;"AMPARO DA SERRA (MG)";"MG";"AMPARO DA SERRA";22;2;13;37
2005;"ANDRADAS (MG)";"MG";"ANDRADAS";839;43;51;933
2005;"ANDRELANDIA (MG)";"MG";"ANDRELANDIA";105;10;6;121
2005;"ANGELANDIA (MG)";"MG";"ANGELANDIA";38;1;12;51
2005;"ANTONIO CARLOS (MG)";"MG";"ANTONIO CARLOS";113;4;11;128
2005;"ANTONIO DIAS (MG)";"MG";"ANTONIO DIAS";50;6;35;91
2005;"ANTONIO PRADO DE MINAS (MG)";"MG";"ANTONIO PRADO DE MINAS";10;0;4;14
2005;"ARACAI (MG)";"MG";"ARACAI";10;2;3;15
2005;"ARACITABA (MG)";"MG";"ARACITABA";9;4;1;14
2005;"ARACUAI (MG)";"MG";"ARACUAI";126;6;44;176
2005;"ARAGUARI (MG)";"MG";"ARAGUARI";1662;195;165;2022
2005;"ARANTINA (MG)";"MG";"ARANTINA";20;0;2;22
2005;"ARAPONGA (MG)";"MG";"ARAPONGA";33;1;7;41
2005;"ARAPORA (MG)";"MG";"ARAPORA";136;13;60;209
2005;"ARAPUA (MG)";"MG";"ARAPUA";30;1;10;41
2005;"ARAUJOS (MG)";"MG";"ARAUJOS";90;5;4;99
2005;"ARAXA (MG)";"MG";"ARAXA";1274;79;224;1577
2005;"ARCEBURGO (MG)";"MG";"ARCEBURGO";83;17;25;125
2005;"ARCOS (MG)";"MG";"ARCOS";766;47;149;962
2005;"AREADO (MG)";"MG";"AREADO";170;11;47;228
2005;"ARGIRITA (MG)";"MG";"ARGIRITA";16;3;2;21
2005;"ARICANDUVA (MG)";"MG";"ARICANDUVA";9;0;8;17
2005;"ARINOS (MG)";"MG";"ARINOS";113;8;35;156
2005;"ASTOLFO DUTRA (MG)";"MG";"ASTOLFO DUTRA";173;8;12;193
2005;"ATALEIA (MG)";"MG";"ATALEIA";51;9;13;73
2005;"AUGUSTO DE LIMA (MG)";"MG";"AUGUSTO DE LIMA";21;1;10;32
2005;"BAEPENDI (MG)";"MG";"BAEPENDI";283;24;16;323
2005;"BALDIM (MG)";"MG";"BALDIM";80;4;6;90
2005;"BAMBUI (MG)";"MG";"BAMBUI";335;11;76;422
2005;"BANDEIRA (MG)";"MG";"BANDEIRA";1;3;1;5
2005;"BANDEIRA DO SUL (MG)";"MG";"BANDEIRA DO SUL";106;14;5;125
2005;"BARAO DE COCAIS (MG)";"MG";"BARAO DE COCAIS";290;30;44;364
2005;"BARAO DE MONTE ALTO (MG)";"MG";"BARAO DE MONTE ALTO";12;5;4;21
2005;"BARBACENA (MG)";"MG";"BARBACENA";1212;176;153;1541
2005;"BARRA LONGA (MG)";"MG";"BARRA LONGA";45;2;4;51
2005;"BARROSO (MG)";"MG";"BARROSO";277;14;12;303
2005;"BELA VISTA DE MINAS (MG)";"MG";"BELA VISTA DE MINAS";92;11;8;111
2005;"BELMIRO BRAGA (MG)";"MG";"BELMIRO BRAGA";33;4;1;38
2005;"BELO HORIZONTE (MG)";"MG";"BELO HORIZONTE";24009;3048;6272;33329
2005;"BELO ORIENTE (MG)";"MG";"BELO ORIENTE";199;10;50;259
2005;"BELO VALE (MG)";"MG";"BELO VALE";80;4;14;98
2005;"BERILO (MG)";"MG";"BERILO";44;2;20;66
2005;"BERIZAL (MG)";"MG";"BERIZAL";9;1;5;15
2005;"BERTOPOLIS (MG)";"MG";"BERTOPOLIS";8;1;1;10
2005;"BETIM (MG)";"MG";"BETIM";2580;340;663;3583
2005;"BIAS FORTES (MG)";"MG";"BIAS FORTES";22;1;2;25
2005;"BICAS (MG)";"MG";"BICAS";181;18;21;220
2005;"BIQUINHAS (MG)";"MG";"BIQUINHAS";27;5;2;34
2005;"BOA ESPERANCA (MG)";"MG";"BOA ESPERANCA";453;21;98;572
2005;"BOCAINA DE MINAS (MG)";"MG";"BOCAINA DE MINAS";42;4;5;51
2005;"BOCAIUVA (MG)";"MG";"BOCAIUVA";262;20;79;361
2005;"BOM DESPACHO (MG)";"MG";"BOM DESPACHO";837;30;175;1042
2005;"BOM JARDIM DE MINAS (MG)";"MG";"BOM JARDIM DE MINAS";64;4;10;78
2005;"BOM JESUS DA PENHA (MG)";"MG";"BOM JESUS DA PENHA";83;3;6;92
2005;"BOM JESUS DO AMPARO (MG)";"MG";"BOM JESUS DO AMPARO";41;3;6;50
2005;"BOM JESUS DO GALHO (MG)";"MG";"BOM JESUS DO GALHO";63;4;7;74
2005;"BOM REPOUSO (MG)";"MG";"BOM REPOUSO";135;4;4;143
2005;"BOM SUCESSO (MG)";"MG";"BOM SUCESSO";188;8;23;219
2005;"BONFIM (MG)";"MG";"BONFIM";82;8;13;103
2005;"BONFINOPOLIS DE MINAS (MG)";"MG";"BONFINOPOLIS DE MINAS";68;1;18;87
2005;"BONITO DE MINAS (MG)";"MG";"BONITO DE MINAS";14;2;11;27
2005;"BORDA DA MATA (MG)";"MG";"BORDA DA MATA";226;12;49;287
2005;"BOTELHOS (MG)";"MG";"BOTELHOS";197;22;21;240
2005;"BOTUMIRIM (MG)";"MG";"BOTUMIRIM";4;1;4;9
2005;"BRAS PIRES (MG)";"MG";"BRAS PIRES";25;4;4;33
2005;"BRASILANDIA DE MINAS (MG)";"MG";"BRASILANDIA DE MINAS";161;5;62;228
2005;"BRASILIA DE MINAS (MG)";"MG";"BRASILIA DE MINAS";118;8;55;181
2005;"BRASOPOLIS (MG)";"MG";"BRASOPOLIS";151;13;20;184
2005;"BRAUNAS (MG)";"MG";"BRAUNAS";6;3;8;17
2005;"BRUMADINHO (MG)";"MG";"BRUMADINHO";558;64;101;723
2005;"BUENO BRANDAO (MG)";"MG";"BUENO BRANDAO";123;12;22;157
2005;"BUENOPOLIS (MG)";"MG";"BUENOPOLIS";64;2;15;81
2005;"BUGRE (MG)";"MG";"BUGRE";17;1;3;21
2005;"BURITIS (MG)";"MG";"BURITIS";215;3;66;284
2005;"BURITIZEIRO (MG)";"MG";"BURITIZEIRO";151;0;39;190
2005;"CABECEIRA GRANDE (MG)";"MG";"CABECEIRA GRANDE";20;3;7;30
2005;"CABO VERDE (MG)";"MG";"CABO VERDE";154;8;19;181
2005;"CACHOEIRA DA PRATA (MG)";"MG";"CACHOEIRA DA PRATA";42;5;2;49
2005;"CACHOEIRA DE MINAS (MG)";"MG";"CACHOEIRA DE MINAS";101;17;14;132
2005;"CACHOEIRA DE PAJEU (MG)";"MG";"CACHOEIRA DE PAJEU";22;7;12;41
2005;"CACHOEIRA DOURADA (MG)";"MG";"CACHOEIRA DOURADA";11;6;2;19
2005;"CAETANOPOLIS (MG)";"MG";"CAETANOPOLIS";78;6;23;107
2005;"CAETE (MG)";"MG";"CAETE";381;48;54;483
2005;"CAIANA (MG)";"MG";"CAIANA";23;1;6;30
2005;"CAJURI (MG)";"MG";"CAJURI";32;2;6;40
2005;"CALDAS (MG)";"MG";"CALDAS";185;8;25;218
2005;"CAMACHO (MG)";"MG";"CAMACHO";50;2;5;57
2005;"CAMANDUCAIA (MG)";"MG";"CAMANDUCAIA";390;21;31;442
2005;"CAMBUI (MG)";"MG";"CAMBUI";383;17;72;472
2005;"CAMBUQUIRA (MG)";"MG";"CAMBUQUIRA";98;13;5;116
2005;"CAMPANARIO (MG)";"MG";"CAMPANARIO";9;3;3;15
2005;"CAMPANHA (MG)";"MG";"CAMPANHA";167;11;17;195
2005;"CAMPESTRE (MG)";"MG";"CAMPESTRE";367;18;29;414
2005;"CAMPINA VERDE (MG)";"MG";"CAMPINA VERDE";247;12;29;288
2005;"CAMPO AZUL (MG)";"MG";"CAMPO AZUL";1;0;3;4
2005;"CAMPO BELO (MG)";"MG";"CAMPO BELO";913;33;107;1053
2005;"CAMPO DO MEIO (MG)";"MG";"CAMPO DO MEIO";87;10;44;141
2005;"CAMPO FLORIDO (MG)";"MG";"CAMPO FLORIDO";79;14;32;125
2005;"CAMPOS ALTOS (MG)";"MG";"CAMPOS ALTOS";260;12;43;315
2005;"CAMPOS GERAIS (MG)";"MG";"CAMPOS GERAIS";213;9;41;263
2005;"CANA VERDE (MG)";"MG";"CANA VERDE";39;4;5;48
2005;"CANAA (MG)";"MG";"CANAA";42;2;7;51
2005;"CANAPOLIS (MG)";"MG";"CANAPOLIS";173;7;76;256
2005;"CANDEIAS (MG)";"MG";"CANDEIAS";193;10;23;226
2005;"CANTAGALO (MG)";"MG";"CANTAGALO";8;2;4;14
2005;"CAPARAO (MG)";"MG";"CAPARAO";39;1;3;43
2005;"CAPELA NOVA (MG)";"MG";"CAPELA NOVA";12;8;2;22
2005;"CAPELINHA (MG)";"MG";"CAPELINHA";441;13;96;550
2005;"CAPETINGA (MG)";"MG";"CAPETINGA";147;6;26;179
2005;"CAPIM BRANCO (MG)";"MG";"CAPIM BRANCO";49;4;15;68
2005;"CAPINOPOLIS (MG)";"MG";"CAPINOPOLIS";226;16;45;287
2005;"CAPITAO ANDRADE (MG)";"MG";"CAPITAO ANDRADE";17;1;2;20
2005;"CAPITAO ENEAS (MG)";"MG";"CAPITAO ENEAS";41;1;14;56
2005;"CAPITOLIO (MG)";"MG";"CAPITOLIO";119;11;10;140
2005;"CAPUTIRA (MG)";"MG";"CAPUTIRA";57;1;16;74
2005;"CARAI (MG)";"MG";"CARAI";26;19;24;69
2005;"CARANAIBA (MG)";"MG";"CARANAIBA";15;3;8;26
2005;"CARANDAI (MG)";"MG";"CARANDAI";391;15;72;478
2005;"CARANGOLA (MG)";"MG";"CARANGOLA";300;26;34;360
2005;"CARATINGA (MG)";"MG";"CARATINGA";909;27;1026;1962
2005;"CARBONITA (MG)";"MG";"CARBONITA";138;5;37;180
2005;"CAREACU (MG)";"MG";"CAREACU";61;7;3;71
2005;"CARLOS CHAGAS (MG)";"MG";"CARLOS CHAGAS";104;22;26;152
2005;"CARMESIA (MG)";"MG";"CARMESIA";40;1;916;957
2005;"CARMO DA CACHOEIRA (MG)";"MG";"CARMO DA CACHOEIRA";127;12;31;170
2005;"CARMO DA MATA (MG)";"MG";"CARMO DA MATA";93;8;30;131
2005;"CARMO DE MINAS (MG)";"MG";"CARMO DE MINAS";93;14;13;120
2005;"CARMO DO CAJURU (MG)";"MG";"CARMO DO CAJURU";226;11;48;285
2005;"CARMO DO PARANAIBA (MG)";"MG";"CARMO DO PARANAIBA";471;20;74;565
2005;"CARMO DO RIO CLARO (MG)";"MG";"CARMO DO RIO CLARO";239;14;53;306
2005;"CARMOPOLIS DE MINAS (MG)";"MG";"CARMOPOLIS DE MINAS";398;8;24;430
2005;"CARNEIRINHO (MG)";"MG";"CARNEIRINHO";118;23;47;188
2005;"CARRANCAS (MG)";"MG";"CARRANCAS";33;3;10;46
2005;"CARVALHOPOLIS (MG)";"MG";"CARVALHOPOLIS";32;9;3;44
2005;"CARVALHOS (MG)";"MG";"CARVALHOS";34;2;4;40
2005;"CASA GRANDE (MG)";"MG";"CASA GRANDE";19;1;1;21
2005;"CASCALHO RICO (MG)";"MG";"CASCALHO RICO";50;13;5;68
2005;"CASSIA (MG)";"MG";"CASSIA";333;12;26;371
2005;"CATAGUASES (MG)";"MG";"CATAGUASES";582;48;119;749
2005;"CATAS ALTAS (MG)";"MG";"CATAS ALTAS";75;7;7;89
2005;"CATAS ALTAS DA NORUEGA (MG)";"MG";"CATAS ALTAS DA NORUEGA";30;0;7;37
2005;"CATUJI (MG)";"MG";"CATUJI";22;6;4;32
2005;"CATUTI (MG)";"MG";"CATUTI";6;4;11;21
2005;"CAXAMBU (MG)";"MG";"CAXAMBU";187;18;18;223
2005;"CEDRO DO ABAETE (MG)";"MG";"CEDRO DO ABAETE";8;1;1;10
2005;"CENTRAL DE MINAS (MG)";"MG";"CENTRAL DE MINAS";51;4;7;62
2005;"CENTRALINA (MG)";"MG";"CENTRALINA";87;1;11;99
2005;"CHACARA (MG)";"MG";"CHACARA";18;4;2;24
2005;"CHALE (MG)";"MG";"CHALE";30;4;4;38
2005;"CHAPADA DO NORTE (MG)";"MG";"CHAPADA DO NORTE";23;8;10;41
2005;"CHAPADA GAUCHA (MG)";"MG";"CHAPADA GAUCHA";44;2;5;51
2005;"CHIADOR (MG)";"MG";"CHIADOR";24;2;6;32
2005;"CIPOTANEA (MG)";"MG";"CIPOTANEA";27;2;7;36
2005;"CLARAVAL (MG)";"MG";"CLARAVAL";188;5;22;215
2005;"CLARO DOS POCOES (MG)";"MG";"CLARO DOS POCOES";17;0;13;30
2005;"CLAUDIO (MG)";"MG";"CLAUDIO";504;18;35;557
2005;"COIMBRA (MG)";"MG";"COIMBRA";73;1;7;81
2005;"COLUNA (MG)";"MG";"COLUNA";21;0;9;30
2005;"COMENDADOR GOMES (MG)";"MG";"COMENDADOR GOMES";28;2;3;33
2005;"COMERCINHO (MG)";"MG";"COMERCINHO";18;3;9;30
2005;"CONCEICAO DA APARECIDA (MG)";"MG";"CONCEICAO DA APARECIDA";100;3;7;110
2005;"CONCEICAO DA BARRA DE MINAS (MG)";"MG";"CONCEICAO DA BARRA DE MINAS";27;5;4;36
2005;"CONCEICAO DAS ALAGOAS (MG)";"MG";"CONCEICAO DAS ALAGOAS";371;12;57;440
2005;"CONCEICAO DAS PEDRAS (MG)";"MG";"CONCEICAO DAS PEDRAS";16;4;2;22
2005;"CONCEICAO DE IPANEMA (MG)";"MG";"CONCEICAO DE IPANEMA";20;4;2;26
2005;"CONCEICAO DO MATO DENTRO (MG)";"MG";"CONCEICAO DO MATO DENTRO";70;3;60;133
2005;"CONCEICAO DO PARA (MG)";"MG";"CONCEICAO DO PARA";46;6;12;64
2005;"CONCEICAO DO RIO VERDE (MG)";"MG";"CONCEICAO DO RIO VERDE";166;23;14;203
2005;"CONCEICAO DOS OUROS (MG)";"MG";"CONCEICAO DOS OUROS";185;18;2;205
2005;"CONEGO MARINHO (MG)";"MG";"CONEGO MARINHO";5;2;5;12
2005;"CONFINS (MG)";"MG";"CONFINS";75;10;5;90
2005;"CONGONHAL (MG)";"MG";"CONGONHAL";158;3;11;172
2005;"CONGONHAS (MG)";"MG";"CONGONHAS";540;55;73;668
2005;"CONGONHAS DO NORTE (MG)";"MG";"CONGONHAS DO NORTE";18;2;2;22
2005;"CONQUISTA (MG)";"MG";"CONQUISTA";134;9;27;170
2005;"CONSELHEIRO LAFAIETE (MG)";"MG";"CONSELHEIRO LAFAIETE";900;137;297;1334
2005;"CONSELHEIRO PENA (MG)";"MG";"CONSELHEIRO PENA";162;4;36;202
2005;"CONSOLACAO (MG)";"MG";"CONSOLACAO";8;4;0;12
2005;"CONTAGEM (MG)";"MG";"CONTAGEM";9070;803;1612;11485
2005;"COQUEIRAL (MG)";"MG";"COQUEIRAL";82;5;8;95
2005;"CORACAO DE JESUS (MG)";"MG";"CORACAO DE JESUS";109;2;69;180
2005;"CORDISBURGO (MG)";"MG";"CORDISBURGO";62;3;8;73
2005;"CORDISLANDIA (MG)";"MG";"CORDISLANDIA";44;2;2;48
2005;"CORINTO (MG)";"MG";"CORINTO";204;3;41;248
2005;"COROACI (MG)";"MG";"COROACI";28;2;8;38
2005;"COROMANDEL (MG)";"MG";"COROMANDEL";435;20;71;526
2005;"CORONEL FABRICIANO (MG)";"MG";"CORONEL FABRICIANO";799;94;324;1217
2005;"CORONEL MURTA (MG)";"MG";"CORONEL MURTA";11;0;6;17
2005;"CORONEL PACHECO (MG)";"MG";"CORONEL PACHECO";30;4;6;40
2005;"CORONEL XAVIER CHAVES (MG)";"MG";"CORONEL XAVIER CHAVES";70;1;1;72
2005;"CORREGO DANTA (MG)";"MG";"CORREGO DANTA";21;2;6;29
2005;"CORREGO DO BOM JESUS (MG)";"MG";"CORREGO DO BOM JESUS";26;4;6;36
2005;"CORREGO FUNDO (MG)";"MG";"CORREGO FUNDO";270;10;12;292
2005;"CORREGO NOVO (MG)";"MG";"CORREGO NOVO";10;4;6;20
2005;"COUTO DE MAGALHAES DE MINAS (MG)";"MG";"COUTO DE MAGALHAES DE MINAS";38;1;6;45
2005;"CRISOLITA (MG)";"MG";"CRISOLITA";8;3;9;20
2005;"CRISTAIS (MG)";"MG";"CRISTAIS";99;4;10;113
2005;"CRISTALIA (MG)";"MG";"CRISTALIA";8;0;8;16
2005;"CRISTIANO OTONI (MG)";"MG";"CRISTIANO OTONI";71;6;6;83
2005;"CRISTINA (MG)";"MG";"CRISTINA";69;14;8;91
2005;"CRUCILANDIA (MG)";"MG";"CRUCILANDIA";89;2;6;97
2005;"CRUZEIRO DA FORTALEZA (MG)";"MG";"CRUZEIRO DA FORTALEZA";44;4;5;53
2005;"CRUZILIA (MG)";"MG";"CRUZILIA";246;10;17;273
2005;"CUPARAQUE (MG)";"MG";"CUPARAQUE";26;4;3;33
2005;"CURRAL DE DENTRO (MG)";"MG";"CURRAL DE DENTRO";39;4;1;44
2005;"CURVELO (MG)";"MG";"CURVELO";827;16;474;1317
2005;"DATAS (MG)";"MG";"DATAS";18;2;8;28
2005;"DELFIM MOREIRA (MG)";"MG";"DELFIM MOREIRA";66;1;11;78
2005;"DELFINOPOLIS (MG)";"MG";"DELFINOPOLIS";65;10;8;83
2005;"DELTA (MG)";"MG";"DELTA";327;16;102;445
2005;"DESCOBERTO (MG)";"MG";"DESCOBERTO";24;3;1;28
2005;"DESTERRO DE ENTRE RIOS (MG)";"MG";"DESTERRO DE ENTRE RIOS";67;4;15;86
2005;"DESTERRO DO MELO (MG)";"MG";"DESTERRO DO MELO";20;2;8;30
2005;"DIAMANTINA (MG)";"MG";"DIAMANTINA";227;37;193;457
2005;"DIOGO DE VASCONCELOS (MG)";"MG";"DIOGO DE VASCONCELOS";14;1;5;20
2005;"DIONISIO (MG)";"MG";"DIONISIO";33;3;11;47
2005;"DIVINESIA (MG)";"MG";"DIVINESIA";28;6;3;37
2005;"DIVINO (MG)";"MG";"DIVINO";197;7;26;230
2005;"DIVINO DAS LARANJEIRAS (MG)";"MG";"DIVINO DAS LARANJEIRAS";24;0;4;28
2005;"DIVINOLANDIA DE MINAS (MG)";"MG";"DIVINOLANDIA DE MINAS";41;2;15;58
2005;"DIVINOPOLIS (MG)";"MG";"DIVINOPOLIS";2652;154;580;3386
2005;"DIVISA ALEGRE (MG)";"MG";"DIVISA ALEGRE";28;1;5;34
2005;"DIVISA NOVA (MG)";"MG";"DIVISA NOVA";44;6;9;59
2005;"DIVISOPOLIS (MG)";"MG";"DIVISOPOLIS";7;5;4;16
2005;"DOM BOSCO (MG)";"MG";"DOM BOSCO";12;2;12;26
2005;"DOM CAVATI (MG)";"MG";"DOM CAVATI";91;1;4;96
2005;"DOM JOAQUIM (MG)";"MG";"DOM JOAQUIM";3;2;4;9
2005;"DOM SILVERIO (MG)";"MG";"DOM SILVERIO";42;5;4;51
2005;"DOM VICOSO (MG)";"MG";"DOM VICOSO";15;9;5;29
2005;"DONA EUZEBIA (MG)";"MG";"DONA EUZEBIA";235;3;2;240
2005;"DORES DE CAMPOS (MG)";"MG";"DORES DE CAMPOS";53;5;17;75
2005;"DORES DE GUANHAES (MG)";"MG";"DORES DE GUANHAES";40;0;14;54
2005;"DORES DO INDAIA (MG)";"MG";"DORES DO INDAIA";191;14;11;216
2005;"DORES DO TURVO (MG)";"MG";"DORES DO TURVO";23;2;13;38
2005;"DORESOPOLIS (MG)";"MG";"DORESOPOLIS";9;5;1;15
2005;"DOURADOQUARA (MG)";"MG";"DOURADOQUARA";25;6;0;31
2005;"DURANDE (MG)";"MG";"DURANDE";52;1;10;63
2005;"ELOI MENDES (MG)";"MG";"ELOI MENDES";410;30;22;462
2005;"ENGENHEIRO CALDAS (MG)";"MG";"ENGENHEIRO CALDAS";87;5;2;94
2005;"ENGENHEIRO NAVARRO (MG)";"MG";"ENGENHEIRO NAVARRO";30;0;13;43
2005;"ENTRE RIOS DE MINAS (MG)";"MG";"ENTRE RIOS DE MINAS";177;13;33;223
2005;"ENTRE FOLHAS (MG)";"MG";"ENTRE FOLHAS";45;2;2;49
2005;"ERVALIA (MG)";"MG";"ERVALIA";218;4;17;239
2005;"ESMERALDAS (MG)";"MG";"ESMERALDAS";279;10;114;403
2005;"ESPERA FELIZ (MG)";"MG";"ESPERA FELIZ";232;21;24;277
2005;"ESPINOSA (MG)";"MG";"ESPINOSA";263;5;33;301
2005;"ESPIRITO SANTO DO DOURADO (MG)";"MG";"ESPIRITO SANTO DO DOURADO";56;1;4;61
2005;"ESTIVA (MG)";"MG";"ESTIVA";210;5;12;227
2005;"ESTRELA DALVA (MG)";"MG";"ESTRELA DALVA";19;3;1;23
2005;"ESTRELA DO INDAIA (MG)";"MG";"ESTRELA DO INDAIA";33;2;2;37
2005;"ESTRELA DO SUL (MG)";"MG";"ESTRELA DO SUL";68;2;12;82
2005;"EUGENOPOLIS (MG)";"MG";"EUGENOPOLIS";52;9;17;78
2005;"EWBANK DA CAMARA (MG)";"MG";"EWBANK DA CAMARA";34;4;3;41
2005;"EXTREMA (MG)";"MG";"EXTREMA";345;41;42;428
2005;"FAMA (MG)";"MG";"FAMA";7;6;1;14
2005;"FARIA LEMOS (MG)";"MG";"FARIA LEMOS";16;5;0;21
2005;"FELICIO DOS SANTOS (MG)";"MG";"FELICIO DOS SANTOS";10;4;9;23
2005;"FELISBURGO (MG)";"MG";"FELISBURGO";8;4;4;16
2005;"FELIXLANDIA (MG)";"MG";"FELIXLANDIA";148;4;39;191
2005;"FERNANDES TOURINHO (MG)";"MG";"FERNANDES TOURINHO";6;4;5;15
2005;"FERROS (MG)";"MG";"FERROS";70;3;28;101
2005;"FERVEDOURO (MG)";"MG";"FERVEDOURO";67;4;6;77
2005;"FLORESTAL (MG)";"MG";"FLORESTAL";46;3;13;62
2005;"FORMIGA (MG)";"MG";"FORMIGA";1196;70;178;1444
2005;"FORMOSO (MG)";"MG";"FORMOSO";25;0;16;41
2005;"FORTALEZA DE MINAS (MG)";"MG";"FORTALEZA DE MINAS";44;11;6;61
2005;"FORTUNA DE MINAS (MG)";"MG";"FORTUNA DE MINAS";17;3;6;26
2005;"FRANCISCO BADARO (MG)";"MG";"FRANCISCO BADARO";25;0;13;38
2005;"FRANCISCO DUMONT (MG)";"MG";"FRANCISCO DUMONT";35;1;15;51
2005;"FRANCISCO SA (MG)";"MG";"FRANCISCO SA";83;5;37;125
2005;"FRANCISCOPOLIS (MG)";"MG";"FRANCISCOPOLIS";7;2;6;15
2005;"FREI GASPAR (MG)";"MG";"FREI GASPAR";10;4;5;19
2005;"FREI INOCENCIO (MG)";"MG";"FREI INOCENCIO";94;7;18;119
2005;"FREI LAGONEGRO (MG)";"MG";"FREI LAGONEGRO";3;3;4;10
2005;"FRONTEIRA (MG)";"MG";"FRONTEIRA";205;19;42;266
2005;"FRONTEIRA DOS VALES (MG)";"MG";"FRONTEIRA DOS VALES";6;1;1;8
2005;"FRUTA DE LEITE (MG)";"MG";"FRUTA DE LEITE";16;1;14;31
2005;"FRUTAL (MG)";"MG";"FRUTAL";1197;86;105;1388
2005;"FUNILANDIA (MG)";"MG";"FUNILANDIA";29;2;6;37
2005;"GALILEIA (MG)";"MG";"GALILEIA";55;2;8;65
2005;"GAMELEIRAS (MG)";"MG";"GAMELEIRAS";16;1;8;25
2005;"GLAUCILANDIA (MG)";"MG";"GLAUCILANDIA";1;1;3;5
2005;"GOIABEIRA (MG)";"MG";"GOIABEIRA";21;5;3;29
2005;"GOIANA (MG)";"MG";"GOIANA";15;3;2;20
2005;"GONCALVES (MG)";"MG";"GONCALVES";65;11;4;80
2005;"GONZAGA (MG)";"MG";"GONZAGA";19;4;7;30
2005;"GOUVEA (MG)";"MG";"GOUVEA";102;6;19;127
2005;"GOVERNADOR VALADARES (MG)";"MG";"GOVERNADOR VALADARES";2525;161;300;2986
2005;"GRAO MOGOL (MG)";"MG";"GRAO MOGOL";31;0;53;84
2005;"GRUPIARA (MG)";"MG";"GRUPIARA";8;0;2;10
2005;"GUANHAES (MG)";"MG";"GUANHAES";287;22;73;382
2005;"GUAPE (MG)";"MG";"GUAPE";120;6;35;161
2005;"GUARACIABA (MG)";"MG";"GUARACIABA";44;3;15;62
2005;"GUARACIAMA (MG)";"MG";"GUARACIAMA";16;1;11;28
2005;"GUARANESIA (MG)";"MG";"GUARANESIA";269;18;60;347
2005;"GUARANI (MG)";"MG";"GUARANI";86;4;6;96
2005;"GUARARA (MG)";"MG";"GUARARA";42;7;1;50
2005;"GUARDA MOR (MG)";"MG";"GUARDA MOR";66;9;10;85
2005;"GUAXUPE (MG)";"MG";"GUAXUPE";691;43;107;841
2005;"GUIDOVAL (MG)";"MG";"GUIDOVAL";86;0;3;89
2005;"GUIMARANIA (MG)";"MG";"GUIMARANIA";105;4;11;120
2005;"GUIRICEMA (MG)";"MG";"GUIRICEMA";149;4;14;167
2005;"GURINHATA (MG)";"MG";"GURINHATA";79;5;17;101
2005;"HELIODORA (MG)";"MG";"HELIODORA";51;5;7;63
2005;"IAPU (MG)";"MG";"IAPU";87;8;11;106
2005;"IBERTIOGA (MG)";"MG";"IBERTIOGA";31;4;2;37
2005;"IBIA (MG)";"MG";"IBIA";297;14;68;379
2005;"IBIAI (MG)";"MG";"IBIAI";34;1;3;38
2005;"IBIRACATU (MG)";"MG";"IBIRACATU";4;2;5;11
2005;"IBIRACI (MG)";"MG";"IBIRACI";314;22;23;359
2005;"IBIRITE (MG)";"MG";"IBIRITE";680;78;180;938
2005;"IBITIURA DE MINAS (MG)";"MG";"IBITIURA DE MINAS";55;1;3;59
2005;"IBITURUNA (MG)";"MG";"IBITURUNA";22;5;1;28
2005;"ICARAI DE MINAS (MG)";"MG";"ICARAI DE MINAS";11;2;1;14
2005;"IGARAPE (MG)";"MG";"IGARAPE";467;32;83;582
2005;"IGARATINGA (MG)";"MG";"IGARATINGA";263;4;10;277
2005;"IGUATAMA (MG)";"MG";"IGUATAMA";108;4;13;125
2005;"IJACI (MG)";"MG";"IJACI";81;2;8;91
2005;"ILICINEA (MG)";"MG";"ILICINEA";140;3;24;167
2005;"IMBE DE MINAS (MG)";"MG";"IMBE DE MINAS";19;1;5;25
2005;"INCONFIDENTES (MG)";"MG";"INCONFIDENTES";59;9;8;76
2005;"INDAIABIRA (MG)";"MG";"INDAIABIRA";22;3;14;39
2005;"INDIANOPOLIS (MG)";"MG";"INDIANOPOLIS";47;23;10;80
2005;"INGAI (MG)";"MG";"INGAI";15;4;4;23
2005;"INHAPIM (MG)";"MG";"INHAPIM";198;8;32;238
2005;"INHAUMA (MG)";"MG";"INHAUMA";54;1;11;66
2005;"INIMUTABA (MG)";"MG";"INIMUTABA";19;2;4;25
2005;"IPABA (MG)";"MG";"IPABA";44;9;18;71
2005;"IPANEMA (MG)";"MG";"IPANEMA";133;14;18;165
2005;"IPATINGA (MG)";"MG";"IPATINGA";2205;350;423;2978
2005;"IPIACU (MG)";"MG";"IPIACU";38;3;5;46
2005;"IPUIUNA (MG)";"MG";"IPUIUNA";277;11;7;295
2005;"IRAI DE MINAS (MG)";"MG";"IRAI DE MINAS";135;11;17;163
2005;"ITABIRA (MG)";"MG";"ITABIRA";998;173;247;1418
2005;"ITABIRINHA DE MANTENA (MG)";"MG";"ITABIRINHA DE MANTENA";87;0;23;110
2005;"ITABIRITO (MG)";"MG";"ITABIRITO";585;57;142;784
2005;"ITACAMBIRA (MG)";"MG";"ITACAMBIRA";8;0;5;13
2005;"ITACARAMBI (MG)";"MG";"ITACARAMBI";59;3;25;87
2005;"ITAGUARA (MG)";"MG";"ITAGUARA";288;8;29;325
2005;"ITAIPE (MG)";"MG";"ITAIPE";35;2;14;51
2005;"ITAJUBA (MG)";"MG";"ITAJUBA";734;74;93;901
2005;"ITAMARANDIBA (MG)";"MG";"ITAMARANDIBA";431;10;61;502
2005;"ITAMARATI DE MINAS (MG)";"MG";"ITAMARATI DE MINAS";66;4;10;80
2005;"ITAMBACURI (MG)";"MG";"ITAMBACURI";134;7;23;164
2005;"ITAMBE DO MATO DENTRO (MG)";"MG";"ITAMBE DO MATO DENTRO";13;1;2;16
2005;"ITAMOGI (MG)";"MG";"ITAMOGI";164;12;17;193
2005;"ITAMONTE (MG)";"MG";"ITAMONTE";247;19;21;287
2005;"ITANHANDU (MG)";"MG";"ITANHANDU";233;19;20;272
2005;"ITANHOMI (MG)";"MG";"ITANHOMI";69;2;13;84
2005;"ITAOBIM (MG)";"MG";"ITAOBIM";169;17;22;208
2005;"ITAPAGIPE (MG)";"MG";"ITAPAGIPE";186;6;20;212
2005;"ITAPECERICA (MG)";"MG";"ITAPECERICA";245;17;48;310
2005;"ITAPEVA (MG)";"MG";"ITAPEVA";192;3;7;202
2005;"ITATIAIUCU (MG)";"MG";"ITATIAIUCU";219;4;17;240
2005;"ITAU DE MINAS (MG)";"MG";"ITAU DE MINAS";252;11;34;297
2005;"ITAUNA (MG)";"MG";"ITAUNA";1095;97;185;1377
2005;"ITAVERAVA (MG)";"MG";"ITAVERAVA";26;0;7;33
2005;"ITINGA (MG)";"MG";"ITINGA";31;4;15;50
2005;"ITUETA (MG)";"MG";"ITUETA";40;0;9;49
2005;"ITUIUTABA (MG)";"MG";"ITUIUTABA";1065;94;162;1321
2005;"ITUMIRIM (MG)";"MG";"ITUMIRIM";44;6;4;54
2005;"ITURAMA (MG)";"MG";"ITURAMA";568;27;152;747
2005;"ITUTINGA (MG)";"MG";"ITUTINGA";47;12;0;59
2005;"JABOTICATUBAS (MG)";"MG";"JABOTICATUBAS";126;6;27;159
2005;"JACINTO (MG)";"MG";"JACINTO";14;4;11;29
2005;"JACUI (MG)";"MG";"JACUI";98;9;12;119
2005;"JACUTINGA (MG)";"MG";"JACUTINGA";259;22;32;313
2005;"JAGUARACU (MG)";"MG";"JAGUARACU";24;2;3;29
2005;"JAIBA (MG)";"MG";"JAIBA";187;4;30;221
2005;"JAMPRUCA (MG)";"MG";"JAMPRUCA";9;2;12;23
2005;"JANAUBA (MG)";"MG";"JANAUBA";531;7;64;602
2005;"JANUARIA (MG)";"MG";"JANUARIA";223;10;55;288
2005;"JAPARAIBA (MG)";"MG";"JAPARAIBA";40;1;11;52
2005;"JAPONVAR (MG)";"MG";"JAPONVAR";5;0;9;14
2005;"JECEABA (MG)";"MG";"JECEABA";35;7;5;47
2005;"JENIPAPO DE MINAS (MG)";"MG";"JENIPAPO DE MINAS";12;2;8;22
2005;"JEQUERI (MG)";"MG";"JEQUERI";48;5;23;76
2005;"JEQUITAI (MG)";"MG";"JEQUITAI";52;3;7;62
2005;"JEQUITIBA (MG)";"MG";"JEQUITIBA";36;3;15;54
2005;"JEQUITINHONHA (MG)";"MG";"JEQUITINHONHA";51;7;12;70
2005;"JESUANIA (MG)";"MG";"JESUANIA";54;7;5;66
2005;"JOAIMA (MG)";"MG";"JOAIMA";45;4;16;65
2005;"JOANESIA (MG)";"MG";"JOANESIA";10;4;6;20
2005;"JOAO MONLEVADE (MG)";"MG";"JOAO MONLEVADE";766;70;167;1003
2005;"JOAO PINHEIRO (MG)";"MG";"JOAO PINHEIRO";624;9;137;770
2005;"JOAQUIM FELICIO (MG)";"MG";"JOAQUIM FELICIO";25;1;7;33
2005;"JORDANIA (MG)";"MG";"JORDANIA";12;8;9;29
2005;"JOSE GONCALVES DE MINAS (MG)";"MG";"JOSE GONCALVES DE MINAS";18;5;6;29
2005;"JOSE RAYDAN (MG)";"MG";"JOSE RAYDAN";15;1;6;22
2005;"JOSENOPOLIS (MG)";"MG";"JOSENOPOLIS";13;2;1;16
2005;"JUATUBA (MG)";"MG";"JUATUBA";145;18;147;310
2005;"JUIZ DE FORA (MG)";"MG";"JUIZ DE FORA";3900;396;1142;5438
2005;"JURAMENTO (MG)";"MG";"JURAMENTO";12;1;9;22
2005;"JURUAIA (MG)";"MG";"JURUAIA";48;6;10;64
2005;"JUVENILIA (MG)";"MG";"JUVENILIA";8;2;7;17
2005;"LADAINHA (MG)";"MG";"LADAINHA";29;7;14;50
2005;"LAGAMAR (MG)";"MG";"LAGAMAR";61;8;15;84
2005;"LAGOA DA PRATA (MG)";"MG";"LAGOA DA PRATA";511;26;135;672
2005;"LAGOA DOS PATOS (MG)";"MG";"LAGOA DOS PATOS";23;1;5;29
2005;"LAGOA DOURADA (MG)";"MG";"LAGOA DOURADA";225;6;32;263
2005;"LAGOA FORMOSA (MG)";"MG";"LAGOA FORMOSA";188;10;58;256
2005;"LAGOA GRANDE (MG)";"MG";"LAGOA GRANDE";71;2;33;106
2005;"LAGOA SANTA (MG)";"MG";"LAGOA SANTA";525;56;81;662
2005;"LAJINHA (MG)";"MG";"LAJINHA";155;9;24;188
2005;"LAMBARI (MG)";"MG";"LAMBARI";233;19;22;274
2005;"LAMIM (MG)";"MG";"LAMIM";29;2;3;34
2005;"LARANJAL (MG)";"MG";"LARANJAL";118;4;2;124
2005;"LASSANCE (MG)";"MG";"LASSANCE";35;2;6;43
2005;"LAVRAS (MG)";"MG";"LAVRAS";839;89;148;1076
2005;"LEANDRO FERREIRA (MG)";"MG";"LEANDRO FERREIRA";36;2;3;41
2005;"LEME DO PRADO (MG)";"MG";"LEME DO PRADO";23;3;19;45
2005;"LEOPOLDINA (MG)";"MG";"LEOPOLDINA";548;39;52;639
2005;"LIBERDADE (MG)";"MG";"LIBERDADE";64;17;6;87
2005;"LIMA DUARTE (MG)";"MG";"LIMA DUARTE";147;8;34;189
2005;"LIMEIRA DO OESTE (MG)";"MG";"LIMEIRA DO OESTE";80;7;29;116
2005;"LONTRA (MG)";"MG";"LONTRA";8;2;5;15
2005;"LUISBURGO (MG)";"MG";"LUISBURGO";16;1;19;36
2005;"LUISLANDIA (MG)";"MG";"LUISLANDIA";5;3;2;10
2005;"LUMINARIAS (MG)";"MG";"LUMINARIAS";80;4;22;106
2005;"LUZ (MG)";"MG";"LUZ";250;38;21;309
2005;"MACHACALIS (MG)";"MG";"MACHACALIS";19;1;5;25
2005;"MACHADO (MG)";"MG";"MACHADO";564;50;72;686
2005;"MADRE DE DEUS DE MINAS (MG)";"MG";"MADRE DE DEUS DE MINAS";50;2;3;55
2005;"MALACACHETA (MG)";"MG";"MALACACHETA";72;1;32;105
2005;"MAMONAS (MG)";"MG";"MAMONAS";50;1;6;57
2005;"MANGA (MG)";"MG";"MANGA";79;4;28;111
2005;"MANHUACU (MG)";"MG";"MANHUACU";1043;45;104;1192
2005;"MANHUMIRIM (MG)";"MG";"MANHUMIRIM";240;21;24;285
2005;"MANTENA (MG)";"MG";"MANTENA";484;18;61;563
2005;"MAR DE ESPANHA (MG)";"MG";"MAR DE ESPANHA";119;12;9;140
2005;"MARAVILHAS (MG)";"MG";"MARAVILHAS";127;4;5;136
2005;"MARIA DA FE (MG)";"MG";"MARIA DA FE";196;9;21;226
2005;"MARIANA (MG)";"MG";"MARIANA";344;75;167;586
2005;"MARILAC (MG)";"MG";"MARILAC";7;3;2;12
2005;"MARIO CAMPOS (MG)";"MG";"MARIO CAMPOS";135;4;8;147
2005;"MARIPA DE MINAS (MG)";"MG";"MARIPA DE MINAS";26;5;2;33
2005;"MARLIERIA (MG)";"MG";"MARLIERIA";22;3;7;32
2005;"MARMELOPOLIS (MG)";"MG";"MARMELOPOLIS";19;6;6;31
2005;"MARTINHO CAMPOS (MG)";"MG";"MARTINHO CAMPOS";315;14;49;378
2005;"MARTINS SOARES (MG)";"MG";"MARTINS SOARES";40;2;9;51
2005;"MATA VERDE (MG)";"MG";"MATA VERDE";12;3;3;18
2005;"MATERLANDIA (MG)";"MG";"MATERLANDIA";10;1;7;18
2005;"MATEUS LEME (MG)";"MG";"MATEUS LEME";300;33;56;389
2005;"MATHIAS LOBATO (MG)";"MG";"MATHIAS LOBATO";35;2;4;41
2005;"MATIAS BARBOSA (MG)";"MG";"MATIAS BARBOSA";293;8;26;327
2005;"MATIAS CARDOSO (MG)";"MG";"MATIAS CARDOSO";10;2;6;18
2005;"MATIPO (MG)";"MG";"MATIPO";175;15;13;203
2005;"MATO VERDE (MG)";"MG";"MATO VERDE";103;3;19;125
2005;"MATOZINHOS (MG)";"MG";"MATOZINHOS";242;36;61;339
2005;"MATUTINA (MG)";"MG";"MATUTINA";65;8;4;77
2005;"MEDEIROS (MG)";"MG";"MEDEIROS";27;7;2;36
2005;"MEDINA (MG)";"MG";"MEDINA";92;16;25;133
2005;"MENDES PIMENTEL (MG)";"MG";"MENDES PIMENTEL";19;2;9;30
2005;"MERCES (MG)";"MG";"MERCES";87;4;10;101
2005;"MESQUITA (MG)";"MG";"MESQUITA";14;1;6;21
2005;"MINAS NOVAS (MG)";"MG";"MINAS NOVAS";69;15;54;138
2005;"MINDURI (MG)";"MG";"MINDURI";41;5;4;50
2005;"MIRABELA (MG)";"MG";"MIRABELA";59;2;17;78
2005;"MIRADOURO (MG)";"MG";"MIRADOURO";78;1;20;99
2005;"MIRAI (MG)";"MG";"MIRAI";114;11;13;138
2005;"MIRAVANIA (MG)";"MG";"MIRAVANIA";7;0;5;12
2005;"MOEDA (MG)";"MG";"MOEDA";51;2;10;63
2005;"MOEMA (MG)";"MG";"MOEMA";97;4;100;201
2005;"MONJOLOS (MG)";"MG";"MONJOLOS";3;1;5;9
2005;"MONSENHOR PAULO (MG)";"MG";"MONSENHOR PAULO";115;9;6;130
2005;"MONTALVANIA (MG)";"MG";"MONTALVANIA";72;3;34;109
2005;"MONTE ALEGRE DE MINAS (MG)";"MG";"MONTE ALEGRE DE MINAS";428;8;24;460
2005;"MONTE AZUL (MG)";"MG";"MONTE AZUL";131;6;27;164
2005;"MONTE BELO (MG)";"MG";"MONTE BELO";194;15;38;247
2005;"MONTE CARMELO (MG)";"MG";"MONTE CARMELO";1014;36;97;1147
2005;"MONTE FORMOSO (MG)";"MG";"MONTE FORMOSO";5;2;7;14
2005;"MONTE SANTO DE MINAS (MG)";"MG";"MONTE SANTO DE MINAS";359;14;65;438
2005;"MONTE SIAO (MG)";"MG";"MONTE SIAO";180;24;28;232
2005;"MONTES CLAROS (MG)";"MG";"MONTES CLAROS";3307;133;803;4243
2005;"MONTEZUMA (MG)";"MG";"MONTEZUMA";18;3;14;35
2005;"MORADA NOVA DE MINAS (MG)";"MG";"MORADA NOVA DE MINAS";77;16;16;109
2005;"MORRO DA GARCA (MG)";"MG";"MORRO DA GARCA";40;2;15;57
2005;"MORRO DO PILAR (MG)";"MG";"MORRO DO PILAR";21;5;1;27
2005;"MUNHOZ (MG)";"MG";"MUNHOZ";67;5;8;80
2005;"MURIAE (MG)";"MG";"MURIAE";1037;55;132;1224
2005;"MUTUM (MG)";"MG";"MUTUM";119;12;29;160
2005;"MUZAMBINHO (MG)";"MG";"MUZAMBINHO";255;28;24;307
2005;"NACIP RAYDAN (MG)";"MG";"NACIP RAYDAN";2;1;2;5
2005;"NANUQUE (MG)";"MG";"NANUQUE";489;30;129;648
2005;"NAQUE (MG)";"MG";"NAQUE";19;2;18;39
2005;"NATALANDIA (MG)";"MG";"NATALANDIA";12;2;12;26
2005;"NATERCIA (MG)";"MG";"NATERCIA";67;3;11;81
2005;"NAZARENO (MG)";"MG";"NAZARENO";127;8;18;153
2005;"NEPOMUCENO (MG)";"MG";"NEPOMUCENO";356;8;44;408
2005;"NINHEIRA (MG)";"MG";"NINHEIRA";16;2;16;34
2005;"NOVA BELEM (MG)";"MG";"NOVA BELEM";27;1;5;33
2005;"NOVA ERA (MG)";"MG";"NOVA ERA";143;12;66;221
2005;"NOVA LIMA (MG)";"MG";"NOVA LIMA";630;151;109;890
2005;"NOVA MODICA (MG)";"MG";"NOVA MODICA";11;2;11;24
2005;"NOVA PONTE (MG)";"MG";"NOVA PONTE";142;35;52;229
2005;"NOVA PORTEIRINHA (MG)";"MG";"NOVA PORTEIRINHA";21;2;12;35
2005;"NOVA RESENDE (MG)";"MG";"NOVA RESENDE";247;9;26;282
2005;"NOVA SERRANA (MG)";"MG";"NOVA SERRANA";286;25;38;349
2005;"NOVA UNIAO (MG)";"MG";"NOVA UNIAO";94;6;10;110
2005;"NOVO CRUZEIRO (MG)";"MG";"NOVO CRUZEIRO";85;15;55;155
2005;"NOVO ORIENTE DE MINAS (MG)";"MG";"NOVO ORIENTE DE MINAS";25;5;10;40
2005;"NOVORIZONTE (MG)";"MG";"NOVORIZONTE";37;0;8;45
2005;"OLARIA (MG)";"MG";"OLARIA";10;5;2;17
2005;"OLHOS D AGUA (MG)";"MG";"OLHOS D AGUA";29;5;21;55
2005;"OLIMPIO NORONHA (MG)";"MG";"OLIMPIO NORONHA";21;8;4;33
2005;"OLIVEIRA (MG)";"MG";"OLIVEIRA";596;28;53;677
2005;"OLIVEIRA FORTES (MG)";"MG";"OLIVEIRA FORTES";14;5;2;21
2005;"ONCA DE PITANGUI (MG)";"MG";"ONCA DE PITANGUI";23;4;7;34
2005;"ORATORIOS (MG)";"MG";"ORATORIOS";34;1;11;46
2005;"ORIZANIA (MG)";"MG";"ORIZANIA";31;3;7;41
2005;"OURO BRANCO (MG)";"MG";"OURO BRANCO";320;51;132;503
2005;"OURO FINO (MG)";"MG";"OURO FINO";421;22;65;508
2005;"OURO PRETO (MG)";"MG";"OURO PRETO";717;104;278;1099
2005;"OURO VERDE DE MINAS (MG)";"MG";"OURO VERDE DE MINAS";13;1;3;17
2005;"PADRE CARVALHO (MG)";"MG";"PADRE CARVALHO";7;1;9;17
2005;"PADRE PARAISO (MG)";"MG";"PADRE PARAISO";70;45;45;160
2005;"PAI PEDRO (MG)";"MG";"PAI PEDRO";13;5;17;35
2005;"PAINEIRAS (MG)";"MG";"PAINEIRAS";78;10;17;105
2005;"PAINS (MG)";"MG";"PAINS";184;15;19;218
2005;"PAIVA (MG)";"MG";"PAIVA";10;2;2;14
2005;"PALMA (MG)";"MG";"PALMA";60;2;4;66
2005;"PALMOPOLIS (MG)";"MG";"PALMOPOLIS";12;3;5;20
2005;"PAPAGAIOS (MG)";"MG";"PAPAGAIOS";459;5;44;508
2005;"PARA DE MINAS (MG)";"MG";"PARA DE MINAS";1448;89;170;1707
2005;"PARACATU (MG)";"MG";"PARACATU";993;31;206;1230
2005;"PARAGUACU (MG)";"MG";"PARAGUACU";230;25;17;272
2005;"PARAISOPOLIS (MG)";"MG";"PARAISOPOLIS";312;26;19;357
2005;"PARAOPEBA (MG)";"MG";"PARAOPEBA";352;14;42;408
2005;"PASSA QUATRO (MG)";"MG";"PASSA QUATRO";265;16;14;295
2005;"PASSA TEMPO (MG)";"MG";"PASSA TEMPO";109;14;13;136
2005;"PASSA VINTE (MG)";"MG";"PASSA VINTE";14;6;5;25
2005;"PASSABEM (MG)";"MG";"PASSABEM";5;2;1;8
2005;"PASSOS (MG)";"MG";"PASSOS";1436;66;244;1746
2005;"PATIS (MG)";"MG";"PATIS";2;0;5;7
2005;"PATOS DE MINAS (MG)";"MG";"PATOS DE MINAS";2090;73;1392;3555
2005;"PATROCINIO (MG)";"MG";"PATROCINIO";1246;44;322;1612
2005;"PATROCINIO DO MURIAE (MG)";"MG";"PATROCINIO DO MURIAE";48;2;2;52
2005;"PAULA CANDIDO (MG)";"MG";"PAULA CANDIDO";43;4;11;58
2005;"PAULISTAS (MG)";"MG";"PAULISTAS";13;1;9;23
2005;"PAVAO (MG)";"MG";"PAVAO";26;4;6;36
2005;"PECANHA (MG)";"MG";"PECANHA";101;4;42;147
2005;"PEDRA AZUL (MG)";"MG";"PEDRA AZUL";117;6;45;168
2005;"PEDRA BONITA (MG)";"MG";"PEDRA BONITA";16;5;5;26
2005;"PEDRA DO ANTA (MG)";"MG";"PEDRA DO ANTA";11;1;10;22
2005;"PEDRA DO INDAIA (MG)";"MG";"PEDRA DO INDAIA";52;0;3;55
2005;"PEDRA DOURADA (MG)";"MG";"PEDRA DOURADA";7;2;3;12
2005;"PEDRALVA (MG)";"MG";"PEDRALVA";118;8;14;140
2005;"PEDRAS DE MARIA DA CRUZ (MG)";"MG";"PEDRAS DE MARIA DA CRUZ";10;2;19;31
2005;"PEDRINOPOLIS (MG)";"MG";"PEDRINOPOLIS";56;7;5;68
2005;"PEDRO LEOPOLDO (MG)";"MG";"PEDRO LEOPOLDO";705;82;152;939
2005;"PEDRO TEIXEIRA (MG)";"MG";"PEDRO TEIXEIRA";16;2;1;19
2005;"PEQUERI (MG)";"MG";"PEQUERI";59;10;4;73
2005;"PEQUI (MG)";"MG";"PEQUI";39;5;6;50
2005;"PERDIGAO (MG)";"MG";"PERDIGAO";86;11;2;99
2005;"PERDIZES (MG)";"MG";"PERDIZES";218;19;23;260
2005;"PERDOES (MG)";"MG";"PERDOES";383;16;39;438
2005;"PERIQUITO (MG)";"MG";"PERIQUITO";22;3;19;44
2005;"PESCADOR (MG)";"MG";"PESCADOR";10;3;3;16
2005;"PIAU (MG)";"MG";"PIAU";36;3;7;46
2005;"PIEDADE DE CARATINGA (MG)";"MG";"PIEDADE DE CARATINGA";78;4;4;86
2005;"PIEDADE DE PONTE NOVA (MG)";"MG";"PIEDADE DE PONTE NOVA";30;1;8;39
2005;"PIEDADE DO RIO GRANDE (MG)";"MG";"PIEDADE DO RIO GRANDE";36;1;6;43
2005;"PIEDADE DOS GERAIS (MG)";"MG";"PIEDADE DOS GERAIS";47;2;11;60
2005;"PIMENTA (MG)";"MG";"PIMENTA";180;6;15;201
2005;"PINGO D AGUA (MG)";"MG";"PINGO D AGUA";11;3;5;19
2005;"PINTOPOLIS (MG)";"MG";"PINTOPOLIS";8;1;2;11
2005;"PIRACEMA (MG)";"MG";"PIRACEMA";57;4;11;72
2005;"PIRAJUBA (MG)";"MG";"PIRAJUBA";86;7;4;97
2005;"PIRANGA (MG)";"MG";"PIRANGA";100;12;31;143
2005;"PIRANGUCU (MG)";"MG";"PIRANGUCU";26;11;33;70
2005;"PIRANGUINHO (MG)";"MG";"PIRANGUINHO";92;5;9;106
2005;"PIRAPETINGA (MG)";"MG";"PIRAPETINGA";261;13;15;289
2005;"PIRAPORA (MG)";"MG";"PIRAPORA";398;18;98;514
2005;"PIRAUBA (MG)";"MG";"PIRAUBA";100;12;7;119
2005;"PITANGUI (MG)";"MG";"PITANGUI";508;27;57;592
2005;"PIUI (MG)";"MG";"PIUI";516;23;47;586
2005;"PLANURA (MG)";"MG";"PLANURA";129;5;33;167
2005;"POCO FUNDO (MG)";"MG";"POCO FUNDO";198;27;14;239
2005;"POCOS DE CALDAS (MG)";"MG";"POCOS DE CALDAS";2367;317;318;3002
2005;"POCRANE (MG)";"MG";"POCRANE";52;4;8;64
2005;"POMPEU (MG)";"MG";"POMPEU";349;16;65;430
2005;"PONTE NOVA (MG)";"MG";"PONTE NOVA";731;17;99;847
2005;"PONTO CHIQUE (MG)";"MG";"PONTO CHIQUE";1;0;8;9
2005;"PONTO DOS VOLANTES (MG)";"MG";"PONTO DOS VOLANTES";13;3;18;34
2005;"PORTEIRINHA (MG)";"MG";"PORTEIRINHA";226;4;100;330
2005;"PORTO FIRME (MG)";"MG";"PORTO FIRME";34;2;9;45
2005;"POTE (MG)";"MG";"POTE";41;4;9;54
2005;"POUSO ALEGRE (MG)";"MG";"POUSO ALEGRE";1718;125;401;2244
2005;"POUSO ALTO (MG)";"MG";"POUSO ALTO";78;6;3;87
2005;"PRADOS (MG)";"MG";"PRADOS";55;3;5;63
2005;"PRATA (MG)";"MG";"PRATA";303;45;52;400
2005;"PRATAPOLIS (MG)";"MG";"PRATAPOLIS";162;12;9;183
2005;"PRATINHA (MG)";"MG";"PRATINHA";43;2;3;48
2005;"PRESIDENTE BERNARDES (MG)";"MG";"PRESIDENTE BERNARDES";15;1;8;24
2005;"PRESIDENTE JUSCELINO (MG)";"MG";"PRESIDENTE JUSCELINO";27;1;10;38
2005;"PRESIDENTE KUBITSCHEK (MG)";"MG";"PRESIDENTE KUBITSCHEK";9;4;4;17
2005;"PRESIDENTE OLEGARIO (MG)";"MG";"PRESIDENTE OLEGARIO";177;11;79;267
2005;"PRUDENTE DE MORAIS (MG)";"MG";"PRUDENTE DE MORAIS";108;6;11;125
2005;"QUARTEL GERAL (MG)";"MG";"QUARTEL GERAL";38;7;2;47
2005;"QUELUZITA (MG)";"MG";"QUELUZITA";17;4;1;22
2005;"RAPOSOS (MG)";"MG";"RAPOSOS";46;18;11;75
2005;"RAUL SOARES (MG)";"MG";"RAUL SOARES";134;9;30;173
2005;"RECREIO (MG)";"MG";"RECREIO";142;6;15;163
2005;"REDUTO (MG)";"MG";"REDUTO";31;3;4;38
2005;"RESENDE COSTA (MG)";"MG";"RESENDE COSTA";119;4;9;132
2005;"RESPLENDOR (MG)";"MG";"RESPLENDOR";150;8;27;185
2005;"RESSAQUINHA (MG)";"MG";"RESSAQUINHA";89;3;9;101
2005;"RIACHINHO (MG)";"MG";"RIACHINHO";42;1;14;57
2005;"RIACHO DOS MACHADOS (MG)";"MG";"RIACHO DOS MACHADOS";48;4;28;80
2005;"RIBEIRAO DAS NEVES (MG)";"MG";"RIBEIRAO DAS NEVES";1836;204;463;2503
2005;"RIBEIRAO VERMELHO (MG)";"MG";"RIBEIRAO VERMELHO";21;6;2;29
2005;"RIO ACIMA (MG)";"MG";"RIO ACIMA";81;10;11;102
2005;"RIO CASCA (MG)";"MG";"RIO CASCA";193;7;38;238
2005;"RIO DO PRADO (MG)";"MG";"RIO DO PRADO";8;3;5;16
2005;"RIO DOCE (MG)";"MG";"RIO DOCE";16;2;5;23
2005;"RIO ESPERA (MG)";"MG";"RIO ESPERA";16;0;4;20
2005;"RIO MANSO (MG)";"MG";"RIO MANSO";89;2;10;101
2005;"RIO NOVO (MG)";"MG";"RIO NOVO";91;4;14;109
2005;"RIO PARANAIBA (MG)";"MG";"RIO PARANAIBA";114;7;37;158
2005;"RIO PARDO DE MINAS (MG)";"MG";"RIO PARDO DE MINAS";129;4;85;218
2005;"RIO PIRACICABA (MG)";"MG";"RIO PIRACICABA";146;14;23;183
2005;"RIO POMBA (MG)";"MG";"RIO POMBA";170;16;26;212
2005;"RIO PRETO (MG)";"MG";"RIO PRETO";169;73;33;275
2005;"RIO VERMELHO (MG)";"MG";"RIO VERMELHO";39;14;26;79
2005;"RITAPOLIS (MG)";"MG";"RITAPOLIS";25;1;6;32
2005;"ROCHEDO DE MINAS (MG)";"MG";"ROCHEDO DE MINAS";19;0;2;21
2005;"RODEIRO (MG)";"MG";"RODEIRO";106;4;6;116
2005;"ROMARIA (MG)";"MG";"ROMARIA";30;7;3;40
2005;"ROSARIO DA LIMEIRA (MG)";"MG";"ROSARIO DA LIMEIRA";30;3;11;44
2005;"RUBELITA (MG)";"MG";"RUBELITA";11;2;7;20
2005;"RUBIM (MG)";"MG";"RUBIM";18;4;12;34
2005;"SABARA (MG)";"MG";"SABARA";436;112;230;778
2005;"SABINOPOLIS (MG)";"MG";"SABINOPOLIS";83;11;23;117
2005;"SACRAMENTO (MG)";"MG";"SACRAMENTO";402;35;41;478
2005;"SALINAS (MG)";"MG";"SALINAS";263;19;77;359
2005;"SALTO DA DIVISA (MG)";"MG";"SALTO DA DIVISA";4;3;2;9
2005;"SANTA BARBARA (MG)";"MG";"SANTA BARBARA";293;32;126;451
2005;"SANTA BARBARA DO LESTE (MG)";"MG";"SANTA BARBARA DO LESTE";120;6;4;130
2005;"SANTA BARBARA DO MONTE VERDE (MG)";"MG";"SANTA BARBARA DO MONTE VERDE";296;57;49;402
2005;"SANTA BARBARA DO TUGURIO (MG)";"MG";"SANTA BARBARA DO TUGURIO";33;3;6;42
2005;"SANTA CRUZ DE MINAS (MG)";"MG";"SANTA CRUZ DE MINAS";33;4;2;39
2005;"SANTA CRUZ DE SALINAS (MG)";"MG";"SANTA CRUZ DE SALINAS";7;0;14;21
2005;"SANTA CRUZ DO ESCALVADO (MG)";"MG";"SANTA CRUZ DO ESCALVADO";22;1;10;33
2005;"SANTA EFIGENIA DE MINAS (MG)";"MG";"SANTA EFIGENIA DE MINAS";12;3;2;17
2005;"SANTA FE DE MINAS (MG)";"MG";"SANTA FE DE MINAS";4;1;1;6
2005;"SANTA HELENA DE MINAS (MG)";"MG";"SANTA HELENA DE MINAS";7;1;3;11
2005;"SANTA JULIANA (MG)";"MG";"SANTA JULIANA";218;21;27;266
2005;"SANTA LUZIA (MG)";"MG";"SANTA LUZIA";996;99;472;1567
2005;"SANTA MARGARIDA (MG)";"MG";"SANTA MARGARIDA";139;10;13;162
2005;"SANTA MARIA DE ITABIRA (MG)";"MG";"SANTA MARIA DE ITABIRA";74;6;23;103
2005;"SANTA MARIA DO SALTO (MG)";"MG";"SANTA MARIA DO SALTO";12;4;2;18
2005;"SANTA MARIA DO SUACUI (MG)";"MG";"SANTA MARIA DO SUACUI";54;0;22;76
2005;"SANTA RITA DE CALDAS (MG)";"MG";"SANTA RITA DE CALDAS";214;8;8;230
2005;"SANTA RITA DE JACUTINGA (MG)";"MG";"SANTA RITA DE JACUTINGA";41;4;3;48
2005;"SANTA RITA DE MINAS (MG)";"MG";"SANTA RITA DE MINAS";100;4;6;110
2005;"SANTA RITA DO IBITIPOCA (MG)";"MG";"SANTA RITA DO IBITIPOCA";31;2;1;34
2005;"SANTA RITA DO ITUETO (MG)";"MG";"SANTA RITA DO ITUETO";59;3;9;71
2005;"SANTA RITA DO SAPUCAI (MG)";"MG";"SANTA RITA DO SAPUCAI";304;30;55;389
2005;"SANTA ROSA DA SERRA (MG)";"MG";"SANTA ROSA DA SERRA";29;2;4;35
2005;"SANTA VITORIA (MG)";"MG";"SANTA VITORIA";231;7;16;254
2005;"SANTANA DA VARGEM (MG)";"MG";"SANTANA DA VARGEM";57;4;17;78
2005;"SANTANA DE CATAGUASES (MG)";"MG";"SANTANA DE CATAGUASES";35;5;6;46
2005;"SANTANA DE PIRAPAMA (MG)";"MG";"SANTANA DE PIRAPAMA";53;5;19;77
2005;"SANTANA DO DESERTO (MG)";"MG";"SANTANA DO DESERTO";41;3;5;49
2005;"SANTANA DO GARAMBEU (MG)";"MG";"SANTANA DO GARAMBEU";12;0;2;14
2005;"SANTANA DO JACARE (MG)";"MG";"SANTANA DO JACARE";35;5;3;43
2005;"SANTANA DO MANHUACU (MG)";"MG";"SANTANA DO MANHUACU";82;4;9;95
2005;"SANTANA DO PARAISO (MG)";"MG";"SANTANA DO PARAISO";75;5;23;103
2005;"SANTANA DO RIACHO (MG)";"MG";"SANTANA DO RIACHO";9;3;2;14
2005;"SANTANA DOS MONTES (MG)";"MG";"SANTANA DOS MONTES";24;4;7;35
2005;"SANTO ANTONIO DO AMPARO (MG)";"MG";"SANTO ANTONIO DO AMPARO";191;9;14;214
2005;"SANTO ANTONIO DO AVENTUREIRO (MG)";"MG";"SANTO ANTONIO DO AVENTUREIRO";43;2;4;49
2005;"SANTO ANTONIO DO GRAMA (MG)";"MG";"SANTO ANTONIO DO GRAMA";33;0;5;38
2005;"SANTO ANTONIO DO ITAMBE (MG)";"MG";"SANTO ANTONIO DO ITAMBE";9;2;7;18
2005;"SANTO ANTONIO DO JACINTO (MG)";"MG";"SANTO ANTONIO DO JACINTO";22;5;20;47
2005;"SANTO ANTONIO DO MONTE (MG)";"MG";"SANTO ANTONIO DO MONTE";357;17;81;455
2005;"SANTO ANTONIO DO RETIRO (MG)";"MG";"SANTO ANTONIO DO RETIRO";22;1;13;36
2005;"SANTO ANTONIO DO RIO ABAIXO (MG)";"MG";"SANTO ANTONIO DO RIO ABAIXO";8;3;3;14
2005;"SANTO HIPOLITO (MG)";"MG";"SANTO HIPOLITO";15;1;2;18
2005;"SANTOS DUMONT (MG)";"MG";"SANTOS DUMONT";341;19;93;453
2005;"SAO BENTO ABADE (MG)";"MG";"SAO BENTO ABADE";31;5;2;38
2005;"SAO BRAS DO SUACUI (MG)";"MG";"SAO BRAS DO SUACUI";22;2;4;28
2005;"SAO DOMINGOS DAS DORES (MG)";"MG";"SAO DOMINGOS DAS DORES";61;1;3;65
2005;"SAO DOMINGOS DO PRATA (MG)";"MG";"SAO DOMINGOS DO PRATA";146;6;36;188
2005;"SAO FELIX DE MINAS (MG)";"MG";"SAO FELIX DE MINAS";12;1;5;18
2005;"SAO FRANCISCO (MG)";"MG";"SAO FRANCISCO";159;3;61;223
2005;"SAO FRANCISCO DE PAULA (MG)";"MG";"SAO FRANCISCO DE PAULA";59;3;16;78
2005;"SAO FRANCISCO DE SALES (MG)";"MG";"SAO FRANCISCO DE SALES";62;3;15;80
2005;"SAO FRANCISCO DO GLORIA (MG)";"MG";"SAO FRANCISCO DO GLORIA";41;4;4;49
2005;"SAO GERALDO (MG)";"MG";"SAO GERALDO";87;3;3;93
2005;"SAO GERALDO DA PIEDADE (MG)";"MG";"SAO GERALDO DA PIEDADE";9;2;4;15
2005;"SAO GERALDO DO BAIXIO (MG)";"MG";"SAO GERALDO DO BAIXIO";11;3;6;20
2005;"SAO GONCALO DO ABAETE (MG)";"MG";"SAO GONCALO DO ABAETE";84;5;12;101
2005;"SAO GONCALO DO PARA (MG)";"MG";"SAO GONCALO DO PARA";121;6;6;133
2005;"SAO GONCALO DO RIO ABAIXO (MG)";"MG";"SAO GONCALO DO RIO ABAIXO";48;14;15;77
2005;"SAO GONCALO DO RIO PRETO (MG)";"MG";"SAO GONCALO DO RIO PRETO";16;4;3;23
2005;"SAO GONCALO DO SAPUCAI (MG)";"MG";"SAO GONCALO DO SAPUCAI";350;15;47;412
2005;"SAO GOTARDO (MG)";"MG";"SAO GOTARDO";668;32;101;801
2005;"SAO JOAO BATISTA DO GLORIA (MG)";"MG";"SAO JOAO BATISTA DO GLORIA";65;8;7;80
2005;"SAO JOAO DA LAGOA (MG)";"MG";"SAO JOAO DA LAGOA";27;1;8;36
2005;"SAO JOAO DA MATA (MG)";"MG";"SAO JOAO DA MATA";31;7;1;39
2005;"SAO JOAO DA PONTE (MG)";"MG";"SAO JOAO DA PONTE";38;2;30;70
2005;"SAO JOAO DAS MISSOES (MG)";"MG";"SAO JOAO DAS MISSOES";10;4;9;23
2005;"SAO JOAO DEL REI (MG)";"MG";"SAO JOAO DEL REI";840;73;163;1076
2005;"SAO JOAO DO MANHUACU (MG)";"MG";"SAO JOAO DO MANHUACU";99;4;14;117
2005;"SAO JOAO DO MANTENINHA (MG)";"MG";"SAO JOAO DO MANTENINHA";48;4;4;56
2005;"SAO JOAO DO ORIENTE (MG)";"MG";"SAO JOAO DO ORIENTE";66;4;4;74
2005;"SAO JOAO DO PACUI (MG)";"MG";"SAO JOAO DO PACUI";1;0;3;4
2005;"SAO JOAO DO PARAISO (MG)";"MG";"SAO JOAO DO PARAISO";99;4;45;148
2005;"SAO JOAO EVANGELISTA (MG)";"MG";"SAO JOAO EVANGELISTA";75;6;22;103
2005;"SAO JOAO NEPOMUCENO (MG)";"MG";"SAO JOAO NEPOMUCENO";227;15;29;271
2005;"SAO JOAQUIM DE BICAS (MG)";"MG";"SAO JOAQUIM DE BICAS";199;30;38;267
2005;"SAO JOSE DA BARRA (MG)";"MG";"SAO JOSE DA BARRA";63;3;17;83
2005;"SAO JOSE DA LAPA (MG)";"MG";"SAO JOSE DA LAPA";160;17;25;202
2005;"SAO JOSE DA SAFIRA (MG)";"MG";"SAO JOSE DA SAFIRA";1;1;1;3
2005;"SAO JOSE DA VARGINHA (MG)";"MG";"SAO JOSE DA VARGINHA";37;1;4;42
2005;"SAO JOSE DO ALEGRE (MG)";"MG";"SAO JOSE DO ALEGRE";32;5;3;40
2005;"SAO JOSE DO DIVINO (MG)";"MG";"SAO JOSE DO DIVINO";11;2;6;19
2005;"SAO JOSE DO GOIABAL (MG)";"MG";"SAO JOSE DO GOIABAL";39;8;39;86
2005;"SAO JOSE DO JACURI (MG)";"MG";"SAO JOSE DO JACURI";9;2;4;15
2005;"SAO JOSE DO MANTIMENTO (MG)";"MG";"SAO JOSE DO MANTIMENTO";9;2;2;13
2005;"SAO LOURENCO (MG)";"MG";"SAO LOURENCO";373;37;19;429
2005;"SAO MIGUEL DO ANTA (MG)";"MG";"SAO MIGUEL DO ANTA";63;4;5;72
2005;"SAO PEDRO DA UNIAO (MG)";"MG";"SAO PEDRO DA UNIAO";79;8;7;94
2005;"SAO PEDRO DO SUACUI (MG)";"MG";"SAO PEDRO DO SUACUI";12;2;6;20
2005;"SAO PEDRO DOS FERROS (MG)";"MG";"SAO PEDRO DOS FERROS";99;1;23;123
2005;"SAO ROMAO (MG)";"MG";"SAO ROMAO";18;0;7;25
2005;"SAO ROQUE DE MINAS (MG)";"MG";"SAO ROQUE DE MINAS";75;3;6;84
2005;"SAO SEBASTIAO DA BELA VISTA (MG)";"MG";"SAO SEBASTIAO DA BELA VISTA";26;3;7;36
2005;"SAO SEBASTIAO DA VARGEM ALEGRE (MG)";"MG";"SAO SEBASTIAO DA VARGEM ALEGRE";12;3;4;19
2005;"SAO SEBASTIAO DO ANTA (MG)";"MG";"SAO SEBASTIAO DO ANTA";26;2;1;29
2005;"SAO SEBASTIAO DO MARANHAO (MG)";"MG";"SAO SEBASTIAO DO MARANHAO";22;3;11;36
2005;"SAO SEBASTIAO DO OESTE (MG)";"MG";"SAO SEBASTIAO DO OESTE";69;3;10;82
2005;"SAO SEBASTIAO DO PARAISO (MG)";"MG";"SAO SEBASTIAO DO PARAISO";1148;47;100;1295
2005;"SAO SEBASTIAO DO RIO PRETO (MG)";"MG";"SAO SEBASTIAO DO RIO PRETO";6;4;2;12
2005;"SAO SEBASTIAO DO RIO VERDE (MG)";"MG";"SAO SEBASTIAO DO RIO VERDE";9;2;3;14
2005;"SAO TIAGO (MG)";"MG";"SAO TIAGO";83;7;11;101
2005;"SAO TOMAS DE AQUINO (MG)";"MG";"SAO TOMAS DE AQUINO";53;12;7;72
2005;"SAO TOME DAS LETRAS (MG)";"MG";"SAO TOME DAS LETRAS";87;5;11;103
2005;"SAO VICENTE DE MINAS (MG)";"MG";"SAO VICENTE DE MINAS";53;6;1;60
2005;"SAPUCAI MIRIM (MG)";"MG";"SAPUCAI MIRIM";132;18;12;162
2005;"SARDOA (MG)";"MG";"SARDOA";20;2;6;28
2005;"SARZEDO (MG)";"MG";"SARZEDO";219;13;22;254
2005;"SEM PEIXE (MG)";"MG";"SEM PEIXE";3;3;3;9
2005;"SENADOR AMARAL (MG)";"MG";"SENADOR AMARAL";77;6;4;87
2005;"SENADOR CORTES (MG)";"MG";"SENADOR CORTES";8;2;3;13
2005;"SENADOR FIRMINO (MG)";"MG";"SENADOR FIRMINO";60;5;7;72
2005;"SENADOR JOSE BENTO (MG)";"MG";"SENADOR JOSE BENTO";14;1;6;21
2005;"SENADOR MODESTINO GONCALVES (MG)";"MG";"SENADOR MODESTINO GONCALVES";18;5;5;28
2005;"SENHORA DE OLIVEIRA (MG)";"MG";"SENHORA DE OLIVEIRA";46;2;5;53
2005;"SENHORA DO PORTO (MG)";"MG";"SENHORA DO PORTO";15;2;8;25
2005;"SENHORA DOS REMEDIOS (MG)";"MG";"SENHORA DOS REMEDIOS";48;5;10;63
2005;"SERICITA (MG)";"MG";"SERICITA";45;2;2;49
2005;"SERITINGA (MG)";"MG";"SERITINGA";15;2;1;18
2005;"SERRA AZUL DE MINAS (MG)";"MG";"SERRA AZUL DE MINAS";13;1;5;19
2005;"SERRA DA SAUDADE (MG)";"MG";"SERRA DA SAUDADE";5;3;0;8
2005;"SERRA DO SALITRE (MG)";"MG";"SERRA DO SALITRE";163;4;41;208
2005;"SERRA DOS AIMORES (MG)";"MG";"SERRA DOS AIMORES";46;2;13;61
2005;"SERRANIA (MG)";"MG";"SERRANIA";94;9;8;111
2005;"SERRANOPOLIS DE MINAS (MG)";"MG";"SERRANOPOLIS DE MINAS";5;2;7;14
2005;"SERRANOS (MG)";"MG";"SERRANOS";8;2;1;11
2005;"SERRO (MG)";"MG";"SERRO";116;6;24;146
2005;"SETE LAGOAS (MG)";"MG";"SETE LAGOAS";2338;255;357;2950
2005;"SETUBINHA (MG)";"MG";"SETUBINHA";11;2;14;27
2005;"SILVEIRANIA (MG)";"MG";"SILVEIRANIA";5;2;4;11
2005;"SILVIANOPOLIS (MG)";"MG";"SILVIANOPOLIS";65;7;6;78
2005;"SIMAO PEREIRA (MG)";"MG";"SIMAO PEREIRA";38;5;2;45
2005;"SIMONESIA (MG)";"MG";"SIMONESIA";139;7;24;170
2005;"SOBRALIA (MG)";"MG";"SOBRALIA";23;1;6;30
2005;"SOLEDADE DE MINAS (MG)";"MG";"SOLEDADE DE MINAS";25;6;0;31
2005;"TABULEIRO (MG)";"MG";"TABULEIRO";52;4;6;62
2005;"TAIOBEIRAS (MG)";"MG";"TAIOBEIRAS";453;10;67;530
2005;"TAPARUBA (MG)";"MG";"TAPARUBA";16;1;5;22
2005;"TAPIRA (MG)";"MG";"TAPIRA";28;6;10;44
2005;"TAPIRAI (MG)";"MG";"TAPIRAI";9;2;2;13
2005;"TAQUARACU DE MINAS (MG)";"MG";"TAQUARACU DE MINAS";46;5;7;58
2005;"TARUMIRIM (MG)";"MG";"TARUMIRIM";100;8;22;130
2005;"TEIXEIRAS (MG)";"MG";"TEIXEIRAS";103;4;11;118
2005;"TEOFILO OTONI (MG)";"MG";"TEOFILO OTONI";1086;88;112;1286
2005;"TIMOTEO (MG)";"MG";"TIMOTEO";738;115;105;958
2005;"TIRADENTES (MG)";"MG";"TIRADENTES";59;6;7;72
2005;"TIROS (MG)";"MG";"TIROS";119;13;8;140
2005;"TOCANTINS (MG)";"MG";"TOCANTINS";165;2;4;171
2005;"TOCOS DO MOJI (MG)";"MG";"TOCOS DO MOJI";30;4;6;40
2005;"TOLEDO (MG)";"MG";"TOLEDO";39;2;7;48
2005;"TOMBOS (MG)";"MG";"TOMBOS";88;11;14;113
2005;"TRES CORACOES (MG)";"MG";"TRES CORACOES";751;62;114;927
2005;"TRES MARIAS (MG)";"MG";"TRES MARIAS";254;21;56;331
2005;"TRES PONTAS (MG)";"MG";"TRES PONTAS";674;31;104;809
2005;"TUMIRITINGA (MG)";"MG";"TUMIRITINGA";22;3;2;27
2005;"TUPACIGUARA (MG)";"MG";"TUPACIGUARA";368;41;43;452
2005;"TURMALINA (MG)";"MG";"TURMALINA";195;6;41;242
2005;"TURVOLANDIA (MG)";"MG";"TURVOLANDIA";78;10;3;91
2005;"UBA (MG)";"MG";"UBA";1272;41;86;1399
2005;"UBAI (MG)";"MG";"UBAI";14;2;12;28
2005;"UBAPORANGA (MG)";"MG";"UBAPORANGA";96;4;11;111
2005;"UBERABA (MG)";"MG";"UBERABA";3179;466;531;4176
2005;"UBERLANDIA (MG)";"MG";"UBERLANDIA";8364;696;1091;10151
2005;"UMBURATIBA (MG)";"MG";"UMBURATIBA";7;1;1;9
2005;"UNAI (MG)";"MG";"UNAI";1112;37;251;1400
2005;"UNIAO DE MINAS (MG)";"MG";"UNIAO DE MINAS";34;3;15;52
2005;"URUANA DE MINAS (MG)";"MG";"URUANA DE MINAS";11;1;7;19
2005;"URUCANIA (MG)";"MG";"URUCANIA";118;4;25;147
2005;"URUCUIA (MG)";"MG";"URUCUIA";32;1;10;43
2005;"VARGEM ALEGRE (MG)";"MG";"VARGEM ALEGRE";55;5;7;67
2005;"VARGEM BONITA (MG)";"MG";"VARGEM BONITA";15;5;4;24
2005;"VARGEM GRANDE DO RIO PARDO (MG)";"MG";"VARGEM GRANDE DO RIO PARDO";22;2;8;32
2005;"VARGINHA (MG)";"MG";"VARGINHA";1517;71;175;1763
2005;"VARJAO DE MINAS (MG)";"MG";"VARJAO DE MINAS";65;4;27;96
2005;"VARZEA DA PALMA (MG)";"MG";"VARZEA DA PALMA";365;11;58;434
2005;"VARZELANDIA (MG)";"MG";"VARZELANDIA";37;4;19;60
2005;"VAZANTE (MG)";"MG";"VAZANTE";266;15;69;350
2005;"VERDELANDIA (MG)";"MG";"VERDELANDIA";11;2;2;15
2005;"VEREDINHA (MG)";"MG";"VEREDINHA";18;0;13;31
2005;"VERISSIMO (MG)";"MG";"VERISSIMO";32;21;3;56
2005;"VERMELHO NOVO (MG)";"MG";"VERMELHO NOVO";37;1;14;52
2005;"VESPASIANO (MG)";"MG";"VESPASIANO";367;56;107;530
2005;"VICOSA (MG)";"MG";"VICOSA";511;71;132;714
2005;"VIEIRAS (MG)";"MG";"VIEIRAS";21;3;3;27
2005;"VIRGEM DA LAPA (MG)";"MG";"VIRGEM DA LAPA";40;4;17;61
2005;"VIRGINIA (MG)";"MG";"VIRGINIA";88;10;4;102
2005;"VIRGINOPOLIS (MG)";"MG";"VIRGINOPOLIS";66;5;6;77
2005;"VIRGOLANDIA (MG)";"MG";"VIRGOLANDIA";13;1;5;19
2005;"VISCONDE DO RIO BRANCO (MG)";"MG";"VISCONDE DO RIO BRANCO";667;23;49;739
2005;"VOLTA GRANDE (MG)";"MG";"VOLTA GRANDE";34;3;6;43
2005;"WENCESLAU BRAZ (MG)";"MG";"WENCESLAU BRAZ";44;3;4;51
2005;"AGUA CLARA (MS)";"MS";"AGUA CLARA";318;6;39;363
2005;"ALCINOPOLIS (MS)";"MS";"ALCINOPOLIS";58;4;11;73
2005;"AMAMBAI (MS)";"MS";"AMAMBAI";557;8;30;595
2005;"ANASTACIO (MS)";"MS";"ANASTACIO";244;8;15;267
2005;"ANAURILANDIA (MS)";"MS";"ANAURILANDIA";74;8;26;108
2005;"ANGELICA (MS)";"MS";"ANGELICA";116;3;21;140
2005;"ANTONIO JOAO (MS)";"MS";"ANTONIO JOAO";80;1;8;89
2005;"APARECIDA DO TABOADO (MS)";"MS";"APARECIDA DO TABOADO";290;13;42;345
2005;"AQUIDAUANA (MS)";"MS";"AQUIDAUANA";246;18;36;300
2005;"ARAL MOREIRA (MS)";"MS";"ARAL MOREIRA";117;7;13;137
2005;"BANDEIRANTES (MS)";"MS";"BANDEIRANTES";87;6;8;101
2005;"BATAGUASSU (MS)";"MS";"BATAGUASSU";462;17;97;576
2005;"BATAYPORA (MS)";"MS";"BATAYPORA";131;1;23;155
2005;"BELA VISTA (MS)";"MS";"BELA VISTA";153;16;24;193
2005;"BODOQUENA (MS)";"MS";"BODOQUENA";51;6;24;81
2005;"BONITO (MS)";"MS";"BONITO";189;28;40;257
2005;"BRASILANDIA (MS)";"MS";"BRASILANDIA";161;9;42;212
2005;"CAARAPO (MS)";"MS";"CAARAPO";370;8;53;431
2005;"CAMAPUA (MS)";"MS";"CAMAPUA";275;18;16;309
2005;"CAMPO GRANDE (MS)";"MS";"CAMPO GRANDE";9724;575;1324;11623
2005;"CARACOL (MS)";"MS";"CARACOL";24;6;5;35
2005;"CASSILANDIA (MS)";"MS";"CASSILANDIA";421;9;24;454
2005;"CHAPADAO DO SUL (MS)";"MS";"CHAPADAO DO SUL";491;7;34;532
2005;"CORGUINHO (MS)";"MS";"CORGUINHO";46;2;11;59
2005;"CORONEL SAPUCAIA (MS)";"MS";"CORONEL SAPUCAIA";185;1;11;197
2005;"CORUMBA (MS)";"MS";"CORUMBA";560;37;96;693
2005;"COSTA RICA (MS)";"MS";"COSTA RICA";363;7;33;403
2005;"COXIM (MS)";"MS";"COXIM";432;9;44;485
2005;"DEODAPOLIS (MS)";"MS";"DEODAPOLIS";187;5;26;218
2005;"DOIS IRMAOS DO BURITI (MS)";"MS";"DOIS IRMAOS DO BURITI";77;11;20;108
2005;"DOURADINA (MS)";"MS";"DOURADINA";151;0;10;161
2005;"DOURADOS (MS)";"MS";"DOURADOS";3075;114;230;3419
2005;"ELDORADO (MS)";"MS";"ELDORADO";202;4;15;221
2005;"FATIMA DO SUL (MS)";"MS";"FATIMA DO SUL";360;3;20;383
2005;"FIGUEIRAO (MS)";"MS";"FIGUEIRAO";8;7;2;17
2005;"GLORIA DE DOURADOS (MS)";"MS";"GLORIA DE DOURADOS";168;1;22;191
2005;"GUIA LOPES DA LAGUNA (MS)";"MS";"GUIA LOPES DA LAGUNA";107;10;19;136
2005;"IGUATEMI (MS)";"MS";"IGUATEMI";188;3;32;223
2005;"INOCENCIA (MS)";"MS";"INOCENCIA";137;1;17;155
2005;"ITAPORA (MS)";"MS";"ITAPORA";314;8;34;356
2005;"ITAQUIRAI (MS)";"MS";"ITAQUIRAI";136;2;49;187
2005;"IVINHEMA (MS)";"MS";"IVINHEMA";406;6;157;569
2005;"JAPORA (MS)";"MS";"JAPORA";10;2;7;19
2005;"JARAGUARI (MS)";"MS";"JARAGUARI";52;1;18;71
2005;"JARDIM (MS)";"MS";"JARDIM";340;14;20;374
2005;"JATEI (MS)";"MS";"JATEI";28;4;13;45
2005;"JUTI (MS)";"MS";"JUTI";37;3;12;52
2005;"LADARIO (MS)";"MS";"LADARIO";140;11;47;198
2005;"LAGUNA CARAPA (MS)";"MS";"LAGUNA CARAPA";120;1;18;139
2005;"MARACAJU (MS)";"MS";"MARACAJU";655;12;69;736
2005;"MIRANDA (MS)";"MS";"MIRANDA";218;13;31;262
2005;"MUNDO NOVO (MS)";"MS";"MUNDO NOVO";200;11;25;236
2005;"NAVIRAI (MS)";"MS";"NAVIRAI";660;11;104;775
2005;"NIOAQUE (MS)";"MS";"NIOAQUE";88;10;31;129
2005;"NOVA ALVORADA DO SUL (MS)";"MS";"NOVA ALVORADA DO SUL";199;7;41;247
2005;"NOVA ANDRADINA (MS)";"MS";"NOVA ANDRADINA";800;10;119;929
2005;"NOVO HORIZONTE DO SUL (MS)";"MS";"NOVO HORIZONTE DO SUL";54;0;14;68
2005;"PARANAIBA (MS)";"MS";"PARANAIBA";677;10;51;738
2005;"PARANHOS (MS)";"MS";"PARANHOS";67;1;12;80
2005;"PEDRO GOMES (MS)";"MS";"PEDRO GOMES";71;5;8;84
2005;"PONTA PORA (MS)";"MS";"PONTA PORA";1257;29;121;1407
2005;"PORTO MURTINHO (MS)";"MS";"PORTO MURTINHO";43;6;12;61
2005;"RIBAS DO RIO PARDO (MS)";"MS";"RIBAS DO RIO PARDO";431;11;26;468
2005;"RIO BRILHANTE (MS)";"MS";"RIO BRILHANTE";443;12;101;556
2005;"RIO NEGRO (MS)";"MS";"RIO NEGRO";43;2;8;53
2005;"RIO VERDE DE MATO GROSSO (MS)";"MS";"RIO VERDE DE MATO GROSSO";236;9;7;252
2005;"ROCHEDO (MS)";"MS";"ROCHEDO";36;6;7;49
2005;"SANTA RITA DO PARDO (MS)";"MS";"SANTA RITA DO PARDO";99;7;21;127
2005;"SAO GABRIEL DO OESTE (MS)";"MS";"SAO GABRIEL DO OESTE";665;15;34;714
2005;"SELVIRIA (MS)";"MS";"SELVIRIA";73;2;13;88
2005;"SETE QUEDAS (MS)";"MS";"SETE QUEDAS";192;5;18;215
2005;"SIDROLANDIA (MS)";"MS";"SIDROLANDIA";458;22;103;583
2005;"SONORA (MS)";"MS";"SONORA";178;9;71;258
2005;"TACURU (MS)";"MS";"TACURU";90;1;11;102
2005;"TAQUARUSSU (MS)";"MS";"TAQUARUSSU";37;2;9;48
2005;"TERENOS (MS)";"MS";"TERENOS";217;5;15;237
2005;"TRES LAGOAS (MS)";"MS";"TRES LAGOAS";1337;30;244;1611
2005;"VICENTINA (MS)";"MS";"VICENTINA";77;5;43;125
2005;"ACORIZAL (MT)";"MT";"ACORIZAL";9;1;3;13
2005;"AGUA BOA (MT)";"MT";"AGUA BOA";360;6;16;382
2005;"ALTA FLORESTA (MT)";"MT";"ALTA FLORESTA";957;7;61;1025
2005;"ALTO ARAGUAIA (MT)";"MT";"ALTO ARAGUAIA";81;4;14;99
2005;"ALTO BOA VISTA (MT)";"MT";"ALTO BOA VISTA";13;0;1;14
2005;"ALTO GARCAS (MT)";"MT";"ALTO GARCAS";253;3;25;281
2005;"ALTO PARAGUAI (MT)";"MT";"ALTO PARAGUAI";18;6;2;26
2005;"ALTO TAQUARI (MT)";"MT";"ALTO TAQUARI";99;4;7;110
2005;"APIACAS (MT)";"MT";"APIACAS";68;1;2;71
2005;"ARAGUAIANA (MT)";"MT";"ARAGUAIANA";8;0;1;9
2005;"ARAGUAINHA (MT)";"MT";"ARAGUAINHA";6;2;0;8
2005;"ARAPUTANGA (MT)";"MT";"ARAPUTANGA";214;5;15;234
2005;"ARENAPOLIS (MT)";"MT";"ARENAPOLIS";154;10;33;197
2005;"ARIPUANA (MT)";"MT";"ARIPUANA";217;4;14;235
2005;"BARAO DE MELGACO (MT)";"MT";"BARAO DE MELGACO";7;0;2;9
2005;"BARRA DO BUGRES (MT)";"MT";"BARRA DO BUGRES";421;10;102;533
2005;"BARRA DO GARCAS (MT)";"MT";"BARRA DO GARCAS";743;20;168;931
2005;"BOM JESUS DO ARAGUAIA (MT)";"MT";"BOM JESUS DO ARAGUAIA";10;0;3;13
2005;"BRASNORTE (MT)";"MT";"BRASNORTE";172;2;12;186
2005;"CACERES (MT)";"MT";"CACERES";673;39;191;903
2005;"CAMPINAPOLIS (MT)";"MT";"CAMPINAPOLIS";50;0;8;58
2005;"CAMPO NOVO DO PARECIS (MT)";"MT";"CAMPO NOVO DO PARECIS";580;14;43;637
2005;"CAMPO VERDE (MT)";"MT";"CAMPO VERDE";575;18;53;646
2005;"CAMPOS DE JULIO (MT)";"MT";"CAMPOS DE JULIO";112;5;9;126
2005;"CANABRAVA DO NORTE (MT)";"MT";"CANABRAVA DO NORTE";5;0;1;6
2005;"CANARANA (MT)";"MT";"CANARANA";377;1;25;403
2005;"CARLINDA (MT)";"MT";"CARLINDA";90;0;12;102
2005;"CASTANHEIRA (MT)";"MT";"CASTANHEIRA";76;1;8;85
2005;"CHAPADA DOS GUIMARAES (MT)";"MT";"CHAPADA DOS GUIMARAES";161;11;31;203
2005;"CLAUDIA (MT)";"MT";"CLAUDIA";351;4;11;366
2005;"COCALINHO (MT)";"MT";"COCALINHO";15;1;7;23
2005;"COLIDER (MT)";"MT";"COLIDER";626;13;63;702
2005;"COLNIZA (MT)";"MT";"COLNIZA";81;0;0;81
2005;"COMODORO (MT)";"MT";"COMODORO";308;4;41;353
2005;"CONFRESA (MT)";"MT";"CONFRESA";64;3;11;78
2005;"CONQUISTA D OESTE (MT)";"MT";"CONQUISTA D OESTE";27;1;8;36
2005;"COTRIGUACU (MT)";"MT";"COTRIGUACU";81;1;14;96
2005;"CUIABA (MT)";"MT";"CUIABA";5820;594;1405;7819
2005;"CURVELANDIA (MT)";"MT";"CURVELANDIA";40;0;9;49
2005;"DENISE (MT)";"MT";"DENISE";53;3;20;76
2005;"DIAMANTINO (MT)";"MT";"DIAMANTINO";391;14;52;457
2005;"DOM AQUINO (MT)";"MT";"DOM AQUINO";87;9;13;109
2005;"FELIZ NATAL (MT)";"MT";"FELIZ NATAL";158;1;6;165
2005;"FIGUEIROPOLIS D OESTE (MT)";"MT";"FIGUEIROPOLIS D OESTE";48;1;7;56
2005;"GAUCHA DO NORTE (MT)";"MT";"GAUCHA DO NORTE";30;3;3;36
2005;"GENERAL CARNEIRO (MT)";"MT";"GENERAL CARNEIRO";17;1;3;21
2005;"GLORIA D OESTE (MT)";"MT";"GLORIA D OESTE";28;3;6;37
2005;"GUARANTA DO NORTE (MT)";"MT";"GUARANTA DO NORTE";694;3;21;718
2005;"GUIRATINGA (MT)";"MT";"GUIRATINGA";106;4;3;113
2005;"INDIAVAI (MT)";"MT";"INDIAVAI";16;1;6;23
2005;"IPIRANGA DO NORTE (MT)";"MT";"IPIRANGA DO NORTE";7;0;0;7
2005;"ITANHANGA (MT)";"MT";"ITANHANGA";6;0;1;7
2005;"ITAUBA (MT)";"MT";"ITAUBA";94;3;5;102
2005;"ITIQUIRA (MT)";"MT";"ITIQUIRA";55;7;15;77
2005;"JACIARA (MT)";"MT";"JACIARA";430;13;82;525
2005;"JANGADA (MT)";"MT";"JANGADA";36;4;9;49
2005;"JAURU (MT)";"MT";"JAURU";134;3;17;154
2005;"JUARA (MT)";"MT";"JUARA";545;11;25;581
2005;"JUINA (MT)";"MT";"JUINA";601;5;41;647
2005;"JURUENA (MT)";"MT";"JURUENA";93;1;7;101
2005;"JUSCIMEIRA (MT)";"MT";"JUSCIMEIRA";92;3;32;127
2005;"LAMBARI D OESTE (MT)";"MT";"LAMBARI D OESTE";41;0;14;55
2005;"LUCAS DO RIO VERDE (MT)";"MT";"LUCAS DO RIO VERDE";979;23;53;1055
2005;"LUCIARA (MT)";"MT";"LUCIARA";5;0;2;7
2005;"MARCELANDIA (MT)";"MT";"MARCELANDIA";317;4;9;330
2005;"MATUPA (MT)";"MT";"MATUPA";277;6;20;303
2005;"MIRASSOL D OESTE (MT)";"MT";"MIRASSOL D OESTE";559;8;41;608
2005;"NOBRES (MT)";"MT";"NOBRES";197;5;27;229
2005;"NORTELANDIA (MT)";"MT";"NORTELANDIA";64;5;15;84
2005;"NOSSA SENHORA DO LIVRAMENTO (MT)";"MT";"NOSSA SENHORA DO LIVRAMENTO";33;3;19;55
2005;"NOVA BANDEIRANTES (MT)";"MT";"NOVA BANDEIRANTES";70;2;13;85
2005;"NOVA BRASILANDIA (MT)";"MT";"NOVA BRASILANDIA";24;1;8;33
2005;"NOVA CANAA DO NORTE (MT)";"MT";"NOVA CANAA DO NORTE";145;1;20;166
2005;"NOVA GUARITA (MT)";"MT";"NOVA GUARITA";62;2;7;71
2005;"NOVA LACERDA (MT)";"MT";"NOVA LACERDA";33;1;13;47
2005;"NOVA MARILANDIA (MT)";"MT";"NOVA MARILANDIA";12;2;4;18
2005;"NOVA MARINGA (MT)";"MT";"NOVA MARINGA";52;0;7;59
2005;"NOVA MONTE VERDE (MT)";"MT";"NOVA MONTE VERDE";67;1;1;69
2005;"NOVA MUTUM (MT)";"MT";"NOVA MUTUM";526;6;25;557
2005;"NOVA NAZARE (MT)";"MT";"NOVA NAZARE";5;1;3;9
2005;"NOVA OLIMPIA (MT)";"MT";"NOVA OLIMPIA";187;14;70;271
2005;"NOVA SANTA HELENA (MT)";"MT";"NOVA SANTA HELENA";38;1;6;45
2005;"NOVA UBIRATA (MT)";"MT";"NOVA UBIRATA";71;4;3;78
2005;"NOVA XAVANTINA (MT)";"MT";"NOVA XAVANTINA";235;5;25;265
2005;"NOVO HORIZONTE DO NORTE (MT)";"MT";"NOVO HORIZONTE DO NORTE";25;0;7;32
2005;"NOVO MUNDO (MT)";"MT";"NOVO MUNDO";57;2;5;64
2005;"NOVO SANTO ANTONIO (MT)";"MT";"NOVO SANTO ANTONIO";2;0;1;3
2005;"NOVO SAO JOAQUIM (MT)";"MT";"NOVO SAO JOAQUIM";45;0;7;52
2005;"PARANAITA (MT)";"MT";"PARANAITA";158;2;13;173
2005;"PARANATINGA (MT)";"MT";"PARANATINGA";292;5;21;318
2005;"PEDRA PRETA (MT)";"MT";"PEDRA PRETA";204;12;21;237
2005;"PEIXOTO DE AZEVEDO (MT)";"MT";"PEIXOTO DE AZEVEDO";213;9;37;259
2005;"PLANALTO DA SERRA (MT)";"MT";"PLANALTO DA SERRA";6;1;3;10
2005;"POCONE (MT)";"MT";"POCONE";240;11;23;274
2005;"PONTAL DO ARAGUAIA (MT)";"MT";"PONTAL DO ARAGUAIA";12;0;1;13
2005;"PONTE BRANCA (MT)";"MT";"PONTE BRANCA";4;1;0;5
2005;"PONTES E LACERDA (MT)";"MT";"PONTES E LACERDA";676;16;55;747
2005;"PORTO ALEGRE DO NORTE (MT)";"MT";"PORTO ALEGRE DO NORTE";20;3;6;29
2005;"PORTO DOS GAUCHOS (MT)";"MT";"PORTO DOS GAUCHOS";75;3;5;83
2005;"PORTO ESPERIDIAO (MT)";"MT";"PORTO ESPERIDIAO";67;2;25;94
2005;"PORTO ESTRELA (MT)";"MT";"PORTO ESTRELA";16;2;3;21
2005;"POXOREO (MT)";"MT";"POXOREO";78;5;22;105
2005;"PRIMAVERA DO LESTE (MT)";"MT";"PRIMAVERA DO LESTE";1259;40;60;1359
2005;"QUERENCIA (MT)";"MT";"QUERENCIA";156;0;9;165
2005;"RESERVA DO CABACAL (MT)";"MT";"RESERVA DO CABACAL";16;1;5;22
2005;"RIBEIRAO CASCALHEIRA (MT)";"MT";"RIBEIRAO CASCALHEIRA";52;1;4;57
2005;"RIBEIRAOZINHO (MT)";"MT";"RIBEIRAOZINHO";6;1;4;11
2005;"RIO BRANCO (MT)";"MT";"RIO BRANCO";76;4;9;89
2005;"RONDOLANDIA (MT)";"MT";"RONDOLANDIA";3;0;4;7
2005;"RONDONOPOLIS (MT)";"MT";"RONDONOPOLIS";2927;95;269;3291
2005;"ROSARIO OESTE (MT)";"MT";"ROSARIO OESTE";102;6;15;123
2005;"SALTO DO CEU (MT)";"MT";"SALTO DO CEU";26;1;6;33
2005;"SANTA CARMEN (MT)";"MT";"SANTA CARMEN";122;4;6;132
2005;"SANTA CRUZ DO XINGU (MT)";"MT";"SANTA CRUZ DO XINGU";1;0;1;2
2005;"SANTA RITA DO TRIVELATO (MT)";"MT";"SANTA RITA DO TRIVELATO";29;1;2;32
2005;"SANTA TEREZINHA (MT)";"MT";"SANTA TEREZINHA";5;1;4;10
2005;"SANTO AFONSO (MT)";"MT";"SANTO AFONSO";24;2;5;31
2005;"SANTO ANTONIO DO LESTE (MT)";"MT";"SANTO ANTONIO DO LESTE";64;1;12;77
2005;"SANTO ANTONIO DO LEVERGER (MT)";"MT";"SANTO ANTONIO DO LEVERGER";57;7;13;77
2005;"SAO FELIX DO ARAGUAIA (MT)";"MT";"SAO FELIX DO ARAGUAIA";28;2;15;45
2005;"SAO JOSE DO POVO (MT)";"MT";"SAO JOSE DO POVO";13;1;6;20
2005;"SAO JOSE DO RIO CLARO (MT)";"MT";"SAO JOSE DO RIO CLARO";212;6;25;243
2005;"SAO JOSE DO XINGU (MT)";"MT";"SAO JOSE DO XINGU";7;0;4;11
2005;"SAO JOSE DOS QUATRO MARCOS (MT)";"MT";"SAO JOSE DOS QUATRO MARCOS";352;6;39;397
2005;"SAO PEDRO DA CIPA (MT)";"MT";"SAO PEDRO DA CIPA";17;4;15;36
2005;"SAPEZAL (MT)";"MT";"SAPEZAL";288;4;15;307
2005;"SERRA NOVA DOURADA (MT)";"MT";"SERRA NOVA DOURADA";1;0;1;2
2005;"SINOP (MT)";"MT";"SINOP";2426;29;126;2581
2005;"SORRISO (MT)";"MT";"SORRISO";1634;30;76;1740
2005;"TABAPORA (MT)";"MT";"TABAPORA";78;3;10;91
2005;"TANGARA DA SERRA (MT)";"MT";"TANGARA DA SERRA";1629;70;130;1829
2005;"TAPURAH (MT)";"MT";"TAPURAH";249;9;13;271
2005;"TERRA NOVA DO NORTE (MT)";"MT";"TERRA NOVA DO NORTE";212;4;17;233
2005;"TESOURO (MT)";"MT";"TESOURO";7;1;3;11
2005;"TORIXOREU (MT)";"MT";"TORIXOREU";11;0;3;14
2005;"UNIAO DO SUL (MT)";"MT";"UNIAO DO SUL";69;0;3;72
2005;"VALE DE SAO DOMINGOS (MT)";"MT";"VALE DE SAO DOMINGOS";10;0;6;16
2005;"VARZEA GRANDE (MT)";"MT";"VARZEA GRANDE";3218;165;326;3709
2005;"VERA (MT)";"MT";"VERA";236;3;11;250
2005;"VILA BELA DA SANTISSIMA TRINDA (MT)";"MT";"VILA BELA DA SANTISSIMA TRINDA";56;1;15;72
2005;"VILA RICA (MT)";"MT";"VILA RICA";140;6;13;159
2005;"ABAETETUBA (PA)";"PA";"ABAETETUBA";172;7;99;278
2005;"ABEL FIGUEIREDO (PA)";"PA";"ABEL FIGUEIREDO";19;6;3;28
2005;"ACARA (PA)";"PA";"ACARA";43;3;11;57
2005;"AFUA (PA)";"PA";"AFUA";0;0;0;0
2005;"AGUA AZUL DO NORTE (PA)";"PA";"AGUA AZUL DO NORTE";18;2;4;24
2005;"ALENQUER (PA)";"PA";"ALENQUER";88;2;27;117
2005;"ALMEIRIM (PA)";"PA";"ALMEIRIM";166;6;59;231
2005;"ALTAMIRA (PA)";"PA";"ALTAMIRA";657;71;36;764
2005;"ANAJAS (PA)";"PA";"ANAJAS";0;0;0;0
2005;"ANANINDEUA (PA)";"PA";"ANANINDEUA";2547;168;821;3536
2005;"ANAPU (PA)";"PA";"ANAPU";27;6;1;34
2005;"AUGUSTO CORREA (PA)";"PA";"AUGUSTO CORREA";20;3;28;51
2005;"AURORA DO PARA (PA)";"PA";"AURORA DO PARA";30;1;30;61
2005;"AVEIRO (PA)";"PA";"AVEIRO";0;0;0;0
2005;"BAGRE (PA)";"PA";"BAGRE";1;0;0;1
2005;"BAIAO (PA)";"PA";"BAIAO";17;0;3;20
2005;"BANNACH (PA)";"PA";"BANNACH";11;0;1;12
2005;"BARCARENA (PA)";"PA";"BARCARENA";395;106;352;853
2005;"BELEM (PA)";"PA";"BELEM";6050;741;2184;8975
2005;"BELTERRA (PA)";"PA";"BELTERRA";21;0;8;29
2005;"BENEVIDES (PA)";"PA";"BENEVIDES";248;10;39;297
2005;"BOM JESUS DO TOCANTINS (PA)";"PA";"BOM JESUS DO TOCANTINS";36;14;3;53
2005;"BONITO (PA)";"PA";"BONITO";21;0;18;39
2005;"BRAGANCA (PA)";"PA";"BRAGANCA";269;25;101;395
2005;"BRASIL NOVO (PA)";"PA";"BRASIL NOVO";55;20;4;79
2005;"BREJO GRANDE DO ARAGUAIA (PA)";"PA";"BREJO GRANDE DO ARAGUAIA";7;5;4;16
2005;"BREU BRANCO (PA)";"PA";"BREU BRANCO";191;13;37;241
2005;"BREVES (PA)";"PA";"BREVES";13;0;4;17
2005;"BUJARU (PA)";"PA";"BUJARU";23;2;4;29
2005;"CACHOEIRA DO ARARI (PA)";"PA";"CACHOEIRA DO ARARI";3;1;1;5
2005;"CACHOEIRA DO PIRIA (PA)";"PA";"CACHOEIRA DO PIRIA";14;2;9;25
2005;"CAMETA (PA)";"PA";"CAMETA";60;2;22;84
2005;"CANAA DOS CARAJAS (PA)";"PA";"CANAA DOS CARAJAS";67;25;19;111
2005;"CAPANEMA (PA)";"PA";"CAPANEMA";470;13;72;555
2005;"CAPITAO POCO (PA)";"PA";"CAPITAO POCO";229;11;36;276
2005;"CASTANHAL (PA)";"PA";"CASTANHAL";1684;95;221;2000
2005;"CHAVES (PA)";"PA";"CHAVES";0;0;0;0
2005;"COLARES (PA)";"PA";"COLARES";3;0;1;4
2005;"CONCEICAO DO ARAGUAIA (PA)";"PA";"CONCEICAO DO ARAGUAIA";246;23;59;328
2005;"CONCORDIA DO PARA (PA)";"PA";"CONCORDIA DO PARA";76;0;10;86
2005;"CUMARU DO NORTE (PA)";"PA";"CUMARU DO NORTE";7;0;3;10
2005;"CURIONOPOLIS (PA)";"PA";"CURIONOPOLIS";37;58;1;96
2005;"CURRALINHO (PA)";"PA";"CURRALINHO";1;0;0;1
2005;"CURUA (PA)";"PA";"CURUA";0;0;0;0
2005;"CURUCA (PA)";"PA";"CURUCA";34;2;3;39
2005;"DOM ELISEU (PA)";"PA";"DOM ELISEU";381;19;11;411
2005;"ELDORADO DOS CARAJAS (PA)";"PA";"ELDORADO DOS CARAJAS";63;6;2;71
2005;"FARO (PA)";"PA";"FARO";2;1;0;3
2005;"FLORESTA DO ARAGUAIA (PA)";"PA";"FLORESTA DO ARAGUAIA";45;0;2;47
2005;"GARRAFAO DO NORTE (PA)";"PA";"GARRAFAO DO NORTE";43;3;4;50
2005;"GOIANESIA DO PARA (PA)";"PA";"GOIANESIA DO PARA";170;8;17;195
2005;"GURUPA (PA)";"PA";"GURUPA";2;0;0;2
2005;"IGARAPE ACU (PA)";"PA";"IGARAPE ACU";100;40;36;176
2005;"IGARAPE MIRI (PA)";"PA";"IGARAPE MIRI";43;8;14;65
2005;"INHANGAPI (PA)";"PA";"INHANGAPI";15;0;20;35
2005;"IPIXUNA DO PARA (PA)";"PA";"IPIXUNA DO PARA";60;3;10;73
2005;"IRITUIA (PA)";"PA";"IRITUIA";44;1;18;63
2005;"ITAITUBA (PA)";"PA";"ITAITUBA";461;31;38;530
2005;"ITUPIRANGA (PA)";"PA";"ITUPIRANGA";66;53;12;131
2005;"JACAREACANGA (PA)";"PA";"JACAREACANGA";4;0;0;4
2005;"JACUNDA (PA)";"PA";"JACUNDA";384;12;26;422
2005;"JURUTI (PA)";"PA";"JURUTI";6;1;0;7
2005;"LIMOEIRO DO AJURU (PA)";"PA";"LIMOEIRO DO AJURU";0;0;0;0
2005;"MAE DO RIO (PA)";"PA";"MAE DO RIO";220;7;36;263
2005;"MAGALHAES BARATA (PA)";"PA";"MAGALHAES BARATA";10;1;2;13
2005;"MARABA (PA)";"PA";"MARABA";1954;143;243;2340
2005;"MARACANA (PA)";"PA";"MARACANA";9;7;11;27
2005;"MARAPANIM (PA)";"PA";"MARAPANIM";16;8;10;34
2005;"MARITUBA (PA)";"PA";"MARITUBA";367;16;91;474
2005;"MEDICILANDIA (PA)";"PA";"MEDICILANDIA";110;8;7;125
2005;"MELGACO (PA)";"PA";"MELGACO";1;0;0;1
2005;"MOCAJUBA (PA)";"PA";"MOCAJUBA";8;2;4;14
2005;"MOJU (PA)";"PA";"MOJU";96;5;60;161
2005;"MONTE ALEGRE (PA)";"PA";"MONTE ALEGRE";151;3;71;225
2005;"MUANA (PA)";"PA";"MUANA";0;1;0;1
2005;"NOVA ESPERANCA DO PIRIA (PA)";"PA";"NOVA ESPERANCA DO PIRIA";25;2;4;31
2005;"NOVA IPIXUNA (PA)";"PA";"NOVA IPIXUNA";85;4;11;100
2005;"NOVA TIMBOTEUA (PA)";"PA";"NOVA TIMBOTEUA";32;5;9;46
2005;"NOVO PROGRESSO (PA)";"PA";"NOVO PROGRESSO";38;2;3;43
2005;"NOVO REPARTIMENTO (PA)";"PA";"NOVO REPARTIMENTO";192;10;14;216
2005;"OBIDOS (PA)";"PA";"OBIDOS";112;0;21;133
2005;"OEIRAS DO PARA (PA)";"PA";"OEIRAS DO PARA";3;1;0;4
2005;"ORIXIMINA (PA)";"PA";"ORIXIMINA";159;5;12;176
2005;"OUREM (PA)";"PA";"OUREM";50;1;11;62
2005;"OURILANDIA DO NORTE (PA)";"PA";"OURILANDIA DO NORTE";55;2;5;62
2005;"PACAJA (PA)";"PA";"PACAJA";50;8;4;62
2005;"PALESTINA DO PARA (PA)";"PA";"PALESTINA DO PARA";9;2;1;12
2005;"PARAGOMINAS (PA)";"PA";"PARAGOMINAS";844;12;55;911
2005;"PARAUAPEBAS (PA)";"PA";"PARAUAPEBAS";609;286;73;968
2005;"PAU D ARCO (PA)";"PA";"PAU D ARCO";8;4;0;12
2005;"PEIXE BOI (PA)";"PA";"PEIXE BOI";14;0;9;23
2005;"PICARRA (PA)";"PA";"PICARRA";8;0;2;10
2005;"PLACAS (PA)";"PA";"PLACAS";22;2;1;25
2005;"PONTA DE PEDRAS (PA)";"PA";"PONTA DE PEDRAS";1;0;0;1
2005;"PORTEL (PA)";"PA";"PORTEL";8;0;0;8
2005;"PORTO DE MOZ (PA)";"PA";"PORTO DE MOZ";11;0;0;11
2005;"PRAINHA (PA)";"PA";"PRAINHA";10;0;1;11
2005;"PRIMAVERA (PA)";"PA";"PRIMAVERA";10;1;4;15
2005;"QUATIPURU (PA)";"PA";"QUATIPURU";3;2;10;15
2005;"REDENCAO (PA)";"PA";"REDENCAO";575;36;30;641
2005;"RIO MARIA (PA)";"PA";"RIO MARIA";140;33;10;183
2005;"RONDON DO PARA (PA)";"PA";"RONDON DO PARA";351;33;9;393
2005;"RUROPOLIS (PA)";"PA";"RUROPOLIS";89;1;8;98
2005;"SALINOPOLIS (PA)";"PA";"SALINOPOLIS";78;12;28;118
2005;"SALVATERRA (PA)";"PA";"SALVATERRA";15;12;9;36
2005;"SANTA BARBARA DO PARA (PA)";"PA";"SANTA BARBARA DO PARA";28;7;3;38
2005;"SANTA CRUZ DO ARARI (PA)";"PA";"SANTA CRUZ DO ARARI";1;0;0;1
2005;"SANTA ISABEL DO PARA (PA)";"PA";"SANTA ISABEL DO PARA";380;13;57;450
2005;"SANTA LUZIA DO PARA (PA)";"PA";"SANTA LUZIA DO PARA";73;1;28;102
2005;"SANTA MARIA DAS BARREIRAS (PA)";"PA";"SANTA MARIA DAS BARREIRAS";11;0;2;13
2005;"SANTA MARIA DO PARA (PA)";"PA";"SANTA MARIA DO PARA";147;22;31;200
2005;"SANTANA DO ARAGUAIA (PA)";"PA";"SANTANA DO ARAGUAIA";90;7;11;108
2005;"SANTAREM (PA)";"PA";"SANTAREM";1585;48;370;2003
2005;"SANTAREM NOVO (PA)";"PA";"SANTAREM NOVO";7;2;7;16
2005;"SANTO ANTONIO DO TAUA (PA)";"PA";"SANTO ANTONIO DO TAUA";53;5;45;103
2005;"SAO CAETANO DE ODIVELAS (PA)";"PA";"SAO CAETANO DE ODIVELAS";12;0;1;13
2005;"SAO DOMINGOS DO ARAGUAIA (PA)";"PA";"SAO DOMINGOS DO ARAGUAIA";72;16;16;104
2005;"SAO DOMINGOS DO CAPIM (PA)";"PA";"SAO DOMINGOS DO CAPIM";26;1;8;35
2005;"SAO FELIX DO XINGU (PA)";"PA";"SAO FELIX DO XINGU";70;2;7;79
2005;"SAO FRANCISCO DO PARA (PA)";"PA";"SAO FRANCISCO DO PARA";17;21;17;55
2005;"SAO GERALDO DO ARAGUAIA (PA)";"PA";"SAO GERALDO DO ARAGUAIA";67;2;8;77
2005;"SAO JOAO DA PONTA (PA)";"PA";"SAO JOAO DA PONTA";2;2;4;8
2005;"SAO JOAO DE PIRABAS (PA)";"PA";"SAO JOAO DE PIRABAS";15;5;7;27
2005;"SAO JOAO DO ARAGUAIA (PA)";"PA";"SAO JOAO DO ARAGUAIA";9;10;10;29
2005;"SAO MIGUEL DO GUAMA (PA)";"PA";"SAO MIGUEL DO GUAMA";276;17;48;341
2005;"SAO SEBASTIAO DA BOA VISTA (PA)";"PA";"SAO SEBASTIAO DA BOA VISTA";0;0;0;0
2005;"SAPUCAIA (PA)";"PA";"SAPUCAIA";16;2;1;19
2005;"SENADOR JOSE PORFIRIO (PA)";"PA";"SENADOR JOSE PORFIRIO";9;0;0;9
2005;"SOURE (PA)";"PA";"SOURE";17;1;6;24
2005;"TAILANDIA (PA)";"PA";"TAILANDIA";360;18;25;403
2005;"TERRA ALTA (PA)";"PA";"TERRA ALTA";10;11;10;31
2005;"TERRA SANTA (PA)";"PA";"TERRA SANTA";6;1;1;8
2005;"TOME ACU (PA)";"PA";"TOME ACU";271;6;46;323
2005;"TRACUATEUA (PA)";"PA";"TRACUATEUA";14;2;19;35
2005;"TRAIRAO (PA)";"PA";"TRAIRAO";49;0;0;49
2005;"TUCUMA (PA)";"PA";"TUCUMA";209;9;21;239
2005;"TUCURUI (PA)";"PA";"TUCURUI";478;63;100;641
2005;"ULIANOPOLIS (PA)";"PA";"ULIANOPOLIS";133;12;11;156
2005;"URUARA (PA)";"PA";"URUARA";278;3;10;291
2005;"VIGIA (PA)";"PA";"VIGIA";84;2;40;126
2005;"VISEU (PA)";"PA";"VISEU";29;3;14;46
2005;"VITORIA DO XINGU (PA)";"PA";"VITORIA DO XINGU";8;11;4;23
2005;"XINGUARA (PA)";"PA";"XINGUARA";433;17;73;523
2005;"AGUA BRANCA (PB)";"PB";"AGUA BRANCA";5;1;2;8
2005;"AGUIAR (PB)";"PB";"AGUIAR";4;0;2;6
2005;"ALAGOA GRANDE (PB)";"PB";"ALAGOA GRANDE";67;12;17;96
2005;"ALAGOA NOVA (PB)";"PB";"ALAGOA NOVA";56;6;7;69
2005;"ALAGOINHA (PB)";"PB";"ALAGOINHA";34;4;10;48
2005;"ALCANTIL (PB)";"PB";"ALCANTIL";23;3;2;28
2005;"ALGODAO DE JANDAIRA (PB)";"PB";"ALGODAO DE JANDAIRA";12;0;2;14
2005;"ALHANDRA (PB)";"PB";"ALHANDRA";54;12;11;77
2005;"AMPARO (PB)";"PB";"AMPARO";2;1;3;6
2005;"APARECIDA (PB)";"PB";"APARECIDA";17;3;3;23
2005;"ARACAGI (PB)";"PB";"ARACAGI";38;0;19;57
2005;"ARARA (PB)";"PB";"ARARA";29;3;15;47
2005;"ARARUNA (PB)";"PB";"ARARUNA";54;11;14;79
2005;"AREIA (PB)";"PB";"AREIA";89;9;7;105
2005;"AREIA DE BARAUNAS (PB)";"PB";"AREIA DE BARAUNAS";1;1;1;3
2005;"AREIAL (PB)";"PB";"AREIAL";10;0;3;13
2005;"AROEIRAS (PB)";"PB";"AROEIRAS";14;1;4;19
2005;"ASSUNCAO (PB)";"PB";"ASSUNCAO";7;3;1;11
2005;"BAIA DA TRAICAO (PB)";"PB";"BAIA DA TRAICAO";5;2;5;12
2005;"BANANEIRAS (PB)";"PB";"BANANEIRAS";48;5;18;71
2005;"BARAUNA (PB)";"PB";"BARAUNA";5;0;1;6
2005;"BARRA DE SANTA ROSA (PB)";"PB";"BARRA DE SANTA ROSA";35;1;10;46
2005;"BARRA DE SANTANA (PB)";"PB";"BARRA DE SANTANA";42;1;3;46
2005;"BARRA DE SAO MIGUEL (PB)";"PB";"BARRA DE SAO MIGUEL";0;0;2;2
2005;"BAYEUX (PB)";"PB";"BAYEUX";334;20;120;474
2005;"BELEM (PB)";"PB";"BELEM";83;5;8;96
2005;"BELEM DO BREJO DO CRUZ (PB)";"PB";"BELEM DO BREJO DO CRUZ";5;8;1;14
2005;"BERNARDINO BATISTA (PB)";"PB";"BERNARDINO BATISTA";0;0;1;1
2005;"BOA VENTURA (PB)";"PB";"BOA VENTURA";3;2;0;5
2005;"BOA VISTA (PB)";"PB";"BOA VISTA";61;4;8;73
2005;"BOM JESUS (PB)";"PB";"BOM JESUS";3;1;0;4
2005;"BOM SUCESSO (PB)";"PB";"BOM SUCESSO";6;1;3;10
2005;"BONITO DE SANTA FE (PB)";"PB";"BONITO DE SANTA FE";18;1;0;19
2005;"BOQUEIRAO (PB)";"PB";"BOQUEIRAO";105;3;9;117
2005;"BORBOREMA (PB)";"PB";"BORBOREMA";18;4;1;23
2005;"BREJO DO CRUZ (PB)";"PB";"BREJO DO CRUZ";33;5;2;40
2005;"BREJO DOS SANTOS (PB)";"PB";"BREJO DOS SANTOS";12;2;0;14
2005;"CAAPORA (PB)";"PB";"CAAPORA";16;9;1;26
2005;"CABACEIRAS (PB)";"PB";"CABACEIRAS";18;4;11;33
2005;"CABEDELO (PB)";"PB";"CABEDELO";209;20;14;243
2005;"CACHOEIRA DOS INDIOS (PB)";"PB";"CACHOEIRA DOS INDIOS";11;0;2;13
2005;"CACIMBA DE AREIA (PB)";"PB";"CACIMBA DE AREIA";8;0;3;11
2005;"CACIMBA DE DENTRO (PB)";"PB";"CACIMBA DE DENTRO";30;4;25;59
2005;"CACIMBAS (PB)";"PB";"CACIMBAS";3;0;3;6
2005;"CAICARA (PB)";"PB";"CAICARA";15;1;4;20
2005;"CAJAZEIRAS (PB)";"PB";"CAJAZEIRAS";400;14;34;448
2005;"CAJAZEIRINHAS (PB)";"PB";"CAJAZEIRINHAS";2;2;0;4
2005;"CALDAS BRANDAO (PB)";"PB";"CALDAS BRANDAO";8;1;2;11
2005;"CAMALAU (PB)";"PB";"CAMALAU";14;4;4;22
2005;"CAMPINA GRANDE (PB)";"PB";"CAMPINA GRANDE";3573;153;596;4322
2005;"CAPIM (PB)";"PB";"CAPIM";10;0;1;11
2005;"CARAUBAS (PB)";"PB";"CARAUBAS";3;1;0;4
2005;"CARRAPATEIRA (PB)";"PB";"CARRAPATEIRA";0;2;0;2
2005;"CASSERENGUE (PB)";"PB";"CASSERENGUE";15;0;8;23
2005;"CATINGUEIRA (PB)";"PB";"CATINGUEIRA";8;1;1;10
2005;"CATOLE DO ROCHA (PB)";"PB";"CATOLE DO ROCHA";210;14;12;236
2005;"CATURITE (PB)";"PB";"CATURITE";50;1;5;56
2005;"CONCEICAO (PB)";"PB";"CONCEICAO";63;8;6;77
2005;"CONDADO (PB)";"PB";"CONDADO";12;1;2;15
2005;"CONDE (PB)";"PB";"CONDE";37;5;5;47
2005;"CONGO (PB)";"PB";"CONGO";10;1;2;13
2005;"COREMAS (PB)";"PB";"COREMAS";22;2;4;28
2005;"COXIXOLA (PB)";"PB";"COXIXOLA";2;3;0;5
2005;"CRUZ DO ESPIRITO SANTO (PB)";"PB";"CRUZ DO ESPIRITO SANTO";14;4;7;25
2005;"CUBATI (PB)";"PB";"CUBATI";11;1;0;12
2005;"CUITE (PB)";"PB";"CUITE";69;1;7;77
2005;"CUITE DE MAMANGUAPE (PB)";"PB";"CUITE DE MAMANGUAPE";10;4;12;26
2005;"CUITEGI (PB)";"PB";"CUITEGI";7;0;1;8
2005;"CURRAL DE CIMA (PB)";"PB";"CURRAL DE CIMA";14;2;9;25
2005;"CURRAL VELHO (PB)";"PB";"CURRAL VELHO";4;1;2;7
2005;"DAMIAO (PB)";"PB";"DAMIAO";10;3;3;16
2005;"DESTERRO (PB)";"PB";"DESTERRO";18;0;2;20
2005;"DIAMANTE (PB)";"PB";"DIAMANTE";5;2;0;7
2005;"DONA INES (PB)";"PB";"DONA INES";13;0;9;22
2005;"DUAS ESTRADAS (PB)";"PB";"DUAS ESTRADAS";4;3;2;9
2005;"EMAS (PB)";"PB";"EMAS";2;0;2;4
2005;"ESPERANCA (PB)";"PB";"ESPERANCA";254;8;55;317
2005;"FAGUNDES (PB)";"PB";"FAGUNDES";25;2;10;37
2005;"FREI MARTINHO (PB)";"PB";"FREI MARTINHO";5;0;2;7
2005;"GADO BRAVO (PB)";"PB";"GADO BRAVO";17;3;3;23
2005;"GUARABIRA (PB)";"PB";"GUARABIRA";325;22;108;455
2005;"GURINHEM (PB)";"PB";"GURINHEM";22;3;12;37
2005;"GURJAO (PB)";"PB";"GURJAO";5;2;0;7
2005;"IBIARA (PB)";"PB";"IBIARA";4;2;1;7
2005;"IGARACY (PB)";"PB";"IGARACY";12;3;2;17
2005;"IMACULADA (PB)";"PB";"IMACULADA";5;1;1;7
2005;"INGA (PB)";"PB";"INGA";92;3;18;113
2005;"ITABAIANA (PB)";"PB";"ITABAIANA";166;7;23;196
2005;"ITAPORANGA (PB)";"PB";"ITAPORANGA";63;16;9;88
2005;"ITAPOROROCA (PB)";"PB";"ITAPOROROCA";53;3;9;65
2005;"ITATUBA (PB)";"PB";"ITATUBA";17;1;2;20
2005;"JACARAU (PB)";"PB";"JACARAU";30;1;9;40
2005;"JERICO (PB)";"PB";"JERICO";24;1;0;25
2005;"JOAO PESSOA (PB)";"PB";"JOAO PESSOA";3302;479;860;4641
2005;"JUAREZ TAVORA (PB)";"PB";"JUAREZ TAVORA";15;2;8;25
2005;"JUAZEIRINHO (PB)";"PB";"JUAZEIRINHO";44;5;3;52
2005;"JUNCO DO SERIDO (PB)";"PB";"JUNCO DO SERIDO";31;2;3;36
2005;"JURIPIRANGA (PB)";"PB";"JURIPIRANGA";23;2;15;40
2005;"JURU (PB)";"PB";"JURU";8;11;1;20
2005;"LAGOA (PB)";"PB";"LAGOA";9;2;3;14
2005;"LAGOA DE DENTRO (PB)";"PB";"LAGOA DE DENTRO";12;0;5;17
2005;"LAGOA SECA (PB)";"PB";"LAGOA SECA";91;15;7;113
2005;"LASTRO (PB)";"PB";"LASTRO";7;2;0;9
2005;"LIVRAMENTO (PB)";"PB";"LIVRAMENTO";22;2;1;25
2005;"LOGRADOURO (PB)";"PB";"LOGRADOURO";0;1;4;5
2005;"LUCENA (PB)";"PB";"LUCENA";10;3;8;21
2005;"MAE D AGUA (PB)";"PB";"MAE D AGUA";1;1;3;5
2005;"MALTA (PB)";"PB";"MALTA";3;2;2;7
2005;"MAMANGUAPE (PB)";"PB";"MAMANGUAPE";262;7;50;319
2005;"MANAIRA (PB)";"PB";"MANAIRA";5;1;1;7
2005;"MARCACAO (PB)";"PB";"MARCACAO";0;3;2;5
2005;"MARI (PB)";"PB";"MARI";56;4;27;87
2005;"MARIZOPOLIS (PB)";"PB";"MARIZOPOLIS";10;3;0;13
2005;"MASSARANDUBA (PB)";"PB";"MASSARANDUBA";12;2;5;19
2005;"MATARACA (PB)";"PB";"MATARACA";23;3;7;33
2005;"MATINHAS (PB)";"PB";"MATINHAS";4;0;0;4
2005;"MATO GROSSO (PB)";"PB";"MATO GROSSO";9;1;1;11
2005;"MATUREIA (PB)";"PB";"MATUREIA";10;2;1;13
2005;"MOGEIRO (PB)";"PB";"MOGEIRO";13;2;2;17
2005;"MONTADAS (PB)";"PB";"MONTADAS";11;0;5;16
2005;"MONTE HOREBE (PB)";"PB";"MONTE HOREBE";6;0;2;8
2005;"MONTEIRO (PB)";"PB";"MONTEIRO";192;26;28;246
2005;"MULUNGU (PB)";"PB";"MULUNGU";19;0;8;27
2005;"NATUBA (PB)";"PB";"NATUBA";11;1;0;12
2005;"NAZAREZINHO (PB)";"PB";"NAZAREZINHO";16;0;1;17
2005;"NOVA FLORESTA (PB)";"PB";"NOVA FLORESTA";23;2;5;30
2005;"NOVA OLINDA (PB)";"PB";"NOVA OLINDA";8;3;1;12
2005;"NOVA PALMEIRA (PB)";"PB";"NOVA PALMEIRA";8;0;2;10
2005;"OLHO D AGUA (PB)";"PB";"OLHO D AGUA";3;3;3;9
2005;"OLIVEDOS (PB)";"PB";"OLIVEDOS";16;3;6;25
2005;"OURO VELHO (PB)";"PB";"OURO VELHO";6;3;0;9
2005;"PARARI (PB)";"PB";"PARARI";1;1;0;2
2005;"PASSAGEM (PB)";"PB";"PASSAGEM";10;0;1;11
2005;"PATOS (PB)";"PB";"PATOS";641;37;35;713
2005;"PAULISTA (PB)";"PB";"PAULISTA";28;1;2;31
2005;"PEDRA BRANCA (PB)";"PB";"PEDRA BRANCA";5;0;3;8
2005;"PEDRA LAVRADA (PB)";"PB";"PEDRA LAVRADA";12;2;3;17
2005;"PEDRAS DE FOGO (PB)";"PB";"PEDRAS DE FOGO";209;14;39;262
2005;"PEDRO REGIS (PB)";"PB";"PEDRO REGIS";15;1;2;18
2005;"PIANCO (PB)";"PB";"PIANCO";59;5;2;66
2005;"PICUI (PB)";"PB";"PICUI";72;1;11;84
2005;"PILAR (PB)";"PB";"PILAR";9;1;9;19
2005;"PILOES (PB)";"PB";"PILOES";7;1;1;9
2005;"PILOEZINHOS (PB)";"PB";"PILOEZINHOS";6;2;2;10
2005;"PIRPIRITUBA (PB)";"PB";"PIRPIRITUBA";15;1;6;22
2005;"PITIMBU (PB)";"PB";"PITIMBU";10;6;3;19
2005;"POCINHOS (PB)";"PB";"POCINHOS";58;4;11;73
2005;"POCO DANTAS (PB)";"PB";"POCO DANTAS";2;1;1;4
2005;"POCO DE JOSE DE MOURA (PB)";"PB";"POCO DE JOSE DE MOURA";2;1;2;5
2005;"POMBAL (PB)";"PB";"POMBAL";236;4;9;249
2005;"PRATA (PB)";"PB";"PRATA";12;2;2;16
2005;"PRINCESA ISABEL (PB)";"PB";"PRINCESA ISABEL";73;25;2;100
2005;"PUXINANA (PB)";"PB";"PUXINANA";40;4;5;49
2005;"QUEIMADAS (PB)";"PB";"QUEIMADAS";258;29;68;355
2005;"QUIXABA (PB)";"PB";"QUIXABA";2;1;2;5
2005;"REMIGIO (PB)";"PB";"REMIGIO";144;1;13;158
2005;"RIACHAO (PB)";"PB";"RIACHAO";2;0;3;5
2005;"RIACHAO DO BACAMARTE (PB)";"PB";"RIACHAO DO BACAMARTE";1;0;3;4
2005;"RIACHAO DO POCO (PB)";"PB";"RIACHAO DO POCO";4;0;5;9
2005;"RIACHO DE SANTO ANTONIO (PB)";"PB";"RIACHO DE SANTO ANTONIO";4;3;1;8
2005;"RIACHO DOS CAVALOS (PB)";"PB";"RIACHO DOS CAVALOS";5;1;2;8
2005;"RIO TINTO (PB)";"PB";"RIO TINTO";46;2;13;61
2005;"SALGADINHO (PB)";"PB";"SALGADINHO";5;0;0;5
2005;"SALGADO DE SAO FELIX (PB)";"PB";"SALGADO DE SAO FELIX";11;2;2;15
2005;"SANTA CECILIA (PB)";"PB";"SANTA CECILIA";1;0;3;4
2005;"SANTA CRUZ (PB)";"PB";"SANTA CRUZ";6;3;5;14
2005;"SANTA HELENA (PB)";"PB";"SANTA HELENA";5;0;4;9
2005;"SANTA INES (PB)";"PB";"SANTA INES";15;0;0;15
2005;"SANTA LUZIA (PB)";"PB";"SANTA LUZIA";174;14;11;199
2005;"SANTA RITA (PB)";"PB";"SANTA RITA";430;29;148;607
2005;"SANTA TERESINHA (PB)";"PB";"SANTA TERESINHA";13;0;4;17
2005;"SANTANA DE MANGUEIRA (PB)";"PB";"SANTANA DE MANGUEIRA";2;0;0;2
2005;"SANTANA DOS GARROTES (PB)";"PB";"SANTANA DOS GARROTES";12;1;0;13
2005;"SANTAREM (PB)";"PB";"SANTAREM";3;0;0;3
2005;"SANTO ANDRE (PB)";"PB";"SANTO ANDRE";9;0;0;9
2005;"SAO BENTO (PB)";"PB";"SAO BENTO";178;11;10;199
2005;"SAO BENTO DE POMBAL (PB)";"PB";"SAO BENTO DE POMBAL";6;2;2;10
2005;"SAO DOMINGOS DE POMBAL (PB)";"PB";"SAO DOMINGOS DE POMBAL";1;0;2;3
2005;"SAO DOMINGOS DO CARIRI (PB)";"PB";"SAO DOMINGOS DO CARIRI";3;0;2;5
2005;"SAO FRANCISCO (PB)";"PB";"SAO FRANCISCO";10;0;0;10
2005;"SAO JOAO DO CARIRI (PB)";"PB";"SAO JOAO DO CARIRI";3;2;3;8
2005;"SAO JOAO DO RIO DO PEIXE (PB)";"PB";"SAO JOAO DO RIO DO PEIXE";21;1;5;27
2005;"SAO JOAO DO TIGRE (PB)";"PB";"SAO JOAO DO TIGRE";7;0;1;8
2005;"SAO JOSE DA LAGOA TAPADA (PB)";"PB";"SAO JOSE DA LAGOA TAPADA";4;0;0;4
2005;"SAO JOSE DE CAIANA (PB)";"PB";"SAO JOSE DE CAIANA";3;2;1;6
2005;"SAO JOSE DE ESPINHARAS (PB)";"PB";"SAO JOSE DE ESPINHARAS";10;0;1;11
2005;"SAO JOSE DE PIRANHAS (PB)";"PB";"SAO JOSE DE PIRANHAS";27;4;1;32
2005;"SAO JOSE DE PRINCESA (PB)";"PB";"SAO JOSE DE PRINCESA";5;0;0;5
2005;"SAO JOSE DO BONFIM (PB)";"PB";"SAO JOSE DO BONFIM";6;0;1;7
2005;"SAO JOSE DO BREJO DO CRUZ (PB)";"PB";"SAO JOSE DO BREJO DO CRUZ";0;1;0;1
2005;"SAO JOSE DO SABUGI (PB)";"PB";"SAO JOSE DO SABUGI";16;2;1;19
2005;"SAO JOSE DOS CORDEIROS (PB)";"PB";"SAO JOSE DOS CORDEIROS";2;1;0;3
2005;"SAO JOSE DOS RAMOS (PB)";"PB";"SAO JOSE DOS RAMOS";16;2;3;21
2005;"SAO MAMEDE (PB)";"PB";"SAO MAMEDE";13;1;1;15
2005;"SAO MIGUEL DE TAIPU (PB)";"PB";"SAO MIGUEL DE TAIPU";11;0;2;13
2005;"SAO SEBASTIAO DE LAGOA DE ROCA (PB)";"PB";"SAO SEBASTIAO DE LAGOA DE ROCA";16;1;4;21
2005;"SAO SEBASTIAO DO UMBUZEIRO (PB)";"PB";"SAO SEBASTIAO DO UMBUZEIRO";6;0;2;8
2005;"SAPE (PB)";"PB";"SAPE";310;9;52;371
2005;"SERIDO (PB)";"PB";"SERIDO";17;2;2;21
2005;"SERRA BRANCA (PB)";"PB";"SERRA BRANCA";49;7;4;60
2005;"SERRA DA RAIZ (PB)";"PB";"SERRA DA RAIZ";3;0;3;6
2005;"SERRA GRANDE (PB)";"PB";"SERRA GRANDE";2;0;0;2
2005;"SERRA REDONDA (PB)";"PB";"SERRA REDONDA";15;0;1;16
2005;"SERRARIA (PB)";"PB";"SERRARIA";11;3;2;16
2005;"SERTAOZINHO (PB)";"PB";"SERTAOZINHO";4;0;2;6
2005;"SOBRADO (PB)";"PB";"SOBRADO";13;1;2;16
2005;"SOLANEA (PB)";"PB";"SOLANEA";128;11;22;161
2005;"SOLEDADE (PB)";"PB";"SOLEDADE";73;6;7;86
2005;"SOSSEGO (PB)";"PB";"SOSSEGO";8;1;2;11
2005;"SOUSA (PB)";"PB";"SOUSA";492;15;39;546
2005;"SUME (PB)";"PB";"SUME";51;9;14;74
2005;"TACIMA (PB)";"PB";"TACIMA";18;2;12;32
2005;"TAPEROA (PB)";"PB";"TAPEROA";39;4;2;45
2005;"TAVARES (PB)";"PB";"TAVARES";22;5;2;29
2005;"TEIXEIRA (PB)";"PB";"TEIXEIRA";83;4;11;98
2005;"TENORIO (PB)";"PB";"TENORIO";6;1;0;7
2005;"TRIUNFO (PB)";"PB";"TRIUNFO";3;1;1;5
2005;"UIRAUNA (PB)";"PB";"UIRAUNA";47;3;4;54
2005;"UMBUZEIRO (PB)";"PB";"UMBUZEIRO";35;10;13;58
2005;"VARZEA (PB)";"PB";"VARZEA";3;3;1;7
2005;"VIEIROPOLIS (PB)";"PB";"VIEIROPOLIS";6;0;2;8
2005;"VISTA SERRANA (PB)";"PB";"VISTA SERRANA";7;0;3;10
2005;"ZABELE (PB)";"PB";"ZABELE";2;0;0;2
2005;"ABREU E LIMA (PE)";"PE";"ABREU E LIMA";363;41;234;638
2005;"AFOGADOS DA INGAZEIRA (PE)";"PE";"AFOGADOS DA INGAZEIRA";211;21;18;250
2005;"AFRANIO (PE)";"PE";"AFRANIO";44;6;4;54
2005;"AGRESTINA (PE)";"PE";"AGRESTINA";92;4;10;106
2005;"AGUA PRETA (PE)";"PE";"AGUA PRETA";104;30;21;155
2005;"AGUAS BELAS (PE)";"PE";"AGUAS BELAS";178;38;27;243
2005;"ALAGOINHA (PE)";"PE";"ALAGOINHA";57;9;7;73
2005;"ALIANCA (PE)";"PE";"ALIANCA";73;1;49;123
2005;"ALTINHO (PE)";"PE";"ALTINHO";39;5;14;58
2005;"AMARAJI (PE)";"PE";"AMARAJI";47;7;12;66
2005;"ANGELIM (PE)";"PE";"ANGELIM";20;4;2;26
2005;"ARACOIABA (PE)";"PE";"ARACOIABA";42;8;47;97
2005;"ARARIPINA (PE)";"PE";"ARARIPINA";703;19;39;761
2005;"ARCOVERDE (PE)";"PE";"ARCOVERDE";773;56;69;898
2005;"BARRA DE GUABIRABA (PE)";"PE";"BARRA DE GUABIRABA";45;9;7;61
2005;"BARREIROS (PE)";"PE";"BARREIROS";217;5;21;243
2005;"BELEM DE MARIA (PE)";"PE";"BELEM DE MARIA";61;8;4;73
2005;"BELEM DE SAO FRANCISCO (PE)";"PE";"BELEM DE SAO FRANCISCO";66;7;6;79
2005;"BELO JARDIM (PE)";"PE";"BELO JARDIM";433;26;41;500
2005;"BETANIA (PE)";"PE";"BETANIA";21;3;2;26
2005;"BEZERROS (PE)";"PE";"BEZERROS";468;31;47;546
2005;"BODOCO (PE)";"PE";"BODOCO";106;3;7;116
2005;"BOM CONSELHO (PE)";"PE";"BOM CONSELHO";271;27;18;316
2005;"BOM JARDIM (PE)";"PE";"BOM JARDIM";89;4;16;109
2005;"BONITO (PE)";"PE";"BONITO";182;10;17;209
2005;"BREJAO (PE)";"PE";"BREJAO";27;1;6;34
2005;"BREJINHO (PE)";"PE";"BREJINHO";10;2;3;15
2005;"BREJO DA MADRE DE DEUS (PE)";"PE";"BREJO DA MADRE DE DEUS";118;3;6;127
2005;"BUENOS AIRES (PE)";"PE";"BUENOS AIRES";41;2;6;49
2005;"BUIQUE (PE)";"PE";"BUIQUE";167;13;17;197
2005;"CABO DE SANTO AGOSTINHO (PE)";"PE";"CABO DE SANTO AGOSTINHO";717;89;240;1046
2005;"CABROBO (PE)";"PE";"CABROBO";176;7;5;188
2005;"CACHOEIRINHA (PE)";"PE";"CACHOEIRINHA";83;5;6;94
2005;"CAETES (PE)";"PE";"CAETES";177;14;7;198
2005;"CALCADO (PE)";"PE";"CALCADO";26;2;12;40
2005;"CALUMBI (PE)";"PE";"CALUMBI";41;2;1;44
2005;"CAMARAGIBE (PE)";"PE";"CAMARAGIBE";494;120;119;733
2005;"CAMOCIM DE SAO FELIX (PE)";"PE";"CAMOCIM DE SAO FELIX";106;10;5;121
2005;"CAMUTANGA (PE)";"PE";"CAMUTANGA";62;0;10;72
2005;"CANHOTINHO (PE)";"PE";"CANHOTINHO";140;8;8;156
2005;"CAPOEIRAS (PE)";"PE";"CAPOEIRAS";133;22;2;157
2005;"CARNAIBA (PE)";"PE";"CARNAIBA";33;10;3;46
2005;"CARNAUBEIRA DA PENHA (PE)";"PE";"CARNAUBEIRA DA PENHA";22;1;0;23
2005;"CARPINA (PE)";"PE";"CARPINA";640;67;67;774
2005;"CARUARU (PE)";"PE";"CARUARU";2894;236;377;3507
2005;"CASINHAS (PE)";"PE";"CASINHAS";13;1;6;20
2005;"CATENDE (PE)";"PE";"CATENDE";145;9;22;176
2005;"CEDRO (PE)";"PE";"CEDRO";25;3;7;35
2005;"CHA DE ALEGRIA (PE)";"PE";"CHA DE ALEGRIA";25;7;9;41
2005;"CHA GRANDE (PE)";"PE";"CHA GRANDE";141;15;13;169
2005;"CONDADO (PE)";"PE";"CONDADO";116;3;51;170
2005;"CORRENTES (PE)";"PE";"CORRENTES";52;19;3;74
2005;"CORTES (PE)";"PE";"CORTES";61;6;16;83
2005;"CUMARU (PE)";"PE";"CUMARU";64;0;3;67
2005;"CUPIRA (PE)";"PE";"CUPIRA";184;15;11;210
2005;"CUSTODIA (PE)";"PE";"CUSTODIA";197;16;13;226
2005;"DORMENTES (PE)";"PE";"DORMENTES";43;3;2;48
2005;"ESCADA (PE)";"PE";"ESCADA";254;30;78;362
2005;"EXU (PE)";"PE";"EXU";219;4;18;241
2005;"FEIRA NOVA (PE)";"PE";"FEIRA NOVA";114;5;6;125
2005;"FERNANDO DE NORONHA (PE)";"PE";"FERNANDO DE NORONHA";10;15;7;32
2005;"FERREIROS (PE)";"PE";"FERREIROS";36;1;20;57
2005;"FLORES (PE)";"PE";"FLORES";28;3;3;34
2005;"FLORESTA (PE)";"PE";"FLORESTA";242;2;2;246
2005;"FREI MIGUELINHO (PE)";"PE";"FREI MIGUELINHO";87;1;12;100
2005;"GAMELEIRA (PE)";"PE";"GAMELEIRA";45;7;21;73
2005;"GARANHUNS (PE)";"PE";"GARANHUNS";1411;78;75;1564
2005;"GLORIA DO GOITA (PE)";"PE";"GLORIA DO GOITA";105;19;14;138
2005;"GOIANA (PE)";"PE";"GOIANA";657;33;87;777
2005;"GRANITO (PE)";"PE";"GRANITO";11;0;1;12
2005;"GRAVATA (PE)";"PE";"GRAVATA";599;40;34;673
2005;"IATI (PE)";"PE";"IATI";25;8;11;44
2005;"IBIMIRIM (PE)";"PE";"IBIMIRIM";103;14;5;122
2005;"IBIRAJUBA (PE)";"PE";"IBIRAJUBA";27;0;2;29
2005;"IGARASSU (PE)";"PE";"IGARASSU";571;32;247;850
2005;"IGUARACI (PE)";"PE";"IGUARACI";56;4;12;72
2005;"INAJA (PE)";"PE";"INAJA";29;2;3;34
2005;"INGAZEIRA (PE)";"PE";"INGAZEIRA";8;0;1;9
2005;"IPOJUCA (PE)";"PE";"IPOJUCA";324;109;86;519
2005;"IPUBI (PE)";"PE";"IPUBI";103;5;15;123
2005;"ITACURUBA (PE)";"PE";"ITACURUBA";11;1;2;14
2005;"ITAIBA (PE)";"PE";"ITAIBA";59;10;4;73
2005;"ITAMARACA (PE)";"PE";"ITAMARACA";44;12;7;63
2005;"ITAMBE (PE)";"PE";"ITAMBE";280;9;55;344
2005;"ITAPETIM (PE)";"PE";"ITAPETIM";30;2;2;34
2005;"ITAPISSUMA (PE)";"PE";"ITAPISSUMA";42;56;6;104
2005;"ITAQUITINGA (PE)";"PE";"ITAQUITINGA";19;2;20;41
2005;"JABOATAO DOS GUARARAPES (PE)";"PE";"JABOATAO DOS GUARARAPES";3288;692;1397;5377
2005;"JAQUEIRA (PE)";"PE";"JAQUEIRA";34;1;6;41
2005;"JATAUBA (PE)";"PE";"JATAUBA";33;4;4;41
2005;"JATOBA (PE)";"PE";"JATOBA";12;1;3;16
2005;"JOAO ALFREDO (PE)";"PE";"JOAO ALFREDO";114;2;5;121
2005;"JOAQUIM NABUCO (PE)";"PE";"JOAQUIM NABUCO";91;10;19;120
2005;"JUCATI (PE)";"PE";"JUCATI";69;2;7;78
2005;"JUPI (PE)";"PE";"JUPI";108;4;5;117
2005;"JUREMA (PE)";"PE";"JUREMA";57;3;2;62
2005;"LAGOA DO CARRO (PE)";"PE";"LAGOA DO CARRO";48;8;6;62
2005;"LAGOA DO ITAENGA (PE)";"PE";"LAGOA DO ITAENGA";176;8;32;216
2005;"LAGOA DO OURO (PE)";"PE";"LAGOA DO OURO";30;9;3;42
2005;"LAGOA DOS GATOS (PE)";"PE";"LAGOA DOS GATOS";76;6;3;85
2005;"LAGOA GRANDE (PE)";"PE";"LAGOA GRANDE";48;5;12;65
2005;"LAJEDO (PE)";"PE";"LAJEDO";358;27;26;411
2005;"LIMOEIRO (PE)";"PE";"LIMOEIRO";320;24;34;378
2005;"MACAPARANA (PE)";"PE";"MACAPARANA";112;11;24;147
2005;"MACHADOS (PE)";"PE";"MACHADOS";72;0;5;77
2005;"MANARI (PE)";"PE";"MANARI";13;3;3;19
2005;"MARAIAL (PE)";"PE";"MARAIAL";100;1;11;112
2005;"MIRANDIBA (PE)";"PE";"MIRANDIBA";69;3;0;72
2005;"MOREILANDIA (PE)";"PE";"MOREILANDIA";16;0;4;20
2005;"MORENO (PE)";"PE";"MORENO";337;36;45;418
2005;"NAZARE DA MATA (PE)";"PE";"NAZARE DA MATA";159;10;25;194
2005;"OLINDA (PE)";"PE";"OLINDA";1996;266;870;3132
2005;"OROBO (PE)";"PE";"OROBO";58;5;9;72
2005;"OROCO (PE)";"PE";"OROCO";38;1;2;41
2005;"OURICURI (PE)";"PE";"OURICURI";401;13;52;466
2005;"PALMARES (PE)";"PE";"PALMARES";486;40;121;647
2005;"PALMEIRINA (PE)";"PE";"PALMEIRINA";9;5;1;15
2005;"PANELAS (PE)";"PE";"PANELAS";62;6;7;75
2005;"PARANATAMA (PE)";"PE";"PARANATAMA";29;5;9;43
2005;"PARNAMIRIM (PE)";"PE";"PARNAMIRIM";91;0;6;97
2005;"PASSIRA (PE)";"PE";"PASSIRA";114;11;16;141
2005;"PAUDALHO (PE)";"PE";"PAUDALHO";293;12;23;328
2005;"PAULISTA (PE)";"PE";"PAULISTA";911;138;175;1224
2005;"PEDRA (PE)";"PE";"PEDRA";80;9;6;95
2005;"PESQUEIRA (PE)";"PE";"PESQUEIRA";385;24;62;471
2005;"PETROLANDIA (PE)";"PE";"PETROLANDIA";185;2;11;198
2005;"PETROLINA (PE)";"PE";"PETROLINA";1886;178;247;2311
2005;"POCAO (PE)";"PE";"POCAO";40;4;2;46
2005;"POMBOS (PE)";"PE";"POMBOS";192;6;12;210
2005;"PRIMAVERA (PE)";"PE";"PRIMAVERA";50;3;22;75
2005;"QUIPAPA (PE)";"PE";"QUIPAPA";46;7;15;68
2005;"QUIXABA (PE)";"PE";"QUIXABA";10;2;2;14
2005;"RECIFE (PE)";"PE";"RECIFE";11585;1284;2470;15339
2005;"RIACHO DAS ALMAS (PE)";"PE";"RIACHO DAS ALMAS";148;3;21;172
2005;"RIBEIRAO (PE)";"PE";"RIBEIRAO";199;28;48;275
2005;"RIO FORMOSO (PE)";"PE";"RIO FORMOSO";98;6;35;139
2005;"SAIRE (PE)";"PE";"SAIRE";57;5;18;80
2005;"SALGADINHO (PE)";"PE";"SALGADINHO";8;1;1;10
2005;"SALGUEIRO (PE)";"PE";"SALGUEIRO";386;23;28;437
2005;"SALOA (PE)";"PE";"SALOA";41;10;2;53
2005;"SANHARO (PE)";"PE";"SANHARO";62;3;11;76
2005;"SANTA CRUZ (PE)";"PE";"SANTA CRUZ";62;2;5;69
2005;"SANTA CRUZ DA BAIXA VERDE (PE)";"PE";"SANTA CRUZ DA BAIXA VERDE";136;0;1;137
2005;"SANTA CRUZ DO CAPIBARIBE (PE)";"PE";"SANTA CRUZ DO CAPIBARIBE";450;30;29;509
2005;"SANTA FILOMENA (PE)";"PE";"SANTA FILOMENA";22;0;11;33
2005;"SANTA MARIA DA BOA VISTA (PE)";"PE";"SANTA MARIA DA BOA VISTA";112;4;25;141
2005;"SANTA MARIA DO CAMBUCA (PE)";"PE";"SANTA MARIA DO CAMBUCA";96;1;9;106
2005;"SANTA TEREZINHA (PE)";"PE";"SANTA TEREZINHA";19;3;3;25
2005;"SAO BENEDITO DO SUL (PE)";"PE";"SAO BENEDITO DO SUL";18;2;5;25
2005;"SAO BENTO DO UNA (PE)";"PE";"SAO BENTO DO UNA";441;16;50;507
2005;"SAO CAITANO (PE)";"PE";"SAO CAITANO";182;8;27;217
2005;"SAO JOAO (PE)";"PE";"SAO JOAO";66;12;8;86
2005;"SAO JOAQUIM DO MONTE (PE)";"PE";"SAO JOAQUIM DO MONTE";44;4;12;60
2005;"SAO JOSE DA COROA GRANDE (PE)";"PE";"SAO JOSE DA COROA GRANDE";48;3;5;56
2005;"SAO JOSE DO BELMONTE (PE)";"PE";"SAO JOSE DO BELMONTE";194;5;18;217
2005;"SAO JOSE DO EGITO (PE)";"PE";"SAO JOSE DO EGITO";329;15;28;372
2005;"SAO LOURENCO DA MATA (PE)";"PE";"SAO LOURENCO DA MATA";229;22;218;469
2005;"SAO VICENTE FERRER (PE)";"PE";"SAO VICENTE FERRER";76;4;8;88
2005;"SERRA TALHADA (PE)";"PE";"SERRA TALHADA";1012;25;27;1064
2005;"SERRITA (PE)";"PE";"SERRITA";48;3;5;56
2005;"SERTANIA (PE)";"PE";"SERTANIA";280;15;22;317
2005;"SIRINHAEM (PE)";"PE";"SIRINHAEM";145;7;21;173
2005;"SOLIDAO (PE)";"PE";"SOLIDAO";12;0;1;13
2005;"SURUBIM (PE)";"PE";"SURUBIM";446;14;35;495
2005;"TABIRA (PE)";"PE";"TABIRA";101;6;9;116
2005;"TACAIMBO (PE)";"PE";"TACAIMBO";52;2;9;63
2005;"TACARATU (PE)";"PE";"TACARATU";24;6;3;33
2005;"TAMANDARE (PE)";"PE";"TAMANDARE";41;8;10;59
2005;"TAQUARITINGA DO NORTE (PE)";"PE";"TAQUARITINGA DO NORTE";93;11;5;109
2005;"TEREZINHA (PE)";"PE";"TEREZINHA";14;1;4;19
2005;"TERRA NOVA (PE)";"PE";"TERRA NOVA";74;0;4;78
2005;"TIMBAUBA (PE)";"PE";"TIMBAUBA";560;20;48;628
2005;"TORITAMA (PE)";"PE";"TORITAMA";147;7;9;163
2005;"TRACUNHAEM (PE)";"PE";"TRACUNHAEM";24;7;15;46
2005;"TRINDADE (PE)";"PE";"TRINDADE";194;7;7;208
2005;"TRIUNFO (PE)";"PE";"TRIUNFO";142;6;4;152
2005;"TUPANATINGA (PE)";"PE";"TUPANATINGA";85;5;2;92
2005;"TUPARETAMA (PE)";"PE";"TUPARETAMA";62;7;12;81
2005;"VENTUROSA (PE)";"PE";"VENTUROSA";84;13;7;104
2005;"VERDEJANTE (PE)";"PE";"VERDEJANTE";42;1;7;50
2005;"VERTENTE DO LERIO (PE)";"PE";"VERTENTE DO LERIO";39;0;4;43
2005;"VERTENTES (PE)";"PE";"VERTENTES";84;5;15;104
2005;"VICENCIA (PE)";"PE";"VICENCIA";213;7;43;263
2005;"VITORIA DE SANTO ANTAO (PE)";"PE";"VITORIA DE SANTO ANTAO";1681;52;203;1936
2005;"XEXEU (PE)";"PE";"XEXEU";29;5;10;44
2005;"ACAUA (PI)";"PI";"ACAUA";6;1;0;7
2005;"AGRICOLANDIA (PI)";"PI";"AGRICOLANDIA";9;0;4;13
2005;"AGUA BRANCA (PI)";"PI";"AGUA BRANCA";39;3;3;45
2005;"ALAGOINHA DO PIAUI (PI)";"PI";"ALAGOINHA DO PIAUI";6;1;2;9
2005;"ALEGRETE DO PIAUI (PI)";"PI";"ALEGRETE DO PIAUI";3;2;1;6
2005;"ALTO LONGA (PI)";"PI";"ALTO LONGA";11;2;3;16
2005;"ALTOS (PI)";"PI";"ALTOS";103;0;9;112
2005;"ALVORADA DO GURGUEIA (PI)";"PI";"ALVORADA DO GURGUEIA";9;2;2;13
2005;"AMARANTE (PI)";"PI";"AMARANTE";27;3;2;32
2005;"ANGICAL DO PIAUI (PI)";"PI";"ANGICAL DO PIAUI";9;0;1;10
2005;"ANISIO DE ABREU (PI)";"PI";"ANISIO DE ABREU";0;4;1;5
2005;"ANTONIO ALMEIDA (PI)";"PI";"ANTONIO ALMEIDA";10;1;1;12
2005;"AROAZES (PI)";"PI";"AROAZES";4;1;3;8
2005;"AROEIRAS DO ITAIM (PI)";"PI";"AROEIRAS DO ITAIM";3;0;1;4
2005;"ARRAIAL (PI)";"PI";"ARRAIAL";1;0;1;2
2005;"ASSUNCAO DO PIAUI (PI)";"PI";"ASSUNCAO DO PIAUI";4;0;0;4
2005;"AVELINO LOPES (PI)";"PI";"AVELINO LOPES";7;3;1;11
2005;"BAIXA GRANDE DO RIBEIRO (PI)";"PI";"BAIXA GRANDE DO RIBEIRO";3;0;0;3
2005;"BARRA D ALCANTARA (PI)";"PI";"BARRA D ALCANTARA";5;0;0;5
2005;"BARRAS (PI)";"PI";"BARRAS";68;4;11;83
2005;"BARREIRAS DO PIAUI (PI)";"PI";"BARREIRAS DO PIAUI";2;0;0;2
2005;"BARRO DURO (PI)";"PI";"BARRO DURO";33;2;1;36
2005;"BATALHA (PI)";"PI";"BATALHA";29;2;7;38
2005;"BELA VISTA DO PIAUI (PI)";"PI";"BELA VISTA DO PIAUI";2;1;0;3
2005;"BELEM DO PIAUI (PI)";"PI";"BELEM DO PIAUI";2;0;0;2
2005;"BENEDITINOS (PI)";"PI";"BENEDITINOS";11;1;3;15
2005;"BERTOLINIA (PI)";"PI";"BERTOLINIA";6;2;0;8
2005;"BETANIA DO PIAUI (PI)";"PI";"BETANIA DO PIAUI";0;3;1;4
2005;"BOA HORA (PI)";"PI";"BOA HORA";2;0;1;3
2005;"BOCAINA (PI)";"PI";"BOCAINA";6;3;2;11
2005;"BOM JESUS (PI)";"PI";"BOM JESUS";116;0;8;124
2005;"BOM PRINCIPIO DO PIAUI (PI)";"PI";"BOM PRINCIPIO DO PIAUI";0;2;1;3
2005;"BONFIM DO PIAUI (PI)";"PI";"BONFIM DO PIAUI";4;1;1;6
2005;"BOQUEIRAO DO PIAUI (PI)";"PI";"BOQUEIRAO DO PIAUI";1;0;0;1
2005;"BRASILEIRA (PI)";"PI";"BRASILEIRA";4;1;1;6
2005;"BREJO DO PIAUI (PI)";"PI";"BREJO DO PIAUI";2;1;0;3
2005;"BURITI DOS LOPES (PI)";"PI";"BURITI DOS LOPES";13;0;5;18
2005;"BURITI DOS MONTES (PI)";"PI";"BURITI DOS MONTES";5;1;0;6
2005;"CABECEIRAS DO PIAUI (PI)";"PI";"CABECEIRAS DO PIAUI";2;0;1;3
2005;"CAJAZEIRAS DO PIAUI (PI)";"PI";"CAJAZEIRAS DO PIAUI";0;0;0;0
2005;"CAJUEIRO DA PRAIA (PI)";"PI";"CAJUEIRO DA PRAIA";4;0;2;6
2005;"CALDEIRAO GRANDE DO PIAUI (PI)";"PI";"CALDEIRAO GRANDE DO PIAUI";3;1;1;5
2005;"CAMPINAS DO PIAUI (PI)";"PI";"CAMPINAS DO PIAUI";0;0;1;1
2005;"CAMPO ALEGRE DO FIDALGO (PI)";"PI";"CAMPO ALEGRE DO FIDALGO";1;1;0;2
2005;"CAMPO GRANDE DO PIAUI (PI)";"PI";"CAMPO GRANDE DO PIAUI";6;0;0;6
2005;"CAMPO LARGO DO PIAUI (PI)";"PI";"CAMPO LARGO DO PIAUI";0;2;0;2
2005;"CAMPO MAIOR (PI)";"PI";"CAMPO MAIOR";252;12;28;292
2005;"CANAVIEIRA (PI)";"PI";"CANAVIEIRA";0;0;0;0
2005;"CANTO DO BURITI (PI)";"PI";"CANTO DO BURITI";43;2;3;48
2005;"CAPITAO DE CAMPOS (PI)";"PI";"CAPITAO DE CAMPOS";7;3;4;14
2005;"CAPITAO GERVASIO OLIVEIRA (PI)";"PI";"CAPITAO GERVASIO OLIVEIRA";1;0;2;3
2005;"CARACOL (PI)";"PI";"CARACOL";12;1;1;14
2005;"CARAUBAS DO PIAUI (PI)";"PI";"CARAUBAS DO PIAUI";4;1;0;5
2005;"CARIDADE DO PIAUI (PI)";"PI";"CARIDADE DO PIAUI";4;0;1;5
2005;"CASTELO DO PIAUI (PI)";"PI";"CASTELO DO PIAUI";21;0;3;24
2005;"CAXINGO (PI)";"PI";"CAXINGO";5;1;1;7
2005;"COCAL (PI)";"PI";"COCAL";27;2;3;32
2005;"COCAL DE TELHA (PI)";"PI";"COCAL DE TELHA";3;1;0;4
2005;"COCAL DOS ALVES (PI)";"PI";"COCAL DOS ALVES";0;1;0;1
2005;"COIVARAS (PI)";"PI";"COIVARAS";2;0;1;3
2005;"COLONIA DO GURGUEIA (PI)";"PI";"COLONIA DO GURGUEIA";1;3;0;4
2005;"COLONIA DO PIAUI (PI)";"PI";"COLONIA DO PIAUI";6;2;0;8
2005;"CONCEICAO DO CANINDE (PI)";"PI";"CONCEICAO DO CANINDE";1;1;0;2
2005;"CORONEL JOSE DIAS (PI)";"PI";"CORONEL JOSE DIAS";3;0;1;4
2005;"CORRENTE (PI)";"PI";"CORRENTE";45;3;0;48
2005;"CRISTALANDIA DO PIAUI (PI)";"PI";"CRISTALANDIA DO PIAUI";1;0;1;2
2005;"CRISTINO CASTRO (PI)";"PI";"CRISTINO CASTRO";27;1;3;31
2005;"CURIMATA (PI)";"PI";"CURIMATA";4;0;1;5
2005;"CURRAIS (PI)";"PI";"CURRAIS";2;2;0;4
2005;"CURRAL NOVO DO PIAUI (PI)";"PI";"CURRAL NOVO DO PIAUI";0;1;0;1
2005;"CURRALINHOS (PI)";"PI";"CURRALINHOS";1;0;0;1
2005;"DEMERVAL LOBAO (PI)";"PI";"DEMERVAL LOBAO";18;1;1;20
2005;"DIRCEU ARCOVERDE (PI)";"PI";"DIRCEU ARCOVERDE";4;0;0;4
2005;"DOM EXPEDITO LOPES (PI)";"PI";"DOM EXPEDITO LOPES";54;2;2;58
2005;"DOM INOCENCIO (PI)";"PI";"DOM INOCENCIO";6;1;2;9
2005;"DOMINGOS MOURAO (PI)";"PI";"DOMINGOS MOURAO";2;0;0;2
2005;"ELESBAO VELOSO (PI)";"PI";"ELESBAO VELOSO";28;1;3;32
2005;"ELISEU MARTINS (PI)";"PI";"ELISEU MARTINS";6;1;1;8
2005;"ESPERANTINA (PI)";"PI";"ESPERANTINA";95;12;14;121
2005;"FARTURA DO PIAUI (PI)";"PI";"FARTURA DO PIAUI";4;0;0;4
2005;"FLORES DO PIAUI (PI)";"PI";"FLORES DO PIAUI";2;0;0;2
2005;"FLORESTA DO PIAUI (PI)";"PI";"FLORESTA DO PIAUI";1;1;0;2
2005;"FLORIANO (PI)";"PI";"FLORIANO";871;47;23;941
2005;"FRANCINOPOLIS (PI)";"PI";"FRANCINOPOLIS";8;3;0;11
2005;"FRANCISCO AYRES (PI)";"PI";"FRANCISCO AYRES";2;2;1;5
2005;"FRANCISCO MACEDO (PI)";"PI";"FRANCISCO MACEDO";1;0;0;1
2005;"FRANCISCO SANTOS (PI)";"PI";"FRANCISCO SANTOS";35;4;1;40
2005;"FRONTEIRAS (PI)";"PI";"FRONTEIRAS";49;8;3;60
2005;"GEMINIANO (PI)";"PI";"GEMINIANO";8;2;4;14
2005;"GILBUES (PI)";"PI";"GILBUES";6;1;2;9
2005;"GUADALUPE (PI)";"PI";"GUADALUPE";31;6;2;39
2005;"GUARIBAS (PI)";"PI";"GUARIBAS";2;0;0;2
2005;"HUGO NAPOLEAO (PI)";"PI";"HUGO NAPOLEAO";3;0;0;3
2005;"ILHA GRANDE (PI)";"PI";"ILHA GRANDE";1;2;1;4
2005;"INHUMA (PI)";"PI";"INHUMA";53;5;4;62
2005;"IPIRANGA DO PIAUI (PI)";"PI";"IPIRANGA DO PIAUI";22;3;3;28
2005;"ISAIAS COELHO (PI)";"PI";"ISAIAS COELHO";2;0;2;4
2005;"ITAINOPOLIS (PI)";"PI";"ITAINOPOLIS";10;4;3;17
2005;"ITAUEIRA (PI)";"PI";"ITAUEIRA";17;2;0;19
2005;"JACOBINA DO PIAUI (PI)";"PI";"JACOBINA DO PIAUI";12;1;0;13
2005;"JAICOS (PI)";"PI";"JAICOS";49;5;2;56
2005;"JARDIM DO MULATO (PI)";"PI";"JARDIM DO MULATO";2;0;0;2
2005;"JATOBA DO PIAUI (PI)";"PI";"JATOBA DO PIAUI";13;0;0;13
2005;"JERUMENHA (PI)";"PI";"JERUMENHA";6;0;0;6
2005;"JOAO COSTA (PI)";"PI";"JOAO COSTA";1;0;0;1
2005;"JOAQUIM PIRES (PI)";"PI";"JOAQUIM PIRES";6;0;0;6
2005;"JOCA MARQUES (PI)";"PI";"JOCA MARQUES";1;0;1;2
2005;"JOSE DE FREITAS (PI)";"PI";"JOSE DE FREITAS";41;1;8;50
2005;"JUAZEIRO DO PIAUI (PI)";"PI";"JUAZEIRO DO PIAUI";1;0;0;1
2005;"JULIO BORGES (PI)";"PI";"JULIO BORGES";1;1;0;2
2005;"JUREMA (PI)";"PI";"JUREMA";1;0;1;2
2005;"LAGOA ALEGRE (PI)";"PI";"LAGOA ALEGRE";1;0;2;3
2005;"LAGOA DE SAO FRANCISCO (PI)";"PI";"LAGOA DE SAO FRANCISCO";1;0;0;1
2005;"LAGOA DO BARRO DO PIAUI (PI)";"PI";"LAGOA DO BARRO DO PIAUI";1;1;4;6
2005;"LAGOA DO PIAUI (PI)";"PI";"LAGOA DO PIAUI";5;0;0;5
2005;"LAGOA DO SITIO (PI)";"PI";"LAGOA DO SITIO";7;0;1;8
2005;"LAGOINHA DO PIAUI (PI)";"PI";"LAGOINHA DO PIAUI";3;2;2;7
2005;"LANDRI SALES (PI)";"PI";"LANDRI SALES";2;1;0;3
2005;"LUIS CORREIA (PI)";"PI";"LUIS CORREIA";16;3;5;24
2005;"LUZILANDIA (PI)";"PI";"LUZILANDIA";15;2;6;23
2005;"MADEIRO (PI)";"PI";"MADEIRO";3;1;1;5
2005;"MANOEL EMIDIO (PI)";"PI";"MANOEL EMIDIO";4;1;2;7
2005;"MARCOLANDIA (PI)";"PI";"MARCOLANDIA";49;8;2;59
2005;"MARCOS PARENTE (PI)";"PI";"MARCOS PARENTE";2;4;0;6
2005;"MASSAPE DO PIAUI (PI)";"PI";"MASSAPE DO PIAUI";2;1;0;3
2005;"MATIAS OLIMPIO (PI)";"PI";"MATIAS OLIMPIO";6;4;2;12
2005;"MIGUEL ALVES (PI)";"PI";"MIGUEL ALVES";10;2;3;15
2005;"MIGUEL LEAO (PI)";"PI";"MIGUEL LEAO";2;0;0;2
2005;"MILTON BRANDAO (PI)";"PI";"MILTON BRANDAO";0;0;0;0
2005;"MONSENHOR GIL (PI)";"PI";"MONSENHOR GIL";6;3;1;10
2005;"MONSENHOR HIPOLITO (PI)";"PI";"MONSENHOR HIPOLITO";6;8;1;15
2005;"MONTE ALEGRE DO PIAUI (PI)";"PI";"MONTE ALEGRE DO PIAUI";5;2;2;9
2005;"MORRO CABECA NO TEMPO (PI)";"PI";"MORRO CABECA NO TEMPO";0;0;0;0
2005;"MORRO DO CHAPEU DO PIAUI (PI)";"PI";"MORRO DO CHAPEU DO PIAUI";1;1;1;3
2005;"MURICI DOS PORTELAS (PI)";"PI";"MURICI DOS PORTELAS";1;0;1;2
2005;"NAZARE DO PIAUI (PI)";"PI";"NAZARE DO PIAUI";6;1;1;8
2005;"NOSSA SENHORA DE NAZARE (PI)";"PI";"NOSSA SENHORA DE NAZARE";0;0;1;1
2005;"NOSSA SENHORA DOS REMEDIOS (PI)";"PI";"NOSSA SENHORA DOS REMEDIOS";0;1;0;1
2005;"NOVA SANTA RITA (PI)";"PI";"NOVA SANTA RITA";0;2;0;2
2005;"NOVO ORIENTE DO PIAUI (PI)";"PI";"NOVO ORIENTE DO PIAUI";8;1;2;11
2005;"NOVO SANTO ANTONIO (PI)";"PI";"NOVO SANTO ANTONIO";3;0;0;3
2005;"OEIRAS (PI)";"PI";"OEIRAS";178;14;13;205
2005;"OLHO D AGUA DO PIAUI (PI)";"PI";"OLHO D AGUA DO PIAUI";2;1;1;4
2005;"PADRE MARCOS (PI)";"PI";"PADRE MARCOS";6;2;1;9
2005;"PAES LANDIM (PI)";"PI";"PAES LANDIM";2;1;0;3
2005;"PAJEU DO PIAUI (PI)";"PI";"PAJEU DO PIAUI";2;1;0;3
2005;"PALMEIRA DO PIAUI (PI)";"PI";"PALMEIRA DO PIAUI";11;1;0;12
2005;"PALMEIRAIS (PI)";"PI";"PALMEIRAIS";8;2;0;10
2005;"PAQUETA (PI)";"PI";"PAQUETA";7;2;2;11
2005;"PARNAGUA (PI)";"PI";"PARNAGUA";2;0;0;2
2005;"PARNAIBA (PI)";"PI";"PARNAIBA";677;75;136;888
2005;"PASSAGEM FRANCA DO PIAUI (PI)";"PI";"PASSAGEM FRANCA DO PIAUI";0;0;0;0
2005;"PATOS DO PIAUI (PI)";"PI";"PATOS DO PIAUI";8;1;2;11
2005;"PAU D ARCO DO PIAUI (PI)";"PI";"PAU D ARCO DO PIAUI";2;0;1;3
2005;"PAULISTANA (PI)";"PI";"PAULISTANA";60;10;5;75
2005;"PAVUSSU (PI)";"PI";"PAVUSSU";1;0;0;1
2005;"PEDRO II (PI)";"PI";"PEDRO II";43;5;3;51
2005;"PEDRO LAURENTINO (PI)";"PI";"PEDRO LAURENTINO";0;0;0;0
2005;"PICOS (PI)";"PI";"PICOS";1185;101;41;1327
2005;"PIMENTEIRAS (PI)";"PI";"PIMENTEIRAS";16;4;1;21
2005;"PIO IX (PI)";"PI";"PIO IX";20;2;3;25
2005;"PIRACURUCA (PI)";"PI";"PIRACURUCA";89;4;18;111
2005;"PIRIPIRI (PI)";"PI";"PIRIPIRI";203;10;45;258
2005;"PORTO (PI)";"PI";"PORTO";1;2;0;3
2005;"PORTO ALEGRE DO PIAUI (PI)";"PI";"PORTO ALEGRE DO PIAUI";4;3;0;7
2005;"PRATA DO PIAUI (PI)";"PI";"PRATA DO PIAUI";2;1;1;4
2005;"QUEIMADA NOVA (PI)";"PI";"QUEIMADA NOVA";7;1;2;10
2005;"REDENCAO DO GURGUEIA (PI)";"PI";"REDENCAO DO GURGUEIA";3;0;6;9
2005;"REGENERACAO (PI)";"PI";"REGENERACAO";36;4;2;42
2005;"RIACHO FRIO (PI)";"PI";"RIACHO FRIO";1;1;0;2
2005;"RIBEIRA DO PIAUI (PI)";"PI";"RIBEIRA DO PIAUI";1;0;1;2
2005;"RIBEIRO GONCALVES (PI)";"PI";"RIBEIRO GONCALVES";6;0;0;6
2005;"RIO GRANDE DO PIAUI (PI)";"PI";"RIO GRANDE DO PIAUI";4;1;2;7
2005;"SANTA CRUZ DO PIAUI (PI)";"PI";"SANTA CRUZ DO PIAUI";7;5;0;12
2005;"SANTA CRUZ DOS MILAGRES (PI)";"PI";"SANTA CRUZ DOS MILAGRES";1;0;0;1
2005;"SANTA FILOMENA (PI)";"PI";"SANTA FILOMENA";5;1;1;7
2005;"SANTA LUZ (PI)";"PI";"SANTA LUZ";5;0;1;6
2005;"SANTA ROSA DO PIAUI (PI)";"PI";"SANTA ROSA DO PIAUI";2;1;3;6
2005;"SANTANA DO PIAUI (PI)";"PI";"SANTANA DO PIAUI";15;2;5;22
2005;"SANTO ANTONIO DE LISBOA (PI)";"PI";"SANTO ANTONIO DE LISBOA";18;7;3;28
2005;"SANTO ANTONIO DOS MILAGRES (PI)";"PI";"SANTO ANTONIO DOS MILAGRES";1;3;0;4
2005;"SANTO INACIO DO PIAUI (PI)";"PI";"SANTO INACIO DO PIAUI";1;3;0;4
2005;"SAO BRAZ DO PIAUI (PI)";"PI";"SAO BRAZ DO PIAUI";1;0;0;1
2005;"SAO FELIX DO PIAUI (PI)";"PI";"SAO FELIX DO PIAUI";2;0;2;4
2005;"SAO FRANCISCO DE ASSIS DO PIAU (PI)";"PI";"SAO FRANCISCO DE ASSIS DO PIAU";1;0;2;3
2005;"SAO FRANCISCO DO PIAUI (PI)";"PI";"SAO FRANCISCO DO PIAUI";1;0;1;2
2005;"SAO GONCALO DO GURGUEIA (PI)";"PI";"SAO GONCALO DO GURGUEIA";1;2;0;3
2005;"SAO GONCALO DO PIAUI (PI)";"PI";"SAO GONCALO DO PIAUI";7;3;6;16
2005;"SAO JOAO DA CANABRAVA (PI)";"PI";"SAO JOAO DA CANABRAVA";7;2;2;11
2005;"SAO JOAO DA FRONTEIRA (PI)";"PI";"SAO JOAO DA FRONTEIRA";1;1;3;5
2005;"SAO JOAO DA SERRA (PI)";"PI";"SAO JOAO DA SERRA";0;0;0;0
2005;"SAO JOAO DA VARJOTA (PI)";"PI";"SAO JOAO DA VARJOTA";1;0;1;2
2005;"SAO JOAO DO ARRAIAL (PI)";"PI";"SAO JOAO DO ARRAIAL";2;1;0;3
2005;"SAO JOAO DO PIAUI (PI)";"PI";"SAO JOAO DO PIAUI";42;6;4;52
2005;"SAO JOSE DO DIVINO (PI)";"PI";"SAO JOSE DO DIVINO";3;1;0;4
2005;"SAO JOSE DO PEIXE (PI)";"PI";"SAO JOSE DO PEIXE";1;1;0;2
2005;"SAO JOSE DO PIAUI (PI)";"PI";"SAO JOSE DO PIAUI";12;3;1;16
2005;"SAO JULIAO (PI)";"PI";"SAO JULIAO";7;1;1;9
2005;"SAO LOURENCO DO PIAUI (PI)";"PI";"SAO LOURENCO DO PIAUI";0;0;1;1
2005;"SAO LUIS DO PIAUI (PI)";"PI";"SAO LUIS DO PIAUI";3;2;0;5
2005;"SAO MIGUEL DA BAIXA GRANDE (PI)";"PI";"SAO MIGUEL DA BAIXA GRANDE";1;0;0;1
2005;"SAO MIGUEL DO FIDALGO (PI)";"PI";"SAO MIGUEL DO FIDALGO";2;1;1;4
2005;"SAO MIGUEL DO TAPUIO (PI)";"PI";"SAO MIGUEL DO TAPUIO";5;0;3;8
2005;"SAO PEDRO DO PIAUI (PI)";"PI";"SAO PEDRO DO PIAUI";17;1;1;19
2005;"SAO RAIMUNDO NONATO (PI)";"PI";"SAO RAIMUNDO NONATO";146;5;14;165
2005;"SEBASTIAO BARROS (PI)";"PI";"SEBASTIAO BARROS";0;2;0;2
2005;"SEBASTIAO LEAL (PI)";"PI";"SEBASTIAO LEAL";4;1;0;5
2005;"SIGEFREDO PACHECO (PI)";"PI";"SIGEFREDO PACHECO";7;2;0;9
2005;"SIMOES (PI)";"PI";"SIMOES";32;4;1;37
2005;"SIMPLICIO MENDES (PI)";"PI";"SIMPLICIO MENDES";27;4;4;35
2005;"SOCORRO DO PIAUI (PI)";"PI";"SOCORRO DO PIAUI";0;0;0;0
2005;"SUSSUAPARA (PI)";"PI";"SUSSUAPARA";8;6;1;15
2005;"TAMBORIL DO PIAUI (PI)";"PI";"TAMBORIL DO PIAUI";1;0;0;1
2005;"TANQUE DO PIAUI (PI)";"PI";"TANQUE DO PIAUI";3;0;2;5
2005;"TERESINA (PI)";"PI";"TERESINA";6940;623;1762;9325
2005;"UNIAO (PI)";"PI";"UNIAO";56;15;8;79
2005;"URUCUI (PI)";"PI";"URUCUI";137;3;4;144
2005;"VALENCA DO PIAUI (PI)";"PI";"VALENCA DO PIAUI";68;13;7;88
2005;"VARZEA BRANCA (PI)";"PI";"VARZEA BRANCA";1;0;4;5
2005;"VARZEA GRANDE (PI)";"PI";"VARZEA GRANDE";4;2;1;7
2005;"VERA MENDES (PI)";"PI";"VERA MENDES";1;3;0;4
2005;"VILA NOVA DO PIAUI (PI)";"PI";"VILA NOVA DO PIAUI";2;0;1;3
2005;"WALL FERRAZ (PI)";"PI";"WALL FERRAZ";3;2;0;5
2005;"ABATIA (PR)";"PR";"ABATIA";104;2;22;128
2005;"ADRIANOPOLIS (PR)";"PR";"ADRIANOPOLIS";56;3;12;71
2005;"AGUDOS DO SUL (PR)";"PR";"AGUDOS DO SUL";236;5;12;253
2005;"ALMIRANTE TAMANDARE (PR)";"PR";"ALMIRANTE TAMANDARE";863;52;185;1100
2005;"ALTAMIRA DO PARANA (PR)";"PR";"ALTAMIRA DO PARANA";28;4;10;42
2005;"ALTO PARANA (PR)";"PR";"ALTO PARANA";190;6;47;243
2005;"ALTO PIQUIRI (PR)";"PR";"ALTO PIQUIRI";162;4;23;189
2005;"ALTONIA (PR)";"PR";"ALTONIA";327;9;32;368
2005;"ALVORADA DO SUL (PR)";"PR";"ALVORADA DO SUL";234;6;39;279
2005;"AMAPORA (PR)";"PR";"AMAPORA";61;3;28;92
2005;"AMPERE (PR)";"PR";"AMPERE";298;11;19;328
2005;"ANAHY (PR)";"PR";"ANAHY";46;2;6;54
2005;"ANDIRA (PR)";"PR";"ANDIRA";453;13;54;520
2005;"ANGULO (PR)";"PR";"ANGULO";56;1;5;62
2005;"ANTONINA (PR)";"PR";"ANTONINA";84;12;23;119
2005;"ANTONIO OLINTO (PR)";"PR";"ANTONIO OLINTO";102;3;17;122
2005;"APUCARANA (PR)";"PR";"APUCARANA";1982;148;207;2337
2005;"ARAPONGAS (PR)";"PR";"ARAPONGAS";2688;94;85;2867
2005;"ARAPOTI (PR)";"PR";"ARAPOTI";395;19;54;468
2005;"ARAPUA (PR)";"PR";"ARAPUA";72;2;13;87
2005;"ARARUNA (PR)";"PR";"ARARUNA";277;6;18;301
2005;"ARAUCARIA (PR)";"PR";"ARAUCARIA";2436;163;354;2953
2005;"ARIRANHA DO IVAI (PR)";"PR";"ARIRANHA DO IVAI";32;3;11;46
2005;"ASSAI (PR)";"PR";"ASSAI";432;8;28;468
2005;"ASSIS CHATEAUBRIAND (PR)";"PR";"ASSIS CHATEAUBRIAND";985;15;56;1056
2005;"ASTORGA (PR)";"PR";"ASTORGA";510;21;60;591
2005;"ATALAIA (PR)";"PR";"ATALAIA";83;8;13;104
2005;"BALSA NOVA (PR)";"PR";"BALSA NOVA";197;7;26;230
2005;"BANDEIRANTES (PR)";"PR";"BANDEIRANTES";777;20;79;876
2005;"BARBOSA FERRAZ (PR)";"PR";"BARBOSA FERRAZ";131;8;15;154
2005;"BARRA DO JACARE (PR)";"PR";"BARRA DO JACARE";40;3;6;49
2005;"BARRACAO (PR)";"PR";"BARRACAO";167;12;28;207
2005;"BELA VISTA DO CAROBA (PR)";"PR";"BELA VISTA DO CAROBA";39;2;9;50
2005;"BELA VISTA DO PARAISO (PR)";"PR";"BELA VISTA DO PARAISO";338;10;46;394
2005;"BITURUNA (PR)";"PR";"BITURUNA";319;9;62;390
2005;"BOA ESPERANCA (PR)";"PR";"BOA ESPERANCA";139;3;12;154
2005;"BOA ESPERANCA DO IGUACU (PR)";"PR";"BOA ESPERANCA DO IGUACU";45;3;7;55
2005;"BOA VENTURA DE SAO ROQUE (PR)";"PR";"BOA VENTURA DE SAO ROQUE";121;5;16;142
2005;"BOA VISTA DA APARECIDA (PR)";"PR";"BOA VISTA DA APARECIDA";118;5;18;141
2005;"BOCAIUVA DO SUL (PR)";"PR";"BOCAIUVA DO SUL";197;5;10;212
2005;"BOM JESUS DO SUL (PR)";"PR";"BOM JESUS DO SUL";26;4;3;33
2005;"BOM SUCESSO (PR)";"PR";"BOM SUCESSO";80;2;25;107
2005;"BOM SUCESSO DO SUL (PR)";"PR";"BOM SUCESSO DO SUL";74;10;5;89
2005;"BORRAZOPOLIS (PR)";"PR";"BORRAZOPOLIS";199;3;8;210
2005;"BRAGANEY (PR)";"PR";"BRAGANEY";116;2;9;127
2005;"BRASILANDIA DO SUL (PR)";"PR";"BRASILANDIA DO SUL";44;2;6;52
2005;"CAFEARA (PR)";"PR";"CAFEARA";28;0;9;37
2005;"CAFELANDIA (PR)";"PR";"CAFELANDIA";383;9;32;424
2005;"CAFEZAL DO SUL (PR)";"PR";"CAFEZAL DO SUL";100;2;31;133
2005;"CALIFORNIA (PR)";"PR";"CALIFORNIA";169;3;11;183
2005;"CAMBARA (PR)";"PR";"CAMBARA";993;19;59;1071
2005;"CAMBE (PR)";"PR";"CAMBE";1428;113;121;1662
2005;"CAMBIRA (PR)";"PR";"CAMBIRA";185;1;9;195
2005;"CAMPINA DA LAGOA (PR)";"PR";"CAMPINA DA LAGOA";296;12;38;346
2005;"CAMPINA DO SIMAO (PR)";"PR";"CAMPINA DO SIMAO";56;4;18;78
2005;"CAMPINA GRANDE DO SUL (PR)";"PR";"CAMPINA GRANDE DO SUL";511;28;43;582
2005;"CAMPO BONITO (PR)";"PR";"CAMPO BONITO";73;3;6;82
2005;"CAMPO DO TENENTE (PR)";"PR";"CAMPO DO TENENTE";89;4;26;119
2005;"CAMPO LARGO (PR)";"PR";"CAMPO LARGO";1800;137;309;2246
2005;"CAMPO MAGRO (PR)";"PR";"CAMPO MAGRO";253;18;21;292
2005;"CAMPO MOURAO (PR)";"PR";"CAMPO MOURAO";1713;36;400;2149
2005;"CANDIDO DE ABREU (PR)";"PR";"CANDIDO DE ABREU";176;5;30;211
2005;"CANDOI (PR)";"PR";"CANDOI";283;3;62;348
2005;"CANTAGALO (PR)";"PR";"CANTAGALO";192;5;29;226
2005;"CAPANEMA (PR)";"PR";"CAPANEMA";318;11;36;365
2005;"CAPITAO LEONIDAS MARQUES (PR)";"PR";"CAPITAO LEONIDAS MARQUES";346;12;22;380
2005;"CARAMBEI (PR)";"PR";"CARAMBEI";428;19;40;487
2005;"CARLOPOLIS (PR)";"PR";"CARLOPOLIS";234;14;25;273
2005;"CASCAVEL (PR)";"PR";"CASCAVEL";5837;217;620;6674
2005;"CASTRO (PR)";"PR";"CASTRO";1319;56;160;1535
2005;"CATANDUVAS (PR)";"PR";"CATANDUVAS";164;5;22;191
2005;"CENTENARIO DO SUL (PR)";"PR";"CENTENARIO DO SUL";103;9;38;150
2005;"CERRO AZUL (PR)";"PR";"CERRO AZUL";284;5;38;327
2005;"CEU AZUL (PR)";"PR";"CEU AZUL";282;9;37;328
2005;"CHOPINZINHO (PR)";"PR";"CHOPINZINHO";426;13;60;499
2005;"CIANORTE (PR)";"PR";"CIANORTE";1237;24;143;1404
2005;"CIDADE GAUCHA (PR)";"PR";"CIDADE GAUCHA";175;6;55;236
2005;"CLEVELANDIA (PR)";"PR";"CLEVELANDIA";430;20;30;480
2005;"COLOMBO (PR)";"PR";"COLOMBO";2815;122;359;3296
2005;"COLORADO (PR)";"PR";"COLORADO";521;24;61;606
2005;"CONGONHINHAS (PR)";"PR";"CONGONHINHAS";94;5;20;119
2005;"CONSELHEIRO MAIRINCK (PR)";"PR";"CONSELHEIRO MAIRINCK";29;2;8;39
2005;"CONTENDA (PR)";"PR";"CONTENDA";555;13;34;602
2005;"CORBELIA (PR)";"PR";"CORBELIA";584;13;26;623
2005;"CORNELIO PROCOPIO (PR)";"PR";"CORNELIO PROCOPIO";890;61;88;1039
2005;"CORONEL DOMINGOS SOARES (PR)";"PR";"CORONEL DOMINGOS SOARES";60;3;17;80
2005;"CORONEL VIVIDA (PR)";"PR";"CORONEL VIVIDA";561;16;73;650
2005;"CORUMBATAI DO SUL (PR)";"PR";"CORUMBATAI DO SUL";40;0;11;51
2005;"CRUZ MACHADO (PR)";"PR";"CRUZ MACHADO";327;9;35;371
2005;"CRUZEIRO DO IGUACU (PR)";"PR";"CRUZEIRO DO IGUACU";58;2;13;73
2005;"CRUZEIRO DO OESTE (PR)";"PR";"CRUZEIRO DO OESTE";345;6;56;407
2005;"CRUZEIRO DO SUL (PR)";"PR";"CRUZEIRO DO SUL";70;5;14;89
2005;"CRUZMALTINA (PR)";"PR";"CRUZMALTINA";50;0;5;55
2005;"CURITIBA (PR)";"PR";"CURITIBA";29844;2802;4988;37634
2005;"CURIUVA (PR)";"PR";"CURIUVA";167;10;48;225
2005;"DIAMANTE D OESTE (PR)";"PR";"DIAMANTE D OESTE";52;8;14;74
2005;"DIAMANTE DO NORTE (PR)";"PR";"DIAMANTE DO NORTE";69;1;14;84
2005;"DIAMANTE DO SUL (PR)";"PR";"DIAMANTE DO SUL";32;1;6;39
2005;"DOIS VIZINHOS (PR)";"PR";"DOIS VIZINHOS";669;29;67;765
2005;"DOURADINA (PR)";"PR";"DOURADINA";160;3;7;170
2005;"DOUTOR CAMARGO (PR)";"PR";"DOUTOR CAMARGO";130;2;31;163
2005;"DOUTOR ULYSSES (PR)";"PR";"DOUTOR ULYSSES";32;1;5;38
2005;"ENEAS MARQUES (PR)";"PR";"ENEAS MARQUES";122;4;15;141
2005;"ENGENHEIRO BELTRAO (PR)";"PR";"ENGENHEIRO BELTRAO";364;6;50;420
2005;"ENTRE RIOS DO OESTE (PR)";"PR";"ENTRE RIOS DO OESTE";106;2;6;114
2005;"ESPERANCA NOVA (PR)";"PR";"ESPERANCA NOVA";22;3;4;29
2005;"ESPIGAO ALTO DO IGUACU (PR)";"PR";"ESPIGAO ALTO DO IGUACU";44;2;2;48
2005;"FAROL (PR)";"PR";"FAROL";55;0;8;63
2005;"FAXINAL (PR)";"PR";"FAXINAL";290;3;22;315
2005;"FAZENDA RIO GRANDE (PR)";"PR";"FAZENDA RIO GRANDE";646;31;158;835
2005;"FENIX (PR)";"PR";"FENIX";93;0;9;102
2005;"FERNANDES PINHEIRO (PR)";"PR";"FERNANDES PINHEIRO";77;4;12;93
2005;"FIGUEIRA (PR)";"PR";"FIGUEIRA";93;5;21;119
2005;"FLOR DA SERRA DO SUL (PR)";"PR";"FLOR DA SERRA DO SUL";85;2;17;104
2005;"FLORAI (PR)";"PR";"FLORAI";126;3;19;148
2005;"FLORESTA (PR)";"PR";"FLORESTA";194;4;15;213
2005;"FLORESTOPOLIS (PR)";"PR";"FLORESTOPOLIS";150;2;56;208
2005;"FLORIDA (PR)";"PR";"FLORIDA";41;5;8;54
2005;"FORMOSA DO OESTE (PR)";"PR";"FORMOSA DO OESTE";152;13;10;175
2005;"FOZ DO IGUACU (PR)";"PR";"FOZ DO IGUACU";2661;773;782;4216
2005;"FOZ DO JORDAO (PR)";"PR";"FOZ DO JORDAO";52;1;10;63
2005;"FRANCISCO ALVES (PR)";"PR";"FRANCISCO ALVES";138;2;15;155
2005;"FRANCISCO BELTRAO (PR)";"PR";"FRANCISCO BELTRAO";1492;49;139;1680
2005;"GENERAL CARNEIRO (PR)";"PR";"GENERAL CARNEIRO";351;7;35;393
2005;"GODOY MOREIRA (PR)";"PR";"GODOY MOREIRA";37;1;7;45
2005;"GOIO ERE (PR)";"PR";"GOIO ERE";645;15;57;717
2005;"GOIOXIM (PR)";"PR";"GOIOXIM";67;4;15;86
2005;"GRANDES RIOS (PR)";"PR";"GRANDES RIOS";63;6;8;77
2005;"GUAIRA (PR)";"PR";"GUAIRA";1178;22;83;1283
2005;"GUAIRACA (PR)";"PR";"GUAIRACA";135;1;18;154
2005;"GUAMIRANGA (PR)";"PR";"GUAMIRANGA";119;4;8;131
2005;"GUAPIRAMA (PR)";"PR";"GUAPIRAMA";78;2;16;96
2005;"GUAPOREMA (PR)";"PR";"GUAPOREMA";37;0;5;42
2005;"GUARACI (PR)";"PR";"GUARACI";81;1;12;94
2005;"GUARANIACU (PR)";"PR";"GUARANIACU";304;10;48;362
2005;"GUARAPUAVA (PR)";"PR";"GUARAPUAVA";3583;189;296;4068
2005;"GUARAQUECABA (PR)";"PR";"GUARAQUECABA";15;0;3;18
2005;"GUARATUBA (PR)";"PR";"GUARATUBA";190;13;38;241
2005;"HONORIO SERPA (PR)";"PR";"HONORIO SERPA";94;2;19;115
2005;"IBAITI (PR)";"PR";"IBAITI";416;14;118;548
2005;"IBEMA (PR)";"PR";"IBEMA";121;3;10;134
2005;"IBIPORA (PR)";"PR";"IBIPORA";716;21;94;831
2005;"ICARAIMA (PR)";"PR";"ICARAIMA";97;0;27;124
2005;"IGUARACU (PR)";"PR";"IGUARACU";52;0;11;63
2005;"IGUATU (PR)";"PR";"IGUATU";36;0;7;43
2005;"IMBAU (PR)";"PR";"IMBAU";135;9;22;166
2005;"IMBITUVA (PR)";"PR";"IMBITUVA";637;13;39;689
2005;"INACIO MARTINS (PR)";"PR";"INACIO MARTINS";194;7;17;218
2005;"INAJA (PR)";"PR";"INAJA";25;0;15;40
2005;"INDIANOPOLIS (PR)";"PR";"INDIANOPOLIS";108;1;6;115
2005;"IPIRANGA (PR)";"PR";"IPIRANGA";288;9;29;326
2005;"IPORA (PR)";"PR";"IPORA";296;9;28;333
2005;"IRACEMA DO OESTE (PR)";"PR";"IRACEMA DO OESTE";60;5;3;68
2005;"IRATI (PR)";"PR";"IRATI";1201;48;108;1357
2005;"IRETAMA (PR)";"PR";"IRETAMA";121;3;18;142
2005;"ITAGUAJE (PR)";"PR";"ITAGUAJE";83;2;18;103
2005;"ITAIPULANDIA (PR)";"PR";"ITAIPULANDIA";143;12;22;177
2005;"ITAMBARACA (PR)";"PR";"ITAMBARACA";126;4;17;147
2005;"ITAMBE (PR)";"PR";"ITAMBE";156;2;17;175
2005;"ITAPEJARA D OESTE (PR)";"PR";"ITAPEJARA D OESTE";230;5;15;250
2005;"ITAPERUCU (PR)";"PR";"ITAPERUCU";372;28;37;437
2005;"ITAUNA DO SUL (PR)";"PR";"ITAUNA DO SUL";43;1;6;50
2005;"IVAI (PR)";"PR";"IVAI";226;5;20;251
2005;"IVAIPORA (PR)";"PR";"IVAIPORA";660;16;62;738
2005;"IVATE (PR)";"PR";"IVATE";119;1;37;157
2005;"IVATUBA (PR)";"PR";"IVATUBA";44;2;8;54
2005;"JABOTI (PR)";"PR";"JABOTI";54;2;5;61
2005;"JACAREZINHO (PR)";"PR";"JACAREZINHO";433;30;94;557
2005;"JAGUAPITA (PR)";"PR";"JAGUAPITA";241;13;35;289
2005;"JAGUARIAIVA (PR)";"PR";"JAGUARIAIVA";531;24;83;638
2005;"JANDAIA DO SUL (PR)";"PR";"JANDAIA DO SUL";445;17;82;544
2005;"JANIOPOLIS (PR)";"PR";"JANIOPOLIS";108;5;15;128
2005;"JAPIRA (PR)";"PR";"JAPIRA";36;1;3;40
2005;"JAPURA (PR)";"PR";"JAPURA";185;2;13;200
2005;"JARDIM ALEGRE (PR)";"PR";"JARDIM ALEGRE";171;9;14;194
2005;"JARDIM OLINDA (PR)";"PR";"JARDIM OLINDA";38;2;5;45
2005;"JATAIZINHO (PR)";"PR";"JATAIZINHO";278;17;18;313
2005;"JESUITAS (PR)";"PR";"JESUITAS";201;8;20;229
2005;"JOAQUIM TAVORA (PR)";"PR";"JOAQUIM TAVORA";180;7;12;199
2005;"JUNDIAI DO SUL (PR)";"PR";"JUNDIAI DO SUL";15;2;7;24
2005;"JURANDA (PR)";"PR";"JURANDA";282;5;6;293
2005;"JUSSARA (PR)";"PR";"JUSSARA";159;3;19;181
2005;"KALORE (PR)";"PR";"KALORE";128;5;13;146
2005;"LAPA (PR)";"PR";"LAPA";968;32;111;1111
2005;"LARANJAL (PR)";"PR";"LARANJAL";25;3;9;37
2005;"LARANJEIRAS DO SUL (PR)";"PR";"LARANJEIRAS DO SUL";535;14;62;611
2005;"LEOPOLIS (PR)";"PR";"LEOPOLIS";55;4;4;63
2005;"LIDIANOPOLIS (PR)";"PR";"LIDIANOPOLIS";57;5;10;72
2005;"LINDOESTE (PR)";"PR";"LINDOESTE";71;3;9;83
2005;"LOANDA (PR)";"PR";"LOANDA";338;10;38;386
2005;"LOBATO (PR)";"PR";"LOBATO";142;3;15;160
2005;"LONDRINA (PR)";"PR";"LONDRINA";7316;505;1521;9342
2005;"LUIZIANA (PR)";"PR";"LUIZIANA";125;1;11;137
2005;"LUNARDELLI (PR)";"PR";"LUNARDELLI";78;6;6;90
2005;"LUPIONOPOLIS (PR)";"PR";"LUPIONOPOLIS";71;1;23;95
2005;"MALLET (PR)";"PR";"MALLET";257;8;27;292
2005;"MAMBORE (PR)";"PR";"MAMBORE";476;4;24;504
2005;"MANDAGUACU (PR)";"PR";"MANDAGUACU";313;3;39;355
2005;"MANDAGUARI (PR)";"PR";"MANDAGUARI";580;17;50;647
2005;"MANDIRITUBA (PR)";"PR";"MANDIRITUBA";629;11;48;688
2005;"MANFRINOPOLIS (PR)";"PR";"MANFRINOPOLIS";20;3;12;35
2005;"MANGUEIRINHA (PR)";"PR";"MANGUEIRINHA";365;10;39;414
2005;"MANOEL RIBAS (PR)";"PR";"MANOEL RIBAS";253;7;19;279
2005;"MARECHAL CANDIDO RONDON (PR)";"PR";"MARECHAL CANDIDO RONDON";1151;46;111;1308
2005;"MARIA HELENA (PR)";"PR";"MARIA HELENA";71;2;13;86
2005;"MARIALVA (PR)";"PR";"MARIALVA";667;33;39;739
2005;"MARILANDIA DO SUL (PR)";"PR";"MARILANDIA DO SUL";186;5;8;199
2005;"MARILENA (PR)";"PR";"MARILENA";94;2;34;130
2005;"MARILUZ (PR)";"PR";"MARILUZ";163;4;37;204
2005;"MARINGA (PR)";"PR";"MARINGA";6705;295;672;7672
2005;"MARIOPOLIS (PR)";"PR";"MARIOPOLIS";164;5;13;182
2005;"MARIPA (PR)";"PR";"MARIPA";245;4;12;261
2005;"MARMELEIRO (PR)";"PR";"MARMELEIRO";236;7;36;279
2005;"MARQUINHO (PR)";"PR";"MARQUINHO";40;1;9;50
2005;"MARUMBI (PR)";"PR";"MARUMBI";64;3;12;79
2005;"MATELANDIA (PR)";"PR";"MATELANDIA";312;5;34;351
2005;"MATINHOS (PR)";"PR";"MATINHOS";184;18;22;224
2005;"MATO RICO (PR)";"PR";"MATO RICO";25;1;5;31
2005;"MAUA DA SERRA (PR)";"PR";"MAUA DA SERRA";167;1;17;185
2005;"MEDIANEIRA (PR)";"PR";"MEDIANEIRA";896;29;80;1005
2005;"MERCEDES (PR)";"PR";"MERCEDES";150;3;16;169
2005;"MIRADOR (PR)";"PR";"MIRADOR";13;1;6;20
2005;"MIRASELVA (PR)";"PR";"MIRASELVA";25;4;12;41
2005;"MISSAL (PR)";"PR";"MISSAL";266;10;29;305
2005;"MOREIRA SALES (PR)";"PR";"MOREIRA SALES";155;6;42;203
2005;"MORRETES (PR)";"PR";"MORRETES";120;5;20;145
2005;"MUNHOZ DE MELO (PR)";"PR";"MUNHOZ DE MELO";43;2;5;50
2005;"NOSSA SENHORA DAS GRACAS (PR)";"PR";"NOSSA SENHORA DAS GRACAS";16;4;16;36
2005;"NOVA ALIANCA DO IVAI (PR)";"PR";"NOVA ALIANCA DO IVAI";15;4;2;21
2005;"NOVA AMERICA DA COLINA (PR)";"PR";"NOVA AMERICA DA COLINA";75;2;11;88
2005;"NOVA AURORA (PR)";"PR";"NOVA AURORA";364;4;25;393
2005;"NOVA CANTU (PR)";"PR";"NOVA CANTU";97;0;19;116
2005;"NOVA ESPERANCA (PR)";"PR";"NOVA ESPERANCA";684;20;34;738
2005;"NOVA ESPERANCA DO SUDOESTE (PR)";"PR";"NOVA ESPERANCA DO SUDOESTE";45;5;10;60
2005;"NOVA FATIMA (PR)";"PR";"NOVA FATIMA";194;1;17;212
2005;"NOVA LARANJEIRAS (PR)";"PR";"NOVA LARANJEIRAS";118;3;20;141
2005;"NOVA LONDRINA (PR)";"PR";"NOVA LONDRINA";328;8;33;369
2005;"NOVA OLIMPIA (PR)";"PR";"NOVA OLIMPIA";78;5;13;96
2005;"NOVA PRATA DO IGUACU (PR)";"PR";"NOVA PRATA DO IGUACU";184;3;29;216
2005;"NOVA SANTA BARBARA (PR)";"PR";"NOVA SANTA BARBARA";93;3;4;100
2005;"NOVA SANTA ROSA (PR)";"PR";"NOVA SANTA ROSA";262;6;6;274
2005;"NOVA TEBAS (PR)";"PR";"NOVA TEBAS";72;1;10;83
2005;"NOVO ITACOLOMI (PR)";"PR";"NOVO ITACOLOMI";58;2;5;65
2005;"ORTIGUEIRA (PR)";"PR";"ORTIGUEIRA";181;7;42;230
2005;"OURIZONA (PR)";"PR";"OURIZONA";60;3;18;81
2005;"OURO VERDE DO OESTE (PR)";"PR";"OURO VERDE DO OESTE";107;1;10;118
2005;"PAICANDU (PR)";"PR";"PAICANDU";361;10;28;399
2005;"PALMAS (PR)";"PR";"PALMAS";734;33;51;818
2005;"PALMEIRA (PR)";"PR";"PALMEIRA";755;34;47;836
2005;"PALMITAL (PR)";"PR";"PALMITAL";179;10;34;223
2005;"PALOTINA (PR)";"PR";"PALOTINA";932;18;78;1028
2005;"PARAISO DO NORTE (PR)";"PR";"PARAISO DO NORTE";172;8;34;214
2005;"PARANACITY (PR)";"PR";"PARANACITY";143;9;32;184
2005;"PARANAGUA (PR)";"PR";"PARANAGUA";1362;89;98;1549
2005;"PARANAPOEMA (PR)";"PR";"PARANAPOEMA";34;1;11;46
2005;"PARANAVAI (PR)";"PR";"PARANAVAI";1523;37;134;1694
2005;"PATO BRAGADO (PR)";"PR";"PATO BRAGADO";103;3;8;114
2005;"PATO BRANCO (PR)";"PR";"PATO BRANCO";1466;81;279;1826
2005;"PAULA FREITAS (PR)";"PR";"PAULA FREITAS";123;2;13;138
2005;"PAULO FRONTIN (PR)";"PR";"PAULO FRONTIN";116;0;11;127
2005;"PEABIRU (PR)";"PR";"PEABIRU";248;8;9;265
2005;"PEROBAL (PR)";"PR";"PEROBAL";87;3;28;118
2005;"PEROLA (PR)";"PR";"PEROLA";170;4;12;186
2005;"PEROLA D OESTE (PR)";"PR";"PEROLA D OESTE";112;3;26;141
2005;"PIEN (PR)";"PR";"PIEN";264;17;15;296
2005;"PINHAIS (PR)";"PR";"PINHAIS";1454;84;207;1745
2005;"PINHAL DO SAO BENTO (PR)";"PR";"PINHAL DO SAO BENTO";31;0;7;38
2005;"PINHALAO (PR)";"PR";"PINHALAO";68;3;9;80
2005;"PINHAO (PR)";"PR";"PINHAO";334;2;63;399
2005;"PIRAI DO SUL (PR)";"PR";"PIRAI DO SUL";353;15;57;425
2005;"PIRAQUARA (PR)";"PR";"PIRAQUARA";305;39;92;436
2005;"PITANGA (PR)";"PR";"PITANGA";620;21;79;720
2005;"PITANGUEIRAS (PR)";"PR";"PITANGUEIRAS";51;6;15;72
2005;"PLANALTINA DO PARANA (PR)";"PR";"PLANALTINA DO PARANA";74;4;7;85
2005;"PLANALTO (PR)";"PR";"PLANALTO";269;10;22;301
2005;"PONTA GROSSA (PR)";"PR";"PONTA GROSSA";4796;334;837;5967
2005;"PONTAL DO PARANA (PR)";"PR";"PONTAL DO PARANA";116;10;22;148
2005;"PORECATU (PR)";"PR";"PORECATU";282;12;90;384
2005;"PORTO AMAZONAS (PR)";"PR";"PORTO AMAZONAS";45;4;10;59
2005;"PORTO BARREIRO (PR)";"PR";"PORTO BARREIRO";51;1;15;67
2005;"PORTO RICO (PR)";"PR";"PORTO RICO";13;1;6;20
2005;"PORTO VITORIA (PR)";"PR";"PORTO VITORIA";120;1;7;128
2005;"PRADO FERREIRA (PR)";"PR";"PRADO FERREIRA";60;3;8;71
2005;"PRANCHITA (PR)";"PR";"PRANCHITA";179;3;10;192
2005;"PRESIDENTE CASTELO BRANCO (PR)";"PR";"PRESIDENTE CASTELO BRANCO";72;2;16;90
2005;"PRIMEIRO DE MAIO (PR)";"PR";"PRIMEIRO DE MAIO";261;8;16;285
2005;"PRUDENTOPOLIS (PR)";"PR";"PRUDENTOPOLIS";862;13;89;964
2005;"QUARTO CENTENARIO (PR)";"PR";"QUARTO CENTENARIO";112;5;9;126
2005;"QUATIGUA (PR)";"PR";"QUATIGUA";289;6;10;305
2005;"QUATRO BARRAS (PR)";"PR";"QUATRO BARRAS";480;25;94;599
2005;"QUATRO PONTES (PR)";"PR";"QUATRO PONTES";146;5;5;156
2005;"QUEDAS DO IGUACU (PR)";"PR";"QUEDAS DO IGUACU";496;8;90;594
2005;"QUERENCIA DO NORTE (PR)";"PR";"QUERENCIA DO NORTE";143;4;19;166
2005;"QUINTA DO SOL (PR)";"PR";"QUINTA DO SOL";109;3;12;124
2005;"QUITANDINHA (PR)";"PR";"QUITANDINHA";359;5;42;406
2005;"RAMILANDIA (PR)";"PR";"RAMILANDIA";38;2;7;47
2005;"RANCHO ALEGRE (PR)";"PR";"RANCHO ALEGRE";101;1;9;111
2005;"RANCHO ALEGRE D OESTE (PR)";"PR";"RANCHO ALEGRE D OESTE";69;1;6;76
2005;"REALEZA (PR)";"PR";"REALEZA";424;10;26;460
2005;"REBOUCAS (PR)";"PR";"REBOUCAS";188;6;27;221
2005;"RENASCENCA (PR)";"PR";"RENASCENCA";174;6;18;198
2005;"RESERVA (PR)";"PR";"RESERVA";378;9;36;423
2005;"RESERVA DO IGUACU (PR)";"PR";"RESERVA DO IGUACU";72;4;14;90
2005;"RIBEIRAO CLARO (PR)";"PR";"RIBEIRAO CLARO";139;17;15;171
2005;"RIBEIRAO DO PINHAL (PR)";"PR";"RIBEIRAO DO PINHAL";185;31;13;229
2005;"RIO AZUL (PR)";"PR";"RIO AZUL";206;4;27;237
2005;"RIO BOM (PR)";"PR";"RIO BOM";56;5;3;64
2005;"RIO BONITO DO IGUACU (PR)";"PR";"RIO BONITO DO IGUACU";186;4;55;245
2005;"RIO BRANCO DO IVAI (PR)";"PR";"RIO BRANCO DO IVAI";35;1;7;43
2005;"RIO BRANCO DO SUL (PR)";"PR";"RIO BRANCO DO SUL";530;48;70;648
2005;"RIO NEGRO (PR)";"PR";"RIO NEGRO";709;45;45;799
2005;"ROLANDIA (PR)";"PR";"ROLANDIA";1341;43;84;1468
2005;"RONCADOR (PR)";"PR";"RONCADOR";220;4;25;249
2005;"RONDON (PR)";"PR";"RONDON";231;7;38;276
2005;"ROSARIO DO IVAI (PR)";"PR";"ROSARIO DO IVAI";45;6;20;71
2005;"SABAUDIA (PR)";"PR";"SABAUDIA";116;4;10;130
2005;"SALGADO FILHO (PR)";"PR";"SALGADO FILHO";74;3;10;87
2005;"SALTO DO ITARARE (PR)";"PR";"SALTO DO ITARARE";76;4;17;97
2005;"SALTO DO LONTRA (PR)";"PR";"SALTO DO LONTRA";187;7;33;227
2005;"SANTA AMELIA (PR)";"PR";"SANTA AMELIA";64;4;10;78
2005;"SANTA CECILIA DO PAVAO (PR)";"PR";"SANTA CECILIA DO PAVAO";65;6;8;79
2005;"SANTA CRUZ DO MONTE CASTELO (PR)";"PR";"SANTA CRUZ DO MONTE CASTELO";166;5;16;187
2005;"SANTA FE (PR)";"PR";"SANTA FE";155;9;22;186
2005;"SANTA HELENA (PR)";"PR";"SANTA HELENA";524;23;72;619
2005;"SANTA INES (PR)";"PR";"SANTA INES";10;3;6;19
2005;"SANTA ISABEL DO IVAI (PR)";"PR";"SANTA ISABEL DO IVAI";143;3;15;161
2005;"SANTA IZABEL DO OESTE (PR)";"PR";"SANTA IZABEL DO OESTE";190;14;20;224
2005;"SANTA LUCIA (PR)";"PR";"SANTA LUCIA";65;1;7;73
2005;"SANTA MARIA DO OESTE (PR)";"PR";"SANTA MARIA DO OESTE";121;4;17;142
2005;"SANTA MARIANA (PR)";"PR";"SANTA MARIANA";275;10;30;315
2005;"SANTA MONICA (PR)";"PR";"SANTA MONICA";33;2;6;41
2005;"SANTA TEREZA DO OESTE (PR)";"PR";"SANTA TEREZA DO OESTE";136;9;11;156
2005;"SANTA TEREZINHA DE ITAIPU (PR)";"PR";"SANTA TEREZINHA DE ITAIPU";327;22;29;378
2005;"SANTANA DO ITARARE (PR)";"PR";"SANTANA DO ITARARE";79;1;11;91
2005;"SANTO ANTONIO DA PLATINA (PR)";"PR";"SANTO ANTONIO DA PLATINA";512;22;224;758
2005;"SANTO ANTONIO DO CAIUA (PR)";"PR";"SANTO ANTONIO DO CAIUA";17;2;8;27
2005;"SANTO ANTONIO DO PARAISO (PR)";"PR";"SANTO ANTONIO DO PARAISO";59;2;6;67
2005;"SANTO ANTONIO DO SUDOESTE (PR)";"PR";"SANTO ANTONIO DO SUDOESTE";293;6;33;332
2005;"SANTO INACIO (PR)";"PR";"SANTO INACIO";71;1;12;84
2005;"SAO CARLOS DO IVAI (PR)";"PR";"SAO CARLOS DO IVAI";187;5;15;207
2005;"SAO JERONIMO DA SERRA (PR)";"PR";"SAO JERONIMO DA SERRA";95;4;17;116
2005;"SAO JOAO (PR)";"PR";"SAO JOAO";257;8;29;294
2005;"SAO JOAO DO CAIUA (PR)";"PR";"SAO JOAO DO CAIUA";42;4;13;59
2005;"SAO JOAO DO IVAI (PR)";"PR";"SAO JOAO DO IVAI";236;6;36;278
2005;"SAO JOAO DO TRIUNFO (PR)";"PR";"SAO JOAO DO TRIUNFO";154;6;27;187
2005;"SAO JORGE D OESTE (PR)";"PR";"SAO JORGE D OESTE";148;3;24;175
2005;"SAO JORGE DO IVAI (PR)";"PR";"SAO JORGE DO IVAI";235;6;10;251
2005;"SAO JORGE DO PATROCINIO (PR)";"PR";"SAO JORGE DO PATROCINIO";75;5;9;89
2005;"SAO JOSE DA BOA VISTA (PR)";"PR";"SAO JOSE DA BOA VISTA";87;4;13;104
2005;"SAO JOSE DAS PALMEIRAS (PR)";"PR";"SAO JOSE DAS PALMEIRAS";50;8;6;64
2005;"SAO JOSE DOS PINHAIS (PR)";"PR";"SAO JOSE DOS PINHAIS";4584;316;443;5343
2005;"SAO MANOEL DO PARANA (PR)";"PR";"SAO MANOEL DO PARANA";32;2;6;40
2005;"SAO MATEUS DO SUL (PR)";"PR";"SAO MATEUS DO SUL";690;26;77;793
2005;"SAO MIGUEL DO IGUACU (PR)";"PR";"SAO MIGUEL DO IGUACU";678;12;64;754
2005;"SAO PEDRO DO IGUACU (PR)";"PR";"SAO PEDRO DO IGUACU";129;7;12;148
2005;"SAO PEDRO DO IVAI (PR)";"PR";"SAO PEDRO DO IVAI";232;2;41;275
2005;"SAO PEDRO DO PARANA (PR)";"PR";"SAO PEDRO DO PARANA";23;1;6;30
2005;"SAO SEBASTIAO DA AMOREIRA (PR)";"PR";"SAO SEBASTIAO DA AMOREIRA";181;7;17;205
2005;"SAO TOME (PR)";"PR";"SAO TOME";84;2;18;104
2005;"SAPOPEMA (PR)";"PR";"SAPOPEMA";53;1;9;63
2005;"SARANDI (PR)";"PR";"SARANDI";674;17;78;769
2005;"SAUDADE DO IGUACU (PR)";"PR";"SAUDADE DO IGUACU";53;6;13;72
2005;"SENGES (PR)";"PR";"SENGES";424;18;43;485
2005;"SERRANOPOLIS DO IGUACU (PR)";"PR";"SERRANOPOLIS DO IGUACU";113;10;10;133
2005;"SERTANEJA (PR)";"PR";"SERTANEJA";183;6;16;205
2005;"SERTANOPOLIS (PR)";"PR";"SERTANOPOLIS";450;8;33;491
2005;"SIQUEIRA CAMPOS (PR)";"PR";"SIQUEIRA CAMPOS";282;7;33;322
2005;"SULINA (PR)";"PR";"SULINA";68;3;12;83
2005;"TAMARANA (PR)";"PR";"TAMARANA";202;7;31;240
2005;"TAMBOARA (PR)";"PR";"TAMBOARA";52;5;5;62
2005;"TAPEJARA (PR)";"PR";"TAPEJARA";269;7;44;320
2005;"TAPIRA (PR)";"PR";"TAPIRA";110;3;5;118
2005;"TEIXEIRA SOARES (PR)";"PR";"TEIXEIRA SOARES";183;5;26;214
2005;"TELEMACO BORBA (PR)";"PR";"TELEMACO BORBA";978;132;184;1294
2005;"TERRA BOA (PR)";"PR";"TERRA BOA";260;8;38;306
2005;"TERRA RICA (PR)";"PR";"TERRA RICA";255;2;32;289
2005;"TERRA ROXA (PR)";"PR";"TERRA ROXA";373;8;22;403
2005;"TIBAGI (PR)";"PR";"TIBAGI";233;13;40;286
2005;"TIJUCAS DO SUL (PR)";"PR";"TIJUCAS DO SUL";267;6;22;295
2005;"TOLEDO (PR)";"PR";"TOLEDO";2316;136;204;2656
2005;"TOMAZINA (PR)";"PR";"TOMAZINA";63;4;17;84
2005;"TRES BARRAS DO PARANA (PR)";"PR";"TRES BARRAS DO PARANA";258;3;18;279
2005;"TUNAS DO PARANA (PR)";"PR";"TUNAS DO PARANA";74;5;12;91
2005;"TUNEIRAS DO OESTE (PR)";"PR";"TUNEIRAS DO OESTE";101;1;23;125
2005;"TUPASSI (PR)";"PR";"TUPASSI";280;4;11;295
2005;"TURVO (PR)";"PR";"TURVO";281;7;34;322
2005;"UBIRATA (PR)";"PR";"UBIRATA";532;16;34;582
2005;"UMUARAMA (PR)";"PR";"UMUARAMA";2002;41;158;2201
2005;"UNIAO DA VITORIA (PR)";"PR";"UNIAO DA VITORIA";1082;30;56;1168
2005;"UNIFLOR (PR)";"PR";"UNIFLOR";19;5;6;30
2005;"URAI (PR)";"PR";"URAI";253;16;19;288
2005;"VENTANIA (PR)";"PR";"VENTANIA";116;3;28;147
2005;"VERA CRUZ DO OESTE (PR)";"PR";"VERA CRUZ DO OESTE";218;8;12;238
2005;"VERE (PR)";"PR";"VERE";160;9;19;188
2005;"VILA ALTA (PR)";"PR";"VILA ALTA";30;6;9;45
2005;"VIRMOND (PR)";"PR";"VIRMOND";85;1;11;97
2005;"VITORINO (PR)";"PR";"VITORINO";191;4;10;205
2005;"WENCESLAU BRAZ (PR)";"PR";"WENCESLAU BRAZ";334;15;59;408
2005;"XAMBRE (PR)";"PR";"XAMBRE";70;6;6;82
2005;"ANGRA DOS REIS (RJ)";"RJ";"ANGRA DOS REIS";876;156;233;1265
2005;"APERIBE (RJ)";"RJ";"APERIBE";77;7;3;87
2005;"ARARUAMA (RJ)";"RJ";"ARARUAMA";1119;202;81;1402
2005;"AREAL (RJ)";"RJ";"AREAL";84;27;21;132
2005;"ARMACAO DE BUZIOS (RJ)";"RJ";"ARMACAO DE BUZIOS";148;138;16;302
2005;"ARRAIAL DO CABO (RJ)";"RJ";"ARRAIAL DO CABO";106;27;12;145
2005;"BARRA DO PIRAI (RJ)";"RJ";"BARRA DO PIRAI";2300;99;193;2592
2005;"BARRA MANSA (RJ)";"RJ";"BARRA MANSA";1416;92;424;1932
2005;"BELFORD ROXO (RJ)";"RJ";"BELFORD ROXO";749;188;432;1369
2005;"BOM JARDIM (RJ)";"RJ";"BOM JARDIM";323;16;15;354
2005;"BOM JESUS DO ITABAPOANA (RJ)";"RJ";"BOM JESUS DO ITABAPOANA";263;23;25;311
2005;"CABO FRIO (RJ)";"RJ";"CABO FRIO";2656;261;312;3229
2005;"CACHOEIRAS DE MACACU (RJ)";"RJ";"CACHOEIRAS DE MACACU";651;89;30;770
2005;"CAMBUCI (RJ)";"RJ";"CAMBUCI";65;7;9;81
2005;"CAMPOS DOS GOITACAZES (RJ)";"RJ";"CAMPOS DOS GOITACAZES";4445;303;798;5546
2005;"CANTAGALO (RJ)";"RJ";"CANTAGALO";105;18;23;146
2005;"CARAPEBUS (RJ)";"RJ";"CARAPEBUS";47;19;5;71
2005;"CARDOSO MOREIRA (RJ)";"RJ";"CARDOSO MOREIRA";124;7;19;150
2005;"CARMO (RJ)";"RJ";"CARMO";84;12;24;120
2005;"CASIMIRO DE ABREU (RJ)";"RJ";"CASIMIRO DE ABREU";451;63;25;539
2005;"COMENDADOR LEVY GASPARIAN (RJ)";"RJ";"COMENDADOR LEVY GASPARIAN";92;26;11;129
2005;"CONCEICAO DE MACABU (RJ)";"RJ";"CONCEICAO DE MACABU";145;27;47;219
2005;"CORDEIRO (RJ)";"RJ";"CORDEIRO";221;31;35;287
2005;"DUAS BARRAS (RJ)";"RJ";"DUAS BARRAS";46;15;4;65
2005;"DUQUE DE CAXIAS (RJ)";"RJ";"DUQUE DE CAXIAS";5534;656;2241;8431
2005;"ENGENHEIRO PAULO DE FRONTIN (RJ)";"RJ";"ENGENHEIRO PAULO DE FRONTIN";137;15;15;167
2005;"GUAPIMIRIM (RJ)";"RJ";"GUAPIMIRIM";219;41;27;287
2005;"IGUABA GRANDE (RJ)";"RJ";"IGUABA GRANDE";75;74;8;157
2005;"ITABORAI (RJ)";"RJ";"ITABORAI";2727;831;557;4115
2005;"ITAGUAI (RJ)";"RJ";"ITAGUAI";938;247;196;1381
2005;"ITALVA (RJ)";"RJ";"ITALVA";147;9;12;168
2005;"ITAOCARA (RJ)";"RJ";"ITAOCARA";237;25;19;281
2005;"ITAPERUNA (RJ)";"RJ";"ITAPERUNA";867;69;86;1022
2005;"ITATIAIA (RJ)";"RJ";"ITATIAIA";174;64;27;265
2005;"JAPERI (RJ)";"RJ";"JAPERI";133;26;13;172
2005;"LAJE DO MURIAE (RJ)";"RJ";"LAJE DO MURIAE";35;4;6;45
2005;"MACAE (RJ)";"RJ";"MACAE";2056;480;585;3121
2005;"MACUCO (RJ)";"RJ";"MACUCO";94;9;3;106
2005;"MAGE (RJ)";"RJ";"MAGE";858;248;154;1260
2005;"MANGARATIBA (RJ)";"RJ";"MANGARATIBA";102;80;82;264
2005;"MARICA (RJ)";"RJ";"MARICA";535;215;165;915
2005;"MENDES (RJ)";"RJ";"MENDES";209;34;18;261
2005;"MESQUITA (RJ)";"RJ";"MESQUITA";212;76;332;620
2005;"MIGUEL PEREIRA (RJ)";"RJ";"MIGUEL PEREIRA";207;41;22;270
2005;"MIRACEMA (RJ)";"RJ";"MIRACEMA";172;7;19;198
2005;"NATIVIDADE (RJ)";"RJ";"NATIVIDADE";71;11;18;100
2005;"NILOPOLIS (RJ)";"RJ";"NILOPOLIS";433;120;254;807
2005;"NITEROI (RJ)";"RJ";"NITEROI";1831;1184;1564;4579
2005;"NOVA FRIBURGO (RJ)";"RJ";"NOVA FRIBURGO";3202;168;273;3643
2005;"NOVA IGUACU (RJ)";"RJ";"NOVA IGUACU";4428;785;1341;6554
2005;"PARACAMBI (RJ)";"RJ";"PARACAMBI";135;28;65;228
2005;"PARAIBA DO SUL (RJ)";"RJ";"PARAIBA DO SUL";334;54;189;577
2005;"PARATI (RJ)";"RJ";"PARATI";135;48;30;213
2005;"PATY DO ALFERES (RJ)";"RJ";"PATY DO ALFERES";352;36;25;413
2005;"PETROPOLIS (RJ)";"RJ";"PETROPOLIS";2985;486;601;4072
2005;"PINHEIRAL (RJ)";"RJ";"PINHEIRAL";106;24;22;152
2005;"PIRAI (RJ)";"RJ";"PIRAI";439;34;58;531
2005;"PORCIUNCULA (RJ)";"RJ";"PORCIUNCULA";66;3;6;75
2005;"PORTO REAL (RJ)";"RJ";"PORTO REAL";298;28;24;350
2005;"QUATIS (RJ)";"RJ";"QUATIS";200;100;28;328
2005;"QUEIMADOS (RJ)";"RJ";"QUEIMADOS";285;185;93;563
2005;"QUISSAMA (RJ)";"RJ";"QUISSAMA";164;16;45;225
2005;"RESENDE (RJ)";"RJ";"RESENDE";745;126;227;1098
2005;"RIO BONITO (RJ)";"RJ";"RIO BONITO";3070;276;165;3511
2005;"RIO CLARO (RJ)";"RJ";"RIO CLARO";67;6;6;79
2005;"RIO DAS FLORES (RJ)";"RJ";"RIO DAS FLORES";55;11;4;70
2005;"RIO DAS OSTRAS (RJ)";"RJ";"RIO DAS OSTRAS";585;185;45;815
2005;"RIO DE JANEIRO (RJ)";"RJ";"RIO DE JANEIRO";26520;11542;11178;49240
2005;"SANTA MARIA MADALENA (RJ)";"RJ";"SANTA MARIA MADALENA";37;7;2;46
2005;"SANTO ANTONIO DE PADUA (RJ)";"RJ";"SANTO ANTONIO DE PADUA";452;48;21;521
2005;"SAO FIDELIS (RJ)";"RJ";"SAO FIDELIS";322;23;46;391
2005;"SAO FRANCISCO DE ITABAPOANA (RJ)";"RJ";"SAO FRANCISCO DE ITABAPOANA";204;21;18;243
2005;"SAO GONCALO (RJ)";"RJ";"SAO GONCALO";2066;1306;1561;4933
2005;"SAO JOAO DA BARRA (RJ)";"RJ";"SAO JOAO DA BARRA";217;23;24;264
2005;"SAO JOAO DE MERITI (RJ)";"RJ";"SAO JOAO DE MERITI";2138;318;1103;3559
2005;"SAO JOSE DE UBA (RJ)";"RJ";"SAO JOSE DE UBA";7;3;2;12
2005;"SAO JOSE DO VALE DO RIO PRETO (RJ)";"RJ";"SAO JOSE DO VALE DO RIO PRETO";460;37;23;520
2005;"SAO PEDRO DA ALDEIA (RJ)";"RJ";"SAO PEDRO DA ALDEIA";324;63;30;417
2005;"SAO SEBASTIAO DO ALTO (RJ)";"RJ";"SAO SEBASTIAO DO ALTO";57;3;2;62
2005;"SAPUCAIA (RJ)";"RJ";"SAPUCAIA";90;5;6;101
2005;"SAQUAREMA (RJ)";"RJ";"SAQUAREMA";397;76;47;520
2005;"SEROPEDICA (RJ)";"RJ";"SEROPEDICA";365;37;119;521
2005;"SILVA JARDIM (RJ)";"RJ";"SILVA JARDIM";238;29;14;281
2005;"SUMIDOURO (RJ)";"RJ";"SUMIDOURO";182;7;11;200
2005;"TANGUA (RJ)";"RJ";"TANGUA";161;13;11;185
2005;"TERESOPOLIS (RJ)";"RJ";"TERESOPOLIS";1478;151;259;1888
2005;"TRAJANO DE MORAIS (RJ)";"RJ";"TRAJANO DE MORAIS";35;3;8;46
2005;"TRES RIOS (RJ)";"RJ";"TRES RIOS";674;70;187;931
2005;"VALENCA (RJ)";"RJ";"VALENCA";241;40;39;320
2005;"VARRE SAI (RJ)";"RJ";"VARRE SAI";25;3;1;29
2005;"VASSOURAS (RJ)";"RJ";"VASSOURAS";335;37;72;444
2005;"VOLTA REDONDA (RJ)";"RJ";"VOLTA REDONDA";1826;217;452;2495
2005;"ACARI (RN)";"RN";"ACARI";66;6;4;76
2005;"AFONSO BEZERRA (RN)";"RN";"AFONSO BEZERRA";16;4;3;23
2005;"AGUA NOVA (RN)";"RN";"AGUA NOVA";3;4;0;7
2005;"ALEXANDRIA (RN)";"RN";"ALEXANDRIA";41;5;10;56
2005;"ALMINO AFONSO (RN)";"RN";"ALMINO AFONSO";5;5;0;10
2005;"ALTO DO RODRIGUES (RN)";"RN";"ALTO DO RODRIGUES";71;8;15;94
2005;"ANGICOS (RN)";"RN";"ANGICOS";70;6;8;84
2005;"ANTONIO MARTINS (RN)";"RN";"ANTONIO MARTINS";7;7;0;14
2005;"APODI (RN)";"RN";"APODI";132;14;13;159
2005;"AREIA BRANCA (RN)";"RN";"AREIA BRANCA";94;33;32;159
2005;"ARES (RN)";"RN";"ARES";72;5;8;85
2005;"ASSU (RN)";"RN";"ASSU";354;34;27;415
2005;"BAIA FORMOSA (RN)";"RN";"BAIA FORMOSA";35;0;4;39
2005;"BARAUNA (RN)";"RN";"BARAUNA";108;15;8;131
2005;"BARCELONA (RN)";"RN";"BARCELONA";20;3;1;24
2005;"BENTO FERNANDES (RN)";"RN";"BENTO FERNANDES";10;4;0;14
2005;"BOA SAUDE (RN)";"RN";"BOA SAUDE";32;5;1;38
2005;"BODO (RN)";"RN";"BODO";5;5;1;11
2005;"BOM JESUS (RN)";"RN";"BOM JESUS";41;2;3;46
2005;"BREJINHO (RN)";"RN";"BREJINHO";42;6;6;54
2005;"CAICARA DO NORTE (RN)";"RN";"CAICARA DO NORTE";8;0;1;9
2005;"CAICARA DO RIO DO VENTO (RN)";"RN";"CAICARA DO RIO DO VENTO";15;4;1;20
2005;"CAICO (RN)";"RN";"CAICO";939;39;31;1009
2005;"CAMPO GRANDE (RN)";"RN";"CAMPO GRANDE";23;8;0;31
2005;"CAMPO REDONDO (RN)";"RN";"CAMPO REDONDO";25;5;2;32
2005;"CANGUARETAMA (RN)";"RN";"CANGUARETAMA";112;17;40;169
2005;"CARAUBAS (RN)";"RN";"CARAUBAS";88;15;5;108
2005;"CARNAUBA DOS DANTAS (RN)";"RN";"CARNAUBA DOS DANTAS";96;3;4;103
2005;"CARNAUBAIS (RN)";"RN";"CARNAUBAIS";32;18;9;59
2005;"CEARA MIRIM (RN)";"RN";"CEARA MIRIM";229;21;47;297
2005;"CERRO CORA (RN)";"RN";"CERRO CORA";55;6;4;65
2005;"CORONEL EZEQUIEL (RN)";"RN";"CORONEL EZEQUIEL";14;4;3;21
2005;"CORONEL JOAO PESSOA (RN)";"RN";"CORONEL JOAO PESSOA";9;3;0;12
2005;"CRUZETA (RN)";"RN";"CRUZETA";39;6;2;47
2005;"CURRAIS NOVOS (RN)";"RN";"CURRAIS NOVOS";449;22;36;507
2005;"DOUTOR SEVERIANO (RN)";"RN";"DOUTOR SEVERIANO";6;6;1;13
2005;"ENCANTO (RN)";"RN";"ENCANTO";8;2;1;11
2005;"EQUADOR (RN)";"RN";"EQUADOR";38;2;1;41
2005;"ESPIRITO SANTO (RN)";"RN";"ESPIRITO SANTO";13;2;6;21
2005;"ESPIRITO SANTO DO OESTE (RN)";"RN";"ESPIRITO SANTO DO OESTE";10;4;2;16
2005;"EXTREMOZ (RN)";"RN";"EXTREMOZ";31;12;49;92
2005;"FELIPE GUERRA (RN)";"RN";"FELIPE GUERRA";10;7;2;19
2005;"FERNANDO PEDROZA (RN)";"RN";"FERNANDO PEDROZA";12;1;1;14
2005;"FLORANIA (RN)";"RN";"FLORANIA";36;6;3;45
2005;"FRANCISCO DANTAS (RN)";"RN";"FRANCISCO DANTAS";6;2;1;9
2005;"FRUTUOSO GOMES (RN)";"RN";"FRUTUOSO GOMES";14;4;0;18
2005;"GALINHOS (RN)";"RN";"GALINHOS";6;3;1;10
2005;"GOIANINHA (RN)";"RN";"GOIANINHA";75;25;26;126
2005;"GOVERNADOR DIX SEPT ROSADO (RN)";"RN";"GOVERNADOR DIX SEPT ROSADO";81;7;7;95
2005;"GROSSOS (RN)";"RN";"GROSSOS";24;4;4;32
2005;"GUAMARE (RN)";"RN";"GUAMARE";30;11;15;56
2005;"IELMO MARINHO (RN)";"RN";"IELMO MARINHO";25;4;8;37
2005;"IPANGUACU (RN)";"RN";"IPANGUACU";36;12;45;93
2005;"IPUEIRA (RN)";"RN";"IPUEIRA";9;8;6;23
2005;"ITAJA (RN)";"RN";"ITAJA";45;3;4;52
2005;"ITAU (RN)";"RN";"ITAU";13;1;0;14
2005;"JACANA (RN)";"RN";"JACANA";64;17;9;90
2005;"JANDAIRA (RN)";"RN";"JANDAIRA";28;2;5;35
2005;"JANDUIS (RN)";"RN";"JANDUIS";9;1;0;10
2005;"JAPI (RN)";"RN";"JAPI";26;3;6;35
2005;"JARDIM DE ANGICOS (RN)";"RN";"JARDIM DE ANGICOS";7;0;1;8
2005;"JARDIM DE PIRANHAS (RN)";"RN";"JARDIM DE PIRANHAS";49;16;5;70
2005;"JARDIM DO SERIDO (RN)";"RN";"JARDIM DO SERIDO";117;8;48;173
2005;"JOAO CAMARA (RN)";"RN";"JOAO CAMARA";182;8;16;206
2005;"JOAO DIAS (RN)";"RN";"JOAO DIAS";3;1;0;4
2005;"JOSE DA PENHA (RN)";"RN";"JOSE DA PENHA";13;8;1;22
2005;"JUCURUTU (RN)";"RN";"JUCURUTU";79;13;5;97
2005;"JUNDIA (RN)";"RN";"JUNDIA";7;2;2;11
2005;"LAGOA DANTA (RN)";"RN";"LAGOA DANTA";21;2;7;30
2005;"LAGOA DE PEDRAS (RN)";"RN";"LAGOA DE PEDRAS";21;2;4;27
2005;"LAGOA DE VELHOS (RN)";"RN";"LAGOA DE VELHOS";11;0;0;11
2005;"LAGOA NOVA (RN)";"RN";"LAGOA NOVA";45;5;3;53
2005;"LAGOA SALGADA (RN)";"RN";"LAGOA SALGADA";37;2;4;43
2005;"LAJES (RN)";"RN";"LAJES";35;5;5;45
2005;"LAJES PINTADAS (RN)";"RN";"LAJES PINTADAS";13;6;4;23
2005;"LUCRECIA (RN)";"RN";"LUCRECIA";15;1;1;17
2005;"LUIS GOMES (RN)";"RN";"LUIS GOMES";10;5;2;17
2005;"MACAIBA (RN)";"RN";"MACAIBA";315;19;36;370
2005;"MACAU (RN)";"RN";"MACAU";97;23;31;151
2005;"MAJOR SALES (RN)";"RN";"MAJOR SALES";4;4;0;8
2005;"MARCELINO VIEIRA (RN)";"RN";"MARCELINO VIEIRA";11;6;1;18
2005;"MARTINS (RN)";"RN";"MARTINS";27;3;2;32
2005;"MAXARANGUAPE (RN)";"RN";"MAXARANGUAPE";11;5;4;20
2005;"MESSIAS TARGINO (RN)";"RN";"MESSIAS TARGINO";16;6;1;23
2005;"MONTANHAS (RN)";"RN";"MONTANHAS";22;4;7;33
2005;"MONTE ALEGRE (RN)";"RN";"MONTE ALEGRE";59;5;7;71
2005;"MONTE DAS GAMELEIRAS (RN)";"RN";"MONTE DAS GAMELEIRAS";9;3;5;17
2005;"MOSSORO (RN)";"RN";"MOSSORO";2429;139;120;2688
2005;"NATAL (RN)";"RN";"NATAL";5065;987;1715;7767
2005;"NISIA FLORESTA (RN)";"RN";"NISIA FLORESTA";53;18;47;118
2005;"NOVA CRUZ (RN)";"RN";"NOVA CRUZ";213;17;28;258
2005;"OLHO D AGUA DO BORGES (RN)";"RN";"OLHO D AGUA DO BORGES";15;4;0;19
2005;"OURO BRANCO (RN)";"RN";"OURO BRANCO";34;4;7;45
2005;"PARANA (RN)";"RN";"PARANA";4;3;1;8
2005;"PARAZINHO (RN)";"RN";"PARAZINHO";15;0;6;21
2005;"PARELHAS (RN)";"RN";"PARELHAS";222;9;17;248
2005;"PARNAMIRIM (RN)";"RN";"PARNAMIRIM";978;234;156;1368
2005;"PASSA E FICA (RN)";"RN";"PASSA E FICA";56;10;5;71
2005;"PASSAGEM (RN)";"RN";"PASSAGEM";12;7;2;21
2005;"PATU (RN)";"RN";"PATU";62;18;2;82
2005;"PAU DOS FERROS (RN)";"RN";"PAU DOS FERROS";221;31;3;255
2005;"PEDRA GRANDE (RN)";"RN";"PEDRA GRANDE";13;1;3;17
2005;"PEDRA PRETA (RN)";"RN";"PEDRA PRETA";19;1;4;24
2005;"PEDRO AVELINO (RN)";"RN";"PEDRO AVELINO";26;1;1;28
2005;"PEDRO VELHO (RN)";"RN";"PEDRO VELHO";36;2;7;45
2005;"PENDENCIAS (RN)";"RN";"PENDENCIAS";44;6;11;61
2005;"PILOES (RN)";"RN";"PILOES";0;3;0;3
2005;"POCO BRANCO (RN)";"RN";"POCO BRANCO";22;3;4;29
2005;"PORTALEGRE (RN)";"RN";"PORTALEGRE";33;5;1;39
2005;"PORTO DO MANGUE (RN)";"RN";"PORTO DO MANGUE";30;8;2;40
2005;"PUREZA (RN)";"RN";"PUREZA";45;2;5;52
2005;"RAFAEL FERNANDES (RN)";"RN";"RAFAEL FERNANDES";10;3;0;13
2005;"RAFAEL GODEIRO (RN)";"RN";"RAFAEL GODEIRO";8;1;0;9
2005;"RIACHO DA CRUZ (RN)";"RN";"RIACHO DA CRUZ";2;2;0;4
2005;"RIACHO DE SANTANA (RN)";"RN";"RIACHO DE SANTANA";2;6;1;9
2005;"RIACHUELO (RN)";"RN";"RIACHUELO";20;3;2;25
2005;"RIO DO FOGO (RN)";"RN";"RIO DO FOGO";17;2;0;19
2005;"RODOLFO FERNANDES (RN)";"RN";"RODOLFO FERNANDES";15;5;1;21
2005;"RUY BARBOSA (RN)";"RN";"RUY BARBOSA";12;2;1;15
2005;"SANTA CRUZ (RN)";"RN";"SANTA CRUZ";247;13;17;277
2005;"SANTA MARIA (RN)";"RN";"SANTA MARIA";25;0;3;28
2005;"SANTANA DO MATOS (RN)";"RN";"SANTANA DO MATOS";54;6;0;60
2005;"SANTANA DO SERIDO (RN)";"RN";"SANTANA DO SERIDO";15;1;0;16
2005;"SANTO ANTONIO (RN)";"RN";"SANTO ANTONIO";84;21;10;115
2005;"SAO BENTO DO NORTE (RN)";"RN";"SAO BENTO DO NORTE";8;3;1;12
2005;"SAO BENTO DO TRAIRI (RN)";"RN";"SAO BENTO DO TRAIRI";12;2;2;16
2005;"SAO FERNANDO (RN)";"RN";"SAO FERNANDO";4;3;1;8
2005;"SAO FRANCISCO DO OESTE (RN)";"RN";"SAO FRANCISCO DO OESTE";8;2;2;12
2005;"SAO GONCALO DO AMARANTE (RN)";"RN";"SAO GONCALO DO AMARANTE";170;41;70;281
2005;"SAO JOAO DO SABUGI (RN)";"RN";"SAO JOAO DO SABUGI";25;7;2;34
2005;"SAO JOSE DE MIPIBU (RN)";"RN";"SAO JOSE DE MIPIBU";171;28;29;228
2005;"SAO JOSE DO CAMPESTRE (RN)";"RN";"SAO JOSE DO CAMPESTRE";54;4;7;65
2005;"SAO JOSE DO SERIDO (RN)";"RN";"SAO JOSE DO SERIDO";19;7;1;27
2005;"SAO MIGUEL (RN)";"RN";"SAO MIGUEL";86;13;15;114
2005;"SAO MIGUEL DE TOUROS (RN)";"RN";"SAO MIGUEL DE TOUROS";13;2;4;19
2005;"SAO PAULO DO POTENGI (RN)";"RN";"SAO PAULO DO POTENGI";75;6;6;87
2005;"SAO PEDRO (RN)";"RN";"SAO PEDRO";24;3;2;29
2005;"SAO RAFAEL (RN)";"RN";"SAO RAFAEL";20;7;0;27
2005;"SAO TOME (RN)";"RN";"SAO TOME";34;3;16;53
2005;"SAO VICENTE (RN)";"RN";"SAO VICENTE";34;1;1;36
2005;"SENADOR ELOI DE SOUZA (RN)";"RN";"SENADOR ELOI DE SOUZA";10;4;3;17
2005;"SENADOR GEORGINO AVELINO (RN)";"RN";"SENADOR GEORGINO AVELINO";7;1;1;9
2005;"SERRA CAIADA (RN)";"RN";"SERRA CAIADA";20;5;6;31
2005;"SERRA DE SAO BENTO (RN)";"RN";"SERRA DE SAO BENTO";13;3;2;18
2005;"SERRA DO MEL (RN)";"RN";"SERRA DO MEL";41;6;4;51
2005;"SERRA NEGRA DO NORTE (RN)";"RN";"SERRA NEGRA DO NORTE";74;11;3;88
2005;"SERRINHA (RN)";"RN";"SERRINHA";18;6;1;25
2005;"SERRINHA DOS PINTOS (RN)";"RN";"SERRINHA DOS PINTOS";27;4;0;31
2005;"SEVERIANO MELO (RN)";"RN";"SEVERIANO MELO";28;3;5;36
2005;"SITIO NOVO (RN)";"RN";"SITIO NOVO";14;3;0;17
2005;"TABOLEIRO GRANDE (RN)";"RN";"TABOLEIRO GRANDE";4;2;1;7
2005;"TAIPU (RN)";"RN";"TAIPU";32;2;5;39
2005;"TANGARA (RN)";"RN";"TANGARA";63;3;12;78
2005;"TENENTE ANANIAS (RN)";"RN";"TENENTE ANANIAS";18;2;2;22
2005;"TENENTE LAURENTINO CRUZ (RN)";"RN";"TENENTE LAURENTINO CRUZ";34;7;2;43
2005;"TIBAU (RN)";"RN";"TIBAU";12;15;6;33
2005;"TIBAU DO SUL (RN)";"RN";"TIBAU DO SUL";22;34;7;63
2005;"TIMBAUBA DOS BATISTAS (RN)";"RN";"TIMBAUBA DOS BATISTAS";14;5;2;21
2005;"TOUROS (RN)";"RN";"TOUROS";115;20;21;156
2005;"TRIUNFO POTIGUAR (RN)";"RN";"TRIUNFO POTIGUAR";11;4;0;15
2005;"UMARIZAL (RN)";"RN";"UMARIZAL";38;12;1;51
2005;"UPANEMA (RN)";"RN";"UPANEMA";25;12;6;43
2005;"VARZEA (RN)";"RN";"VARZEA";15;2;4;21
2005;"VENHA VER (RN)";"RN";"VENHA VER";11;2;0;13
2005;"VERA CRUZ (RN)";"RN";"VERA CRUZ";78;2;14;94
2005;"VICOSA (RN)";"RN";"VICOSA";4;3;0;7
2005;"VILA FLOR (RN)";"RN";"VILA FLOR";3;2;1;6
2005;"ALTA FLORESTA D OESTE (RO)";"RO";"ALTA FLORESTA D OESTE";352;8;21;381
2005;"ALTO ALEGRE DOS PARECIS (RO)";"RO";"ALTO ALEGRE DOS PARECIS";58;2;5;65
2005;"ALTO PARAISO (RO)";"RO";"ALTO PARAISO";87;3;16;106
2005;"ALVORADA D OESTE (RO)";"RO";"ALVORADA D OESTE";205;4;20;229
2005;"ARIQUEMES (RO)";"RO";"ARIQUEMES";1533;14;113;1660
2005;"BURITIS (RO)";"RO";"BURITIS";215;1;11;227
2005;"CABIXI (RO)";"RO";"CABIXI";56;1;9;66
2005;"CACAULANDIA (RO)";"RO";"CACAULANDIA";27;1;7;35
2005;"CACOAL (RO)";"RO";"CACOAL";1213;24;159;1396
2005;"CAMPO NOVO DE RONDONIA (RO)";"RO";"CAMPO NOVO DE RONDONIA";26;0;6;32
2005;"CANDEIAS DO JAMARI (RO)";"RO";"CANDEIAS DO JAMARI";66;2;6;74
2005;"CASTANHEIRAS (RO)";"RO";"CASTANHEIRAS";19;2;4;25
2005;"CEREJEIRAS (RO)";"RO";"CEREJEIRAS";295;10;25;330
2005;"CHUPINGUAIA (RO)";"RO";"CHUPINGUAIA";36;1;10;47
2005;"COLORADO DO OESTE (RO)";"RO";"COLORADO DO OESTE";304;5;26;335
2005;"CORUMBIARA (RO)";"RO";"CORUMBIARA";31;2;4;37
2005;"COSTA MARQUES (RO)";"RO";"COSTA MARQUES";34;2;3;39
2005;"CUJUBIM (RO)";"RO";"CUJUBIM";35;0;4;39
2005;"ESPIGAO D OESTE (RO)";"RO";"ESPIGAO D OESTE";380;4;46;430
2005;"GOVERNADOR JORGE TEIXEIRA (RO)";"RO";"GOVERNADOR JORGE TEIXEIRA";25;0;6;31
2005;"GUAJARA MIRIM (RO)";"RO";"GUAJARA MIRIM";338;8;9;355
2005;"JAMARI (RO)";"RO";"JAMARI";42;0;7;49
2005;"JARU (RO)";"RO";"JARU";788;19;98;905
2005;"JI PARANA (RO)";"RO";"JI PARANA";2001;47;482;2530
2005;"MACHADINHO D OESTE (RO)";"RO";"MACHADINHO D OESTE";170;0;30;200
2005;"MINISTRO ANDREAZZA (RO)";"RO";"MINISTRO ANDREAZZA";94;1;7;102
2005;"MIRANTE DA SERRA (RO)";"RO";"MIRANTE DA SERRA";125;1;13;139
2005;"MONTE NEGRO (RO)";"RO";"MONTE NEGRO";154;2;32;188
2005;"NOVA BRASILANDIA D OESTE (RO)";"RO";"NOVA BRASILANDIA D OESTE";179;3;15;197
2005;"NOVA UNIAO (RO)";"RO";"NOVA UNIAO";10;1;2;13
2005;"NOVO HORIZONTE DO OESTE (RO)";"RO";"NOVO HORIZONTE DO OESTE";43;1;7;51
2005;"OURO PRETO DO OESTE (RO)";"RO";"OURO PRETO DO OESTE";629;17;83;729
2005;"PARECIS (RO)";"RO";"PARECIS";18;0;3;21
2005;"PIMENTA BUENO (RO)";"RO";"PIMENTA BUENO";698;12;42;752
2005;"PIMENTEIRAS DO OESTE (RO)";"RO";"PIMENTEIRAS DO OESTE";10;0;6;16
2005;"PORTO VELHO (RO)";"RO";"PORTO VELHO";3140;174;597;3911
2005;"PRESIDENTE MEDICI (RO)";"RO";"PRESIDENTE MEDICI";206;1;30;237
2005;"PRIMAVERA DE RONDONIA (RO)";"RO";"PRIMAVERA DE RONDONIA";24;2;5;31
2005;"RIO CRESPO (RO)";"RO";"RIO CRESPO";20;1;6;27
2005;"ROLIM DE MOURA (RO)";"RO";"ROLIM DE MOURA";909;20;63;992
2005;"SANTA LUZIA D OESTE (RO)";"RO";"SANTA LUZIA D OESTE";84;2;29;115
2005;"SAO FELIPE D OESTE (RO)";"RO";"SAO FELIPE D OESTE";25;1;12;38
2005;"SAO FRANCISCO DO GUAPORE (RO)";"RO";"SAO FRANCISCO DO GUAPORE";121;0;7;128
2005;"SAO MIGUEL DO GUAPORE (RO)";"RO";"SAO MIGUEL DO GUAPORE";129;2;13;144
2005;"SERINGUEIRAS (RO)";"RO";"SERINGUEIRAS";44;3;9;56
2005;"TEIXEIROPOLIS (RO)";"RO";"TEIXEIROPOLIS";10;0;5;15
2005;"THEOBROMA (RO)";"RO";"THEOBROMA";23;0;15;38
2005;"URUPA (RO)";"RO";"URUPA";72;2;21;95
2005;"VALE DO ANARI (RO)";"RO";"VALE DO ANARI";22;1;1;24
2005;"VALE DO PARAISO (RO)";"RO";"VALE DO PARAISO";27;0;2;29
2005;"VILA NOVA DO MAMORE (RO)";"RO";"VILA NOVA DO MAMORE";80;0;8;88
2005;"VILHENA (RO)";"RO";"VILHENA";1019;22;101;1142
2005;"ALTO ALEGRE (RR)";"RR";"ALTO ALEGRE";15;1;3;19
2005;"AMAJARI (RR)";"RR";"AMAJARI";5;0;0;5
2005;"BOA VISTA (RR)";"RR";"BOA VISTA";2183;182;349;2714
2005;"BONFIM (RR)";"RR";"BONFIM";5;0;0;5
2005;"CANTA (RR)";"RR";"CANTA";11;0;4;15
2005;"CARACARAI (RR)";"RR";"CARACARAI";30;4;0;34
2005;"CAROEBE (RR)";"RR";"CAROEBE";13;1;2;16
2005;"IRACEMA (RR)";"RR";"IRACEMA";5;5;0;10
2005;"MUCAJAI (RR)";"RR";"MUCAJAI";53;15;5;73
2005;"NORMANDIA (RR)";"RR";"NORMANDIA";6;0;0;6
2005;"PACARAIMA (RR)";"RR";"PACARAIMA";15;0;1;16
2005;"RORAINOPOLIS (RR)";"RR";"RORAINOPOLIS";34;3;4;41
2005;"SAO JOAO DA BALIZA (RR)";"RR";"SAO JOAO DA BALIZA";16;3;1;20
2005;"SAO LUIZ (RR)";"RR";"SAO LUIZ";16;1;0;17
2005;"UIRAMUTA (RR)";"RR";"UIRAMUTA";2;0;0;2
2005;"ACEGUA (RS)";"RS";"ACEGUA";49;11;10;70
2005;"AGUA SANTA (RS)";"RS";"AGUA SANTA";116;2;13;131
2005;"AGUDO (RS)";"RS";"AGUDO";243;10;44;297
2005;"AJURICABA (RS)";"RS";"AJURICABA";294;10;23;327
2005;"ALECRIM (RS)";"RS";"ALECRIM";74;4;20;98
2005;"ALEGRETE (RS)";"RS";"ALEGRETE";811;27;141;979
2005;"ALEGRIA (RS)";"RS";"ALEGRIA";70;3;10;83
2005;"ALMIRANTE TAMANDARE DO SUL (RS)";"RS";"ALMIRANTE TAMANDARE DO SUL";66;4;4;74
2005;"ALPESTRE (RS)";"RS";"ALPESTRE";95;12;24;131
2005;"ALTO ALEGRE (RS)";"RS";"ALTO ALEGRE";61;2;9;72
2005;"ALTO FELIZ (RS)";"RS";"ALTO FELIZ";75;6;11;92
2005;"ALVORADA (RS)";"RS";"ALVORADA";1032;87;465;1584
2005;"AMARAL FERRADOR (RS)";"RS";"AMARAL FERRADOR";121;4;12;137
2005;"AMETISTA DO SUL (RS)";"RS";"AMETISTA DO SUL";40;0;17;57
2005;"ANDRE DA ROCHA (RS)";"RS";"ANDRE DA ROCHA";40;4;3;47
2005;"ANTA GORDA (RS)";"RS";"ANTA GORDA";152;10;21;183
2005;"ANTONIO PRADO (RS)";"RS";"ANTONIO PRADO";567;19;40;626
2005;"ARAMBARE (RS)";"RS";"ARAMBARE";31;2;5;38
2005;"ARARICA (RS)";"RS";"ARARICA";50;8;3;61
2005;"ARATIBA (RS)";"RS";"ARATIBA";134;17;23;174
2005;"ARROIO DO MEIO (RS)";"RS";"ARROIO DO MEIO";365;13;42;420
2005;"ARROIO DO PADRE (RS)";"RS";"ARROIO DO PADRE";78;8;9;95
2005;"ARROIO DO SAL (RS)";"RS";"ARROIO DO SAL";60;7;7;74
2005;"ARROIO DO TIGRE (RS)";"RS";"ARROIO DO TIGRE";251;18;29;298
2005;"ARROIO DOS RATOS (RS)";"RS";"ARROIO DOS RATOS";169;5;52;226
2005;"ARROIO GRANDE (RS)";"RS";"ARROIO GRANDE";193;12;32;237
2005;"ARVOREZINHA (RS)";"RS";"ARVOREZINHA";334;31;29;394
2005;"AUGUSTO PESTANA (RS)";"RS";"AUGUSTO PESTANA";304;11;19;334
2005;"AUREA (RS)";"RS";"AUREA";81;6;5;92
2005;"BAGE (RS)";"RS";"BAGE";916;92;218;1226
2005;"BALNEARIO PINHAL (RS)";"RS";"BALNEARIO PINHAL";71;7;7;85
2005;"BARAO (RS)";"RS";"BARAO";146;16;34;196
2005;"BARAO DE COTEGIPE (RS)";"RS";"BARAO DE COTEGIPE";165;13;11;189
2005;"BARAO DO TRIUNFO (RS)";"RS";"BARAO DO TRIUNFO";126;8;19;153
2005;"BARRA DO GUARITA (RS)";"RS";"BARRA DO GUARITA";16;2;4;22
2005;"BARRA DO QUARAI (RS)";"RS";"BARRA DO QUARAI";24;0;8;32
2005;"BARRA DO RIBEIRO (RS)";"RS";"BARRA DO RIBEIRO";139;7;39;185
2005;"BARRA DO RIO AZUL (RS)";"RS";"BARRA DO RIO AZUL";32;7;8;47
2005;"BARRA FUNDA (RS)";"RS";"BARRA FUNDA";125;2;8;135
2005;"BARRACAO (RS)";"RS";"BARRACAO";104;7;10;121
2005;"BARROS CASSAL (RS)";"RS";"BARROS CASSAL";124;5;28;157
2005;"BENJAMIN CONSTANT DO SUL (RS)";"RS";"BENJAMIN CONSTANT DO SUL";23;4;5;32
2005;"BENTO GONCALVES (RS)";"RS";"BENTO GONCALVES";2841;173;266;3280
2005;"BOA VISTA DAS MISSOES (RS)";"RS";"BOA VISTA DAS MISSOES";81;3;6;90
2005;"BOA VISTA DO BURICA (RS)";"RS";"BOA VISTA DO BURICA";149;6;19;174
2005;"BOA VISTA DO CADEADO (RS)";"RS";"BOA VISTA DO CADEADO";36;4;12;52
2005;"BOA VISTA DO INCRA (RS)";"RS";"BOA VISTA DO INCRA";42;1;6;49
2005;"BOA VISTA DO SUL (RS)";"RS";"BOA VISTA DO SUL";267;5;7;279
2005;"BOM JESUS (RS)";"RS";"BOM JESUS";210;8;29;247
2005;"BOM PRINCIPIO (RS)";"RS";"BOM PRINCIPIO";298;20;29;347
2005;"BOM PROGRESSO (RS)";"RS";"BOM PROGRESSO";30;3;4;37
2005;"BOM RETIRO DO SUL (RS)";"RS";"BOM RETIRO DO SUL";134;9;23;166
2005;"BOQUEIRAO DO LEAO (RS)";"RS";"BOQUEIRAO DO LEAO";137;5;16;158
2005;"BOSSOROCA (RS)";"RS";"BOSSOROCA";142;5;12;159
2005;"BOZANO (RS)";"RS";"BOZANO";98;2;8;108
2005;"BRAGA (RS)";"RS";"BRAGA";52;0;8;60
2005;"BROCHIER (RS)";"RS";"BROCHIER";192;13;18;223
2005;"BUTIA (RS)";"RS";"BUTIA";253;7;64;324
2005;"CACAPAVA DO SUL (RS)";"RS";"CACAPAVA DO SUL";486;17;81;584
2005;"CACEQUI (RS)";"RS";"CACEQUI";122;7;18;147
2005;"CACHOEIRA DO SUL (RS)";"RS";"CACHOEIRA DO SUL";921;40;184;1145
2005;"CACHOEIRINHA (RS)";"RS";"CACHOEIRINHA";1636;155;352;2143
2005;"CACIQUE DOBLE (RS)";"RS";"CACIQUE DOBLE";71;4;7;82
2005;"CAIBATE (RS)";"RS";"CAIBATE";108;6;3;117
2005;"CAICARA (RS)";"RS";"CAICARA";59;6;14;79
2005;"CAMAQUA (RS)";"RS";"CAMAQUA";1153;34;176;1363
2005;"CAMARGO (RS)";"RS";"CAMARGO";85;4;11;100
2005;"CAMBARA DO SUL (RS)";"RS";"CAMBARA DO SUL";270;14;22;306
2005;"CAMPESTRE DA SERRA (RS)";"RS";"CAMPESTRE DA SERRA";126;7;7;140
2005;"CAMPINA DAS MISSOES (RS)";"RS";"CAMPINA DAS MISSOES";107;9;22;138
2005;"CAMPINAS DO SUL (RS)";"RS";"CAMPINAS DO SUL";175;12;18;205
2005;"CAMPO BOM (RS)";"RS";"CAMPO BOM";576;82;107;765
2005;"CAMPO NOVO (RS)";"RS";"CAMPO NOVO";136;8;14;158
2005;"CAMPOS BORGES (RS)";"RS";"CAMPOS BORGES";86;5;12;103
2005;"CANDELARIA (RS)";"RS";"CANDELARIA";310;20;66;396
2005;"CANDIDO GODOI (RS)";"RS";"CANDIDO GODOI";160;15;15;190
2005;"CANDIOTA (RS)";"RS";"CANDIOTA";80;16;24;120
2005;"CANELA (RS)";"RS";"CANELA";430;50;101;581
2005;"CANGUCU (RS)";"RS";"CANGUCU";870;21;116;1007
2005;"CANOAS (RS)";"RS";"CANOAS";3363;303;839;4505
2005;"CANUDOS DO VALE (RS)";"RS";"CANUDOS DO VALE";17;6;1;24
2005;"CAPAO BONITO DO SUL (RS)";"RS";"CAPAO BONITO DO SUL";26;2;3;31
2005;"CAPAO DA CANOA (RS)";"RS";"CAPAO DA CANOA";337;64;73;474
2005;"CAPAO DO CIPO (RS)";"RS";"CAPAO DO CIPO";43;5;5;53
2005;"CAPAO DO LEAO (RS)";"RS";"CAPAO DO LEAO";204;12;26;242
2005;"CAPELA DE SANTANA (RS)";"RS";"CAPELA DE SANTANA";91;7;25;123
2005;"CAPITAO (RS)";"RS";"CAPITAO";43;6;7;56
2005;"CAPIVARI DO SUL (RS)";"RS";"CAPIVARI DO SUL";87;6;3;96
2005;"CARAA (RS)";"RS";"CARAA";75;1;11;87
2005;"CARAZINHO (RS)";"RS";"CARAZINHO";1203;48;197;1448
2005;"CARLOS BARBOSA (RS)";"RS";"CARLOS BARBOSA";574;39;77;690
2005;"CARLOS GOMES (RS)";"RS";"CARLOS GOMES";24;2;6;32
2005;"CASCA (RS)";"RS";"CASCA";315;9;12;336
2005;"CASEIROS (RS)";"RS";"CASEIROS";109;5;10;124
2005;"CATUIPE (RS)";"RS";"CATUIPE";278;7;19;304
2005;"CAXIAS DO SUL (RS)";"RS";"CAXIAS DO SUL";6621;975;1114;8710
2005;"CENTENARIO (RS)";"RS";"CENTENARIO";80;7;3;90
2005;"CERRITO (RS)";"RS";"CERRITO";88;0;6;94
2005;"CERRO BRANCO (RS)";"RS";"CERRO BRANCO";57;5;12;74
2005;"CERRO GRANDE (RS)";"RS";"CERRO GRANDE";42;1;8;51
2005;"CERRO GRANDE DO SUL (RS)";"RS";"CERRO GRANDE DO SUL";206;11;16;233
2005;"CERRO LARGO (RS)";"RS";"CERRO LARGO";250;8;40;298
2005;"CHAPADA (RS)";"RS";"CHAPADA";260;33;22;315
2005;"CHARQUEADAS (RS)";"RS";"CHARQUEADAS";245;52;52;349
2005;"CHARRUA (RS)";"RS";"CHARRUA";70;2;10;82
2005;"CHIAPETTA (RS)";"RS";"CHIAPETTA";107;3;12;122
2005;"CHUI (RS)";"RS";"CHUI";144;13;13;170
2005;"CHUVISCA (RS)";"RS";"CHUVISCA";90;2;19;111
2005;"CIDREIRA (RS)";"RS";"CIDREIRA";69;7;14;90
2005;"CIRIACO (RS)";"RS";"CIRIACO";104;8;16;128
2005;"COLINAS (RS)";"RS";"COLINAS";52;6;12;70
2005;"COLORADO (RS)";"RS";"COLORADO";181;9;12;202
2005;"CONDOR (RS)";"RS";"CONDOR";175;5;21;201
2005;"CONSTANTINA (RS)";"RS";"CONSTANTINA";219;16;61;296
2005;"COQUEIRO BAIXO (RS)";"RS";"COQUEIRO BAIXO";15;9;2;26
2005;"COQUEIROS DO SUL (RS)";"RS";"COQUEIROS DO SUL";82;4;11;97
2005;"CORONEL BARROS (RS)";"RS";"CORONEL BARROS";68;2;7;77
2005;"CORONEL BICACO (RS)";"RS";"CORONEL BICACO";145;12;14;171
2005;"CORONEL PILAR (RS)";"RS";"CORONEL PILAR";153;2;6;161
2005;"COTIPORA (RS)";"RS";"COTIPORA";140;11;8;159
2005;"COXILHA (RS)";"RS";"COXILHA";83;4;9;96
2005;"CRISSIUMAL (RS)";"RS";"CRISSIUMAL";243;15;39;297
2005;"CRISTAL (RS)";"RS";"CRISTAL";150;3;19;172
2005;"CRISTAL DO SUL (RS)";"RS";"CRISTAL DO SUL";14;1;11;26
2005;"CRUZ ALTA (RS)";"RS";"CRUZ ALTA";1139;46;114;1299
2005;"CRUZALTENSE (RS)";"RS";"CRUZALTENSE";51;1;6;58
2005;"CRUZEIRO DO SUL (RS)";"RS";"CRUZEIRO DO SUL";239;6;13;258
2005;"DAVID CANABARRO (RS)";"RS";"DAVID CANABARRO";144;3;17;164
2005;"DERRUBADAS (RS)";"RS";"DERRUBADAS";59;10;2;71
2005;"DEZESSEIS DE NOVEMBRO (RS)";"RS";"DEZESSEIS DE NOVEMBRO";41;1;5;47
2005;"DILERMANDO DE AGUIAR (RS)";"RS";"DILERMANDO DE AGUIAR";23;1;17;41
2005;"DOIS IRMAOS (RS)";"RS";"DOIS IRMAOS";350;14;107;471
2005;"DOIS IRMAOS DAS MISSOES (RS)";"RS";"DOIS IRMAOS DAS MISSOES";32;3;4;39
2005;"DOIS LAJEADOS (RS)";"RS";"DOIS LAJEADOS";92;2;8;102
2005;"DOM FELICIANO (RS)";"RS";"DOM FELICIANO";205;11;58;274
2005;"DOM PEDRITO (RS)";"RS";"DOM PEDRITO";491;22;27;540
2005;"DOM PEDRO DE ALCANTARA (RS)";"RS";"DOM PEDRO DE ALCANTARA";63;3;5;71
2005;"DONA FRANCISCA (RS)";"RS";"DONA FRANCISCA";33;1;6;40
2005;"DOUTOR MAURICIO CARDOSO (RS)";"RS";"DOUTOR MAURICIO CARDOSO";145;18;19;182
2005;"DOUTOR RICARDO (RS)";"RS";"DOUTOR RICARDO";47;2;6;55
2005;"ELDORADO DO SUL (RS)";"RS";"ELDORADO DO SUL";310;13;26;349
2005;"ENCANTADO (RS)";"RS";"ENCANTADO";479;22;94;595
2005;"ENCRUZILHADA DO SUL (RS)";"RS";"ENCRUZILHADA DO SUL";273;9;83;365
2005;"ENGENHO VELHO (RS)";"RS";"ENGENHO VELHO";21;1;6;28
2005;"ENTRE IJUIS (RS)";"RS";"ENTRE IJUIS";226;12;33;271
2005;"ENTRE RIOS DO SUL (RS)";"RS";"ENTRE RIOS DO SUL";39;9;12;60
2005;"EREBANGO (RS)";"RS";"EREBANGO";93;2;4;99
2005;"ERECHIM (RS)";"RS";"ERECHIM";1475;182;583;2240
2005;"ERNESTINA (RS)";"RS";"ERNESTINA";117;7;13;137
2005;"ERVAL GRANDE (RS)";"RS";"ERVAL GRANDE";85;8;9;102
2005;"ERVAL SECO (RS)";"RS";"ERVAL SECO";116;4;24;144
2005;"ESMERALDA (RS)";"RS";"ESMERALDA";61;2;10;73
2005;"ESPERANCA DO SUL (RS)";"RS";"ESPERANCA DO SUL";34;2;7;43
2005;"ESPUMOSO (RS)";"RS";"ESPUMOSO";505;25;61;591
2005;"ESTACAO (RS)";"RS";"ESTACAO";164;6;4;174
2005;"ESTANCIA VELHA (RS)";"RS";"ESTANCIA VELHA";645;49;123;817
2005;"ESTEIO (RS)";"RS";"ESTEIO";1054;96;211;1361
2005;"ESTRELA (RS)";"RS";"ESTRELA";631;31;75;737
2005;"ESTRELA VELHA (RS)";"RS";"ESTRELA VELHA";78;5;9;92
2005;"EUGENIO DE CASTRO (RS)";"RS";"EUGENIO DE CASTRO";77;6;5;88
2005;"FAGUNDES VARELA (RS)";"RS";"FAGUNDES VARELA";74;6;10;90
2005;"FARROUPILHA (RS)";"RS";"FARROUPILHA";1716;185;171;2072
2005;"FAXINAL DO SOTURNO (RS)";"RS";"FAXINAL DO SOTURNO";107;7;5;119
2005;"FAXINALZINHO (RS)";"RS";"FAXINALZINHO";48;3;6;57
2005;"FAZENDA VILANOVA (RS)";"RS";"FAZENDA VILANOVA";92;10;10;112
2005;"FELIZ (RS)";"RS";"FELIZ";337;23;74;434
2005;"FLORES DA CUNHA (RS)";"RS";"FLORES DA CUNHA";1175;49;84;1308
2005;"FLORIANO PEIXOTO (RS)";"RS";"FLORIANO PEIXOTO";40;8;11;59
2005;"FONTOURA XAVIER (RS)";"RS";"FONTOURA XAVIER";130;9;28;167
2005;"FORMIGUEIRO (RS)";"RS";"FORMIGUEIRO";85;3;13;101
2005;"FORQUETINHA (RS)";"RS";"FORQUETINHA";34;2;2;38
2005;"FORTALEZA DOS VALOS (RS)";"RS";"FORTALEZA DOS VALOS";236;2;11;249
2005;"FREDERICO WESTPHALEN (RS)";"RS";"FREDERICO WESTPHALEN";520;26;55;601
2005;"GARIBALDI (RS)";"RS";"GARIBALDI";1113;59;83;1255
2005;"GARRUCHOS (RS)";"RS";"GARRUCHOS";21;5;10;36
2005;"GAURAMA (RS)";"RS";"GAURAMA";142;9;9;160
2005;"GENERAL CAMARA (RS)";"RS";"GENERAL CAMARA";70;12;16;98
2005;"GENTIL (RS)";"RS";"GENTIL";79;5;10;94
2005;"GETULIO VARGAS (RS)";"RS";"GETULIO VARGAS";434;22;29;485
2005;"GIRUA (RS)";"RS";"GIRUA";427;20;37;484
2005;"GLORINHA (RS)";"RS";"GLORINHA";141;18;5;164
2005;"GRAMADO (RS)";"RS";"GRAMADO";571;90;96;757
2005;"GRAMADO DOS LOUREIROS (RS)";"RS";"GRAMADO DOS LOUREIROS";19;2;8;29
2005;"GRAMADO XAVIER (RS)";"RS";"GRAMADO XAVIER";51;3;8;62
2005;"GRAVATAI (RS)";"RS";"GRAVATAI";2378;303;445;3126
2005;"GUABIJU (RS)";"RS";"GUABIJU";43;5;8;56
2005;"GUAIBA (RS)";"RS";"GUAIBA";883;103;357;1343
2005;"GUAPORE (RS)";"RS";"GUAPORE";323;31;41;395
2005;"GUARANI DAS MISSOES (RS)";"RS";"GUARANI DAS MISSOES";161;5;13;179
2005;"HARMONIA (RS)";"RS";"HARMONIA";176;4;6;186
2005;"HERVAL (RS)";"RS";"HERVAL";79;2;7;88
2005;"HERVEIRAS (RS)";"RS";"HERVEIRAS";42;3;2;47
2005;"HORIZONTINA (RS)";"RS";"HORIZONTINA";282;34;54;370
2005;"HULHA NEGRA (RS)";"RS";"HULHA NEGRA";22;7;13;42
2005;"HUMAITA (RS)";"RS";"HUMAITA";87;5;8;100
2005;"IBARAMA (RS)";"RS";"IBARAMA";77;4;14;95
2005;"IBIACA (RS)";"RS";"IBIACA";221;6;11;238
2005;"IBIRAIARAS (RS)";"RS";"IBIRAIARAS";370;6;19;395
2005;"IBIRAPUITA (RS)";"RS";"IBIRAPUITA";94;4;16;114
2005;"IBIRUBA (RS)";"RS";"IBIRUBA";759;24;54;837
2005;"IGREJINHA (RS)";"RS";"IGREJINHA";300;31;63;394
2005;"IJUI (RS)";"RS";"IJUI";1583;74;120;1777
2005;"ILOPOLIS (RS)";"RS";"ILOPOLIS";119;13;5;137
2005;"IMBE (RS)";"RS";"IMBE";151;13;37;201
2005;"IMIGRANTE (RS)";"RS";"IMIGRANTE";83;14;20;117
2005;"INDEPENDENCIA (RS)";"RS";"INDEPENDENCIA";154;18;30;202
2005;"INHACORA (RS)";"RS";"INHACORA";53;5;5;63
2005;"IPE (RS)";"RS";"IPE";199;14;22;235
2005;"IPIRANGA DO SUL (RS)";"RS";"IPIRANGA DO SUL";85;5;6;96
2005;"IRAI (RS)";"RS";"IRAI";91;14;17;122
2005;"ITAARA (RS)";"RS";"ITAARA";111;2;7;120
2005;"ITACURUBI (RS)";"RS";"ITACURUBI";24;5;8;37
2005;"ITAPUCA (RS)";"RS";"ITAPUCA";29;5;6;40
2005;"ITAQUI (RS)";"RS";"ITAQUI";539;10;43;592
2005;"ITATI (RS)";"RS";"ITATI";49;3;4;56
2005;"ITATIBA DO SUL (RS)";"RS";"ITATIBA DO SUL";63;9;5;77
2005;"IVORA (RS)";"RS";"IVORA";53;4;3;60
2005;"IVOTI (RS)";"RS";"IVOTI";419;33;97;549
2005;"JABOTICABA (RS)";"RS";"JABOTICABA";50;2;15;67
2005;"JACUIZINHO (RS)";"RS";"JACUIZINHO";29;4;4;37
2005;"JACUTINGA (RS)";"RS";"JACUTINGA";92;11;8;111
2005;"JAGUARAO (RS)";"RS";"JAGUARAO";283;11;26;320
2005;"JAGUARI (RS)";"RS";"JAGUARI";190;16;41;247
2005;"JAQUIRANA (RS)";"RS";"JAQUIRANA";138;4;6;148
2005;"JARI (RS)";"RS";"JARI";34;1;10;45
2005;"JOIA (RS)";"RS";"JOIA";251;5;24;280
2005;"JULIO DE CASTILHOS (RS)";"RS";"JULIO DE CASTILHOS";490;16;47;553
2005;"LAGOA BONITA DO SUL (RS)";"RS";"LAGOA BONITA DO SUL";37;1;16;54
2005;"LAGOA DOS TRES CANTOS (RS)";"RS";"LAGOA DOS TRES CANTOS";62;7;6;75
2005;"LAGOA VERMELHA (RS)";"RS";"LAGOA VERMELHA";528;20;72;620
2005;"LAGOAO (RS)";"RS";"LAGOAO";48;1;20;69
2005;"LAJEADO (RS)";"RS";"LAJEADO";1577;102;238;1917
2005;"LAJEADO DO BUGRE (RS)";"RS";"LAJEADO DO BUGRE";22;1;5;28
2005;"LAVRAS DO SUL (RS)";"RS";"LAVRAS DO SUL";62;12;18;92
2005;"LIBERATO SALZANO (RS)";"RS";"LIBERATO SALZANO";87;7;17;111
2005;"LINDOLFO COLLOR (RS)";"RS";"LINDOLFO COLLOR";89;10;14;113
2005;"LINHA NOVA (RS)";"RS";"LINHA NOVA";57;6;6;69
2005;"MACAMBARA (RS)";"RS";"MACAMBARA";24;0;18;42
2005;"MACHADINHO (RS)";"RS";"MACHADINHO";86;4;17;107
2005;"MAMPITUBA (RS)";"RS";"MAMPITUBA";16;0;5;21
2005;"MANOEL VIANA (RS)";"RS";"MANOEL VIANA";128;4;8;140
2005;"MAQUINE (RS)";"RS";"MAQUINE";218;11;9;238
2005;"MARATA (RS)";"RS";"MARATA";76;8;25;109
2005;"MARAU (RS)";"RS";"MARAU";775;51;115;941
2005;"MARCELINO RAMOS (RS)";"RS";"MARCELINO RAMOS";106;18;13;137
2005;"MARIANA PIMENTEL (RS)";"RS";"MARIANA PIMENTEL";86;3;16;105
2005;"MARIANO MORO (RS)";"RS";"MARIANO MORO";54;11;5;70
2005;"MARQUES DE SOUZA (RS)";"RS";"MARQUES DE SOUZA";97;12;13;122
2005;"MATA (RS)";"RS";"MATA";75;3;18;96
2005;"MATO CASTELHANO (RS)";"RS";"MATO CASTELHANO";102;4;16;122
2005;"MATO LEITAO (RS)";"RS";"MATO LEITAO";164;5;9;178
2005;"MATO QUEIMADO (RS)";"RS";"MATO QUEIMADO";31;1;7;39
2005;"MAXIMILIANO DE ALMEIDA (RS)";"RS";"MAXIMILIANO DE ALMEIDA";128;6;47;181
2005;"MINAS DO LEAO (RS)";"RS";"MINAS DO LEAO";85;12;20;117
2005;"MIRAGUAI (RS)";"RS";"MIRAGUAI";52;4;15;71
2005;"MONTAURI (RS)";"RS";"MONTAURI";46;6;3;55
2005;"MONTE ALEGRE DOS CAMPOS (RS)";"RS";"MONTE ALEGRE DOS CAMPOS";49;2;18;69
2005;"MONTE BELO DO SUL (RS)";"RS";"MONTE BELO DO SUL";178;4;12;194
2005;"MONTENEGRO (RS)";"RS";"MONTENEGRO";1030;117;197;1344
2005;"MORMACO (RS)";"RS";"MORMACO";51;4;8;63
2005;"MORRINHOS DO SUL (RS)";"RS";"MORRINHOS DO SUL";110;2;6;118
2005;"MORRO REDONDO (RS)";"RS";"MORRO REDONDO";189;3;18;210
2005;"MORRO REUTER (RS)";"RS";"MORRO REUTER";124;11;30;165
2005;"MOSTARDAS (RS)";"RS";"MOSTARDAS";198;7;36;241
2005;"MUCUM (RS)";"RS";"MUCUM";85;10;21;116
2005;"MUITOS CAPOES (RS)";"RS";"MUITOS CAPOES";37;2;3;42
2005;"MULITERNO (RS)";"RS";"MULITERNO";68;3;6;77
2005;"NAO ME TOQUE (RS)";"RS";"NAO ME TOQUE";434;18;45;497
2005;"NICOLAU VERGUEIRO (RS)";"RS";"NICOLAU VERGUEIRO";73;3;11;87
2005;"NONOAI (RS)";"RS";"NONOAI";157;12;33;202
2005;"NOVA ALVORADA (RS)";"RS";"NOVA ALVORADA";115;2;6;123
2005;"NOVA ARACA (RS)";"RS";"NOVA ARACA";140;14;20;174
2005;"NOVA BASSANO (RS)";"RS";"NOVA BASSANO";337;19;24;380
2005;"NOVA BOA VISTA (RS)";"RS";"NOVA BOA VISTA";50;7;7;64
2005;"NOVA BRESCIA (RS)";"RS";"NOVA BRESCIA";83;10;6;99
2005;"NOVA CANDELARIA (RS)";"RS";"NOVA CANDELARIA";57;5;8;70
2005;"NOVA ESPERANCA DO SUL (RS)";"RS";"NOVA ESPERANCA DO SUL";42;11;21;74
2005;"NOVA HARTZ (RS)";"RS";"NOVA HARTZ";97;13;50;160
2005;"NOVA PADUA (RS)";"RS";"NOVA PADUA";248;5;5;258
2005;"NOVA PALMA (RS)";"RS";"NOVA PALMA";175;8;17;200
2005;"NOVA PETROPOLIS (RS)";"RS";"NOVA PETROPOLIS";456;33;76;565
2005;"NOVA PRATA (RS)";"RS";"NOVA PRATA";499;23;43;565
2005;"NOVA RAMADA (RS)";"RS";"NOVA RAMADA";66;2;10;78
2005;"NOVA ROMA DO SUL (RS)";"RS";"NOVA ROMA DO SUL";177;10;17;204
2005;"NOVA SANTA RITA (RS)";"RS";"NOVA SANTA RITA";399;42;34;475
2005;"NOVO BARREIRO (RS)";"RS";"NOVO BARREIRO";73;10;10;93
2005;"NOVO CABRAIS (RS)";"RS";"NOVO CABRAIS";57;2;6;65
2005;"NOVO HAMBURGO (RS)";"RS";"NOVO HAMBURGO";2280;212;456;2948
2005;"NOVO MACHADO (RS)";"RS";"NOVO MACHADO";121;18;5;144
2005;"NOVO TIRADENTES (RS)";"RS";"NOVO TIRADENTES";22;0;9;31
2005;"NOVO XINGU (RS)";"RS";"NOVO XINGU";21;4;7;32
2005;"OSORIO (RS)";"RS";"OSORIO";683;35;117;835
2005;"PAIM FILHO (RS)";"RS";"PAIM FILHO";99;6;15;120
2005;"PALMARES DO SUL (RS)";"RS";"PALMARES DO SUL";151;15;27;193
2005;"PALMEIRA DAS MISSOES (RS)";"RS";"PALMEIRA DAS MISSOES";686;23;52;761
2005;"PALMITINHO (RS)";"RS";"PALMITINHO";111;7;20;138
2005;"PANAMBI (RS)";"RS";"PANAMBI";832;33;98;963
2005;"PANTANO GRANDE (RS)";"RS";"PANTANO GRANDE";256;10;19;285
2005;"PARAI (RS)";"RS";"PARAI";257;12;23;292
2005;"PARAISO DO SUL (RS)";"RS";"PARAISO DO SUL";78;3;8;89
2005;"PARECI NOVO (RS)";"RS";"PARECI NOVO";382;6;23;411
2005;"PAROBE (RS)";"RS";"PAROBE";376;53;118;547
2005;"PASSA SETE (RS)";"RS";"PASSA SETE";55;3;17;75
2005;"PASSO DO SOBRADO (RS)";"RS";"PASSO DO SOBRADO";120;6;41;167
2005;"PASSO FUNDO (RS)";"RS";"PASSO FUNDO";2523;140;306;2969
2005;"PAULO BENTO (RS)";"RS";"PAULO BENTO";52;9;5;66
2005;"PAVERAMA (RS)";"RS";"PAVERAMA";131;18;39;188
2005;"PEDRAS ALTAS (RS)";"RS";"PEDRAS ALTAS";10;6;4;20
2005;"PEDRO OSORIO (RS)";"RS";"PEDRO OSORIO";92;6;21;119
2005;"PEJUCARA (RS)";"RS";"PEJUCARA";192;3;13;208
2005;"PELOTAS (RS)";"RS";"PELOTAS";4332;174;911;5417
2005;"PICADA CAFE (RS)";"RS";"PICADA CAFE";78;15;36;129
2005;"PINHAL (RS)";"RS";"PINHAL";41;2;9;52
2005;"PINHAL DA SERRA (RS)";"RS";"PINHAL DA SERRA";26;4;6;36
2005;"PINHAL GRANDE (RS)";"RS";"PINHAL GRANDE";72;10;12;94
2005;"PINHEIRINHO DO VALE (RS)";"RS";"PINHEIRINHO DO VALE";38;0;12;50
2005;"PINHEIRO MACHADO (RS)";"RS";"PINHEIRO MACHADO";128;9;25;162
2005;"PINTO BANDEIRA (RS)";"RS";"PINTO BANDEIRA";9;0;0;9
2005;"PIRAPO (RS)";"RS";"PIRAPO";19;4;5;28
2005;"PIRATINI (RS)";"RS";"PIRATINI";218;14;79;311
2005;"PLANALTO (RS)";"RS";"PLANALTO";147;5;28;180
2005;"POCO DAS ANTAS (RS)";"RS";"POCO DAS ANTAS";64;8;13;85
2005;"PONTAO (RS)";"RS";"PONTAO";68;4;16;88
2005;"PONTE PRETA (RS)";"RS";"PONTE PRETA";42;6;4;52
2005;"PORTAO (RS)";"RS";"PORTAO";1240;59;90;1389
2005;"PORTO ALEGRE (RS)";"RS";"PORTO ALEGRE";12524;1965;3452;17941
2005;"PORTO LUCENA (RS)";"RS";"PORTO LUCENA";74;6;16;96
2005;"PORTO MAUA (RS)";"RS";"PORTO MAUA";32;5;6;43
2005;"PORTO VERA CRUZ (RS)";"RS";"PORTO VERA CRUZ";7;1;3;11
2005;"PORTO XAVIER (RS)";"RS";"PORTO XAVIER";160;8;25;193
2005;"POUSO NOVO (RS)";"RS";"POUSO NOVO";24;3;4;31
2005;"PRESIDENTE LUCENA (RS)";"RS";"PRESIDENTE LUCENA";87;4;5;96
2005;"PROGRESSO (RS)";"RS";"PROGRESSO";95;9;17;121
2005;"PROTASIO ALVES (RS)";"RS";"PROTASIO ALVES";48;3;6;57
2005;"PUTINGA (RS)";"RS";"PUTINGA";67;4;8;79
2005;"QUARAI (RS)";"RS";"QUARAI";130;9;33;172
2005;"QUATRO IRMAOS (RS)";"RS";"QUATRO IRMAOS";36;9;3;48
2005;"QUEVEDOS (RS)";"RS";"QUEVEDOS";20;0;6;26
2005;"QUINZE DE NOVEMBRO (RS)";"RS";"QUINZE DE NOVEMBRO";156;8;17;181
2005;"REDENTORA (RS)";"RS";"REDENTORA";74;4;12;90
2005;"RELVADO (RS)";"RS";"RELVADO";32;6;4;42
2005;"RESTINGA SECA (RS)";"RS";"RESTINGA SECA";238;5;45;288
2005;"RIO DOS INDIOS (RS)";"RS";"RIO DOS INDIOS";46;2;16;64
2005;"RIO GRANDE (RS)";"RS";"RIO GRANDE";1544;91;374;2009
2005;"RIO PARDO (RS)";"RS";"RIO PARDO";346;27;60;433
2005;"RIOZINHO (RS)";"RS";"RIOZINHO";39;4;24;67
2005;"ROCA SALES (RS)";"RS";"ROCA SALES";133;13;34;180
2005;"RODEIO BONITO (RS)";"RS";"RODEIO BONITO";75;4;26;105
2005;"ROLADOR (RS)";"RS";"ROLADOR";31;3;7;41
2005;"ROLANTE (RS)";"RS";"ROLANTE";159;11;47;217
2005;"RONDA ALTA (RS)";"RS";"RONDA ALTA";223;13;21;257
2005;"RONDINHA (RS)";"RS";"RONDINHA";124;10;18;152
2005;"ROQUE GONZALES (RS)";"RS";"ROQUE GONZALES";93;2;18;113
2005;"ROSARIO DO SUL (RS)";"RS";"ROSARIO DO SUL";382;17;41;440
2005;"SAGRADA FAMILIA (RS)";"RS";"SAGRADA FAMILIA";15;3;5;23
2005;"SALDANHA MARINHO (RS)";"RS";"SALDANHA MARINHO";127;8;9;144
2005;"SALTO DO JACUI (RS)";"RS";"SALTO DO JACUI";166;14;20;200
2005;"SALVADOR DAS MISSOES (RS)";"RS";"SALVADOR DAS MISSOES";72;1;7;80
2005;"SALVADOR DO SUL (RS)";"RS";"SALVADOR DO SUL";203;16;33;252
2005;"SANANDUVA (RS)";"RS";"SANANDUVA";484;12;45;541
2005;"SANTA BARBARA DO SUL (RS)";"RS";"SANTA BARBARA DO SUL";303;12;27;342
2005;"SANTA CECILIA DO SUL (RS)";"RS";"SANTA CECILIA DO SUL";30;3;8;41
2005;"SANTA CLARA DO SUL (RS)";"RS";"SANTA CLARA DO SUL";101;15;10;126
2005;"SANTA CRUZ DO SUL (RS)";"RS";"SANTA CRUZ DO SUL";1503;127;473;2103
2005;"SANTA MARGARIDA DO SUL (RS)";"RS";"SANTA MARGARIDA DO SUL";30;5;2;37
2005;"SANTA MARIA (RS)";"RS";"SANTA MARIA";2500;240;858;3598
2005;"SANTA MARIA DO HERVAL (RS)";"RS";"SANTA MARIA DO HERVAL";149;8;49;206
2005;"SANTA ROSA (RS)";"RS";"SANTA ROSA";1206;73;143;1422
2005;"SANTA TEREZA (RS)";"RS";"SANTA TEREZA";66;5;5;76
2005;"SANTA VITORIA DO PALMAR (RS)";"RS";"SANTA VITORIA DO PALMAR";436;11;64;511
2005;"SANTANA DA BOA VISTA (RS)";"RS";"SANTANA DA BOA VISTA";50;5;28;83
2005;"SANTANA DO LIVRAMENTO (RS)";"RS";"SANTANA DO LIVRAMENTO";604;36;115;755
2005;"SANTIAGO (RS)";"RS";"SANTIAGO";645;39;79;763
2005;"SANTO ANGELO (RS)";"RS";"SANTO ANGELO";976;69;88;1133
2005;"SANTO ANTONIO DA PATRULHA (RS)";"RS";"SANTO ANTONIO DA PATRULHA";655;33;124;812
2005;"SANTO ANTONIO DAS MISSOES (RS)";"RS";"SANTO ANTONIO DAS MISSOES";139;22;18;179
2005;"SANTO ANTONIO DO PALMA (RS)";"RS";"SANTO ANTONIO DO PALMA";34;3;8;45
2005;"SANTO ANTONIO DO PLANALTO (RS)";"RS";"SANTO ANTONIO DO PLANALTO";74;1;6;81
2005;"SANTO AUGUSTO (RS)";"RS";"SANTO AUGUSTO";423;22;21;466
2005;"SANTO CRISTO (RS)";"RS";"SANTO CRISTO";324;17;52;393
2005;"SANTO EXPEDITO DO SUL (RS)";"RS";"SANTO EXPEDITO DO SUL";75;3;7;85
2005;"SAO BORJA (RS)";"RS";"SAO BORJA";952;24;85;1061
2005;"SAO DOMINGOS DO SUL (RS)";"RS";"SAO DOMINGOS DO SUL";71;5;3;79
2005;"SAO FRANCISCO DE ASSIS (RS)";"RS";"SAO FRANCISCO DE ASSIS";225;8;61;294
2005;"SAO FRANCISCO DE PAULA (RS)";"RS";"SAO FRANCISCO DE PAULA";435;23;37;495
2005;"SAO GABRIEL (RS)";"RS";"SAO GABRIEL";730;16;77;823
2005;"SAO JERONIMO (RS)";"RS";"SAO JERONIMO";240;15;99;354
2005;"SAO JOAO DA URTIGA (RS)";"RS";"SAO JOAO DA URTIGA";129;3;13;145
2005;"SAO JOAO DO POLESINE (RS)";"RS";"SAO JOAO DO POLESINE";54;0;6;60
2005;"SAO JORGE (RS)";"RS";"SAO JORGE";121;7;20;148
2005;"SAO JOSE DAS MISSOES (RS)";"RS";"SAO JOSE DAS MISSOES";32;2;6;40
2005;"SAO JOSE DO HERVAL (RS)";"RS";"SAO JOSE DO HERVAL";52;2;11;65
2005;"SAO JOSE DO HORTENCIO (RS)";"RS";"SAO JOSE DO HORTENCIO";179;5;42;226
2005;"SAO JOSE DO INHACORA (RS)";"RS";"SAO JOSE DO INHACORA";30;4;6;40
2005;"SAO JOSE DO NORTE (RS)";"RS";"SAO JOSE DO NORTE";255;3;40;298
2005;"SAO JOSE DO OURO (RS)";"RS";"SAO JOSE DO OURO";229;6;18;253
2005;"SAO JOSE DO SUL (RS)";"RS";"SAO JOSE DO SUL";86;13;2;101
2005;"SAO JOSE DOS AUSENTES (RS)";"RS";"SAO JOSE DOS AUSENTES";70;4;8;82
2005;"SAO LEOPOLDO (RS)";"RS";"SAO LEOPOLDO";1612;173;459;2244
2005;"SAO LOURENCO DO SUL (RS)";"RS";"SAO LOURENCO DO SUL";842;32;109;983
2005;"SAO LUIZ GONZAGA (RS)";"RS";"SAO LUIZ GONZAGA";464;38;62;564
2005;"SAO MARCOS (RS)";"RS";"SAO MARCOS";585;13;83;681
2005;"SAO MARTINHO (RS)";"RS";"SAO MARTINHO";161;9;11;181
2005;"SAO MARTINHO DA SERRA (RS)";"RS";"SAO MARTINHO DA SERRA";27;2;3;32
2005;"SAO MIGUEL DAS MISSOES (RS)";"RS";"SAO MIGUEL DAS MISSOES";171;11;30;212
2005;"SAO NICOLAU (RS)";"RS";"SAO NICOLAU";52;3;9;64
2005;"SAO PAULO DAS MISSOES (RS)";"RS";"SAO PAULO DAS MISSOES";88;4;18;110
2005;"SAO PEDRO DA SERRA (RS)";"RS";"SAO PEDRO DA SERRA";92;6;10;108
2005;"SAO PEDRO DAS MISSOES (RS)";"RS";"SAO PEDRO DAS MISSOES";21;3;4;28
2005;"SAO PEDRO DO BUTIA (RS)";"RS";"SAO PEDRO DO BUTIA";88;1;8;97
2005;"SAO PEDRO DO SUL (RS)";"RS";"SAO PEDRO DO SUL";217;23;41;281
2005;"SAO SEBASTIAO DO CAI (RS)";"RS";"SAO SEBASTIAO DO CAI";613;22;60;695
2005;"SAO SEPE (RS)";"RS";"SAO SEPE";364;8;63;435
2005;"SAO VALENTIM (RS)";"RS";"SAO VALENTIM";53;3;7;63
2005;"SAO VALENTIM DO SUL (RS)";"RS";"SAO VALENTIM DO SUL";63;2;12;77
2005;"SAO VALERIO DO SUL (RS)";"RS";"SAO VALERIO DO SUL";35;3;6;44
2005;"SAO VENDELINO (RS)";"RS";"SAO VENDELINO";63;7;2;72
2005;"SAO VICENTE DO SUL (RS)";"RS";"SAO VICENTE DO SUL";99;5;22;126
2005;"SAPIRANGA (RS)";"RS";"SAPIRANGA";747;90;150;987
2005;"SAPUCAIA DO SUL (RS)";"RS";"SAPUCAIA DO SUL";1302;141;174;1617
2005;"SARANDI (RS)";"RS";"SARANDI";490;19;51;560
2005;"SEBERI (RS)";"RS";"SEBERI";192;7;29;228
2005;"SEDE NOVA (RS)";"RS";"SEDE NOVA";51;6;10;67
2005;"SEGREDO (RS)";"RS";"SEGREDO";89;4;19;112
2005;"SELBACH (RS)";"RS";"SELBACH";238;6;11;255
2005;"SENADOR SALGADO FILHO (RS)";"RS";"SENADOR SALGADO FILHO";84;5;13;102
2005;"SENTINELA DO SUL (RS)";"RS";"SENTINELA DO SUL";97;3;5;105
2005;"SERAFINA CORREA (RS)";"RS";"SERAFINA CORREA";225;29;34;288
2005;"SERIO (RS)";"RS";"SERIO";51;6;5;62
2005;"SERTAO (RS)";"RS";"SERTAO";214;10;24;248
2005;"SERTAO SANTANA (RS)";"RS";"SERTAO SANTANA";143;7;17;167
2005;"SETE DE SETEMBRO (RS)";"RS";"SETE DE SETEMBRO";46;1;5;52
2005;"SEVERIANO DE ALMEIDA (RS)";"RS";"SEVERIANO DE ALMEIDA";68;8;9;85
2005;"SILVEIRA MARTINS (RS)";"RS";"SILVEIRA MARTINS";98;1;5;104
2005;"SINIMBU (RS)";"RS";"SINIMBU";101;4;4;109
2005;"SOBRADINHO (RS)";"RS";"SOBRADINHO";239;18;49;306
2005;"SOLEDADE (RS)";"RS";"SOLEDADE";403;16;83;502
2005;"TABAI (RS)";"RS";"TABAI";107;13;7;127
2005;"TAPEJARA (RS)";"RS";"TAPEJARA";541;15;58;614
2005;"TAPERA (RS)";"RS";"TAPERA";306;19;24;349
2005;"TAPES (RS)";"RS";"TAPES";259;10;19;288
2005;"TAQUARA (RS)";"RS";"TAQUARA";610;51;224;885
2005;"TAQUARI (RS)";"RS";"TAQUARI";367;36;103;506
2005;"TAQUARUCU DO SUL (RS)";"RS";"TAQUARUCU DO SUL";49;2;9;60
2005;"TAVARES (RS)";"RS";"TAVARES";76;3;8;87
2005;"TENENTE PORTELA (RS)";"RS";"TENENTE PORTELA";228;5;29;262
2005;"TERRA DE AREIA (RS)";"RS";"TERRA DE AREIA";263;16;23;302
2005;"TEUTONIA (RS)";"RS";"TEUTONIA";469;32;63;564
2005;"TIO HUGO (RS)";"RS";"TIO HUGO";57;5;4;66
2005;"TIRADENTES DO SUL (RS)";"RS";"TIRADENTES DO SUL";78;5;7;90
2005;"TOROPI (RS)";"RS";"TOROPI";39;2;13;54
2005;"TORRES (RS)";"RS";"TORRES";329;21;58;408
2005;"TRAMANDAI (RS)";"RS";"TRAMANDAI";454;51;135;640
2005;"TRAVESSEIRO (RS)";"RS";"TRAVESSEIRO";30;5;7;42
2005;"TRES ARROIOS (RS)";"RS";"TRES ARROIOS";60;8;2;70
2005;"TRES CACHOEIRAS (RS)";"RS";"TRES CACHOEIRAS";560;7;10;577
2005;"TRES COROAS (RS)";"RS";"TRES COROAS";174;27;50;251
2005;"TRES DE MAIO (RS)";"RS";"TRES DE MAIO";582;52;72;706
2005;"TRES FORQUILHAS (RS)";"RS";"TRES FORQUILHAS";68;2;2;72
2005;"TRES PALMEIRAS (RS)";"RS";"TRES PALMEIRAS";62;3;11;76
2005;"TRES PASSOS (RS)";"RS";"TRES PASSOS";374;17;107;498
2005;"TRINDADE DO SUL (RS)";"RS";"TRINDADE DO SUL";80;3;15;98
2005;"TRIUNFO (RS)";"RS";"TRIUNFO";345;64;119;528
2005;"TUCUNDUVA (RS)";"RS";"TUCUNDUVA";198;10;15;223
2005;"TUNAS (RS)";"RS";"TUNAS";28;2;12;42
2005;"TUPANCI DO SUL (RS)";"RS";"TUPANCI DO SUL";46;2;8;56
2005;"TUPANCIRETA (RS)";"RS";"TUPANCIRETA";451;22;36;509
2005;"TUPANDI (RS)";"RS";"TUPANDI";55;14;19;88
2005;"TUPARENDI (RS)";"RS";"TUPARENDI";174;8;22;204
2005;"TURUCU (RS)";"RS";"TURUCU";66;6;7;79
2005;"UBIRETAMA (RS)";"RS";"UBIRETAMA";57;2;4;63
2005;"UNIAO DA SERRA (RS)";"RS";"UNIAO DA SERRA";46;3;9;58
2005;"UNISTALDA (RS)";"RS";"UNISTALDA";22;1;7;30
2005;"URUGUAIANA (RS)";"RS";"URUGUAIANA";1614;60;142;1816
2005;"VACARIA (RS)";"RS";"VACARIA";1419;79;316;1814
2005;"VALE DO SOL (RS)";"RS";"VALE DO SOL";154;6;24;184
2005;"VALE REAL (RS)";"RS";"VALE REAL";212;10;17;239
2005;"VALE VERDE (RS)";"RS";"VALE VERDE";31;3;4;38
2005;"VANINI (RS)";"RS";"VANINI";72;10;10;92
2005;"VENANCIO AIRES (RS)";"RS";"VENANCIO AIRES";957;53;160;1170
2005;"VERA CRUZ (RS)";"RS";"VERA CRUZ";290;10;71;371
2005;"VERANOPOLIS (RS)";"RS";"VERANOPOLIS";786;30;55;871
2005;"VESPASIANO CORREA (RS)";"RS";"VESPASIANO CORREA";58;5;12;75
2005;"VIADUTOS (RS)";"RS";"VIADUTOS";115;7;13;135
2005;"VIAMAO (RS)";"RS";"VIAMAO";1479;192;470;2141
2005;"VICENTE DUTRA (RS)";"RS";"VICENTE DUTRA";39;1;13;53
2005;"VICTOR GRAEFF (RS)";"RS";"VICTOR GRAEFF";137;18;4;159
2005;"VILA FLORES (RS)";"RS";"VILA FLORES";145;15;10;170
2005;"VILA LANGARO (RS)";"RS";"VILA LANGARO";69;4;10;83
2005;"VILA MARIA (RS)";"RS";"VILA MARIA";190;7;29;226
2005;"VILA NOVA DO SUL (RS)";"RS";"VILA NOVA DO SUL";68;1;7;76
2005;"VISTA ALEGRE (RS)";"RS";"VISTA ALEGRE";43;0;10;53
2005;"VISTA ALEGRE DO PRATA (RS)";"RS";"VISTA ALEGRE DO PRATA";24;5;4;33
2005;"VISTA GAUCHA (RS)";"RS";"VISTA GAUCHA";40;2;8;50
2005;"VITORIA DAS MISSOES (RS)";"RS";"VITORIA DAS MISSOES";74;2;10;86
2005;"WESTFALIA (RS)";"RS";"WESTFALIA";93;17;8;118
2005;"XANGRI LA (RS)";"RS";"XANGRI LA";109;7;4;120
2005;"ABDON BATISTA (SC)";"SC";"ABDON BATISTA";35;2;8;45
2005;"ABELARDO LUZ (SC)";"SC";"ABELARDO LUZ";297;11;39;347
2005;"AGROLANDIA (SC)";"SC";"AGROLANDIA";167;10;14;191
2005;"AGRONOMICA (SC)";"SC";"AGRONOMICA";113;1;9;123
2005;"AGUA DOCE (SC)";"SC";"AGUA DOCE";136;9;10;155
2005;"AGUAS DE CHAPECO (SC)";"SC";"AGUAS DE CHAPECO";59;5;13;77
2005;"AGUAS FRIAS (SC)";"SC";"AGUAS FRIAS";27;1;4;32
2005;"AGUAS MORNAS (SC)";"SC";"AGUAS MORNAS";185;2;7;194
2005;"ALFREDO WAGNER (SC)";"SC";"ALFREDO WAGNER";186;18;8;212
2005;"ALTO BELA VISTA (SC)";"SC";"ALTO BELA VISTA";41;4;7;52
2005;"ANCHIETA (SC)";"SC";"ANCHIETA";120;12;11;143
2005;"ANGELINA (SC)";"SC";"ANGELINA";133;12;8;153
2005;"ANITA GARIBALDI (SC)";"SC";"ANITA GARIBALDI";113;8;17;138
2005;"ANITAPOLIS (SC)";"SC";"ANITAPOLIS";65;5;9;79
2005;"ANTONIO CARLOS (SC)";"SC";"ANTONIO CARLOS";459;3;6;468
2005;"APIUNA (SC)";"SC";"APIUNA";120;11;11;142
2005;"ARABUTA (SC)";"SC";"ARABUTA";73;5;21;99
2005;"ARAQUARI (SC)";"SC";"ARAQUARI";239;9;18;266
2005;"ARARANGUA (SC)";"SC";"ARARANGUA";1107;44;135;1286
2005;"ARMAZEM (SC)";"SC";"ARMAZEM";200;7;4;211
2005;"ARROIO TRINTA (SC)";"SC";"ARROIO TRINTA";119;6;8;133
2005;"ARVOREDO (SC)";"SC";"ARVOREDO";24;4;4;32
2005;"ASCURRA (SC)";"SC";"ASCURRA";158;11;21;190
2005;"ATALANTA (SC)";"SC";"ATALANTA";71;3;4;78
2005;"AURORA (SC)";"SC";"AURORA";121;4;6;131
2005;"BALNEARIO ARROIO DO SILVA (SC)";"SC";"BALNEARIO ARROIO DO SILVA";62;7;15;84
2005;"BALNEARIO CAMBORIU (SC)";"SC";"BALNEARIO CAMBORIU";688;158;148;994
2005;"BALNEARIO GAIVOTA (SC)";"SC";"BALNEARIO GAIVOTA";116;3;7;126
2005;"BANDEIRANTE (SC)";"SC";"BANDEIRANTE";18;1;12;31
2005;"BARRA BONITA (SC)";"SC";"BARRA BONITA";24;1;8;33
2005;"BARRA DO SUL (SC)";"SC";"BARRA DO SUL";64;4;2;70
2005;"BARRA VELHA (SC)";"SC";"BARRA VELHA";218;14;14;246
2005;"BELA VISTA DO TOLDO (SC)";"SC";"BELA VISTA DO TOLDO";61;2;7;70
2005;"BELMONTE (SC)";"SC";"BELMONTE";41;2;3;46
2005;"BENEDITO NOVO (SC)";"SC";"BENEDITO NOVO";227;16;17;260
2005;"BIGUACU (SC)";"SC";"BIGUACU";664;43;167;874
2005;"BLUMENAU (SC)";"SC";"BLUMENAU";3766;305;707;4778
2005;"BOCAINA DO SUL (SC)";"SC";"BOCAINA DO SUL";31;6;12;49
2005;"BOM JARDIM DA SERRA (SC)";"SC";"BOM JARDIM DA SERRA";80;0;14;94
2005;"BOM JESUS (SC)";"SC";"BOM JESUS";42;0;6;48
2005;"BOM JESUS DO OESTE (SC)";"SC";"BOM JESUS DO OESTE";34;2;9;45
2005;"BOM RETIRO (SC)";"SC";"BOM RETIRO";125;12;13;150
2005;"BOMBINHAS (SC)";"SC";"BOMBINHAS";89;16;14;119
2005;"BOTUVERA (SC)";"SC";"BOTUVERA";151;2;8;161
2005;"BRACO DO NORTE (SC)";"SC";"BRACO DO NORTE";717;36;45;798
2005;"BRACO DO TROMBUDO (SC)";"SC";"BRACO DO TROMBUDO";98;5;5;108
2005;"BRUNOPOLIS (SC)";"SC";"BRUNOPOLIS";43;3;6;52
2005;"BRUSQUE (SC)";"SC";"BRUSQUE";1570;79;145;1794
2005;"CACADOR (SC)";"SC";"CACADOR";1672;75;732;2479
2005;"CAIBI (SC)";"SC";"CAIBI";133;4;18;155
2005;"CALMON (SC)";"SC";"CALMON";35;4;17;56
2005;"CAMBORIU (SC)";"SC";"CAMBORIU";630;23;34;687
2005;"CAMPO ALEGRE (SC)";"SC";"CAMPO ALEGRE";313;12;8;333
2005;"CAMPO BELO DO SUL (SC)";"SC";"CAMPO BELO DO SUL";162;4;18;184
2005;"CAMPO ERE (SC)";"SC";"CAMPO ERE";193;10;25;228
2005;"CAMPOS NOVOS (SC)";"SC";"CAMPOS NOVOS";787;27;82;896
2005;"CANELINHA (SC)";"SC";"CANELINHA";389;6;5;400
2005;"CANOINHAS (SC)";"SC";"CANOINHAS";1047;44;105;1196
2005;"CAPAO ALTO (SC)";"SC";"CAPAO ALTO";30;3;6;39
2005;"CAPINZAL (SC)";"SC";"CAPINZAL";356;21;24;401
2005;"CAPIVARI DE BAIXO (SC)";"SC";"CAPIVARI DE BAIXO";222;9;24;255
2005;"CATANDUVAS (SC)";"SC";"CATANDUVAS";255;12;26;293
2005;"CAXAMBU DO SUL (SC)";"SC";"CAXAMBU DO SUL";74;2;13;89
2005;"CELSO RAMOS (SC)";"SC";"CELSO RAMOS";36;7;3;46
2005;"CERRO NEGRO (SC)";"SC";"CERRO NEGRO";22;3;11;36
2005;"CHAPADAO DO LAGEADO (SC)";"SC";"CHAPADAO DO LAGEADO";30;2;4;36
2005;"CHAPECO (SC)";"SC";"CHAPECO";2906;134;259;3299
2005;"COCAL DO SUL (SC)";"SC";"COCAL DO SUL";206;9;8;223
2005;"CONCORDIA (SC)";"SC";"CONCORDIA";1589;90;156;1835
2005;"CORDILHEIRA ALTA (SC)";"SC";"CORDILHEIRA ALTA";169;5;3;177
2005;"CORONEL FREITAS (SC)";"SC";"CORONEL FREITAS";225;5;22;252
2005;"CORONEL MARTINS (SC)";"SC";"CORONEL MARTINS";28;5;6;39
2005;"CORREIA PINTO (SC)";"SC";"CORREIA PINTO";303;19;41;363
2005;"CORUPA (SC)";"SC";"CORUPA";315;8;27;350
2005;"CRICIUMA (SC)";"SC";"CRICIUMA";2986;283;345;3614
2005;"CUNHA PORA (SC)";"SC";"CUNHA PORA";268;11;37;316
2005;"CUNHATAI (SC)";"SC";"CUNHATAI";20;2;5;27
2005;"CURITIBANOS (SC)";"SC";"CURITIBANOS";828;25;82;935
2005;"DESCANSO (SC)";"SC";"DESCANSO";174;8;22;204
2005;"DIONISIO CERQUEIRA (SC)";"SC";"DIONISIO CERQUEIRA";105;8;13;126
2005;"DONA EMMA (SC)";"SC";"DONA EMMA";72;7;6;85
2005;"DOUTOR PEDRINHO (SC)";"SC";"DOUTOR PEDRINHO";97;5;6;108
2005;"ENTRE RIOS (SC)";"SC";"ENTRE RIOS";20;0;6;26
2005;"ERMO (SC)";"SC";"ERMO";51;0;3;54
2005;"ERVAL VELHO (SC)";"SC";"ERVAL VELHO";85;2;19;106
2005;"FAXINAL DOS GUEDES (SC)";"SC";"FAXINAL DOS GUEDES";308;11;20;339
2005;"FLOR DO SERTAO (SC)";"SC";"FLOR DO SERTAO";16;4;7;27
2005;"FLORIANOPOLIS (SC)";"SC";"FLORIANOPOLIS";3012;831;1247;5090
2005;"FORMOSA DO SUL (SC)";"SC";"FORMOSA DO SUL";46;3;13;62
2005;"FORQUILHINHA (SC)";"SC";"FORQUILHINHA";411;9;31;451
2005;"FRAIBURGO (SC)";"SC";"FRAIBURGO";711;35;175;921
2005;"FREI ROGERIO (SC)";"SC";"FREI ROGERIO";61;1;12;74
2005;"GALVAO (SC)";"SC";"GALVAO";70;3;9;82
2005;"GAROPABA (SC)";"SC";"GAROPABA";151;16;31;198
2005;"GARUVA (SC)";"SC";"GARUVA";247;16;11;274
2005;"GASPAR (SC)";"SC";"GASPAR";989;48;70;1107
2005;"GOVERNADOR CELSO RAMOS (SC)";"SC";"GOVERNADOR CELSO RAMOS";110;17;7;134
2005;"GRAO PARA (SC)";"SC";"GRAO PARA";187;7;7;201
2005;"GRAVATAL (SC)";"SC";"GRAVATAL";172;6;10;188
2005;"GUABIRUBA (SC)";"SC";"GUABIRUBA";210;9;9;228
2005;"GUARACIABA (SC)";"SC";"GUARACIABA";173;6;28;207
2005;"GUARAMIRIM (SC)";"SC";"GUARAMIRIM";701;17;15;733
2005;"GUARUJA DO SUL (SC)";"SC";"GUARUJA DO SUL";147;7;14;168
2005;"GUATAMBU (SC)";"SC";"GUATAMBU";63;2;17;82
2005;"HERVAL D OESTE (SC)";"SC";"HERVAL D OESTE";227;32;46;305
2005;"IBIAM (SC)";"SC";"IBIAM";42;1;11;54
2005;"IBICARE (SC)";"SC";"IBICARE";100;5;4;109
2005;"IBIRAMA (SC)";"SC";"IBIRAMA";296;21;51;368
2005;"ICARA (SC)";"SC";"ICARA";1018;44;88;1150
2005;"ILHOTA (SC)";"SC";"ILHOTA";219;19;11;249
2005;"IMARUI (SC)";"SC";"IMARUI";80;8;19;107
2005;"IMBITUBA (SC)";"SC";"IMBITUBA";438;57;57;552
2005;"IMBUIA (SC)";"SC";"IMBUIA";139;3;14;156
2005;"INDAIAL (SC)";"SC";"INDAIAL";946;36;62;1044
2005;"IOMERE (SC)";"SC";"IOMERE";109;9;6;124
2005;"IPIRA (SC)";"SC";"IPIRA";72;5;10;87
2005;"IPORA DO OESTE (SC)";"SC";"IPORA DO OESTE";171;3;31;205
2005;"IPUACU (SC)";"SC";"IPUACU";68;5;14;87
2005;"IPUMIRIM (SC)";"SC";"IPUMIRIM";167;3;13;183
2005;"IRACEMINHA (SC)";"SC";"IRACEMINHA";70;4;17;91
2005;"IRANI (SC)";"SC";"IRANI";198;11;40;249
2005;"IRATI (SC)";"SC";"IRATI";23;5;4;32
2005;"IRINEOPOLIS (SC)";"SC";"IRINEOPOLIS";182;2;9;193
2005;"ITA (SC)";"SC";"ITA";78;10;23;111
2005;"ITAIOPOLIS (SC)";"SC";"ITAIOPOLIS";411;13;49;473
2005;"ITAJAI (SC)";"SC";"ITAJAI";3211;260;252;3723
2005;"ITAPEMA (SC)";"SC";"ITAPEMA";327;44;37;408
2005;"ITAPIRANGA (SC)";"SC";"ITAPIRANGA";196;14;38;248
2005;"ITAPOA (SC)";"SC";"ITAPOA";100;5;4;109
2005;"ITUPORANGA (SC)";"SC";"ITUPORANGA";494;13;36;543
2005;"JABORA (SC)";"SC";"JABORA";91;6;15;112
2005;"JACINTO MACHADO (SC)";"SC";"JACINTO MACHADO";328;6;20;354
2005;"JAGUARUNA (SC)";"SC";"JAGUARUNA";349;11;22;382
2005;"JARAGUA DO SUL (SC)";"SC";"JARAGUA DO SUL";1884;146;241;2271
2005;"JARDINOPOLIS (SC)";"SC";"JARDINOPOLIS";22;2;3;27
2005;"JOACABA (SC)";"SC";"JOACABA";666;39;27;732
2005;"JOINVILLE (SC)";"SC";"JOINVILLE";6309;557;706;7572
2005;"JOSE BOITEUX (SC)";"SC";"JOSE BOITEUX";80;6;8;94
2005;"JUPIA (SC)";"SC";"JUPIA";36;2;5;43
2005;"LACERDOPOLIS (SC)";"SC";"LACERDOPOLIS";92;6;5;103
2005;"LAGEADO GRANDE (SC)";"SC";"LAGEADO GRANDE";29;1;5;35
2005;"LAGES (SC)";"SC";"LAGES";3063;149;287;3499
2005;"LAGUNA (SC)";"SC";"LAGUNA";413;49;66;528
2005;"LAURENTINO (SC)";"SC";"LAURENTINO";212;4;6;222
2005;"LAURO MULLER (SC)";"SC";"LAURO MULLER";301;15;26;342
2005;"LEBON REGIS (SC)";"SC";"LEBON REGIS";166;3;31;200
2005;"LEOBERTO LEAL (SC)";"SC";"LEOBERTO LEAL";99;5;6;110
2005;"LINDOIA DO SUL (SC)";"SC";"LINDOIA DO SUL";106;11;29;146
2005;"LONTRAS (SC)";"SC";"LONTRAS";208;12;7;227
2005;"LUIZ ALVES (SC)";"SC";"LUIZ ALVES";311;7;12;330
2005;"LUZERNA (SC)";"SC";"LUZERNA";90;8;15;113
2005;"MACIEIRA (SC)";"SC";"MACIEIRA";47;3;9;59
2005;"MAFRA (SC)";"SC";"MAFRA";1037;55;109;1201
2005;"MAJOR GERCINO (SC)";"SC";"MAJOR GERCINO";97;10;4;111
2005;"MAJOR VIEIRA (SC)";"SC";"MAJOR VIEIRA";133;5;9;147
2005;"MARACAJA (SC)";"SC";"MARACAJA";168;3;6;177
2005;"MARAVILHA (SC)";"SC";"MARAVILHA";434;23;43;500
2005;"MAREMA (SC)";"SC";"MAREMA";47;5;5;57
2005;"MASSARANDUBA (SC)";"SC";"MASSARANDUBA";386;15;23;424
2005;"MATOS COSTA (SC)";"SC";"MATOS COSTA";27;2;6;35
2005;"MELEIRO (SC)";"SC";"MELEIRO";170;2;14;186
2005;"MIRIM DOCE (SC)";"SC";"MIRIM DOCE";42;1;6;49
2005;"MODELO (SC)";"SC";"MODELO";78;5;5;88
2005;"MONDAI (SC)";"SC";"MONDAI";143;5;27;175
2005;"MONTE CARLO (SC)";"SC";"MONTE CARLO";168;8;63;239
2005;"MONTE CASTELO (SC)";"SC";"MONTE CASTELO";131;4;11;146
2005;"MORRO DA FUMACA (SC)";"SC";"MORRO DA FUMACA";634;29;27;690
2005;"MORRO GRANDE (SC)";"SC";"MORRO GRANDE";79;0;6;85
2005;"NAVEGANTES (SC)";"SC";"NAVEGANTES";451;44;34;529
2005;"NOVA ERECHIM (SC)";"SC";"NOVA ERECHIM";64;2;7;73
2005;"NOVA ITABERABA (SC)";"SC";"NOVA ITABERABA";52;4;14;70
2005;"NOVA TRENTO (SC)";"SC";"NOVA TRENTO";163;10;28;201
2005;"NOVA VENEZA (SC)";"SC";"NOVA VENEZA";333;29;14;376
2005;"NOVO HORIZONTE (SC)";"SC";"NOVO HORIZONTE";64;5;8;77
2005;"ORLEANS (SC)";"SC";"ORLEANS";697;5;44;746
2005;"OTACILIO COSTA (SC)";"SC";"OTACILIO COSTA";357;26;27;410
2005;"OURO (SC)";"SC";"OURO";169;15;24;208
2005;"OURO VERDE (SC)";"SC";"OURO VERDE";64;2;4;70
2005;"PAIAL (SC)";"SC";"PAIAL";9;5;6;20
2005;"PAINEL (SC)";"SC";"PAINEL";19;2;6;27
2005;"PALHOCA (SC)";"SC";"PALHOCA";1318;95;237;1650
2005;"PALMA SOLA (SC)";"SC";"PALMA SOLA";150;3;20;173
2005;"PALMEIRA (SC)";"SC";"PALMEIRA";49;6;1;56
2005;"PALMITOS (SC)";"SC";"PALMITOS";249;13;49;311
2005;"PAPANDUVA (SC)";"SC";"PAPANDUVA";419;9;46;474
2005;"PARAISO (SC)";"SC";"PARAISO";46;1;4;51
2005;"PASSO DE TORRES (SC)";"SC";"PASSO DE TORRES";85;4;13;102
2005;"PASSOS MAIA (SC)";"SC";"PASSOS MAIA";78;0;23;101
2005;"PAULO LOPES (SC)";"SC";"PAULO LOPES";163;9;9;181
2005;"PEDRAS GRANDES (SC)";"SC";"PEDRAS GRANDES";198;8;7;213
2005;"PENHA (SC)";"SC";"PENHA";223;13;26;262
2005;"PERITIBA (SC)";"SC";"PERITIBA";64;4;8;76
2005;"PETROLANDIA (SC)";"SC";"PETROLANDIA";130;6;19;155
2005;"PICARRAS (SC)";"SC";"PICARRAS";201;17;11;229
2005;"PINHALZINHO (SC)";"SC";"PINHALZINHO";318;12;35;365
2005;"PINHEIRO PRETO (SC)";"SC";"PINHEIRO PRETO";217;6;4;227
2005;"PIRATUBA (SC)";"SC";"PIRATUBA";62;9;14;85
2005;"PLANALTO ALEGRE (SC)";"SC";"PLANALTO ALEGRE";40;5;4;49
2005;"POMERODE (SC)";"SC";"POMERODE";433;23;88;544
2005;"PONTE ALTA (SC)";"SC";"PONTE ALTA";103;4;9;116
2005;"PONTE ALTA DO NORTE (SC)";"SC";"PONTE ALTA DO NORTE";57;1;8;66
2005;"PONTE SERRADA (SC)";"SC";"PONTE SERRADA";253;13;39;305
2005;"PORTO BELO (SC)";"SC";"PORTO BELO";134;11;15;160
2005;"PORTO UNIAO (SC)";"SC";"PORTO UNIAO";468;11;35;514
2005;"POUSO REDONDO (SC)";"SC";"POUSO REDONDO";310;12;22;344
2005;"PRAIA GRANDE (SC)";"SC";"PRAIA GRANDE";167;9;20;196
2005;"PRESIDENTE CASTELO BRANCO (SC)";"SC";"PRESIDENTE CASTELO BRANCO";36;4;7;47
2005;"PRESIDENTE GETULIO (SC)";"SC";"PRESIDENTE GETULIO";222;19;63;304
2005;"PRESIDENTE NEREU (SC)";"SC";"PRESIDENTE NEREU";20;5;4;29
2005;"PRINCESA (SC)";"SC";"PRINCESA";31;1;8;40
2005;"QUILOMBO (SC)";"SC";"QUILOMBO";158;11;25;194
2005;"RANCHO QUEIMADO (SC)";"SC";"RANCHO QUEIMADO";102;4;7;113
2005;"RIO DAS ANTAS (SC)";"SC";"RIO DAS ANTAS";158;7;18;183
2005;"RIO DO CAMPO (SC)";"SC";"RIO DO CAMPO";129;6;14;149
2005;"RIO DO OESTE (SC)";"SC";"RIO DO OESTE";138;11;15;164
2005;"RIO DO SUL (SC)";"SC";"RIO DO SUL";1179;44;117;1340
2005;"RIO DOS CEDROS (SC)";"SC";"RIO DOS CEDROS";201;15;27;243
2005;"RIO FORTUNA (SC)";"SC";"RIO FORTUNA";195;8;10;213
2005;"RIO NEGRINHO (SC)";"SC";"RIO NEGRINHO";787;45;62;894
2005;"RIO RUFINO (SC)";"SC";"RIO RUFINO";26;6;7;39
2005;"RIQUEZA (SC)";"SC";"RIQUEZA";76;1;15;92
2005;"RODEIO (SC)";"SC";"RODEIO";166;7;12;185
2005;"ROMELANDIA (SC)";"SC";"ROMELANDIA";78;5;14;97
2005;"SALETE (SC)";"SC";"SALETE";148;8;12;168
2005;"SALTINHO (SC)";"SC";"SALTINHO";40;2;14;56
2005;"SALTO VELOSO (SC)";"SC";"SALTO VELOSO";101;5;4;110
2005;"SANGAO (SC)";"SC";"SANGAO";317;4;9;330
2005;"SANTA CECILIA (SC)";"SC";"SANTA CECILIA";315;16;30;361
2005;"SANTA HELENA (SC)";"SC";"SANTA HELENA";47;6;7;60
2005;"SANTA ROSA DE LIMA (SC)";"SC";"SANTA ROSA DE LIMA";79;4;4;87
2005;"SANTA ROSA DO SUL (SC)";"SC";"SANTA ROSA DO SUL";221;7;13;241
2005;"SANTA TEREZINHA (SC)";"SC";"SANTA TEREZINHA";110;6;16;132
2005;"SANTA TEREZINHA DO PROGRESSO (SC)";"SC";"SANTA TEREZINHA DO PROGRESSO";37;3;9;49
2005;"SANTIAGO DO SUL (SC)";"SC";"SANTIAGO DO SUL";32;3;3;38
2005;"SANTO AMARO DA IMPERATRIZ (SC)";"SC";"SANTO AMARO DA IMPERATRIZ";442;21;61;524
2005;"SAO BENTO DO SUL (SC)";"SC";"SAO BENTO DO SUL";1113;105;126;1344
2005;"SAO BERNARDINO (SC)";"SC";"SAO BERNARDINO";30;0;16;46
2005;"SAO BONIFACIO (SC)";"SC";"SAO BONIFACIO";99;3;8;110
2005;"SAO CARLOS (SC)";"SC";"SAO CARLOS";147;7;36;190
2005;"SAO CRISTOVAO DO SUL (SC)";"SC";"SAO CRISTOVAO DO SUL";90;1;8;99
2005;"SAO DOMINGOS (SC)";"SC";"SAO DOMINGOS";240;10;31;281
2005;"SAO FRANCISCO DO SUL (SC)";"SC";"SAO FRANCISCO DO SUL";474;35;59;568
2005;"SAO JOAO BATISTA (SC)";"SC";"SAO JOAO BATISTA";365;13;29;407
2005;"SAO JOAO DO ITAPERIU (SC)";"SC";"SAO JOAO DO ITAPERIU";138;1;6;145
2005;"SAO JOAO DO OESTE (SC)";"SC";"SAO JOAO DO OESTE";118;6;6;130
2005;"SAO JOAO DO SUL (SC)";"SC";"SAO JOAO DO SUL";179;4;7;190
2005;"SAO JOAQUIM (SC)";"SC";"SAO JOAQUIM";628;32;144;804
2005;"SAO JOSE (SC)";"SC";"SAO JOSE";2816;221;168;3205
2005;"SAO JOSE DO CEDRO (SC)";"SC";"SAO JOSE DO CEDRO";296;9;110;415
2005;"SAO JOSE DO CERRITO (SC)";"SC";"SAO JOSE DO CERRITO";103;5;25;133
2005;"SAO LOURENCO D OESTE (SC)";"SC";"SAO LOURENCO D OESTE";648;21;52;721
2005;"SAO LUDGERO (SC)";"SC";"SAO LUDGERO";418;6;14;438
2005;"SAO MARTINHO (SC)";"SC";"SAO MARTINHO";111;7;6;124
2005;"SAO MIGUEL D OESTE (SC)";"SC";"SAO MIGUEL D OESTE";778;23;93;894
2005;"SAO MIGUEL DA BOA VISTA (SC)";"SC";"SAO MIGUEL DA BOA VISTA";14;4;6;24
2005;"SAO PEDRO DE ALCANTARA (SC)";"SC";"SAO PEDRO DE ALCANTARA";110;4;4;118
2005;"SAUDADES (SC)";"SC";"SAUDADES";127;5;32;164
2005;"SCHROEDER (SC)";"SC";"SCHROEDER";139;6;19;164
2005;"SEARA (SC)";"SC";"SEARA";293;18;52;363
2005;"SERRA ALTA (SC)";"SC";"SERRA ALTA";42;5;10;57
2005;"SIDEROPOLIS (SC)";"SC";"SIDEROPOLIS";335;13;43;391
2005;"SOMBRIO (SC)";"SC";"SOMBRIO";615;29;23;667
2005;"SUL BRASIL (SC)";"SC";"SUL BRASIL";29;3;9;41
2005;"TAIO (SC)";"SC";"TAIO";416;11;31;458
2005;"TANGARA (SC)";"SC";"TANGARA";311;3;30;344
2005;"TIGRINHOS (SC)";"SC";"TIGRINHOS";11;1;11;23
2005;"TIJUCAS (SC)";"SC";"TIJUCAS";615;32;43;690
2005;"TIMBE DO SUL (SC)";"SC";"TIMBE DO SUL";130;3;8;141
2005;"TIMBO (SC)";"SC";"TIMBO";507;42;42;591
2005;"TIMBO GRANDE (SC)";"SC";"TIMBO GRANDE";120;3;8;131
2005;"TRES BARRAS (SC)";"SC";"TRES BARRAS";231;12;38;281
2005;"TREVISO (SC)";"SC";"TREVISO";60;6;4;70
2005;"TREZE DE MAIO (SC)";"SC";"TREZE DE MAIO";331;6;13;350
2005;"TREZE TILIAS (SC)";"SC";"TREZE TILIAS";190;11;15;216
2005;"TROMBUDO CENTRAL (SC)";"SC";"TROMBUDO CENTRAL";191;7;5;203
2005;"TUBARAO (SC)";"SC";"TUBARAO";1898;71;336;2305
2005;"TUNAPOLIS (SC)";"SC";"TUNAPOLIS";63;5;18;86
2005;"TURVO (SC)";"SC";"TURVO";310;8;23;341
2005;"UNIAO DO OESTE (SC)";"SC";"UNIAO DO OESTE";55;2;10;67
2005;"URUBICI (SC)";"SC";"URUBICI";186;5;31;222
2005;"URUPEMA (SC)";"SC";"URUPEMA";37;4;6;47
2005;"URUSSANGA (SC)";"SC";"URUSSANGA";326;24;80;430
2005;"VARGEAO (SC)";"SC";"VARGEAO";98;1;7;106
2005;"VARGEM (SC)";"SC";"VARGEM";37;1;7;45
2005;"VARGEM BONITA (SC)";"SC";"VARGEM BONITA";134;13;23;170
2005;"VIDAL RAMOS (SC)";"SC";"VIDAL RAMOS";119;9;7;135
2005;"VIDEIRA (SC)";"SC";"VIDEIRA";1217;79;89;1385
2005;"VITOR MEIRELES (SC)";"SC";"VITOR MEIRELES";69;6;12;87
2005;"WITMARSUM (SC)";"SC";"WITMARSUM";67;4;6;77
2005;"XANXERE (SC)";"SC";"XANXERE";1022;65;95;1182
2005;"XAVANTINA (SC)";"SC";"XAVANTINA";128;13;4;145
2005;"XAXIM (SC)";"SC";"XAXIM";591;23;82;696
2005;"ZORTEA (SC)";"SC";"ZORTEA";27;4;4;35
2005;"AMPARO DE SAO FRANCISCO (SE)";"SE";"AMPARO DE SAO FRANCISCO";4;3;1;8
2005;"AQUIDABA (SE)";"SE";"AQUIDABA";100;5;28;133
2005;"ARACAJU (SE)";"SE";"ARACAJU";4107;664;1437;6208
2005;"ARAUA (SE)";"SE";"ARAUA";45;10;13;68
2005;"AREIA BRANCA (SE)";"SE";"AREIA BRANCA";110;9;11;130
2005;"BARRA DOS COQUEIROS (SE)";"SE";"BARRA DOS COQUEIROS";28;5;16;49
2005;"BOQUIM (SE)";"SE";"BOQUIM";184;9;30;223
2005;"BREJO GRANDE (SE)";"SE";"BREJO GRANDE";5;2;6;13
2005;"CAMPO DO BRITO (SE)";"SE";"CAMPO DO BRITO";227;20;26;273
2005;"CANHOBA (SE)";"SE";"CANHOBA";3;2;2;7
2005;"CANINDE DE SAO FRANCISCO (SE)";"SE";"CANINDE DE SAO FRANCISCO";90;14;13;117
2005;"CAPELA (SE)";"SE";"CAPELA";59;15;26;100
2005;"CARIRA (SE)";"SE";"CARIRA";164;37;33;234
2005;"CARMOPOLIS (SE)";"SE";"CARMOPOLIS";68;20;12;100
2005;"CEDRO DE SAO JOAO (SE)";"SE";"CEDRO DE SAO JOAO";21;6;0;27
2005;"CRISTINAPOLIS (SE)";"SE";"CRISTINAPOLIS";46;23;14;83
2005;"CUMBE (SE)";"SE";"CUMBE";12;3;2;17
2005;"DIVINA PASTORA (SE)";"SE";"DIVINA PASTORA";7;3;0;10
2005;"ESTANCIA (SE)";"SE";"ESTANCIA";299;98;82;479
2005;"FEIRA NOVA (SE)";"SE";"FEIRA NOVA";7;5;2;14
2005;"FREI PAULO (SE)";"SE";"FREI PAULO";72;18;13;103
2005;"GARARU (SE)";"SE";"GARARU";24;5;11;40
2005;"GENERAL MAYNARD (SE)";"SE";"GENERAL MAYNARD";10;12;19;41
2005;"GRACCHO CARDOSO (SE)";"SE";"GRACCHO CARDOSO";13;2;6;21
2005;"ILHA DAS FLORES (SE)";"SE";"ILHA DAS FLORES";8;5;5;18
2005;"INDIAROBA (SE)";"SE";"INDIAROBA";26;13;8;47
2005;"ITABAIANA (SE)";"SE";"ITABAIANA";2195;107;79;2381
2005;"ITABAIANINHA (SE)";"SE";"ITABAIANINHA";287;35;29;351
2005;"ITABI (SE)";"SE";"ITABI";17;3;3;23
2005;"ITAPORANGA D AJUDA (SE)";"SE";"ITAPORANGA D AJUDA";145;14;26;185
2005;"JAPARATUBA (SE)";"SE";"JAPARATUBA";32;11;30;73
2005;"JAPOATA (SE)";"SE";"JAPOATA";37;3;15;55
2005;"LAGARTO (SE)";"SE";"LAGARTO";686;80;124;890
2005;"LARANJEIRAS (SE)";"SE";"LARANJEIRAS";79;11;26;116
2005;"MACAMBIRA (SE)";"SE";"MACAMBIRA";32;10;3;45
2005;"MALHADA DOS BOIS (SE)";"SE";"MALHADA DOS BOIS";13;1;3;17
2005;"MALHADOR (SE)";"SE";"MALHADOR";125;21;21;167
2005;"MARUIM (SE)";"SE";"MARUIM";32;9;13;54
2005;"MOITA BONITA (SE)";"SE";"MOITA BONITA";311;22;7;340
2005;"MONTE ALEGRE DE SERGIPE (SE)";"SE";"MONTE ALEGRE DE SERGIPE";58;10;15;83
2005;"MURIBECA (SE)";"SE";"MURIBECA";8;9;14;31
2005;"NEOPOLIS (SE)";"SE";"NEOPOLIS";31;7;14;52
2005;"NOSSA SENHORA APARECIDA (SE)";"SE";"NOSSA SENHORA APARECIDA";96;11;5;112
2005;"NOSSA SENHORA DA GLORIA (SE)";"SE";"NOSSA SENHORA DA GLORIA";286;13;53;352
2005;"NOSSA SENHORA DAS DORES (SE)";"SE";"NOSSA SENHORA DAS DORES";95;15;31;141
2005;"NOSSA SENHORA DE LOURDES (SE)";"SE";"NOSSA SENHORA DE LOURDES";22;4;7;33
2005;"NOSSA SENHORA DO SOCORRO (SE)";"SE";"NOSSA SENHORA DO SOCORRO";459;34;78;571
2005;"PACATUBA (SE)";"SE";"PACATUBA";21;2;18;41
2005;"PEDRA MOLE (SE)";"SE";"PEDRA MOLE";8;4;1;13
2005;"PEDRINHAS (SE)";"SE";"PEDRINHAS";52;5;2;59
2005;"PINHAO (SE)";"SE";"PINHAO";16;21;1;38
2005;"PIRAMBU (SE)";"SE";"PIRAMBU";13;9;13;35
2005;"POCO REDONDO (SE)";"SE";"POCO REDONDO";67;6;29;102
2005;"POCO VERDE (SE)";"SE";"POCO VERDE";66;16;39;121
2005;"PORTO DA FOLHA (SE)";"SE";"PORTO DA FOLHA";53;15;23;91
2005;"PROPRIA (SE)";"SE";"PROPRIA";196;21;49;266
2005;"RIACHAO DO DANTAS (SE)";"SE";"RIACHAO DO DANTAS";19;5;15;39
2005;"RIACHUELO (SE)";"SE";"RIACHUELO";16;4;9;29
2005;"RIBEIROPOLIS (SE)";"SE";"RIBEIROPOLIS";230;42;18;290
2005;"ROSARIO DO CATETE (SE)";"SE";"ROSARIO DO CATETE";26;22;16;64
2005;"SALGADO (SE)";"SE";"SALGADO";82;8;28;118
2005;"SANTA LUZIA DO ITANHY (SE)";"SE";"SANTA LUZIA DO ITANHY";14;2;6;22
2005;"SANTA ROSA DE LIMA (SE)";"SE";"SANTA ROSA DE LIMA";14;4;4;22
2005;"SANTANA DO SAO FRANCISCO (SE)";"SE";"SANTANA DO SAO FRANCISCO";3;5;4;12
2005;"SANTO AMARO DAS BROTAS (SE)";"SE";"SANTO AMARO DAS BROTAS";14;5;6;25
2005;"SAO CRISTOVAO (SE)";"SE";"SAO CRISTOVAO";205;40;42;287
2005;"SAO DOMINGOS (SE)";"SE";"SAO DOMINGOS";97;12;8;117
2005;"SAO FRANCISCO (SE)";"SE";"SAO FRANCISCO";14;3;15;32
2005;"SAO MIGUEL DO ALEIXO (SE)";"SE";"SAO MIGUEL DO ALEIXO";23;8;2;33
2005;"SIMAO DIAS (SE)";"SE";"SIMAO DIAS";157;28;139;324
2005;"SIRIRI (SE)";"SE";"SIRIRI";28;8;11;47
2005;"TELHA (SE)";"SE";"TELHA";7;0;4;11
2005;"TOBIAS BARRETO (SE)";"SE";"TOBIAS BARRETO";166;42;66;274
2005;"TOMAR DO GERU (SE)";"SE";"TOMAR DO GERU";30;9;9;48
2005;"UMBAUBA (SE)";"SE";"UMBAUBA";198;31;24;253
2005;"ADAMANTINA (SP)";"SP";"ADAMANTINA";601;40;52;693
2005;"ADOLFO (SP)";"SP";"ADOLFO";60;3;19;82
2005;"AGUAI (SP)";"SP";"AGUAI";631;24;98;753
2005;"AGUAS DA PRATA (SP)";"SP";"AGUAS DA PRATA";103;13;4;120
2005;"AGUAS DE LINDOIA (SP)";"SP";"AGUAS DE LINDOIA";132;33;29;194
2005;"AGUAS DE SANTA BARBARA (SP)";"SP";"AGUAS DE SANTA BARBARA";82;7;14;103
2005;"AGUAS DE SAO PEDRO (SP)";"SP";"AGUAS DE SAO PEDRO";19;8;2;29
2005;"AGUDOS (SP)";"SP";"AGUDOS";417;28;63;508
2005;"ALAMBARI (SP)";"SP";"ALAMBARI";59;9;2;70
2005;"ALFREDO MARCONDES (SP)";"SP";"ALFREDO MARCONDES";37;2;6;45
2005;"ALTAIR (SP)";"SP";"ALTAIR";60;4;25;89
2005;"ALTINOPOLIS (SP)";"SP";"ALTINOPOLIS";296;15;68;379
2005;"ALTO ALEGRE (SP)";"SP";"ALTO ALEGRE";68;1;31;100
2005;"ALUMINIO (SP)";"SP";"ALUMINIO";158;19;28;205
2005;"ALVARES FLORENCE (SP)";"SP";"ALVARES FLORENCE";55;1;10;66
2005;"ALVARES MACHADO (SP)";"SP";"ALVARES MACHADO";371;16;27;414
2005;"ALVARO DE CARVALHO (SP)";"SP";"ALVARO DE CARVALHO";21;2;11;34
2005;"ALVINLANDIA (SP)";"SP";"ALVINLANDIA";28;2;9;39
2005;"AMERICANA (SP)";"SP";"AMERICANA";2626;314;717;3657
2005;"AMERICO BRASILIENSE (SP)";"SP";"AMERICO BRASILIENSE";539;20;195;754
2005;"AMERICO DE CAMPOS (SP)";"SP";"AMERICO DE CAMPOS";125;4;17;146
2005;"AMPARO (SP)";"SP";"AMPARO";1078;136;79;1293
2005;"ANALANDIA (SP)";"SP";"ANALANDIA";55;5;11;71
2005;"ANDRADINA (SP)";"SP";"ANDRADINA";746;29;81;856
2005;"ANGATUBA (SP)";"SP";"ANGATUBA";318;29;50;397
2005;"ANHEMBI (SP)";"SP";"ANHEMBI";44;7;7;58
2005;"ANHUMAS (SP)";"SP";"ANHUMAS";55;4;4;63
2005;"APARECIDA (SP)";"SP";"APARECIDA";748;51;521;1320
2005;"APARECIDA D OESTE (SP)";"SP";"APARECIDA D OESTE";77;7;15;99
2005;"APIAI (SP)";"SP";"APIAI";227;26;57;310
2005;"ARACARIGUAMA (SP)";"SP";"ARACARIGUAMA";321;30;28;379
2005;"ARACATUBA (SP)";"SP";"ARACATUBA";2571;142;484;3197
2005;"ARACOIABA DA SERRA (SP)";"SP";"ARACOIABA DA SERRA";321;40;16;377
2005;"ARAMINA (SP)";"SP";"ARAMINA";60;5;15;80
2005;"ARANDU (SP)";"SP";"ARANDU";35;10;9;54
2005;"ARAPEI (SP)";"SP";"ARAPEI";27;4;4;35
2005;"ARARAQUARA (SP)";"SP";"ARARAQUARA";2602;281;767;3650
2005;"ARARAS (SP)";"SP";"ARARAS";1803;159;191;2153
2005;"ARCO IRIS (SP)";"SP";"ARCO IRIS";45;2;8;55
2005;"AREALVA (SP)";"SP";"AREALVA";141;7;13;161
2005;"AREIAS (SP)";"SP";"AREIAS";37;2;2;41
2005;"AREIOPOLIS (SP)";"SP";"AREIOPOLIS";98;8;40;146
2005;"ARIRANHA (SP)";"SP";"ARIRANHA";225;14;89;328
2005;"ARTUR NOGUEIRA (SP)";"SP";"ARTUR NOGUEIRA";717;54;121;892
2005;"ARUJA (SP)";"SP";"ARUJA";1646;159;249;2054
2005;"ASPASIA (SP)";"SP";"ASPASIA";26;1;3;30
2005;"ASSIS (SP)";"SP";"ASSIS";1352;97;277;1726
2005;"ATIBAIA (SP)";"SP";"ATIBAIA";1694;190;205;2089
2005;"AURIFLAMA (SP)";"SP";"AURIFLAMA";289;11;35;335
2005;"AVAI (SP)";"SP";"AVAI";42;6;18;66
2005;"AVANHANDAVA (SP)";"SP";"AVANHANDAVA";106;6;28;140
2005;"AVARE (SP)";"SP";"AVARE";1007;61;219;1287
2005;"BADY BASSITT (SP)";"SP";"BADY BASSITT";210;20;18;248
2005;"BALBINOS (SP)";"SP";"BALBINOS";11;1;3;15
2005;"BALSAMO (SP)";"SP";"BALSAMO";152;5;12;169
2005;"BANANAL (SP)";"SP";"BANANAL";91;9;18;118
2005;"BARAO DE ANTONINA (SP)";"SP";"BARAO DE ANTONINA";21;4;10;35
2005;"BARBOSA (SP)";"SP";"BARBOSA";75;4;14;93
2005;"BARIRI (SP)";"SP";"BARIRI";673;21;58;752
2005;"BARRA BONITA (SP)";"SP";"BARRA BONITA";978;51;168;1197
2005;"BARRA DO CHAPEU (SP)";"SP";"BARRA DO CHAPEU";27;3;5;35
2005;"BARRA DO TURVO (SP)";"SP";"BARRA DO TURVO";46;3;23;72
2005;"BARRETOS (SP)";"SP";"BARRETOS";1656;88;356;2100
2005;"BARRINHA (SP)";"SP";"BARRINHA";274;20;127;421
2005;"BARUERI (SP)";"SP";"BARUERI";3048;430;649;4127
2005;"BASTOS (SP)";"SP";"BASTOS";555;16;55;626
2005;"BATATAIS (SP)";"SP";"BATATAIS";860;30;122;1012
2005;"BAURU (SP)";"SP";"BAURU";3775;334;841;4950
2005;"BEBEDOURO (SP)";"SP";"BEBEDOURO";1450;80;179;1709
2005;"BENTO DE ABREU (SP)";"SP";"BENTO DE ABREU";66;4;11;81
2005;"BERNARDINO DE CAMPOS (SP)";"SP";"BERNARDINO DE CAMPOS";245;14;24;283
2005;"BERTIOGA (SP)";"SP";"BERTIOGA";325;38;53;416
2005;"BILAC (SP)";"SP";"BILAC";95;5;15;115
2005;"BIRIGUI (SP)";"SP";"BIRIGUI";1251;39;92;1382
2005;"BIRITIBA MIRIM (SP)";"SP";"BIRITIBA MIRIM";224;8;21;253
2005;"BOA ESPERANCA DO SUL (SP)";"SP";"BOA ESPERANCA DO SUL";338;15;66;419
2005;"BOCAINA (SP)";"SP";"BOCAINA";168;25;26;219
2005;"BOFETE (SP)";"SP";"BOFETE";140;10;26;176
2005;"BOITUVA (SP)";"SP";"BOITUVA";772;48;75;895
2005;"BOM JESUS DOS PERDOES (SP)";"SP";"BOM JESUS DOS PERDOES";272;32;18;322
2005;"BOM SUCESSO DE ITARARE (SP)";"SP";"BOM SUCESSO DE ITARARE";44;8;2;54
2005;"BORA (SP)";"SP";"BORA";16;0;5;21
2005;"BORACEIA (SP)";"SP";"BORACEIA";160;5;12;177
2005;"BORBOREMA (SP)";"SP";"BORBOREMA";260;8;44;312
2005;"BOREBI (SP)";"SP";"BOREBI";27;4;3;34
2005;"BOTUCATU (SP)";"SP";"BOTUCATU";1237;136;344;1717
2005;"BRAGANCA PAULISTA (SP)";"SP";"BRAGANCA PAULISTA";1985;175;201;2361
2005;"BRAUNA (SP)";"SP";"BRAUNA";53;1;20;74
2005;"BREJO ALEGRE (SP)";"SP";"BREJO ALEGRE";34;1;7;42
2005;"BRODOSQUI (SP)";"SP";"BRODOSQUI";383;16;29;428
2005;"BROTAS (SP)";"SP";"BROTAS";376;24;94;494
2005;"BURI (SP)";"SP";"BURI";288;20;36;344
2005;"BURITAMA (SP)";"SP";"BURITAMA";217;17;30;264
2005;"BURITIZAL (SP)";"SP";"BURITIZAL";82;12;29;123
2005;"CABRALIA PAULISTA (SP)";"SP";"CABRALIA PAULISTA";107;1;6;114
2005;"CABREUVA (SP)";"SP";"CABREUVA";790;70;46;906
2005;"CACAPAVA (SP)";"SP";"CACAPAVA";597;150;87;834
2005;"CACHOEIRA PAULISTA (SP)";"SP";"CACHOEIRA PAULISTA";257;27;9;293
2005;"CACONDE (SP)";"SP";"CACONDE";157;17;55;229
2005;"CAFELANDIA (SP)";"SP";"CAFELANDIA";219;10;34;263
2005;"CAIABU (SP)";"SP";"CAIABU";26;4;30;60
2005;"CAIEIRAS (SP)";"SP";"CAIEIRAS";615;107;343;1065
2005;"CAIUA (SP)";"SP";"CAIUA";41;3;8;52
2005;"CAJAMAR (SP)";"SP";"CAJAMAR";702;61;84;847
2005;"CAJATI (SP)";"SP";"CAJATI";283;22;51;356
2005;"CAJOBI (SP)";"SP";"CAJOBI";264;3;56;323
2005;"CAJURU (SP)";"SP";"CAJURU";364;13;83;460
2005;"CAMPINA DO MONTE ALEGRE (SP)";"SP";"CAMPINA DO MONTE ALEGRE";58;7;19;84
2005;"CAMPINAS (SP)";"SP";"CAMPINAS";12801;2319;3433;18553
2005;"CAMPO LIMPO PAULISTA (SP)";"SP";"CAMPO LIMPO PAULISTA";439;74;18;531
2005;"CAMPOS DO JORDAO (SP)";"SP";"CAMPOS DO JORDAO";471;131;26;628
2005;"CAMPOS NOVOS PAULISTA (SP)";"SP";"CAMPOS NOVOS PAULISTA";78;1;17;96
2005;"CANANEIA (SP)";"SP";"CANANEIA";55;5;8;68
2005;"CANAS (SP)";"SP";"CANAS";31;4;3;38
2005;"CANDIDO MOTA (SP)";"SP";"CANDIDO MOTA";688;10;42;740
2005;"CANDIDO RODRIGUES (SP)";"SP";"CANDIDO RODRIGUES";81;6;2;89
2005;"CANITAR (SP)";"SP";"CANITAR";45;6;23;74
2005;"CAPAO BONITO (SP)";"SP";"CAPAO BONITO";739;61;117;917
2005;"CAPELA DO ALTO (SP)";"SP";"CAPELA DO ALTO";298;13;19;330
2005;"CAPIVARI (SP)";"SP";"CAPIVARI";952;57;172;1181
2005;"CARAGUATATUBA (SP)";"SP";"CARAGUATATUBA";917;71;83;1071
2005;"CARAPICUIBA (SP)";"SP";"CARAPICUIBA";1732;327;665;2724
2005;"CARDOSO (SP)";"SP";"CARDOSO";142;6;32;180
2005;"CASA BRANCA (SP)";"SP";"CASA BRANCA";398;48;57;503
2005;"CASSIA DOS COQUEIROS (SP)";"SP";"CASSIA DOS COQUEIROS";11;3;7;21
2005;"CASTILHO (SP)";"SP";"CASTILHO";142;13;66;221
2005;"CATANDUVA (SP)";"SP";"CATANDUVA";2387;120;346;2853
2005;"CATIGUA (SP)";"SP";"CATIGUA";95;2;29;126
2005;"CEDRAL (SP)";"SP";"CEDRAL";169;8;10;187
2005;"CERQUEIRA CESAR (SP)";"SP";"CERQUEIRA CESAR";233;18;47;298
2005;"CERQUILHO (SP)";"SP";"CERQUILHO";703;61;72;836
2005;"CESARIO LANGE (SP)";"SP";"CESARIO LANGE";255;26;28;309
2005;"CHARQUEADA (SP)";"SP";"CHARQUEADA";340;23;65;428
2005;"CHAVANTES (SP)";"SP";"CHAVANTES";127;11;32;170
2005;"CLEMENTINA (SP)";"SP";"CLEMENTINA";148;2;33;183
2005;"COLINA (SP)";"SP";"COLINA";312;10;60;382
2005;"COLOMBIA (SP)";"SP";"COLOMBIA";100;5;44;149
2005;"CONCHAL (SP)";"SP";"CONCHAL";567;23;120;710
2005;"CONCHAS (SP)";"SP";"CONCHAS";252;19;21;292
2005;"CORDEIROPOLIS (SP)";"SP";"CORDEIROPOLIS";516;40;28;584
2005;"COROADOS (SP)";"SP";"COROADOS";60;3;12;75
2005;"CORONEL MACEDO (SP)";"SP";"CORONEL MACEDO";49;6;19;74
2005;"CORUMBATAI (SP)";"SP";"CORUMBATAI";121;9;6;136
2005;"COSMOPOLIS (SP)";"SP";"COSMOPOLIS";538;101;187;826
2005;"COSMORAMA (SP)";"SP";"COSMORAMA";119;5;29;153
2005;"COTIA (SP)";"SP";"COTIA";1658;564;187;2409
2005;"CRAVINHOS (SP)";"SP";"CRAVINHOS";711;52;104;867
2005;"CRISTAIS PAULISTA (SP)";"SP";"CRISTAIS PAULISTA";73;2;15;90
2005;"CRUZALIA (SP)";"SP";"CRUZALIA";66;10;4;80
2005;"CRUZEIRO (SP)";"SP";"CRUZEIRO";524;54;37;615
2005;"CUBATAO (SP)";"SP";"CUBATAO";1767;274;292;2333
2005;"CUNHA (SP)";"SP";"CUNHA";187;17;21;225
2005;"DESCALVADO (SP)";"SP";"DESCALVADO";711;36;110;857
2005;"DIADEMA (SP)";"SP";"DIADEMA";2964;463;447;3874
2005;"DIRCE REIS (SP)";"SP";"DIRCE REIS";50;2;4;56
2005;"DIVINOLANDIA (SP)";"SP";"DIVINOLANDIA";373;11;19;403
2005;"DOBRADA (SP)";"SP";"DOBRADA";62;4;42;108
2005;"DOIS CORREGOS (SP)";"SP";"DOIS CORREGOS";532;16;91;639
2005;"DOLCINOPOLIS (SP)";"SP";"DOLCINOPOLIS";21;2;3;26
2005;"DOURADO (SP)";"SP";"DOURADO";134;13;33;180
2005;"DRACENA (SP)";"SP";"DRACENA";887;26;129;1042
2005;"DUARTINA (SP)";"SP";"DUARTINA";204;14;34;252
2005;"DUMONT (SP)";"SP";"DUMONT";261;9;38;308
2005;"ECHAPORA (SP)";"SP";"ECHAPORA";91;2;15;108
2005;"ELDORADO (SP)";"SP";"ELDORADO";172;6;39;217
2005;"ELIAS FAUSTO (SP)";"SP";"ELIAS FAUSTO";247;9;31;287
2005;"ELISIARIO (SP)";"SP";"ELISIARIO";50;3;6;59
2005;"EMBAUBA (SP)";"SP";"EMBAUBA";88;2;23;113
2005;"EMBU (SP)";"SP";"EMBU";1240;342;412;1994
2005;"EMBU GUACU (SP)";"SP";"EMBU GUACU";778;121;127;1026
2005;"EMILIANOPOLIS (SP)";"SP";"EMILIANOPOLIS";41;1;8;50
2005;"ENGENHEIRO COELHO (SP)";"SP";"ENGENHEIRO COELHO";249;20;102;371
2005;"ESPIRITO SANTO DO PINHAL (SP)";"SP";"ESPIRITO SANTO DO PINHAL";510;76;57;643
2005;"ESPIRITO SANTO DO TURVO (SP)";"SP";"ESPIRITO SANTO DO TURVO";87;11;20;118
2005;"ESTIVA GERBI (SP)";"SP";"ESTIVA GERBI";192;8;13;213
2005;"ESTRELA D OESTE (SP)";"SP";"ESTRELA D OESTE";193;7;13;213
2005;"ESTRELA DO NORTE (SP)";"SP";"ESTRELA DO NORTE";17;3;6;26
2005;"EUCLIDES DA CUNHA PAULISTA (SP)";"SP";"EUCLIDES DA CUNHA PAULISTA";70;4;25;99
2005;"FARTURA (SP)";"SP";"FARTURA";202;10;20;232
2005;"FERNANDO PRESTES (SP)";"SP";"FERNANDO PRESTES";202;7;7;216
2005;"FERNANDOPOLIS (SP)";"SP";"FERNANDOPOLIS";1094;34;117;1245
2005;"FERNAO (SP)";"SP";"FERNAO";15;2;4;21
2005;"FERRAZ DE VASCONCELOS (SP)";"SP";"FERRAZ DE VASCONCELOS";824;87;146;1057
2005;"FLORA RICA (SP)";"SP";"FLORA RICA";19;0;7;26
2005;"FLOREAL (SP)";"SP";"FLOREAL";45;5;5;55
2005;"FLORIDA PAULISTA (SP)";"SP";"FLORIDA PAULISTA";255;4;80;339
2005;"FLORINEA (SP)";"SP";"FLORINEA";33;4;6;43
2005;"FRANCA (SP)";"SP";"FRANCA";2252;193;395;2840
2005;"FRANCISCO MORATO (SP)";"SP";"FRANCISCO MORATO";333;88;121;542
2005;"FRANCO DA ROCHA (SP)";"SP";"FRANCO DA ROCHA";433;101;114;648
2005;"GABRIEL MONTEIRO (SP)";"SP";"GABRIEL MONTEIRO";36;2;9;47
2005;"GALIA (SP)";"SP";"GALIA";113;6;19;138
2005;"GARCA (SP)";"SP";"GARCA";613;35;88;736
2005;"GASTAO VIDIGAL (SP)";"SP";"GASTAO VIDIGAL";61;2;20;83
2005;"GAVIAO PEIXOTO (SP)";"SP";"GAVIAO PEIXOTO";41;4;17;62
2005;"GENERAL SALGADO (SP)";"SP";"GENERAL SALGADO";211;4;44;259
2005;"GETULINA (SP)";"SP";"GETULINA";131;3;37;171
2005;"GLICERIO (SP)";"SP";"GLICERIO";77;1;24;102
2005;"GUAICARA (SP)";"SP";"GUAICARA";53;5;11;69
2005;"GUAIMBE (SP)";"SP";"GUAIMBE";94;4;15;113
2005;"GUAIRA (SP)";"SP";"GUAIRA";846;24;85;955
2005;"GUAPIACU (SP)";"SP";"GUAPIACU";369;14;52;435
2005;"GUAPIARA (SP)";"SP";"GUAPIARA";235;6;32;273
2005;"GUARA (SP)";"SP";"GUARA";216;11;99;326
2005;"GUARACAI (SP)";"SP";"GUARACAI";278;4;16;298
2005;"GUARACI (SP)";"SP";"GUARACI";108;3;41;152
2005;"GUARANI D OESTE (SP)";"SP";"GUARANI D OESTE";23;2;7;32
2005;"GUARANTA (SP)";"SP";"GUARANTA";78;1;26;105
2005;"GUARARAPES (SP)";"SP";"GUARARAPES";588;22;102;712
2005;"GUARAREMA (SP)";"SP";"GUARAREMA";212;22;5;239
2005;"GUARATINGUETA (SP)";"SP";"GUARATINGUETA";822;130;211;1163
2005;"GUAREI (SP)";"SP";"GUAREI";182;18;27;227
2005;"GUARIBA (SP)";"SP";"GUARIBA";719;25;230;974
2005;"GUARUJA (SP)";"SP";"GUARUJA";1467;352;301;2120
2005;"GUARULHOS (SP)";"SP";"GUARULHOS";12733;2407;2328;17468
2005;"GUATAPARA (SP)";"SP";"GUATAPARA";112;6;37;155
2005;"GUZOLANDIA (SP)";"SP";"GUZOLANDIA";52;3;21;76
2005;"HERCULANDIA (SP)";"SP";"HERCULANDIA";313;3;16;332
2005;"HOLAMBRA (SP)";"SP";"HOLAMBRA";327;19;41;387
2005;"HORTOLANDIA (SP)";"SP";"HORTOLANDIA";998;202;198;1398
2005;"IACANGA (SP)";"SP";"IACANGA";147;6;20;173
2005;"IACRI (SP)";"SP";"IACRI";107;2;11;120
2005;"IARAS (SP)";"SP";"IARAS";31;11;10;52
2005;"IBATE (SP)";"SP";"IBATE";403;33;167;603
2005;"IBIRA (SP)";"SP";"IBIRA";143;18;39;200
2005;"IBIRAREMA (SP)";"SP";"IBIRAREMA";110;5;19;134
2005;"IBITINGA (SP)";"SP";"IBITINGA";605;49;94;748
2005;"IBIUNA (SP)";"SP";"IBIUNA";1266;84;88;1438
2005;"ICEM (SP)";"SP";"ICEM";151;5;61;217
2005;"IEPE (SP)";"SP";"IEPE";122;5;20;147
2005;"IGARACU DO TIETE (SP)";"SP";"IGARACU DO TIETE";317;10;37;364
2005;"IGARAPAVA (SP)";"SP";"IGARAPAVA";682;24;89;795
2005;"IGARATA (SP)";"SP";"IGARATA";81;4;7;92
2005;"IGUAPE (SP)";"SP";"IGUAPE";181;15;30;226
2005;"ILHA COMPRIDA (SP)";"SP";"ILHA COMPRIDA";81;7;24;112
2005;"ILHA SOLTEIRA (SP)";"SP";"ILHA SOLTEIRA";194;21;54;269
2005;"ILHABELA (SP)";"SP";"ILHABELA";187;23;33;243
2005;"INDAIATUBA (SP)";"SP";"INDAIATUBA";2083;239;194;2516
2005;"INDIANA (SP)";"SP";"INDIANA";102;2;9;113
2005;"INDIAPORA (SP)";"SP";"INDIAPORA";56;3;12;71
2005;"INUBIA PAULISTA (SP)";"SP";"INUBIA PAULISTA";37;4;9;50
2005;"IPAUCU (SP)";"SP";"IPAUCU";135;14;29;178
2005;"IPERO (SP)";"SP";"IPERO";172;10;36;218
2005;"IPEUNA (SP)";"SP";"IPEUNA";109;12;13;134
2005;"IPIGUA (SP)";"SP";"IPIGUA";17;2;6;25
2005;"IPORANGA (SP)";"SP";"IPORANGA";22;1;8;31
2005;"IPUA (SP)";"SP";"IPUA";237;7;54;298
2005;"IRACEMAPOLIS (SP)";"SP";"IRACEMAPOLIS";497;18;75;590
2005;"IRAPUA (SP)";"SP";"IRAPUA";145;1;47;193
2005;"IRAPURU (SP)";"SP";"IRAPURU";107;9;16;132
2005;"ITABERA (SP)";"SP";"ITABERA";167;8;25;200
2005;"ITAI (SP)";"SP";"ITAI";399;24;76;499
2005;"ITAJOBI (SP)";"SP";"ITAJOBI";437;11;35;483
2005;"ITAJU (SP)";"SP";"ITAJU";59;0;9;68
2005;"ITANHAEM (SP)";"SP";"ITANHAEM";593;66;108;767
2005;"ITAOCA (SP)";"SP";"ITAOCA";11;6;5;22
2005;"ITAPECERICA DA SERRA (SP)";"SP";"ITAPECERICA DA SERRA";1339;391;284;2014
2005;"ITAPETININGA (SP)";"SP";"ITAPETININGA";1931;185;232;2348
2005;"ITAPEVA (SP)";"SP";"ITAPEVA";1472;110;251;1833
2005;"ITAPEVI (SP)";"SP";"ITAPEVI";978;120;75;1173
2005;"ITAPIRA (SP)";"SP";"ITAPIRA";1308;62;163;1533
2005;"ITAPIRAPUA PAULISTA (SP)";"SP";"ITAPIRAPUA PAULISTA";29;6;3;38
2005;"ITAPOLIS (SP)";"SP";"ITAPOLIS";1119;21;141;1281
2005;"ITAPORANGA (SP)";"SP";"ITAPORANGA";191;7;38;236
2005;"ITAPUI (SP)";"SP";"ITAPUI";322;11;40;373
2005;"ITAPURA (SP)";"SP";"ITAPURA";15;2;5;22
2005;"ITAQUAQUECETUBA (SP)";"SP";"ITAQUAQUECETUBA";1448;238;409;2095
2005;"ITARARE (SP)";"SP";"ITARARE";807;27;218;1052
2005;"ITARIRI (SP)";"SP";"ITARIRI";244;8;15;267
2005;"ITATIBA (SP)";"SP";"ITATIBA";1813;121;177;2111
2005;"ITATINGA (SP)";"SP";"ITATINGA";158;19;67;244
2005;"ITIRAPINA (SP)";"SP";"ITIRAPINA";185;12;35;232
2005;"ITIRAPUA (SP)";"SP";"ITIRAPUA";51;4;17;72
2005;"ITOBI (SP)";"SP";"ITOBI";106;7;53;166
2005;"ITU (SP)";"SP";"ITU";2216;206;379;2801
2005;"ITUPEVA (SP)";"SP";"ITUPEVA";601;69;40;710
2005;"ITUVERAVA (SP)";"SP";"ITUVERAVA";623;28;105;756
2005;"JABORANDI (SP)";"SP";"JABORANDI";142;5;31;178
2005;"JABOTICABAL (SP)";"SP";"JABOTICABAL";1346;62;169;1577
2005;"JACAREI (SP)";"SP";"JACAREI";2003;341;261;2605
2005;"JACI (SP)";"SP";"JACI";116;6;10;132
2005;"JACUPIRANGA (SP)";"SP";"JACUPIRANGA";317;13;171;501
2005;"JAGUARIUNA (SP)";"SP";"JAGUARIUNA";788;74;104;966
2005;"JALES (SP)";"SP";"JALES";963;28;60;1051
2005;"JAMBEIRO (SP)";"SP";"JAMBEIRO";26;7;6;39
2005;"JANDIRA (SP)";"SP";"JANDIRA";933;140;96;1169
2005;"JARDINOPOLIS (SP)";"SP";"JARDINOPOLIS";682;42;72;796
2005;"JARINU (SP)";"SP";"JARINU";374;19;29;422
2005;"JAU (SP)";"SP";"JAU";1702;185;250;2137
2005;"JERIQUARA (SP)";"SP";"JERIQUARA";38;5;7;50
2005;"JOANOPOLIS (SP)";"SP";"JOANOPOLIS";221;11;7;239
2005;"JOAO RAMALHO (SP)";"SP";"JOAO RAMALHO";25;4;16;45
2005;"JOSE BONIFACIO (SP)";"SP";"JOSE BONIFACIO";596;14;59;669
2005;"JULIO MESQUITA (SP)";"SP";"JULIO MESQUITA";30;1;11;42
2005;"JUMIRIM (SP)";"SP";"JUMIRIM";64;3;3;70
2005;"JUNDIAI (SP)";"SP";"JUNDIAI";5327;676;772;6775
2005;"JUNQUEIROPOLIS (SP)";"SP";"JUNQUEIROPOLIS";340;13;75;428
2005;"JUQUIA (SP)";"SP";"JUQUIA";325;16;21;362
2005;"JUQUITIBA (SP)";"SP";"JUQUITIBA";343;59;40;442
2005;"LAGOINHA (SP)";"SP";"LAGOINHA";64;8;8;80
2005;"LARANJAL PAULISTA (SP)";"SP";"LARANJAL PAULISTA";500;29;88;617
2005;"LAVINIA (SP)";"SP";"LAVINIA";66;7;9;82
2005;"LAVRINHAS (SP)";"SP";"LAVRINHAS";107;16;8;131
2005;"LEME (SP)";"SP";"LEME";1794;70;321;2185
2005;"LENCOIS PAULISTA (SP)";"SP";"LENCOIS PAULISTA";1067;59;139;1265
2005;"LIMEIRA (SP)";"SP";"LIMEIRA";3623;435;514;4572
2005;"LINDOIA (SP)";"SP";"LINDOIA";89;9;10;108
2005;"LINS (SP)";"SP";"LINS";871;44;135;1050
2005;"LORENA (SP)";"SP";"LORENA";638;74;22;734
2005;"LOURDES (SP)";"SP";"LOURDES";24;3;9;36
2005;"LOUVEIRA (SP)";"SP";"LOUVEIRA";684;66;25;775
2005;"LUCELIA (SP)";"SP";"LUCELIA";338;19;113;470
2005;"LUCIANOPOLIS (SP)";"SP";"LUCIANOPOLIS";35;3;8;46
2005;"LUIS ANTONIO (SP)";"SP";"LUIS ANTONIO";210;18;104;332
2005;"LUIZIANIA (SP)";"SP";"LUIZIANIA";56;1;15;72
2005;"LUPERCIO (SP)";"SP";"LUPERCIO";52;2;20;74
2005;"LUTECIA (SP)";"SP";"LUTECIA";31;3;5;39
2005;"MACATUBA (SP)";"SP";"MACATUBA";592;13;50;655
2005;"MACAUBAL (SP)";"SP";"MACAUBAL";119;6;11;136
2005;"MACEDONIA (SP)";"SP";"MACEDONIA";45;2;9;56
2005;"MAGDA (SP)";"SP";"MAGDA";76;5;10;91
2005;"MAIRINQUE (SP)";"SP";"MAIRINQUE";371;54;72;497
2005;"MAIRIPORA (SP)";"SP";"MAIRIPORA";783;95;129;1007
2005;"MANDURI (SP)";"SP";"MANDURI";124;12;31;167
2005;"MARABA PAULISTA (SP)";"SP";"MARABA PAULISTA";31;2;10;43
2005;"MARACAI (SP)";"SP";"MARACAI";274;21;40;335
2005;"MARAPOAMA (SP)";"SP";"MARAPOAMA";109;4;12;125
2005;"MARIAPOLIS (SP)";"SP";"MARIAPOLIS";31;0;12;43
2005;"MARILIA (SP)";"SP";"MARILIA";2424;156;372;2952
2005;"MARINOPOLIS (SP)";"SP";"MARINOPOLIS";53;3;4;60
2005;"MARTINOPOLIS (SP)";"SP";"MARTINOPOLIS";327;16;63;406
2005;"MATAO (SP)";"SP";"MATAO";1246;42;208;1496
2005;"MAUA (SP)";"SP";"MAUA";2528;698;699;3925
2005;"MENDONCA (SP)";"SP";"MENDONCA";84;2;15;101
2005;"MERIDIANO (SP)";"SP";"MERIDIANO";54;1;11;66
2005;"MESOPOLIS (SP)";"SP";"MESOPOLIS";17;3;7;27
2005;"MIGUELOPOLIS (SP)";"SP";"MIGUELOPOLIS";291;5;71;367
2005;"MINEIROS DO TIETE (SP)";"SP";"MINEIROS DO TIETE";227;7;26;260
2005;"MIRA ESTRELA (SP)";"SP";"MIRA ESTRELA";27;3;14;44
2005;"MIRACATU (SP)";"SP";"MIRACATU";450;17;15;482
2005;"MIRANDOPOLIS (SP)";"SP";"MIRANDOPOLIS";423;16;95;534
2005;"MIRANTE DO PARANAPANEMA (SP)";"SP";"MIRANTE DO PARANAPANEMA";174;10;46;230
2005;"MIRASSOL (SP)";"SP";"MIRASSOL";865;34;41;940
2005;"MIRASSOLANDIA (SP)";"SP";"MIRASSOLANDIA";26;4;10;40
2005;"MOCOCA (SP)";"SP";"MOCOCA";831;47;190;1068
2005;"MOGI DAS CRUZES (SP)";"SP";"MOGI DAS CRUZES";3449;426;613;4488
2005;"MOGI GUACU (SP)";"SP";"MOGI GUACU";1560;232;312;2104
2005;"MOGI MIRIM (SP)";"SP";"MOGI MIRIM";1555;133;409;2097
2005;"MOMBUCA (SP)";"SP";"MOMBUCA";63;6;13;82
2005;"MONCOES (SP)";"SP";"MONCOES";38;1;9;48
2005;"MONGAGUA (SP)";"SP";"MONGAGUA";364;40;53;457
2005;"MONTE ALEGRE DO SUL (SP)";"SP";"MONTE ALEGRE DO SUL";157;18;15;190
2005;"MONTE ALTO (SP)";"SP";"MONTE ALTO";1193;32;88;1313
2005;"MONTE APRAZIVEL (SP)";"SP";"MONTE APRAZIVEL";455;8;50;513
2005;"MONTE AZUL PAULISTA (SP)";"SP";"MONTE AZUL PAULISTA";466;19;93;578
2005;"MONTE CASTELO (SP)";"SP";"MONTE CASTELO";66;2;9;77
2005;"MONTE MOR (SP)";"SP";"MONTE MOR";472;59;112;643
2005;"MONTEIRO LOBATO (SP)";"SP";"MONTEIRO LOBATO";43;13;9;65
2005;"MORRO AGUDO (SP)";"SP";"MORRO AGUDO";524;16;111;651
2005;"MORUNGABA (SP)";"SP";"MORUNGABA";261;35;18;314
2005;"MOTUCA (SP)";"SP";"MOTUCA";148;4;48;200
2005;"MUNICIPIO NAO INFORMADO (SP)";"SP";"MUNICIPIO NAO INFORMADO";0;0;0;0
2005;"MURUTINGA DO SUL (SP)";"SP";"MURUTINGA DO SUL";76;7;4;87
2005;"NANTES (SP)";"SP";"NANTES";19;0;14;33
2005;"NARANDIBA (SP)";"SP";"NARANDIBA";19;3;14;36
2005;"NATIVIDADE DA SERRA (SP)";"SP";"NATIVIDADE DA SERRA";45;8;9;62
2005;"NAZARE PAULISTA (SP)";"SP";"NAZARE PAULISTA";362;8;43;413
2005;"NEVES PAULISTA (SP)";"SP";"NEVES PAULISTA";173;3;23;199
2005;"NHANDEARA (SP)";"SP";"NHANDEARA";163;9;22;194
2005;"NIPOA (SP)";"SP";"NIPOA";99;3;10;112
2005;"NOVA ALIANCA (SP)";"SP";"NOVA ALIANCA";99;7;13;119
2005;"NOVA CAMPINA (SP)";"SP";"NOVA CAMPINA";69;6;8;83
2005;"NOVA CANAA PAULISTA (SP)";"SP";"NOVA CANAA PAULISTA";21;3;4;28
2005;"NOVA CASTILHO (SP)";"SP";"NOVA CASTILHO";10;1;5;16
2005;"NOVA EUROPA (SP)";"SP";"NOVA EUROPA";144;3;68;215
2005;"NOVA GRANADA (SP)";"SP";"NOVA GRANADA";245;11;67;323
2005;"NOVA GUATAPORANGA (SP)";"SP";"NOVA GUATAPORANGA";29;3;10;42
2005;"NOVA INDEPENDENCIA (SP)";"SP";"NOVA INDEPENDENCIA";18;4;4;26
2005;"NOVA LUZITANIA (SP)";"SP";"NOVA LUZITANIA";32;3;18;53
2005;"NOVA ODESSA (SP)";"SP";"NOVA ODESSA";656;77;95;828
2005;"NOVAIS (SP)";"SP";"NOVAIS";98;5;27;130
2005;"NOVO HORIZONTE (SP)";"SP";"NOVO HORIZONTE";738;13;140;891
2005;"NUPORANGA (SP)";"SP";"NUPORANGA";164;8;26;198
2005;"OCAUCU (SP)";"SP";"OCAUCU";79;2;8;89
2005;"OLEO (SP)";"SP";"OLEO";17;8;4;29
2005;"OLIMPIA (SP)";"SP";"OLIMPIA";916;26;122;1064
2005;"ONDA VERDE (SP)";"SP";"ONDA VERDE";74;3;13;90
2005;"ORIENTE (SP)";"SP";"ORIENTE";46;3;12;61
2005;"ORINDIUVA (SP)";"SP";"ORINDIUVA";101;10;50;161
2005;"ORLANDIA (SP)";"SP";"ORLANDIA";793;32;189;1014
2005;"OSASCO (SP)";"SP";"OSASCO";5920;1115;1783;8818
2005;"OSCAR BRESSANE (SP)";"SP";"OSCAR BRESSANE";36;3;7;46
2005;"OSVALDO CRUZ (SP)";"SP";"OSVALDO CRUZ";485;19;64;568
2005;"OURINHOS (SP)";"SP";"OURINHOS";1661;76;240;1977
2005;"OURO VERDE (SP)";"SP";"OURO VERDE";106;1;27;134
2005;"OUROESTE (SP)";"SP";"OUROESTE";72;7;18;97
2005;"PACAEMBU (SP)";"SP";"PACAEMBU";167;17;31;215
2005;"PALESTINA (SP)";"SP";"PALESTINA";108;3;21;132
2005;"PALMARES PAULISTA (SP)";"SP";"PALMARES PAULISTA";73;3;67;143
2005;"PALMEIRA D OESTE (SP)";"SP";"PALMEIRA D OESTE";171;3;25;199
2005;"PALMITAL (SP)";"SP";"PALMITAL";545;22;51;618
2005;"PANORAMA (SP)";"SP";"PANORAMA";181;6;14;201
2005;"PARAGUACU PAULISTA (SP)";"SP";"PARAGUACU PAULISTA";503;24;81;608
2005;"PARAIBUNA (SP)";"SP";"PARAIBUNA";166;36;28;230
2005;"PARAISO (SP)";"SP";"PARAISO";161;5;36;202
2005;"PARANAPANEMA (SP)";"SP";"PARANAPANEMA";379;16;42;437
2005;"PARANAPUA (SP)";"SP";"PARANAPUA";50;5;9;64
2005;"PARAPUA (SP)";"SP";"PARAPUA";212;5;26;243
2005;"PARDINHO (SP)";"SP";"PARDINHO";133;8;16;157
2005;"PARIQUERA ACU (SP)";"SP";"PARIQUERA ACU";226;11;8;245
2005;"PARISI (SP)";"SP";"PARISI";25;3;7;35
2005;"PATROCINIO PAULISTA (SP)";"SP";"PATROCINIO PAULISTA";152;4;29;185
2005;"PAULICEIA (SP)";"SP";"PAULICEIA";136;3;12;151
2005;"PAULINIA (SP)";"SP";"PAULINIA";1381;91;236;1708
2005;"PAULISTANIA (SP)";"SP";"PAULISTANIA";18;6;2;26
2005;"PAULO DE FARIA (SP)";"SP";"PAULO DE FARIA";90;8;36;134
2005;"PEDERNEIRAS (SP)";"SP";"PEDERNEIRAS";735;48;143;926
2005;"PEDRA BELA (SP)";"SP";"PEDRA BELA";95;3;10;108
2005;"PEDRANOPOLIS (SP)";"SP";"PEDRANOPOLIS";34;0;7;41
2005;"PEDREGULHO (SP)";"SP";"PEDREGULHO";203;14;70;287
2005;"PEDREIRA (SP)";"SP";"PEDREIRA";523;69;60;652
2005;"PEDRINHAS PAULISTA (SP)";"SP";"PEDRINHAS PAULISTA";131;4;12;147
2005;"PEDRO DE TOLEDO (SP)";"SP";"PEDRO DE TOLEDO";122;9;3;134
2005;"PENAPOLIS (SP)";"SP";"PENAPOLIS";1108;29;190;1327
2005;"PEREIRA BARRETO (SP)";"SP";"PEREIRA BARRETO";355;17;77;449
2005;"PEREIRAS (SP)";"SP";"PEREIRAS";190;13;22;225
2005;"PERUIBE (SP)";"SP";"PERUIBE";415;99;62;576
2005;"PIACATU (SP)";"SP";"PIACATU";77;1;9;87
2005;"PIEDADE (SP)";"SP";"PIEDADE";1045;67;63;1175
2005;"PILAR DO SUL (SP)";"SP";"PILAR DO SUL";597;30;53;680
2005;"PINDAMONHANGABA (SP)";"SP";"PINDAMONHANGABA";1041;136;123;1300
2005;"PINDORAMA (SP)";"SP";"PINDORAMA";210;8;46;264
2005;"PINHALZINHO (SP)";"SP";"PINHALZINHO";272;10;7;289
2005;"PIQUEROBI (SP)";"SP";"PIQUEROBI";25;5;5;35
2005;"PIQUETE (SP)";"SP";"PIQUETE";91;29;13;133
2005;"PIRACAIA (SP)";"SP";"PIRACAIA";378;34;18;430
2005;"PIRACICABA (SP)";"SP";"PIRACICABA";5646;545;954;7145
2005;"PIRAJU (SP)";"SP";"PIRAJU";354;32;63;449
2005;"PIRAJUI (SP)";"SP";"PIRAJUI";263;9;38;310
2005;"PIRANGI (SP)";"SP";"PIRANGI";342;17;46;405
2005;"PIRAPORA DO BOM JESUS (SP)";"SP";"PIRAPORA DO BOM JESUS";162;15;13;190
2005;"PIRAPOZINHO (SP)";"SP";"PIRAPOZINHO";374;14;20;408
2005;"PIRASSUNUNGA (SP)";"SP";"PIRASSUNUNGA";811;100;242;1153
2005;"PIRATININGA (SP)";"SP";"PIRATININGA";182;8;21;211
2005;"PITANGUEIRAS (SP)";"SP";"PITANGUEIRAS";603;18;176;797
2005;"PLANALTO (SP)";"SP";"PLANALTO";69;4;20;93
2005;"PLATINA (SP)";"SP";"PLATINA";38;3;6;47
2005;"POA (SP)";"SP";"POA";628;89;64;781
2005;"POLONI (SP)";"SP";"POLONI";130;5;28;163
2005;"POMPEIA (SP)";"SP";"POMPEIA";223;14;36;273
2005;"PONGAI (SP)";"SP";"PONGAI";38;3;11;52
2005;"PONTAL (SP)";"SP";"PONTAL";674;9;359;1042
2005;"PONTALINDA (SP)";"SP";"PONTALINDA";33;2;18;53
2005;"PONTES GESTAL (SP)";"SP";"PONTES GESTAL";36;1;10;47
2005;"POPULINA (SP)";"SP";"POPULINA";58;4;12;74
2005;"PORANGABA (SP)";"SP";"PORANGABA";77;7;13;97
2005;"PORTO FELIZ (SP)";"SP";"PORTO FELIZ";975;41;108;1124
2005;"PORTO FERREIRA (SP)";"SP";"PORTO FERREIRA";758;43;128;929
2005;"POTIM (SP)";"SP";"POTIM";41;16;10;67
2005;"POTIRENDABA (SP)";"SP";"POTIRENDABA";344;13;36;393
2005;"PRACINHA (SP)";"SP";"PRACINHA";10;2;10;22
2005;"PRADOPOLIS (SP)";"SP";"PRADOPOLIS";318;16;105;439
2005;"PRAIA GRANDE (SP)";"SP";"PRAIA GRANDE";1321;185;279;1785
2005;"PRATANIA (SP)";"SP";"PRATANIA";78;5;14;97
2005;"PRESIDENTE ALVES (SP)";"SP";"PRESIDENTE ALVES";71;3;26;100
2005;"PRESIDENTE BERNARDES (SP)";"SP";"PRESIDENTE BERNARDES";184;10;22;216
2005;"PRESIDENTE EPITACIO (SP)";"SP";"PRESIDENTE EPITACIO";342;19;67;428
2005;"PRESIDENTE PRUDENTE (SP)";"SP";"PRESIDENTE PRUDENTE";3043;191;753;3987
2005;"PRESIDENTE VENCESLAU (SP)";"SP";"PRESIDENTE VENCESLAU";532;23;47;602
2005;"PROMISSAO (SP)";"SP";"PROMISSAO";511;22;89;622
2005;"QUADRA (SP)";"SP";"QUADRA";34;6;11;51
2005;"QUATA (SP)";"SP";"QUATA";145;7;52;204
2005;"QUEIROZ (SP)";"SP";"QUEIROZ";15;1;5;21
2005;"QUELUZ (SP)";"SP";"QUELUZ";105;11;5;121
2005;"QUINTANA (SP)";"SP";"QUINTANA";80;7;7;94
2005;"RAFARD (SP)";"SP";"RAFARD";202;10;16;228
2005;"RANCHARIA (SP)";"SP";"RANCHARIA";479;38;53;570
2005;"REDENCAO DA SERRA (SP)";"SP";"REDENCAO DA SERRA";33;7;14;54
2005;"REGENTE FEIJO (SP)";"SP";"REGENTE FEIJO";284;21;17;322
2005;"REGINOPOLIS (SP)";"SP";"REGINOPOLIS";66;2;19;87
2005;"REGISTRO (SP)";"SP";"REGISTRO";786;67;231;1084
2005;"RESTINGA (SP)";"SP";"RESTINGA";38;5;11;54
2005;"RIBEIRA (SP)";"SP";"RIBEIRA";25;4;7;36
2005;"RIBEIRAO BONITO (SP)";"SP";"RIBEIRAO BONITO";243;19;44;306
2005;"RIBEIRAO BRANCO (SP)";"SP";"RIBEIRAO BRANCO";122;13;21;156
2005;"RIBEIRAO CORRENTE (SP)";"SP";"RIBEIRAO CORRENTE";34;4;18;56
2005;"RIBEIRAO DO SUL (SP)";"SP";"RIBEIRAO DO SUL";89;4;13;106
2005;"RIBEIRAO DOS INDIOS (SP)";"SP";"RIBEIRAO DOS INDIOS";19;1;7;27
2005;"RIBEIRAO GRANDE (SP)";"SP";"RIBEIRAO GRANDE";69;8;9;86
2005;"RIBEIRAO PIRES (SP)";"SP";"RIBEIRAO PIRES";1045;225;283;1553
2005;"RIBEIRAO PRETO (SP)";"SP";"RIBEIRAO PRETO";6890;628;1236;8754
2005;"RIFAINA (SP)";"SP";"RIFAINA";31;1;4;36
2005;"RINCAO (SP)";"SP";"RINCAO";167;8;36;211
2005;"RINOPOLIS (SP)";"SP";"RINOPOLIS";159;3;34;196
2005;"RIO CLARO (SP)";"SP";"RIO CLARO";2442;202;380;3024
2005;"RIO DAS PEDRAS (SP)";"SP";"RIO DAS PEDRAS";593;36;120;749
2005;"RIO GRANDE DA SERRA (SP)";"SP";"RIO GRANDE DA SERRA";197;42;20;259
2005;"RIOLANDIA (SP)";"SP";"RIOLANDIA";81;3;34;118
2005;"RIVERSUL (SP)";"SP";"RIVERSUL";49;1;14;64
2005;"ROSANA (SP)";"SP";"ROSANA";123;6;38;167
2005;"ROSEIRA (SP)";"SP";"ROSEIRA";111;23;9;143
2005;"RUBIACEA (SP)";"SP";"RUBIACEA";21;1;14;36
2005;"RUBINEIA (SP)";"SP";"RUBINEIA";16;3;6;25
2005;"SABINO (SP)";"SP";"SABINO";48;4;7;59
2005;"SAGRES (SP)";"SP";"SAGRES";9;2;4;15
2005;"SALES (SP)";"SP";"SALES";67;1;21;89
2005;"SALES OLIVEIRA (SP)";"SP";"SALES OLIVEIRA";196;7;38;241
2005;"SALESOPOLIS (SP)";"SP";"SALESOPOLIS";501;28;42;571
2005;"SALMORAO (SP)";"SP";"SALMORAO";20;2;19;41
2005;"SALTINHO (SP)";"SP";"SALTINHO";284;5;7;296
2005;"SALTO (SP)";"SP";"SALTO";1408;127;159;1694
2005;"SALTO DE PIRAPORA (SP)";"SP";"SALTO DE PIRAPORA";466;22;51;539
2005;"SALTO GRANDE (SP)";"SP";"SALTO GRANDE";107;8;20;135
2005;"SANDOVALINA (SP)";"SP";"SANDOVALINA";19;3;6;28
2005;"SANTA ADELIA (SP)";"SP";"SANTA ADELIA";524;15;66;605
2005;"SANTA ALBERTINA (SP)";"SP";"SANTA ALBERTINA";72;7;12;91
2005;"SANTA BARBARA D OESTE (SP)";"SP";"SANTA BARBARA D OESTE";1957;262;197;2416
2005;"SANTA BRANCA (SP)";"SP";"SANTA BRANCA";75;13;43;131
2005;"SANTA CLARA D OESTE (SP)";"SP";"SANTA CLARA D OESTE";16;0;3;19
2005;"SANTA CRUZ DA CONCEICAO (SP)";"SP";"SANTA CRUZ DA CONCEICAO";108;7;11;126
2005;"SANTA CRUZ DA ESPERANCA (SP)";"SP";"SANTA CRUZ DA ESPERANCA";18;0;4;22
2005;"SANTA CRUZ DAS PALMEIRAS (SP)";"SP";"SANTA CRUZ DAS PALMEIRAS";643;20;189;852
2005;"SANTA CRUZ DO RIO PARDO (SP)";"SP";"SANTA CRUZ DO RIO PARDO";988;55;62;1105
2005;"SANTA ERNESTINA (SP)";"SP";"SANTA ERNESTINA";70;3;23;96
2005;"SANTA FE DO SUL (SP)";"SP";"SANTA FE DO SUL";545;8;31;584
2005;"SANTA GERTRUDES (SP)";"SP";"SANTA GERTRUDES";370;22;23;415
2005;"SANTA ISABEL (SP)";"SP";"SANTA ISABEL";594;50;37;681
2005;"SANTA LUCIA (SP)";"SP";"SANTA LUCIA";120;14;44;178
2005;"SANTA MARIA DA SERRA (SP)";"SP";"SANTA MARIA DA SERRA";171;18;16;205
2005;"SANTA MERCEDES (SP)";"SP";"SANTA MERCEDES";26;5;5;36
2005;"SANTA RITA D OESTE (SP)";"SP";"SANTA RITA D OESTE";29;0;5;34
2005;"SANTA RITA DO PASSA QUATRO (SP)";"SP";"SANTA RITA DO PASSA QUATRO";478;39;38;555
2005;"SANTA ROSA DE VITERBO (SP)";"SP";"SANTA ROSA DE VITERBO";327;28;71;426
2005;"SANTA SALETE (SP)";"SP";"SANTA SALETE";37;3;4;44
2005;"SANTANA DA PONTE PENSA (SP)";"SP";"SANTANA DA PONTE PENSA";28;1;1;30
2005;"SANTANA DE PARNAIBA (SP)";"SP";"SANTANA DE PARNAIBA";1132;163;62;1357
2005;"SANTO ANASTACIO (SP)";"SP";"SANTO ANASTACIO";373;13;41;427
2005;"SANTO ANDRE (SP)";"SP";"SANTO ANDRE";7308;1363;1391;10062
2005;"SANTO ANTONIO DA ALEGRIA (SP)";"SP";"SANTO ANTONIO DA ALEGRIA";79;5;16;100
2005;"SANTO ANTONIO DE POSSE (SP)";"SP";"SANTO ANTONIO DE POSSE";535;20;77;632
2005;"SANTO ANTONIO DO ARACANGUA (SP)";"SP";"SANTO ANTONIO DO ARACANGUA";134;4;50;188
2005;"SANTO ANTONIO DO JARDIM (SP)";"SP";"SANTO ANTONIO DO JARDIM";164;10;11;185
2005;"SANTO ANTONIO DO PINHAL (SP)";"SP";"SANTO ANTONIO DO PINHAL";85;11;5;101
2005;"SANTO EXPEDITO (SP)";"SP";"SANTO EXPEDITO";21;1;5;27
2005;"SANTOPOLIS DO AGUAPEI (SP)";"SP";"SANTOPOLIS DO AGUAPEI";60;2;27;89
2005;"SANTOS (SP)";"SP";"SANTOS";4029;614;610;5253
2005;"SAO BENTO DO SAPUCAI (SP)";"SP";"SAO BENTO DO SAPUCAI";97;30;6;133
2005;"SAO BERNARDO DO CAMPO (SP)";"SP";"SAO BERNARDO DO CAMPO";9321;1478;1981;12780
2005;"SAO CAETANO DO SUL (SP)";"SP";"SAO CAETANO DO SUL";2376;387;361;3124
2005;"SAO CARLOS (SP)";"SP";"SAO CARLOS";2801;243;298;3342
2005;"SAO FRANCISCO (SP)";"SP";"SAO FRANCISCO";29;2;11;42
2005;"SAO JOAO DA BOA VISTA (SP)";"SP";"SAO JOAO DA BOA VISTA";1569;129;87;1785
2005;"SAO JOAO DAS DUAS PONTES (SP)";"SP";"SAO JOAO DAS DUAS PONTES";17;3;5;25
2005;"SAO JOAO DE IRACEMA (SP)";"SP";"SAO JOAO DE IRACEMA";12;2;9;23
2005;"SAO JOAO DO PAU D ALHO (SP)";"SP";"SAO JOAO DO PAU D ALHO";31;4;4;39
2005;"SAO JOAQUIM DA BARRA (SP)";"SP";"SAO JOAQUIM DA BARRA";731;34;126;891
2005;"SAO JOSE DA BELA VISTA (SP)";"SP";"SAO JOSE DA BELA VISTA";64;3;30;97
2005;"SAO JOSE DO BARREIRO (SP)";"SP";"SAO JOSE DO BARREIRO";28;4;4;36
2005;"SAO JOSE DO RIO PARDO (SP)";"SP";"SAO JOSE DO RIO PARDO";1039;44;124;1207
2005;"SAO JOSE DO RIO PRETO (SP)";"SP";"SAO JOSE DO RIO PRETO";5304;403;873;6580
2005;"SAO JOSE DOS CAMPOS (SP)";"SP";"SAO JOSE DOS CAMPOS";4528;1089;1000;6617
2005;"SAO LOURENCO DA SERRA (SP)";"SP";"SAO LOURENCO DA SERRA";151;13;17;181
2005;"SAO LUIS DO PARAITINGA (SP)";"SP";"SAO LUIS DO PARAITINGA";109;10;16;135
2005;"SAO MANUEL (SP)";"SP";"SAO MANUEL";620;39;83;742
2005;"SAO MIGUEL ARCANJO (SP)";"SP";"SAO MIGUEL ARCANJO";562;42;40;644
2005;"SAO PAULO (SP)";"SP";"SAO PAULO";120758;26319;34171;181248
2005;"SAO PEDRO (SP)";"SP";"SAO PEDRO";457;49;59;565
2005;"SAO PEDRO DO TURVO (SP)";"SP";"SAO PEDRO DO TURVO";127;10;16;153
2005;"SAO ROQUE (SP)";"SP";"SAO ROQUE";731;101;140;972
2005;"SAO SEBASTIAO (SP)";"SP";"SAO SEBASTIAO";408;51;84;543
2005;"SAO SEBASTIAO DA GRAMA (SP)";"SP";"SAO SEBASTIAO DA GRAMA";205;12;23;240
2005;"SAO SIMAO (SP)";"SP";"SAO SIMAO";262;9;37;308
2005;"SAO VICENTE (SP)";"SP";"SAO VICENTE";1314;671;390;2375
2005;"SARAPUI (SP)";"SP";"SARAPUI";120;9;7;136
2005;"SARUTAIA (SP)";"SP";"SARUTAIA";30;6;9;45
2005;"SEBASTIANOPOLIS DO SUL (SP)";"SP";"SEBASTIANOPOLIS DO SUL";71;3;11;85
2005;"SERRA AZUL (SP)";"SP";"SERRA AZUL";108;8;50;166
2005;"SERRA NEGRA (SP)";"SP";"SERRA NEGRA";323;29;25;377
2005;"SERRANA (SP)";"SP";"SERRANA";501;91;154;746
2005;"SERTAOZINHO (SP)";"SP";"SERTAOZINHO";1983;93;297;2373
2005;"SETE BARRAS (SP)";"SP";"SETE BARRAS";153;6;24;183
2005;"SEVERINIA (SP)";"SP";"SEVERINIA";292;6;123;421
2005;"SILVEIRAS (SP)";"SP";"SILVEIRAS";64;8;4;76
2005;"SOCORRO (SP)";"SP";"SOCORRO";570;71;38;679
2005;"SOROCABA (SP)";"SP";"SOROCABA";5701;830;1036;7567
2005;"SUD MENUCCI (SP)";"SP";"SUD MENUCCI";114;5;40;159
2005;"SUMARE (SP)";"SP";"SUMARE";1820;358;348;2526
2005;"SUZANO (SP)";"SP";"SUZANO";2119;251;277;2647
2005;"SUZANOPOLIS (SP)";"SP";"SUZANOPOLIS";55;4;9;68
2005;"TABAPUA (SP)";"SP";"TABAPUA";138;11;36;185
2005;"TABATINGA (SP)";"SP";"TABATINGA";320;9;90;419
2005;"TABOAO DA SERRA (SP)";"SP";"TABOAO DA SERRA";1456;454;386;2296
2005;"TACIBA (SP)";"SP";"TACIBA";55;2;7;64
2005;"TAGUAI (SP)";"SP";"TAGUAI";119;3;15;137
2005;"TAIACU (SP)";"SP";"TAIACU";137;2;14;153
2005;"TAIUVA (SP)";"SP";"TAIUVA";149;2;22;173
2005;"TAMBAU (SP)";"SP";"TAMBAU";451;20;42;513
2005;"TANABI (SP)";"SP";"TANABI";384;16;67;467
2005;"TAPIRAI (SP)";"SP";"TAPIRAI";125;7;9;141
2005;"TAPIRATIBA (SP)";"SP";"TAPIRATIBA";241;9;39;289
2005;"TAQUARAL (SP)";"SP";"TAQUARAL";52;2;18;72
2005;"TAQUARITINGA (SP)";"SP";"TAQUARITINGA";1342;46;228;1616
2005;"TAQUARITUBA (SP)";"SP";"TAQUARITUBA";491;22;46;559
2005;"TAQUARIVAI (SP)";"SP";"TAQUARIVAI";49;9;6;64
2005;"TARABAI (SP)";"SP";"TARABAI";77;2;18;97
2005;"TARUMA (SP)";"SP";"TARUMA";229;13;117;359
2005;"TATUI (SP)";"SP";"TATUI";1376;88;328;1792
2005;"TAUBATE (SP)";"SP";"TAUBATE";2230;478;591;3299
2005;"TEJUPA (SP)";"SP";"TEJUPA";41;5;4;50
2005;"TEODORO SAMPAIO (SP)";"SP";"TEODORO SAMPAIO";175;7;28;210
2005;"TERRA ROXA (SP)";"SP";"TERRA ROXA";163;8;45;216
2005;"TIETE (SP)";"SP";"TIETE";990;32;124;1146
2005;"TIMBURI (SP)";"SP";"TIMBURI";22;3;6;31
2005;"TORRE DE PEDRA (SP)";"SP";"TORRE DE PEDRA";47;2;2;51
2005;"TORRINHA (SP)";"SP";"TORRINHA";327;10;32;369
2005;"TRABIJU (SP)";"SP";"TRABIJU";24;10;8;42
2005;"TREMEMBE (SP)";"SP";"TREMEMBE";294;39;12;345
2005;"TRES FRONTEIRAS (SP)";"SP";"TRES FRONTEIRAS";62;2;7;71
2005;"TUIUTI (SP)";"SP";"TUIUTI";53;11;8;72
2005;"TUPA (SP)";"SP";"TUPA";1137;30;161;1328
2005;"TUPI PAULISTA (SP)";"SP";"TUPI PAULISTA";255;6;17;278
2005;"TURIUBA (SP)";"SP";"TURIUBA";14;3;1;18
2005;"TURMALINA (SP)";"SP";"TURMALINA";36;3;7;46
2005;"UBARANA (SP)";"SP";"UBARANA";78;3;17;98
2005;"UBATUBA (SP)";"SP";"UBATUBA";526;59;67;652
2005;"UBIRAJARA (SP)";"SP";"UBIRAJARA";71;6;10;87
2005;"UCHOA (SP)";"SP";"UCHOA";124;3;28;155
2005;"UNIAO PAULISTA (SP)";"SP";"UNIAO PAULISTA";19;2;5;26
2005;"URANIA (SP)";"SP";"URANIA";129;10;19;158
2005;"URU (SP)";"SP";"URU";13;4;6;23
2005;"URUPES (SP)";"SP";"URUPES";317;11;45;373
2005;"VALENTIM GENTIL (SP)";"SP";"VALENTIM GENTIL";144;14;21;179
2005;"VALINHOS (SP)";"SP";"VALINHOS";1643;326;739;2708
2005;"VALPARAISO (SP)";"SP";"VALPARAISO";275;16;89;380
2005;"VARGEM (SP)";"SP";"VARGEM";165;10;12;187
2005;"VARGEM GRANDE DO SUL (SP)";"SP";"VARGEM GRANDE DO SUL";903;44;124;1071
2005;"VARGEM GRANDE PAULISTA (SP)";"SP";"VARGEM GRANDE PAULISTA";670;69;38;777
2005;"VARZEA PAULISTA (SP)";"SP";"VARZEA PAULISTA";736;202;134;1072
2005;"VERA CRUZ (SP)";"SP";"VERA CRUZ";131;13;19;163
2005;"VINHEDO (SP)";"SP";"VINHEDO";938;98;71;1107
2005;"VIRADOURO (SP)";"SP";"VIRADOURO";333;11;58;402
2005;"VISTA ALEGRE DO ALTO (SP)";"SP";"VISTA ALEGRE DO ALTO";277;16;57;350
2005;"VITORIA BRASIL (SP)";"SP";"VITORIA BRASIL";13;0;9;22
2005;"VOTORANTIM (SP)";"SP";"VOTORANTIM";888;170;30;1088
2005;"VOTUPORANGA (SP)";"SP";"VOTUPORANGA";1407;46;131;1584
2005;"ZACARIAS (SP)";"SP";"ZACARIAS";26;4;11;41
2005;"ABREULANDIA (TO)";"TO";"ABREULANDIA";8;1;0;9
2005;"AGUIARNOPOLIS (TO)";"TO";"AGUIARNOPOLIS";16;2;3;21
2005;"ALIANCA DO TOCANTINS (TO)";"TO";"ALIANCA DO TOCANTINS";65;2;3;70
2005;"ALMAS (TO)";"TO";"ALMAS";22;0;2;24
2005;"ALVORADA (TO)";"TO";"ALVORADA";106;0;5;111
2005;"ANANAS (TO)";"TO";"ANANAS";38;4;11;53
2005;"ANGICO (TO)";"TO";"ANGICO";6;1;2;9
2005;"APARECIDA DO RIO NEGRO (TO)";"TO";"APARECIDA DO RIO NEGRO";26;7;2;35
2005;"ARAGOMINAS (TO)";"TO";"ARAGOMINAS";143;4;3;150
2005;"ARAGUACEMA (TO)";"TO";"ARAGUACEMA";15;1;4;20
2005;"ARAGUACU (TO)";"TO";"ARAGUACU";59;3;3;65
2005;"ARAGUAINA (TO)";"TO";"ARAGUAINA";2562;82;216;2860
2005;"ARAGUANA (TO)";"TO";"ARAGUANA";252;6;7;265
2005;"ARAGUATINS (TO)";"TO";"ARAGUATINS";148;28;43;219
2005;"ARAPOEMA (TO)";"TO";"ARAPOEMA";37;2;5;44
2005;"ARRAIAS (TO)";"TO";"ARRAIAS";21;0;4;25
2005;"AUGUSTINOPOLIS (TO)";"TO";"AUGUSTINOPOLIS";72;32;3;107
2005;"AURORA DO TOCANTINS (TO)";"TO";"AURORA DO TOCANTINS";1;0;2;3
2005;"AXIXA DO TOCANTINS (TO)";"TO";"AXIXA DO TOCANTINS";16;15;4;35
2005;"BABACULANDIA (TO)";"TO";"BABACULANDIA";241;12;7;260
2005;"BANDEIRANTES DO TOCANTINS (TO)";"TO";"BANDEIRANTES DO TOCANTINS";16;2;2;20
2005;"BARRA DO OURO (TO)";"TO";"BARRA DO OURO";2;0;0;2
2005;"BARROLANDIA (TO)";"TO";"BARROLANDIA";30;1;2;33
2005;"BERNARDO SAYAO (TO)";"TO";"BERNARDO SAYAO";24;2;4;30
2005;"BOM JESUS DO TOCANTINS (TO)";"TO";"BOM JESUS DO TOCANTINS";0;2;0;2
2005;"BRASILANDIA DO TOCANTINS (TO)";"TO";"BRASILANDIA DO TOCANTINS";11;1;1;13
2005;"BREJINHO DE NAZARE (TO)";"TO";"BREJINHO DE NAZARE";24;0;4;28
2005;"BURITI DO TOCANTINS (TO)";"TO";"BURITI DO TOCANTINS";12;8;1;21
2005;"CACHOEIRINHA (TO)";"TO";"CACHOEIRINHA";4;1;0;5
2005;"CAMPOS LINDOS (TO)";"TO";"CAMPOS LINDOS";28;0;1;29
2005;"CARIRI DO TOCANTINS (TO)";"TO";"CARIRI DO TOCANTINS";24;1;2;27
2005;"CARMOLANDIA (TO)";"TO";"CARMOLANDIA";467;35;27;529
2005;"CARRASCO BONITO (TO)";"TO";"CARRASCO BONITO";3;3;1;7
2005;"CASEARA (TO)";"TO";"CASEARA";17;3;1;21
2005;"CENTENARIO (TO)";"TO";"CENTENARIO";3;0;0;3
2005;"CHAPADA DA NATIVIDADE (TO)";"TO";"CHAPADA DA NATIVIDADE";12;0;2;14
2005;"CHAPADA DE AREIA (TO)";"TO";"CHAPADA DE AREIA";1;0;1;2
2005;"COLINAS DO TOCANTINS (TO)";"TO";"COLINAS DO TOCANTINS";379;12;24;415
2005;"COLMEIA (TO)";"TO";"COLMEIA";99;6;7;112
2005;"COMBINADO (TO)";"TO";"COMBINADO";10;1;3;14
2005;"CONCEICAO DO TOCANTINS (TO)";"TO";"CONCEICAO DO TOCANTINS";5;0;0;5
2005;"COUTO DE MAGALHAES (TO)";"TO";"COUTO DE MAGALHAES";6;4;0;10
2005;"CRISTALANDIA (TO)";"TO";"CRISTALANDIA";63;0;2;65
2005;"CRIXAS DO TOCANTINS (TO)";"TO";"CRIXAS DO TOCANTINS";2;4;0;6
2005;"DARCINOPOLIS (TO)";"TO";"DARCINOPOLIS";157;19;4;180
2005;"DIANOPOLIS (TO)";"TO";"DIANOPOLIS";77;3;17;97
2005;"DIVINOPOLIS DO TOCANTINS (TO)";"TO";"DIVINOPOLIS DO TOCANTINS";42;2;2;46
2005;"DOIS IRMAOS DO TOCANTINS (TO)";"TO";"DOIS IRMAOS DO TOCANTINS";27;1;2;30
2005;"DUERE (TO)";"TO";"DUERE";19;1;2;22
2005;"ESPERANTINA (TO)";"TO";"ESPERANTINA";11;6;1;18
2005;"FATIMA (TO)";"TO";"FATIMA";21;2;2;25
2005;"FIGUEIROPOLIS (TO)";"TO";"FIGUEIROPOLIS";39;5;3;47
2005;"FILADELFIA (TO)";"TO";"FILADELFIA";29;6;5;40
2005;"FORMOSO DO ARAGUAIA (TO)";"TO";"FORMOSO DO ARAGUAIA";103;6;17;126
2005;"FORTALEZA DO TABOCAO (TO)";"TO";"FORTALEZA DO TABOCAO";19;4;1;24
2005;"GOIANORTE (TO)";"TO";"GOIANORTE";13;1;3;17
2005;"GOIATINS (TO)";"TO";"GOIATINS";9;3;1;13
2005;"GUARAI (TO)";"TO";"GUARAI";248;7;10;265
2005;"GURUPI (TO)";"TO";"GURUPI";1065;21;121;1207
2005;"IPUEIRAS (TO)";"TO";"IPUEIRAS";1;0;2;3
2005;"ITACAJA (TO)";"TO";"ITACAJA";16;1;0;17
2005;"ITAGUATINS (TO)";"TO";"ITAGUATINS";18;2;1;21
2005;"ITAPIRATINS (TO)";"TO";"ITAPIRATINS";7;0;5;12
2005;"ITAPORA DO TOCANTINS (TO)";"TO";"ITAPORA DO TOCANTINS";9;1;1;11
2005;"JAU DO TOCANTINS (TO)";"TO";"JAU DO TOCANTINS";13;0;4;17
2005;"JUARINA (TO)";"TO";"JUARINA";6;1;0;7
2005;"LAGOA DA CONFUSAO (TO)";"TO";"LAGOA DA CONFUSAO";37;1;3;41
2005;"LAGOA DO TOCANTINS (TO)";"TO";"LAGOA DO TOCANTINS";3;1;2;6
2005;"LAJEADO (TO)";"TO";"LAJEADO";11;0;9;20
2005;"LAVANDEIRA (TO)";"TO";"LAVANDEIRA";0;1;1;2
2005;"LIZARDA (TO)";"TO";"LIZARDA";4;1;0;5
2005;"LUZINOPOLIS (TO)";"TO";"LUZINOPOLIS";4;1;0;5
2005;"MARIANOPOLIS DO TOCANTINS (TO)";"TO";"MARIANOPOLIS DO TOCANTINS";19;0;3;22
2005;"MATEIROS (TO)";"TO";"MATEIROS";11;0;2;13
2005;"MAURILANDIA DO TOCANTINS (TO)";"TO";"MAURILANDIA DO TOCANTINS";3;0;1;4
2005;"MIRACEMA DO TOCANTINS (TO)";"TO";"MIRACEMA DO TOCANTINS";130;7;33;170
2005;"MIRANORTE (TO)";"TO";"MIRANORTE";153;7;5;165
2005;"MONTE DO CARMO (TO)";"TO";"MONTE DO CARMO";6;0;2;8
2005;"MONTE SANTO DO TOCANTINS (TO)";"TO";"MONTE SANTO DO TOCANTINS";55;2;2;59
2005;"MURICILANDIA (TO)";"TO";"MURICILANDIA";11;0;1;12
2005;"NATIVIDADE (TO)";"TO";"NATIVIDADE";33;1;1;35
2005;"NAZARE (TO)";"TO";"NAZARE";11;3;1;15
2005;"NOVA OLINDA (TO)";"TO";"NOVA OLINDA";42;5;5;52
2005;"NOVA ROSALANDIA (TO)";"TO";"NOVA ROSALANDIA";14;0;3;17
2005;"NOVO ACORDO (TO)";"TO";"NOVO ACORDO";15;0;1;16
2005;"NOVO ALEGRE (TO)";"TO";"NOVO ALEGRE";3;2;0;5
2005;"NOVO JARDIM (TO)";"TO";"NOVO JARDIM";4;0;2;6
2005;"OLIVEIRA DE FATIMA (TO)";"TO";"OLIVEIRA DE FATIMA";4;0;2;6
2005;"PALMAS (TO)";"TO";"PALMAS";2279;174;390;2843
2005;"PALMEIRANTE (TO)";"TO";"PALMEIRANTE";3;2;0;5
2005;"PALMEIRAS DO TOCANTINS (TO)";"TO";"PALMEIRAS DO TOCANTINS";19;2;1;22
2005;"PALMEIROPOLIS (TO)";"TO";"PALMEIROPOLIS";44;2;8;54
2005;"PARAISO DO TOCANTINS (TO)";"TO";"PARAISO DO TOCANTINS";769;20;70;859
2005;"PARANA (TO)";"TO";"PARANA";12;2;1;15
2005;"PAU D ARCO (TO)";"TO";"PAU D ARCO";7;1;1;9
2005;"PEDRO AFONSO (TO)";"TO";"PEDRO AFONSO";66;0;8;74
2005;"PEIXE (TO)";"TO";"PEIXE";33;5;63;101
2005;"PEQUIZEIRO (TO)";"TO";"PEQUIZEIRO";17;0;4;21
2005;"PINDORAMA DO TOCANTINS (TO)";"TO";"PINDORAMA DO TOCANTINS";15;0;2;17
2005;"PIRAQUE (TO)";"TO";"PIRAQUE";6;0;4;10
2005;"PIUM (TO)";"TO";"PIUM";25;2;5;32
2005;"PONTE ALTA DO BOM JESUS (TO)";"TO";"PONTE ALTA DO BOM JESUS";4;0;0;4
2005;"PONTE ALTA DO TOCANTINS (TO)";"TO";"PONTE ALTA DO TOCANTINS";12;4;3;19
2005;"PORTO ALEGRE DO TOCANTINS (TO)";"TO";"PORTO ALEGRE DO TOCANTINS";5;0;1;6
2005;"PORTO NACIONAL (TO)";"TO";"PORTO NACIONAL";442;18;73;533
2005;"PRAIA NORTE (TO)";"TO";"PRAIA NORTE";2;4;0;6
2005;"PRESIDENTE KENNEDY (TO)";"TO";"PRESIDENTE KENNEDY";12;0;1;13
2005;"PUGMIL (TO)";"TO";"PUGMIL";14;3;0;17
2005;"RECURSOLANDIA (TO)";"TO";"RECURSOLANDIA";7;0;0;7
2005;"RIACHINHO (TO)";"TO";"RIACHINHO";96;2;7;105
2005;"RIO DA CONCEICAO (TO)";"TO";"RIO DA CONCEICAO";1;1;1;3
2005;"RIO DOS BOIS (TO)";"TO";"RIO DOS BOIS";4;1;2;7
2005;"RIO SONO (TO)";"TO";"RIO SONO";13;1;2;16
2005;"SAMPAIO (TO)";"TO";"SAMPAIO";84;3;1;88
2005;"SANDOLANDIA (TO)";"TO";"SANDOLANDIA";6;1;1;8
2005;"SANTA FE DO ARAGUAIA (TO)";"TO";"SANTA FE DO ARAGUAIA";74;31;11;116
2005;"SANTA MARIA DO TOCANTINS (TO)";"TO";"SANTA MARIA DO TOCANTINS";7;1;0;8
2005;"SANTA RITA DO TOCANTINS (TO)";"TO";"SANTA RITA DO TOCANTINS";5;1;1;7
2005;"SANTA ROSA DO TOCANTINS (TO)";"TO";"SANTA ROSA DO TOCANTINS";13;1;2;16
2005;"SANTA TEREZA DO TOCANTINS (TO)";"TO";"SANTA TEREZA DO TOCANTINS";3;1;0;4
2005;"SANTA TEREZINHA DO TOCANTINS (TO)";"TO";"SANTA TEREZINHA DO TOCANTINS";4;1;2;7
2005;"SAO BENTO DO TOCANTINS (TO)";"TO";"SAO BENTO DO TOCANTINS";5;2;3;10
2005;"SAO FELIX DO TOCANTINS (TO)";"TO";"SAO FELIX DO TOCANTINS";0;1;0;1
2005;"SAO MIGUEL DO TOCANTINS (TO)";"TO";"SAO MIGUEL DO TOCANTINS";27;9;3;39
2005;"SAO SALVADOR DO TOCANTINS (TO)";"TO";"SAO SALVADOR DO TOCANTINS";23;0;1;24
2005;"SAO SEBASTIAO DO TOCANTINS (TO)";"TO";"SAO SEBASTIAO DO TOCANTINS";5;1;1;7
2005;"SAO VALERIO DA NATIVIDADE (TO)";"TO";"SAO VALERIO DA NATIVIDADE";25;1;4;30
2005;"SILVANOPOLIS (TO)";"TO";"SILVANOPOLIS";12;0;0;12
2005;"SITIO NOVO DO TOCANTINS (TO)";"TO";"SITIO NOVO DO TOCANTINS";22;5;4;31
2005;"SUCUPIRA (TO)";"TO";"SUCUPIRA";5;0;6;11
2005;"TAGUATINGA (TO)";"TO";"TAGUATINGA";43;2;8;53
2005;"TAIPAS DO TOCANTINS (TO)";"TO";"TAIPAS DO TOCANTINS";3;0;0;3
2005;"TALISMA (TO)";"TO";"TALISMA";6;5;0;11
2005;"TOCANTINIA (TO)";"TO";"TOCANTINIA";13;0;0;13
2005;"TOCANTINOPOLIS (TO)";"TO";"TOCANTINOPOLIS";1590;259;188;2037
2005;"TUPIRAMA (TO)";"TO";"TUPIRAMA";4;3;0;7
2005;"TUPIRATINS (TO)";"TO";"TUPIRATINS";6;0;1;7
2005;"WANDERLANDIA (TO)";"TO";"WANDERLANDIA";33;4;4;41
2005;"XAMBIOA (TO)";"TO";"XAMBIOA";41;4;2;47
