"ano";"chave";"UF";"MUNICIPIO";"CAMINHAO";"MICRO_ONIBUS";"ONIBUS";"total"
2017;"ACRELANDIA (AC)";"AC";"ACRELANDIA";235;8;43;286
2017;"ASSIS BRASIL (AC)";"AC";"ASSIS BRASIL";26;3;2;31
2017;"BRASILEIA (AC)";"AC";"BRASILEIA";256;5;18;279
2017;"BUJARI (AC)";"AC";"BUJARI";109;5;12;126
2017;"CAPIXABA (AC)";"AC";"CAPIXABA";77;2;13;92
2017;"CRUZEIRO DO SUL (AC)";"AC";"CRUZEIRO DO SUL";712;57;72;841
2017;"EPITACIOLANDIA (AC)";"AC";"EPITACIOLANDIA";222;3;14;239
2017;"FEIJO (AC)";"AC";"FEIJO";114;1;7;122
2017;"JORDAO (AC)";"AC";"JORDAO";2;0;0;2
2017;"MANCIO LIMA (AC)";"AC";"MANCIO LIMA";92;4;13;109
2017;"MANOEL URBANO (AC)";"AC";"MANOEL URBANO";47;0;5;52
2017;"MARECHAL THAUMATURGO (AC)";"AC";"MARECHAL THAUMATURGO";11;0;9;20
2017;"PLACIDO DE CASTRO (AC)";"AC";"PLACIDO DE CASTRO";149;3;20;172
2017;"PORTO ACRE (AC)";"AC";"PORTO ACRE";169;2;38;209
2017;"PORTO WALTER (AC)";"AC";"PORTO WALTER";9;0;5;14
2017;"RIO BRANCO (AC)";"AC";"RIO BRANCO";4181;226;771;5178
2017;"RODRIGUES ALVES (AC)";"AC";"RODRIGUES ALVES";16;0;7;23
2017;"SANTA ROSA DO PURUS (AC)";"AC";"SANTA ROSA DO PURUS";4;0;3;7
2017;"SENA MADUREIRA (AC)";"AC";"SENA MADUREIRA";99;6;9;114
2017;"SENADOR GUIOMARD (AC)";"AC";"SENADOR GUIOMARD";343;8;33;384
2017;"TARAUACA (AC)";"AC";"TARAUACA";144;23;26;193
2017;"XAPURI (AC)";"AC";"XAPURI";68;4;6;78
2017;"AGUA BRANCA (AL)";"AL";"AGUA BRANCA";74;78;12;164
2017;"ANADIA (AL)";"AL";"ANADIA";49;41;37;127
2017;"ARAPIRACA (AL)";"AL";"ARAPIRACA";2866;394;411;3671
2017;"ATALAIA (AL)";"AL";"ATALAIA";206;48;136;390
2017;"BARRA DE SANTO ANTONIO (AL)";"AL";"BARRA DE SANTO ANTONIO";32;6;25;63
2017;"BARRA DE SAO MIGUEL (AL)";"AL";"BARRA DE SAO MIGUEL";27;6;9;42
2017;"BATALHA (AL)";"AL";"BATALHA";117;42;14;173
2017;"BELEM (AL)";"AL";"BELEM";12;23;6;41
2017;"BELO MONTE (AL)";"AL";"BELO MONTE";36;14;7;57
2017;"BOCA DA MATA (AL)";"AL";"BOCA DA MATA";205;68;96;369
2017;"BRANQUINHA (AL)";"AL";"BRANQUINHA";32;19;20;71
2017;"CACIMBINHAS (AL)";"AL";"CACIMBINHAS";76;42;13;131
2017;"CAJUEIRO (AL)";"AL";"CAJUEIRO";89;9;54;152
2017;"CAMPESTRE (AL)";"AL";"CAMPESTRE";33;53;9;95
2017;"CAMPO ALEGRE (AL)";"AL";"CAMPO ALEGRE";126;102;134;362
2017;"CAMPO GRANDE (AL)";"AL";"CAMPO GRANDE";49;16;19;84
2017;"CANAPI (AL)";"AL";"CANAPI";53;46;24;123
2017;"CAPELA (AL)";"AL";"CAPELA";68;5;59;132
2017;"CARNEIROS (AL)";"AL";"CARNEIROS";31;11;5;47
2017;"CHA PRETA (AL)";"AL";"CHA PRETA";32;9;6;47
2017;"COITE DO NOIA (AL)";"AL";"COITE DO NOIA";82;8;25;115
2017;"COLONIA LEOPOLDINA (AL)";"AL";"COLONIA LEOPOLDINA";88;24;37;149
2017;"COQUEIRO SECO (AL)";"AL";"COQUEIRO SECO";8;3;8;19
2017;"CORURIPE (AL)";"AL";"CORURIPE";341;78;221;640
2017;"CRAIBAS (AL)";"AL";"CRAIBAS";212;36;32;280
2017;"DELMIRO GOUVEIA (AL)";"AL";"DELMIRO GOUVEIA";618;431;82;1131
2017;"DOIS RIACHOS (AL)";"AL";"DOIS RIACHOS";86;18;13;117
2017;"ESTRELA DE ALAGOAS (AL)";"AL";"ESTRELA DE ALAGOAS";57;83;27;167
2017;"FEIRA GRANDE (AL)";"AL";"FEIRA GRANDE";97;3;43;143
2017;"FELIZ DESERTO (AL)";"AL";"FELIZ DESERTO";11;5;11;27
2017;"FLEXEIRAS (AL)";"AL";"FLEXEIRAS";33;20;43;96
2017;"GIRAU DO PONCIANO (AL)";"AL";"GIRAU DO PONCIANO";207;64;76;347
2017;"IBATEGUARA (AL)";"AL";"IBATEGUARA";50;62;16;128
2017;"IGACI (AL)";"AL";"IGACI";146;124;40;310
2017;"IGREJA NOVA (AL)";"AL";"IGREJA NOVA";81;25;101;207
2017;"INHAPI (AL)";"AL";"INHAPI";76;23;6;105
2017;"JACARE DOS HOMENS (AL)";"AL";"JACARE DOS HOMENS";38;8;11;57
2017;"JACUIPE (AL)";"AL";"JACUIPE";14;16;14;44
2017;"JAPARATINGA (AL)";"AL";"JAPARATINGA";17;23;13;53
2017;"JARAMATAIA (AL)";"AL";"JARAMATAIA";32;11;7;50
2017;"JEQUIA DA PRAIA (AL)";"AL";"JEQUIA DA PRAIA";39;8;39;86
2017;"JOAQUIM GOMES (AL)";"AL";"JOAQUIM GOMES";107;28;83;218
2017;"JUNDIA (AL)";"AL";"JUNDIA";16;5;13;34
2017;"JUNQUEIRO (AL)";"AL";"JUNQUEIRO";190;25;112;327
2017;"LAGOA DA CANOA (AL)";"AL";"LAGOA DA CANOA";99;25;40;164
2017;"LIMOEIRO DE ANADIA (AL)";"AL";"LIMOEIRO DE ANADIA";142;25;48;215
2017;"MACEIO (AL)";"AL";"MACEIO";7314;1169;2147;10630
2017;"MAJOR ISIDORO (AL)";"AL";"MAJOR ISIDORO";108;34;27;169
2017;"MAR VERMELHO (AL)";"AL";"MAR VERMELHO";11;1;9;21
2017;"MARAGOGI (AL)";"AL";"MARAGOGI";89;146;41;276
2017;"MARAVILHA (AL)";"AL";"MARAVILHA";62;51;8;121
2017;"MARECHAL DEODORO (AL)";"AL";"MARECHAL DEODORO";298;61;162;521
2017;"MARIBONDO (AL)";"AL";"MARIBONDO";72;16;15;103
2017;"MATA GRANDE (AL)";"AL";"MATA GRANDE";66;38;16;120
2017;"MATRIZ DE CAMARAGIBE (AL)";"AL";"MATRIZ DE CAMARAGIBE";145;27;126;298
2017;"MESSIAS (AL)";"AL";"MESSIAS";64;45;93;202
2017;"MINADOR DO NEGRAO (AL)";"AL";"MINADOR DO NEGRAO";58;14;8;80
2017;"MONTEIROPOLIS (AL)";"AL";"MONTEIROPOLIS";15;9;5;29
2017;"MURICI (AL)";"AL";"MURICI";120;24;96;240
2017;"NOVO LINO (AL)";"AL";"NOVO LINO";73;43;65;181
2017;"OLHO D AGUA DAS FLORES (AL)";"AL";"OLHO D AGUA DAS FLORES";126;97;31;254
2017;"OLHO D AGUA DO CASADO (AL)";"AL";"OLHO D AGUA DO CASADO";36;16;12;64
2017;"OLHO D AGUA GRANDE (AL)";"AL";"OLHO D AGUA GRANDE";14;2;14;30
2017;"OLIVENCA (AL)";"AL";"OLIVENCA";61;27;13;101
2017;"OURO BRANCO (AL)";"AL";"OURO BRANCO";88;51;32;171
2017;"PALESTINA (AL)";"AL";"PALESTINA";11;14;5;30
2017;"PALMEIRA DOS INDIOS (AL)";"AL";"PALMEIRA DOS INDIOS";646;295;75;1016
2017;"PAO DE ACUCAR (AL)";"AL";"PAO DE ACUCAR";71;47;15;133
2017;"PARICONHA (AL)";"AL";"PARICONHA";47;41;15;103
2017;"PARIPUEIRA (AL)";"AL";"PARIPUEIRA";60;6;19;85
2017;"PASSO DE CAMARAGIBE (AL)";"AL";"PASSO DE CAMARAGIBE";41;9;32;82
2017;"PAULO JACINTO (AL)";"AL";"PAULO JACINTO";17;9;9;35
2017;"PENEDO (AL)";"AL";"PENEDO";263;67;266;596
2017;"PIACABUCU (AL)";"AL";"PIACABUCU";31;14;20;65
2017;"PILAR (AL)";"AL";"PILAR";153;55;76;284
2017;"PINDOBA (AL)";"AL";"PINDOBA";8;1;4;13
2017;"PIRANHAS (AL)";"AL";"PIRANHAS";84;98;18;200
2017;"POCO DAS TRINCHEIRAS (AL)";"AL";"POCO DAS TRINCHEIRAS";69;62;25;156
2017;"PORTO CALVO (AL)";"AL";"PORTO CALVO";201;122;72;395
2017;"PORTO DE PEDRAS (AL)";"AL";"PORTO DE PEDRAS";20;9;10;39
2017;"PORTO REAL DO COLEGIO (AL)";"AL";"PORTO REAL DO COLEGIO";35;34;21;90
2017;"QUEBRANGULO (AL)";"AL";"QUEBRANGULO";39;12;13;64
2017;"RIO LARGO (AL)";"AL";"RIO LARGO";452;190;205;847
2017;"ROTEIRO (AL)";"AL";"ROTEIRO";14;26;13;53
2017;"SANTA LUZIA DO NORTE (AL)";"AL";"SANTA LUZIA DO NORTE";21;3;53;77
2017;"SANTANA DO IPANEMA (AL)";"AL";"SANTANA DO IPANEMA";440;232;44;716
2017;"SANTANA DO MUNDAU (AL)";"AL";"SANTANA DO MUNDAU";78;34;11;123
2017;"SAO BRAS (AL)";"AL";"SAO BRAS";6;4;6;16
2017;"SAO JOSE DA LAJE (AL)";"AL";"SAO JOSE DA LAJE";116;73;60;249
2017;"SAO JOSE DA TAPERA (AL)";"AL";"SAO JOSE DA TAPERA";134;81;36;251
2017;"SAO LUIS DO QUITUNDE (AL)";"AL";"SAO LUIS DO QUITUNDE";239;36;206;481
2017;"SAO MIGUEL DOS CAMPOS (AL)";"AL";"SAO MIGUEL DOS CAMPOS";432;157;176;765
2017;"SAO MIGUEL DOS MILAGRES (AL)";"AL";"SAO MIGUEL DOS MILAGRES";27;3;7;37
2017;"SAO SEBASTIAO (AL)";"AL";"SAO SEBASTIAO";160;38;145;343
2017;"SATUBA (AL)";"AL";"SATUBA";65;20;24;109
2017;"SENADOR RUI PALMEIRA (AL)";"AL";"SENADOR RUI PALMEIRA";40;16;16;72
2017;"TANQUE D ARCA (AL)";"AL";"TANQUE D ARCA";16;20;9;45
2017;"TAQUARANA (AL)";"AL";"TAQUARANA";114;72;43;229
2017;"TEOTONIO VILELA (AL)";"AL";"TEOTONIO VILELA";188;80;205;473
2017;"TRAIPU (AL)";"AL";"TRAIPU";100;14;24;138
2017;"UNIAO DOS PALMARES (AL)";"AL";"UNIAO DOS PALMARES";526;275;205;1006
2017;"VICOSA (AL)";"AL";"VICOSA";144;32;46;222
2017;"ALVARAES (AM)";"AM";"ALVARAES";9;0;3;12
2017;"AMATURA (AM)";"AM";"AMATURA";4;0;1;5
2017;"ANAMA (AM)";"AM";"ANAMA";1;0;6;7
2017;"ANORI (AM)";"AM";"ANORI";7;1;3;11
2017;"APUI (AM)";"AM";"APUI";162;3;28;193
2017;"ATALAIA DO NORTE (AM)";"AM";"ATALAIA DO NORTE";2;1;1;4
2017;"AUTAZES (AM)";"AM";"AUTAZES";37;4;22;63
2017;"BARCELOS (AM)";"AM";"BARCELOS";11;1;0;12
2017;"BARREIRINHA (AM)";"AM";"BARREIRINHA";9;0;6;15
2017;"BENJAMIN CONSTANT (AM)";"AM";"BENJAMIN CONSTANT";12;6;4;22
2017;"BERURI (AM)";"AM";"BERURI";8;0;0;8
2017;"BOA VISTA DO RAMOS (AM)";"AM";"BOA VISTA DO RAMOS";3;0;1;4
2017;"BOCA DO ACRE (AM)";"AM";"BOCA DO ACRE";58;4;8;70
2017;"BORBA (AM)";"AM";"BORBA";21;0;6;27
2017;"CAAPIRANGA (AM)";"AM";"CAAPIRANGA";12;1;8;21
2017;"CANUTAMA (AM)";"AM";"CANUTAMA";5;0;1;6
2017;"CARAUARI (AM)";"AM";"CARAUARI";44;1;1;46
2017;"CAREIRO (AM)";"AM";"CAREIRO";77;47;79;203
2017;"CAREIRO DA VARZEA (AM)";"AM";"CAREIRO DA VARZEA";27;25;45;97
2017;"COARI (AM)";"AM";"COARI";135;7;15;157
2017;"CODAJAS (AM)";"AM";"CODAJAS";9;2;4;15
2017;"EIRUNEPE (AM)";"AM";"EIRUNEPE";38;2;5;45
2017;"ENVIRA (AM)";"AM";"ENVIRA";17;0;5;22
2017;"FONTE BOA (AM)";"AM";"FONTE BOA";17;0;0;17
2017;"GUAJARA (AM)";"AM";"GUAJARA";4;0;9;13
2017;"HUMAITA (AM)";"AM";"HUMAITA";228;6;33;267
2017;"IPIXUNA (AM)";"AM";"IPIXUNA";4;0;3;7
2017;"IRANDUBA (AM)";"AM";"IRANDUBA";357;49;138;544
2017;"ITACOATIARA (AM)";"AM";"ITACOATIARA";398;39;162;599
2017;"ITAMARATI (AM)";"AM";"ITAMARATI";11;0;0;11
2017;"ITAPIRANGA (AM)";"AM";"ITAPIRANGA";17;2;6;25
2017;"JAPURA (AM)";"AM";"JAPURA";4;0;4;8
2017;"JURUA (AM)";"AM";"JURUA";10;0;4;14
2017;"JUTAI (AM)";"AM";"JUTAI";4;0;0;4
2017;"LABREA (AM)";"AM";"LABREA";42;2;7;51
2017;"MANACAPURU (AM)";"AM";"MANACAPURU";387;90;113;590
2017;"MANAQUIRI (AM)";"AM";"MANAQUIRI";13;7;8;28
2017;"MANAUS (AM)";"AM";"MANAUS";16413;3033;7671;27117
2017;"MANICORE (AM)";"AM";"MANICORE";56;1;17;74
2017;"MARAA (AM)";"AM";"MARAA";5;1;0;6
2017;"MAUES (AM)";"AM";"MAUES";54;5;20;79
2017;"NHAMUNDA (AM)";"AM";"NHAMUNDA";8;0;1;9
2017;"NOVA OLINDA DO NORTE (AM)";"AM";"NOVA OLINDA DO NORTE";20;6;10;36
2017;"NOVO AIRAO (AM)";"AM";"NOVO AIRAO";29;10;11;50
2017;"NOVO ARIPUANA (AM)";"AM";"NOVO ARIPUANA";33;2;7;42
2017;"PARINTINS (AM)";"AM";"PARINTINS";163;8;29;200
2017;"PAUINI (AM)";"AM";"PAUINI";3;1;1;5
2017;"PRESIDENTE FIGUEIREDO (AM)";"AM";"PRESIDENTE FIGUEIREDO";349;57;97;503
2017;"RIO PRETO DA EVA (AM)";"AM";"RIO PRETO DA EVA";165;19;77;261
2017;"SANTA ISABEL DO RIO NEGRO (AM)";"AM";"SANTA ISABEL DO RIO NEGRO";10;4;3;17
2017;"SANTO ANTONIO DO ICA (AM)";"AM";"SANTO ANTONIO DO ICA";9;0;0;9
2017;"SAO GABRIEL DA CACHOEIRA (AM)";"AM";"SAO GABRIEL DA CACHOEIRA";103;14;32;149
2017;"SAO PAULO DE OLIVENCA (AM)";"AM";"SAO PAULO DE OLIVENCA";8;0;5;13
2017;"SAO SEBASTIAO DO UATUMA (AM)";"AM";"SAO SEBASTIAO DO UATUMA";6;0;1;7
2017;"SILVES (AM)";"AM";"SILVES";12;7;4;23
2017;"TABATINGA (AM)";"AM";"TABATINGA";75;10;7;92
2017;"TAPAUA (AM)";"AM";"TAPAUA";5;0;2;7
2017;"TEFE (AM)";"AM";"TEFE";74;19;21;114
2017;"TONANTINS (AM)";"AM";"TONANTINS";6;0;1;7
2017;"UARINI (AM)";"AM";"UARINI";10;0;4;14
2017;"URUCARA (AM)";"AM";"URUCARA";21;3;2;26
2017;"URUCURITUBA (AM)";"AM";"URUCURITUBA";7;1;2;10
2017;"AMAPA (AP)";"AP";"AMAPA";12;2;2;16
2017;"CALCOENE (AP)";"AP";"CALCOENE";19;2;4;25
2017;"CUTIAS (AP)";"AP";"CUTIAS";4;1;0;5
2017;"FERREIRA GOMES (AP)";"AP";"FERREIRA GOMES";6;5;5;16
2017;"ITAUBAL (AP)";"AP";"ITAUBAL";9;0;5;14
2017;"LARANJAL DO JARI (AP)";"AP";"LARANJAL DO JARI";101;10;22;133
2017;"MACAPA (AP)";"AP";"MACAPA";2924;345;893;4162
2017;"MAZAGAO (AP)";"AP";"MAZAGAO";47;15;20;82
2017;"OIAPOQUE (AP)";"AP";"OIAPOQUE";73;7;18;98
2017;"PEDRA BRANCA DO AMAPARI (AP)";"AP";"PEDRA BRANCA DO AMAPARI";32;7;17;56
2017;"PORTO GRANDE (AP)";"AP";"PORTO GRANDE";61;5;17;83
2017;"PRACUUBA (AP)";"AP";"PRACUUBA";6;1;2;9
2017;"SANTANA (AP)";"AP";"SANTANA";663;49;180;892
2017;"SERRA DO NAVIO (AP)";"AP";"SERRA DO NAVIO";16;4;4;24
2017;"TARTARUGALZINHO (AP)";"AP";"TARTARUGALZINHO";27;5;5;37
2017;"VITORIA DO JARI (AP)";"AP";"VITORIA DO JARI";5;1;4;10
2017;"ABAIRA (BA)";"BA";"ABAIRA";62;27;15;104
2017;"ABARE (BA)";"BA";"ABARE";53;47;27;127
2017;"ACAJUTIBA (BA)";"BA";"ACAJUTIBA";73;15;19;107
2017;"ADUSTINA (BA)";"BA";"ADUSTINA";15;8;12;35
2017;"AGUA FRIA (BA)";"BA";"AGUA FRIA";34;21;51;106
2017;"AIQUARA (BA)";"BA";"AIQUARA";6;7;5;18
2017;"ALAGOINHAS (BA)";"BA";"ALAGOINHAS";1369;367;617;2353
2017;"ALCOBACA (BA)";"BA";"ALCOBACA";51;11;34;96
2017;"ALMADINA (BA)";"BA";"ALMADINA";17;2;6;25
2017;"AMARGOSA (BA)";"BA";"AMARGOSA";350;87;93;530
2017;"AMELIA RODRIGUES (BA)";"BA";"AMELIA RODRIGUES";224;129;39;392
2017;"AMERICA DOURADA (BA)";"BA";"AMERICA DOURADA";45;21;14;80
2017;"ANAGE (BA)";"BA";"ANAGE";135;90;52;277
2017;"ANDARAI (BA)";"BA";"ANDARAI";48;18;26;92
2017;"ANDORINHA (BA)";"BA";"ANDORINHA";84;20;57;161
2017;"ANGICAL (BA)";"BA";"ANGICAL";40;15;25;80
2017;"ANGUERA (BA)";"BA";"ANGUERA";24;8;16;48
2017;"ANTAS (BA)";"BA";"ANTAS";32;11;12;55
2017;"ANTONIO CARDOSO (BA)";"BA";"ANTONIO CARDOSO";10;32;24;66
2017;"ANTONIO GONCALVES (BA)";"BA";"ANTONIO GONCALVES";28;17;13;58
2017;"APORA (BA)";"BA";"APORA";56;39;46;141
2017;"APUAREMA (BA)";"BA";"APUAREMA";28;6;10;44
2017;"ARACAS (BA)";"BA";"ARACAS";85;30;39;154
2017;"ARACATU (BA)";"BA";"ARACATU";138;39;37;214
2017;"ARACI (BA)";"BA";"ARACI";310;29;72;411
2017;"ARAMARI (BA)";"BA";"ARAMARI";44;6;17;67
2017;"ARATACA (BA)";"BA";"ARATACA";32;2;4;38
2017;"ARATUIPE (BA)";"BA";"ARATUIPE";44;13;18;75
2017;"AURELINO LEAL (BA)";"BA";"AURELINO LEAL";58;7;14;79
2017;"BAIANOPOLIS (BA)";"BA";"BAIANOPOLIS";63;6;42;111
2017;"BAIXA GRANDE (BA)";"BA";"BAIXA GRANDE";121;81;58;260
2017;"BANZAE (BA)";"BA";"BANZAE";24;6;24;54
2017;"BARRA (BA)";"BA";"BARRA";99;42;40;181
2017;"BARRA DA ESTIVA (BA)";"BA";"BARRA DA ESTIVA";292;92;75;459
2017;"BARRA DO CHOCA (BA)";"BA";"BARRA DO CHOCA";151;227;38;416
2017;"BARRA DO MENDES (BA)";"BA";"BARRA DO MENDES";79;33;30;142
2017;"BARRA DO ROCHA (BA)";"BA";"BARRA DO ROCHA";14;6;6;26
2017;"BARREIRAS (BA)";"BA";"BARREIRAS";2525;205;483;3213
2017;"BARRO ALTO (BA)";"BA";"BARRO ALTO";61;21;26;108
2017;"BARRO PRETO (BA)";"BA";"BARRO PRETO";20;1;11;32
2017;"BARROCAS (BA)";"BA";"BARROCAS";113;13;28;154
2017;"BELMONTE (BA)";"BA";"BELMONTE";58;9;15;82
2017;"BELO CAMPO (BA)";"BA";"BELO CAMPO";141;27;43;211
2017;"BIRITINGA (BA)";"BA";"BIRITINGA";35;19;38;92
2017;"BOA NOVA (BA)";"BA";"BOA NOVA";44;67;27;138
2017;"BOA VISTA DO TUPIM (BA)";"BA";"BOA VISTA DO TUPIM";75;19;25;119
2017;"BOM JESUS DA LAPA (BA)";"BA";"BOM JESUS DA LAPA";506;82;156;744
2017;"BOM JESUS DA SERRA (BA)";"BA";"BOM JESUS DA SERRA";47;61;24;132
2017;"BONINAL (BA)";"BA";"BONINAL";102;34;40;176
2017;"BONITO (BA)";"BA";"BONITO";119;21;25;165
2017;"BOQUIRA (BA)";"BA";"BOQUIRA";148;15;76;239
2017;"BOTUPORA (BA)";"BA";"BOTUPORA";66;6;53;125
2017;"BREJOES (BA)";"BA";"BREJOES";101;12;43;156
2017;"BREJOLANDIA (BA)";"BA";"BREJOLANDIA";35;8;21;64
2017;"BROTAS DE MACAUBAS (BA)";"BA";"BROTAS DE MACAUBAS";35;65;26;126
2017;"BRUMADO (BA)";"BA";"BRUMADO";1682;289;362;2333
2017;"BUERAREMA (BA)";"BA";"BUERAREMA";152;12;49;213
2017;"BURITIRAMA (BA)";"BA";"BURITIRAMA";53;17;29;99
2017;"CAATIBA (BA)";"BA";"CAATIBA";19;5;3;27
2017;"CABACEIRAS DO PARAGUACU (BA)";"BA";"CABACEIRAS DO PARAGUACU";101;33;72;206
2017;"CACHOEIRA (BA)";"BA";"CACHOEIRA";123;126;85;334
2017;"CACULE (BA)";"BA";"CACULE";425;42;49;516
2017;"CAEM (BA)";"BA";"CAEM";34;26;19;79
2017;"CAETANOS (BA)";"BA";"CAETANOS";103;15;20;138
2017;"CAETITE (BA)";"BA";"CAETITE";621;157;156;934
2017;"CAFARNAUM (BA)";"BA";"CAFARNAUM";93;11;53;157
2017;"CAIRU (BA)";"BA";"CAIRU";16;17;12;45
2017;"CALDEIRAO GRANDE (BA)";"BA";"CALDEIRAO GRANDE";35;10;21;66
2017;"CAMACAN (BA)";"BA";"CAMACAN";194;28;49;271
2017;"CAMACARI (BA)";"BA";"CAMACARI";2548;532;1154;4234
2017;"CAMAMU (BA)";"BA";"CAMAMU";179;50;38;267
2017;"CAMPO ALEGRE DE LOURDES (BA)";"BA";"CAMPO ALEGRE DE LOURDES";64;11;19;94
2017;"CAMPO FORMOSO (BA)";"BA";"CAMPO FORMOSO";336;33;128;497
2017;"CANAPOLIS (BA)";"BA";"CANAPOLIS";21;31;12;64
2017;"CANARANA (BA)";"BA";"CANARANA";196;39;39;274
2017;"CANAVIEIRAS (BA)";"BA";"CANAVIEIRAS";99;13;19;131
2017;"CANDEAL (BA)";"BA";"CANDEAL";26;25;22;73
2017;"CANDEIAS (BA)";"BA";"CANDEIAS";873;382;391;1646
2017;"CANDIBA (BA)";"BA";"CANDIBA";75;2;25;102
2017;"CANDIDO SALES (BA)";"BA";"CANDIDO SALES";335;65;57;457
2017;"CANSANCAO (BA)";"BA";"CANSANCAO";233;70;90;393
2017;"CANUDOS (BA)";"BA";"CANUDOS";70;11;53;134
2017;"CAPELA DO ALTO ALEGRE (BA)";"BA";"CAPELA DO ALTO ALEGRE";94;34;26;154
2017;"CAPIM GROSSO (BA)";"BA";"CAPIM GROSSO";651;98;79;828
2017;"CARAIBAS (BA)";"BA";"CARAIBAS";70;39;27;136
2017;"CARAVELAS (BA)";"BA";"CARAVELAS";49;22;37;108
2017;"CARDEAL DA SILVA (BA)";"BA";"CARDEAL DA SILVA";30;12;21;63
2017;"CARINHANHA (BA)";"BA";"CARINHANHA";126;56;52;234
2017;"CASA NOVA (BA)";"BA";"CASA NOVA";420;234;257;911
2017;"CASTRO ALVES (BA)";"BA";"CASTRO ALVES";169;30;80;279
2017;"CATOLANDIA (BA)";"BA";"CATOLANDIA";10;3;9;22
2017;"CATU (BA)";"BA";"CATU";438;153;130;721
2017;"CATURAMA (BA)";"BA";"CATURAMA";46;13;19;78
2017;"CENTRAL (BA)";"BA";"CENTRAL";100;32;14;146
2017;"CHORROCHO (BA)";"BA";"CHORROCHO";45;6;14;65
2017;"CICERO DANTAS (BA)";"BA";"CICERO DANTAS";149;36;66;251
2017;"CIPO (BA)";"BA";"CIPO";52;13;24;89
2017;"COARACI (BA)";"BA";"COARACI";130;9;33;172
2017;"COCOS (BA)";"BA";"COCOS";107;7;42;156
2017;"CONCEICAO DA FEIRA (BA)";"BA";"CONCEICAO DA FEIRA";250;137;18;405
2017;"CONCEICAO DO ALMEIDA (BA)";"BA";"CONCEICAO DO ALMEIDA";132;50;40;222
2017;"CONCEICAO DO COITE (BA)";"BA";"CONCEICAO DO COITE";631;154;146;931
2017;"CONCEICAO DO JACUIPE (BA)";"BA";"CONCEICAO DO JACUIPE";393;157;34;584
2017;"CONDE (BA)";"BA";"CONDE";65;23;28;116
2017;"CONDEUBA (BA)";"BA";"CONDEUBA";134;63;78;275
2017;"CONTENDAS DO SINCORA (BA)";"BA";"CONTENDAS DO SINCORA";32;10;12;54
2017;"CORACAO DE MARIA (BA)";"BA";"CORACAO DE MARIA";128;55;68;251
2017;"CORDEIROS (BA)";"BA";"CORDEIROS";43;17;22;82
2017;"CORIBE (BA)";"BA";"CORIBE";49;25;30;104
2017;"CORONEL JOAO SA (BA)";"BA";"CORONEL JOAO SA";11;3;24;38
2017;"CORRENTINA (BA)";"BA";"CORRENTINA";148;40;90;278
2017;"COTEGIPE (BA)";"BA";"COTEGIPE";62;27;28;117
2017;"CRAVOLANDIA (BA)";"BA";"CRAVOLANDIA";23;8;8;39
2017;"CRISOPOLIS (BA)";"BA";"CRISOPOLIS";76;35;43;154
2017;"CRISTOPOLIS (BA)";"BA";"CRISTOPOLIS";60;12;40;112
2017;"CRUZ DAS ALMAS (BA)";"BA";"CRUZ DAS ALMAS";1092;372;115;1579
2017;"CURACA (BA)";"BA";"CURACA";113;48;45;206
2017;"DARIO MEIRA (BA)";"BA";"DARIO MEIRA";26;23;5;54
2017;"DIAS D AVILA (BA)";"BA";"DIAS D AVILA";707;160;416;1283
2017;"DOM BASILIO (BA)";"BA";"DOM BASILIO";365;29;39;433
2017;"DOM MACEDO COSTA (BA)";"BA";"DOM MACEDO COSTA";12;29;10;51
2017;"ELISIO MEDRADO (BA)";"BA";"ELISIO MEDRADO";44;24;18;86
2017;"ENCRUZILHADA (BA)";"BA";"ENCRUZILHADA";75;36;20;131
2017;"ENTRE RIOS (BA)";"BA";"ENTRE RIOS";268;109;134;511
2017;"ERICO CARDOSO (BA)";"BA";"ERICO CARDOSO";41;11;27;79
2017;"ESPLANADA (BA)";"BA";"ESPLANADA";140;48;113;301
2017;"EUCLIDES DA CUNHA (BA)";"BA";"EUCLIDES DA CUNHA";332;97;267;696
2017;"EUNAPOLIS (BA)";"BA";"EUNAPOLIS";1443;127;495;2065
2017;"FATIMA (BA)";"BA";"FATIMA";23;10;25;58
2017;"FEIRA DA MATA (BA)";"BA";"FEIRA DA MATA";22;12;12;46
2017;"FEIRA DE SANTANA (BA)";"BA";"FEIRA DE SANTANA";9062;1447;1428;11937
2017;"FILADELFIA (BA)";"BA";"FILADELFIA";147;18;32;197
2017;"FIRMINO ALVES (BA)";"BA";"FIRMINO ALVES";19;2;4;25
2017;"FLORESTA AZUL (BA)";"BA";"FLORESTA AZUL";41;5;3;49
2017;"FORMOSA DO RIO PRETO (BA)";"BA";"FORMOSA DO RIO PRETO";167;11;31;209
2017;"GANDU (BA)";"BA";"GANDU";328;197;33;558
2017;"GAVIAO (BA)";"BA";"GAVIAO";27;17;9;53
2017;"GENTIO DO OURO (BA)";"BA";"GENTIO DO OURO";30;17;9;56
2017;"GLORIA (BA)";"BA";"GLORIA";70;27;51;148
2017;"GONGOGI (BA)";"BA";"GONGOGI";17;6;5;28
2017;"GOVERNADOR MANGABEIRA (BA)";"BA";"GOVERNADOR MANGABEIRA";255;47;47;349
2017;"GUAJERU (BA)";"BA";"GUAJERU";35;38;19;92
2017;"GUANAMBI (BA)";"BA";"GUANAMBI";1371;111;239;1721
2017;"GUARATINGA (BA)";"BA";"GUARATINGA";90;8;40;138
2017;"HELIOPOLIS (BA)";"BA";"HELIOPOLIS";25;8;24;57
2017;"IACU (BA)";"BA";"IACU";170;31;43;244
2017;"IBIASSUCE (BA)";"BA";"IBIASSUCE";98;26;24;148
2017;"IBICARAI (BA)";"BA";"IBICARAI";149;21;32;202
2017;"IBICOARA (BA)";"BA";"IBICOARA";294;105;87;486
2017;"IBICUI (BA)";"BA";"IBICUI";57;22;19;98
2017;"IBIPEBA (BA)";"BA";"IBIPEBA";58;32;19;109
2017;"IBIPITANGA (BA)";"BA";"IBIPITANGA";94;30;44;168
2017;"IBIQUERA (BA)";"BA";"IBIQUERA";10;9;4;23
2017;"IBIRAPITANGA (BA)";"BA";"IBIRAPITANGA";84;50;18;152
2017;"IBIRAPUA (BA)";"BA";"IBIRAPUA";97;6;12;115
2017;"IBIRATAIA (BA)";"BA";"IBIRATAIA";85;56;20;161
2017;"IBITIARA (BA)";"BA";"IBITIARA";115;70;62;247
2017;"IBITITA (BA)";"BA";"IBITITA";59;16;29;104
2017;"IBOTIRAMA (BA)";"BA";"IBOTIRAMA";288;86;41;415
2017;"ICHU (BA)";"BA";"ICHU";41;26;15;82
2017;"IGAPORA (BA)";"BA";"IGAPORA";120;47;47;214
2017;"IGRAPIUNA (BA)";"BA";"IGRAPIUNA";52;33;26;111
2017;"IGUAI (BA)";"BA";"IGUAI";75;52;52;179
2017;"ILHEUS (BA)";"BA";"ILHEUS";852;197;303;1352
2017;"INHAMBUPE (BA)";"BA";"INHAMBUPE";230;115;108;453
2017;"IPECAETA (BA)";"BA";"IPECAETA";33;11;56;100
2017;"IPIAU (BA)";"BA";"IPIAU";423;64;86;573
2017;"IPIRA (BA)";"BA";"IPIRA";477;84;153;714
2017;"IPUPIARA (BA)";"BA";"IPUPIARA";77;31;8;116
2017;"IRAJUBA (BA)";"BA";"IRAJUBA";47;7;22;76
2017;"IRAMAIA (BA)";"BA";"IRAMAIA";45;15;23;83
2017;"IRAQUARA (BA)";"BA";"IRAQUARA";146;41;55;242
2017;"IRARA (BA)";"BA";"IRARA";173;35;86;294
2017;"IRECE (BA)";"BA";"IRECE";1093;146;292;1531
2017;"ITABELA (BA)";"BA";"ITABELA";315;24;119;458
2017;"ITABERABA (BA)";"BA";"ITABERABA";596;115;101;812
2017;"ITABUNA (BA)";"BA";"ITABUNA";1983;100;796;2879
2017;"ITACARE (BA)";"BA";"ITACARE";42;35;11;88
2017;"ITAETE (BA)";"BA";"ITAETE";82;25;29;136
2017;"ITAGI (BA)";"BA";"ITAGI";48;6;7;61
2017;"ITAGIBA (BA)";"BA";"ITAGIBA";38;60;21;119
2017;"ITAGIMIRIM (BA)";"BA";"ITAGIMIRIM";57;6;10;73
2017;"ITAGUACU DA BAHIA (BA)";"BA";"ITAGUACU DA BAHIA";33;14;8;55
2017;"ITAJU DO COLONIA (BA)";"BA";"ITAJU DO COLONIA";29;3;7;39
2017;"ITAJUIPE (BA)";"BA";"ITAJUIPE";89;32;19;140
2017;"ITAMARAJU (BA)";"BA";"ITAMARAJU";493;63;179;735
2017;"ITAMARI (BA)";"BA";"ITAMARI";49;12;2;63
2017;"ITAMBE (BA)";"BA";"ITAMBE";86;73;11;170
2017;"ITANAGRA (BA)";"BA";"ITANAGRA";25;1;6;32
2017;"ITANHEM (BA)";"BA";"ITANHEM";67;11;33;111
2017;"ITAPARICA (BA)";"BA";"ITAPARICA";54;32;47;133
2017;"ITAPE (BA)";"BA";"ITAPE";34;0;6;40
2017;"ITAPEBI (BA)";"BA";"ITAPEBI";59;3;8;70
2017;"ITAPETINGA (BA)";"BA";"ITAPETINGA";512;79;138;729
2017;"ITAPICURU (BA)";"BA";"ITAPICURU";60;16;50;126
2017;"ITAPITANGA (BA)";"BA";"ITAPITANGA";12;4;5;21
2017;"ITAQUARA (BA)";"BA";"ITAQUARA";44;7;16;67
2017;"ITARANTIM (BA)";"BA";"ITARANTIM";110;19;7;136
2017;"ITATIM (BA)";"BA";"ITATIM";247;36;35;318
2017;"ITIRUCU (BA)";"BA";"ITIRUCU";126;19;22;167
2017;"ITIUBA (BA)";"BA";"ITIUBA";143;58;90;291
2017;"ITORORO (BA)";"BA";"ITORORO";109;27;27;163
2017;"ITUACU (BA)";"BA";"ITUACU";193;79;65;337
2017;"ITUBERA (BA)";"BA";"ITUBERA";161;26;44;231
2017;"IUIU (BA)";"BA";"IUIU";48;16;14;78
2017;"JABORANDI (BA)";"BA";"JABORANDI";84;2;33;119
2017;"JACARACI (BA)";"BA";"JACARACI";54;20;36;110
2017;"JACOBINA (BA)";"BA";"JACOBINA";812;148;282;1242
2017;"JAGUAQUARA (BA)";"BA";"JAGUAQUARA";654;49;86;789
2017;"JAGUARARI (BA)";"BA";"JAGUARARI";299;94;97;490
2017;"JAGUARIPE (BA)";"BA";"JAGUARIPE";55;36;37;128
2017;"JANDAIRA (BA)";"BA";"JANDAIRA";25;4;16;45
2017;"JEQUIE (BA)";"BA";"JEQUIE";1880;172;442;2494
2017;"JEREMOABO (BA)";"BA";"JEREMOABO";100;35;62;197
2017;"JIQUIRICA (BA)";"BA";"JIQUIRICA";58;27;24;109
2017;"JITAUNA (BA)";"BA";"JITAUNA";34;15;20;69
2017;"JOAO DOURADO (BA)";"BA";"JOAO DOURADO";181;49;44;274
2017;"JUAZEIRO (BA)";"BA";"JUAZEIRO";2849;1062;1083;4994
2017;"JUCURUCU (BA)";"BA";"JUCURUCU";18;2;6;26
2017;"JUSSARA (BA)";"BA";"JUSSARA";74;23;22;119
2017;"JUSSARI (BA)";"BA";"JUSSARI";18;1;3;22
2017;"JUSSIAPE (BA)";"BA";"JUSSIAPE";70;38;28;136
2017;"LAFAIETE COUTINHO (BA)";"BA";"LAFAIETE COUTINHO";24;3;10;37
2017;"LAGEDO DO TABOCAL (BA)";"BA";"LAGEDO DO TABOCAL";44;8;10;62
2017;"LAGOA REAL (BA)";"BA";"LAGOA REAL";94;27;35;156
2017;"LAJE (BA)";"BA";"LAJE";196;109;54;359
2017;"LAJEDAO (BA)";"BA";"LAJEDAO";14;1;13;28
2017;"LAJEDINHO (BA)";"BA";"LAJEDINHO";12;7;15;34
2017;"LAMARAO (BA)";"BA";"LAMARAO";11;17;9;37
2017;"LAPAO (BA)";"BA";"LAPAO";167;20;54;241
2017;"LAURO DE FREITAS (BA)";"BA";"LAURO DE FREITAS";2493;503;757;3753
2017;"LENCOIS (BA)";"BA";"LENCOIS";38;24;5;67
2017;"LICINIO DE ALMEIDA (BA)";"BA";"LICINIO DE ALMEIDA";133;18;23;174
2017;"LIVRAMENTO DE NOSSA SENHORA (BA)";"BA";"LIVRAMENTO DE NOSSA SENHORA";538;78;159;775
2017;"LUIS EDUARDO MAGALHAES (BA)";"BA";"LUIS EDUARDO MAGALHAES";1805;118;245;2168
2017;"MACAJUBA (BA)";"BA";"MACAJUBA";39;31;40;110
2017;"MACARANI (BA)";"BA";"MACARANI";96;11;22;129
2017;"MACAUBAS (BA)";"BA";"MACAUBAS";272;47;258;577
2017;"MACURURE (BA)";"BA";"MACURURE";28;5;15;48
2017;"MADRE DE DEUS (BA)";"BA";"MADRE DE DEUS";103;53;32;188
2017;"MAETINGA (BA)";"BA";"MAETINGA";51;12;18;81
2017;"MAIQUINIQUE (BA)";"BA";"MAIQUINIQUE";57;10;16;83
2017;"MAIRI (BA)";"BA";"MAIRI";93;32;45;170
2017;"MALHADA (BA)";"BA";"MALHADA";53;28;26;107
2017;"MALHADA DE PEDRAS (BA)";"BA";"MALHADA DE PEDRAS";102;50;40;192
2017;"MANOEL VITORINO (BA)";"BA";"MANOEL VITORINO";69;25;23;117
2017;"MANSIDAO (BA)";"BA";"MANSIDAO";26;0;11;37
2017;"MARACAS (BA)";"BA";"MARACAS";282;39;63;384
2017;"MARAGOGIPE (BA)";"BA";"MARAGOGIPE";167;50;62;279
2017;"MARAU (BA)";"BA";"MARAU";38;4;11;53
2017;"MARCIONILIO SOUZA (BA)";"BA";"MARCIONILIO SOUZA";47;25;18;90
2017;"MASCOTE (BA)";"BA";"MASCOTE";55;7;12;74
2017;"MATA DE SAO JOAO (BA)";"BA";"MATA DE SAO JOAO";303;109;124;536
2017;"MATINA (BA)";"BA";"MATINA";27;17;34;78
2017;"MEDEIROS NETO (BA)";"BA";"MEDEIROS NETO";99;26;52;177
2017;"MIGUEL CALMON (BA)";"BA";"MIGUEL CALMON";96;42;42;180
2017;"MILAGRES (BA)";"BA";"MILAGRES";172;16;20;208
2017;"MIRANGABA (BA)";"BA";"MIRANGABA";71;15;54;140
2017;"MIRANTE (BA)";"BA";"MIRANTE";73;33;21;127
2017;"MONTE SANTO (BA)";"BA";"MONTE SANTO";295;97;195;587
2017;"MORPARA (BA)";"BA";"MORPARA";24;26;10;60
2017;"MORRO DO CHAPEU (BA)";"BA";"MORRO DO CHAPEU";215;70;31;316
2017;"MORTUGABA (BA)";"BA";"MORTUGABA";83;8;21;112
2017;"MUCUGE (BA)";"BA";"MUCUGE";113;26;75;214
2017;"MUCURI (BA)";"BA";"MUCURI";154;44;105;303
2017;"MULUNGU DO MORRO (BA)";"BA";"MULUNGU DO MORRO";100;10;19;129
2017;"MUNDO NOVO (BA)";"BA";"MUNDO NOVO";75;31;32;138
2017;"MUNIZ FERREIRA (BA)";"BA";"MUNIZ FERREIRA";66;47;12;125
2017;"MUQUEM DO SAO FRANCISCO (BA)";"BA";"MUQUEM DO SAO FRANCISCO";44;25;36;105
2017;"MURITIBA (BA)";"BA";"MURITIBA";151;50;43;244
2017;"MUTUIPE (BA)";"BA";"MUTUIPE";161;100;69;330
2017;"NAZARE (BA)";"BA";"NAZARE";268;78;45;391
2017;"NILO PECANHA (BA)";"BA";"NILO PECANHA";48;36;27;111
2017;"NORDESTINA (BA)";"BA";"NORDESTINA";93;17;31;141
2017;"NOVA CANAA (BA)";"BA";"NOVA CANAA";73;26;18;117
2017;"NOVA FATIMA (BA)";"BA";"NOVA FATIMA";89;13;14;116
2017;"NOVA IBIA (BA)";"BA";"NOVA IBIA";23;13;7;43
2017;"NOVA ITARANA (BA)";"BA";"NOVA ITARANA";41;9;8;58
2017;"NOVA REDENCAO (BA)";"BA";"NOVA REDENCAO";20;13;9;42
2017;"NOVA SOURE (BA)";"BA";"NOVA SOURE";74;11;41;126
2017;"NOVA VICOSA (BA)";"BA";"NOVA VICOSA";181;45;79;305
2017;"NOVO HORIZONTE (BA)";"BA";"NOVO HORIZONTE";62;18;17;97
2017;"NOVO TRIUNFO (BA)";"BA";"NOVO TRIUNFO";19;3;4;26
2017;"OLINDINA (BA)";"BA";"OLINDINA";100;53;73;226
2017;"OLIVEIRA DOS BREJINHOS (BA)";"BA";"OLIVEIRA DOS BREJINHOS";149;69;62;280
2017;"OURICANGAS (BA)";"BA";"OURICANGAS";39;9;26;74
2017;"OUROLANDIA (BA)";"BA";"OUROLANDIA";83;27;14;124
2017;"PALMAS DE MONTE ALTO (BA)";"BA";"PALMAS DE MONTE ALTO";80;14;47;141
2017;"PALMEIRAS (BA)";"BA";"PALMEIRAS";52;35;11;98
2017;"PARAMIRIM (BA)";"BA";"PARAMIRIM";222;42;89;353
2017;"PARATINGA (BA)";"BA";"PARATINGA";81;43;54;178
2017;"PARIPIRANGA (BA)";"BA";"PARIPIRANGA";70;11;46;127
2017;"PAU BRASIL (BA)";"BA";"PAU BRASIL";54;16;42;112
2017;"PAULO AFONSO (BA)";"BA";"PAULO AFONSO";896;351;412;1659
2017;"PE DE SERRA (BA)";"BA";"PE DE SERRA";89;21;35;145
2017;"PEDRAO (BA)";"BA";"PEDRAO";10;6;9;25
2017;"PEDRO ALEXANDRE (BA)";"BA";"PEDRO ALEXANDRE";4;6;12;22
2017;"PIATA (BA)";"BA";"PIATA";106;52;39;197
2017;"PILAO ARCADO (BA)";"BA";"PILAO ARCADO";59;40;8;107
2017;"PINDAI (BA)";"BA";"PINDAI";63;30;45;138
2017;"PINDOBACU (BA)";"BA";"PINDOBACU";61;42;34;137
2017;"PINTADAS (BA)";"BA";"PINTADAS";68;26;56;150
2017;"PIRAI DO NORTE (BA)";"BA";"PIRAI DO NORTE";35;8;3;46
2017;"PIRIPA (BA)";"BA";"PIRIPA";94;32;26;152
2017;"PIRITIBA (BA)";"BA";"PIRITIBA";88;30;23;141
2017;"PLANALTINO (BA)";"BA";"PLANALTINO";65;10;30;105
2017;"PLANALTO (BA)";"BA";"PLANALTO";137;62;70;269
2017;"POCOES (BA)";"BA";"POCOES";457;387;101;945
2017;"POJUCA (BA)";"BA";"POJUCA";415;122;82;619
2017;"PONTO NOVO (BA)";"BA";"PONTO NOVO";97;17;41;155
2017;"PORTO SEGURO (BA)";"BA";"PORTO SEGURO";828;377;406;1611
2017;"POTIRAGUA (BA)";"BA";"POTIRAGUA";52;8;7;67
2017;"PRADO (BA)";"BA";"PRADO";100;21;52;173
2017;"PRESIDENTE DUTRA (BA)";"BA";"PRESIDENTE DUTRA";82;9;12;103
2017;"PRESIDENTE JANIO QUADROS (BA)";"BA";"PRESIDENTE JANIO QUADROS";55;37;25;117
2017;"PRESIDENTE TANCREDO NEVES (BA)";"BA";"PRESIDENTE TANCREDO NEVES";335;215;41;591
2017;"QUEIMADAS (BA)";"BA";"QUEIMADAS";140;39;77;256
2017;"QUIJINGUE (BA)";"BA";"QUIJINGUE";66;29;84;179
2017;"QUIXABEIRA (BA)";"BA";"QUIXABEIRA";51;21;16;88
2017;"RAFAEL JAMBEIRO (BA)";"BA";"RAFAEL JAMBEIRO";89;39;82;210
2017;"REMANSO (BA)";"BA";"REMANSO";204;87;29;320
2017;"RETIROLANDIA (BA)";"BA";"RETIROLANDIA";115;18;24;157
2017;"RIACHAO DAS NEVES (BA)";"BA";"RIACHAO DAS NEVES";70;32;33;135
2017;"RIACHAO DO JACUIPE (BA)";"BA";"RIACHAO DO JACUIPE";388;52;45;485
2017;"RIACHO DE SANTANA (BA)";"BA";"RIACHO DE SANTANA";281;31;115;427
2017;"RIBEIRA DO AMPARO (BA)";"BA";"RIBEIRA DO AMPARO";16;23;37;76
2017;"RIBEIRA DO POMBAL (BA)";"BA";"RIBEIRA DO POMBAL";303;100;138;541
2017;"RIBEIRAO DO LARGO (BA)";"BA";"RIBEIRAO DO LARGO";33;25;9;67
2017;"RIO DE CONTAS (BA)";"BA";"RIO DE CONTAS";83;43;27;153
2017;"RIO DO ANTONIO (BA)";"BA";"RIO DO ANTONIO";207;33;27;267
2017;"RIO DO PIRES (BA)";"BA";"RIO DO PIRES";104;15;22;141
2017;"RIO REAL (BA)";"BA";"RIO REAL";233;24;68;325
2017;"RODELAS (BA)";"BA";"RODELAS";42;8;8;58
2017;"RUY BARBOSA (BA)";"BA";"RUY BARBOSA";159;77;38;274
2017;"SALINAS DA MARGARIDA (BA)";"BA";"SALINAS DA MARGARIDA";27;12;10;49
2017;"SALVADOR (BA)";"BA";"SALVADOR";17796;4280;8846;30922
2017;"SANTA BARBARA (BA)";"BA";"SANTA BARBARA";81;22;25;128
2017;"SANTA BRIGIDA (BA)";"BA";"SANTA BRIGIDA";28;37;30;95
2017;"SANTA CRUZ CABRALIA (BA)";"BA";"SANTA CRUZ CABRALIA";110;50;42;202
2017;"SANTA CRUZ DA VITORIA (BA)";"BA";"SANTA CRUZ DA VITORIA";16;7;5;28
2017;"SANTA INES (BA)";"BA";"SANTA INES";47;20;6;73
2017;"SANTA LUZIA (BA)";"BA";"SANTA LUZIA";41;6;6;53
2017;"SANTA MARIA DA VITORIA (BA)";"BA";"SANTA MARIA DA VITORIA";442;64;84;590
2017;"SANTA RITA DE CASSIA (BA)";"BA";"SANTA RITA DE CASSIA";67;12;19;98
2017;"SANTA TERESINHA (BA)";"BA";"SANTA TERESINHA";44;16;40;100
2017;"SANTALUZ (BA)";"BA";"SANTALUZ";366;45;59;470
2017;"SANTANA (BA)";"BA";"SANTANA";174;16;75;265
2017;"SANTANOPOLIS (BA)";"BA";"SANTANOPOLIS";30;12;17;59
2017;"SANTO AMARO (BA)";"BA";"SANTO AMARO";264;141;144;549
2017;"SANTO ANTONIO DE JESUS (BA)";"BA";"SANTO ANTONIO DE JESUS";2394;295;239;2928
2017;"SANTO ESTEVAO (BA)";"BA";"SANTO ESTEVAO";337;111;86;534
2017;"SAO DESIDERIO (BA)";"BA";"SAO DESIDERIO";325;44;134;503
2017;"SAO DOMINGOS (BA)";"BA";"SAO DOMINGOS";46;4;9;59
2017;"SAO FELIPE (BA)";"BA";"SAO FELIPE";307;54;59;420
2017;"SAO FELIX (BA)";"BA";"SAO FELIX";63;25;19;107
2017;"SAO FELIX DO CORIBE (BA)";"BA";"SAO FELIX DO CORIBE";167;24;33;224
2017;"SAO FRANCISCO DO CONDE (BA)";"BA";"SAO FRANCISCO DO CONDE";157;108;85;350
2017;"SAO GABRIEL (BA)";"BA";"SAO GABRIEL";45;12;26;83
2017;"SAO GONCALO DOS CAMPOS (BA)";"BA";"SAO GONCALO DOS CAMPOS";263;242;47;552
2017;"SAO JOSE DA VITORIA (BA)";"BA";"SAO JOSE DA VITORIA";17;1;7;25
2017;"SAO JOSE DO JACUIPE (BA)";"BA";"SAO JOSE DO JACUIPE";90;22;12;124
2017;"SAO MIGUEL DAS MATAS (BA)";"BA";"SAO MIGUEL DAS MATAS";72;10;24;106
2017;"SAO SEBASTIAO DO PASSE (BA)";"BA";"SAO SEBASTIAO DO PASSE";241;232;149;622
2017;"SAPEACU (BA)";"BA";"SAPEACU";108;71;45;224
2017;"SATIRO DIAS (BA)";"BA";"SATIRO DIAS";25;21;19;65
2017;"SAUBARA (BA)";"BA";"SAUBARA";35;39;3;77
2017;"SAUDE (BA)";"BA";"SAUDE";54;33;22;109
2017;"SEABRA (BA)";"BA";"SEABRA";581;160;188;929
2017;"SEBASTIAO LARANJEIRAS (BA)";"BA";"SEBASTIAO LARANJEIRAS";36;5;32;73
2017;"SENHOR DO BONFIM (BA)";"BA";"SENHOR DO BONFIM";689;165;229;1083
2017;"SENTO SE (BA)";"BA";"SENTO SE";52;12;25;89
2017;"SERRA DO RAMALHO (BA)";"BA";"SERRA DO RAMALHO";123;39;57;219
2017;"SERRA DOURADA (BA)";"BA";"SERRA DOURADA";73;17;38;128
2017;"SERRA PRETA (BA)";"BA";"SERRA PRETA";64;19;65;148
2017;"SERRINHA (BA)";"BA";"SERRINHA";802;162;247;1211
2017;"SERROLANDIA (BA)";"BA";"SERROLANDIA";77;54;23;154
2017;"SIMOES FILHO (BA)";"BA";"SIMOES FILHO";2519;543;874;3936
2017;"SITIO DO MATO (BA)";"BA";"SITIO DO MATO";43;12;28;83
2017;"SITIO DO QUINTO (BA)";"BA";"SITIO DO QUINTO";22;4;12;38
2017;"SOBRADINHO (BA)";"BA";"SOBRADINHO";112;41;34;187
2017;"SOUTO SOARES (BA)";"BA";"SOUTO SOARES";129;19;32;180
2017;"TABOCAS DO BREJO VELHO (BA)";"BA";"TABOCAS DO BREJO VELHO";41;4;15;60
2017;"TANHACU (BA)";"BA";"TANHACU";297;76;61;434
2017;"TANQUE NOVO (BA)";"BA";"TANQUE NOVO";281;17;54;352
2017;"TANQUINHO (BA)";"BA";"TANQUINHO";29;25;16;70
2017;"TAPEROA (BA)";"BA";"TAPEROA";164;26;24;214
2017;"TAPIRAMUTA (BA)";"BA";"TAPIRAMUTA";58;15;22;95
2017;"TEIXEIRA DE FREITAS (BA)";"BA";"TEIXEIRA DE FREITAS";1637;137;408;2182
2017;"TEODORO SAMPAIO (BA)";"BA";"TEODORO SAMPAIO";15;13;14;42
2017;"TEOFILANDIA (BA)";"BA";"TEOFILANDIA";141;58;41;240
2017;"TEOLANDIA (BA)";"BA";"TEOLANDIA";179;50;18;247
2017;"TERRA NOVA (BA)";"BA";"TERRA NOVA";27;15;21;63
2017;"TREMEDAL (BA)";"BA";"TREMEDAL";67;29;48;144
2017;"TUCANO (BA)";"BA";"TUCANO";323;60;125;508
2017;"UAUA (BA)";"BA";"UAUA";263;47;41;351
2017;"UBAIRA (BA)";"BA";"UBAIRA";137;46;54;237
2017;"UBAITABA (BA)";"BA";"UBAITABA";198;23;24;245
2017;"UBATA (BA)";"BA";"UBATA";220;25;21;266
2017;"UIBAI (BA)";"BA";"UIBAI";69;14;21;104
2017;"UMBURANAS (BA)";"BA";"UMBURANAS";67;28;24;119
2017;"UNA (BA)";"BA";"UNA";74;10;69;153
2017;"URANDI (BA)";"BA";"URANDI";154;19;39;212
2017;"URUCUCA (BA)";"BA";"URUCUCA";109;11;17;137
2017;"UTINGA (BA)";"BA";"UTINGA";80;17;24;121
2017;"VALENCA (BA)";"BA";"VALENCA";850;299;151;1300
2017;"VALENTE (BA)";"BA";"VALENTE";207;22;40;269
2017;"VARZEA DA ROCA (BA)";"BA";"VARZEA DA ROCA";61;22;24;107
2017;"VARZEA DO POCO (BA)";"BA";"VARZEA DO POCO";96;17;15;128
2017;"VARZEA NOVA (BA)";"BA";"VARZEA NOVA";73;16;20;109
2017;"VARZEDO (BA)";"BA";"VARZEDO";80;16;32;128
2017;"VERA CRUZ (BA)";"BA";"VERA CRUZ";212;205;67;484
2017;"VEREDA (BA)";"BA";"VEREDA";11;7;3;21
2017;"VITORIA DA CONQUISTA (BA)";"BA";"VITORIA DA CONQUISTA";4769;1084;1595;7448
2017;"WAGNER (BA)";"BA";"WAGNER";46;5;15;66
2017;"WANDERLEY (BA)";"BA";"WANDERLEY";88;10;23;121
2017;"WENCESLAU GUIMARAES (BA)";"BA";"WENCESLAU GUIMARAES";140;36;19;195
2017;"XIQUE XIQUE (BA)";"BA";"XIQUE XIQUE";181;45;37;263
2017;"ABAIARA (CE)";"CE";"ABAIARA";42;29;8;79
2017;"ACARAPE (CE)";"CE";"ACARAPE";103;14;116;233
2017;"ACARAU (CE)";"CE";"ACARAU";258;47;71;376
2017;"ACOPIARA (CE)";"CE";"ACOPIARA";422;81;61;564
2017;"AIUABA (CE)";"CE";"AIUABA";38;6;7;51
2017;"ALCANTARAS (CE)";"CE";"ALCANTARAS";52;17;25;94
2017;"ALTANEIRA (CE)";"CE";"ALTANEIRA";48;20;6;74
2017;"ALTO SANTO (CE)";"CE";"ALTO SANTO";159;12;22;193
2017;"AMONTADA (CE)";"CE";"AMONTADA";212;39;46;297
2017;"ANTONINA DO NORTE (CE)";"CE";"ANTONINA DO NORTE";66;1;8;75
2017;"APUIARES (CE)";"CE";"APUIARES";100;9;18;127
2017;"AQUIRAZ (CE)";"CE";"AQUIRAZ";848;140;143;1131
2017;"ARACATI (CE)";"CE";"ARACATI";592;136;161;889
2017;"ARACOIABA (CE)";"CE";"ARACOIABA";139;22;36;197
2017;"ARARENDA (CE)";"CE";"ARARENDA";36;16;13;65
2017;"ARARIPE (CE)";"CE";"ARARIPE";127;101;64;292
2017;"ARATUBA (CE)";"CE";"ARATUBA";88;2;20;110
2017;"ARNEIROZ (CE)";"CE";"ARNEIROZ";46;14;5;65
2017;"ASSARE (CE)";"CE";"ASSARE";132;54;14;200
2017;"AURORA (CE)";"CE";"AURORA";116;32;21;169
2017;"BAIXIO (CE)";"CE";"BAIXIO";22;22;15;59
2017;"BANABUIU (CE)";"CE";"BANABUIU";214;11;30;255
2017;"BARBALHA (CE)";"CE";"BARBALHA";416;115;112;643
2017;"BARREIRA (CE)";"CE";"BARREIRA";163;13;27;203
2017;"BARRO (CE)";"CE";"BARRO";110;37;20;167
2017;"BARROQUINHA (CE)";"CE";"BARROQUINHA";63;40;9;112
2017;"BATURITE (CE)";"CE";"BATURITE";239;28;40;307
2017;"BEBERIBE (CE)";"CE";"BEBERIBE";320;87;101;508
2017;"BELA CRUZ (CE)";"CE";"BELA CRUZ";149;19;44;212
2017;"BOA VIAGEM (CE)";"CE";"BOA VIAGEM";621;37;88;746
2017;"BREJO SANTO (CE)";"CE";"BREJO SANTO";562;104;69;735
2017;"CAMOCIM (CE)";"CE";"CAMOCIM";256;56;39;351
2017;"CAMPOS SALES (CE)";"CE";"CAMPOS SALES";272;96;68;436
2017;"CANINDE (CE)";"CE";"CANINDE";631;76;188;895
2017;"CAPISTRANO (CE)";"CE";"CAPISTRANO";80;11;25;116
2017;"CARIDADE (CE)";"CE";"CARIDADE";88;11;20;119
2017;"CARIRE (CE)";"CE";"CARIRE";96;14;31;141
2017;"CARIRIACU (CE)";"CE";"CARIRIACU";102;44;14;160
2017;"CARIUS (CE)";"CE";"CARIUS";59;29;17;105
2017;"CARNAUBAL (CE)";"CE";"CARNAUBAL";86;32;14;132
2017;"CASCAVEL (CE)";"CE";"CASCAVEL";572;89;173;834
2017;"CATARINA (CE)";"CE";"CATARINA";57;4;2;63
2017;"CATUNDA (CE)";"CE";"CATUNDA";50;14;7;71
2017;"CAUCAIA (CE)";"CE";"CAUCAIA";2089;362;449;2900
2017;"CEDRO (CE)";"CE";"CEDRO";130;47;45;222
2017;"CHAVAL (CE)";"CE";"CHAVAL";41;19;12;72
2017;"CHORO (CE)";"CE";"CHORO";81;12;47;140
2017;"CHOROZINHO (CE)";"CE";"CHOROZINHO";158;21;43;222
2017;"COREAU (CE)";"CE";"COREAU";113;20;44;177
2017;"CRATEUS (CE)";"CE";"CRATEUS";435;110;126;671
2017;"CRATO (CE)";"CE";"CRATO";1166;245;152;1563
2017;"CROATA (CE)";"CE";"CROATA";80;30;17;127
2017;"CRUZ (CE)";"CE";"CRUZ";210;27;117;354
2017;"DEPUTADO IRAPUAN PINHEIRO (CE)";"CE";"DEPUTADO IRAPUAN PINHEIRO";28;9;15;52
2017;"ERERE (CE)";"CE";"ERERE";10;3;6;19
2017;"EUSEBIO (CE)";"CE";"EUSEBIO";1688;76;135;1899
2017;"FARIAS BRITO (CE)";"CE";"FARIAS BRITO";130;35;24;189
2017;"FORQUILHA (CE)";"CE";"FORQUILHA";155;29;51;235
2017;"FORTALEZA (CE)";"CE";"FORTALEZA";22247;3421;7102;32770
2017;"FORTIM (CE)";"CE";"FORTIM";55;27;26;108
2017;"FRECHEIRINHA (CE)";"CE";"FRECHEIRINHA";106;22;31;159
2017;"GENERAL SAMPAIO (CE)";"CE";"GENERAL SAMPAIO";37;4;8;49
2017;"GRACA (CE)";"CE";"GRACA";33;18;14;65
2017;"GRANJA (CE)";"CE";"GRANJA";255;154;44;453
2017;"GRANJEIRO (CE)";"CE";"GRANJEIRO";14;4;2;20
2017;"GROAIRAS (CE)";"CE";"GROAIRAS";79;23;32;134
2017;"GUAIUBA (CE)";"CE";"GUAIUBA";105;29;13;147
2017;"GUARACIABA DO NORTE (CE)";"CE";"GUARACIABA DO NORTE";499;59;38;596
2017;"GUARAMIRANGA (CE)";"CE";"GUARAMIRANGA";39;3;12;54
2017;"HIDROLANDIA (CE)";"CE";"HIDROLANDIA";190;24;22;236
2017;"HORIZONTE (CE)";"CE";"HORIZONTE";557;93;111;761
2017;"IBARETAMA (CE)";"CE";"IBARETAMA";158;7;25;190
2017;"IBIAPINA (CE)";"CE";"IBIAPINA";209;30;30;269
2017;"IBICUITINGA (CE)";"CE";"IBICUITINGA";89;8;29;126
2017;"ICAPUI (CE)";"CE";"ICAPUI";120;25;68;213
2017;"ICO (CE)";"CE";"ICO";406;105;103;614
2017;"IGUATU (CE)";"CE";"IGUATU";1115;77;168;1360
2017;"INDEPENDENCIA (CE)";"CE";"INDEPENDENCIA";265;4;27;296
2017;"IPAPORANGA (CE)";"CE";"IPAPORANGA";38;12;10;60
2017;"IPAUMIRIM (CE)";"CE";"IPAUMIRIM";297;72;41;410
2017;"IPU (CE)";"CE";"IPU";340;30;30;400
2017;"IPUEIRAS (CE)";"CE";"IPUEIRAS";112;49;14;175
2017;"IRACEMA (CE)";"CE";"IRACEMA";69;19;29;117
2017;"IRAUCUBA (CE)";"CE";"IRAUCUBA";121;21;42;184
2017;"ITAICABA (CE)";"CE";"ITAICABA";38;5;15;58
2017;"ITAITINGA (CE)";"CE";"ITAITINGA";477;70;75;622
2017;"ITAPAJE (CE)";"CE";"ITAPAJE";373;49;59;481
2017;"ITAPIPOCA (CE)";"CE";"ITAPIPOCA";1014;105;135;1254
2017;"ITAPIUNA (CE)";"CE";"ITAPIUNA";73;13;33;119
2017;"ITAREMA (CE)";"CE";"ITAREMA";162;24;57;243
2017;"ITATIRA (CE)";"CE";"ITATIRA";207;20;36;263
2017;"JAGUARETAMA (CE)";"CE";"JAGUARETAMA";170;15;26;211
2017;"JAGUARIBARA (CE)";"CE";"JAGUARIBARA";112;18;17;147
2017;"JAGUARIBE (CE)";"CE";"JAGUARIBE";414;66;36;516
2017;"JAGUARUANA (CE)";"CE";"JAGUARUANA";299;33;23;355
2017;"JARDIM (CE)";"CE";"JARDIM";188;87;43;318
2017;"JATI (CE)";"CE";"JATI";60;122;17;199
2017;"JIJOCA DE JERICOACOARA (CE)";"CE";"JIJOCA DE JERICOACOARA";104;19;21;144
2017;"JUAZEIRO DO NORTE (CE)";"CE";"JUAZEIRO DO NORTE";2061;212;307;2580
2017;"JUCAS (CE)";"CE";"JUCAS";131;8;35;174
2017;"LAVRAS DA MANGABEIRA (CE)";"CE";"LAVRAS DA MANGABEIRA";131;32;39;202
2017;"LIMOEIRO DO NORTE (CE)";"CE";"LIMOEIRO DO NORTE";830;43;156;1029
2017;"MADALENA (CE)";"CE";"MADALENA";195;11;30;236
2017;"MARACANAU (CE)";"CE";"MARACANAU";2252;269;436;2957
2017;"MARANGUAPE (CE)";"CE";"MARANGUAPE";711;176;306;1193
2017;"MARCO (CE)";"CE";"MARCO";325;18;34;377
2017;"MARTINOPOLE (CE)";"CE";"MARTINOPOLE";46;24;3;73
2017;"MASSAPE (CE)";"CE";"MASSAPE";122;41;114;277
2017;"MAURITI (CE)";"CE";"MAURITI";191;78;71;340
2017;"MERUOCA (CE)";"CE";"MERUOCA";49;25;23;97
2017;"MILAGRES (CE)";"CE";"MILAGRES";130;77;31;238
2017;"MILHA (CE)";"CE";"MILHA";105;15;33;153
2017;"MIRAIMA (CE)";"CE";"MIRAIMA";37;6;13;56
2017;"MISSAO VELHA (CE)";"CE";"MISSAO VELHA";274;75;36;385
2017;"MOMBACA (CE)";"CE";"MOMBACA";287;40;42;369
2017;"MONSENHOR TABOSA (CE)";"CE";"MONSENHOR TABOSA";99;8;9;116
2017;"MORADA NOVA (CE)";"CE";"MORADA NOVA";598;76;138;812
2017;"MORAUJO (CE)";"CE";"MORAUJO";27;6;10;43
2017;"MORRINHOS (CE)";"CE";"MORRINHOS";115;19;28;162
2017;"MUCAMBO (CE)";"CE";"MUCAMBO";45;21;16;82
2017;"MULUNGU (CE)";"CE";"MULUNGU";81;10;13;104
2017;"NOVA OLINDA (CE)";"CE";"NOVA OLINDA";131;30;16;177
2017;"NOVA RUSSAS (CE)";"CE";"NOVA RUSSAS";224;35;16;275
2017;"NOVO ORIENTE (CE)";"CE";"NOVO ORIENTE";80;40;24;144
2017;"OCARA (CE)";"CE";"OCARA";205;16;61;282
2017;"OROS (CE)";"CE";"OROS";153;33;32;218
2017;"PACAJUS (CE)";"CE";"PACAJUS";749;104;174;1027
2017;"PACATUBA (CE)";"CE";"PACATUBA";285;85;44;414
2017;"PACOTI (CE)";"CE";"PACOTI";117;7;16;140
2017;"PACUJA (CE)";"CE";"PACUJA";22;4;9;35
2017;"PALHANO (CE)";"CE";"PALHANO";87;15;15;117
2017;"PALMACIA (CE)";"CE";"PALMACIA";52;14;19;85
2017;"PARACURU (CE)";"CE";"PARACURU";236;25;45;306
2017;"PARAIPABA (CE)";"CE";"PARAIPABA";313;18;34;365
2017;"PARAMBU (CE)";"CE";"PARAMBU";264;14;24;302
2017;"PARAMOTI (CE)";"CE";"PARAMOTI";71;8;20;99
2017;"PEDRA BRANCA (CE)";"CE";"PEDRA BRANCA";601;42;45;688
2017;"PENAFORTE (CE)";"CE";"PENAFORTE";97;58;25;180
2017;"PENTECOSTE (CE)";"CE";"PENTECOSTE";305;26;36;367
2017;"PEREIRO (CE)";"CE";"PEREIRO";103;15;33;151
2017;"PINDORETAMA (CE)";"CE";"PINDORETAMA";185;16;40;241
2017;"PIQUET CARNEIRO (CE)";"CE";"PIQUET CARNEIRO";65;7;15;87
2017;"PIRES FERREIRA (CE)";"CE";"PIRES FERREIRA";24;9;5;38
2017;"PORANGA (CE)";"CE";"PORANGA";30;14;7;51
2017;"PORTEIRAS (CE)";"CE";"PORTEIRAS";70;435;78;583
2017;"POTENGI (CE)";"CE";"POTENGI";72;6;11;89
2017;"POTIRETAMA (CE)";"CE";"POTIRETAMA";56;4;7;67
2017;"QUITERIANOPOLIS (CE)";"CE";"QUITERIANOPOLIS";99;18;8;125
2017;"QUIXADA (CE)";"CE";"QUIXADA";1086;75;155;1316
2017;"QUIXELO (CE)";"CE";"QUIXELO";79;21;42;142
2017;"QUIXERAMOBIM (CE)";"CE";"QUIXERAMOBIM";661;47;157;865
2017;"QUIXERE (CE)";"CE";"QUIXERE";296;18;46;360
2017;"REDENCAO (CE)";"CE";"REDENCAO";246;45;68;359
2017;"RERIUTABA (CE)";"CE";"RERIUTABA";116;34;26;176
2017;"RUSSAS (CE)";"CE";"RUSSAS";1004;66;185;1255
2017;"SABOEIRO (CE)";"CE";"SABOEIRO";51;9;13;73
2017;"SALITRE (CE)";"CE";"SALITRE";173;17;41;231
2017;"SANTA QUITERIA (CE)";"CE";"SANTA QUITERIA";333;63;38;434
2017;"SANTANA DO ACARAU (CE)";"CE";"SANTANA DO ACARAU";174;71;65;310
2017;"SANTANA DO CARIRI (CE)";"CE";"SANTANA DO CARIRI";97;42;27;166
2017;"SAO BENEDITO (CE)";"CE";"SAO BENEDITO";521;128;91;740
2017;"SAO GONCALO DO AMARANTE (CE)";"CE";"SAO GONCALO DO AMARANTE";452;109;165;726
2017;"SAO JOAO DO JAGUARIBE (CE)";"CE";"SAO JOAO DO JAGUARIBE";48;3;9;60
2017;"SAO LUIS DO CURU (CE)";"CE";"SAO LUIS DO CURU";73;4;12;89
2017;"SENADOR POMPEU (CE)";"CE";"SENADOR POMPEU";200;32;72;304
2017;"SENADOR SA (CE)";"CE";"SENADOR SA";30;7;17;54
2017;"SOBRAL (CE)";"CE";"SOBRAL";1774;256;460;2490
2017;"SOLONOPOLE (CE)";"CE";"SOLONOPOLE";100;19;24;143
2017;"TABULEIRO DO NORTE (CE)";"CE";"TABULEIRO DO NORTE";399;45;54;498
2017;"TAMBORIL (CE)";"CE";"TAMBORIL";144;28;28;200
2017;"TARRAFAS (CE)";"CE";"TARRAFAS";32;11;8;51
2017;"TAUA (CE)";"CE";"TAUA";575;132;59;766
2017;"TEJUCUOCA (CE)";"CE";"TEJUCUOCA";115;14;27;156
2017;"TIANGUA (CE)";"CE";"TIANGUA";1495;165;247;1907
2017;"TRAIRI (CE)";"CE";"TRAIRI";270;28;91;389
2017;"TURURU (CE)";"CE";"TURURU";77;13;15;105
2017;"UBAJARA (CE)";"CE";"UBAJARA";304;32;83;419
2017;"UMARI (CE)";"CE";"UMARI";12;5;7;24
2017;"UMIRIM (CE)";"CE";"UMIRIM";60;40;42;142
2017;"URUBURETAMA (CE)";"CE";"URUBURETAMA";104;14;34;152
2017;"URUOCA (CE)";"CE";"URUOCA";93;18;20;131
2017;"VARJOTA (CE)";"CE";"VARJOTA";168;48;13;229
2017;"VARZEA ALEGRE (CE)";"CE";"VARZEA ALEGRE";284;51;60;395
2017;"VICOSA DO CEARA (CE)";"CE";"VICOSA DO CEARA";453;61;99;613
2017;"BRASILIA (DF)";"DF";"BRASILIA";23657;5692;12413;41762
2017;"AFONSO CLAUDIO (ES)";"ES";"AFONSO CLAUDIO";771;106;111;988
2017;"AGUA DOCE DO NORTE (ES)";"ES";"AGUA DOCE DO NORTE";133;36;36;205
2017;"AGUIA BRANCA (ES)";"ES";"AGUIA BRANCA";191;14;51;256
2017;"ALEGRE (ES)";"ES";"ALEGRE";286;56;42;384
2017;"ALFREDO CHAVES (ES)";"ES";"ALFREDO CHAVES";535;42;42;619
2017;"ALTO RIO NOVO (ES)";"ES";"ALTO RIO NOVO";122;24;26;172
2017;"ANCHIETA (ES)";"ES";"ANCHIETA";376;95;68;539
2017;"APIACA (ES)";"ES";"APIACA";189;25;9;223
2017;"ARACRUZ (ES)";"ES";"ARACRUZ";1483;225;515;2223
2017;"ATILIO VIVACQUA (ES)";"ES";"ATILIO VIVACQUA";217;19;27;263
2017;"BAIXO GUANDU (ES)";"ES";"BAIXO GUANDU";580;52;94;726
2017;"BARRA DE SAO FRANCISCO (ES)";"ES";"BARRA DE SAO FRANCISCO";628;56;147;831
2017;"BOA ESPERANCA (ES)";"ES";"BOA ESPERANCA";278;21;53;352
2017;"BOM JESUS DO NORTE (ES)";"ES";"BOM JESUS DO NORTE";366;47;37;450
2017;"BREJETUBA (ES)";"ES";"BREJETUBA";320;43;63;426
2017;"CACHOEIRO DE ITAPEMIRIM (ES)";"ES";"CACHOEIRO DE ITAPEMIRIM";5265;272;1737;7274
2017;"CARIACICA (ES)";"ES";"CARIACICA";5935;746;1524;8205
2017;"CASTELO (ES)";"ES";"CASTELO";1215;100;101;1416
2017;"COLATINA (ES)";"ES";"COLATINA";2640;208;608;3456
2017;"CONCEICAO DA BARRA (ES)";"ES";"CONCEICAO DA BARRA";265;22;136;423
2017;"CONCEICAO DO CASTELO (ES)";"ES";"CONCEICAO DO CASTELO";322;58;65;445
2017;"DIVINO DE SAO LOURENCO (ES)";"ES";"DIVINO DE SAO LOURENCO";74;10;12;96
2017;"DOMINGOS MARTINS (ES)";"ES";"DOMINGOS MARTINS";1401;135;90;1626
2017;"DORES DO RIO PRETO (ES)";"ES";"DORES DO RIO PRETO";161;28;18;207
2017;"ECOPORANGA (ES)";"ES";"ECOPORANGA";209;57;112;378
2017;"FUNDAO (ES)";"ES";"FUNDAO";378;59;52;489
2017;"GOVERNADOR LINDENBERG (ES)";"ES";"GOVERNADOR LINDENBERG";321;7;5;333
2017;"GUACUI (ES)";"ES";"GUACUI";774;67;73;914
2017;"GUARAPARI (ES)";"ES";"GUARAPARI";1396;341;293;2030
2017;"IBATIBA (ES)";"ES";"IBATIBA";630;133;100;863
2017;"IBIRACU (ES)";"ES";"IBIRACU";387;30;38;455
2017;"IBITIRAMA (ES)";"ES";"IBITIRAMA";166;35;26;227
2017;"ICONHA (ES)";"ES";"ICONHA";703;38;73;814
2017;"IRUPI (ES)";"ES";"IRUPI";275;50;39;364
2017;"ITAGUACU (ES)";"ES";"ITAGUACU";316;19;63;398
2017;"ITAPEMIRIM (ES)";"ES";"ITAPEMIRIM";621;63;84;768
2017;"ITARANA (ES)";"ES";"ITARANA";453;42;45;540
2017;"IUNA (ES)";"ES";"IUNA";563;99;74;736
2017;"JAGUARE (ES)";"ES";"JAGUARE";508;28;86;622
2017;"JERONIMO MONTEIRO (ES)";"ES";"JERONIMO MONTEIRO";117;31;21;169
2017;"JOAO NEIVA (ES)";"ES";"JOAO NEIVA";337;33;40;410
2017;"LARANJA DA TERRA (ES)";"ES";"LARANJA DA TERRA";347;26;34;407
2017;"LINHARES (ES)";"ES";"LINHARES";3036;218;608;3862
2017;"MANTENOPOLIS (ES)";"ES";"MANTENOPOLIS";186;35;34;255
2017;"MARATAIZES (ES)";"ES";"MARATAIZES";1199;57;104;1360
2017;"MARECHAL FLORIANO (ES)";"ES";"MARECHAL FLORIANO";842;54;49;945
2017;"MARILANDIA (ES)";"ES";"MARILANDIA";440;23;30;493
2017;"MIMOSO DO SUL (ES)";"ES";"MIMOSO DO SUL";381;82;94;557
2017;"MONTANHA (ES)";"ES";"MONTANHA";267;21;105;393
2017;"MUCURICI (ES)";"ES";"MUCURICI";91;12;23;126
2017;"MUNIZ FREIRE (ES)";"ES";"MUNIZ FREIRE";289;62;51;402
2017;"MUQUI (ES)";"ES";"MUQUI";217;26;39;282
2017;"NOVA VENECIA (ES)";"ES";"NOVA VENECIA";1032;64;198;1294
2017;"PANCAS (ES)";"ES";"PANCAS";341;38;23;402
2017;"PEDRO CANARIO (ES)";"ES";"PEDRO CANARIO";760;62;345;1167
2017;"PINHEIROS (ES)";"ES";"PINHEIROS";335;22;160;517
2017;"PIUMA (ES)";"ES";"PIUMA";313;41;17;371
2017;"PONTO BELO (ES)";"ES";"PONTO BELO";70;12;19;101
2017;"PRESIDENTE KENNEDY (ES)";"ES";"PRESIDENTE KENNEDY";400;18;23;441
2017;"RIO BANANAL (ES)";"ES";"RIO BANANAL";713;20;50;783
2017;"RIO NOVO DO SUL (ES)";"ES";"RIO NOVO DO SUL";378;30;31;439
2017;"SANTA LEOPOLDINA (ES)";"ES";"SANTA LEOPOLDINA";501;53;37;591
2017;"SANTA MARIA DE JETIBA (ES)";"ES";"SANTA MARIA DE JETIBA";2833;96;93;3022
2017;"SANTA TERESA (ES)";"ES";"SANTA TERESA";819;55;131;1005
2017;"SAO DOMINGOS DO NORTE (ES)";"ES";"SAO DOMINGOS DO NORTE";283;21;42;346
2017;"SAO GABRIEL DA PALHA (ES)";"ES";"SAO GABRIEL DA PALHA";790;44;171;1005
2017;"SAO JOSE DO CALCADO (ES)";"ES";"SAO JOSE DO CALCADO";112;30;23;165
2017;"SAO MATEUS (ES)";"ES";"SAO MATEUS";1347;135;412;1894
2017;"SAO ROQUE DO CANAA (ES)";"ES";"SAO ROQUE DO CANAA";363;26;31;420
2017;"SERRA (ES)";"ES";"SERRA";9056;798;2106;11960
2017;"SOORETAMA (ES)";"ES";"SOORETAMA";361;19;57;437
2017;"VARGEM ALTA (ES)";"ES";"VARGEM ALTA";588;41;66;695
2017;"VENDA NOVA DO IMIGRANTE (ES)";"ES";"VENDA NOVA DO IMIGRANTE";903;29;129;1061
2017;"VIANA (ES)";"ES";"VIANA";1277;123;375;1775
2017;"VILA PAVAO (ES)";"ES";"VILA PAVAO";179;9;37;225
2017;"VILA VALERIO (ES)";"ES";"VILA VALERIO";395;24;81;500
2017;"VILA VELHA (ES)";"ES";"VILA VELHA";4433;992;918;6343
2017;"VITORIA (ES)";"ES";"VITORIA";4262;1026;937;6225
2017;"ABADIA DE GOIAS (GO)";"GO";"ABADIA DE GOIAS";148;8;11;167
2017;"ABADIANIA (GO)";"GO";"ABADIANIA";309;43;34;386
2017;"ACREUNA (GO)";"GO";"ACREUNA";452;18;126;596
2017;"ADELANDIA (GO)";"GO";"ADELANDIA";39;1;6;46
2017;"AGUA FRIA DE GOIAS (GO)";"GO";"AGUA FRIA DE GOIAS";58;8;21;87
2017;"AGUA LIMPA (GO)";"GO";"AGUA LIMPA";20;7;2;29
2017;"AGUAS LINDAS DE GOIAS (GO)";"GO";"AGUAS LINDAS DE GOIAS";1364;205;692;2261
2017;"ALEXANIA (GO)";"GO";"ALEXANIA";543;54;56;653
2017;"ALOANDIA (GO)";"GO";"ALOANDIA";29;2;4;35
2017;"ALTO HORIZONTE (GO)";"GO";"ALTO HORIZONTE";69;4;17;90
2017;"ALTO PARAISO DE GOIAS (GO)";"GO";"ALTO PARAISO DE GOIAS";79;11;16;106
2017;"ALVORADA DO NORTE (GO)";"GO";"ALVORADA DO NORTE";169;13;17;199
2017;"AMARALINA (GO)";"GO";"AMARALINA";14;4;13;31
2017;"AMERICANO DO BRASIL (GO)";"GO";"AMERICANO DO BRASIL";72;9;24;105
2017;"AMORINOPOLIS (GO)";"GO";"AMORINOPOLIS";42;8;11;61
2017;"ANAPOLIS (GO)";"GO";"ANAPOLIS";9950;354;1827;12131
2017;"ANHANGUERA (GO)";"GO";"ANHANGUERA";9;0;0;9
2017;"ANICUNS (GO)";"GO";"ANICUNS";402;29;106;537
2017;"APARECIDA DE GOIANIA (GO)";"GO";"APARECIDA DE GOIANIA";7398;474;666;8538
2017;"APARECIDA DO RIO DOCE (GO)";"GO";"APARECIDA DO RIO DOCE";63;13;12;88
2017;"APORE (GO)";"GO";"APORE";112;15;32;159
2017;"ARACU (GO)";"GO";"ARACU";33;8;12;53
2017;"ARAGARCAS (GO)";"GO";"ARAGARCAS";562;16;32;610
2017;"ARAGOIANIA (GO)";"GO";"ARAGOIANIA";108;6;8;122
2017;"ARAGUAPAZ (GO)";"GO";"ARAGUAPAZ";112;13;19;144
2017;"ARENOPOLIS (GO)";"GO";"ARENOPOLIS";26;12;10;48
2017;"ARUANA (GO)";"GO";"ARUANA";74;2;20;96
2017;"AURILANDIA (GO)";"GO";"AURILANDIA";32;4;3;39
2017;"AVELINOPOLIS (GO)";"GO";"AVELINOPOLIS";60;3;3;66
2017;"BALIZA (GO)";"GO";"BALIZA";12;1;8;21
2017;"BARRO ALTO (GO)";"GO";"BARRO ALTO";176;32;84;292
2017;"BELA VISTA DE GOIAS (GO)";"GO";"BELA VISTA DE GOIAS";522;25;56;603
2017;"BOM JARDIM DE GOIAS (GO)";"GO";"BOM JARDIM DE GOIAS";163;8;38;209
2017;"BOM JESUS (GO)";"GO";"BOM JESUS";467;68;130;665
2017;"BONFINOPOLIS (GO)";"GO";"BONFINOPOLIS";75;7;12;94
2017;"BONOPOLIS (GO)";"GO";"BONOPOLIS";24;3;10;37
2017;"BRAZABRANTES (GO)";"GO";"BRAZABRANTES";76;3;5;84
2017;"BRITANIA (GO)";"GO";"BRITANIA";100;9;12;121
2017;"BURITI ALEGRE (GO)";"GO";"BURITI ALEGRE";248;37;22;307
2017;"BURITI DE GOIAS (GO)";"GO";"BURITI DE GOIAS";24;10;2;36
2017;"BURITINOPOLIS (GO)";"GO";"BURITINOPOLIS";28;2;8;38
2017;"CABECEIRAS (GO)";"GO";"CABECEIRAS";163;10;35;208
2017;"CACHOEIRA ALTA (GO)";"GO";"CACHOEIRA ALTA";165;26;92;283
2017;"CACHOEIRA DE GOIAS (GO)";"GO";"CACHOEIRA DE GOIAS";14;3;2;19
2017;"CACHOEIRA DOURADA (GO)";"GO";"CACHOEIRA DOURADA";120;13;40;173
2017;"CACU (GO)";"GO";"CACU";304;31;41;376
2017;"CAIAPONIA (GO)";"GO";"CAIAPONIA";250;13;14;277
2017;"CALDAS NOVAS (GO)";"GO";"CALDAS NOVAS";851;132;123;1106
2017;"CALDAZINHA (GO)";"GO";"CALDAZINHA";37;5;3;45
2017;"CAMPESTRE DE GOIAS (GO)";"GO";"CAMPESTRE DE GOIAS";48;1;7;56
2017;"CAMPINACU (GO)";"GO";"CAMPINACU";46;2;6;54
2017;"CAMPINORTE (GO)";"GO";"CAMPINORTE";209;20;20;249
2017;"CAMPO ALEGRE DE GOIAS (GO)";"GO";"CAMPO ALEGRE DE GOIAS";174;24;29;227
2017;"CAMPO LIMPO DE GOIAS (GO)";"GO";"CAMPO LIMPO DE GOIAS";185;2;7;194
2017;"CAMPOS BELOS (GO)";"GO";"CAMPOS BELOS";307;19;65;391
2017;"CAMPOS VERDES (GO)";"GO";"CAMPOS VERDES";43;9;2;54
2017;"CARMO DO RIO VERDE (GO)";"GO";"CARMO DO RIO VERDE";116;15;59;190
2017;"CASTELANDIA (GO)";"GO";"CASTELANDIA";72;7;9;88
2017;"CATALAO (GO)";"GO";"CATALAO";2103;220;383;2706
2017;"CATURAI (GO)";"GO";"CATURAI";57;5;8;70
2017;"CAVALCANTE (GO)";"GO";"CAVALCANTE";54;4;6;64
2017;"CERES (GO)";"GO";"CERES";514;31;52;597
2017;"CEZARINA (GO)";"GO";"CEZARINA";148;12;24;184
2017;"CHAPADAO DO CEU (GO)";"GO";"CHAPADAO DO CEU";353;17;31;401
2017;"CIDADE OCIDENTAL (GO)";"GO";"CIDADE OCIDENTAL";216;72;113;401
2017;"COCALZINHO DE GOIAS (GO)";"GO";"COCALZINHO DE GOIAS";241;33;36;310
2017;"COLINAS DO SUL (GO)";"GO";"COLINAS DO SUL";27;4;1;32
2017;"CORREGO DO OURO (GO)";"GO";"CORREGO DO OURO";21;3;3;27
2017;"CORUMBA DE GOIAS (GO)";"GO";"CORUMBA DE GOIAS";117;21;36;174
2017;"CORUMBAIBA (GO)";"GO";"CORUMBAIBA";163;26;10;199
2017;"CRISTALINA (GO)";"GO";"CRISTALINA";1951;117;527;2595
2017;"CRISTIANOPOLIS (GO)";"GO";"CRISTIANOPOLIS";68;9;4;81
2017;"CRIXAS (GO)";"GO";"CRIXAS";185;20;23;228
2017;"CROMINIA (GO)";"GO";"CROMINIA";63;9;4;76
2017;"CUMARI (GO)";"GO";"CUMARI";31;9;4;44
2017;"DAMIANOPOLIS (GO)";"GO";"DAMIANOPOLIS";33;4;17;54
2017;"DAMOLANDIA (GO)";"GO";"DAMOLANDIA";57;6;7;70
2017;"DAVINOPOLIS (GO)";"GO";"DAVINOPOLIS";34;4;4;42
2017;"DIORAMA (GO)";"GO";"DIORAMA";17;5;7;29
2017;"DIVINOPOLIS DE GOIAS (GO)";"GO";"DIVINOPOLIS DE GOIAS";37;5;10;52
2017;"DOVERLANDIA (GO)";"GO";"DOVERLANDIA";158;17;39;214
2017;"EDEALINA (GO)";"GO";"EDEALINA";82;15;13;110
2017;"EDEIA (GO)";"GO";"EDEIA";285;13;27;325
2017;"ESTRELA DO NORTE (GO)";"GO";"ESTRELA DO NORTE";47;1;3;51
2017;"FAINA (GO)";"GO";"FAINA";72;16;10;98
2017;"FAZENDA NOVA (GO)";"GO";"FAZENDA NOVA";53;11;10;74
2017;"FIRMINOPOLIS (GO)";"GO";"FIRMINOPOLIS";129;6;7;142
2017;"FLORES DE GOIAS (GO)";"GO";"FLORES DE GOIAS";56;6;11;73
2017;"FORMOSA (GO)";"GO";"FORMOSA";3487;203;741;4431
2017;"FORMOSO (GO)";"GO";"FORMOSO";57;7;9;73
2017;"GAMELEIRA DE GOIAS (GO)";"GO";"GAMELEIRA DE GOIAS";41;4;18;63
2017;"GOIANAPOLIS (GO)";"GO";"GOIANAPOLIS";254;25;32;311
2017;"GOIANDIRA (GO)";"GO";"GOIANDIRA";57;11;6;74
2017;"GOIANESIA (GO)";"GO";"GOIANESIA";1152;110;302;1564
2017;"GOIANIA (GO)";"GO";"GOIANIA";24874;2052;6742;33668
2017;"GOIANIRA (GO)";"GO";"GOIANIRA";425;30;92;547
2017;"GOIAS (GO)";"GO";"GOIAS";281;20;56;357
2017;"GOIATUBA (GO)";"GO";"GOIATUBA";831;56;148;1035
2017;"GOUVELANDIA (GO)";"GO";"GOUVELANDIA";65;11;12;88
2017;"GUAPO (GO)";"GO";"GUAPO";280;29;56;365
2017;"GUARAITA (GO)";"GO";"GUARAITA";25;2;3;30
2017;"GUARANI DE GOIAS (GO)";"GO";"GUARANI DE GOIAS";17;6;10;33
2017;"GUARINOS (GO)";"GO";"GUARINOS";11;8;3;22
2017;"HEITORAI (GO)";"GO";"HEITORAI";43;3;4;50
2017;"HIDROLANDIA (GO)";"GO";"HIDROLANDIA";641;34;49;724
2017;"HIDROLINA (GO)";"GO";"HIDROLINA";30;1;4;35
2017;"IACIARA (GO)";"GO";"IACIARA";153;16;25;194
2017;"INACIOLANDIA (GO)";"GO";"INACIOLANDIA";73;8;17;98
2017;"INDIARA (GO)";"GO";"INDIARA";266;19;40;325
2017;"INHUMAS (GO)";"GO";"INHUMAS";1227;90;200;1517
2017;"IPAMERI (GO)";"GO";"IPAMERI";494;91;91;676
2017;"IPIRANGA DE GOIAS (GO)";"GO";"IPIRANGA DE GOIAS";32;8;8;48
2017;"IPORA (GO)";"GO";"IPORA";570;45;57;672
2017;"ISRAELANDIA (GO)";"GO";"ISRAELANDIA";44;5;8;57
2017;"ITABERAI (GO)";"GO";"ITABERAI";905;50;108;1063
2017;"ITAGUARI (GO)";"GO";"ITAGUARI";59;13;14;86
2017;"ITAGUARU (GO)";"GO";"ITAGUARU";116;12;12;140
2017;"ITAJA (GO)";"GO";"ITAJA";123;10;20;153
2017;"ITAPACI (GO)";"GO";"ITAPACI";240;25;101;366
2017;"ITAPIRAPUA (GO)";"GO";"ITAPIRAPUA";77;10;12;99
2017;"ITAPURANGA (GO)";"GO";"ITAPURANGA";429;39;74;542
2017;"ITARUMA (GO)";"GO";"ITARUMA";101;22;20;143
2017;"ITAUCU (GO)";"GO";"ITAUCU";143;10;13;166
2017;"ITUMBIARA (GO)";"GO";"ITUMBIARA";2066;245;418;2729
2017;"IVOLANDIA (GO)";"GO";"IVOLANDIA";14;4;1;19
2017;"JANDAIA (GO)";"GO";"JANDAIA";120;8;17;145
2017;"JARAGUA (GO)";"GO";"JARAGUA";474;38;48;560
2017;"JATAI (GO)";"GO";"JATAI";2422;173;280;2875
2017;"JAUPACI (GO)";"GO";"JAUPACI";31;5;9;45
2017;"JESUPOLIS (GO)";"GO";"JESUPOLIS";23;4;7;34
2017;"JOVIANIA (GO)";"GO";"JOVIANIA";148;18;24;190
2017;"JUSSARA (GO)";"GO";"JUSSARA";469;24;26;519
2017;"LAGOA SANTA (GO)";"GO";"LAGOA SANTA";21;4;8;33
2017;"LEOPOLDO DE BULHOES (GO)";"GO";"LEOPOLDO DE BULHOES";222;24;11;257
2017;"LUZIANIA (GO)";"GO";"LUZIANIA";2500;272;569;3341
2017;"MAIRIPOTABA (GO)";"GO";"MAIRIPOTABA";36;8;4;48
2017;"MAMBAI (GO)";"GO";"MAMBAI";93;5;29;127
2017;"MARA ROSA (GO)";"GO";"MARA ROSA";163;12;17;192
2017;"MARZAGAO (GO)";"GO";"MARZAGAO";34;2;5;41
2017;"MATRINCHA (GO)";"GO";"MATRINCHA";55;7;14;76
2017;"MAURILANDIA (GO)";"GO";"MAURILANDIA";391;18;124;533
2017;"MIMOSO DE GOIAS (GO)";"GO";"MIMOSO DE GOIAS";12;6;6;24
2017;"MINACU (GO)";"GO";"MINACU";524;53;47;624
2017;"MINEIROS (GO)";"GO";"MINEIROS";1433;96;181;1710
2017;"MOIPORA (GO)";"GO";"MOIPORA";8;0;1;9
2017;"MONTE ALEGRE DE GOIAS (GO)";"GO";"MONTE ALEGRE DE GOIAS";30;6;9;45
2017;"MONTES CLAROS DE GOIAS (GO)";"GO";"MONTES CLAROS DE GOIAS";112;17;33;162
2017;"MONTIVIDIU (GO)";"GO";"MONTIVIDIU";383;43;77;503
2017;"MONTIVIDIU DO NORTE (GO)";"GO";"MONTIVIDIU DO NORTE";26;4;19;49
2017;"MORRINHOS (GO)";"GO";"MORRINHOS";922;76;152;1150
2017;"MORRO AGUDO DE GOIAS (GO)";"GO";"MORRO AGUDO DE GOIAS";30;5;4;39
2017;"MOSSAMEDES (GO)";"GO";"MOSSAMEDES";51;10;7;68
2017;"MOZARLANDIA (GO)";"GO";"MOZARLANDIA";159;22;46;227
2017;"MUNDO NOVO (GO)";"GO";"MUNDO NOVO";56;7;22;85
2017;"MUTUNOPOLIS (GO)";"GO";"MUTUNOPOLIS";40;4;17;61
2017;"NAZARIO (GO)";"GO";"NAZARIO";113;11;18;142
2017;"NEROPOLIS (GO)";"GO";"NEROPOLIS";598;24;43;665
2017;"NIQUELANDIA (GO)";"GO";"NIQUELANDIA";725;88;164;977
2017;"NOVA AMERICA (GO)";"GO";"NOVA AMERICA";35;2;3;40
2017;"NOVA AURORA (GO)";"GO";"NOVA AURORA";45;7;5;57
2017;"NOVA CRIXAS (GO)";"GO";"NOVA CRIXAS";140;9;43;192
2017;"NOVA GLORIA (GO)";"GO";"NOVA GLORIA";125;9;28;162
2017;"NOVA IGUACU DE GOIAS (GO)";"GO";"NOVA IGUACU DE GOIAS";29;7;6;42
2017;"NOVA ROMA (GO)";"GO";"NOVA ROMA";8;4;6;18
2017;"NOVA VENEZA (GO)";"GO";"NOVA VENEZA";166;18;24;208
2017;"NOVO BRASIL (GO)";"GO";"NOVO BRASIL";31;6;4;41
2017;"NOVO GAMA (GO)";"GO";"NOVO GAMA";417;115;182;714
2017;"NOVO PLANALTO (GO)";"GO";"NOVO PLANALTO";54;13;4;71
2017;"ORIZONA (GO)";"GO";"ORIZONA";248;67;51;366
2017;"OURO VERDE DE GOIAS (GO)";"GO";"OURO VERDE DE GOIAS";120;2;15;137
2017;"OUVIDOR (GO)";"GO";"OUVIDOR";78;5;17;100
2017;"PADRE BERNARDO (GO)";"GO";"PADRE BERNARDO";471;35;98;604
2017;"PALESTINA DE GOIAS (GO)";"GO";"PALESTINA DE GOIAS";24;17;12;53
2017;"PALMEIRAS DE GOIAS (GO)";"GO";"PALMEIRAS DE GOIAS";428;24;135;587
2017;"PALMELO (GO)";"GO";"PALMELO";34;4;6;44
2017;"PALMINOPOLIS (GO)";"GO";"PALMINOPOLIS";68;2;6;76
2017;"PANAMA (GO)";"GO";"PANAMA";73;13;10;96
2017;"PARANAIGUARA (GO)";"GO";"PARANAIGUARA";118;19;17;154
2017;"PARAUNA (GO)";"GO";"PARAUNA";200;32;47;279
2017;"PEROLANDIA (GO)";"GO";"PEROLANDIA";58;9;10;77
2017;"PETROLINA DE GOIAS (GO)";"GO";"PETROLINA DE GOIAS";184;6;21;211
2017;"PILAR DE GOIAS (GO)";"GO";"PILAR DE GOIAS";29;5;6;40
2017;"PIRACANJUBA (GO)";"GO";"PIRACANJUBA";503;43;44;590
2017;"PIRANHAS (GO)";"GO";"PIRANHAS";241;18;44;303
2017;"PIRENOPOLIS (GO)";"GO";"PIRENOPOLIS";326;66;39;431
2017;"PIRES DO RIO (GO)";"GO";"PIRES DO RIO";589;39;66;694
2017;"PLANALTINA (GO)";"GO";"PLANALTINA";756;106;438;1300
2017;"PONTALINA (GO)";"GO";"PONTALINA";327;25;39;391
2017;"PORANGATU (GO)";"GO";"PORANGATU";776;62;101;939
2017;"PORTEIRAO (GO)";"GO";"PORTEIRAO";119;12;48;179
2017;"PORTELANDIA (GO)";"GO";"PORTELANDIA";63;27;4;94
2017;"POSSE (GO)";"GO";"POSSE";769;69;131;969
2017;"PROFESSOR JAMIL (GO)";"GO";"PROFESSOR JAMIL";34;2;6;42
2017;"QUIRINOPOLIS (GO)";"GO";"QUIRINOPOLIS";1016;71;267;1354
2017;"RIALMA (GO)";"GO";"RIALMA";309;29;42;380
2017;"RIANAPOLIS (GO)";"GO";"RIANAPOLIS";100;5;10;115
2017;"RIO QUENTE (GO)";"GO";"RIO QUENTE";53;23;59;135
2017;"RIO VERDE (GO)";"GO";"RIO VERDE";3951;406;604;4961
2017;"RUBIATABA (GO)";"GO";"RUBIATABA";376;34;103;513
2017;"SANCLERLANDIA (GO)";"GO";"SANCLERLANDIA";133;11;9;153
2017;"SANTA BARBARA DE GOIAS (GO)";"GO";"SANTA BARBARA DE GOIAS";127;9;11;147
2017;"SANTA CRUZ DE GOIAS (GO)";"GO";"SANTA CRUZ DE GOIAS";13;4;4;21
2017;"SANTA FE DE GOIAS (GO)";"GO";"SANTA FE DE GOIAS";47;8;5;60
2017;"SANTA HELENA DE GOIAS (GO)";"GO";"SANTA HELENA DE GOIAS";1020;64;302;1386
2017;"SANTA ISABEL (GO)";"GO";"SANTA ISABEL";13;10;6;29
2017;"SANTA RITA DO ARAGUAIA (GO)";"GO";"SANTA RITA DO ARAGUAIA";140;18;11;169
2017;"SANTA RITA DO NOVO DESTINO (GO)";"GO";"SANTA RITA DO NOVO DESTINO";27;14;9;50
2017;"SANTA ROSA DE GOIAS (GO)";"GO";"SANTA ROSA DE GOIAS";38;4;5;47
2017;"SANTA TEREZA DE GOIAS (GO)";"GO";"SANTA TEREZA DE GOIAS";46;4;7;57
2017;"SANTA TEREZINHA DE GOIAS (GO)";"GO";"SANTA TEREZINHA DE GOIAS";118;13;23;154
2017;"SANTO ANTONIO DA BARRA (GO)";"GO";"SANTO ANTONIO DA BARRA";40;17;20;77
2017;"SANTO ANTONIO DE GOIAS (GO)";"GO";"SANTO ANTONIO DE GOIAS";92;9;22;123
2017;"SANTO ANTONIO DO DESCOBERTO (GO)";"GO";"SANTO ANTONIO DO DESCOBERTO";330;75;200;605
2017;"SAO DOMINGOS (GO)";"GO";"SAO DOMINGOS";49;7;42;98
2017;"SAO FRANCISCO DE GOIAS (GO)";"GO";"SAO FRANCISCO DE GOIAS";61;7;13;81
2017;"SAO JOAO D ALIANCA (GO)";"GO";"SAO JOAO D ALIANCA";166;7;24;197
2017;"SAO JOAO DA PARAUNA (GO)";"GO";"SAO JOAO DA PARAUNA";27;2;3;32
2017;"SAO LUIS DE MONTES BELOS (GO)";"GO";"SAO LUIS DE MONTES BELOS";505;36;93;634
2017;"SAO LUIZ DO NORTE (GO)";"GO";"SAO LUIZ DO NORTE";68;10;21;99
2017;"SAO MIGUEL DO ARAGUAIA (GO)";"GO";"SAO MIGUEL DO ARAGUAIA";380;26;82;488
2017;"SAO MIGUEL DO PASSA QUATRO (GO)";"GO";"SAO MIGUEL DO PASSA QUATRO";59;5;6;70
2017;"SAO PATRICIO (GO)";"GO";"SAO PATRICIO";14;2;6;22
2017;"SAO SIMAO (GO)";"GO";"SAO SIMAO";248;47;70;365
2017;"SENADOR CANEDO (GO)";"GO";"SENADOR CANEDO";980;108;117;1205
2017;"SERRANOPOLIS (GO)";"GO";"SERRANOPOLIS";134;17;21;172
2017;"SILVANIA (GO)";"GO";"SILVANIA";453;47;54;554
2017;"SIMOLANDIA (GO)";"GO";"SIMOLANDIA";157;5;11;173
2017;"SITIO D ABADIA (GO)";"GO";"SITIO D ABADIA";13;1;8;22
2017;"TAQUARAL DE GOIAS (GO)";"GO";"TAQUARAL DE GOIAS";32;4;6;42
2017;"TERESINA DE GOIAS (GO)";"GO";"TERESINA DE GOIAS";19;1;2;22
2017;"TEREZOPOLIS DE GOIAS (GO)";"GO";"TEREZOPOLIS DE GOIAS";106;4;28;138
2017;"TRES RANCHOS (GO)";"GO";"TRES RANCHOS";44;9;5;58
2017;"TRINDADE (GO)";"GO";"TRINDADE";1323;88;153;1564
2017;"TROMBAS (GO)";"GO";"TROMBAS";41;5;16;62
2017;"TURVANIA (GO)";"GO";"TURVANIA";68;6;9;83
2017;"TURVELANDIA (GO)";"GO";"TURVELANDIA";93;13;23;129
2017;"UIRAPURU (GO)";"GO";"UIRAPURU";20;9;7;36
2017;"URUACU (GO)";"GO";"URUACU";692;40;98;830
2017;"URUANA (GO)";"GO";"URUANA";333;9;19;361
2017;"URUTAI (GO)";"GO";"URUTAI";35;2;10;47
2017;"VALPARAISO DE GOIAS (GO)";"GO";"VALPARAISO DE GOIAS";764;231;268;1263
2017;"VARJAO (GO)";"GO";"VARJAO";60;2;9;71
2017;"VIANOPOLIS (GO)";"GO";"VIANOPOLIS";601;37;50;688
2017;"VICENTINOPOLIS (GO)";"GO";"VICENTINOPOLIS";211;11;67;289
2017;"VILA BOA (GO)";"GO";"VILA BOA";36;3;29;68
2017;"VILA PROPICIO (GO)";"GO";"VILA PROPICIO";33;19;28;80
2017;"ACAILANDIA (MA)";"MA";"ACAILANDIA";1756;123;248;2127
2017;"AFONSO CUNHA (MA)";"MA";"AFONSO CUNHA";11;1;6;18
2017;"AGUA DOCE DO MARANHAO (MA)";"MA";"AGUA DOCE DO MARANHAO";3;4;11;18
2017;"ALCANTARA (MA)";"MA";"ALCANTARA";55;27;40;122
2017;"ALDEIAS ALTAS (MA)";"MA";"ALDEIAS ALTAS";50;3;26;79
2017;"ALTAMIRA DO MARANHAO (MA)";"MA";"ALTAMIRA DO MARANHAO";23;3;3;29
2017;"ALTO ALEGRE DO MARANHAO (MA)";"MA";"ALTO ALEGRE DO MARANHAO";66;32;3;101
2017;"ALTO ALEGRE DO PINDARE (MA)";"MA";"ALTO ALEGRE DO PINDARE";49;12;4;65
2017;"ALTO PARNAIBA (MA)";"MA";"ALTO PARNAIBA";83;3;7;93
2017;"AMAPA DO MARANHAO (MA)";"MA";"AMAPA DO MARANHAO";17;2;4;23
2017;"AMARANTE DO MARANHAO (MA)";"MA";"AMARANTE DO MARANHAO";139;10;9;158
2017;"ANAJATUBA (MA)";"MA";"ANAJATUBA";45;7;11;63
2017;"ANAPURUS (MA)";"MA";"ANAPURUS";60;1;20;81
2017;"APICUM ACU (MA)";"MA";"APICUM ACU";15;8;4;27
2017;"ARAGUANA (MA)";"MA";"ARAGUANA";16;0;7;23
2017;"ARAIOSES (MA)";"MA";"ARAIOSES";37;6;29;72
2017;"ARAME (MA)";"MA";"ARAME";112;10;4;126
2017;"ARARI (MA)";"MA";"ARARI";108;11;10;129
2017;"AXIXA (MA)";"MA";"AXIXA";25;6;11;42
2017;"BACABAL (MA)";"MA";"BACABAL";941;103;99;1143
2017;"BACABEIRA (MA)";"MA";"BACABEIRA";127;8;36;171
2017;"BACURI (MA)";"MA";"BACURI";12;6;6;24
2017;"BACURITUBA (MA)";"MA";"BACURITUBA";5;0;6;11
2017;"BALSAS (MA)";"MA";"BALSAS";1881;63;146;2090
2017;"BARAO DE GRAJAU (MA)";"MA";"BARAO DE GRAJAU";80;4;12;96
2017;"BARRA DO CORDA (MA)";"MA";"BARRA DO CORDA";769;28;24;821
2017;"BARREIRINHAS (MA)";"MA";"BARREIRINHAS";92;7;26;125
2017;"BELA VISTA DO MARANHAO (MA)";"MA";"BELA VISTA DO MARANHAO";51;6;5;62
2017;"BELAGUA (MA)";"MA";"BELAGUA";2;5;3;10
2017;"BENEDITO LEITE (MA)";"MA";"BENEDITO LEITE";9;5;2;16
2017;"BEQUIMAO (MA)";"MA";"BEQUIMAO";101;16;19;136
2017;"BERNARDO DO MEARIM (MA)";"MA";"BERNARDO DO MEARIM";42;1;5;48
2017;"BOA VISTA DO GURUPI (MA)";"MA";"BOA VISTA DO GURUPI";11;5;3;19
2017;"BOM JARDIM (MA)";"MA";"BOM JARDIM";132;12;6;150
2017;"BOM JESUS DAS SELVAS (MA)";"MA";"BOM JESUS DAS SELVAS";154;7;8;169
2017;"BOM LUGAR (MA)";"MA";"BOM LUGAR";36;15;12;63
2017;"BREJO (MA)";"MA";"BREJO";86;18;15;119
2017;"BREJO DE AREIA (MA)";"MA";"BREJO DE AREIA";27;3;6;36
2017;"BURITI (MA)";"MA";"BURITI";30;12;18;60
2017;"BURITI BRAVO (MA)";"MA";"BURITI BRAVO";52;2;9;63
2017;"BURITICUPU (MA)";"MA";"BURITICUPU";506;52;19;577
2017;"BURITIRANA (MA)";"MA";"BURITIRANA";35;4;2;41
2017;"CACHOEIRA GRANDE (MA)";"MA";"CACHOEIRA GRANDE";8;2;5;15
2017;"CAJAPIO (MA)";"MA";"CAJAPIO";10;1;3;14
2017;"CAJARI (MA)";"MA";"CAJARI";10;3;6;19
2017;"CAMPESTRE DO MARANHAO (MA)";"MA";"CAMPESTRE DO MARANHAO";40;19;26;85
2017;"CANDIDO MENDES (MA)";"MA";"CANDIDO MENDES";13;7;3;23
2017;"CANTANHEDE (MA)";"MA";"CANTANHEDE";27;3;9;39
2017;"CAPINZAL DO NORTE (MA)";"MA";"CAPINZAL DO NORTE";45;16;3;64
2017;"CAROLINA (MA)";"MA";"CAROLINA";95;7;12;114
2017;"CARUTAPERA (MA)";"MA";"CARUTAPERA";38;19;14;71
2017;"CAXIAS (MA)";"MA";"CAXIAS";927;80;184;1191
2017;"CEDRAL (MA)";"MA";"CEDRAL";15;0;7;22
2017;"CENTRAL DO MARANHAO (MA)";"MA";"CENTRAL DO MARANHAO";14;6;4;24
2017;"CENTRO DO GUILHERME (MA)";"MA";"CENTRO DO GUILHERME";22;0;4;26
2017;"CENTRO NOVO DO MARANHAO (MA)";"MA";"CENTRO NOVO DO MARANHAO";36;2;11;49
2017;"CHAPADINHA (MA)";"MA";"CHAPADINHA";398;30;25;453
2017;"CIDELANDIA (MA)";"MA";"CIDELANDIA";64;9;12;85
2017;"CODO (MA)";"MA";"CODO";686;30;43;759
2017;"COELHO NETO (MA)";"MA";"COELHO NETO";118;18;47;183
2017;"COLINAS (MA)";"MA";"COLINAS";177;22;20;219
2017;"CONCEICAO DO LAGO ACU (MA)";"MA";"CONCEICAO DO LAGO ACU";28;4;1;33
2017;"COROATA (MA)";"MA";"COROATA";221;56;24;301
2017;"CURURUPU (MA)";"MA";"CURURUPU";44;14;10;68
2017;"DAVINOPOLIS (MA)";"MA";"DAVINOPOLIS";90;2;5;97
2017;"DOM PEDRO (MA)";"MA";"DOM PEDRO";448;9;42;499
2017;"DUQUE BACELAR (MA)";"MA";"DUQUE BACELAR";5;1;8;14
2017;"ESPERANTINOPOLIS (MA)";"MA";"ESPERANTINOPOLIS";89;17;5;111
2017;"ESTREITO (MA)";"MA";"ESTREITO";209;18;23;250
2017;"FEIRA NOVA DO MARANHAO (MA)";"MA";"FEIRA NOVA DO MARANHAO";20;1;5;26
2017;"FERNANDO FALCAO (MA)";"MA";"FERNANDO FALCAO";23;0;10;33
2017;"FORMOSA DA SERRA NEGRA (MA)";"MA";"FORMOSA DA SERRA NEGRA";44;5;9;58
2017;"FORTALEZA DOS NOGUEIRAS (MA)";"MA";"FORTALEZA DOS NOGUEIRAS";103;14;9;126
2017;"FORTUNA (MA)";"MA";"FORTUNA";42;20;4;66
2017;"GODOFREDO VIANA (MA)";"MA";"GODOFREDO VIANA";11;13;11;35
2017;"GONCALVES DIAS (MA)";"MA";"GONCALVES DIAS";71;7;10;88
2017;"GOVERNADOR ARCHER (MA)";"MA";"GOVERNADOR ARCHER";33;10;9;52
2017;"GOVERNADOR EDISON LOBAO (MA)";"MA";"GOVERNADOR EDISON LOBAO";94;0;15;109
2017;"GOVERNADOR EUGENIO BARROS (MA)";"MA";"GOVERNADOR EUGENIO BARROS";52;11;21;84
2017;"GOVERNADOR LUIZ ROCHA (MA)";"MA";"GOVERNADOR LUIZ ROCHA";20;3;5;28
2017;"GOVERNADOR NEWTON BELLO (MA)";"MA";"GOVERNADOR NEWTON BELLO";21;0;1;22
2017;"GOVERNADOR NUNES FREIRE (MA)";"MA";"GOVERNADOR NUNES FREIRE";105;7;7;119
2017;"GRACA ARANHA (MA)";"MA";"GRACA ARANHA";17;4;4;25
2017;"GRAJAU (MA)";"MA";"GRAJAU";545;40;56;641
2017;"GUIMARAES (MA)";"MA";"GUIMARAES";18;4;16;38
2017;"HUMBERTO DE CAMPOS (MA)";"MA";"HUMBERTO DE CAMPOS";22;12;8;42
2017;"ICATU (MA)";"MA";"ICATU";24;4;13;41
2017;"IGARAPE DO MEIO (MA)";"MA";"IGARAPE DO MEIO";35;6;10;51
2017;"IGARAPE GRANDE (MA)";"MA";"IGARAPE GRANDE";70;10;8;88
2017;"IMPERATRIZ (MA)";"MA";"IMPERATRIZ";4091;286;488;4865
2017;"ITAIPAVA DO GRAJAU (MA)";"MA";"ITAIPAVA DO GRAJAU";29;5;9;43
2017;"ITAPECURU MIRIM (MA)";"MA";"ITAPECURU MIRIM";396;38;38;472
2017;"ITINGA DO MARANHAO (MA)";"MA";"ITINGA DO MARANHAO";165;8;10;183
2017;"JATOBA (MA)";"MA";"JATOBA";5;2;12;19
2017;"JENIPAPO DOS VIEIRAS (MA)";"MA";"JENIPAPO DOS VIEIRAS";61;4;11;76
2017;"JOAO LISBOA (MA)";"MA";"JOAO LISBOA";141;9;10;160
2017;"JOSELANDIA (MA)";"MA";"JOSELANDIA";72;15;8;95
2017;"JUNCO DO MARANHAO (MA)";"MA";"JUNCO DO MARANHAO";14;13;4;31
2017;"LAGO DA PEDRA (MA)";"MA";"LAGO DA PEDRA";306;50;22;378
2017;"LAGO DO JUNCO (MA)";"MA";"LAGO DO JUNCO";19;3;13;35
2017;"LAGO DOS RODRIGUES (MA)";"MA";"LAGO DOS RODRIGUES";53;12;8;73
2017;"LAGO VERDE (MA)";"MA";"LAGO VERDE";36;0;11;47
2017;"LAGOA DO MATO (MA)";"MA";"LAGOA DO MATO";28;0;12;40
2017;"LAGOA GRANDE DO MARANHAO (MA)";"MA";"LAGOA GRANDE DO MARANHAO";35;1;3;39
2017;"LAJEADO NOVO (MA)";"MA";"LAJEADO NOVO";26;5;4;35
2017;"LIMA CAMPOS (MA)";"MA";"LIMA CAMPOS";90;37;8;135
2017;"LORETO (MA)";"MA";"LORETO";30;6;9;45
2017;"LUIS DOMINGUES (MA)";"MA";"LUIS DOMINGUES";5;2;4;11
2017;"MAGALHAES DE ALMEIDA (MA)";"MA";"MAGALHAES DE ALMEIDA";18;2;13;33
2017;"MARACACUME (MA)";"MA";"MARACACUME";84;52;3;139
2017;"MARAJA DO SENA (MA)";"MA";"MARAJA DO SENA";13;0;2;15
2017;"MARANHAOZINHO (MA)";"MA";"MARANHAOZINHO";49;2;3;54
2017;"MATA ROMA (MA)";"MA";"MATA ROMA";50;10;21;81
2017;"MATINHA (MA)";"MA";"MATINHA";58;15;9;82
2017;"MATOES (MA)";"MA";"MATOES";46;5;26;77
2017;"MATOES DO NORTE (MA)";"MA";"MATOES DO NORTE";22;5;6;33
2017;"MILAGRES DO MARANHAO (MA)";"MA";"MILAGRES DO MARANHAO";11;3;9;23
2017;"MIRADOR (MA)";"MA";"MIRADOR";45;4;4;53
2017;"MIRANDA DO NORTE (MA)";"MA";"MIRANDA DO NORTE";158;6;14;178
2017;"MIRINZAL (MA)";"MA";"MIRINZAL";49;6;6;61
2017;"MONCAO (MA)";"MA";"MONCAO";32;6;8;46
2017;"MONTES ALTOS (MA)";"MA";"MONTES ALTOS";41;0;2;43
2017;"MORROS (MA)";"MA";"MORROS";24;4;7;35
2017;"NINA RODRIGUES (MA)";"MA";"NINA RODRIGUES";13;3;6;22
2017;"NOVA COLINAS (MA)";"MA";"NOVA COLINAS";20;2;12;34
2017;"NOVA IORQUE (MA)";"MA";"NOVA IORQUE";14;1;2;17
2017;"NOVA OLINDA DO MARANHAO (MA)";"MA";"NOVA OLINDA DO MARANHAO";67;14;7;88
2017;"OLHO D AGUA DAS CUNHAS (MA)";"MA";"OLHO D AGUA DAS CUNHAS";74;17;17;108
2017;"OLINDA NOVA DO MARANHAO (MA)";"MA";"OLINDA NOVA DO MARANHAO";42;1;10;53
2017;"PACO DO LUMIAR (MA)";"MA";"PACO DO LUMIAR";470;129;171;770
2017;"PALMEIRANDIA (MA)";"MA";"PALMEIRANDIA";27;2;11;40
2017;"PARAIBANO (MA)";"MA";"PARAIBANO";91;16;7;114
2017;"PARNARAMA (MA)";"MA";"PARNARAMA";51;3;5;59
2017;"PASSAGEM FRANCA (MA)";"MA";"PASSAGEM FRANCA";43;6;7;56
2017;"PASTOS BONS (MA)";"MA";"PASTOS BONS";146;13;10;169
2017;"PAULINO NEVES (MA)";"MA";"PAULINO NEVES";6;2;12;20
2017;"PAULO RAMOS (MA)";"MA";"PAULO RAMOS";87;9;6;102
2017;"PEDREIRAS (MA)";"MA";"PEDREIRAS";393;73;44;510
2017;"PEDRO DO ROSARIO (MA)";"MA";"PEDRO DO ROSARIO";21;1;8;30
2017;"PENALVA (MA)";"MA";"PENALVA";40;4;4;48
2017;"PERI MIRIM (MA)";"MA";"PERI MIRIM";28;12;9;49
2017;"PERITORO (MA)";"MA";"PERITORO";62;70;12;144
2017;"PINDARE MIRIM (MA)";"MA";"PINDARE MIRIM";101;17;17;135
2017;"PINHEIRO (MA)";"MA";"PINHEIRO";516;45;97;658
2017;"PIO XII (MA)";"MA";"PIO XII";119;7;8;134
2017;"PIRAPEMAS (MA)";"MA";"PIRAPEMAS";25;6;4;35
2017;"POCAO DE PEDRAS (MA)";"MA";"POCAO DE PEDRAS";55;21;7;83
2017;"PORTO FRANCO (MA)";"MA";"PORTO FRANCO";126;19;12;157
2017;"PORTO RICO DO MARANHAO (MA)";"MA";"PORTO RICO DO MARANHAO";4;0;3;7
2017;"PRESIDENTE DUTRA (MA)";"MA";"PRESIDENTE DUTRA";519;28;33;580
2017;"PRESIDENTE JUSCELINO (MA)";"MA";"PRESIDENTE JUSCELINO";10;5;4;19
2017;"PRESIDENTE MEDICI (MA)";"MA";"PRESIDENTE MEDICI";15;6;3;24
2017;"PRESIDENTE SARNEY (MA)";"MA";"PRESIDENTE SARNEY";17;9;10;36
2017;"PRESIDENTE VARGAS (MA)";"MA";"PRESIDENTE VARGAS";23;5;6;34
2017;"PRIMEIRA CRUZ (MA)";"MA";"PRIMEIRA CRUZ";2;1;5;8
2017;"RAPOSA (MA)";"MA";"RAPOSA";126;7;60;193
2017;"RIACHAO (MA)";"MA";"RIACHAO";105;13;23;141
2017;"RIBAMAR FIQUENE (MA)";"MA";"RIBAMAR FIQUENE";31;3;4;38
2017;"ROSARIO (MA)";"MA";"ROSARIO";225;26;56;307
2017;"SAMBAIBA (MA)";"MA";"SAMBAIBA";27;6;7;40
2017;"SANTA FILOMENA DO MARANHAO (MA)";"MA";"SANTA FILOMENA DO MARANHAO";9;7;6;22
2017;"SANTA HELENA (MA)";"MA";"SANTA HELENA";111;14;15;140
2017;"SANTA INES (MA)";"MA";"SANTA INES";882;182;122;1186
2017;"SANTA LUZIA (MA)";"MA";"SANTA LUZIA";309;94;14;417
2017;"SANTA LUZIA DO PARUA (MA)";"MA";"SANTA LUZIA DO PARUA";133;18;13;164
2017;"SANTA QUITERIA DO MARANHAO (MA)";"MA";"SANTA QUITERIA DO MARANHAO";44;3;19;66
2017;"SANTA RITA (MA)";"MA";"SANTA RITA";184;11;21;216
2017;"SANTANA DO MARANHAO (MA)";"MA";"SANTANA DO MARANHAO";12;3;9;24
2017;"SANTO AMARO DO MARANHAO (MA)";"MA";"SANTO AMARO DO MARANHAO";5;6;2;13
2017;"SANTO ANTONIO DOS LOPES (MA)";"MA";"SANTO ANTONIO DOS LOPES";126;10;14;150
2017;"SAO BENEDITO DO RIO PRETO (MA)";"MA";"SAO BENEDITO DO RIO PRETO";24;8;6;38
2017;"SAO BENTO (MA)";"MA";"SAO BENTO";163;46;22;231
2017;"SAO BERNARDO (MA)";"MA";"SAO BERNARDO";94;8;25;127
2017;"SAO DOMINGOS DO AZEITAO (MA)";"MA";"SAO DOMINGOS DO AZEITAO";54;3;4;61
2017;"SAO DOMINGOS DO MARANHAO (MA)";"MA";"SAO DOMINGOS DO MARANHAO";253;6;23;282
2017;"SAO FELIX DE BALSAS (MA)";"MA";"SAO FELIX DE BALSAS";7;2;2;11
2017;"SAO FRANCISCO DO BREJAO (MA)";"MA";"SAO FRANCISCO DO BREJAO";64;3;8;75
2017;"SAO FRANCISCO DO MARANHAO (MA)";"MA";"SAO FRANCISCO DO MARANHAO";10;0;2;12
2017;"SAO JOAO BATISTA (MA)";"MA";"SAO JOAO BATISTA";34;6;11;51
2017;"SAO JOAO DO CARU (MA)";"MA";"SAO JOAO DO CARU";34;2;3;39
2017;"SAO JOAO DO PARAISO (MA)";"MA";"SAO JOAO DO PARAISO";30;5;8;43
2017;"SAO JOAO DO SOTER (MA)";"MA";"SAO JOAO DO SOTER";31;3;12;46
2017;"SAO JOAO DOS PATOS (MA)";"MA";"SAO JOAO DOS PATOS";207;12;10;229
2017;"SAO JOSE DE RIBAMAR (MA)";"MA";"SAO JOSE DE RIBAMAR";894;169;335;1398
2017;"SAO JOSE DOS BASILIOS (MA)";"MA";"SAO JOSE DOS BASILIOS";17;3;6;26
2017;"SAO LUIS (MA)";"MA";"SAO LUIS";10116;1410;4380;15906
2017;"SAO LUIS GONZAGA DO MARANHAO (MA)";"MA";"SAO LUIS GONZAGA DO MARANHAO";41;10;11;62
2017;"SAO MATEUS DO MARANHAO (MA)";"MA";"SAO MATEUS DO MARANHAO";129;42;27;198
2017;"SAO PEDRO DA AGUA BRANCA (MA)";"MA";"SAO PEDRO DA AGUA BRANCA";20;8;6;34
2017;"SAO PEDRO DOS CRENTES (MA)";"MA";"SAO PEDRO DOS CRENTES";43;1;8;52
2017;"SAO RAIMUNDO DAS MANGABEIRAS (MA)";"MA";"SAO RAIMUNDO DAS MANGABEIRAS";175;15;54;244
2017;"SAO RAIMUNDO DO DOCA BEZERRA (MA)";"MA";"SAO RAIMUNDO DO DOCA BEZERRA";18;0;2;20
2017;"SAO ROBERTO (MA)";"MA";"SAO ROBERTO";17;6;4;27
2017;"SAO VICENTE FERRER (MA)";"MA";"SAO VICENTE FERRER";38;2;5;45
2017;"SATUBINHA (MA)";"MA";"SATUBINHA";16;6;2;24
2017;"SENADOR ALEXANDRE COSTA (MA)";"MA";"SENADOR ALEXANDRE COSTA";29;10;8;47
2017;"SENADOR LA ROCQUE (MA)";"MA";"SENADOR LA ROCQUE";83;2;5;90
2017;"SERRANO DO MARANHAO (MA)";"MA";"SERRANO DO MARANHAO";6;1;6;13
2017;"SITIO NOVO (MA)";"MA";"SITIO NOVO";81;5;8;94
2017;"SUCUPIRA DO NORTE (MA)";"MA";"SUCUPIRA DO NORTE";27;3;5;35
2017;"SUCUPIRA DO RIACHAO (MA)";"MA";"SUCUPIRA DO RIACHAO";11;7;6;24
2017;"TASSO FRAGOSO (MA)";"MA";"TASSO FRAGOSO";85;6;8;99
2017;"TIMBIRAS (MA)";"MA";"TIMBIRAS";45;4;10;59
2017;"TIMON (MA)";"MA";"TIMON";715;44;173;932
2017;"TRIZIDELA DO VALE (MA)";"MA";"TRIZIDELA DO VALE";171;34;13;218
2017;"TUFILANDIA (MA)";"MA";"TUFILANDIA";11;5;1;17
2017;"TUNTUM (MA)";"MA";"TUNTUM";152;8;21;181
2017;"TURIACU (MA)";"MA";"TURIACU";44;6;7;57
2017;"TURILANDIA (MA)";"MA";"TURILANDIA";12;5;4;21
2017;"TUTOIA (MA)";"MA";"TUTOIA";97;23;13;133
2017;"URBANO SANTOS (MA)";"MA";"URBANO SANTOS";87;10;20;117
2017;"VARGEM GRANDE (MA)";"MA";"VARGEM GRANDE";146;8;18;172
2017;"VIANA (MA)";"MA";"VIANA";227;12;10;249
2017;"VILA NOVA DOS MARTIRIOS (MA)";"MA";"VILA NOVA DOS MARTIRIOS";48;6;6;60
2017;"VITORIA DO MEARIM (MA)";"MA";"VITORIA DO MEARIM";114;7;10;131
2017;"VITORINO FREIRE (MA)";"MA";"VITORINO FREIRE";123;10;13;146
2017;"ZE DOCA (MA)";"MA";"ZE DOCA";253;29;39;321
2017;"ABADIA DOS DOURADOS (MG)";"MG";"ABADIA DOS DOURADOS";177;35;16;228
2017;"ABAETE (MG)";"MG";"ABAETE";498;42;188;728
2017;"ABRE CAMPO (MG)";"MG";"ABRE CAMPO";244;15;48;307
2017;"ACAIACA (MG)";"MG";"ACAIACA";36;9;11;56
2017;"ACUCENA (MG)";"MG";"ACUCENA";55;20;41;116
2017;"AGUA BOA (MG)";"MG";"AGUA BOA";82;20;43;145
2017;"AGUA COMPRIDA (MG)";"MG";"AGUA COMPRIDA";36;10;11;57
2017;"AGUANIL (MG)";"MG";"AGUANIL";81;5;9;95
2017;"AGUAS FORMOSAS (MG)";"MG";"AGUAS FORMOSAS";120;32;51;203
2017;"AGUAS VERMELHAS (MG)";"MG";"AGUAS VERMELHAS";91;29;36;156
2017;"AIMORES (MG)";"MG";"AIMORES";202;39;49;290
2017;"AIURUOCA (MG)";"MG";"AIURUOCA";116;29;14;159
2017;"ALAGOA (MG)";"MG";"ALAGOA";40;3;19;62
2017;"ALBERTINA (MG)";"MG";"ALBERTINA";53;20;8;81
2017;"ALEM PARAIBA (MG)";"MG";"ALEM PARAIBA";1593;137;78;1808
2017;"ALFENAS (MG)";"MG";"ALFENAS";1366;165;328;1859
2017;"ALFREDO VASCONCELOS (MG)";"MG";"ALFREDO VASCONCELOS";177;14;32;223
2017;"ALMENARA (MG)";"MG";"ALMENARA";322;98;156;576
2017;"ALPERCATA (MG)";"MG";"ALPERCATA";94;4;8;106
2017;"ALPINOPOLIS (MG)";"MG";"ALPINOPOLIS";518;52;90;660
2017;"ALTEROSA (MG)";"MG";"ALTEROSA";292;36;67;395
2017;"ALTO CAPARAO (MG)";"MG";"ALTO CAPARAO";100;21;26;147
2017;"ALTO JEQUITIBA (MG)";"MG";"ALTO JEQUITIBA";114;9;19;142
2017;"ALTO RIO DOCE (MG)";"MG";"ALTO RIO DOCE";140;34;35;209
2017;"ALVARENGA (MG)";"MG";"ALVARENGA";42;5;17;64
2017;"ALVINOPOLIS (MG)";"MG";"ALVINOPOLIS";224;18;30;272
2017;"ALVORADA DE MINAS (MG)";"MG";"ALVORADA DE MINAS";26;20;18;64
2017;"AMPARO DA SERRA (MG)";"MG";"AMPARO DA SERRA";55;5;43;103
2017;"ANDRADAS (MG)";"MG";"ANDRADAS";1223;115;119;1457
2017;"ANDRELANDIA (MG)";"MG";"ANDRELANDIA";170;39;31;240
2017;"ANGELANDIA (MG)";"MG";"ANGELANDIA";101;12;39;152
2017;"ANTONIO CARLOS (MG)";"MG";"ANTONIO CARLOS";186;29;41;256
2017;"ANTONIO DIAS (MG)";"MG";"ANTONIO DIAS";115;13;59;187
2017;"ANTONIO PRADO DE MINAS (MG)";"MG";"ANTONIO PRADO DE MINAS";20;7;5;32
2017;"ARACAI (MG)";"MG";"ARACAI";18;10;8;36
2017;"ARACITABA (MG)";"MG";"ARACITABA";13;3;3;19
2017;"ARACUAI (MG)";"MG";"ARACUAI";280;19;124;423
2017;"ARAGUARI (MG)";"MG";"ARAGUARI";2600;443;216;3259
2017;"ARANTINA (MG)";"MG";"ARANTINA";46;6;3;55
2017;"ARAPONGA (MG)";"MG";"ARAPONGA";73;10;17;100
2017;"ARAPORA (MG)";"MG";"ARAPORA";228;14;64;306
2017;"ARAPUA (MG)";"MG";"ARAPUA";58;4;18;80
2017;"ARAUJOS (MG)";"MG";"ARAUJOS";152;15;10;177
2017;"ARAXA (MG)";"MG";"ARAXA";1987;268;356;2611
2017;"ARCEBURGO (MG)";"MG";"ARCEBURGO";159;30;73;262
2017;"ARCOS (MG)";"MG";"ARCOS";1306;108;308;1722
2017;"AREADO (MG)";"MG";"AREADO";250;30;88;368
2017;"ARGIRITA (MG)";"MG";"ARGIRITA";26;5;9;40
2017;"ARICANDUVA (MG)";"MG";"ARICANDUVA";29;6;15;50
2017;"ARINOS (MG)";"MG";"ARINOS";430;36;137;603
2017;"ASTOLFO DUTRA (MG)";"MG";"ASTOLFO DUTRA";258;7;27;292
2017;"ATALEIA (MG)";"MG";"ATALEIA";94;31;45;170
2017;"AUGUSTO DE LIMA (MG)";"MG";"AUGUSTO DE LIMA";36;7;23;66
2017;"BAEPENDI (MG)";"MG";"BAEPENDI";418;76;37;531
2017;"BALDIM (MG)";"MG";"BALDIM";202;11;24;237
2017;"BAMBUI (MG)";"MG";"BAMBUI";574;65;92;731
2017;"BANDEIRA (MG)";"MG";"BANDEIRA";23;8;16;47
2017;"BANDEIRA DO SUL (MG)";"MG";"BANDEIRA DO SUL";125;25;11;161
2017;"BARAO DE COCAIS (MG)";"MG";"BARAO DE COCAIS";528;104;121;753
2017;"BARAO D0 MONTE ALTO (MG)";"MG";"BARAO D0 MONTE ALTO";64;7;14;85
2017;"BARBACENA (MG)";"MG";"BARBACENA";1921;337;249;2507
2017;"BARRA LONGA (MG)";"MG";"BARRA LONGA";43;5;15;63
2017;"BARROSO (MG)";"MG";"BARROSO";465;34;40;539
2017;"BELA VISTA DE MINAS (MG)";"MG";"BELA VISTA DE MINAS";191;14;25;230
2017;"BELMIRO BRAGA (MG)";"MG";"BELMIRO BRAGA";80;14;9;103
2017;"BELO HORIZONTE (MG)";"MG";"BELO HORIZONTE";34773;6288;8761;49822
2017;"BELO ORIENTE (MG)";"MG";"BELO ORIENTE";252;32;108;392
2017;"BELO VALE (MG)";"MG";"BELO VALE";296;29;36;361
2017;"BERILO (MG)";"MG";"BERILO";81;11;38;130
2017;"BERIZAL (MG)";"MG";"BERIZAL";41;10;11;62
2017;"BERTOPOLIS (MG)";"MG";"BERTOPOLIS";14;5;5;24
2017;"BETIM (MG)";"MG";"BETIM";6143;785;1339;8267
2017;"BIAS FORTES (MG)";"MG";"BIAS FORTES";30;3;7;40
2017;"BICAS (MG)";"MG";"BICAS";243;35;43;321
2017;"BIQUINHAS (MG)";"MG";"BIQUINHAS";63;7;5;75
2017;"BOA ESPERANCA (MG)";"MG";"BOA ESPERANCA";882;124;220;1226
2017;"BOCAINA DE MINAS (MG)";"MG";"BOCAINA DE MINAS";112;18;15;145
2017;"BOCAIUVA (MG)";"MG";"BOCAIUVA";582;87;219;888
2017;"BOM DESPACHO (MG)";"MG";"BOM DESPACHO";1163;94;476;1733
2017;"BOM JARDIM DE MINAS (MG)";"MG";"BOM JARDIM DE MINAS";159;22;21;202
2017;"BOM JESUS DA PENHA (MG)";"MG";"BOM JESUS DA PENHA";154;22;20;196
2017;"BOM JESUS DO AMPARO (MG)";"MG";"BOM JESUS DO AMPARO";95;11;18;124
2017;"BOM JESUS DO GALHO (MG)";"MG";"BOM JESUS DO GALHO";117;7;27;151
2017;"BOM REPOUSO (MG)";"MG";"BOM REPOUSO";224;12;21;257
2017;"BOM SUCESSO (MG)";"MG";"BOM SUCESSO";227;35;64;326
2017;"BONFIM (MG)";"MG";"BONFIM";166;21;23;210
2017;"BONFINOPOLIS DE MINAS (MG)";"MG";"BONFINOPOLIS DE MINAS";99;5;34;138
2017;"BONITO DE MINAS (MG)";"MG";"BONITO DE MINAS";46;7;38;91
2017;"BORDA DA MATA (MG)";"MG";"BORDA DA MATA";309;40;80;429
2017;"BOTELHOS (MG)";"MG";"BOTELHOS";268;90;53;411
2017;"BOTUMIRIM (MG)";"MG";"BOTUMIRIM";46;10;30;86
2017;"BRAS PIRES (MG)";"MG";"BRAS PIRES";62;8;12;82
2017;"BRASILANDIA DE MINAS (MG)";"MG";"BRASILANDIA DE MINAS";240;24;130;394
2017;"BRASILIA DE MINAS (MG)";"MG";"BRASILIA DE MINAS";321;30;91;442
2017;"BRASOPOLIS (MG)";"MG";"BRASOPOLIS";238;37;47;322
2017;"BRAUNAS (MG)";"MG";"BRAUNAS";22;8;22;52
2017;"BRUMADINHO (MG)";"MG";"BRUMADINHO";985;130;274;1389
2017;"BUENO BRANDAO (MG)";"MG";"BUENO BRANDAO";234;47;26;307
2017;"BUENOPOLIS (MG)";"MG";"BUENOPOLIS";124;14;39;177
2017;"BUGRE (MG)";"MG";"BUGRE";30;4;12;46
2017;"BURITIS (MG)";"MG";"BURITIS";332;18;119;469
2017;"BURITIZEIRO (MG)";"MG";"BURITIZEIRO";279;47;128;454
2017;"CABECEIRA GRANDE (MG)";"MG";"CABECEIRA GRANDE";69;8;14;91
2017;"CABO VERDE (MG)";"MG";"CABO VERDE";199;53;51;303
2017;"CACHOEIRA DA PRATA (MG)";"MG";"CACHOEIRA DA PRATA";56;4;8;68
2017;"CACHOEIRA DE MINAS (MG)";"MG";"CACHOEIRA DE MINAS";152;28;22;202
2017;"CACHOEIRA DE PAJEU (MG)";"MG";"CACHOEIRA DE PAJEU";44;19;21;84
2017;"CACHOEIRA DOURADA (MG)";"MG";"CACHOEIRA DOURADA";16;13;3;32
2017;"CAETANOPOLIS (MG)";"MG";"CAETANOPOLIS";153;21;50;224
2017;"CAETE (MG)";"MG";"CAETE";588;142;71;801
2017;"CAIANA (MG)";"MG";"CAIANA";55;12;14;81
2017;"CAJURI (MG)";"MG";"CAJURI";65;9;13;87
2017;"CALDAS (MG)";"MG";"CALDAS";318;54;33;405
2017;"CAMACHO (MG)";"MG";"CAMACHO";50;8;21;79
2017;"CAMANDUCAIA (MG)";"MG";"CAMANDUCAIA";553;56;65;674
2017;"CAMBUI (MG)";"MG";"CAMBUI";665;85;117;867
2017;"CAMBUQUIRA (MG)";"MG";"CAMBUQUIRA";172;43;43;258
2017;"CAMPANARIO (MG)";"MG";"CAMPANARIO";20;5;7;32
2017;"CAMPANHA (MG)";"MG";"CAMPANHA";307;63;58;428
2017;"CAMPESTRE (MG)";"MG";"CAMPESTRE";576;65;74;715
2017;"CAMPINA VERDE (MG)";"MG";"CAMPINA VERDE";274;55;52;381
2017;"CAMPO AZUL (MG)";"MG";"CAMPO AZUL";13;4;11;28
2017;"CAMPO BELO (MG)";"MG";"CAMPO BELO";1385;101;141;1627
2017;"CAMPO DO MEIO (MG)";"MG";"CAMPO DO MEIO";146;22;83;251
2017;"CAMPO FLORIDO (MG)";"MG";"CAMPO FLORIDO";220;41;80;341
2017;"CAMPOS ALTOS (MG)";"MG";"CAMPOS ALTOS";386;44;113;543
2017;"CAMPOS GERAIS (MG)";"MG";"CAMPOS GERAIS";429;47;153;629
2017;"CANA VERDE (MG)";"MG";"CANA VERDE";80;6;21;107
2017;"CANAA (MG)";"MG";"CANAA";66;4;9;79
2017;"CANAPOLIS (MG)";"MG";"CANAPOLIS";264;17;95;376
2017;"CANDEIAS (MG)";"MG";"CANDEIAS";283;48;48;379
2017;"CANTAGALO (MG)";"MG";"CANTAGALO";29;5;9;43
2017;"CAPARAO (MG)";"MG";"CAPARAO";77;5;14;96
2017;"CAPELA NOVA (MG)";"MG";"CAPELA NOVA";32;21;10;63
2017;"CAPELINHA (MG)";"MG";"CAPELINHA";814;63;206;1083
2017;"CAPETINGA (MG)";"MG";"CAPETINGA";190;30;41;261
2017;"CAPIM BRANCO (MG)";"MG";"CAPIM BRANCO";93;22;18;133
2017;"CAPINOPOLIS (MG)";"MG";"CAPINOPOLIS";294;29;71;394
2017;"CAPITAO ANDRADE (MG)";"MG";"CAPITAO ANDRADE";55;6;8;69
2017;"CAPITAO ENEAS (MG)";"MG";"CAPITAO ENEAS";103;5;37;145
2017;"CAPITOLIO (MG)";"MG";"CAPITOLIO";183;25;34;242
2017;"CAPUTIRA (MG)";"MG";"CAPUTIRA";145;15;63;223
2017;"CARAI (MG)";"MG";"CARAI";90;68;64;222
2017;"CARANAIBA (MG)";"MG";"CARANAIBA";26;18;20;64
2017;"CARANDAI (MG)";"MG";"CARANDAI";630;74;117;821
2017;"CARANGOLA (MG)";"MG";"CARANGOLA";448;71;68;587
2017;"CARATINGA (MG)";"MG";"CARATINGA";1413;112;513;2038
2017;"CARBONITA (MG)";"MG";"CARBONITA";169;21;59;249
2017;"CAREACU (MG)";"MG";"CAREACU";138;10;16;164
2017;"CARLOS CHAGAS (MG)";"MG";"CARLOS CHAGAS";172;47;60;279
2017;"CARMESIA (MG)";"MG";"CARMESIA";84;3;1355;1442
2017;"CARMO DA CACHOEIRA (MG)";"MG";"CARMO DA CACHOEIRA";193;54;63;310
2017;"CARMO DA MATA (MG)";"MG";"CARMO DA MATA";150;33;63;246
2017;"CARMO DE MINAS (MG)";"MG";"CARMO DE MINAS";162;57;37;256
2017;"CARMO DO CAJURU (MG)";"MG";"CARMO DO CAJURU";440;68;111;619
2017;"CARMO DO PARANAIBA (MG)";"MG";"CARMO DO PARANAIBA";756;90;133;979
2017;"CARMO DO RIO CLARO (MG)";"MG";"CARMO DO RIO CLARO";428;36;106;570
2017;"CARMOPOLIS DE MINAS (MG)";"MG";"CARMOPOLIS DE MINAS";575;71;62;708
2017;"CARNEIRINHO (MG)";"MG";"CARNEIRINHO";202;26;76;304
2017;"CARRANCAS (MG)";"MG";"CARRANCAS";57;10;11;78
2017;"CARVALHOPOLIS (MG)";"MG";"CARVALHOPOLIS";50;13;10;73
2017;"CARVALHOS (MG)";"MG";"CARVALHOS";86;11;12;109
2017;"CASA GRANDE (MG)";"MG";"CASA GRANDE";47;3;5;55
2017;"CASCALHO RICO (MG)";"MG";"CASCALHO RICO";58;28;6;92
2017;"CASSIA (MG)";"MG";"CASSIA";443;67;74;584
2017;"CATAGUASES (MG)";"MG";"CATAGUASES";853;109;182;1144
2017;"CATAS ALTAS (MG)";"MG";"CATAS ALTAS";141;29;9;179
2017;"CATAS ALTAS DA NORUEGA (MG)";"MG";"CATAS ALTAS DA NORUEGA";52;5;13;70
2017;"CATUJI (MG)";"MG";"CATUJI";42;23;26;91
2017;"CATUTI (MG)";"MG";"CATUTI";45;8;27;80
2017;"CAXAMBU (MG)";"MG";"CAXAMBU";233;49;29;311
2017;"CEDRO DO ABAETE (MG)";"MG";"CEDRO DO ABAETE";12;3;4;19
2017;"CENTRAL DE MINAS (MG)";"MG";"CENTRAL DE MINAS";89;10;22;121
2017;"CENTRALINA (MG)";"MG";"CENTRALINA";140;7;21;168
2017;"CHACARA (MG)";"MG";"CHACARA";46;6;18;70
2017;"CHALE (MG)";"MG";"CHALE";92;10;15;117
2017;"CHAPADA DO NORTE (MG)";"MG";"CHAPADA DO NORTE";52;20;32;104
2017;"CHAPADA GAUCHA (MG)";"MG";"CHAPADA GAUCHA";191;10;55;256
2017;"CHIADOR (MG)";"MG";"CHIADOR";199;26;9;234
2017;"CIPOTANEA (MG)";"MG";"CIPOTANEA";74;7;20;101
2017;"CLARAVAL (MG)";"MG";"CLARAVAL";121;10;22;153
2017;"CLARO DOS POCOES (MG)";"MG";"CLARO DOS POCOES";102;16;80;198
2017;"CLAUDIO (MG)";"MG";"CLAUDIO";868;59;67;994
2017;"COIMBRA (MG)";"MG";"COIMBRA";140;6;14;160
2017;"COLUNA (MG)";"MG";"COLUNA";68;6;20;94
2017;"COMENDADOR GOMES (MG)";"MG";"COMENDADOR GOMES";52;13;16;81
2017;"COMERCINHO (MG)";"MG";"COMERCINHO";31;13;24;68
2017;"CONCEICAO DA APARECIDA (MG)";"MG";"CONCEICAO DA APARECIDA";200;16;35;251
2017;"CONCEICAO DA BARRA DE MINAS (MG)";"MG";"CONCEICAO DA BARRA DE MINAS";47;18;11;76
2017;"CONCEICAO DAS ALAGOAS (MG)";"MG";"CONCEICAO DAS ALAGOAS";555;63;136;754
2017;"CONCEICAO DAS PEDRAS (MG)";"MG";"CONCEICAO DAS PEDRAS";24;9;7;40
2017;"CONCEICAO DE IPANEMA (MG)";"MG";"CONCEICAO DE IPANEMA";55;14;7;76
2017;"CONCEICAO DO MATO DENTRO (MG)";"MG";"CONCEICAO DO MATO DENTRO";193;59;202;454
2017;"CONCEICAO DO PARA (MG)";"MG";"CONCEICAO DO PARA";83;16;21;120
2017;"CONCEICAO DO RIO VERDE (MG)";"MG";"CONCEICAO DO RIO VERDE";216;70;39;325
2017;"CONCEICAO DOS OUROS (MG)";"MG";"CONCEICAO DOS OUROS";282;26;19;327
2017;"CONEGO MARINHO (MG)";"MG";"CONEGO MARINHO";29;6;27;62
2017;"CONFINS (MG)";"MG";"CONFINS";181;20;39;240
2017;"CONGONHAL (MG)";"MG";"CONGONHAL";308;12;14;334
2017;"CONGONHAS (MG)";"MG";"CONGONHAS";1130;181;134;1445
2017;"CONGONHAS DO NORTE (MG)";"MG";"CONGONHAS DO NORTE";58;7;13;78
2017;"CONQUISTA (MG)";"MG";"CONQUISTA";174;28;37;239
2017;"CONSELHEIRO LAFAIETE (MG)";"MG";"CONSELHEIRO LAFAIETE";1551;362;657;2570
2017;"CONSELHEIRO PENA (MG)";"MG";"CONSELHEIRO PENA";242;12;66;320
2017;"CONSOLACAO (MG)";"MG";"CONSOLACAO";17;9;3;29
2017;"CONTAGEM (MG)";"MG";"CONTAGEM";14865;1732;3038;19635
2017;"COQUEIRAL (MG)";"MG";"COQUEIRAL";140;18;29;187
2017;"CORACAO DE JESUS (MG)";"MG";"CORACAO DE JESUS";227;12;126;365
2017;"CORDISBURGO (MG)";"MG";"CORDISBURGO";113;18;20;151
2017;"CORDISLANDIA (MG)";"MG";"CORDISLANDIA";43;18;7;68
2017;"CORINTO (MG)";"MG";"CORINTO";374;32;98;504
2017;"COROACI (MG)";"MG";"COROACI";82;12;16;110
2017;"COROMANDEL (MG)";"MG";"COROMANDEL";721;105;107;933
2017;"CORONEL FABRICIANO (MG)";"MG";"CORONEL FABRICIANO";1231;223;548;2002
2017;"CORONEL MURTA (MG)";"MG";"CORONEL MURTA";38;9;21;68
2017;"CORONEL PACHECO (MG)";"MG";"CORONEL PACHECO";32;5;9;46
2017;"CORONEL XAVIER CHAVES (MG)";"MG";"CORONEL XAVIER CHAVES";95;8;4;107
2017;"CORREGO DANTA (MG)";"MG";"CORREGO DANTA";49;3;16;68
2017;"CORREGO DO BOM JESUS (MG)";"MG";"CORREGO DO BOM JESUS";50;12;13;75
2017;"CORREGO FUNDO (MG)";"MG";"CORREGO FUNDO";345;26;28;399
2017;"CORREGO NOVO (MG)";"MG";"CORREGO NOVO";12;4;11;27
2017;"COUTO DE MAGALHAES DE MINAS (MG)";"MG";"COUTO DE MAGALHAES DE MINAS";59;5;13;77
2017;"CRISOLITA (MG)";"MG";"CRISOLITA";15;17;12;44
2017;"CRISTAIS (MG)";"MG";"CRISTAIS";176;36;33;245
2017;"CRISTALIA (MG)";"MG";"CRISTALIA";36;6;32;74
2017;"CRISTIANO OTONI (MG)";"MG";"CRISTIANO OTONI";126;16;22;164
2017;"CRISTINA (MG)";"MG";"CRISTINA";108;29;18;155
2017;"CRUCILANDIA (MG)";"MG";"CRUCILANDIA";172;11;17;200
2017;"CRUZEIRO DA FORTALEZA (MG)";"MG";"CRUZEIRO DA FORTALEZA";116;10;15;141
2017;"CRUZILIA (MG)";"MG";"CRUZILIA";394;44;60;498
2017;"CUPARAQUE (MG)";"MG";"CUPARAQUE";63;8;7;78
2017;"CURRAL DE DENTRO (MG)";"MG";"CURRAL DE DENTRO";72;12;21;105
2017;"CURVELO (MG)";"MG";"CURVELO";1314;82;1537;2933
2017;"DATAS (MG)";"MG";"DATAS";50;5;19;74
2017;"DELFIM MOREIRA (MG)";"MG";"DELFIM MOREIRA";87;15;30;132
2017;"DELFINOPOLIS (MG)";"MG";"DELFINOPOLIS";121;20;24;165
2017;"DELTA (MG)";"MG";"DELTA";481;44;163;688
2017;"DESCOBERTO (MG)";"MG";"DESCOBERTO";39;7;3;49
2017;"DESTERRO DE ENTRE RIOS (MG)";"MG";"DESTERRO DE ENTRE RIOS";134;27;28;189
2017;"DESTERRO DO MELO (MG)";"MG";"DESTERRO DO MELO";44;13;19;76
2017;"DIAMANTINA (MG)";"MG";"DIAMANTINA";475;102;400;977
2017;"DIOGO DE VASCONCELOS (MG)";"MG";"DIOGO DE VASCONCELOS";24;7;12;43
2017;"DIONISIO (MG)";"MG";"DIONISIO";46;6;22;74
2017;"DIVINESIA (MG)";"MG";"DIVINESIA";96;6;16;118
2017;"DIVINO (MG)";"MG";"DIVINO";299;27;58;384
2017;"DIVINO DAS LARANJEIRAS (MG)";"MG";"DIVINO DAS LARANJEIRAS";54;1;7;62
2017;"DIVINOLANDIA DE MINAS (MG)";"MG";"DIVINOLANDIA DE MINAS";83;6;19;108
2017;"DIVINOPOLIS (MG)";"MG";"DIVINOPOLIS";3359;305;791;4455
2017;"DIVISA ALEGRE (MG)";"MG";"DIVISA ALEGRE";64;7;10;81
2017;"DIVISA NOVA (MG)";"MG";"DIVISA NOVA";116;34;44;194
2017;"DIVISOPOLIS (MG)";"MG";"DIVISOPOLIS";72;16;13;101
2017;"DOM BOSCO (MG)";"MG";"DOM BOSCO";30;8;16;54
2017;"DOM CAVATI (MG)";"MG";"DOM CAVATI";169;4;15;188
2017;"DOM JOAQUIM (MG)";"MG";"DOM JOAQUIM";30;9;14;53
2017;"DOM SILVERIO (MG)";"MG";"DOM SILVERIO";75;13;13;101
2017;"DOM VICOSO (MG)";"MG";"DOM VICOSO";30;12;14;56
2017;"DONA EUZEBIA (MG)";"MG";"DONA EUZEBIA";336;6;5;347
2017;"DORES DE CAMPOS (MG)";"MG";"DORES DE CAMPOS";124;27;38;189
2017;"DORES DE GUANHAES (MG)";"MG";"DORES DE GUANHAES";53;9;27;89
2017;"DORES DO INDAIA (MG)";"MG";"DORES DO INDAIA";264;46;19;329
2017;"DORES DO TURVO (MG)";"MG";"DORES DO TURVO";72;6;19;97
2017;"DORESOPOLIS (MG)";"MG";"DORESOPOLIS";18;8;4;30
2017;"DOURADOQUARA (MG)";"MG";"DOURADOQUARA";30;7;2;39
2017;"DURANDE (MG)";"MG";"DURANDE";112;13;27;152
2017;"ELOI MENDES (MG)";"MG";"ELOI MENDES";599;90;60;749
2017;"ENGENHEIRO CALDAS (MG)";"MG";"ENGENHEIRO CALDAS";168;9;20;197
2017;"ENGENHEIRO NAVARRO (MG)";"MG";"ENGENHEIRO NAVARRO";71;5;28;104
2017;"ENTRE FOLHAS (MG)";"MG";"ENTRE FOLHAS";70;4;14;88
2017;"ENTRE RIOS DE MINAS (MG)";"MG";"ENTRE RIOS DE MINAS";317;30;75;422
2017;"ERVALIA (MG)";"MG";"ERVALIA";369;28;71;468
2017;"ESMERALDAS (MG)";"MG";"ESMERALDAS";566;61;310;937
2017;"ESPERA FELIZ (MG)";"MG";"ESPERA FELIZ";414;45;62;521
2017;"ESPINOSA (MG)";"MG";"ESPINOSA";382;42;124;548
2017;"ESPIRITO SANTO DO DOURADO (MG)";"MG";"ESPIRITO SANTO DO DOURADO";117;8;11;136
2017;"ESTIVA (MG)";"MG";"ESTIVA";291;24;27;342
2017;"ESTRELA DALVA (MG)";"MG";"ESTRELA DALVA";31;5;4;40
2017;"ESTRELA DO INDAIA (MG)";"MG";"ESTRELA DO INDAIA";49;12;9;70
2017;"ESTRELA DO SUL (MG)";"MG";"ESTRELA DO SUL";119;21;23;163
2017;"EUGENOPOLIS (MG)";"MG";"EUGENOPOLIS";151;40;42;233
2017;"EWBANK DA CAMARA (MG)";"MG";"EWBANK DA CAMARA";44;4;5;53
2017;"EXTREMA (MG)";"MG";"EXTREMA";582;134;128;844
2017;"FAMA (MG)";"MG";"FAMA";18;7;1;26
2017;"FARIA LEMOS (MG)";"MG";"FARIA LEMOS";27;8;3;38
2017;"FELICIO DOS SANTOS (MG)";"MG";"FELICIO DOS SANTOS";49;18;31;98
2017;"FELISBURGO (MG)";"MG";"FELISBURGO";25;10;18;53
2017;"FELIXLANDIA (MG)";"MG";"FELIXLANDIA";255;20;65;340
2017;"FERNANDES TOURINHO (MG)";"MG";"FERNANDES TOURINHO";24;10;13;47
2017;"FERROS (MG)";"MG";"FERROS";116;21;58;195
2017;"FERVEDOURO (MG)";"MG";"FERVEDOURO";152;11;18;181
2017;"FLORESTAL (MG)";"MG";"FLORESTAL";110;14;43;167
2017;"FORMIGA (MG)";"MG";"FORMIGA";1770;205;235;2210
2017;"FORMOSO (MG)";"MG";"FORMOSO";51;5;39;95
2017;"FORTALEZA DE MINAS (MG)";"MG";"FORTALEZA DE MINAS";78;20;15;113
2017;"FORTUNA DE MINAS (MG)";"MG";"FORTUNA DE MINAS";36;6;11;53
2017;"FRANCISCO BADARO (MG)";"MG";"FRANCISCO BADARO";61;12;35;108
2017;"FRANCISCO DUMONT (MG)";"MG";"FRANCISCO DUMONT";67;6;34;107
2017;"FRANCISCO SA (MG)";"MG";"FRANCISCO SA";249;23;131;403
2017;"FRANCISCOPOLIS (MG)";"MG";"FRANCISCOPOLIS";25;9;21;55
2017;"FREI GASPAR (MG)";"MG";"FREI GASPAR";34;12;15;61
2017;"FREI INOCENCIO (MG)";"MG";"FREI INOCENCIO";97;9;29;135
2017;"FREI LAGONEGRO (MG)";"MG";"FREI LAGONEGRO";10;3;15;28
2017;"FRONTEIRA (MG)";"MG";"FRONTEIRA";247;48;85;380
2017;"FRONTEIRA DOS VALES (MG)";"MG";"FRONTEIRA DOS VALES";14;5;4;23
2017;"FRUTA DE LEITE (MG)";"MG";"FRUTA DE LEITE";24;6;32;62
2017;"FRUTAL (MG)";"MG";"FRUTAL";1622;151;219;1992
2017;"FUNILANDIA (MG)";"MG";"FUNILANDIA";60;2;22;84
2017;"GALILEIA (MG)";"MG";"GALILEIA";71;4;14;89
2017;"GAMELEIRAS (MG)";"MG";"GAMELEIRAS";35;7;19;61
2017;"GLAUCILANDIA (MG)";"MG";"GLAUCILANDIA";5;2;7;14
2017;"GOIABEIRA (MG)";"MG";"GOIABEIRA";34;8;5;47
2017;"GOIANA (MG)";"MG";"GOIANA";32;7;8;47
2017;"GONCALVES (MG)";"MG";"GONCALVES";103;16;11;130
2017;"GONZAGA (MG)";"MG";"GONZAGA";41;7;14;62
2017;"GOUVEA (MG)";"MG";"GOUVEA";148;19;41;208
2017;"GOVERNADOR VALADARES (MG)";"MG";"GOVERNADOR VALADARES";3481;357;395;4233
2017;"GRAO MOGOL (MG)";"MG";"GRAO MOGOL";108;29;81;218
2017;"GRUPIARA (MG)";"MG";"GRUPIARA";14;4;6;24
2017;"GUANHAES (MG)";"MG";"GUANHAES";634;68;131;833
2017;"GUAPE (MG)";"MG";"GUAPE";276;28;75;379
2017;"GUARACIABA (MG)";"MG";"GUARACIABA";95;22;47;164
2017;"GUARACIAMA (MG)";"MG";"GUARACIAMA";62;2;18;82
2017;"GUARANESIA (MG)";"MG";"GUARANESIA";423;81;126;630
2017;"GUARANI (MG)";"MG";"GUARANI";87;22;15;124
2017;"GUARARA (MG)";"MG";"GUARARA";53;15;4;72
2017;"GUARDA MOR (MG)";"MG";"GUARDA MOR";132;25;33;190
2017;"GUAXUPE (MG)";"MG";"GUAXUPE";946;104;159;1209
2017;"GUIDOVAL (MG)";"MG";"GUIDOVAL";170;3;10;183
2017;"GUIMARANIA (MG)";"MG";"GUIMARANIA";182;20;54;256
2017;"GUIRICEMA (MG)";"MG";"GUIRICEMA";264;17;25;306
2017;"GURINHATA (MG)";"MG";"GURINHATA";109;17;38;164
2017;"HELIODORA (MG)";"MG";"HELIODORA";95;18;18;131
2017;"IAPU (MG)";"MG";"IAPU";164;17;31;212
2017;"IBERTIOGA (MG)";"MG";"IBERTIOGA";63;28;9;100
2017;"IBIA (MG)";"MG";"IBIA";455;62;119;636
2017;"IBIAI (MG)";"MG";"IBIAI";71;13;12;96
2017;"IBIRACATU (MG)";"MG";"IBIRACATU";19;5;22;46
2017;"IBIRACI (MG)";"MG";"IBIRACI";427;41;54;522
2017;"IBIRITE (MG)";"MG";"IBIRITE";1514;273;354;2141
2017;"IBITIURA DE MINAS (MG)";"MG";"IBITIURA DE MINAS";115;6;7;128
2017;"IBITURUNA (MG)";"MG";"IBITURUNA";32;5;5;42
2017;"ICARAI DE MINAS (MG)";"MG";"ICARAI DE MINAS";34;2;20;56
2017;"IGARAPE (MG)";"MG";"IGARAPE";816;67;169;1052
2017;"IGARATINGA (MG)";"MG";"IGARATINGA";550;7;24;581
2017;"IGUATAMA (MG)";"MG";"IGUATAMA";142;24;20;186
2017;"IJACI (MG)";"MG";"IJACI";236;10;29;275
2017;"ILICINEA (MG)";"MG";"ILICINEA";264;19;47;330
2017;"IMBE DE MINAS (MG)";"MG";"IMBE DE MINAS";51;10;21;82
2017;"INCONFIDENTES (MG)";"MG";"INCONFIDENTES";94;27;34;155
2017;"INDAIABIRA (MG)";"MG";"INDAIABIRA";94;16;32;142
2017;"INDIANOPOLIS (MG)";"MG";"INDIANOPOLIS";111;44;20;175
2017;"INGAI (MG)";"MG";"INGAI";20;19;16;55
2017;"INHAPIM (MG)";"MG";"INHAPIM";452;32;86;570
2017;"INHAUMA (MG)";"MG";"INHAUMA";126;7;25;158
2017;"INIMUTABA (MG)";"MG";"INIMUTABA";45;6;14;65
2017;"IPABA (MG)";"MG";"IPABA";99;18;30;147
2017;"IPANEMA (MG)";"MG";"IPANEMA";267;28;54;349
2017;"IPATINGA (MG)";"MG";"IPATINGA";3340;672;739;4751
2017;"IPIACU (MG)";"MG";"IPIACU";72;2;12;86
2017;"IPUIUNA (MG)";"MG";"IPUIUNA";447;45;42;534
2017;"IRAI DE MINAS (MG)";"MG";"IRAI DE MINAS";255;28;36;319
2017;"ITABIRA (MG)";"MG";"ITABIRA";1877;320;561;2758
2017;"ITABIRINHA (MG)";"MG";"ITABIRINHA";173;9;40;222
2017;"ITABIRITO (MG)";"MG";"ITABIRITO";1006;266;367;1639
2017;"ITACAMBIRA (MG)";"MG";"ITACAMBIRA";18;3;8;29
2017;"ITACARAMBI (MG)";"MG";"ITACARAMBI";144;13;54;211
2017;"ITAGUARA (MG)";"MG";"ITAGUARA";472;22;85;579
2017;"ITAIPE (MG)";"MG";"ITAIPE";87;21;28;136
2017;"ITAJUBA (MG)";"MG";"ITAJUBA";867;115;148;1130
2017;"ITAMARANDIBA (MG)";"MG";"ITAMARANDIBA";760;62;162;984
2017;"ITAMARATI DE MINAS (MG)";"MG";"ITAMARATI DE MINAS";113;14;13;140
2017;"ITAMBACURI (MG)";"MG";"ITAMBACURI";206;40;58;304
2017;"ITAMBE DO MATO DENTRO (MG)";"MG";"ITAMBE DO MATO DENTRO";22;5;7;34
2017;"ITAMOGI (MG)";"MG";"ITAMOGI";321;26;49;396
2017;"ITAMONTE (MG)";"MG";"ITAMONTE";323;28;36;387
2017;"ITANHANDU (MG)";"MG";"ITANHANDU";507;37;29;573
2017;"ITANHOMI (MG)";"MG";"ITANHOMI";132;24;29;185
2017;"ITAOBIM (MG)";"MG";"ITAOBIM";230;36;45;311
2017;"ITAPAGIPE (MG)";"MG";"ITAPAGIPE";287;22;56;365
2017;"ITAPECERICA (MG)";"MG";"ITAPECERICA";380;67;61;508
2017;"ITAPEVA (MG)";"MG";"ITAPEVA";266;37;21;324
2017;"ITATIAIUCU (MG)";"MG";"ITATIAIUCU";370;24;51;445
2017;"ITAU DE MINAS (MG)";"MG";"ITAU DE MINAS";315;43;51;409
2017;"ITAUNA (MG)";"MG";"ITAUNA";1614;253;284;2151
2017;"ITAVERAVA (MG)";"MG";"ITAVERAVA";58;11;22;91
2017;"ITINGA (MG)";"MG";"ITINGA";77;31;42;150
2017;"ITUETA (MG)";"MG";"ITUETA";79;11;21;111
2017;"ITUIUTABA (MG)";"MG";"ITUIUTABA";1468;285;388;2141
2017;"ITUMIRIM (MG)";"MG";"ITUMIRIM";71;35;8;114
2017;"ITURAMA (MG)";"MG";"ITURAMA";923;98;331;1352
2017;"ITUTINGA (MG)";"MG";"ITUTINGA";68;26;5;99
2017;"JABOTICATUBAS (MG)";"MG";"JABOTICATUBAS";324;21;67;412
2017;"JACINTO (MG)";"MG";"JACINTO";46;10;46;102
2017;"JACUI (MG)";"MG";"JACUI";174;18;36;228
2017;"JACUTINGA (MG)";"MG";"JACUTINGA";435;92;81;608
2017;"JAGUARACU (MG)";"MG";"JAGUARACU";52;2;7;61
2017;"JAIBA (MG)";"MG";"JAIBA";452;26;196;674
2017;"JAMPRUCA (MG)";"MG";"JAMPRUCA";18;6;29;53
2017;"JANAUBA (MG)";"MG";"JANAUBA";905;41;188;1134
2017;"JANUARIA (MG)";"MG";"JANUARIA";490;31;172;693
2017;"JAPARAIBA (MG)";"MG";"JAPARAIBA";93;12;20;125
2017;"JAPONVAR (MG)";"MG";"JAPONVAR";58;13;18;89
2017;"JECEABA (MG)";"MG";"JECEABA";120;38;20;178
2017;"JENIPAPO DE MINAS (MG)";"MG";"JENIPAPO DE MINAS";40;11;34;85
2017;"JEQUERI (MG)";"MG";"JEQUERI";158;14;58;230
2017;"JEQUITAI (MG)";"MG";"JEQUITAI";73;3;35;111
2017;"JEQUITIBA (MG)";"MG";"JEQUITIBA";109;12;32;153
2017;"JEQUITINHONHA (MG)";"MG";"JEQUITINHONHA";118;52;43;213
2017;"JESUANIA (MG)";"MG";"JESUANIA";76;23;12;111
2017;"JOAIMA (MG)";"MG";"JOAIMA";73;14;44;131
2017;"JOANESIA (MG)";"MG";"JOANESIA";20;8;17;45
2017;"JOAO MONLEVADE (MG)";"MG";"JOAO MONLEVADE";1314;143;245;1702
2017;"JOAO PINHEIRO (MG)";"MG";"JOAO PINHEIRO";1046;76;324;1446
2017;"JOAQUIM FELICIO (MG)";"MG";"JOAQUIM FELICIO";52;2;14;68
2017;"JORDANIA (MG)";"MG";"JORDANIA";41;18;26;85
2017;"JOSE GONCALVES DE MINAS (MG)";"MG";"JOSE GONCALVES DE MINAS";32;14;20;66
2017;"JOSE RAYDAN (MG)";"MG";"JOSE RAYDAN";40;2;17;59
2017;"JOSENOPOLIS (MG)";"MG";"JOSENOPOLIS";25;7;21;53
2017;"JUATUBA (MG)";"MG";"JUATUBA";329;58;259;646
2017;"JUIZ DE FORA (MG)";"MG";"JUIZ DE FORA";6387;872;1834;9093
2017;"JURAMENTO (MG)";"MG";"JURAMENTO";23;4;16;43
2017;"JURUAIA (MG)";"MG";"JURUAIA";119;24;33;176
2017;"JUVENILIA (MG)";"MG";"JUVENILIA";38;5;15;58
2017;"LADAINHA (MG)";"MG";"LADAINHA";69;24;54;147
2017;"LAGAMAR (MG)";"MG";"LAGAMAR";125;37;26;188
2017;"LAGOA DA PRATA (MG)";"MG";"LAGOA DA PRATA";1231;74;177;1482
2017;"LAGOA DOS PATOS (MG)";"MG";"LAGOA DOS PATOS";40;0;15;55
2017;"LAGOA DOURADA (MG)";"MG";"LAGOA DOURADA";441;47;151;639
2017;"LAGOA FORMOSA (MG)";"MG";"LAGOA FORMOSA";454;29;112;595
2017;"LAGOA GRANDE (MG)";"MG";"LAGOA GRANDE";145;10;70;225
2017;"LAGOA SANTA (MG)";"MG";"LAGOA SANTA";888;141;149;1178
2017;"LAJINHA (MG)";"MG";"LAJINHA";332;56;62;450
2017;"LAMBARI (MG)";"MG";"LAMBARI";430;70;39;539
2017;"LAMIM (MG)";"MG";"LAMIM";47;2;10;59
2017;"LARANJAL (MG)";"MG";"LARANJAL";121;11;8;140
2017;"LASSANCE (MG)";"MG";"LASSANCE";53;20;14;87
2017;"LAVRAS (MG)";"MG";"LAVRAS";1455;224;295;1974
2017;"LEANDRO FERREIRA (MG)";"MG";"LEANDRO FERREIRA";51;8;12;71
2017;"LEME DO PRADO (MG)";"MG";"LEME DO PRADO";35;7;20;62
2017;"LEOPOLDINA (MG)";"MG";"LEOPOLDINA";766;87;95;948
2017;"LIBERDADE (MG)";"MG";"LIBERDADE";147;21;13;181
2017;"LIMA DUARTE (MG)";"MG";"LIMA DUARTE";234;38;37;309
2017;"LIMEIRA DO OESTE (MG)";"MG";"LIMEIRA DO OESTE";190;32;67;289
2017;"LONTRA (MG)";"MG";"LONTRA";37;6;16;59
2017;"LUISBURGO (MG)";"MG";"LUISBURGO";55;11;24;90
2017;"LUISLANDIA (MG)";"MG";"LUISLANDIA";27;8;20;55
2017;"LUMINARIAS (MG)";"MG";"LUMINARIAS";134;8;45;187
2017;"LUZ (MG)";"MG";"LUZ";381;62;39;482
2017;"MACHACALIS (MG)";"MG";"MACHACALIS";44;6;15;65
2017;"MACHADO (MG)";"MG";"MACHADO";858;172;142;1172
2017;"MADRE DE DEUS DE MINAS (MG)";"MG";"MADRE DE DEUS DE MINAS";125;20;14;159
2017;"MALACACHETA (MG)";"MG";"MALACACHETA";125;19;67;211
2017;"MAMONAS (MG)";"MG";"MAMONAS";120;12;34;166
2017;"MANGA (MG)";"MG";"MANGA";161;15;62;238
2017;"MANHUACU (MG)";"MG";"MANHUACU";1832;170;209;2211
2017;"MANHUMIRIM (MG)";"MG";"MANHUMIRIM";410;60;50;520
2017;"MANTENA (MG)";"MG";"MANTENA";589;46;88;723
2017;"MAR DE ESPANHA (MG)";"MG";"MAR DE ESPANHA";278;33;26;337
2017;"MARAVILHAS (MG)";"MG";"MARAVILHAS";181;20;17;218
2017;"MARIA DA FE (MG)";"MG";"MARIA DA FE";275;22;39;336
2017;"MARIANA (MG)";"MG";"MARIANA";737;251;315;1303
2017;"MARILAC (MG)";"MG";"MARILAC";30;4;17;51
2017;"MARIO CAMPOS (MG)";"MG";"MARIO CAMPOS";279;27;31;337
2017;"MARIPA DE MINAS (MG)";"MG";"MARIPA DE MINAS";62;12;6;80
2017;"MARLIERIA (MG)";"MG";"MARLIERIA";47;7;12;66
2017;"MARMELOPOLIS (MG)";"MG";"MARMELOPOLIS";46;9;11;66
2017;"MARTINHO CAMPOS (MG)";"MG";"MARTINHO CAMPOS";418;30;80;528
2017;"MARTINS SOARES (MG)";"MG";"MARTINS SOARES";178;13;26;217
2017;"MATA VERDE (MG)";"MG";"MATA VERDE";68;53;12;133
2017;"MATERLANDIA (MG)";"MG";"MATERLANDIA";17;6;5;28
2017;"MATEUS LEME (MG)";"MG";"MATEUS LEME";628;108;130;866
2017;"MATHIAS LOBATO (MG)";"MG";"MATHIAS LOBATO";35;3;9;47
2017;"MATIAS BARBOSA (MG)";"MG";"MATIAS BARBOSA";758;49;47;854
2017;"MATIAS CARDOSO (MG)";"MG";"MATIAS CARDOSO";53;4;29;86
2017;"MATIPO (MG)";"MG";"MATIPO";330;33;63;426
2017;"MATO VERDE (MG)";"MG";"MATO VERDE";204;6;49;259
2017;"MATOZINHOS (MG)";"MG";"MATOZINHOS";444;120;151;715
2017;"MATUTINA (MG)";"MG";"MATUTINA";86;24;9;119
2017;"MEDEIROS (MG)";"MG";"MEDEIROS";92;27;8;127
2017;"MEDINA (MG)";"MG";"MEDINA";180;67;46;293
2017;"MENDES PIMENTEL (MG)";"MG";"MENDES PIMENTEL";44;8;16;68
2017;"MERCES (MG)";"MG";"MERCES";200;33;21;254
2017;"MESQUITA (MG)";"MG";"MESQUITA";33;15;15;63
2017;"MINAS NOVAS (MG)";"MG";"MINAS NOVAS";189;37;127;353
2017;"MINDURI (MG)";"MG";"MINDURI";91;10;5;106
2017;"MIRABELA (MG)";"MG";"MIRABELA";151;28;37;216
2017;"MIRADOURO (MG)";"MG";"MIRADOURO";117;17;34;168
2017;"MIRAI (MG)";"MG";"MIRAI";181;14;27;222
2017;"MIRAVANIA (MG)";"MG";"MIRAVANIA";20;4;17;41
2017;"MOEDA (MG)";"MG";"MOEDA";126;19;80;225
2017;"MOEMA (MG)";"MG";"MOEMA";212;19;124;355
2017;"MONJOLOS (MG)";"MG";"MONJOLOS";9;3;10;22
2017;"MONSENHOR PAULO (MG)";"MG";"MONSENHOR PAULO";222;32;16;270
2017;"MONTALVANIA (MG)";"MG";"MONTALVANIA";178;17;102;297
2017;"MONTE ALEGRE DE MINAS (MG)";"MG";"MONTE ALEGRE DE MINAS";666;81;76;823
2017;"MONTE AZUL (MG)";"MG";"MONTE AZUL";185;13;84;282
2017;"MONTE BELO (MG)";"MG";"MONTE BELO";312;45;58;415
2017;"MONTE CARMELO (MG)";"MG";"MONTE CARMELO";1530;152;195;1877
2017;"MONTE FORMOSO (MG)";"MG";"MONTE FORMOSO";29;29;59;117
2017;"MONTE SANTO DE MINAS (MG)";"MG";"MONTE SANTO DE MINAS";566;71;133;770
2017;"MONTE SIAO (MG)";"MG";"MONTE SIAO";337;57;45;439
2017;"MONTES CLAROS (MG)";"MG";"MONTES CLAROS";4800;427;1232;6459
2017;"MONTEZUMA (MG)";"MG";"MONTEZUMA";64;12;39;115
2017;"MORADA NOVA DE MINAS (MG)";"MG";"MORADA NOVA DE MINAS";133;25;29;187
2017;"MORRO DA GARCA (MG)";"MG";"MORRO DA GARCA";46;10;21;77
2017;"MORRO DO PILAR (MG)";"MG";"MORRO DO PILAR";35;10;3;48
2017;"MUNHOZ (MG)";"MG";"MUNHOZ";177;22;11;210
2017;"MURIAE (MG)";"MG";"MURIAE";1530;154;227;1911
2017;"MUTUM (MG)";"MG";"MUTUM";277;37;101;415
2017;"MUZAMBINHO (MG)";"MG";"MUZAMBINHO";519;102;56;677
2017;"NACIP RAYDAN (MG)";"MG";"NACIP RAYDAN";12;2;6;20
2017;"NANUQUE (MG)";"MG";"NANUQUE";595;74;227;896
2017;"NAQUE (MG)";"MG";"NAQUE";48;5;23;76
2017;"NATALANDIA (MG)";"MG";"NATALANDIA";31;1;21;53
2017;"NATERCIA (MG)";"MG";"NATERCIA";109;13;25;147
2017;"NAZARENO (MG)";"MG";"NAZARENO";234;21;43;298
2017;"NEPOMUCENO (MG)";"MG";"NEPOMUCENO";523;64;128;715
2017;"NINHEIRA (MG)";"MG";"NINHEIRA";67;11;48;126
2017;"NOVA BELEM (MG)";"MG";"NOVA BELEM";41;2;15;58
2017;"NOVA ERA (MG)";"MG";"NOVA ERA";261;59;79;399
2017;"NOVA LIMA (MG)";"MG";"NOVA LIMA";1768;404;259;2431
2017;"NOVA MODICA (MG)";"MG";"NOVA MODICA";21;3;14;38
2017;"NOVA PONTE (MG)";"MG";"NOVA PONTE";278;68;83;429
2017;"NOVA PORTEIRINHA (MG)";"MG";"NOVA PORTEIRINHA";46;6;21;73
2017;"NOVA RESENDE (MG)";"MG";"NOVA RESENDE";473;29;93;595
2017;"NOVA SERRANA (MG)";"MG";"NOVA SERRANA";632;74;134;840
2017;"NOVA UNIAO (MG)";"MG";"NOVA UNIAO";208;11;26;245
2017;"NOVO CRUZEIRO (MG)";"MG";"NOVO CRUZEIRO";237;53;209;499
2017;"NOVO ORIENTE DE MINAS (MG)";"MG";"NOVO ORIENTE DE MINAS";45;41;26;112
2017;"NOVORIZONTE (MG)";"MG";"NOVORIZONTE";80;1;28;109
2017;"OLARIA (MG)";"MG";"OLARIA";24;7;11;42
2017;"OLHOS D AGUA (MG)";"MG";"OLHOS D AGUA";107;18;54;179
2017;"OLIMPIO NORONHA (MG)";"MG";"OLIMPIO NORONHA";29;11;10;50
2017;"OLIVEIRA (MG)";"MG";"OLIVEIRA";825;116;137;1078
2017;"OLIVEIRA FORTES (MG)";"MG";"OLIVEIRA FORTES";27;3;4;34
2017;"ONCA DE PITANGUI (MG)";"MG";"ONCA DE PITANGUI";26;12;14;52
2017;"ORATORIOS (MG)";"MG";"ORATORIOS";112;6;24;142
2017;"ORIZANIA (MG)";"MG";"ORIZANIA";99;14;19;132
2017;"OURO BRANCO (MG)";"MG";"OURO BRANCO";525;129;195;849
2017;"OURO FINO (MG)";"MG";"OURO FINO";708;107;121;936
2017;"OURO PRETO (MG)";"MG";"OURO PRETO";1126;267;290;1683
2017;"OURO VERDE DE MINAS (MG)";"MG";"OURO VERDE DE MINAS";30;6;11;47
2017;"PADRE CARVALHO (MG)";"MG";"PADRE CARVALHO";29;8;31;68
2017;"PADRE PARAISO (MG)";"MG";"PADRE PARAISO";162;95;86;343
2017;"PAI PEDRO (MG)";"MG";"PAI PEDRO";20;3;33;56
2017;"PAINEIRAS (MG)";"MG";"PAINEIRAS";87;23;14;124
2017;"PAINS (MG)";"MG";"PAINS";282;21;31;334
2017;"PAIVA (MG)";"MG";"PAIVA";11;5;2;18
2017;"PALMA (MG)";"MG";"PALMA";120;10;10;140
2017;"PALMOPOLIS (MG)";"MG";"PALMOPOLIS";26;11;19;56
2017;"PAPAGAIOS (MG)";"MG";"PAPAGAIOS";596;17;84;697
2017;"PARA DE MINAS (MG)";"MG";"PARA DE MINAS";2437;187;238;2862
2017;"PARACATU (MG)";"MG";"PARACATU";1666;204;453;2323
2017;"PARAGUACU (MG)";"MG";"PARAGUACU";365;61;49;475
2017;"PARAISOPOLIS (MG)";"MG";"PARAISOPOLIS";412;58;47;517
2017;"PARAOPEBA (MG)";"MG";"PARAOPEBA";489;35;57;581
2017;"PASSA QUATRO (MG)";"MG";"PASSA QUATRO";409;42;33;484
2017;"PASSA TEMPO (MG)";"MG";"PASSA TEMPO";224;41;26;291
2017;"PASSA VINTE (MG)";"MG";"PASSA VINTE";321;36;21;378
2017;"PASSABEM (MG)";"MG";"PASSABEM";14;5;4;23
2017;"PASSOS (MG)";"MG";"PASSOS";2225;222;436;2883
2017;"PATIS (MG)";"MG";"PATIS";18;7;17;42
2017;"PATOS DE MINAS (MG)";"MG";"PATOS DE MINAS";3503;211;434;4148
2017;"PATROCINIO (MG)";"MG";"PATROCINIO";2114;207;600;2921
2017;"PATROCINIO DO MURIAE (MG)";"MG";"PATROCINIO DO MURIAE";111;15;10;136
2017;"PAULA CANDIDO (MG)";"MG";"PAULA CANDIDO";93;13;18;124
2017;"PAULISTAS (MG)";"MG";"PAULISTAS";57;4;11;72
2017;"PAVAO (MG)";"MG";"PAVAO";55;23;14;92
2017;"PECANHA (MG)";"MG";"PECANHA";157;17;68;242
2017;"PEDRA AZUL (MG)";"MG";"PEDRA AZUL";189;26;60;275
2017;"PEDRA BONITA (MG)";"MG";"PEDRA BONITA";99;13;23;135
2017;"PEDRA DO ANTA (MG)";"MG";"PEDRA DO ANTA";38;3;21;62
2017;"PEDRA DO INDAIA (MG)";"MG";"PEDRA DO INDAIA";108;15;7;130
2017;"PEDRA DOURADA (MG)";"MG";"PEDRA DOURADA";18;9;19;46
2017;"PEDRALVA (MG)";"MG";"PEDRALVA";198;34;29;261
2017;"PEDRAS DE MARIA DA CRUZ (MG)";"MG";"PEDRAS DE MARIA DA CRUZ";35;7;41;83
2017;"PEDRINOPOLIS (MG)";"MG";"PEDRINOPOLIS";62;13;11;86
2017;"PEDRO LEOPOLDO (MG)";"MG";"PEDRO LEOPOLDO";1259;215;200;1674
2017;"PEDRO TEIXEIRA (MG)";"MG";"PEDRO TEIXEIRA";18;7;5;30
2017;"PEQUERI (MG)";"MG";"PEQUERI";90;7;6;103
2017;"PEQUI (MG)";"MG";"PEQUI";69;21;7;97
2017;"PERDIGAO (MG)";"MG";"PERDIGAO";170;13;13;196
2017;"PERDIZES (MG)";"MG";"PERDIZES";341;70;73;484
2017;"PERDOES (MG)";"MG";"PERDOES";554;49;85;688
2017;"PERIQUITO (MG)";"MG";"PERIQUITO";61;3;29;93
2017;"PESCADOR (MG)";"MG";"PESCADOR";21;7;12;40
2017;"PIAU (MG)";"MG";"PIAU";67;12;8;87
2017;"PIEDADE DE CARATINGA (MG)";"MG";"PIEDADE DE CARATINGA";198;13;27;238
2017;"PIEDADE DE PONTE NOVA (MG)";"MG";"PIEDADE DE PONTE NOVA";43;4;19;66
2017;"PIEDADE DO RIO GRANDE (MG)";"MG";"PIEDADE DO RIO GRANDE";70;12;8;90
2017;"PIEDADE DOS GERAIS (MG)";"MG";"PIEDADE DOS GERAIS";111;10;16;137
2017;"PIMENTA (MG)";"MG";"PIMENTA";256;16;31;303
2017;"PINGO D AGUA (MG)";"MG";"PINGO D AGUA";31;3;10;44
2017;"PINTOPOLIS (MG)";"MG";"PINTOPOLIS";24;3;15;42
2017;"PIRACEMA (MG)";"MG";"PIRACEMA";130;11;23;164
2017;"PIRAJUBA (MG)";"MG";"PIRAJUBA";188;26;14;228
2017;"PIRANGA (MG)";"MG";"PIRANGA";172;31;83;286
2017;"PIRANGUCU (MG)";"MG";"PIRANGUCU";71;25;31;127
2017;"PIRANGUINHO (MG)";"MG";"PIRANGUINHO";254;27;32;313
2017;"PIRAPETINGA (MG)";"MG";"PIRAPETINGA";536;30;52;618
2017;"PIRAPORA (MG)";"MG";"PIRAPORA";621;68;198;887
2017;"PIRAUBA (MG)";"MG";"PIRAUBA";149;19;19;187
2017;"PITANGUI (MG)";"MG";"PITANGUI";589;101;107;797
2017;"PIUMHI (MG)";"MG";"PIUMHI";869;78;98;1045
2017;"PLANURA (MG)";"MG";"PLANURA";181;20;78;279
2017;"POCO FUNDO (MG)";"MG";"POCO FUNDO";360;62;36;458
2017;"POCOS DE CALDAS (MG)";"MG";"POCOS DE CALDAS";2924;630;464;4018
2017;"POCRANE (MG)";"MG";"POCRANE";102;8;18;128
2017;"POMPEU (MG)";"MG";"POMPEU";509;31;155;695
2017;"PONTE NOVA (MG)";"MG";"PONTE NOVA";1198;111;166;1475
2017;"PONTO CHIQUE (MG)";"MG";"PONTO CHIQUE";11;1;9;21
2017;"PONTO DOS VOLANTES (MG)";"MG";"PONTO DOS VOLANTES";50;20;45;115
2017;"PORTEIRINHA (MG)";"MG";"PORTEIRINHA";475;37;274;786
2017;"PORTO FIRME (MG)";"MG";"PORTO FIRME";72;8;24;104
2017;"POTE (MG)";"MG";"POTE";94;25;40;159
2017;"POUSO ALEGRE (MG)";"MG";"POUSO ALEGRE";2852;349;533;3734
2017;"POUSO ALTO (MG)";"MG";"POUSO ALTO";114;20;14;148
2017;"PRADOS (MG)";"MG";"PRADOS";137;25;20;182
2017;"PRATA (MG)";"MG";"PRATA";471;140;114;725
2017;"PRATAPOLIS (MG)";"MG";"PRATAPOLIS";255;25;32;312
2017;"PRATINHA (MG)";"MG";"PRATINHA";82;12;10;104
2017;"PRESIDENTE BERNARDES (MG)";"MG";"PRESIDENTE BERNARDES";31;8;13;52
2017;"PRESIDENTE JUSCELINO (MG)";"MG";"PRESIDENTE JUSCELINO";58;5;21;84
2017;"PRESIDENTE KUBITSCHEK (MG)";"MG";"PRESIDENTE KUBITSCHEK";29;13;8;50
2017;"PRESIDENTE OLEGARIO (MG)";"MG";"PRESIDENTE OLEGARIO";290;26;131;447
2017;"PRUDENTE DE MORAIS (MG)";"MG";"PRUDENTE DE MORAIS";127;17;14;158
2017;"QUARTEL GERAL (MG)";"MG";"QUARTEL GERAL";46;5;8;59
2017;"QUELUZITA (MG)";"MG";"QUELUZITA";25;9;5;39
2017;"RAPOSOS (MG)";"MG";"RAPOSOS";83;55;40;178
2017;"RAUL SOARES (MG)";"MG";"RAUL SOARES";298;52;83;433
2017;"RECREIO (MG)";"MG";"RECREIO";200;31;29;260
2017;"REDUTO (MG)";"MG";"REDUTO";117;10;15;142
2017;"RESENDE COSTA (MG)";"MG";"RESENDE COSTA";253;23;33;309
2017;"RESPLENDOR (MG)";"MG";"RESPLENDOR";204;44;47;295
2017;"RESSAQUINHA (MG)";"MG";"RESSAQUINHA";198;15;31;244
2017;"RIACHINHO (MG)";"MG";"RIACHINHO";116;6;31;153
2017;"RIACHO DOS MACHADOS (MG)";"MG";"RIACHO DOS MACHADOS";64;6;45;115
2017;"RIBEIRAO DAS NEVES (MG)";"MG";"RIBEIRAO DAS NEVES";2830;643;714;4187
2017;"RIBEIRAO VERMELHO (MG)";"MG";"RIBEIRAO VERMELHO";49;13;5;67
2017;"RIO ACIMA (MG)";"MG";"RIO ACIMA";139;29;19;187
2017;"RIO CASCA (MG)";"MG";"RIO CASCA";239;11;49;299
2017;"RIO DO PRADO (MG)";"MG";"RIO DO PRADO";16;9;12;37
2017;"RIO DOCE (MG)";"MG";"RIO DOCE";21;9;8;38
2017;"RIO ESPERA (MG)";"MG";"RIO ESPERA";49;1;16;66
2017;"RIO MANSO (MG)";"MG";"RIO MANSO";188;7;17;212
2017;"RIO NOVO (MG)";"MG";"RIO NOVO";189;30;39;258
2017;"RIO PARANAIBA (MG)";"MG";"RIO PARANAIBA";326;20;128;474
2017;"RIO PARDO DE MINAS (MG)";"MG";"RIO PARDO DE MINAS";240;41;207;488
2017;"RIO PIRACICABA (MG)";"MG";"RIO PIRACICABA";197;25;35;257
2017;"RIO POMBA (MG)";"MG";"RIO POMBA";288;41;44;373
2017;"RIO PRETO (MG)";"MG";"RIO PRETO";564;45;62;671
2017;"RIO VERMELHO (MG)";"MG";"RIO VERMELHO";93;44;50;187
2017;"RITAPOLIS (MG)";"MG";"RITAPOLIS";44;14;10;68
2017;"ROCHEDO DE MINAS (MG)";"MG";"ROCHEDO DE MINAS";31;5;4;40
2017;"RODEIRO (MG)";"MG";"RODEIRO";297;8;27;332
2017;"ROMARIA (MG)";"MG";"ROMARIA";55;27;12;94
2017;"ROSARIO DA LIMEIRA (MG)";"MG";"ROSARIO DA LIMEIRA";87;6;42;135
2017;"RUBELITA (MG)";"MG";"RUBELITA";24;11;14;49
2017;"RUBIM (MG)";"MG";"RUBIM";28;5;33;66
2017;"SABARA (MG)";"MG";"SABARA";849;231;396;1476
2017;"SABINOPOLIS (MG)";"MG";"SABINOPOLIS";160;45;82;287
2017;"SACRAMENTO (MG)";"MG";"SACRAMENTO";592;97;97;786
2017;"SALINAS (MG)";"MG";"SALINAS";498;57;158;713
2017;"SALTO DA DIVISA (MG)";"MG";"SALTO DA DIVISA";12;13;13;38
2017;"SANTA BARBARA (MG)";"MG";"SANTA BARBARA";423;98;114;635
2017;"SANTA BARBARA DO LESTE (MG)";"MG";"SANTA BARBARA DO LESTE";212;10;14;236
2017;"SANTA BARBARA DO MONTE VERDE (MG)";"MG";"SANTA BARBARA DO MONTE VERDE";646;54;137;837
2017;"SANTA BARBARA DO TUGURIO (MG)";"MG";"SANTA BARBARA DO TUGURIO";77;32;49;158
2017;"SANTA CRUZ DE MINAS (MG)";"MG";"SANTA CRUZ DE MINAS";95;15;6;116
2017;"SANTA CRUZ DE SALINAS (MG)";"MG";"SANTA CRUZ DE SALINAS";31;6;30;67
2017;"SANTA CRUZ DO ESCALVADO (MG)";"MG";"SANTA CRUZ DO ESCALVADO";51;13;21;85
2017;"SANTA EFIGENIA DE MINAS (MG)";"MG";"SANTA EFIGENIA DE MINAS";33;10;9;52
2017;"SANTA FE DE MINAS (MG)";"MG";"SANTA FE DE MINAS";9;2;8;19
2017;"SANTA HELENA DE MINAS (MG)";"MG";"SANTA HELENA DE MINAS";13;8;12;33
2017;"SANTA JULIANA (MG)";"MG";"SANTA JULIANA";506;50;80;636
2017;"SANTA LUZIA (MG)";"MG";"SANTA LUZIA";2061;381;701;3143
2017;"SANTA MARGARIDA (MG)";"MG";"SANTA MARGARIDA";279;34;54;367
2017;"SANTA MARIA DE ITABIRA (MG)";"MG";"SANTA MARIA DE ITABIRA";145;22;63;230
2017;"SANTA MARIA DO SALTO (MG)";"MG";"SANTA MARIA DO SALTO";13;8;11;32
2017;"SANTA MARIA DO SUACUI (MG)";"MG";"SANTA MARIA DO SUACUI";100;6;62;168
2017;"SANTA RITA DE CALDAS (MG)";"MG";"SANTA RITA DE CALDAS";348;29;22;399
2017;"SANTA RITA DE IBITIPOCA (MG)";"MG";"SANTA RITA DE IBITIPOCA";56;19;6;81
2017;"SANTA RITA DE JACUTINGA (MG)";"MG";"SANTA RITA DE JACUTINGA";116;10;9;135
2017;"SANTA RITA DE MINAS (MG)";"MG";"SANTA RITA DE MINAS";129;16;24;169
2017;"SANTA RITA DO ITUETO (MG)";"MG";"SANTA RITA DO ITUETO";107;12;20;139
2017;"SANTA RITA DO SAPUCAI (MG)";"MG";"SANTA RITA DO SAPUCAI";480;102;106;688
2017;"SANTA ROSA DA SERRA (MG)";"MG";"SANTA ROSA DA SERRA";78;12;18;108
2017;"SANTA VITORIA (MG)";"MG";"SANTA VITORIA";466;71;69;606
2017;"SANTANA DA VARGEM (MG)";"MG";"SANTANA DA VARGEM";115;14;33;162
2017;"SANTANA DE CATAGUASES (MG)";"MG";"SANTANA DE CATAGUASES";39;9;7;55
2017;"SANTANA DE PIRAPAMA (MG)";"MG";"SANTANA DE PIRAPAMA";85;7;38;130
2017;"SANTANA DO DESERTO (MG)";"MG";"SANTANA DO DESERTO";78;18;14;110
2017;"SANTANA DO GARAMBEU (MG)";"MG";"SANTANA DO GARAMBEU";22;11;8;41
2017;"SANTANA DO JACARE (MG)";"MG";"SANTANA DO JACARE";61;8;21;90
2017;"SANTANA DO MANHUACU (MG)";"MG";"SANTANA DO MANHUACU";277;10;25;312
2017;"SANTANA DO PARAISO (MG)";"MG";"SANTANA DO PARAISO";194;28;36;258
2017;"SANTANA DO RIACHO (MG)";"MG";"SANTANA DO RIACHO";60;11;7;78
2017;"SANTANA DOS MONTES (MG)";"MG";"SANTANA DOS MONTES";47;8;9;64
2017;"SANTO ANTONIO DO AMPARO (MG)";"MG";"SANTO ANTONIO DO AMPARO";342;56;110;508
2017;"SANTO ANTONIO DO AVENTUREIRO (MG)";"MG";"SANTO ANTONIO DO AVENTUREIRO";82;1;11;94
2017;"SANTO ANTONIO DO GRAMA (MG)";"MG";"SANTO ANTONIO DO GRAMA";56;10;10;76
2017;"SANTO ANTONIO DO ITAMBE (MG)";"MG";"SANTO ANTONIO DO ITAMBE";20;8;11;39
2017;"SANTO ANTONIO DO JACINTO (MG)";"MG";"SANTO ANTONIO DO JACINTO";49;5;45;99
2017;"SANTO ANTONIO DO MONTE (MG)";"MG";"SANTO ANTONIO DO MONTE";569;71;114;754
2017;"SANTO ANTONIO DO RETIRO (MG)";"MG";"SANTO ANTONIO DO RETIRO";68;5;43;116
2017;"SANTO ANTONIO DO RIO ABAIXO (MG)";"MG";"SANTO ANTONIO DO RIO ABAIXO";14;7;11;32
2017;"SANTO HIPOLITO (MG)";"MG";"SANTO HIPOLITO";28;7;5;40
2017;"SANTOS DUMONT (MG)";"MG";"SANTOS DUMONT";440;114;157;711
2017;"SAO BENTO ABADE (MG)";"MG";"SAO BENTO ABADE";45;26;32;103
2017;"SAO BRAS DO SUACUI (MG)";"MG";"SAO BRAS DO SUACUI";60;8;12;80
2017;"SAO DOMINGOS DAS DORES (MG)";"MG";"SAO DOMINGOS DAS DORES";125;15;18;158
2017;"SAO DOMINGOS DO PRATA (MG)";"MG";"SAO DOMINGOS DO PRATA";330;24;82;436
2017;"SAO FELIX DE MINAS (MG)";"MG";"SAO FELIX DE MINAS";30;3;15;48
2017;"SAO FRANCISCO (MG)";"MG";"SAO FRANCISCO";341;38;190;569
2017;"SAO FRANCISCO DE PAULA (MG)";"MG";"SAO FRANCISCO DE PAULA";87;32;28;147
2017;"SAO FRANCISCO DE SALES (MG)";"MG";"SAO FRANCISCO DE SALES";98;12;28;138
2017;"SAO FRANCISCO DO GLORIA (MG)";"MG";"SAO FRANCISCO DO GLORIA";75;15;15;105
2017;"SAO GERALDO (MG)";"MG";"SAO GERALDO";204;11;22;237
2017;"SAO GERALDO DA PIEDADE (MG)";"MG";"SAO GERALDO DA PIEDADE";24;6;12;42
2017;"SAO GERALDO DO BAIXIO (MG)";"MG";"SAO GERALDO DO BAIXIO";21;6;9;36
2017;"SAO GONCALO DO ABAETE (MG)";"MG";"SAO GONCALO DO ABAETE";104;22;26;152
2017;"SAO GONCALO DO PARA (MG)";"MG";"SAO GONCALO DO PARA";248;28;35;311
2017;"SAO GONCALO DO RIO ABAIXO (MG)";"MG";"SAO GONCALO DO RIO ABAIXO";221;58;46;325
2017;"SAO GONCALO DO RIO PRETO (MG)";"MG";"SAO GONCALO DO RIO PRETO";34;9;8;51
2017;"SAO GONCALO DO SAPUCAI (MG)";"MG";"SAO GONCALO DO SAPUCAI";511;58;91;660
2017;"SAO GOTARDO (MG)";"MG";"SAO GOTARDO";1094;116;292;1502
2017;"SAO JOAO BATISTA DO GLORIA (MG)";"MG";"SAO JOAO BATISTA DO GLORIA";162;15;18;195
2017;"SAO JOAO DA LAGOA (MG)";"MG";"SAO JOAO DA LAGOA";42;16;17;75
2017;"SAO JOAO DA MATA (MG)";"MG";"SAO JOAO DA MATA";65;25;6;96
2017;"SAO JOAO DA PONTE (MG)";"MG";"SAO JOAO DA PONTE";93;14;79;186
2017;"SAO JOAO DAS MISSOES (MG)";"MG";"SAO JOAO DAS MISSOES";42;5;25;72
2017;"SAO JOAO DEL REI (MG)";"MG";"SAO JOAO DEL REI";1276;247;259;1782
2017;"SAO JOAO DO MANHUACU (MG)";"MG";"SAO JOAO DO MANHUACU";195;17;44;256
2017;"SAO JOAO DO MANTENINHA (MG)";"MG";"SAO JOAO DO MANTENINHA";91;15;8;114
2017;"SAO JOAO DO ORIENTE (MG)";"MG";"SAO JOAO DO ORIENTE";122;8;13;143
2017;"SAO JOAO DO PACUI (MG)";"MG";"SAO JOAO DO PACUI";22;6;10;38
2017;"SAO JOAO DO PARAISO (MG)";"MG";"SAO JOAO DO PARAISO";236;41;114;391
2017;"SAO JOAO EVANGELISTA (MG)";"MG";"SAO JOAO EVANGELISTA";146;23;54;223
2017;"SAO JOAO NEPOMUCENO (MG)";"MG";"SAO JOAO NEPOMUCENO";309;50;27;386
2017;"SAO JOAQUIM DE BICAS (MG)";"MG";"SAO JOAQUIM DE BICAS";639;71;48;758
2017;"SAO JOSE DA BARRA (MG)";"MG";"SAO JOSE DA BARRA";130;16;32;178
2017;"SAO JOSE DA LAPA (MG)";"MG";"SAO JOSE DA LAPA";597;97;133;827
2017;"SAO JOSE DA SAFIRA (MG)";"MG";"SAO JOSE DA SAFIRA";11;1;7;19
2017;"SAO JOSE DA VARGINHA (MG)";"MG";"SAO JOSE DA VARGINHA";61;1;20;82
2017;"SAO JOSE DO ALEGRE (MG)";"MG";"SAO JOSE DO ALEGRE";50;8;7;65
2017;"SAO JOSE DO DIVINO (MG)";"MG";"SAO JOSE DO DIVINO";26;7;16;49
2017;"SAO JOSE DO GOIABAL (MG)";"MG";"SAO JOSE DO GOIABAL";52;8;42;102
2017;"SAO JOSE DO JACURI (MG)";"MG";"SAO JOSE DO JACURI";45;3;8;56
2017;"SAO JOSE DO MANTIMENTO (MG)";"MG";"SAO JOSE DO MANTIMENTO";39;1;5;45
2017;"SAO LOURENCO (MG)";"MG";"SAO LOURENCO";621;85;67;773
2017;"SAO MIGUEL DO ANTA (MG)";"MG";"SAO MIGUEL DO ANTA";94;15;12;121
2017;"SAO PEDRO DA UNIAO (MG)";"MG";"SAO PEDRO DA UNIAO";130;19;18;167
2017;"SAO PEDRO DO SUACUI (MG)";"MG";"SAO PEDRO DO SUACUI";44;5;9;58
2017;"SAO PEDRO DOS FERROS (MG)";"MG";"SAO PEDRO DOS FERROS";108;9;45;162
2017;"SAO ROMAO (MG)";"MG";"SAO ROMAO";50;5;17;72
2017;"SAO ROQUE DE MINAS (MG)";"MG";"SAO ROQUE DE MINAS";209;16;33;258
2017;"SAO SEBASTIAO DA BELA VISTA (MG)";"MG";"SAO SEBASTIAO DA BELA VISTA";106;16;17;139
2017;"SAO SEBASTIAO DA VARGEM ALEGRE (MG)";"MG";"SAO SEBASTIAO DA VARGEM ALEGRE";42;4;11;57
2017;"SAO SEBASTIAO DO ANTA (MG)";"MG";"SAO SEBASTIAO DO ANTA";72;10;9;91
2017;"SAO SEBASTIAO DO MARANHAO (MG)";"MG";"SAO SEBASTIAO DO MARANHAO";30;14;29;73
2017;"SAO SEBASTIAO DO OESTE (MG)";"MG";"SAO SEBASTIAO DO OESTE";183;10;50;243
2017;"SAO SEBASTIAO DO PARAISO (MG)";"MG";"SAO SEBASTIAO DO PARAISO";1746;143;251;2140
2017;"SAO SEBASTIAO DO RIO PRETO (MG)";"MG";"SAO SEBASTIAO DO RIO PRETO";10;6;6;22
2017;"SAO SEBASTIAO DO RIO VERDE (MG)";"MG";"SAO SEBASTIAO DO RIO VERDE";20;5;7;32
2017;"SAO TIAGO (MG)";"MG";"SAO TIAGO";268;21;33;322
2017;"SAO TOMAS DE AQUINO (MG)";"MG";"SAO TOMAS DE AQUINO";114;26;17;157
2017;"SAO TOME DAS LETRAS (MG)";"MG";"SAO TOME DAS LETRAS";98;15;30;143
2017;"SAO VICENTE DE MINAS (MG)";"MG";"SAO VICENTE DE MINAS";128;27;8;163
2017;"SAPUCAI MIRIM (MG)";"MG";"SAPUCAI MIRIM";237;34;14;285
2017;"SARDOA (MG)";"MG";"SARDOA";68;13;13;94
2017;"SARZEDO (MG)";"MG";"SARZEDO";853;78;126;1057
2017;"SEM PEIXE (MG)";"MG";"SEM PEIXE";16;4;15;35
2017;"SENADOR AMARAL (MG)";"MG";"SENADOR AMARAL";137;7;13;157
2017;"SENADOR CORTES (MG)";"MG";"SENADOR CORTES";27;5;4;36
2017;"SENADOR FIRMINO (MG)";"MG";"SENADOR FIRMINO";122;11;32;165
2017;"SENADOR JOSE BENTO (MG)";"MG";"SENADOR JOSE BENTO";15;0;9;24
2017;"SENADOR MODESTINO GONCALVES (MG)";"MG";"SENADOR MODESTINO GONCALVES";34;6;13;53
2017;"SENHORA DE OLIVEIRA (MG)";"MG";"SENHORA DE OLIVEIRA";88;5;14;107
2017;"SENHORA DO PORTO (MG)";"MG";"SENHORA DO PORTO";24;11;17;52
2017;"SENHORA DOS REMEDIOS (MG)";"MG";"SENHORA DOS REMEDIOS";143;42;28;213
2017;"SERICITA (MG)";"MG";"SERICITA";115;4;9;128
2017;"SERITINGA (MG)";"MG";"SERITINGA";30;3;4;37
2017;"SERRA AZUL DE MINAS (MG)";"MG";"SERRA AZUL DE MINAS";23;8;12;43
2017;"SERRA DA SAUDADE (MG)";"MG";"SERRA DA SAUDADE";9;6;3;18
2017;"SERRA DO SALITRE (MG)";"MG";"SERRA DO SALITRE";310;21;111;442
2017;"SERRA DOS AIMORES (MG)";"MG";"SERRA DOS AIMORES";79;3;30;112
2017;"SERRANIA (MG)";"MG";"SERRANIA";137;24;25;186
2017;"SERRANOPOLIS DE MINAS (MG)";"MG";"SERRANOPOLIS DE MINAS";20;1;24;45
2017;"SERRANOS (MG)";"MG";"SERRANOS";25;8;4;37
2017;"SERRO (MG)";"MG";"SERRO";220;30;90;340
2017;"SETE LAGOAS (MG)";"MG";"SETE LAGOAS";3622;471;827;4920
2017;"SETUBINHA (MG)";"MG";"SETUBINHA";38;9;40;87
2017;"SILVEIRANIA (MG)";"MG";"SILVEIRANIA";21;4;8;33
2017;"SILVIANOPOLIS (MG)";"MG";"SILVIANOPOLIS";100;15;17;132
2017;"SIMAO PEREIRA (MG)";"MG";"SIMAO PEREIRA";72;18;7;97
2017;"SIMONESIA (MG)";"MG";"SIMONESIA";325;20;54;399
2017;"SOBRALIA (MG)";"MG";"SOBRALIA";44;5;11;60
2017;"SOLEDADE DE MINAS (MG)";"MG";"SOLEDADE DE MINAS";55;19;4;78
2017;"TABULEIRO (MG)";"MG";"TABULEIRO";87;8;14;109
2017;"TAIOBEIRAS (MG)";"MG";"TAIOBEIRAS";831;56;223;1110
2017;"TAPARUBA (MG)";"MG";"TAPARUBA";34;3;12;49
2017;"TAPIRA (MG)";"MG";"TAPIRA";153;17;33;203
2017;"TAPIRAI (MG)";"MG";"TAPIRAI";20;9;5;34
2017;"TAQUARACU DE MINAS (MG)";"MG";"TAQUARACU DE MINAS";109;10;14;133
2017;"TARUMIRIM (MG)";"MG";"TARUMIRIM";152;19;34;205
2017;"TEIXEIRAS (MG)";"MG";"TEIXEIRAS";185;16;17;218
2017;"TEOFILO OTONI (MG)";"MG";"TEOFILO OTONI";1632;227;196;2055
2017;"TIMOTEO (MG)";"MG";"TIMOTEO";941;215;160;1316
2017;"TIRADENTES (MG)";"MG";"TIRADENTES";119;26;12;157
2017;"TIROS (MG)";"MG";"TIROS";192;17;18;227
2017;"TOCANTINS (MG)";"MG";"TOCANTINS";269;19;23;311
2017;"TOCOS DO MOJI (MG)";"MG";"TOCOS DO MOJI";63;14;16;93
2017;"TOLEDO (MG)";"MG";"TOLEDO";151;12;22;185
2017;"TOMBOS (MG)";"MG";"TOMBOS";153;41;37;231
2017;"TRES CORACOES (MG)";"MG";"TRES CORACOES";1155;121;229;1505
2017;"TRES MARIAS (MG)";"MG";"TRES MARIAS";449;58;113;620
2017;"TRES PONTAS (MG)";"MG";"TRES PONTAS";1088;151;238;1477
2017;"TUMIRITINGA (MG)";"MG";"TUMIRITINGA";37;5;12;54
2017;"TUPACIGUARA (MG)";"MG";"TUPACIGUARA";653;101;88;842
2017;"TURMALINA (MG)";"MG";"TURMALINA";381;39;95;515
2017;"TURVOLANDIA (MG)";"MG";"TURVOLANDIA";129;35;16;180
2017;"UBA (MG)";"MG";"UBA";2042;119;196;2357
2017;"UBAI (MG)";"MG";"UBAI";49;13;51;113
2017;"UBAPORANGA (MG)";"MG";"UBAPORANGA";212;11;36;259
2017;"UBERABA (MG)";"MG";"UBERABA";5215;1112;1133;7460
2017;"UBERLANDIA (MG)";"MG";"UBERLANDIA";11576;1345;1697;14618
2017;"UMBURATIBA (MG)";"MG";"UMBURATIBA";13;4;6;23
2017;"UNAI (MG)";"MG";"UNAI";1734;109;483;2326
2017;"UNIAO DE MINAS (MG)";"MG";"UNIAO DE MINAS";60;9;43;112
2017;"URUANA DE MINAS (MG)";"MG";"URUANA DE MINAS";26;3;15;44
2017;"URUCANIA (MG)";"MG";"URUCANIA";195;8;61;264
2017;"URUCUIA (MG)";"MG";"URUCUIA";111;7;48;166
2017;"VARGEM ALEGRE (MG)";"MG";"VARGEM ALEGRE";75;5;15;95
2017;"VARGEM BONITA (MG)";"MG";"VARGEM BONITA";43;3;7;53
2017;"VARGEM GRANDE DO RIO PARDO (MG)";"MG";"VARGEM GRANDE DO RIO PARDO";72;9;23;104
2017;"VARGINHA (MG)";"MG";"VARGINHA";2211;219;298;2728
2017;"VARJAO DE MINAS (MG)";"MG";"VARJAO DE MINAS";106;16;65;187
2017;"VARZEA DA PALMA (MG)";"MG";"VARZEA DA PALMA";513;24;115;652
2017;"VARZELANDIA (MG)";"MG";"VARZELANDIA";73;11;68;152
2017;"VAZANTE (MG)";"MG";"VAZANTE";390;46;81;517
2017;"VERDELANDIA (MG)";"MG";"VERDELANDIA";20;4;12;36
2017;"VEREDINHA (MG)";"MG";"VEREDINHA";68;17;24;109
2017;"VERISSIMO (MG)";"MG";"VERISSIMO";40;35;8;83
2017;"VERMELHO NOVO (MG)";"MG";"VERMELHO NOVO";116;10;29;155
2017;"VESPASIANO (MG)";"MG";"VESPASIANO";1310;283;241;1834
2017;"VICOSA (MG)";"MG";"VICOSA";800;175;235;1210
2017;"VIEIRAS (MG)";"MG";"VIEIRAS";44;15;10;69
2017;"VIRGEM DA LAPA (MG)";"MG";"VIRGEM DA LAPA";75;12;40;127
2017;"VIRGINIA (MG)";"MG";"VIRGINIA";204;24;12;240
2017;"VIRGINOPOLIS (MG)";"MG";"VIRGINOPOLIS";136;11;38;185
2017;"VIRGOLANDIA (MG)";"MG";"VIRGOLANDIA";30;7;14;51
2017;"VISCONDE DO RIO BRANCO (MG)";"MG";"VISCONDE DO RIO BRANCO";1155;60;78;1293
2017;"VOLTA GRANDE (MG)";"MG";"VOLTA GRANDE";80;15;9;104
2017;"WENCESLAU BRAZ (MG)";"MG";"WENCESLAU BRAZ";39;8;12;59
2017;"AGUA CLARA (MS)";"MS";"AGUA CLARA";447;32;122;601
2017;"ALCINOPOLIS (MS)";"MS";"ALCINOPOLIS";109;18;19;146
2017;"AMAMBAI (MS)";"MS";"AMAMBAI";827;28;80;935
2017;"ANASTACIO (MS)";"MS";"ANASTACIO";457;24;39;520
2017;"ANAURILANDIA (MS)";"MS";"ANAURILANDIA";131;21;65;217
2017;"ANGELICA (MS)";"MS";"ANGELICA";305;57;75;437
2017;"ANTONIO JOAO (MS)";"MS";"ANTONIO JOAO";132;8;31;171
2017;"APARECIDA DO TABOADO (MS)";"MS";"APARECIDA DO TABOADO";459;50;62;571
2017;"AQUIDAUANA (MS)";"MS";"AQUIDAUANA";414;26;85;525
2017;"ARAL MOREIRA (MS)";"MS";"ARAL MOREIRA";245;14;31;290
2017;"BANDEIRANTES (MS)";"MS";"BANDEIRANTES";241;15;53;309
2017;"BATAGUASSU (MS)";"MS";"BATAGUASSU";465;44;231;740
2017;"BATAYPORA (MS)";"MS";"BATAYPORA";208;11;31;250
2017;"BELA VISTA (MS)";"MS";"BELA VISTA";331;52;66;449
2017;"BODOQUENA (MS)";"MS";"BODOQUENA";109;30;43;182
2017;"BONITO (MS)";"MS";"BONITO";358;78;84;520
2017;"BRASILANDIA (MS)";"MS";"BRASILANDIA";285;33;93;411
2017;"CAARAPO (MS)";"MS";"CAARAPO";661;19;172;852
2017;"CAMAPUA (MS)";"MS";"CAMAPUA";374;51;48;473
2017;"CAMPO GRANDE (MS)";"MS";"CAMPO GRANDE";15612;1035;2353;19000
2017;"CARACOL (MS)";"MS";"CARACOL";70;18;16;104
2017;"CASSILANDIA (MS)";"MS";"CASSILANDIA";507;27;56;590
2017;"CHAPADAO DO SUL (MS)";"MS";"CHAPADAO DO SUL";965;33;129;1127
2017;"CORGUINHO (MS)";"MS";"CORGUINHO";72;16;27;115
2017;"CORONEL SAPUCAIA (MS)";"MS";"CORONEL SAPUCAIA";374;11;38;423
2017;"CORUMBA (MS)";"MS";"CORUMBA";985;88;253;1326
2017;"COSTA RICA (MS)";"MS";"COSTA RICA";566;20;160;746
2017;"COXIM (MS)";"MS";"COXIM";677;23;91;791
2017;"DEODAPOLIS (MS)";"MS";"DEODAPOLIS";295;27;106;428
2017;"DOIS IRMAOS DO BURITI (MS)";"MS";"DOIS IRMAOS DO BURITI";169;28;38;235
2017;"DOURADINA (MS)";"MS";"DOURADINA";314;11;24;349
2017;"DOURADOS (MS)";"MS";"DOURADOS";4375;257;595;5227
2017;"ELDORADO (MS)";"MS";"ELDORADO";289;20;40;349
2017;"FATIMA DO SUL (MS)";"MS";"FATIMA DO SUL";485;14;43;542
2017;"FIGUEIRAO (MS)";"MS";"FIGUEIRAO";59;33;5;97
2017;"GLORIA DE DOURADOS (MS)";"MS";"GLORIA DE DOURADOS";213;10;30;253
2017;"GUIA LOPES DA LAGUNA (MS)";"MS";"GUIA LOPES DA LAGUNA";218;25;28;271
2017;"IGUATEMI (MS)";"MS";"IGUATEMI";278;8;73;359
2017;"INOCENCIA (MS)";"MS";"INOCENCIA";210;10;46;266
2017;"ITAPORA (MS)";"MS";"ITAPORA";489;31;50;570
2017;"ITAQUIRAI (MS)";"MS";"ITAQUIRAI";273;11;128;412
2017;"IVINHEMA (MS)";"MS";"IVINHEMA";731;77;301;1109
2017;"JAPORA (MS)";"MS";"JAPORA";54;3;23;80
2017;"JARAGUARI (MS)";"MS";"JARAGUARI";81;10;20;111
2017;"JARDIM (MS)";"MS";"JARDIM";508;28;66;602
2017;"JATEI (MS)";"MS";"JATEI";61;7;46;114
2017;"JUTI (MS)";"MS";"JUTI";121;13;30;164
2017;"LADARIO (MS)";"MS";"LADARIO";165;28;67;260
2017;"LAGUNA CARAPA (MS)";"MS";"LAGUNA CARAPA";217;5;28;250
2017;"MARACAJU (MS)";"MS";"MARACAJU";1176;42;148;1366
2017;"MIRANDA (MS)";"MS";"MIRANDA";404;36;128;568
2017;"MUNDO NOVO (MS)";"MS";"MUNDO NOVO";333;48;28;409
2017;"NAVIRAI (MS)";"MS";"NAVIRAI";1051;46;187;1284
2017;"NIOAQUE (MS)";"MS";"NIOAQUE";204;25;68;297
2017;"NOVA ALVORADA DO SUL (MS)";"MS";"NOVA ALVORADA DO SUL";400;30;84;514
2017;"NOVA ANDRADINA (MS)";"MS";"NOVA ANDRADINA";1170;45;275;1490
2017;"NOVO HORIZONTE DO SUL (MS)";"MS";"NOVO HORIZONTE DO SUL";89;9;26;124
2017;"PARAISO DAS AGUAS (MS)";"MS";"PARAISO DAS AGUAS";96;19;16;131
2017;"PARANAIBA (MS)";"MS";"PARANAIBA";926;46;117;1089
2017;"PARANHOS (MS)";"MS";"PARANHOS";112;8;35;155
2017;"PEDRO GOMES (MS)";"MS";"PEDRO GOMES";115;9;18;142
2017;"PONTA PORA (MS)";"MS";"PONTA PORA";2140;132;374;2646
2017;"PORTO MURTINHO (MS)";"MS";"PORTO MURTINHO";98;20;30;148
2017;"RIBAS DO RIO PARDO (MS)";"MS";"RIBAS DO RIO PARDO";650;55;93;798
2017;"RIO BRILHANTE (MS)";"MS";"RIO BRILHANTE";746;56;150;952
2017;"RIO NEGRO (MS)";"MS";"RIO NEGRO";95;10;11;116
2017;"RIO VERDE DE MATO GROSSO (MS)";"MS";"RIO VERDE DE MATO GROSSO";426;28;36;490
2017;"ROCHEDO (MS)";"MS";"ROCHEDO";80;5;14;99
2017;"SANTA RITA DO PARDO (MS)";"MS";"SANTA RITA DO PARDO";150;15;42;207
2017;"SAO GABRIEL DO OESTE (MS)";"MS";"SAO GABRIEL DO OESTE";1078;31;94;1203
2017;"SELVIRIA (MS)";"MS";"SELVIRIA";116;18;27;161
2017;"SETE QUEDAS (MS)";"MS";"SETE QUEDAS";273;10;21;304
2017;"SIDROLANDIA (MS)";"MS";"SIDROLANDIA";743;170;322;1235
2017;"SONORA (MS)";"MS";"SONORA";260;30;124;414
2017;"TACURU (MS)";"MS";"TACURU";140;8;22;170
2017;"TAQUARUSSU (MS)";"MS";"TAQUARUSSU";57;7;16;80
2017;"TERENOS (MS)";"MS";"TERENOS";390;17;64;471
2017;"TRES LAGOAS (MS)";"MS";"TRES LAGOAS";1996;250;406;2652
2017;"VICENTINA (MS)";"MS";"VICENTINA";159;8;111;278
2017;"ACORIZAL (MT)";"MT";"ACORIZAL";21;5;3;29
2017;"AGUA BOA (MT)";"MT";"AGUA BOA";688;25;57;770
2017;"ALTA FLORESTA (MT)";"MT";"ALTA FLORESTA";1505;32;154;1691
2017;"ALTO ARAGUAIA (MT)";"MT";"ALTO ARAGUAIA";238;28;44;310
2017;"ALTO BOA VISTA (MT)";"MT";"ALTO BOA VISTA";66;0;6;72
2017;"ALTO GARCAS (MT)";"MT";"ALTO GARCAS";324;20;58;402
2017;"ALTO PARAGUAI (MT)";"MT";"ALTO PARAGUAI";49;9;8;66
2017;"ALTO TAQUARI (MT)";"MT";"ALTO TAQUARI";265;28;27;320
2017;"APIACAS (MT)";"MT";"APIACAS";156;9;11;176
2017;"ARAGUAIANA (MT)";"MT";"ARAGUAIANA";17;1;4;22
2017;"ARAGUAINHA (MT)";"MT";"ARAGUAINHA";11;1;1;13
2017;"ARAPUTANGA (MT)";"MT";"ARAPUTANGA";290;13;29;332
2017;"ARENAPOLIS (MT)";"MT";"ARENAPOLIS";226;12;64;302
2017;"ARIPUANA (MT)";"MT";"ARIPUANA";485;11;55;551
2017;"BARAO DE MELGACO (MT)";"MT";"BARAO DE MELGACO";19;5;7;31
2017;"BARRA DO BUGRES (MT)";"MT";"BARRA DO BUGRES";646;20;180;846
2017;"BARRA DO GARCAS (MT)";"MT";"BARRA DO GARCAS";946;35;229;1210
2017;"BOM JESUS DO ARAGUAIA (MT)";"MT";"BOM JESUS DO ARAGUAIA";78;2;18;98
2017;"BRASNORTE (MT)";"MT";"BRASNORTE";403;8;70;481
2017;"CACERES (MT)";"MT";"CACERES";1082;63;338;1483
2017;"CAMPINAPOLIS (MT)";"MT";"CAMPINAPOLIS";116;6;23;145
2017;"CAMPO NOVO DO PARECIS (MT)";"MT";"CAMPO NOVO DO PARECIS";858;56;149;1063
2017;"CAMPO VERDE (MT)";"MT";"CAMPO VERDE";1076;52;165;1293
2017;"CAMPOS DE JULIO (MT)";"MT";"CAMPOS DE JULIO";225;14;47;286
2017;"CANABRAVA DO NORTE (MT)";"MT";"CANABRAVA DO NORTE";44;0;10;54
2017;"CANARANA (MT)";"MT";"CANARANA";638;19;38;695
2017;"CARLINDA (MT)";"MT";"CARLINDA";167;2;28;197
2017;"CASTANHEIRA (MT)";"MT";"CASTANHEIRA";175;2;32;209
2017;"CHAPADA DOS GUIMARAES (MT)";"MT";"CHAPADA DOS GUIMARAES";235;39;56;330
2017;"CLAUDIA (MT)";"MT";"CLAUDIA";444;5;37;486
2017;"COCALINHO (MT)";"MT";"COCALINHO";42;1;10;53
2017;"COLIDER (MT)";"MT";"COLIDER";937;25;142;1104
2017;"COLNIZA (MT)";"MT";"COLNIZA";455;1;47;503
2017;"COMODORO (MT)";"MT";"COMODORO";624;13;103;740
2017;"CONFRESA (MT)";"MT";"CONFRESA";374;6;72;452
2017;"CONQUISTA D OESTE (MT)";"MT";"CONQUISTA D OESTE";65;5;13;83
2017;"COTRIGUACU (MT)";"MT";"COTRIGUACU";169;7;42;218
2017;"CUIABA (MT)";"MT";"CUIABA";10568;899;3259;14726
2017;"CURVELANDIA (MT)";"MT";"CURVELANDIA";108;0;22;130
2017;"DENISE (MT)";"MT";"DENISE";93;6;34;133
2017;"DIAMANTINO (MT)";"MT";"DIAMANTINO";583;23;100;706
2017;"DOM AQUINO (MT)";"MT";"DOM AQUINO";143;10;28;181
2017;"FELIZ NATAL (MT)";"MT";"FELIZ NATAL";280;4;27;311
2017;"FIGUEIROPOLIS D OESTE (MT)";"MT";"FIGUEIROPOLIS D OESTE";74;3;11;88
2017;"GAUCHA DO NORTE (MT)";"MT";"GAUCHA DO NORTE";161;4;26;191
2017;"GENERAL CARNEIRO (MT)";"MT";"GENERAL CARNEIRO";25;5;7;37
2017;"GLORIA D OESTE (MT)";"MT";"GLORIA D OESTE";69;3;18;90
2017;"GUARANTA DO NORTE (MT)";"MT";"GUARANTA DO NORTE";1025;20;85;1130
2017;"GUIRATINGA (MT)";"MT";"GUIRATINGA";218;16;17;251
2017;"INDIAVAI (MT)";"MT";"INDIAVAI";24;3;7;34
2017;"IPIRANGA DO NORTE (MT)";"MT";"IPIRANGA DO NORTE";180;9;13;202
2017;"ITANHANGA (MT)";"MT";"ITANHANGA";206;7;15;228
2017;"ITAUBA (MT)";"MT";"ITAUBA";140;13;15;168
2017;"ITIQUIRA (MT)";"MT";"ITIQUIRA";168;26;83;277
2017;"JACIARA (MT)";"MT";"JACIARA";705;48;165;918
2017;"JANGADA (MT)";"MT";"JANGADA";66;9;21;96
2017;"JAURU (MT)";"MT";"JAURU";178;10;46;234
2017;"JUARA (MT)";"MT";"JUARA";955;24;85;1064
2017;"JUINA (MT)";"MT";"JUINA";1088;20;93;1201
2017;"JURUENA (MT)";"MT";"JURUENA";216;2;20;238
2017;"JUSCIMEIRA (MT)";"MT";"JUSCIMEIRA";168;7;68;243
2017;"LAMBARI D OESTE (MT)";"MT";"LAMBARI D OESTE";101;2;31;134
2017;"LUCAS DO RIO VERDE (MT)";"MT";"LUCAS DO RIO VERDE";1863;67;169;2099
2017;"LUCIARA (MT)";"MT";"LUCIARA";12;0;3;15
2017;"MARCELANDIA (MT)";"MT";"MARCELANDIA";425;11;21;457
2017;"MATUPA (MT)";"MT";"MATUPA";497;10;54;561
2017;"MIRASSOL D OESTE (MT)";"MT";"MIRASSOL D OESTE";925;15;102;1042
2017;"NOBRES (MT)";"MT";"NOBRES";341;37;59;437
2017;"NORTELANDIA (MT)";"MT";"NORTELANDIA";95;9;22;126
2017;"NOSSA SENHORA DO LIVRAMENTO (MT)";"MT";"NOSSA SENHORA DO LIVRAMENTO";121;11;33;165
2017;"NOVA BANDEIRANTES (MT)";"MT";"NOVA BANDEIRANTES";245;4;37;286
2017;"NOVA BRASILANDIA (MT)";"MT";"NOVA BRASILANDIA";79;2;13;94
2017;"NOVA CANAA DO NORTE (MT)";"MT";"NOVA CANAA DO NORTE";277;6;68;351
2017;"NOVA GUARITA (MT)";"MT";"NOVA GUARITA";121;4;20;145
2017;"NOVA LACERDA (MT)";"MT";"NOVA LACERDA";147;2;31;180
2017;"NOVA MARILANDIA (MT)";"MT";"NOVA MARILANDIA";59;6;11;76
2017;"NOVA MARINGA (MT)";"MT";"NOVA MARINGA";136;5;11;152
2017;"NOVA MONTE VERDE (MT)";"MT";"NOVA MONTE VERDE";181;4;14;199
2017;"NOVA MUTUM (MT)";"MT";"NOVA MUTUM";1228;22;141;1391
2017;"NOVA NAZARE (MT)";"MT";"NOVA NAZARE";10;6;5;21
2017;"NOVA OLIMPIA (MT)";"MT";"NOVA OLIMPIA";384;16;143;543
2017;"NOVA SANTA HELENA (MT)";"MT";"NOVA SANTA HELENA";74;5;14;93
2017;"NOVA UBIRATA (MT)";"MT";"NOVA UBIRATA";248;22;36;306
2017;"NOVA XAVANTINA (MT)";"MT";"NOVA XAVANTINA";496;29;47;572
2017;"NOVO HORIZONTE DO NORTE (MT)";"MT";"NOVO HORIZONTE DO NORTE";55;1;12;68
2017;"NOVO MUNDO (MT)";"MT";"NOVO MUNDO";137;3;23;163
2017;"NOVO SANTO ANTONIO (MT)";"MT";"NOVO SANTO ANTONIO";3;0;2;5
2017;"NOVO SAO JOAQUIM (MT)";"MT";"NOVO SAO JOAQUIM";113;5;18;136
2017;"PARANAITA (MT)";"MT";"PARANAITA";270;17;79;366
2017;"PARANATINGA (MT)";"MT";"PARANATINGA";531;25;86;642
2017;"PEDRA PRETA (MT)";"MT";"PEDRA PRETA";382;13;62;457
2017;"PEIXOTO DE AZEVEDO (MT)";"MT";"PEIXOTO DE AZEVEDO";485;14;81;580
2017;"PLANALTO DA SERRA (MT)";"MT";"PLANALTO DA SERRA";33;2;12;47
2017;"POCONE (MT)";"MT";"POCONE";553;27;45;625
2017;"PONTAL DO ARAGUAIA (MT)";"MT";"PONTAL DO ARAGUAIA";38;2;4;44
2017;"PONTE BRANCA (MT)";"MT";"PONTE BRANCA";10;2;1;13
2017;"PONTES E LACERDA (MT)";"MT";"PONTES E LACERDA";1028;26;134;1188
2017;"PORTO ALEGRE DO NORTE (MT)";"MT";"PORTO ALEGRE DO NORTE";119;7;36;162
2017;"PORTO DOS GAUCHOS (MT)";"MT";"PORTO DOS GAUCHOS";154;17;10;181
2017;"PORTO ESPERIDIAO (MT)";"MT";"PORTO ESPERIDIAO";164;10;60;234
2017;"PORTO ESTRELA (MT)";"MT";"PORTO ESTRELA";36;4;11;51
2017;"POXOREO (MT)";"MT";"POXOREO";165;25;52;242
2017;"PRIMAVERA DO LESTE (MT)";"MT";"PRIMAVERA DO LESTE";2237;107;209;2553
2017;"QUERENCIA (MT)";"MT";"QUERENCIA";451;35;69;555
2017;"RESERVA DO CABACAL (MT)";"MT";"RESERVA DO CABACAL";19;1;8;28
2017;"RIBEIRAO CASCALHEIRA (MT)";"MT";"RIBEIRAO CASCALHEIRA";151;12;20;183
2017;"RIBEIRAOZINHO (MT)";"MT";"RIBEIRAOZINHO";16;1;7;24
2017;"RIO BRANCO (MT)";"MT";"RIO BRANCO";93;4;32;129
2017;"RONDOLANDIA (MT)";"MT";"RONDOLANDIA";44;1;23;68
2017;"RONDONOPOLIS (MT)";"MT";"RONDONOPOLIS";4808;198;537;5543
2017;"ROSARIO OESTE (MT)";"MT";"ROSARIO OESTE";194;16;44;254
2017;"SALTO DO CEU (MT)";"MT";"SALTO DO CEU";57;7;26;90
2017;"SANTA CARMEM (MT)";"MT";"SANTA CARMEM";179;6;17;202
2017;"SANTA CRUZ DO XINGU (MT)";"MT";"SANTA CRUZ DO XINGU";16;1;8;25
2017;"SANTA RITA DO TRIVELATO (MT)";"MT";"SANTA RITA DO TRIVELATO";92;2;16;110
2017;"SANTA TEREZINHA (MT)";"MT";"SANTA TEREZINHA";14;2;18;34
2017;"SANTO AFONSO (MT)";"MT";"SANTO AFONSO";32;3;13;48
2017;"SANTO ANTONIO DO LESTE (MT)";"MT";"SANTO ANTONIO DO LESTE";72;7;21;100
2017;"SANTO ANTONIO DO LEVERGER (MT)";"MT";"SANTO ANTONIO DO LEVERGER";150;12;15;177
2017;"SAO FELIX DO ARAGUAIA (MT)";"MT";"SAO FELIX DO ARAGUAIA";61;20;27;108
2017;"SAO JOSE DO POVO (MT)";"MT";"SAO JOSE DO POVO";22;2;5;29
2017;"SAO JOSE DO RIO CLARO (MT)";"MT";"SAO JOSE DO RIO CLARO";384;16;59;459
2017;"SAO JOSE DO XINGU (MT)";"MT";"SAO JOSE DO XINGU";36;2;14;52
2017;"SAO JOSE DOS QUATRO MARCOS (MT)";"MT";"SAO JOSE DOS QUATRO MARCOS";514;14;75;603
2017;"SAO PEDRO DA CIPA (MT)";"MT";"SAO PEDRO DA CIPA";27;8;26;61
2017;"SAPEZAL (MT)";"MT";"SAPEZAL";622;47;120;789
2017;"SERRA NOVA DOURADA (MT)";"MT";"SERRA NOVA DOURADA";7;2;2;11
2017;"SINOP (MT)";"MT";"SINOP";3799;139;222;4160
2017;"SORRISO (MT)";"MT";"SORRISO";2554;93;216;2863
2017;"TABAPORA (MT)";"MT";"TABAPORA";189;3;29;221
2017;"TANGARA DA SERRA (MT)";"MT";"TANGARA DA SERRA";2205;96;237;2538
2017;"TAPURAH (MT)";"MT";"TAPURAH";392;6;41;439
2017;"TERRA NOVA DO NORTE (MT)";"MT";"TERRA NOVA DO NORTE";309;11;37;357
2017;"TESOURO (MT)";"MT";"TESOURO";20;5;5;30
2017;"TORIXOREU (MT)";"MT";"TORIXOREU";44;6;5;55
2017;"UNIAO DO SUL (MT)";"MT";"UNIAO DO SUL";112;2;10;124
2017;"VALE DE SAO DOMINGOS (MT)";"MT";"VALE DE SAO DOMINGOS";28;0;15;43
2017;"VARZEA GRANDE (MT)";"MT";"VARZEA GRANDE";5266;363;665;6294
2017;"VERA (MT)";"MT";"VERA";294;3;31;328
2017;"VILA BELA DA SANTISSIMA TRINDA (MT)";"MT";"VILA BELA DA SANTISSIMA TRINDA";159;5;52;216
2017;"VILA RICA (MT)";"MT";"VILA RICA";368;3;43;414
2017;"ABAETETUBA (PA)";"PA";"ABAETETUBA";383;25;277;685
2017;"ABEL FIGUEIREDO (PA)";"PA";"ABEL FIGUEIREDO";73;6;4;83
2017;"ACARA (PA)";"PA";"ACARA";102;13;95;210
2017;"AFUA (PA)";"PA";"AFUA";1;0;0;1
2017;"AGUA AZUL DO NORTE (PA)";"PA";"AGUA AZUL DO NORTE";106;11;34;151
2017;"ALENQUER (PA)";"PA";"ALENQUER";213;6;84;303
2017;"ALMEIRIM (PA)";"PA";"ALMEIRIM";249;23;100;372
2017;"ALTAMIRA (PA)";"PA";"ALTAMIRA";2121;195;531;2847
2017;"ANAJAS (PA)";"PA";"ANAJAS";0;1;1;2
2017;"ANANINDEUA (PA)";"PA";"ANANINDEUA";4555;382;1583;6520
2017;"ANAPU (PA)";"PA";"ANAPU";177;19;19;215
2017;"AUGUSTO CORREA (PA)";"PA";"AUGUSTO CORREA";56;3;73;132
2017;"AURORA DO PARA (PA)";"PA";"AURORA DO PARA";99;11;79;189
2017;"AVEIRO (PA)";"PA";"AVEIRO";5;0;6;11
2017;"BAGRE (PA)";"PA";"BAGRE";1;0;2;3
2017;"BAIAO (PA)";"PA";"BAIAO";63;6;29;98
2017;"BANNACH (PA)";"PA";"BANNACH";22;0;4;26
2017;"BARCARENA (PA)";"PA";"BARCARENA";1106;174;799;2079
2017;"BELEM (PA)";"PA";"BELEM";8953;2120;3796;14869
2017;"BELTERRA (PA)";"PA";"BELTERRA";73;14;70;157
2017;"BENEVIDES (PA)";"PA";"BENEVIDES";1015;69;164;1248
2017;"BOM JESUS DO TOCANTINS (PA)";"PA";"BOM JESUS DO TOCANTINS";89;10;9;108
2017;"BONITO (PA)";"PA";"BONITO";48;4;62;114
2017;"BRAGANCA (PA)";"PA";"BRAGANCA";467;41;205;713
2017;"BRASIL NOVO (PA)";"PA";"BRASIL NOVO";206;13;17;236
2017;"BREJO GRANDE DO ARAGUAIA (PA)";"PA";"BREJO GRANDE DO ARAGUAIA";32;4;9;45
2017;"BREU BRANCO (PA)";"PA";"BREU BRANCO";323;14;126;463
2017;"BREVES (PA)";"PA";"BREVES";73;3;10;86
2017;"BUJARU (PA)";"PA";"BUJARU";50;10;37;97
2017;"CACHOEIRA DO ARARI (PA)";"PA";"CACHOEIRA DO ARARI";17;2;19;38
2017;"CACHOEIRA DO PIRIA (PA)";"PA";"CACHOEIRA DO PIRIA";42;5;33;80
2017;"CAMETA (PA)";"PA";"CAMETA";166;11;77;254
2017;"CANAA DOS CARAJAS (PA)";"PA";"CANAA DOS CARAJAS";447;94;243;784
2017;"CAPANEMA (PA)";"PA";"CAPANEMA";814;31;118;963
2017;"CAPITAO POCO (PA)";"PA";"CAPITAO POCO";461;22;118;601
2017;"CASTANHAL (PA)";"PA";"CASTANHAL";2973;170;464;3607
2017;"CHAVES (PA)";"PA";"CHAVES";1;0;0;1
2017;"COLARES (PA)";"PA";"COLARES";8;0;4;12
2017;"CONCEICAO DO ARAGUAIA (PA)";"PA";"CONCEICAO DO ARAGUAIA";469;49;111;629
2017;"CONCORDIA DO PARA (PA)";"PA";"CONCORDIA DO PARA";180;12;80;272
2017;"CUMARU DO NORTE (PA)";"PA";"CUMARU DO NORTE";28;1;11;40
2017;"CURIONOPOLIS (PA)";"PA";"CURIONOPOLIS";225;116;22;363
2017;"CURRALINHO (PA)";"PA";"CURRALINHO";2;0;2;4
2017;"CURUA (PA)";"PA";"CURUA";10;1;4;15
2017;"CURUCA (PA)";"PA";"CURUCA";58;14;22;94
2017;"DOM ELISEU (PA)";"PA";"DOM ELISEU";594;66;57;717
2017;"ELDORADO DOS CARAJAS (PA)";"PA";"ELDORADO DOS CARAJAS";216;54;28;298
2017;"FARO (PA)";"PA";"FARO";3;1;1;5
2017;"FLORESTA DO ARAGUAIA (PA)";"PA";"FLORESTA DO ARAGUAIA";215;1;29;245
2017;"GARRAFAO DO NORTE (PA)";"PA";"GARRAFAO DO NORTE";131;9;25;165
2017;"GOIANESIA DO PARA (PA)";"PA";"GOIANESIA DO PARA";319;23;45;387
2017;"GURUPA (PA)";"PA";"GURUPA";11;0;3;14
2017;"IGARAPE ACU (PA)";"PA";"IGARAPE ACU";217;77;109;403
2017;"IGARAPE MIRI (PA)";"PA";"IGARAPE MIRI";105;26;47;178
2017;"INHANGAPI (PA)";"PA";"INHANGAPI";43;3;30;76
2017;"IPIXUNA DO PARA (PA)";"PA";"IPIXUNA DO PARA";94;10;51;155
2017;"IRITUIA (PA)";"PA";"IRITUIA";105;7;64;176
2017;"ITAITUBA (PA)";"PA";"ITAITUBA";1278;45;159;1482
2017;"ITUPIRANGA (PA)";"PA";"ITUPIRANGA";244;96;47;387
2017;"JACAREACANGA (PA)";"PA";"JACAREACANGA";39;2;1;42
2017;"JACUNDA (PA)";"PA";"JACUNDA";647;24;58;729
2017;"JURUTI (PA)";"PA";"JURUTI";106;12;16;134
2017;"LIMOEIRO DO AJURU (PA)";"PA";"LIMOEIRO DO AJURU";3;0;5;8
2017;"MAE DO RIO (PA)";"PA";"MAE DO RIO";378;36;88;502
2017;"MAGALHAES BARATA (PA)";"PA";"MAGALHAES BARATA";12;8;11;31
2017;"MARABA (PA)";"PA";"MARABA";3745;293;749;4787
2017;"MARACANA (PA)";"PA";"MARACANA";32;12;34;78
2017;"MARAPANIM (PA)";"PA";"MARAPANIM";42;12;37;91
2017;"MARITUBA (PA)";"PA";"MARITUBA";981;99;558;1638
2017;"MEDICILANDIA (PA)";"PA";"MEDICILANDIA";227;9;41;277
2017;"MELGACO (PA)";"PA";"MELGACO";8;1;4;13
2017;"MOCAJUBA (PA)";"PA";"MOCAJUBA";21;3;13;37
2017;"MOJU (PA)";"PA";"MOJU";254;24;267;545
2017;"MOJUI DOS CAMPOS (PA)";"PA";"MOJUI DOS CAMPOS";64;1;39;104
2017;"MONTE ALEGRE (PA)";"PA";"MONTE ALEGRE";337;13;196;546
2017;"MUANA (PA)";"PA";"MUANA";6;3;12;21
2017;"NOVA ESPERANCA DO PIRIA (PA)";"PA";"NOVA ESPERANCA DO PIRIA";98;8;26;132
2017;"NOVA IPIXUNA (PA)";"PA";"NOVA IPIXUNA";171;1;28;200
2017;"NOVA TIMBOTEUA (PA)";"PA";"NOVA TIMBOTEUA";80;7;26;113
2017;"NOVO PROGRESSO (PA)";"PA";"NOVO PROGRESSO";874;12;47;933
2017;"NOVO REPARTIMENTO (PA)";"PA";"NOVO REPARTIMENTO";531;38;63;632
2017;"OBIDOS (PA)";"PA";"OBIDOS";215;6;70;291
2017;"OEIRAS DO PARA (PA)";"PA";"OEIRAS DO PARA";10;1;12;23
2017;"ORIXIMINA (PA)";"PA";"ORIXIMINA";357;14;40;411
2017;"OUREM (PA)";"PA";"OUREM";178;5;20;203
2017;"OURILANDIA DO NORTE (PA)";"PA";"OURILANDIA DO NORTE";347;13;53;413
2017;"PACAJA (PA)";"PA";"PACAJA";163;30;14;207
2017;"PALESTINA DO PARA (PA)";"PA";"PALESTINA DO PARA";30;5;6;41
2017;"PARAGOMINAS (PA)";"PA";"PARAGOMINAS";1775;95;222;2092
2017;"PARAUAPEBAS (PA)";"PA";"PARAUAPEBAS";2526;600;1257;4383
2017;"PAU D ARCO (PA)";"PA";"PAU D ARCO";27;13;9;49
2017;"PEIXE BOI (PA)";"PA";"PEIXE BOI";29;6;17;52
2017;"PICARRA (PA)";"PA";"PICARRA";39;0;8;47
2017;"PLACAS (PA)";"PA";"PLACAS";118;7;5;130
2017;"PONTA DE PEDRAS (PA)";"PA";"PONTA DE PEDRAS";22;2;6;30
2017;"PORTEL (PA)";"PA";"PORTEL";22;2;11;35
2017;"PORTO DE MOZ (PA)";"PA";"PORTO DE MOZ";28;1;7;36
2017;"PRAINHA (PA)";"PA";"PRAINHA";41;1;5;47
2017;"PRIMAVERA (PA)";"PA";"PRIMAVERA";36;4;27;67
2017;"QUATIPURU (PA)";"PA";"QUATIPURU";15;6;16;37
2017;"REDENCAO (PA)";"PA";"REDENCAO";1892;100;199;2191
2017;"RIO MARIA (PA)";"PA";"RIO MARIA";346;32;58;436
2017;"RONDON DO PARA (PA)";"PA";"RONDON DO PARA";539;47;28;614
2017;"RUROPOLIS (PA)";"PA";"RUROPOLIS";247;13;27;287
2017;"SALINOPOLIS (PA)";"PA";"SALINOPOLIS";366;55;159;580
2017;"SALVATERRA (PA)";"PA";"SALVATERRA";54;36;31;121
2017;"SANTA BARBARA DO PARA (PA)";"PA";"SANTA BARBARA DO PARA";77;23;110;210
2017;"SANTA CRUZ DO ARARI (PA)";"PA";"SANTA CRUZ DO ARARI";5;1;1;7
2017;"SANTA ISABEL DO PARA (PA)";"PA";"SANTA ISABEL DO PARA";759;56;167;982
2017;"SANTA LUZIA DO PARA (PA)";"PA";"SANTA LUZIA DO PARA";126;13;42;181
2017;"SANTA MARIA DAS BARREIRAS (PA)";"PA";"SANTA MARIA DAS BARREIRAS";116;5;44;165
2017;"SANTA MARIA DO PARA (PA)";"PA";"SANTA MARIA DO PARA";371;22;60;453
2017;"SANTANA DO ARAGUAIA (PA)";"PA";"SANTANA DO ARAGUAIA";325;15;50;390
2017;"SANTAREM (PA)";"PA";"SANTAREM";3213;153;884;4250
2017;"SANTAREM NOVO (PA)";"PA";"SANTAREM NOVO";11;3;17;31
2017;"SANTO ANTONIO DO TAUA (PA)";"PA";"SANTO ANTONIO DO TAUA";163;24;106;293
2017;"SAO CAETANO DE ODIVELAS (PA)";"PA";"SAO CAETANO DE ODIVELAS";28;1;15;44
2017;"SAO DOMINGOS DO ARAGUAIA (PA)";"PA";"SAO DOMINGOS DO ARAGUAIA";191;25;31;247
2017;"SAO DOMINGOS DO CAPIM (PA)";"PA";"SAO DOMINGOS DO CAPIM";46;0;34;80
2017;"SAO FELIX DO XINGU (PA)";"PA";"SAO FELIX DO XINGU";399;9;45;453
2017;"SAO FRANCISCO DO PARA (PA)";"PA";"SAO FRANCISCO DO PARA";58;34;26;118
2017;"SAO GERALDO DO ARAGUAIA (PA)";"PA";"SAO GERALDO DO ARAGUAIA";150;9;21;180
2017;"SAO JOAO DA PONTA (PA)";"PA";"SAO JOAO DA PONTA";4;2;9;15
2017;"SAO JOAO DE PIRABAS (PA)";"PA";"SAO JOAO DE PIRABAS";37;9;31;77
2017;"SAO JOAO DO ARAGUAIA (PA)";"PA";"SAO JOAO DO ARAGUAIA";30;13;13;56
2017;"SAO MIGUEL DO GUAMA (PA)";"PA";"SAO MIGUEL DO GUAMA";496;23;137;656
2017;"SAO SEBASTIAO DA BOA VISTA (PA)";"PA";"SAO SEBASTIAO DA BOA VISTA";5;0;1;6
2017;"SAPUCAIA (PA)";"PA";"SAPUCAIA";52;4;13;69
2017;"SENADOR JOSE PORFIRIO (PA)";"PA";"SENADOR JOSE PORFIRIO";41;3;10;54
2017;"SOURE (PA)";"PA";"SOURE";38;4;17;59
2017;"TAILANDIA (PA)";"PA";"TAILANDIA";834;36;222;1092
2017;"TERRA ALTA (PA)";"PA";"TERRA ALTA";25;17;17;59
2017;"TERRA SANTA (PA)";"PA";"TERRA SANTA";30;0;3;33
2017;"TOME ACU (PA)";"PA";"TOME ACU";583;18;168;769
2017;"TRACUATEUA (PA)";"PA";"TRACUATEUA";57;5;53;115
2017;"TRAIRAO (PA)";"PA";"TRAIRAO";161;2;16;179
2017;"TUCUMA (PA)";"PA";"TUCUMA";728;21;103;852
2017;"TUCURUI (PA)";"PA";"TUCURUI";973;92;247;1312
2017;"ULIANOPOLIS (PA)";"PA";"ULIANOPOLIS";229;28;53;310
2017;"URUARA (PA)";"PA";"URUARA";549;20;36;605
2017;"VIGIA (PA)";"PA";"VIGIA";154;20;88;262
2017;"VISEU (PA)";"PA";"VISEU";95;7;55;157
2017;"VITORIA DO XINGU (PA)";"PA";"VITORIA DO XINGU";52;31;23;106
2017;"XINGUARA (PA)";"PA";"XINGUARA";1140;26;118;1284
2017;"AGUA BRANCA (PB)";"PB";"AGUA BRANCA";18;14;6;38
2017;"AGUIAR (PB)";"PB";"AGUIAR";13;8;3;24
2017;"ALAGOA GRANDE (PB)";"PB";"ALAGOA GRANDE";126;37;47;210
2017;"ALAGOA NOVA (PB)";"PB";"ALAGOA NOVA";172;37;13;222
2017;"ALAGOINHA (PB)";"PB";"ALAGOINHA";44;20;38;102
2017;"ALCANTIL (PB)";"PB";"ALCANTIL";78;14;15;107
2017;"ALGODAO DE JANDAIRA (PB)";"PB";"ALGODAO DE JANDAIRA";33;0;6;39
2017;"ALHANDRA (PB)";"PB";"ALHANDRA";185;25;47;257
2017;"AMPARO (PB)";"PB";"AMPARO";12;10;5;27
2017;"APARECIDA (PB)";"PB";"APARECIDA";43;6;18;67
2017;"ARACAGI (PB)";"PB";"ARACAGI";86;3;60;149
2017;"ARARA (PB)";"PB";"ARARA";92;6;20;118
2017;"ARARUNA (PB)";"PB";"ARARUNA";90;46;17;153
2017;"AREIA (PB)";"PB";"AREIA";126;41;30;197
2017;"AREIA DE BARAUNAS (PB)";"PB";"AREIA DE BARAUNAS";7;4;2;13
2017;"AREIAL (PB)";"PB";"AREIAL";53;13;9;75
2017;"AROEIRAS (PB)";"PB";"AROEIRAS";100;73;21;194
2017;"ASSUNCAO (PB)";"PB";"ASSUNCAO";34;5;5;44
2017;"BAIA DA TRAICAO (PB)";"PB";"BAIA DA TRAICAO";16;9;15;40
2017;"BANANEIRAS (PB)";"PB";"BANANEIRAS";122;35;32;189
2017;"BARAUNA (PB)";"PB";"BARAUNA";30;2;7;39
2017;"BARRA DE SANTA ROSA (PB)";"PB";"BARRA DE SANTA ROSA";110;8;19;137
2017;"BARRA DE SANTANA (PB)";"PB";"BARRA DE SANTANA";96;7;17;120
2017;"BARRA DE SAO MIGUEL (PB)";"PB";"BARRA DE SAO MIGUEL";15;4;5;24
2017;"BAYEUX (PB)";"PB";"BAYEUX";751;50;223;1024
2017;"BELEM (PB)";"PB";"BELEM";140;11;14;165
2017;"BELEM DO BREJO DO CRUZ (PB)";"PB";"BELEM DO BREJO DO CRUZ";17;9;4;30
2017;"BERNARDINO BATISTA (PB)";"PB";"BERNARDINO BATISTA";6;2;5;13
2017;"BOA VENTURA (PB)";"PB";"BOA VENTURA";15;3;2;20
2017;"BOA VISTA (PB)";"PB";"BOA VISTA";111;8;24;143
2017;"BOM JESUS (PB)";"PB";"BOM JESUS";12;0;4;16
2017;"BOM SUCESSO (PB)";"PB";"BOM SUCESSO";13;4;8;25
2017;"BONITO DE SANTA FE (PB)";"PB";"BONITO DE SANTA FE";35;15;3;53
2017;"BOQUEIRAO (PB)";"PB";"BOQUEIRAO";231;14;27;272
2017;"BORBOREMA (PB)";"PB";"BORBOREMA";45;7;3;55
2017;"BREJO DO CRUZ (PB)";"PB";"BREJO DO CRUZ";68;12;7;87
2017;"BREJO DOS SANTOS (PB)";"PB";"BREJO DOS SANTOS";30;4;4;38
2017;"CAAPORA (PB)";"PB";"CAAPORA";59;11;14;84
2017;"CABACEIRAS (PB)";"PB";"CABACEIRAS";27;6;19;52
2017;"CABEDELO (PB)";"PB";"CABEDELO";530;45;38;613
2017;"CACHOEIRA DOS INDIOS (PB)";"PB";"CACHOEIRA DOS INDIOS";22;6;9;37
2017;"CACIMBA DE AREIA (PB)";"PB";"CACIMBA DE AREIA";6;4;5;15
2017;"CACIMBA DE DENTRO (PB)";"PB";"CACIMBA DE DENTRO";86;15;35;136
2017;"CACIMBAS (PB)";"PB";"CACIMBAS";7;13;5;25
2017;"CAICARA (PB)";"PB";"CAICARA";21;4;5;30
2017;"CAJAZEIRAS (PB)";"PB";"CAJAZEIRAS";460;55;69;584
2017;"CAJAZEIRINHAS (PB)";"PB";"CAJAZEIRINHAS";5;0;3;8
2017;"CALDAS BRANDAO (PB)";"PB";"CALDAS BRANDAO";43;4;9;56
2017;"CAMALAU (PB)";"PB";"CAMALAU";34;9;16;59
2017;"CAMPINA GRANDE (PB)";"PB";"CAMPINA GRANDE";4425;359;859;5643
2017;"CAPIM (PB)";"PB";"CAPIM";38;12;17;67
2017;"CARAUBAS (PB)";"PB";"CARAUBAS";15;12;4;31
2017;"CARRAPATEIRA (PB)";"PB";"CARRAPATEIRA";6;0;3;9
2017;"CASSERENGUE (PB)";"PB";"CASSERENGUE";45;10;18;73
2017;"CATINGUEIRA (PB)";"PB";"CATINGUEIRA";18;4;2;24
2017;"CATOLE DO ROCHA (PB)";"PB";"CATOLE DO ROCHA";250;54;16;320
2017;"CATURITE (PB)";"PB";"CATURITE";119;18;15;152
2017;"CONCEICAO (PB)";"PB";"CONCEICAO";103;34;10;147
2017;"CONDADO (PB)";"PB";"CONDADO";40;8;9;57
2017;"CONDE (PB)";"PB";"CONDE";131;27;19;177
2017;"CONGO (PB)";"PB";"CONGO";25;9;7;41
2017;"COREMAS (PB)";"PB";"COREMAS";73;27;11;111
2017;"COXIXOLA (PB)";"PB";"COXIXOLA";4;9;0;13
2017;"CRUZ DO ESPIRITO SANTO (PB)";"PB";"CRUZ DO ESPIRITO SANTO";31;7;27;65
2017;"CUBATI (PB)";"PB";"CUBATI";42;8;6;56
2017;"CUITE (PB)";"PB";"CUITE";96;9;19;124
2017;"CUITE DE MAMANGUAPE (PB)";"PB";"CUITE DE MAMANGUAPE";19;10;33;62
2017;"CUITEGI (PB)";"PB";"CUITEGI";26;4;3;33
2017;"CURRAL DE CIMA (PB)";"PB";"CURRAL DE CIMA";16;5;24;45
2017;"CURRAL VELHO (PB)";"PB";"CURRAL VELHO";8;4;2;14
2017;"DAMIAO (PB)";"PB";"DAMIAO";40;7;9;56
2017;"DESTERRO (PB)";"PB";"DESTERRO";26;16;7;49
2017;"DIAMANTE (PB)";"PB";"DIAMANTE";19;5;5;29
2017;"DONA INES (PB)";"PB";"DONA INES";51;13;23;87
2017;"DUAS ESTRADAS (PB)";"PB";"DUAS ESTRADAS";13;5;4;22
2017;"EMAS (PB)";"PB";"EMAS";10;7;4;21
2017;"ESPERANCA (PB)";"PB";"ESPERANCA";554;30;97;681
2017;"FAGUNDES (PB)";"PB";"FAGUNDES";46;12;29;87
2017;"FREI MARTINHO (PB)";"PB";"FREI MARTINHO";11;1;6;18
2017;"GADO BRAVO (PB)";"PB";"GADO BRAVO";50;30;20;100
2017;"GUARABIRA (PB)";"PB";"GUARABIRA";564;80;196;840
2017;"GURINHEM (PB)";"PB";"GURINHEM";49;10;26;85
2017;"GURJAO (PB)";"PB";"GURJAO";23;2;6;31
2017;"IBIARA (PB)";"PB";"IBIARA";13;4;4;21
2017;"IGARACY (PB)";"PB";"IGARACY";21;10;5;36
2017;"IMACULADA (PB)";"PB";"IMACULADA";16;11;5;32
2017;"INGA (PB)";"PB";"INGA";133;12;37;182
2017;"ITABAIANA (PB)";"PB";"ITABAIANA";152;15;42;209
2017;"ITAPORANGA (PB)";"PB";"ITAPORANGA";151;43;26;220
2017;"ITAPOROROCA (PB)";"PB";"ITAPOROROCA";132;4;36;172
2017;"ITATUBA (PB)";"PB";"ITATUBA";41;4;16;61
2017;"JACARAU (PB)";"PB";"JACARAU";76;6;23;105
2017;"JERICO (PB)";"PB";"JERICO";32;6;3;41
2017;"JOAO PESSOA (PB)";"PB";"JOAO PESSOA";6054;1122;2478;9654
2017;"JUAREZ TAVORA (PB)";"PB";"JUAREZ TAVORA";30;6;14;50
2017;"JUAZEIRINHO (PB)";"PB";"JUAZEIRINHO";87;19;15;121
2017;"JUNCO DO SERIDO (PB)";"PB";"JUNCO DO SERIDO";64;3;5;72
2017;"JURIPIRANGA (PB)";"PB";"JURIPIRANGA";49;4;22;75
2017;"JURU (PB)";"PB";"JURU";16;7;3;26
2017;"LAGOA (PB)";"PB";"LAGOA";17;4;6;27
2017;"LAGOA DE DENTRO (PB)";"PB";"LAGOA DE DENTRO";46;8;16;70
2017;"LAGOA SECA (PB)";"PB";"LAGOA SECA";266;50;18;334
2017;"LASTRO (PB)";"PB";"LASTRO";7;5;4;16
2017;"LIVRAMENTO (PB)";"PB";"LIVRAMENTO";42;5;6;53
2017;"LOGRADOURO (PB)";"PB";"LOGRADOURO";6;3;9;18
2017;"LUCENA (PB)";"PB";"LUCENA";29;4;20;53
2017;"MAE D AGUA (PB)";"PB";"MAE D AGUA";5;1;4;10
2017;"MALTA (PB)";"PB";"MALTA";14;6;3;23
2017;"MAMANGUAPE (PB)";"PB";"MAMANGUAPE";458;23;107;588
2017;"MANAIRA (PB)";"PB";"MANAIRA";24;15;3;42
2017;"MARCACAO (PB)";"PB";"MARCACAO";6;5;17;28
2017;"MARI (PB)";"PB";"MARI";116;9;54;179
2017;"MARIZOPOLIS (PB)";"PB";"MARIZOPOLIS";45;5;2;52
2017;"MASSARANDUBA (PB)";"PB";"MASSARANDUBA";47;31;12;90
2017;"MATARACA (PB)";"PB";"MATARACA";49;5;17;71
2017;"MATINHAS (PB)";"PB";"MATINHAS";15;4;4;23
2017;"MATO GROSSO (PB)";"PB";"MATO GROSSO";11;3;3;17
2017;"MATUREIA (PB)";"PB";"MATUREIA";20;34;7;61
2017;"MOGEIRO (PB)";"PB";"MOGEIRO";37;6;8;51
2017;"MONTADAS (PB)";"PB";"MONTADAS";56;7;8;71
2017;"MONTE HOREBE (PB)";"PB";"MONTE HOREBE";8;3;5;16
2017;"MONTEIRO (PB)";"PB";"MONTEIRO";309;81;65;455
2017;"MULUNGU (PB)";"PB";"MULUNGU";54;7;20;81
2017;"NATUBA (PB)";"PB";"NATUBA";30;7;6;43
2017;"NAZAREZINHO (PB)";"PB";"NAZAREZINHO";30;9;4;43
2017;"NOVA FLORESTA (PB)";"PB";"NOVA FLORESTA";41;7;11;59
2017;"NOVA OLINDA (PB)";"PB";"NOVA OLINDA";24;7;6;37
2017;"NOVA PALMEIRA (PB)";"PB";"NOVA PALMEIRA";30;1;4;35
2017;"OLHO D AGUA (PB)";"PB";"OLHO D AGUA";11;6;5;22
2017;"OLIVEDOS (PB)";"PB";"OLIVEDOS";41;3;10;54
2017;"OURO VELHO (PB)";"PB";"OURO VELHO";15;9;6;30
2017;"PARARI (PB)";"PB";"PARARI";8;3;2;13
2017;"PASSAGEM (PB)";"PB";"PASSAGEM";18;1;2;21
2017;"PATOS (PB)";"PB";"PATOS";723;158;61;942
2017;"PAULISTA (PB)";"PB";"PAULISTA";66;11;13;90
2017;"PEDRA BRANCA (PB)";"PB";"PEDRA BRANCA";12;7;5;24
2017;"PEDRA LAVRADA (PB)";"PB";"PEDRA LAVRADA";49;5;11;65
2017;"PEDRAS DE FOGO (PB)";"PB";"PEDRAS DE FOGO";304;39;96;439
2017;"PEDRO REGIS (PB)";"PB";"PEDRO REGIS";18;1;4;23
2017;"PIANCO (PB)";"PB";"PIANCO";97;17;7;121
2017;"PICUI (PB)";"PB";"PICUI";140;13;52;205
2017;"PILAR (PB)";"PB";"PILAR";33;3;13;49
2017;"PILOES (PB)";"PB";"PILOES";35;2;12;49
2017;"PILOEZINHOS (PB)";"PB";"PILOEZINHOS";14;3;6;23
2017;"PIRPIRITUBA (PB)";"PB";"PIRPIRITUBA";43;0;13;56
2017;"PITIMBU (PB)";"PB";"PITIMBU";40;31;10;81
2017;"POCINHOS (PB)";"PB";"POCINHOS";151;27;32;210
2017;"POCO DANTAS (PB)";"PB";"POCO DANTAS";8;1;5;14
2017;"POCO DE JOSE DE MOURA (PB)";"PB";"POCO DE JOSE DE MOURA";8;5;6;19
2017;"POMBAL (PB)";"PB";"POMBAL";348;67;19;434
2017;"PRATA (PB)";"PB";"PRATA";30;12;5;47
2017;"PRINCESA ISABEL (PB)";"PB";"PRINCESA ISABEL";123;107;22;252
2017;"PUXINANA (PB)";"PB";"PUXINANA";85;37;15;137
2017;"QUEIMADAS (PB)";"PB";"QUEIMADAS";520;111;95;726
2017;"QUIXABA (PB)";"PB";"QUIXABA";9;1;4;14
2017;"REMIGIO (PB)";"PB";"REMIGIO";321;9;31;361
2017;"RIACHAO (PB)";"PB";"RIACHAO";8;2;5;15
2017;"RIACHAO DO BACAMARTE (PB)";"PB";"RIACHAO DO BACAMARTE";26;3;5;34
2017;"RIACHAO DO POCO (PB)";"PB";"RIACHAO DO POCO";23;0;14;37
2017;"RIACHO DE SANTO ANTONIO (PB)";"PB";"RIACHO DE SANTO ANTONIO";16;5;3;24
2017;"RIACHO DOS CAVALOS (PB)";"PB";"RIACHO DOS CAVALOS";33;3;6;42
2017;"RIO TINTO (PB)";"PB";"RIO TINTO";105;14;51;170
2017;"SALGADINHO (PB)";"PB";"SALGADINHO";6;4;5;15
2017;"SALGADO DE SAO FELIX (PB)";"PB";"SALGADO DE SAO FELIX";28;5;12;45
2017;"SANTA CECILIA (PB)";"PB";"SANTA CECILIA";44;12;14;70
2017;"SANTA CRUZ (PB)";"PB";"SANTA CRUZ";16;3;14;33
2017;"SANTA HELENA (PB)";"PB";"SANTA HELENA";13;5;12;30
2017;"SANTA INES (PB)";"PB";"SANTA INES";13;3;3;19
2017;"SANTA LUZIA (PB)";"PB";"SANTA LUZIA";162;18;17;197
2017;"SANTA RITA (PB)";"PB";"SANTA RITA";903;100;300;1303
2017;"SANTA TERESINHA (PB)";"PB";"SANTA TERESINHA";30;4;5;39
2017;"SANTANA DE MANGUEIRA (PB)";"PB";"SANTANA DE MANGUEIRA";5;1;3;9
2017;"SANTANA DOS GARROTES (PB)";"PB";"SANTANA DOS GARROTES";21;13;4;38
2017;"SANTAREM (PB)";"PB";"SANTAREM";6;2;4;12
2017;"SANTO ANDRE (PB)";"PB";"SANTO ANDRE";19;5;23;47
2017;"SAO BENTINHO (PB)";"PB";"SAO BENTINHO";25;6;3;34
2017;"SAO BENTO (PB)";"PB";"SAO BENTO";231;30;23;284
2017;"SAO DOMINGOS DE POMBAL (PB)";"PB";"SAO DOMINGOS DE POMBAL";7;8;6;21
2017;"SAO DOMINGOS DO CARIRI (PB)";"PB";"SAO DOMINGOS DO CARIRI";9;4;4;17
2017;"SAO FRANCISCO (PB)";"PB";"SAO FRANCISCO";10;2;4;16
2017;"SAO JOAO DO CARIRI (PB)";"PB";"SAO JOAO DO CARIRI";33;5;10;48
2017;"SAO JOAO DO RIO DO PEIXE (PB)";"PB";"SAO JOAO DO RIO DO PEIXE";79;11;22;112
2017;"SAO JOAO DO TIGRE (PB)";"PB";"SAO JOAO DO TIGRE";16;5;5;26
2017;"SAO JOSE DA LAGOA TAPADA (PB)";"PB";"SAO JOSE DA LAGOA TAPADA";25;6;7;38
2017;"SAO JOSE DE CAIANA (PB)";"PB";"SAO JOSE DE CAIANA";10;7;7;24
2017;"SAO JOSE DE ESPINHARAS (PB)";"PB";"SAO JOSE DE ESPINHARAS";23;5;6;34
2017;"SAO JOSE DE PIRANHAS (PB)";"PB";"SAO JOSE DE PIRANHAS";53;19;10;82
2017;"SAO JOSE DE PRINCESA (PB)";"PB";"SAO JOSE DE PRINCESA";6;9;4;19
2017;"SAO JOSE DO BONFIM (PB)";"PB";"SAO JOSE DO BONFIM";10;3;3;16
2017;"SAO JOSE DO BREJO DO CRUZ (PB)";"PB";"SAO JOSE DO BREJO DO CRUZ";4;1;2;7
2017;"SAO JOSE DO SABUGI (PB)";"PB";"SAO JOSE DO SABUGI";25;1;6;32
2017;"SAO JOSE DOS CORDEIROS (PB)";"PB";"SAO JOSE DOS CORDEIROS";17;8;3;28
2017;"SAO JOSE DOS RAMOS (PB)";"PB";"SAO JOSE DOS RAMOS";21;1;10;32
2017;"SAO MAMEDE (PB)";"PB";"SAO MAMEDE";31;3;5;39
2017;"SAO MIGUEL DE TAIPU (PB)";"PB";"SAO MIGUEL DE TAIPU";28;0;8;36
2017;"SAO SEBASTIAO DE LAGOA DE ROCA (PB)";"PB";"SAO SEBASTIAO DE LAGOA DE ROCA";111;28;16;155
2017;"SAO SEBASTIAO DO UMBUZEIRO (PB)";"PB";"SAO SEBASTIAO DO UMBUZEIRO";13;2;4;19
2017;"SAO VICENTE DO SERIDO (PB)";"PB";"SAO VICENTE DO SERIDO";38;9;12;59
2017;"SAPE (PB)";"PB";"SAPE";397;37;116;550
2017;"SERRA BRANCA (PB)";"PB";"SERRA BRANCA";110;22;9;141
2017;"SERRA DA RAIZ (PB)";"PB";"SERRA DA RAIZ";9;1;6;16
2017;"SERRA GRANDE (PB)";"PB";"SERRA GRANDE";7;2;4;13
2017;"SERRA REDONDA (PB)";"PB";"SERRA REDONDA";27;12;4;43
2017;"SERRARIA (PB)";"PB";"SERRARIA";19;9;8;36
2017;"SERTAOZINHO (PB)";"PB";"SERTAOZINHO";12;4;13;29
2017;"SOBRADO (PB)";"PB";"SOBRADO";78;4;7;89
2017;"SOLANEA (PB)";"PB";"SOLANEA";263;40;40;343
2017;"SOLEDADE (PB)";"PB";"SOLEDADE";193;26;27;246
2017;"SOSSEGO (PB)";"PB";"SOSSEGO";32;5;6;43
2017;"SOUSA (PB)";"PB";"SOUSA";919;56;79;1054
2017;"SUME (PB)";"PB";"SUME";130;30;22;182
2017;"TACIMA (PB)";"PB";"TACIMA";41;7;19;67
2017;"TAPEROA (PB)";"PB";"TAPEROA";97;22;8;127
2017;"TAVARES (PB)";"PB";"TAVARES";27;15;12;54
2017;"TEIXEIRA (PB)";"PB";"TEIXEIRA";110;21;20;151
2017;"TENORIO (PB)";"PB";"TENORIO";16;1;4;21
2017;"TRIUNFO (PB)";"PB";"TRIUNFO";24;3;6;33
2017;"UIRAUNA (PB)";"PB";"UIRAUNA";83;15;5;103
2017;"UMBUZEIRO (PB)";"PB";"UMBUZEIRO";70;26;27;123
2017;"VARZEA (PB)";"PB";"VARZEA";16;5;5;26
2017;"VIEIROPOLIS (PB)";"PB";"VIEIROPOLIS";11;5;11;27
2017;"VISTA SERRANA (PB)";"PB";"VISTA SERRANA";16;1;5;22
2017;"ZABELE (PB)";"PB";"ZABELE";18;6;8;32
2017;"ABREU E LIMA (PE)";"PE";"ABREU E LIMA";575;88;383;1046
2017;"AFOGADOS DA INGAZEIRA (PE)";"PE";"AFOGADOS DA INGAZEIRA";510;107;94;711
2017;"AFRANIO (PE)";"PE";"AFRANIO";231;32;26;289
2017;"AGRESTINA (PE)";"PE";"AGRESTINA";208;51;25;284
2017;"AGUA PRETA (PE)";"PE";"AGUA PRETA";169;69;75;313
2017;"AGUAS BELAS (PE)";"PE";"AGUAS BELAS";367;80;53;500
2017;"ALAGOINHA (PE)";"PE";"ALAGOINHA";155;55;19;229
2017;"ALIANCA (PE)";"PE";"ALIANCA";177;28;140;345
2017;"ALTINHO (PE)";"PE";"ALTINHO";105;69;37;211
2017;"AMARAJI (PE)";"PE";"AMARAJI";123;34;50;207
2017;"ANGELIM (PE)";"PE";"ANGELIM";52;36;7;95
2017;"ARACOIABA (PE)";"PE";"ARACOIABA";85;17;96;198
2017;"ARARIPINA (PE)";"PE";"ARARIPINA";1138;81;84;1303
2017;"ARCOVERDE (PE)";"PE";"ARCOVERDE";1257;218;130;1605
2017;"BARRA DE GUABIRABA (PE)";"PE";"BARRA DE GUABIRABA";71;21;15;107
2017;"BARREIROS (PE)";"PE";"BARREIROS";284;33;84;401
2017;"BELEM DE MARIA (PE)";"PE";"BELEM DE MARIA";87;41;18;146
2017;"BELEM DE SAO FRANCISCO (PE)";"PE";"BELEM DE SAO FRANCISCO";117;39;22;178
2017;"BELO JARDIM (PE)";"PE";"BELO JARDIM";898;428;98;1424
2017;"BETANIA (PE)";"PE";"BETANIA";54;11;10;75
2017;"BEZERROS (PE)";"PE";"BEZERROS";882;167;110;1159
2017;"BODOCO (PE)";"PE";"BODOCO";254;9;23;286
2017;"BOM CONSELHO (PE)";"PE";"BOM CONSELHO";330;66;47;443
2017;"BOM JARDIM (PE)";"PE";"BOM JARDIM";288;338;56;682
2017;"BONITO (PE)";"PE";"BONITO";412;93;42;547
2017;"BREJAO (PE)";"PE";"BREJAO";72;22;16;110
2017;"BREJINHO (PE)";"PE";"BREJINHO";58;17;9;84
2017;"BREJO DA MADRE DE DEUS (PE)";"PE";"BREJO DA MADRE DE DEUS";389;485;19;893
2017;"BUENOS AIRES (PE)";"PE";"BUENOS AIRES";63;12;20;95
2017;"BUIQUE (PE)";"PE";"BUIQUE";288;106;50;444
2017;"CABO DE SANTO AGOSTINHO (PE)";"PE";"CABO DE SANTO AGOSTINHO";1498;266;516;2280
2017;"CABROBO (PE)";"PE";"CABROBO";270;21;31;322
2017;"CACHOEIRINHA (PE)";"PE";"CACHOEIRINHA";226;79;16;321
2017;"CAETES (PE)";"PE";"CAETES";315;68;41;424
2017;"CALCADO (PE)";"PE";"CALCADO";70;14;26;110
2017;"CALUMBI (PE)";"PE";"CALUMBI";54;6;7;67
2017;"CAMARAGIBE (PE)";"PE";"CAMARAGIBE";758;220;187;1165
2017;"CAMOCIM DE SAO FELIX (PE)";"PE";"CAMOCIM DE SAO FELIX";145;60;13;218
2017;"CAMUTANGA (PE)";"PE";"CAMUTANGA";100;3;14;117
2017;"CANHOTINHO (PE)";"PE";"CANHOTINHO";234;99;17;350
2017;"CAPOEIRAS (PE)";"PE";"CAPOEIRAS";287;64;27;378
2017;"CARNAIBA (PE)";"PE";"CARNAIBA";164;60;27;251
2017;"CARNAUBEIRA DA PENHA (PE)";"PE";"CARNAUBEIRA DA PENHA";44;14;7;65
2017;"CARPINA (PE)";"PE";"CARPINA";978;133;174;1285
2017;"CARUARU (PE)";"PE";"CARUARU";4821;910;706;6437
2017;"CASINHAS (PE)";"PE";"CASINHAS";81;144;20;245
2017;"CATENDE (PE)";"PE";"CATENDE";200;74;75;349
2017;"CEDRO (PE)";"PE";"CEDRO";44;6;14;64
2017;"CHA DE ALEGRIA (PE)";"PE";"CHA DE ALEGRIA";53;22;38;113
2017;"CHA GRANDE (PE)";"PE";"CHA GRANDE";328;67;34;429
2017;"CONDADO (PE)";"PE";"CONDADO";140;20;63;223
2017;"CORRENTES (PE)";"PE";"CORRENTES";85;49;12;146
2017;"CORTES (PE)";"PE";"CORTES";180;57;38;275
2017;"CUMARU (PE)";"PE";"CUMARU";170;111;19;300
2017;"CUPIRA (PE)";"PE";"CUPIRA";290;101;20;411
2017;"CUSTODIA (PE)";"PE";"CUSTODIA";381;96;41;518
2017;"DORMENTES (PE)";"PE";"DORMENTES";326;15;36;377
2017;"ESCADA (PE)";"PE";"ESCADA";381;90;152;623
2017;"EXU (PE)";"PE";"EXU";327;12;31;370
2017;"FEIRA NOVA (PE)";"PE";"FEIRA NOVA";256;54;20;330
2017;"FERNANDO DE NORONHA (PE)";"PE";"FERNANDO DE NORONHA";14;24;7;45
2017;"FERREIROS (PE)";"PE";"FERREIROS";86;1;50;137
2017;"FLORES (PE)";"PE";"FLORES";128;50;19;197
2017;"FLORESTA (PE)";"PE";"FLORESTA";504;31;28;563
2017;"FREI MIGUELINHO (PE)";"PE";"FREI MIGUELINHO";235;144;23;402
2017;"GAMELEIRA (PE)";"PE";"GAMELEIRA";91;17;61;169
2017;"GARANHUNS (PE)";"PE";"GARANHUNS";1787;318;173;2278
2017;"GLORIA DO GOITA (PE)";"PE";"GLORIA DO GOITA";209;69;46;324
2017;"GOIANA (PE)";"PE";"GOIANA";793;222;155;1170
2017;"GRANITO (PE)";"PE";"GRANITO";37;1;13;51
2017;"GRAVATA (PE)";"PE";"GRAVATA";1041;145;93;1279
2017;"IATI (PE)";"PE";"IATI";100;41;30;171
2017;"IBIMIRIM (PE)";"PE";"IBIMIRIM";214;56;22;292
2017;"IBIRAJUBA (PE)";"PE";"IBIRAJUBA";54;15;8;77
2017;"IGARASSU (PE)";"PE";"IGARASSU";946;125;635;1706
2017;"IGUARACI (PE)";"PE";"IGUARACI";140;29;33;202
2017;"ILHA DE ITAMARACA (PE)";"PE";"ILHA DE ITAMARACA";90;14;16;120
2017;"INAJA (PE)";"PE";"INAJA";72;13;14;99
2017;"INGAZEIRA (PE)";"PE";"INGAZEIRA";38;13;6;57
2017;"IPOJUCA (PE)";"PE";"IPOJUCA";741;334;317;1392
2017;"IPUBI (PE)";"PE";"IPUBI";279;16;36;331
2017;"ITACURUBA (PE)";"PE";"ITACURUBA";31;2;7;40
2017;"ITAIBA (PE)";"PE";"ITAIBA";164;40;22;226
2017;"ITAMBE (PE)";"PE";"ITAMBE";420;47;148;615
2017;"ITAPETIM (PE)";"PE";"ITAPETIM";85;6;11;102
2017;"ITAPISSUMA (PE)";"PE";"ITAPISSUMA";123;34;30;187
2017;"ITAQUITINGA (PE)";"PE";"ITAQUITINGA";43;16;47;106
2017;"JABOATAO DOS GUARARAPES (PE)";"PE";"JABOATAO DOS GUARARAPES";5578;779;2145;8502
2017;"JAQUEIRA (PE)";"PE";"JAQUEIRA";61;10;29;100
2017;"JATAUBA (PE)";"PE";"JATAUBA";171;217;16;404
2017;"JATOBA (PE)";"PE";"JATOBA";56;25;16;97
2017;"JOAO ALFREDO (PE)";"PE";"JOAO ALFREDO";228;634;26;888
2017;"JOAQUIM NABUCO (PE)";"PE";"JOAQUIM NABUCO";80;18;57;155
2017;"JUCATI (PE)";"PE";"JUCATI";127;30;29;186
2017;"JUPI (PE)";"PE";"JUPI";233;44;49;326
2017;"JUREMA (PE)";"PE";"JUREMA";86;44;17;147
2017;"LAGOA DO CARRO (PE)";"PE";"LAGOA DO CARRO";109;15;21;145
2017;"LAGOA DO ITAENGA (PE)";"PE";"LAGOA DO ITAENGA";414;46;63;523
2017;"LAGOA DO OURO (PE)";"PE";"LAGOA DO OURO";46;31;16;93
2017;"LAGOA DOS GATOS (PE)";"PE";"LAGOA DOS GATOS";109;42;9;160
2017;"LAGOA GRANDE (PE)";"PE";"LAGOA GRANDE";168;9;18;195
2017;"LAJEDO (PE)";"PE";"LAJEDO";608;109;60;777
2017;"LIMOEIRO (PE)";"PE";"LIMOEIRO";537;151;79;767
2017;"MACAPARANA (PE)";"PE";"MACAPARANA";208;18;59;285
2017;"MACHADOS (PE)";"PE";"MACHADOS";184;42;19;245
2017;"MANARI (PE)";"PE";"MANARI";63;19;11;93
2017;"MARAIAL (PE)";"PE";"MARAIAL";125;19;26;170
2017;"MIRANDIBA (PE)";"PE";"MIRANDIBA";128;5;9;142
2017;"MOREILANDIA (PE)";"PE";"MOREILANDIA";70;5;10;85
2017;"MORENO (PE)";"PE";"MORENO";710;157;138;1005
2017;"NAZARE DA MATA (PE)";"PE";"NAZARE DA MATA";244;30;63;337
2017;"OLINDA (PE)";"PE";"OLINDA";3118;453;1350;4921
2017;"OROBO (PE)";"PE";"OROBO";218;222;80;520
2017;"OROCO (PE)";"PE";"OROCO";90;2;14;106
2017;"OURICURI (PE)";"PE";"OURICURI";712;43;112;867
2017;"PALMARES (PE)";"PE";"PALMARES";518;115;222;855
2017;"PALMEIRINA (PE)";"PE";"PALMEIRINA";25;20;7;52
2017;"PANELAS (PE)";"PE";"PANELAS";109;74;25;208
2017;"PARANATAMA (PE)";"PE";"PARANATAMA";144;42;22;208
2017;"PARNAMIRIM (PE)";"PE";"PARNAMIRIM";311;7;24;342
2017;"PASSIRA (PE)";"PE";"PASSIRA";296;153;33;482
2017;"PAUDALHO (PE)";"PE";"PAUDALHO";604;46;84;734
2017;"PAULISTA (PE)";"PE";"PAULISTA";1613;357;332;2302
2017;"PEDRA (PE)";"PE";"PEDRA";180;66;25;271
2017;"PESQUEIRA (PE)";"PE";"PESQUEIRA";811;147;146;1104
2017;"PETROLANDIA (PE)";"PE";"PETROLANDIA";335;16;66;417
2017;"PETROLINA (PE)";"PE";"PETROLINA";4394;281;580;5255
2017;"POCAO (PE)";"PE";"POCAO";67;41;13;121
2017;"POMBOS (PE)";"PE";"POMBOS";503;65;53;621
2017;"PRIMAVERA (PE)";"PE";"PRIMAVERA";96;14;39;149
2017;"QUIPAPA (PE)";"PE";"QUIPAPA";101;34;44;179
2017;"QUIXABA (PE)";"PE";"QUIXABA";49;30;12;91
2017;"RECIFE (PE)";"PE";"RECIFE";19277;2480;3918;25675
2017;"RIACHO DAS ALMAS (PE)";"PE";"RIACHO DAS ALMAS";373;110;30;513
2017;"RIBEIRAO (PE)";"PE";"RIBEIRAO";261;47;112;420
2017;"RIO FORMOSO (PE)";"PE";"RIO FORMOSO";116;41;89;246
2017;"SAIRE (PE)";"PE";"SAIRE";104;13;20;137
2017;"SALGADINHO (PE)";"PE";"SALGADINHO";21;57;5;83
2017;"SALGUEIRO (PE)";"PE";"SALGUEIRO";562;57;73;692
2017;"SALOA (PE)";"PE";"SALOA";71;39;14;124
2017;"SANHARO (PE)";"PE";"SANHARO";163;36;43;242
2017;"SANTA CRUZ (PE)";"PE";"SANTA CRUZ";191;10;29;230
2017;"SANTA CRUZ DA BAIXA VERDE (PE)";"PE";"SANTA CRUZ DA BAIXA VERDE";215;13;10;238
2017;"SANTA CRUZ DO CAPIBARIBE (PE)";"PE";"SANTA CRUZ DO CAPIBARIBE";1024;421;68;1513
2017;"SANTA FILOMENA (PE)";"PE";"SANTA FILOMENA";153;8;32;193
2017;"SANTA MARIA DA BOA VISTA (PE)";"PE";"SANTA MARIA DA BOA VISTA";281;17;75;373
2017;"SANTA MARIA DO CAMBUCA (PE)";"PE";"SANTA MARIA DO CAMBUCA";210;120;29;359
2017;"SANTA TEREZINHA (PE)";"PE";"SANTA TEREZINHA";85;17;8;110
2017;"SAO BENEDITO DO SUL (PE)";"PE";"SAO BENEDITO DO SUL";31;15;17;63
2017;"SAO BENTO DO UNA (PE)";"PE";"SAO BENTO DO UNA";1024;92;105;1221
2017;"SAO CAITANO (PE)";"PE";"SAO CAITANO";391;272;40;703
2017;"SAO JOAO (PE)";"PE";"SAO JOAO";127;60;25;212
2017;"SAO JOAQUIM DO MONTE (PE)";"PE";"SAO JOAQUIM DO MONTE";89;49;25;163
2017;"SAO JOSE DA COROA GRANDE (PE)";"PE";"SAO JOSE DA COROA GRANDE";70;18;37;125
2017;"SAO JOSE DO BELMONTE (PE)";"PE";"SAO JOSE DO BELMONTE";339;38;45;422
2017;"SAO JOSE DO EGITO (PE)";"PE";"SAO JOSE DO EGITO";530;56;81;667
2017;"SAO LOURENCO DA MATA (PE)";"PE";"SAO LOURENCO DA MATA";453;104;505;1062
2017;"SAO VICENTE FERRER (PE)";"PE";"SAO VICENTE FERRER";200;14;21;235
2017;"SERRA TALHADA (PE)";"PE";"SERRA TALHADA";1600;126;86;1812
2017;"SERRITA (PE)";"PE";"SERRITA";111;7;16;134
2017;"SERTANIA (PE)";"PE";"SERTANIA";496;86;62;644
2017;"SIRINHAEM (PE)";"PE";"SIRINHAEM";226;33;95;354
2017;"SOLIDAO (PE)";"PE";"SOLIDAO";25;7;8;40
2017;"SURUBIM (PE)";"PE";"SURUBIM";891;724;105;1720
2017;"TABIRA (PE)";"PE";"TABIRA";301;52;49;402
2017;"TACAIMBO (PE)";"PE";"TACAIMBO";115;44;19;178
2017;"TACARATU (PE)";"PE";"TACARATU";70;46;13;129
2017;"TAMANDARE (PE)";"PE";"TAMANDARE";78;34;29;141
2017;"TAQUARITINGA DO NORTE (PE)";"PE";"TAQUARITINGA DO NORTE";345;98;48;491
2017;"TEREZINHA (PE)";"PE";"TEREZINHA";30;11;11;52
2017;"TERRA NOVA (PE)";"PE";"TERRA NOVA";73;1;12;86
2017;"TIMBAUBA (PE)";"PE";"TIMBAUBA";667;39;116;822
2017;"TORITAMA (PE)";"PE";"TORITAMA";325;85;34;444
2017;"TRACUNHAEM (PE)";"PE";"TRACUNHAEM";51;24;19;94
2017;"TRINDADE (PE)";"PE";"TRINDADE";389;42;21;452
2017;"TRIUNFO (PE)";"PE";"TRIUNFO";258;28;14;300
2017;"TUPANATINGA (PE)";"PE";"TUPANATINGA";154;56;36;246
2017;"TUPARETAMA (PE)";"PE";"TUPARETAMA";123;42;18;183
2017;"VENTUROSA (PE)";"PE";"VENTUROSA";196;49;13;258
2017;"VERDEJANTE (PE)";"PE";"VERDEJANTE";69;8;16;93
2017;"VERTENTE DO LERIO (PE)";"PE";"VERTENTE DO LERIO";93;119;17;229
2017;"VERTENTES (PE)";"PE";"VERTENTES";226;93;25;344
2017;"VICENCIA (PE)";"PE";"VICENCIA";295;18;86;399
2017;"VITORIA DE SANTO ANTAO (PE)";"PE";"VITORIA DE SANTO ANTAO";2398;171;360;2929
2017;"XEXEU (PE)";"PE";"XEXEU";78;17;41;136
2017;"ACAUA (PI)";"PI";"ACAUA";127;22;27;176
2017;"AGRICOLANDIA (PI)";"PI";"AGRICOLANDIA";18;3;8;29
2017;"AGUA BRANCA (PI)";"PI";"AGUA BRANCA";205;22;25;252
2017;"ALAGOINHA DO PIAUI (PI)";"PI";"ALAGOINHA DO PIAUI";68;4;5;77
2017;"ALEGRETE DO PIAUI (PI)";"PI";"ALEGRETE DO PIAUI";53;4;4;61
2017;"ALTO LONGA (PI)";"PI";"ALTO LONGA";54;12;28;94
2017;"ALTOS (PI)";"PI";"ALTOS";307;13;61;381
2017;"ALVORADA DO GURGUEIA (PI)";"PI";"ALVORADA DO GURGUEIA";24;3;10;37
2017;"AMARANTE (PI)";"PI";"AMARANTE";86;16;25;127
2017;"ANGICAL DO PIAUI (PI)";"PI";"ANGICAL DO PIAUI";27;4;8;39
2017;"ANISIO DE ABREU (PI)";"PI";"ANISIO DE ABREU";62;11;11;84
2017;"ANTONIO ALMEIDA (PI)";"PI";"ANTONIO ALMEIDA";30;4;6;40
2017;"AROAZES (PI)";"PI";"AROAZES";22;7;11;40
2017;"AROEIRAS DO ITAIM (PI)";"PI";"AROEIRAS DO ITAIM";15;0;13;28
2017;"ARRAIAL (PI)";"PI";"ARRAIAL";14;2;4;20
2017;"ASSUNCAO DO PIAUI (PI)";"PI";"ASSUNCAO DO PIAUI";12;0;3;15
2017;"AVELINO LOPES (PI)";"PI";"AVELINO LOPES";31;7;5;43
2017;"BAIXA GRANDE DO RIBEIRO (PI)";"PI";"BAIXA GRANDE DO RIBEIRO";114;2;19;135
2017;"BARRA D ALCANTARA (PI)";"PI";"BARRA D ALCANTARA";20;3;4;27
2017;"BARRAS (PI)";"PI";"BARRAS";160;18;96;274
2017;"BARREIRAS DO PIAUI (PI)";"PI";"BARREIRAS DO PIAUI";5;1;2;8
2017;"BARRO DURO (PI)";"PI";"BARRO DURO";51;6;6;63
2017;"BATALHA (PI)";"PI";"BATALHA";101;9;21;131
2017;"BELA VISTA DO PIAUI (PI)";"PI";"BELA VISTA DO PIAUI";17;1;7;25
2017;"BELEM DO PIAUI (PI)";"PI";"BELEM DO PIAUI";38;3;3;44
2017;"BENEDITINOS (PI)";"PI";"BENEDITINOS";43;2;15;60
2017;"BERTOLINIA (PI)";"PI";"BERTOLINIA";25;12;15;52
2017;"BETANIA DO PIAUI (PI)";"PI";"BETANIA DO PIAUI";76;13;6;95
2017;"BOA HORA (PI)";"PI";"BOA HORA";24;2;10;36
2017;"BOCAINA (PI)";"PI";"BOCAINA";13;10;4;27
2017;"BOM JESUS (PI)";"PI";"BOM JESUS";318;13;25;356
2017;"BOM PRINCIPIO DO PIAUI (PI)";"PI";"BOM PRINCIPIO DO PIAUI";13;4;11;28
2017;"BONFIM DO PIAUI (PI)";"PI";"BONFIM DO PIAUI";48;4;10;62
2017;"BOQUEIRAO DO PIAUI (PI)";"PI";"BOQUEIRAO DO PIAUI";19;1;4;24
2017;"BRASILEIRA (PI)";"PI";"BRASILEIRA";27;6;12;45
2017;"BREJO DO PIAUI (PI)";"PI";"BREJO DO PIAUI";11;5;3;19
2017;"BURITI DOS LOPES (PI)";"PI";"BURITI DOS LOPES";58;9;23;90
2017;"BURITI DOS MONTES (PI)";"PI";"BURITI DOS MONTES";16;8;5;29
2017;"CABECEIRAS DO PIAUI (PI)";"PI";"CABECEIRAS DO PIAUI";29;3;30;62
2017;"CAJAZEIRAS DO PIAUI (PI)";"PI";"CAJAZEIRAS DO PIAUI";6;0;3;9
2017;"CAJUEIRO DA PRAIA (PI)";"PI";"CAJUEIRO DA PRAIA";16;3;16;35
2017;"CALDEIRAO GRANDE DO PIAUI (PI)";"PI";"CALDEIRAO GRANDE DO PIAUI";44;21;17;82
2017;"CAMPINAS DO PIAUI (PI)";"PI";"CAMPINAS DO PIAUI";7;4;2;13
2017;"CAMPO ALEGRE DO FIDALGO (PI)";"PI";"CAMPO ALEGRE DO FIDALGO";42;6;2;50
2017;"CAMPO GRANDE DO PIAUI (PI)";"PI";"CAMPO GRANDE DO PIAUI";55;12;4;71
2017;"CAMPO LARGO DO PIAUI (PI)";"PI";"CAMPO LARGO DO PIAUI";11;2;5;18
2017;"CAMPO MAIOR (PI)";"PI";"CAMPO MAIOR";474;42;94;610
2017;"CANAVIEIRA (PI)";"PI";"CANAVIEIRA";3;1;1;5
2017;"CANTO DO BURITI (PI)";"PI";"CANTO DO BURITI";128;41;24;193
2017;"CAPITAO DE CAMPOS (PI)";"PI";"CAPITAO DE CAMPOS";47;6;14;67
2017;"CAPITAO GERVASIO OLIVEIRA (PI)";"PI";"CAPITAO GERVASIO OLIVEIRA";28;2;8;38
2017;"CARACOL (PI)";"PI";"CARACOL";73;5;7;85
2017;"CARAUBAS DO PIAUI (PI)";"PI";"CARAUBAS DO PIAUI";27;3;10;40
2017;"CARIDADE DO PIAUI (PI)";"PI";"CARIDADE DO PIAUI";24;1;8;33
2017;"CASTELO DO PIAUI (PI)";"PI";"CASTELO DO PIAUI";83;19;26;128
2017;"CAXINGO (PI)";"PI";"CAXINGO";16;4;8;28
2017;"COCAL (PI)";"PI";"COCAL";176;24;33;233
2017;"COCAL DE TELHA (PI)";"PI";"COCAL DE TELHA";10;5;4;19
2017;"COCAL DOS ALVES (PI)";"PI";"COCAL DOS ALVES";8;14;4;26
2017;"COIVARAS (PI)";"PI";"COIVARAS";13;1;7;21
2017;"COLONIA DO GURGUEIA (PI)";"PI";"COLONIA DO GURGUEIA";19;12;4;35
2017;"COLONIA DO PIAUI (PI)";"PI";"COLONIA DO PIAUI";19;8;9;36
2017;"CONCEICAO DO CANINDE (PI)";"PI";"CONCEICAO DO CANINDE";14;3;5;22
2017;"CORONEL JOSE DIAS (PI)";"PI";"CORONEL JOSE DIAS";17;9;6;32
2017;"CORRENTE (PI)";"PI";"CORRENTE";418;33;59;510
2017;"CRISTALANDIA DO PIAUI (PI)";"PI";"CRISTALANDIA DO PIAUI";22;6;4;32
2017;"CRISTINO CASTRO (PI)";"PI";"CRISTINO CASTRO";48;6;17;71
2017;"CURIMATA (PI)";"PI";"CURIMATA";61;1;9;71
2017;"CURRAIS (PI)";"PI";"CURRAIS";6;2;2;10
2017;"CURRAL NOVO DO PIAUI (PI)";"PI";"CURRAL NOVO DO PIAUI";21;4;3;28
2017;"CURRALINHOS (PI)";"PI";"CURRALINHOS";6;0;2;8
2017;"DEMERVAL LOBAO (PI)";"PI";"DEMERVAL LOBAO";87;3;38;128
2017;"DIRCEU ARCOVERDE (PI)";"PI";"DIRCEU ARCOVERDE";84;11;6;101
2017;"DOM EXPEDITO LOPES (PI)";"PI";"DOM EXPEDITO LOPES";75;9;6;90
2017;"DOM INOCENCIO (PI)";"PI";"DOM INOCENCIO";92;20;14;126
2017;"DOMINGOS MOURAO (PI)";"PI";"DOMINGOS MOURAO";4;1;5;10
2017;"ELESBAO VELOSO (PI)";"PI";"ELESBAO VELOSO";78;9;11;98
2017;"ELISEU MARTINS (PI)";"PI";"ELISEU MARTINS";14;3;3;20
2017;"ESPERANTINA (PI)";"PI";"ESPERANTINA";255;24;63;342
2017;"FARTURA DO PIAUI (PI)";"PI";"FARTURA DO PIAUI";26;11;4;41
2017;"FLORES DO PIAUI (PI)";"PI";"FLORES DO PIAUI";16;6;3;25
2017;"FLORESTA DO PIAUI (PI)";"PI";"FLORESTA DO PIAUI";12;5;5;22
2017;"FLORIANO (PI)";"PI";"FLORIANO";1188;117;80;1385
2017;"FRANCINOPOLIS (PI)";"PI";"FRANCINOPOLIS";20;12;2;34
2017;"FRANCISCO AYRES (PI)";"PI";"FRANCISCO AYRES";9;12;7;28
2017;"FRANCISCO MACEDO (PI)";"PI";"FRANCISCO MACEDO";37;11;8;56
2017;"FRANCISCO SANTOS (PI)";"PI";"FRANCISCO SANTOS";85;12;9;106
2017;"FRONTEIRAS (PI)";"PI";"FRONTEIRAS";137;22;13;172
2017;"GEMINIANO (PI)";"PI";"GEMINIANO";41;12;11;64
2017;"GILBUES (PI)";"PI";"GILBUES";16;6;11;33
2017;"GUADALUPE (PI)";"PI";"GUADALUPE";94;13;9;116
2017;"GUARIBAS (PI)";"PI";"GUARIBAS";12;1;5;18
2017;"HUGO NAPOLEAO (PI)";"PI";"HUGO NAPOLEAO";10;0;2;12
2017;"ILHA GRANDE (PI)";"PI";"ILHA GRANDE";16;6;9;31
2017;"INHUMA (PI)";"PI";"INHUMA";117;9;19;145
2017;"IPIRANGA DO PIAUI (PI)";"PI";"IPIRANGA DO PIAUI";66;15;10;91
2017;"ISAIAS COELHO (PI)";"PI";"ISAIAS COELHO";20;1;8;29
2017;"ITAINOPOLIS (PI)";"PI";"ITAINOPOLIS";64;29;24;117
2017;"ITAUEIRA (PI)";"PI";"ITAUEIRA";77;11;6;94
2017;"JACOBINA DO PIAUI (PI)";"PI";"JACOBINA DO PIAUI";75;7;1;83
2017;"JAICOS (PI)";"PI";"JAICOS";151;15;13;179
2017;"JARDIM DO MULATO (PI)";"PI";"JARDIM DO MULATO";11;1;3;15
2017;"JATOBA DO PIAUI (PI)";"PI";"JATOBA DO PIAUI";38;1;12;51
2017;"JERUMENHA (PI)";"PI";"JERUMENHA";23;2;1;26
2017;"JOAO COSTA (PI)";"PI";"JOAO COSTA";7;0;3;10
2017;"JOAQUIM PIRES (PI)";"PI";"JOAQUIM PIRES";44;5;13;62
2017;"JOCA MARQUES (PI)";"PI";"JOCA MARQUES";10;1;5;16
2017;"JOSE DE FREITAS (PI)";"PI";"JOSE DE FREITAS";144;15;78;237
2017;"JUAZEIRO DO PIAUI (PI)";"PI";"JUAZEIRO DO PIAUI";26;2;5;33
2017;"JULIO BORGES (PI)";"PI";"JULIO BORGES";13;6;5;24
2017;"JUREMA (PI)";"PI";"JUREMA";22;4;21;47
2017;"LAGOA ALEGRE (PI)";"PI";"LAGOA ALEGRE";15;3;25;43
2017;"LAGOA DE SAO FRANCISCO (PI)";"PI";"LAGOA DE SAO FRANCISCO";13;5;3;21
2017;"LAGOA DO BARRO DO PIAUI (PI)";"PI";"LAGOA DO BARRO DO PIAUI";30;7;10;47
2017;"LAGOA DO PIAUI (PI)";"PI";"LAGOA DO PIAUI";18;1;5;24
2017;"LAGOA DO SITIO (PI)";"PI";"LAGOA DO SITIO";16;4;4;24
2017;"LAGOINHA DO PIAUI (PI)";"PI";"LAGOINHA DO PIAUI";8;0;3;11
2017;"LANDRI SALES (PI)";"PI";"LANDRI SALES";24;5;1;30
2017;"LUIS CORREIA (PI)";"PI";"LUIS CORREIA";88;21;61;170
2017;"LUZILANDIA (PI)";"PI";"LUZILANDIA";115;21;37;173
2017;"MADEIRO (PI)";"PI";"MADEIRO";12;4;3;19
2017;"MANOEL EMIDIO (PI)";"PI";"MANOEL EMIDIO";17;2;6;25
2017;"MARCOLANDIA (PI)";"PI";"MARCOLANDIA";571;58;14;643
2017;"MARCOS PARENTE (PI)";"PI";"MARCOS PARENTE";13;2;3;18
2017;"MASSAPE DO PIAUI (PI)";"PI";"MASSAPE DO PIAUI";25;1;5;31
2017;"MATIAS OLIMPIO (PI)";"PI";"MATIAS OLIMPIO";37;7;8;52
2017;"MIGUEL ALVES (PI)";"PI";"MIGUEL ALVES";61;7;35;103
2017;"MIGUEL LEAO (PI)";"PI";"MIGUEL LEAO";7;0;1;8
2017;"MILTON BRANDAO (PI)";"PI";"MILTON BRANDAO";15;4;6;25
2017;"MONSENHOR GIL (PI)";"PI";"MONSENHOR GIL";37;5;8;50
2017;"MONSENHOR HIPOLITO (PI)";"PI";"MONSENHOR HIPOLITO";48;11;7;66
2017;"MONTE ALEGRE DO PIAUI (PI)";"PI";"MONTE ALEGRE DO PIAUI";21;3;10;34
2017;"MORRO CABECA NO TEMPO (PI)";"PI";"MORRO CABECA NO TEMPO";7;0;4;11
2017;"MORRO DO CHAPEU DO PIAUI (PI)";"PI";"MORRO DO CHAPEU DO PIAUI";6;3;13;22
2017;"MURICI DOS PORTELAS (PI)";"PI";"MURICI DOS PORTELAS";13;1;9;23
2017;"NAZARE DO PIAUI (PI)";"PI";"NAZARE DO PIAUI";24;17;4;45
2017;"NAZARIA (PI)";"PI";"NAZARIA";22;0;12;34
2017;"NOSSA SENHORA DE NAZARE (PI)";"PI";"NOSSA SENHORA DE NAZARE";17;6;15;38
2017;"NOSSA SENHORA DOS REMEDIOS (PI)";"PI";"NOSSA SENHORA DOS REMEDIOS";13;5;5;23
2017;"NOVA SANTA RITA (PI)";"PI";"NOVA SANTA RITA";3;6;4;13
2017;"NOVO ORIENTE DO PIAUI (PI)";"PI";"NOVO ORIENTE DO PIAUI";19;3;13;35
2017;"NOVO SANTO ANTONIO (PI)";"PI";"NOVO SANTO ANTONIO";15;1;5;21
2017;"OEIRAS (PI)";"PI";"OEIRAS";374;79;52;505
2017;"OLHO D AGUA DO PIAUI (PI)";"PI";"OLHO D AGUA DO PIAUI";7;1;3;11
2017;"PADRE MARCOS (PI)";"PI";"PADRE MARCOS";112;14;7;133
2017;"PAES LANDIM (PI)";"PI";"PAES LANDIM";9;7;2;18
2017;"PAJEU DO PIAUI (PI)";"PI";"PAJEU DO PIAUI";13;8;3;24
2017;"PALMEIRA DO PIAUI (PI)";"PI";"PALMEIRA DO PIAUI";43;3;6;52
2017;"PALMEIRAIS (PI)";"PI";"PALMEIRAIS";19;3;14;36
2017;"PAQUETA (PI)";"PI";"PAQUETA";23;5;7;35
2017;"PARNAGUA (PI)";"PI";"PARNAGUA";24;5;5;34
2017;"PARNAIBA (PI)";"PI";"PARNAIBA";1333;115;321;1769
2017;"PASSAGEM FRANCA DO PIAUI (PI)";"PI";"PASSAGEM FRANCA DO PIAUI";14;2;6;22
2017;"PATOS DO PIAUI (PI)";"PI";"PATOS DO PIAUI";25;4;9;38
2017;"PAU D ARCO DO PIAUI (PI)";"PI";"PAU D ARCO DO PIAUI";10;0;7;17
2017;"PAULISTANA (PI)";"PI";"PAULISTANA";449;73;86;608
2017;"PAVUSSU (PI)";"PI";"PAVUSSU";16;3;2;21
2017;"PEDRO II (PI)";"PI";"PEDRO II";149;50;27;226
2017;"PEDRO LAURENTINO (PI)";"PI";"PEDRO LAURENTINO";5;1;2;8
2017;"PICOS (PI)";"PI";"PICOS";1835;158;103;2096
2017;"PIMENTEIRAS (PI)";"PI";"PIMENTEIRAS";54;10;7;71
2017;"PIO IX (PI)";"PI";"PIO IX";128;15;20;163
2017;"PIRACURUCA (PI)";"PI";"PIRACURUCA";314;23;56;393
2017;"PIRIPIRI (PI)";"PI";"PIRIPIRI";421;73;171;665
2017;"PORTO (PI)";"PI";"PORTO";18;4;5;27
2017;"PORTO ALEGRE DO PIAUI (PI)";"PI";"PORTO ALEGRE DO PIAUI";12;4;2;18
2017;"PRATA DO PIAUI (PI)";"PI";"PRATA DO PIAUI";12;1;2;15
2017;"QUEIMADA NOVA (PI)";"PI";"QUEIMADA NOVA";109;8;33;150
2017;"REDENCAO DO GURGUEIA (PI)";"PI";"REDENCAO DO GURGUEIA";18;4;15;37
2017;"REGENERACAO (PI)";"PI";"REGENERACAO";100;12;17;129
2017;"RIACHO FRIO (PI)";"PI";"RIACHO FRIO";8;4;5;17
2017;"RIBEIRA DO PIAUI (PI)";"PI";"RIBEIRA DO PIAUI";11;2;2;15
2017;"RIBEIRO GONCALVES (PI)";"PI";"RIBEIRO GONCALVES";27;1;4;32
2017;"RIO GRANDE DO PIAUI (PI)";"PI";"RIO GRANDE DO PIAUI";27;9;7;43
2017;"SANTA CRUZ DO PIAUI (PI)";"PI";"SANTA CRUZ DO PIAUI";29;20;5;54
2017;"SANTA CRUZ DOS MILAGRES (PI)";"PI";"SANTA CRUZ DOS MILAGRES";9;1;3;13
2017;"SANTA FILOMENA (PI)";"PI";"SANTA FILOMENA";32;0;4;36
2017;"SANTA LUZ (PI)";"PI";"SANTA LUZ";16;1;5;22
2017;"SANTA ROSA DO PIAUI (PI)";"PI";"SANTA ROSA DO PIAUI";17;8;12;37
2017;"SANTANA DO PIAUI (PI)";"PI";"SANTANA DO PIAUI";31;12;18;61
2017;"SANTO ANTONIO DE LISBOA (PI)";"PI";"SANTO ANTONIO DE LISBOA";56;15;6;77
2017;"SANTO ANTONIO DOS MILAGRES (PI)";"PI";"SANTO ANTONIO DOS MILAGRES";3;3;2;8
2017;"SANTO INACIO DO PIAUI (PI)";"PI";"SANTO INACIO DO PIAUI";14;7;2;23
2017;"SAO BRAZ DO PIAUI (PI)";"PI";"SAO BRAZ DO PIAUI";36;5;5;46
2017;"SAO FELIX DO PIAUI (PI)";"PI";"SAO FELIX DO PIAUI";8;2;3;13
2017;"SAO FRANCISCO DE ASSIS DO PIAU (PI)";"PI";"SAO FRANCISCO DE ASSIS DO PIAU";24;8;5;37
2017;"SAO FRANCISCO DO PIAUI (PI)";"PI";"SAO FRANCISCO DO PIAUI";15;14;8;37
2017;"SAO GONCALO DO GURGUEIA (PI)";"PI";"SAO GONCALO DO GURGUEIA";5;1;1;7
2017;"SAO GONCALO DO PIAUI (PI)";"PI";"SAO GONCALO DO PIAUI";17;3;4;24
2017;"SAO JOAO DA CANABRAVA (PI)";"PI";"SAO JOAO DA CANABRAVA";21;12;6;39
2017;"SAO JOAO DA FRONTEIRA (PI)";"PI";"SAO JOAO DA FRONTEIRA";6;2;7;15
2017;"SAO JOAO DA SERRA (PI)";"PI";"SAO JOAO DA SERRA";24;0;4;28
2017;"SAO JOAO DA VARJOTA (PI)";"PI";"SAO JOAO DA VARJOTA";6;7;6;19
2017;"SAO JOAO DO ARRAIAL (PI)";"PI";"SAO JOAO DO ARRAIAL";15;4;9;28
2017;"SAO JOAO DO PIAUI (PI)";"PI";"SAO JOAO DO PIAUI";132;34;20;186
2017;"SAO JOSE DO DIVINO (PI)";"PI";"SAO JOSE DO DIVINO";29;4;5;38
2017;"SAO JOSE DO PEIXE (PI)";"PI";"SAO JOSE DO PEIXE";8;1;4;13
2017;"SAO JOSE DO PIAUI (PI)";"PI";"SAO JOSE DO PIAUI";37;11;10;58
2017;"SAO JULIAO (PI)";"PI";"SAO JULIAO";40;12;5;57
2017;"SAO LOURENCO DO PIAUI (PI)";"PI";"SAO LOURENCO DO PIAUI";12;5;7;24
2017;"SAO LUIS DO PIAUI (PI)";"PI";"SAO LUIS DO PIAUI";13;5;2;20
2017;"SAO MIGUEL DA BAIXA GRANDE (PI)";"PI";"SAO MIGUEL DA BAIXA GRANDE";11;3;4;18
2017;"SAO MIGUEL DO FIDALGO (PI)";"PI";"SAO MIGUEL DO FIDALGO";6;2;3;11
2017;"SAO MIGUEL DO TAPUIO (PI)";"PI";"SAO MIGUEL DO TAPUIO";45;6;23;74
2017;"SAO PEDRO DO PIAUI (PI)";"PI";"SAO PEDRO DO PIAUI";58;4;9;71
2017;"SAO RAIMUNDO NONATO (PI)";"PI";"SAO RAIMUNDO NONATO";755;180;123;1058
2017;"SEBASTIAO BARROS (PI)";"PI";"SEBASTIAO BARROS";9;2;3;14
2017;"SEBASTIAO LEAL (PI)";"PI";"SEBASTIAO LEAL";39;3;3;45
2017;"SIGEFREDO PACHECO (PI)";"PI";"SIGEFREDO PACHECO";47;10;11;68
2017;"SIMOES (PI)";"PI";"SIMOES";125;15;14;154
2017;"SIMPLICIO MENDES (PI)";"PI";"SIMPLICIO MENDES";79;19;12;110
2017;"SOCORRO DO PIAUI (PI)";"PI";"SOCORRO DO PIAUI";10;8;3;21
2017;"SUSSUAPARA (PI)";"PI";"SUSSUAPARA";54;23;7;84
2017;"TAMBORIL DO PIAUI (PI)";"PI";"TAMBORIL DO PIAUI";6;3;1;10
2017;"TANQUE DO PIAUI (PI)";"PI";"TANQUE DO PIAUI";14;3;4;21
2017;"TERESINA (PI)";"PI";"TERESINA";11501;1176;3589;16266
2017;"UNIAO (PI)";"PI";"UNIAO";177;51;72;300
2017;"URUCUI (PI)";"PI";"URUCUI";207;15;25;247
2017;"VALENCA DO PIAUI (PI)";"PI";"VALENCA DO PIAUI";184;40;36;260
2017;"VARZEA BRANCA (PI)";"PI";"VARZEA BRANCA";42;7;17;66
2017;"VARZEA GRANDE (PI)";"PI";"VARZEA GRANDE";16;4;3;23
2017;"VERA MENDES (PI)";"PI";"VERA MENDES";22;5;4;31
2017;"VILA NOVA DO PIAUI (PI)";"PI";"VILA NOVA DO PIAUI";24;8;5;37
2017;"WALL FERRAZ (PI)";"PI";"WALL FERRAZ";16;15;9;40
2017;"ABATIA (PR)";"PR";"ABATIA";165;7;48;220
2017;"ADRIANOPOLIS (PR)";"PR";"ADRIANOPOLIS";132;10;26;168
2017;"AGUDOS DO SUL (PR)";"PR";"AGUDOS DO SUL";464;17;36;517
2017;"ALMIRANTE TAMANDARE (PR)";"PR";"ALMIRANTE TAMANDARE";1659;106;255;2020
2017;"ALTAMIRA DO PARANA (PR)";"PR";"ALTAMIRA DO PARANA";55;6;15;76
2017;"ALTO PARAISO (PR)";"PR";"ALTO PARAISO";66;11;14;91
2017;"ALTO PARANA (PR)";"PR";"ALTO PARANA";329;20;106;455
2017;"ALTO PIQUIRI (PR)";"PR";"ALTO PIQUIRI";221;12;48;281
2017;"ALTONIA (PR)";"PR";"ALTONIA";513;34;56;603
2017;"ALVORADA DO SUL (PR)";"PR";"ALVORADA DO SUL";339;8;66;413
2017;"AMAPORA (PR)";"PR";"AMAPORA";80;5;49;134
2017;"AMPERE (PR)";"PR";"AMPERE";540;23;54;617
2017;"ANAHY (PR)";"PR";"ANAHY";113;2;10;125
2017;"ANDIRA (PR)";"PR";"ANDIRA";615;21;95;731
2017;"ANGULO (PR)";"PR";"ANGULO";92;7;13;112
2017;"ANTONINA (PR)";"PR";"ANTONINA";125;17;49;191
2017;"ANTONIO OLINTO (PR)";"PR";"ANTONIO OLINTO";229;8;41;278
2017;"APUCARANA (PR)";"PR";"APUCARANA";2652;398;337;3387
2017;"ARAPONGAS (PR)";"PR";"ARAPONGAS";3396;273;181;3850
2017;"ARAPOTI (PR)";"PR";"ARAPOTI";740;42;83;865
2017;"ARAPUA (PR)";"PR";"ARAPUA";123;6;27;156
2017;"ARARUNA (PR)";"PR";"ARARUNA";443;27;42;512
2017;"ARAUCARIA (PR)";"PR";"ARAUCARIA";3011;366;615;3992
2017;"ARIRANHA DO IVAI (PR)";"PR";"ARIRANHA DO IVAI";73;3;20;96
2017;"ASSAI (PR)";"PR";"ASSAI";504;31;49;584
2017;"ASSIS CHATEAUBRIAND (PR)";"PR";"ASSIS CHATEAUBRIAND";1317;66;82;1465
2017;"ASTORGA (PR)";"PR";"ASTORGA";759;48;106;913
2017;"ATALAIA (PR)";"PR";"ATALAIA";127;13;35;175
2017;"BALSA NOVA (PR)";"PR";"BALSA NOVA";427;32;152;611
2017;"BANDEIRANTES (PR)";"PR";"BANDEIRANTES";919;66;115;1100
2017;"BARBOSA FERRAZ (PR)";"PR";"BARBOSA FERRAZ";241;8;41;290
2017;"BARRA DO JACARE (PR)";"PR";"BARRA DO JACARE";61;7;15;83
2017;"BARRACAO (PR)";"PR";"BARRACAO";286;32;50;368
2017;"BELA VISTA DO CAROBA (PR)";"PR";"BELA VISTA DO CAROBA";78;5;24;107
2017;"BELA VISTA DO PARAISO (PR)";"PR";"BELA VISTA DO PARAISO";468;39;68;575
2017;"BITURUNA (PR)";"PR";"BITURUNA";537;33;200;770
2017;"BOA ESPERANCA (PR)";"PR";"BOA ESPERANCA";208;8;17;233
2017;"BOA ESPERANCA DO IGUACU (PR)";"PR";"BOA ESPERANCA DO IGUACU";80;4;17;101
2017;"BOA VENTURA DE SAO ROQUE (PR)";"PR";"BOA VENTURA DE SAO ROQUE";228;17;51;296
2017;"BOA VISTA DA APARECIDA (PR)";"PR";"BOA VISTA DA APARECIDA";188;18;33;239
2017;"BOCAIUVA DO SUL (PR)";"PR";"BOCAIUVA DO SUL";362;16;30;408
2017;"BOM JESUS DO SUL (PR)";"PR";"BOM JESUS DO SUL";45;8;15;68
2017;"BOM SUCESSO (PR)";"PR";"BOM SUCESSO";138;12;66;216
2017;"BOM SUCESSO DO SUL (PR)";"PR";"BOM SUCESSO DO SUL";142;7;12;161
2017;"BORRAZOPOLIS (PR)";"PR";"BORRAZOPOLIS";316;6;20;342
2017;"BRAGANEY (PR)";"PR";"BRAGANEY";209;7;26;242
2017;"BRASILANDIA DO SUL (PR)";"PR";"BRASILANDIA DO SUL";94;6;12;112
2017;"CAFEARA (PR)";"PR";"CAFEARA";54;7;18;79
2017;"CAFELANDIA (PR)";"PR";"CAFELANDIA";742;66;92;900
2017;"CAFEZAL DO SUL (PR)";"PR";"CAFEZAL DO SUL";101;6;30;137
2017;"CALIFORNIA (PR)";"PR";"CALIFORNIA";311;12;26;349
2017;"CAMBARA (PR)";"PR";"CAMBARA";869;50;101;1020
2017;"CAMBE (PR)";"PR";"CAMBE";2134;298;149;2581
2017;"CAMBIRA (PR)";"PR";"CAMBIRA";319;8;28;355
2017;"CAMPINA DA LAGOA (PR)";"PR";"CAMPINA DA LAGOA";507;28;53;588
2017;"CAMPINA DO SIMAO (PR)";"PR";"CAMPINA DO SIMAO";136;3;40;179
2017;"CAMPINA GRANDE DO SUL (PR)";"PR";"CAMPINA GRANDE DO SUL";886;92;83;1061
2017;"CAMPO BONITO (PR)";"PR";"CAMPO BONITO";124;9;19;152
2017;"CAMPO DO TENENTE (PR)";"PR";"CAMPO DO TENENTE";176;12;51;239
2017;"CAMPO LARGO (PR)";"PR";"CAMPO LARGO";2597;341;493;3431
2017;"CAMPO MAGRO (PR)";"PR";"CAMPO MAGRO";618;92;52;762
2017;"CAMPO MOURAO (PR)";"PR";"CAMPO MOURAO";2584;125;629;3338
2017;"CANDIDO DE ABREU (PR)";"PR";"CANDIDO DE ABREU";324;13;60;397
2017;"CANDOI (PR)";"PR";"CANDOI";487;15;129;631
2017;"CANTAGALO (PR)";"PR";"CANTAGALO";298;12;58;368
2017;"CAPANEMA (PR)";"PR";"CAPANEMA";538;20;87;645
2017;"CAPITAO LEONIDAS MARQUES (PR)";"PR";"CAPITAO LEONIDAS MARQUES";629;29;71;729
2017;"CARAMBEI (PR)";"PR";"CARAMBEI";748;77;78;903
2017;"CARLOPOLIS (PR)";"PR";"CARLOPOLIS";346;31;81;458
2017;"CASCAVEL (PR)";"PR";"CASCAVEL";8335;475;1044;9854
2017;"CASTRO (PR)";"PR";"CASTRO";2188;262;375;2825
2017;"CATANDUVAS (PR)";"PR";"CATANDUVAS";254;17;47;318
2017;"CENTENARIO DO SUL (PR)";"PR";"CENTENARIO DO SUL";170;34;83;287
2017;"CERRO AZUL (PR)";"PR";"CERRO AZUL";566;26;77;669
2017;"CEU AZUL (PR)";"PR";"CEU AZUL";404;17;57;478
2017;"CHOPINZINHO (PR)";"PR";"CHOPINZINHO";695;41;101;837
2017;"CIANORTE (PR)";"PR";"CIANORTE";1790;93;272;2155
2017;"CIDADE GAUCHA (PR)";"PR";"CIDADE GAUCHA";311;26;93;430
2017;"CLEVELANDIA (PR)";"PR";"CLEVELANDIA";643;46;59;748
2017;"COLOMBO (PR)";"PR";"COLOMBO";4408;369;575;5352
2017;"COLORADO (PR)";"PR";"COLORADO";640;56;183;879
2017;"CONGONHINHAS (PR)";"PR";"CONGONHINHAS";150;7;45;202
2017;"CONSELHEIRO MAIRINCK (PR)";"PR";"CONSELHEIRO MAIRINCK";60;5;13;78
2017;"CONTENDA (PR)";"PR";"CONTENDA";824;24;59;907
2017;"CORBELIA (PR)";"PR";"CORBELIA";853;25;78;956
2017;"CORNELIO PROCOPIO (PR)";"PR";"CORNELIO PROCOPIO";1136;129;156;1421
2017;"CORONEL DOMINGOS SOARES (PR)";"PR";"CORONEL DOMINGOS SOARES";192;11;34;237
2017;"CORONEL VIVIDA (PR)";"PR";"CORONEL VIVIDA";806;45;125;976
2017;"CORUMBATAI DO SUL (PR)";"PR";"CORUMBATAI DO SUL";80;4;28;112
2017;"CRUZ MACHADO (PR)";"PR";"CRUZ MACHADO";715;18;109;842
2017;"CRUZEIRO DO IGUACU (PR)";"PR";"CRUZEIRO DO IGUACU";107;6;25;138
2017;"CRUZEIRO DO OESTE (PR)";"PR";"CRUZEIRO DO OESTE";564;27;88;679
2017;"CRUZEIRO DO SUL (PR)";"PR";"CRUZEIRO DO SUL";97;9;25;131
2017;"CRUZMALTINA (PR)";"PR";"CRUZMALTINA";96;4;11;111
2017;"CURITIBA (PR)";"PR";"CURITIBA";38694;4013;6794;49501
2017;"CURIUVA (PR)";"PR";"CURIUVA";300;20;85;405
2017;"DIAMANTE D OESTE (PR)";"PR";"DIAMANTE D OESTE";84;10;36;130
2017;"DIAMANTE DO NORTE (PR)";"PR";"DIAMANTE DO NORTE";79;6;32;117
2017;"DIAMANTE DO SUL (PR)";"PR";"DIAMANTE DO SUL";45;5;15;65
2017;"DOIS VIZINHOS (PR)";"PR";"DOIS VIZINHOS";1301;118;140;1559
2017;"DOURADINA (PR)";"PR";"DOURADINA";397;12;25;434
2017;"DOUTOR CAMARGO (PR)";"PR";"DOUTOR CAMARGO";199;6;69;274
2017;"DOUTOR ULYSSES (PR)";"PR";"DOUTOR ULYSSES";77;8;29;114
2017;"ENEAS MARQUES (PR)";"PR";"ENEAS MARQUES";216;4;33;253
2017;"ENGENHEIRO BELTRAO (PR)";"PR";"ENGENHEIRO BELTRAO";538;19;106;663
2017;"ENTRE RIOS DO OESTE (PR)";"PR";"ENTRE RIOS DO OESTE";165;7;13;185
2017;"ESPERANCA NOVA (PR)";"PR";"ESPERANCA NOVA";32;5;7;44
2017;"ESPIGAO ALTO DO IGUACU (PR)";"PR";"ESPIGAO ALTO DO IGUACU";93;8;12;113
2017;"FAROL (PR)";"PR";"FAROL";110;2;15;127
2017;"FAXINAL (PR)";"PR";"FAXINAL";498;21;47;566
2017;"FAZENDA RIO GRANDE (PR)";"PR";"FAZENDA RIO GRANDE";1419;87;309;1815
2017;"FENIX (PR)";"PR";"FENIX";150;3;19;172
2017;"FERNANDES PINHEIRO (PR)";"PR";"FERNANDES PINHEIRO";133;8;29;170
2017;"FIGUEIRA (PR)";"PR";"FIGUEIRA";152;18;39;209
2017;"FLOR DA SERRA DO SUL (PR)";"PR";"FLOR DA SERRA DO SUL";116;4;31;151
2017;"FLORAI (PR)";"PR";"FLORAI";172;8;26;206
2017;"FLORESTA (PR)";"PR";"FLORESTA";293;22;37;352
2017;"FLORESTOPOLIS (PR)";"PR";"FLORESTOPOLIS";205;37;123;365
2017;"FLORIDA (PR)";"PR";"FLORIDA";82;7;24;113
2017;"FORMOSA DO OESTE (PR)";"PR";"FORMOSA DO OESTE";301;13;30;344
2017;"FOZ DO IGUACU (PR)";"PR";"FOZ DO IGUACU";3832;1205;1420;6457
2017;"FOZ DO JORDAO (PR)";"PR";"FOZ DO JORDAO";84;8;24;116
2017;"FRANCISCO ALVES (PR)";"PR";"FRANCISCO ALVES";192;7;32;231
2017;"FRANCISCO BELTRAO (PR)";"PR";"FRANCISCO BELTRAO";2383;193;277;2853
2017;"GENERAL CARNEIRO (PR)";"PR";"GENERAL CARNEIRO";488;40;91;619
2017;"GODOY MOREIRA (PR)";"PR";"GODOY MOREIRA";64;3;13;80
2017;"GOIOERE (PR)";"PR";"GOIOERE";672;50;61;783
2017;"GOIOXIM (PR)";"PR";"GOIOXIM";134;15;44;193
2017;"GRANDES RIOS (PR)";"PR";"GRANDES RIOS";123;11;21;155
2017;"GUAIRA (PR)";"PR";"GUAIRA";1160;45;571;1776
2017;"GUAIRACA (PR)";"PR";"GUAIRACA";152;12;37;201
2017;"GUAMIRANGA (PR)";"PR";"GUAMIRANGA";194;17;37;248
2017;"GUAPIRAMA (PR)";"PR";"GUAPIRAMA";132;5;26;163
2017;"GUAPOREMA (PR)";"PR";"GUAPOREMA";53;3;13;69
2017;"GUARACI (PR)";"PR";"GUARACI";123;6;39;168
2017;"GUARANIACU (PR)";"PR";"GUARANIACU";480;48;60;588
2017;"GUARAPUAVA (PR)";"PR";"GUARAPUAVA";4986;576;531;6093
2017;"GUARAQUECABA (PR)";"PR";"GUARAQUECABA";37;4;14;55
2017;"GUARATUBA (PR)";"PR";"GUARATUBA";498;46;66;610
2017;"HONORIO SERPA (PR)";"PR";"HONORIO SERPA";132;6;43;181
2017;"IBAITI (PR)";"PR";"IBAITI";634;53;180;867
2017;"IBEMA (PR)";"PR";"IBEMA";162;18;19;199
2017;"IBIPORA (PR)";"PR";"IBIPORA";1224;96;185;1505
2017;"ICARAIMA (PR)";"PR";"ICARAIMA";192;17;48;257
2017;"IGUARACU (PR)";"PR";"IGUARACU";111;9;14;134
2017;"IGUATU (PR)";"PR";"IGUATU";62;2;10;74
2017;"IMBAU (PR)";"PR";"IMBAU";244;25;40;309
2017;"IMBITUVA (PR)";"PR";"IMBITUVA";863;54;77;994
2017;"INACIO MARTINS (PR)";"PR";"INACIO MARTINS";298;33;53;384
2017;"INAJA (PR)";"PR";"INAJA";31;7;18;56
2017;"INDIANOPOLIS (PR)";"PR";"INDIANOPOLIS";192;6;15;213
2017;"IPIRANGA (PR)";"PR";"IPIRANGA";379;33;89;501
2017;"IPORA (PR)";"PR";"IPORA";433;15;46;494
2017;"IRACEMA DO OESTE (PR)";"PR";"IRACEMA DO OESTE";83;5;9;97
2017;"IRATI (PR)";"PR";"IRATI";1777;124;165;2066
2017;"IRETAMA (PR)";"PR";"IRETAMA";240;5;47;292
2017;"ITAGUAJE (PR)";"PR";"ITAGUAJE";77;10;29;116
2017;"ITAIPULANDIA (PR)";"PR";"ITAIPULANDIA";254;33;48;335
2017;"ITAMBARACA (PR)";"PR";"ITAMBARACA";200;14;35;249
2017;"ITAMBE (PR)";"PR";"ITAMBE";197;5;35;237
2017;"ITAPEJARA D OESTE (PR)";"PR";"ITAPEJARA D OESTE";389;17;48;454
2017;"ITAPERUCU (PR)";"PR";"ITAPERUCU";634;92;105;831
2017;"ITAUNA DO SUL (PR)";"PR";"ITAUNA DO SUL";56;6;13;75
2017;"IVAI (PR)";"PR";"IVAI";393;14;50;457
2017;"IVAIPORA (PR)";"PR";"IVAIPORA";1028;38;115;1181
2017;"IVATE (PR)";"PR";"IVATE";229;12;70;311
2017;"IVATUBA (PR)";"PR";"IVATUBA";65;4;11;80
2017;"JABOTI (PR)";"PR";"JABOTI";80;11;23;114
2017;"JACAREZINHO (PR)";"PR";"JACAREZINHO";627;137;158;922
2017;"JAGUAPITA (PR)";"PR";"JAGUAPITA";407;39;87;533
2017;"JAGUARIAIVA (PR)";"PR";"JAGUARIAIVA";823;81;140;1044
2017;"JANDAIA DO SUL (PR)";"PR";"JANDAIA DO SUL";692;54;69;815
2017;"JANIOPOLIS (PR)";"PR";"JANIOPOLIS";171;7;29;207
2017;"JAPIRA (PR)";"PR";"JAPIRA";63;4;21;88
2017;"JAPURA (PR)";"PR";"JAPURA";331;12;27;370
2017;"JARDIM ALEGRE (PR)";"PR";"JARDIM ALEGRE";292;11;48;351
2017;"JARDIM OLINDA (PR)";"PR";"JARDIM OLINDA";42;3;9;54
2017;"JATAIZINHO (PR)";"PR";"JATAIZINHO";391;30;30;451
2017;"JESUITAS (PR)";"PR";"JESUITAS";346;18;44;408
2017;"JOAQUIM TAVORA (PR)";"PR";"JOAQUIM TAVORA";288;21;37;346
2017;"JUNDIAI DO SUL (PR)";"PR";"JUNDIAI DO SUL";37;6;25;68
2017;"JURANDA (PR)";"PR";"JURANDA";340;7;14;361
2017;"JUSSARA (PR)";"PR";"JUSSARA";198;6;44;248
2017;"KALORE (PR)";"PR";"KALORE";174;16;24;214
2017;"LAPA (PR)";"PR";"LAPA";1377;142;210;1729
2017;"LARANJAL (PR)";"PR";"LARANJAL";76;8;25;109
2017;"LARANJEIRAS DO SUL (PR)";"PR";"LARANJEIRAS DO SUL";901;49;116;1066
2017;"LEOPOLIS (PR)";"PR";"LEOPOLIS";94;7;9;110
2017;"LIDIANOPOLIS (PR)";"PR";"LIDIANOPOLIS";109;8;25;142
2017;"LINDOESTE (PR)";"PR";"LINDOESTE";119;10;32;161
2017;"LOANDA (PR)";"PR";"LOANDA";460;25;64;549
2017;"LOBATO (PR)";"PR";"LOBATO";172;8;34;214
2017;"LONDRINA (PR)";"PR";"LONDRINA";9488;839;2042;12369
2017;"LUIZIANA (PR)";"PR";"LUIZIANA";219;8;27;254
2017;"LUNARDELLI (PR)";"PR";"LUNARDELLI";114;9;15;138
2017;"LUPIONOPOLIS (PR)";"PR";"LUPIONOPOLIS";106;18;71;195
2017;"MALLET (PR)";"PR";"MALLET";478;17;70;565
2017;"MAMBORE (PR)";"PR";"MAMBORE";664;9;49;722
2017;"MANDAGUACU (PR)";"PR";"MANDAGUACU";526;28;60;614
2017;"MANDAGUARI (PR)";"PR";"MANDAGUARI";887;59;88;1034
2017;"MANDIRITUBA (PR)";"PR";"MANDIRITUBA";1191;51;94;1336
2017;"MANFRINOPOLIS (PR)";"PR";"MANFRINOPOLIS";45;7;25;77
2017;"MANGUEIRINHA (PR)";"PR";"MANGUEIRINHA";587;37;92;716
2017;"MANOEL RIBAS (PR)";"PR";"MANOEL RIBAS";443;17;41;501
2017;"MARECHAL CANDIDO RONDON (PR)";"PR";"MARECHAL CANDIDO RONDON";1676;110;215;2001
2017;"MARIA HELENA (PR)";"PR";"MARIA HELENA";140;11;35;186
2017;"MARIALVA (PR)";"PR";"MARIALVA";1003;59;104;1166
2017;"MARILANDIA DO SUL (PR)";"PR";"MARILANDIA DO SUL";282;18;36;336
2017;"MARILENA (PR)";"PR";"MARILENA";128;7;31;166
2017;"MARILUZ (PR)";"PR";"MARILUZ";213;17;79;309
2017;"MARINGA (PR)";"PR";"MARINGA";10186;550;905;11641
2017;"MARIOPOLIS (PR)";"PR";"MARIOPOLIS";268;21;43;332
2017;"MARIPA (PR)";"PR";"MARIPA";370;12;13;395
2017;"MARMELEIRO (PR)";"PR";"MARMELEIRO";455;30;61;546
2017;"MARQUINHO (PR)";"PR";"MARQUINHO";83;5;24;112
2017;"MARUMBI (PR)";"PR";"MARUMBI";109;6;28;143
2017;"MATELANDIA (PR)";"PR";"MATELANDIA";699;16;87;802
2017;"MATINHOS (PR)";"PR";"MATINHOS";394;53;54;501
2017;"MATO RICO (PR)";"PR";"MATO RICO";89;4;14;107
2017;"MAUA DA SERRA (PR)";"PR";"MAUA DA SERRA";274;14;29;317
2017;"MEDIANEIRA (PR)";"PR";"MEDIANEIRA";1430;87;137;1654
2017;"MERCEDES (PR)";"PR";"MERCEDES";271;6;30;307
2017;"MIRADOR (PR)";"PR";"MIRADOR";17;3;10;30
2017;"MIRASELVA (PR)";"PR";"MIRASELVA";41;8;34;83
2017;"MISSAL (PR)";"PR";"MISSAL";418;28;51;497
2017;"MOREIRA SALES (PR)";"PR";"MOREIRA SALES";334;16;103;453
2017;"MORRETES (PR)";"PR";"MORRETES";245;24;42;311
2017;"MUNHOZ DE MELLO (PR)";"PR";"MUNHOZ DE MELLO";85;7;10;102
2017;"NOSSA SENHORA DAS GRACAS (PR)";"PR";"NOSSA SENHORA DAS GRACAS";47;10;36;93
2017;"NOVA ALIANCA DO IVAI (PR)";"PR";"NOVA ALIANCA DO IVAI";29;5;7;41
2017;"NOVA AMERICA DA COLINA (PR)";"PR";"NOVA AMERICA DA COLINA";110;6;30;146
2017;"NOVA AURORA (PR)";"PR";"NOVA AURORA";500;14;54;568
2017;"NOVA CANTU (PR)";"PR";"NOVA CANTU";158;3;31;192
2017;"NOVA ESPERANCA (PR)";"PR";"NOVA ESPERANCA";848;46;88;982
2017;"NOVA ESPERANCA DO SUDOESTE (PR)";"PR";"NOVA ESPERANCA DO SUDOESTE";178;17;29;224
2017;"NOVA FATIMA (PR)";"PR";"NOVA FATIMA";333;6;47;386
2017;"NOVA LARANJEIRAS (PR)";"PR";"NOVA LARANJEIRAS";195;9;39;243
2017;"NOVA LONDRINA (PR)";"PR";"NOVA LONDRINA";386;19;63;468
2017;"NOVA OLIMPIA (PR)";"PR";"NOVA OLIMPIA";127;15;24;166
2017;"NOVA PRATA DO IGUACU (PR)";"PR";"NOVA PRATA DO IGUACU";376;16;40;432
2017;"NOVA SANTA BARBARA (PR)";"PR";"NOVA SANTA BARBARA";147;11;9;167
2017;"NOVA SANTA ROSA (PR)";"PR";"NOVA SANTA ROSA";455;17;19;491
2017;"NOVA TEBAS (PR)";"PR";"NOVA TEBAS";152;10;30;192
2017;"NOVO ITACOLOMI (PR)";"PR";"NOVO ITACOLOMI";108;3;10;121
2017;"ORTIGUEIRA (PR)";"PR";"ORTIGUEIRA";519;51;103;673
2017;"OURIZONA (PR)";"PR";"OURIZONA";107;4;20;131
2017;"OURO VERDE DO OESTE (PR)";"PR";"OURO VERDE DO OESTE";184;9;16;209
2017;"PAICANDU (PR)";"PR";"PAICANDU";621;48;64;733
2017;"PALMAS (PR)";"PR";"PALMAS";1097;94;124;1315
2017;"PALMEIRA (PR)";"PR";"PALMEIRA";1098;73;102;1273
2017;"PALMITAL (PR)";"PR";"PALMITAL";330;16;76;422
2017;"PALOTINA (PR)";"PR";"PALOTINA";1401;66;215;1682
2017;"PARAISO DO NORTE (PR)";"PR";"PARAISO DO NORTE";298;16;74;388
2017;"PARANACITY (PR)";"PR";"PARANACITY";304;20;60;384
2017;"PARANAGUA (PR)";"PR";"PARANAGUA";2041;179;203;2423
2017;"PARANAPOEMA (PR)";"PR";"PARANAPOEMA";79;7;19;105
2017;"PARANAVAI (PR)";"PR";"PARANAVAI";2186;160;267;2613
2017;"PATO BRAGADO (PR)";"PR";"PATO BRAGADO";185;9;21;215
2017;"PATO BRANCO (PR)";"PR";"PATO BRANCO";2429;170;416;3015
2017;"PAULA FREITAS (PR)";"PR";"PAULA FREITAS";195;8;30;233
2017;"PAULO FRONTIN (PR)";"PR";"PAULO FRONTIN";292;6;29;327
2017;"PEABIRU (PR)";"PR";"PEABIRU";379;19;33;431
2017;"PEROBAL (PR)";"PR";"PEROBAL";142;9;35;186
2017;"PEROLA (PR)";"PR";"PEROLA";240;16;25;281
2017;"PEROLA D OESTE (PR)";"PR";"PEROLA D OESTE";241;6;31;278
2017;"PIEN (PR)";"PR";"PIEN";469;28;30;527
2017;"PINHAIS (PR)";"PR";"PINHAIS";2340;256;486;3082
2017;"PINHAL DO SAO BENTO (PR)";"PR";"PINHAL DO SAO BENTO";50;4;21;75
2017;"PINHALAO (PR)";"PR";"PINHALAO";138;14;24;176
2017;"PINHAO (PR)";"PR";"PINHAO";652;78;136;866
2017;"PIRAI DO SUL (PR)";"PR";"PIRAI DO SUL";534;58;124;716
2017;"PIRAQUARA (PR)";"PR";"PIRAQUARA";698;118;251;1067
2017;"PITANGA (PR)";"PR";"PITANGA";1070;43;144;1257
2017;"PITANGUEIRAS (PR)";"PR";"PITANGUEIRAS";60;8;35;103
2017;"PLANALTINA DO PARANA (PR)";"PR";"PLANALTINA DO PARANA";115;6;27;148
2017;"PLANALTO (PR)";"PR";"PLANALTO";419;19;48;486
2017;"PONTA GROSSA (PR)";"PR";"PONTA GROSSA";6656;784;1267;8707
2017;"PONTAL DO PARANA (PR)";"PR";"PONTAL DO PARANA";333;38;59;430
2017;"PORECATU (PR)";"PR";"PORECATU";296;39;167;502
2017;"PORTO AMAZONAS (PR)";"PR";"PORTO AMAZONAS";91;14;18;123
2017;"PORTO BARREIRO (PR)";"PR";"PORTO BARREIRO";99;8;31;138
2017;"PORTO RICO (PR)";"PR";"PORTO RICO";30;3;10;43
2017;"PORTO VITORIA (PR)";"PR";"PORTO VITORIA";185;4;15;204
2017;"PRADO FERREIRA (PR)";"PR";"PRADO FERREIRA";115;4;17;136
2017;"PRANCHITA (PR)";"PR";"PRANCHITA";306;13;22;341
2017;"PRESIDENTE CASTELO BRANCO (PR)";"PR";"PRESIDENTE CASTELO BRANCO";135;12;28;175
2017;"PRIMEIRO DE MAIO (PR)";"PR";"PRIMEIRO DE MAIO";349;17;36;402
2017;"PRUDENTOPOLIS (PR)";"PR";"PRUDENTOPOLIS";1529;69;180;1778
2017;"QUARTO CENTENARIO (PR)";"PR";"QUARTO CENTENARIO";142;4;10;156
2017;"QUATIGUA (PR)";"PR";"QUATIGUA";378;16;22;416
2017;"QUATRO BARRAS (PR)";"PR";"QUATRO BARRAS";760;41;131;932
2017;"QUATRO PONTES (PR)";"PR";"QUATRO PONTES";195;4;8;207
2017;"QUEDAS DO IGUACU (PR)";"PR";"QUEDAS DO IGUACU";823;39;192;1054
2017;"QUERENCIA DO NORTE (PR)";"PR";"QUERENCIA DO NORTE";265;9;37;311
2017;"QUINTA DO SOL (PR)";"PR";"QUINTA DO SOL";149;6;27;182
2017;"QUITANDINHA (PR)";"PR";"QUITANDINHA";574;12;108;694
2017;"RAMILANDIA (PR)";"PR";"RAMILANDIA";60;4;18;82
2017;"RANCHO ALEGRE (PR)";"PR";"RANCHO ALEGRE";117;9;19;145
2017;"RANCHO ALEGRE D OESTE (PR)";"PR";"RANCHO ALEGRE D OESTE";93;3;15;111
2017;"REALEZA (PR)";"PR";"REALEZA";696;33;50;779
2017;"REBOUCAS (PR)";"PR";"REBOUCAS";313;24;60;397
2017;"RENASCENCA (PR)";"PR";"RENASCENCA";293;15;42;350
2017;"RESERVA (PR)";"PR";"RESERVA";739;43;118;900
2017;"RESERVA DO IGUACU (PR)";"PR";"RESERVA DO IGUACU";92;13;22;127
2017;"RIBEIRAO CLARO (PR)";"PR";"RIBEIRAO CLARO";230;45;42;317
2017;"RIBEIRAO DO PINHAL (PR)";"PR";"RIBEIRAO DO PINHAL";236;36;77;349
2017;"RIO AZUL (PR)";"PR";"RIO AZUL";344;17;51;412
2017;"RIO BOM (PR)";"PR";"RIO BOM";98;7;13;118
2017;"RIO BONITO DO IGUACU (PR)";"PR";"RIO BONITO DO IGUACU";342;14;106;462
2017;"RIO BRANCO DO IVAI (PR)";"PR";"RIO BRANCO DO IVAI";48;6;15;69
2017;"RIO BRANCO DO SUL (PR)";"PR";"RIO BRANCO DO SUL";772;125;175;1072
2017;"RIO NEGRO (PR)";"PR";"RIO NEGRO";1159;100;88;1347
2017;"ROLANDIA (PR)";"PR";"ROLANDIA";1755;147;139;2041
2017;"RONCADOR (PR)";"PR";"RONCADOR";416;5;43;464
2017;"RONDON (PR)";"PR";"RONDON";311;15;84;410
2017;"ROSARIO DO IVAI (PR)";"PR";"ROSARIO DO IVAI";110;14;29;153
2017;"SABAUDIA (PR)";"PR";"SABAUDIA";251;15;27;293
2017;"SALGADO FILHO (PR)";"PR";"SALGADO FILHO";102;8;37;147
2017;"SALTO DO ITARARE (PR)";"PR";"SALTO DO ITARARE";130;9;21;160
2017;"SALTO DO LONTRA (PR)";"PR";"SALTO DO LONTRA";347;12;44;403
2017;"SANTA AMELIA (PR)";"PR";"SANTA AMELIA";75;8;22;105
2017;"SANTA CECILIA DO PAVAO (PR)";"PR";"SANTA CECILIA DO PAVAO";104;9;15;128
2017;"SANTA CRUZ DO MONTE CASTELO (PR)";"PR";"SANTA CRUZ DO MONTE CASTELO";239;13;53;305
2017;"SANTA FE (PR)";"PR";"SANTA FE";292;17;39;348
2017;"SANTA HELENA (PR)";"PR";"SANTA HELENA";751;82;164;997
2017;"SANTA INES (PR)";"PR";"SANTA INES";19;10;10;39
2017;"SANTA ISABEL DO IVAI (PR)";"PR";"SANTA ISABEL DO IVAI";216;19;40;275
2017;"SANTA IZABEL DO OESTE (PR)";"PR";"SANTA IZABEL DO OESTE";261;30;39;330
2017;"SANTA LUCIA (PR)";"PR";"SANTA LUCIA";135;4;15;154
2017;"SANTA MARIA DO OESTE (PR)";"PR";"SANTA MARIA DO OESTE";279;22;26;327
2017;"SANTA MARIANA (PR)";"PR";"SANTA MARIANA";336;29;53;418
2017;"SANTA MONICA (PR)";"PR";"SANTA MONICA";56;5;16;77
2017;"SANTA TEREZA DO OESTE (PR)";"PR";"SANTA TEREZA DO OESTE";282;20;30;332
2017;"SANTA TEREZINHA DE ITAIPU (PR)";"PR";"SANTA TEREZINHA DE ITAIPU";520;57;62;639
2017;"SANTANA DO ITARARE (PR)";"PR";"SANTANA DO ITARARE";116;9;27;152
2017;"SANTO ANTONIO DA PLATINA (PR)";"PR";"SANTO ANTONIO DA PLATINA";786;89;263;1138
2017;"SANTO ANTONIO DO CAIUA (PR)";"PR";"SANTO ANTONIO DO CAIUA";24;4;13;41
2017;"SANTO ANTONIO DO PARAISO (PR)";"PR";"SANTO ANTONIO DO PARAISO";81;7;17;105
2017;"SANTO ANTONIO DO SUDOESTE (PR)";"PR";"SANTO ANTONIO DO SUDOESTE";467;20;48;535
2017;"SANTO INACIO (PR)";"PR";"SANTO INACIO";155;10;23;188
2017;"SAO CARLOS DO IVAI (PR)";"PR";"SAO CARLOS DO IVAI";238;11;34;283
2017;"SAO JERONIMO DA SERRA (PR)";"PR";"SAO JERONIMO DA SERRA";210;14;30;254
2017;"SAO JOAO (PR)";"PR";"SAO JOAO";442;21;58;521
2017;"SAO JOAO DO CAIUA (PR)";"PR";"SAO JOAO DO CAIUA";89;8;41;138
2017;"SAO JOAO DO IVAI (PR)";"PR";"SAO JOAO DO IVAI";384;12;39;435
2017;"SAO JOAO DO TRIUNFO (PR)";"PR";"SAO JOAO DO TRIUNFO";296;15;55;366
2017;"SAO JORGE D OESTE (PR)";"PR";"SAO JORGE D OESTE";271;16;54;341
2017;"SAO JORGE DO IVAI (PR)";"PR";"SAO JORGE DO IVAI";292;10;23;325
2017;"SAO JORGE DO PATROCINIO (PR)";"PR";"SAO JORGE DO PATROCINIO";140;11;26;177
2017;"SAO JOSE DA BOA VISTA (PR)";"PR";"SAO JOSE DA BOA VISTA";128;7;31;166
2017;"SAO JOSE DAS PALMEIRAS (PR)";"PR";"SAO JOSE DAS PALMEIRAS";97;11;39;147
2017;"SAO JOSE DOS PINHAIS (PR)";"PR";"SAO JOSE DOS PINHAIS";8255;679;895;9829
2017;"SAO MANOEL DO PARANA (PR)";"PR";"SAO MANOEL DO PARANA";59;2;11;72
2017;"SAO MATEUS DO SUL (PR)";"PR";"SAO MATEUS DO SUL";1139;108;195;1442
2017;"SAO MIGUEL DO IGUACU (PR)";"PR";"SAO MIGUEL DO IGUACU";961;63;95;1119
2017;"SAO PEDRO DO IGUACU (PR)";"PR";"SAO PEDRO DO IGUACU";194;8;46;248
2017;"SAO PEDRO DO IVAI (PR)";"PR";"SAO PEDRO DO IVAI";365;15;49;429
2017;"SAO PEDRO DO PARANA (PR)";"PR";"SAO PEDRO DO PARANA";48;7;9;64
2017;"SAO SEBASTIAO DA AMOREIRA (PR)";"PR";"SAO SEBASTIAO DA AMOREIRA";204;7;55;266
2017;"SAO TOME (PR)";"PR";"SAO TOME";164;12;36;212
2017;"SAPOPEMA (PR)";"PR";"SAPOPEMA";136;5;21;162
2017;"SARANDI (PR)";"PR";"SARANDI";1188;106;197;1491
2017;"SAUDADE DO IGUACU (PR)";"PR";"SAUDADE DO IGUACU";105;20;28;153
2017;"SENGES (PR)";"PR";"SENGES";584;33;71;688
2017;"SERRANOPOLIS DO IGUACU (PR)";"PR";"SERRANOPOLIS DO IGUACU";166;17;14;197
2017;"SERTANEJA (PR)";"PR";"SERTANEJA";216;14;40;270
2017;"SERTANOPOLIS (PR)";"PR";"SERTANOPOLIS";676;23;79;778
2017;"SIQUEIRA CAMPOS (PR)";"PR";"SIQUEIRA CAMPOS";459;21;75;555
2017;"SULINA (PR)";"PR";"SULINA";91;4;14;109
2017;"TAMARANA (PR)";"PR";"TAMARANA";351;18;60;429
2017;"TAMBOARA (PR)";"PR";"TAMBOARA";103;9;16;128
2017;"TAPEJARA (PR)";"PR";"TAPEJARA";452;14;111;577
2017;"TAPIRA (PR)";"PR";"TAPIRA";173;8;37;218
2017;"TEIXEIRA SOARES (PR)";"PR";"TEIXEIRA SOARES";230;22;117;369
2017;"TELEMACO BORBA (PR)";"PR";"TELEMACO BORBA";1178;251;241;1670
2017;"TERRA BOA (PR)";"PR";"TERRA BOA";393;23;116;532
2017;"TERRA RICA (PR)";"PR";"TERRA RICA";425;25;102;552
2017;"TERRA ROXA (PR)";"PR";"TERRA ROXA";619;21;67;707
2017;"TIBAGI (PR)";"PR";"TIBAGI";400;52;77;529
2017;"TIJUCAS DO SUL (PR)";"PR";"TIJUCAS DO SUL";528;20;52;600
2017;"TOLEDO (PR)";"PR";"TOLEDO";3615;270;258;4143
2017;"TOMAZINA (PR)";"PR";"TOMAZINA";125;13;26;164
2017;"TRES BARRAS DO PARANA (PR)";"PR";"TRES BARRAS DO PARANA";388;9;44;441
2017;"TUNAS DO PARANA (PR)";"PR";"TUNAS DO PARANA";134;15;54;203
2017;"TUNEIRAS DO OESTE (PR)";"PR";"TUNEIRAS DO OESTE";170;13;68;251
2017;"TUPASSI (PR)";"PR";"TUPASSI";399;15;42;456
2017;"TURVO (PR)";"PR";"TURVO";457;32;88;577
2017;"UBIRATA (PR)";"PR";"UBIRATA";796;37;83;916
2017;"UMUARAMA (PR)";"PR";"UMUARAMA";2918;94;313;3325
2017;"UNIAO DA VITORIA (PR)";"PR";"UNIAO DA VITORIA";1550;75;104;1729
2017;"UNIFLOR (PR)";"PR";"UNIFLOR";62;8;14;84
2017;"URAI (PR)";"PR";"URAI";360;27;25;412
2017;"VENTANIA (PR)";"PR";"VENTANIA";195;23;35;253
2017;"VERA CRUZ DO OESTE (PR)";"PR";"VERA CRUZ DO OESTE";319;15;22;356
2017;"VERE (PR)";"PR";"VERE";265;8;27;300
2017;"VIRMOND (PR)";"PR";"VIRMOND";134;2;24;160
2017;"VITORINO (PR)";"PR";"VITORINO";289;11;36;336
2017;"WENCESLAU BRAZ (PR)";"PR";"WENCESLAU BRAZ";544;33;86;663
2017;"XAMBRE (PR)";"PR";"XAMBRE";173;12;18;203
2017;"ANGRA DOS REIS (RJ)";"RJ";"ANGRA DOS REIS";1243;241;425;1909
2017;"APERIBE (RJ)";"RJ";"APERIBE";138;21;15;174
2017;"ARARUAMA (RJ)";"RJ";"ARARUAMA";1893;310;192;2395
2017;"AREAL (RJ)";"RJ";"AREAL";178;44;45;267
2017;"ARMACAO DE BUZIOS (RJ)";"RJ";"ARMACAO DE BUZIOS";368;339;62;769
2017;"ARRAIAL DO CABO (RJ)";"RJ";"ARRAIAL DO CABO";180;64;17;261
2017;"BARRA DO PIRAI (RJ)";"RJ";"BARRA DO PIRAI";1406;239;302;1947
2017;"BARRA MANSA (RJ)";"RJ";"BARRA MANSA";1988;267;668;2923
2017;"BELFORD ROXO (RJ)";"RJ";"BELFORD ROXO";2059;512;853;3424
2017;"BOM JARDIM (RJ)";"RJ";"BOM JARDIM";685;64;59;808
2017;"BOM JESUS DO ITABAPOANA (RJ)";"RJ";"BOM JESUS DO ITABAPOANA";298;57;65;420
2017;"CABO FRIO (RJ)";"RJ";"CABO FRIO";3129;365;453;3947
2017;"CACHOEIRAS DE MACACU (RJ)";"RJ";"CACHOEIRAS DE MACACU";960;199;55;1214
2017;"CAMBUCI (RJ)";"RJ";"CAMBUCI";131;27;31;189
2017;"CAMPOS DOS GOYTACAZES (RJ)";"RJ";"CAMPOS DOS GOYTACAZES";6935;1145;1475;9555
2017;"CANTAGALO (RJ)";"RJ";"CANTAGALO";220;52;48;320
2017;"CARAPEBUS (RJ)";"RJ";"CARAPEBUS";135;31;18;184
2017;"CARDOSO MOREIRA (RJ)";"RJ";"CARDOSO MOREIRA";179;34;56;269
2017;"CARMO (RJ)";"RJ";"CARMO";141;34;19;194
2017;"CASIMIRO DE ABREU (RJ)";"RJ";"CASIMIRO DE ABREU";642;99;30;771
2017;"COMENDADOR LEVY GASPARIAN (RJ)";"RJ";"COMENDADOR LEVY GASPARIAN";175;32;21;228
2017;"CONCEICAO DE MACABU (RJ)";"RJ";"CONCEICAO DE MACABU";189;45;58;292
2017;"CORDEIRO (RJ)";"RJ";"CORDEIRO";287;51;58;396
2017;"DUAS BARRAS (RJ)";"RJ";"DUAS BARRAS";152;50;10;212
2017;"DUQUE DE CAXIAS (RJ)";"RJ";"DUQUE DE CAXIAS";9612;1105;3865;14582
2017;"ENGENHEIRO PAULO DE FRONTIN (RJ)";"RJ";"ENGENHEIRO PAULO DE FRONTIN";128;30;19;177
2017;"GUAPIMIRIM (RJ)";"RJ";"GUAPIMIRIM";456;79;58;593
2017;"IGUABA GRANDE (RJ)";"RJ";"IGUABA GRANDE";193;82;32;307
2017;"ITABORAI (RJ)";"RJ";"ITABORAI";3216;762;495;4473
2017;"ITAGUAI (RJ)";"RJ";"ITAGUAI";1737;316;324;2377
2017;"ITALVA (RJ)";"RJ";"ITALVA";207;34;34;275
2017;"ITAOCARA (RJ)";"RJ";"ITAOCARA";381;49;42;472
2017;"ITAPERUNA (RJ)";"RJ";"ITAPERUNA";1095;146;118;1359
2017;"ITATIAIA (RJ)";"RJ";"ITATIAIA";158;83;49;290
2017;"JAPERI (RJ)";"RJ";"JAPERI";548;78;45;671
2017;"LAJE DO MURIAE (RJ)";"RJ";"LAJE DO MURIAE";38;7;15;60
2017;"MACAE (RJ)";"RJ";"MACAE";3139;1028;916;5083
2017;"MACUCO (RJ)";"RJ";"MACUCO";185;13;12;210
2017;"MAGE (RJ)";"RJ";"MAGE";1965;467;189;2621
2017;"MANGARATIBA (RJ)";"RJ";"MANGARATIBA";206;136;134;476
2017;"MARICA (RJ)";"RJ";"MARICA";1246;426;415;2087
2017;"MENDES (RJ)";"RJ";"MENDES";218;57;54;329
2017;"MESQUITA (RJ)";"RJ";"MESQUITA";856;132;680;1668
2017;"MIGUEL PEREIRA (RJ)";"RJ";"MIGUEL PEREIRA";386;83;46;515
2017;"MIRACEMA (RJ)";"RJ";"MIRACEMA";273;39;36;348
2017;"NATIVIDADE (RJ)";"RJ";"NATIVIDADE";90;22;48;160
2017;"NILOPOLIS (RJ)";"RJ";"NILOPOLIS";666;153;341;1160
2017;"NITEROI (RJ)";"RJ";"NITEROI";2815;1265;2667;6747
2017;"NOVA FRIBURGO (RJ)";"RJ";"NOVA FRIBURGO";3768;307;349;4424
2017;"NOVA IGUACU (RJ)";"RJ";"NOVA IGUACU";6762;1613;1769;10144
2017;"PARACAMBI (RJ)";"RJ";"PARACAMBI";709;106;113;928
2017;"PARAIBA DO SUL (RJ)";"RJ";"PARAIBA DO SUL";622;131;106;859
2017;"PARATI (RJ)";"RJ";"PARATI";218;94;57;369
2017;"PATY DO ALFERES (RJ)";"RJ";"PATY DO ALFERES";518;55;63;636
2017;"PETROPOLIS (RJ)";"RJ";"PETROPOLIS";3504;715;983;5202
2017;"PINHEIRAL (RJ)";"RJ";"PINHEIRAL";217;63;138;418
2017;"PIRAI (RJ)";"RJ";"PIRAI";394;81;75;550
2017;"PORCIUNCULA (RJ)";"RJ";"PORCIUNCULA";70;22;27;119
2017;"PORTO REAL (RJ)";"RJ";"PORTO REAL";254;44;19;317
2017;"QUATIS (RJ)";"RJ";"QUATIS";164;73;32;269
2017;"QUEIMADOS (RJ)";"RJ";"QUEIMADOS";683;237;320;1240
2017;"QUISSAMA (RJ)";"RJ";"QUISSAMA";233;41;120;394
2017;"RESENDE (RJ)";"RJ";"RESENDE";1480;282;593;2355
2017;"RIO BONITO (RJ)";"RJ";"RIO BONITO";3385;349;151;3885
2017;"RIO CLARO (RJ)";"RJ";"RIO CLARO";136;22;25;183
2017;"RIO DAS FLORES (RJ)";"RJ";"RIO DAS FLORES";53;30;17;100
2017;"RIO DAS OSTRAS (RJ)";"RJ";"RIO DAS OSTRAS";1149;805;148;2102
2017;"RIO DE JANEIRO (RJ)";"RJ";"RIO DE JANEIRO";42875;17608;17664;78147
2017;"SANTA MARIA MADALENA (RJ)";"RJ";"SANTA MARIA MADALENA";83;30;22;135
2017;"SANTO ANTONIO DE PADUA (RJ)";"RJ";"SANTO ANTONIO DE PADUA";606;112;38;756
2017;"SAO FIDELIS (RJ)";"RJ";"SAO FIDELIS";433;57;73;563
2017;"SAO FRANCISCO DE ITABAPOANA (RJ)";"RJ";"SAO FRANCISCO DE ITABAPOANA";447;123;110;680
2017;"SAO GONCALO (RJ)";"RJ";"SAO GONCALO";5318;1928;3239;10485
2017;"SAO JOAO DA BARRA (RJ)";"RJ";"SAO JOAO DA BARRA";682;96;70;848
2017;"SAO JOAO DE MERITI (RJ)";"RJ";"SAO JOAO DE MERITI";3691;560;1344;5595
2017;"SAO JOSE DE UBA (RJ)";"RJ";"SAO JOSE DE UBA";50;12;10;72
2017;"SAO JOSE DO VALE DO RIO PRETO (RJ)";"RJ";"SAO JOSE DO VALE DO RIO PRETO";727;39;56;822
2017;"SAO PEDRO DA ALDEIA (RJ)";"RJ";"SAO PEDRO DA ALDEIA";960;118;124;1202
2017;"SAO SEBASTIAO DO ALTO (RJ)";"RJ";"SAO SEBASTIAO DO ALTO";124;31;9;164
2017;"SAPUCAIA (RJ)";"RJ";"SAPUCAIA";127;17;14;158
2017;"SAQUAREMA (RJ)";"RJ";"SAQUAREMA";852;154;157;1163
2017;"SEROPEDICA (RJ)";"RJ";"SEROPEDICA";1422;86;277;1785
2017;"SILVA JARDIM (RJ)";"RJ";"SILVA JARDIM";318;60;46;424
2017;"SUMIDOURO (RJ)";"RJ";"SUMIDOURO";368;24;23;415
2017;"TANGUA (RJ)";"RJ";"TANGUA";375;56;71;502
2017;"TERESOPOLIS (RJ)";"RJ";"TERESOPOLIS";2439;334;299;3072
2017;"TRAJANO DE MORAIS (RJ)";"RJ";"TRAJANO DE MORAIS";110;28;19;157
2017;"TRES RIOS (RJ)";"RJ";"TRES RIOS";1052;125;213;1390
2017;"VALENCA (RJ)";"RJ";"VALENCA";392;144;107;643
2017;"VARRE SAI (RJ)";"RJ";"VARRE SAI";69;20;7;96
2017;"VASSOURAS (RJ)";"RJ";"VASSOURAS";588;89;105;782
2017;"VOLTA REDONDA (RJ)";"RJ";"VOLTA REDONDA";2337;438;653;3428
2017;"ACARI (RN)";"RN";"ACARI";112;9;13;134
2017;"AFONSO BEZERRA (RN)";"RN";"AFONSO BEZERRA";34;6;16;56
2017;"AGUA NOVA (RN)";"RN";"AGUA NOVA";9;13;2;24
2017;"ALEXANDRIA (RN)";"RN";"ALEXANDRIA";119;33;15;167
2017;"ALMINO AFONSO (RN)";"RN";"ALMINO AFONSO";27;8;1;36
2017;"ALTO DO RODRIGUES (RN)";"RN";"ALTO DO RODRIGUES";182;19;28;229
2017;"ANGICOS (RN)";"RN";"ANGICOS";122;21;12;155
2017;"ANTONIO MARTINS (RN)";"RN";"ANTONIO MARTINS";38;11;4;53
2017;"APODI (RN)";"RN";"APODI";373;45;53;471
2017;"AREIA BRANCA (RN)";"RN";"AREIA BRANCA";149;45;73;267
2017;"ARES (RN)";"RN";"ARES";62;8;43;113
2017;"ASSU (RN)";"RN";"ASSU";713;65;97;875
2017;"BAIA FORMOSA (RN)";"RN";"BAIA FORMOSA";52;4;29;85
2017;"BARAUNA (RN)";"RN";"BARAUNA";672;34;46;752
2017;"BARCELONA (RN)";"RN";"BARCELONA";25;3;4;32
2017;"BENTO FERNANDES (RN)";"RN";"BENTO FERNANDES";15;6;12;33
2017;"BOA SAUDE (RN)";"RN";"BOA SAUDE";90;6;12;108
2017;"BODO (RN)";"RN";"BODO";7;6;3;16
2017;"BOM JESUS (RN)";"RN";"BOM JESUS";59;8;10;77
2017;"BREJINHO (RN)";"RN";"BREJINHO";128;11;21;160
2017;"CAICARA DO NORTE (RN)";"RN";"CAICARA DO NORTE";19;2;6;27
2017;"CAICARA DO RIO DO VENTO (RN)";"RN";"CAICARA DO RIO DO VENTO";25;4;3;32
2017;"CAICO (RN)";"RN";"CAICO";2227;146;73;2446
2017;"CAMPO GRANDE (RN)";"RN";"CAMPO GRANDE";57;11;10;78
2017;"CAMPO REDONDO (RN)";"RN";"CAMPO REDONDO";72;13;11;96
2017;"CANGUARETAMA (RN)";"RN";"CANGUARETAMA";194;33;83;310
2017;"CARAUBAS (RN)";"RN";"CARAUBAS";185;45;20;250
2017;"CARNAUBA DOS DANTAS (RN)";"RN";"CARNAUBA DOS DANTAS";239;11;9;259
2017;"CARNAUBAIS (RN)";"RN";"CARNAUBAIS";53;20;14;87
2017;"CEARA MIRIM (RN)";"RN";"CEARA MIRIM";374;63;137;574
2017;"CERRO CORA (RN)";"RN";"CERRO CORA";120;11;15;146
2017;"CORONEL EZEQUIEL (RN)";"RN";"CORONEL EZEQUIEL";75;11;4;90
2017;"CORONEL JOAO PESSOA (RN)";"RN";"CORONEL JOAO PESSOA";15;4;4;23
2017;"CRUZETA (RN)";"RN";"CRUZETA";95;15;14;124
2017;"CURRAIS NOVOS (RN)";"RN";"CURRAIS NOVOS";782;64;65;911
2017;"DOUTOR SEVERIANO (RN)";"RN";"DOUTOR SEVERIANO";40;6;10;56
2017;"ENCANTO (RN)";"RN";"ENCANTO";17;8;9;34
2017;"EQUADOR (RN)";"RN";"EQUADOR";154;7;3;164
2017;"ESPIRITO SANTO (RN)";"RN";"ESPIRITO SANTO";27;3;18;48
2017;"EXTREMOZ (RN)";"RN";"EXTREMOZ";97;32;47;176
2017;"FELIPE GUERRA (RN)";"RN";"FELIPE GUERRA";28;10;12;50
2017;"FERNANDO PEDROZA (RN)";"RN";"FERNANDO PEDROZA";30;4;2;36
2017;"FLORANIA (RN)";"RN";"FLORANIA";76;12;8;96
2017;"FRANCISCO DANTAS (RN)";"RN";"FRANCISCO DANTAS";23;4;3;30
2017;"FRUTUOSO GOMES (RN)";"RN";"FRUTUOSO GOMES";30;13;4;47
2017;"GALINHOS (RN)";"RN";"GALINHOS";16;4;4;24
2017;"GOIANINHA (RN)";"RN";"GOIANINHA";197;59;112;368
2017;"GOVERNADOR DIX SEPT ROSADO (RN)";"RN";"GOVERNADOR DIX SEPT ROSADO";183;25;20;228
2017;"GROSSOS (RN)";"RN";"GROSSOS";59;4;21;84
2017;"GUAMARE (RN)";"RN";"GUAMARE";133;21;42;196
2017;"IELMO MARINHO (RN)";"RN";"IELMO MARINHO";68;4;28;100
2017;"IPANGUACU (RN)";"RN";"IPANGUACU";117;26;50;193
2017;"IPUEIRA (RN)";"RN";"IPUEIRA";18;7;6;31
2017;"ITAJA (RN)";"RN";"ITAJA";104;4;6;114
2017;"ITAU (RN)";"RN";"ITAU";41;12;1;54
2017;"JACANA (RN)";"RN";"JACANA";417;68;30;515
2017;"JANDAIRA (RN)";"RN";"JANDAIRA";52;1;16;69
2017;"JANDUIS (RN)";"RN";"JANDUIS";23;7;3;33
2017;"JAPI (RN)";"RN";"JAPI";70;16;11;97
2017;"JARDIM DE ANGICOS (RN)";"RN";"JARDIM DE ANGICOS";10;1;3;14
2017;"JARDIM DE PIRANHAS (RN)";"RN";"JARDIM DE PIRANHAS";113;34;9;156
2017;"JARDIM DO SERIDO (RN)";"RN";"JARDIM DO SERIDO";158;22;52;232
2017;"JOAO CAMARA (RN)";"RN";"JOAO CAMARA";391;29;57;477
2017;"JOAO DIAS (RN)";"RN";"JOAO DIAS";10;1;1;12
2017;"JOSE DA PENHA (RN)";"RN";"JOSE DA PENHA";41;15;3;59
2017;"JUCURUTU (RN)";"RN";"JUCURUTU";165;47;10;222
2017;"JUNDIA (RN)";"RN";"JUNDIA";17;5;10;32
2017;"LAGOA DANTA (RN)";"RN";"LAGOA DANTA";58;12;19;89
2017;"LAGOA DE PEDRAS (RN)";"RN";"LAGOA DE PEDRAS";35;5;19;59
2017;"LAGOA DE VELHOS (RN)";"RN";"LAGOA DE VELHOS";24;2;2;28
2017;"LAGOA NOVA (RN)";"RN";"LAGOA NOVA";118;34;22;174
2017;"LAGOA SALGADA (RN)";"RN";"LAGOA SALGADA";134;5;11;150
2017;"LAJES (RN)";"RN";"LAJES";75;6;12;93
2017;"LAJES PINTADAS (RN)";"RN";"LAJES PINTADAS";29;12;5;46
2017;"LUCRECIA (RN)";"RN";"LUCRECIA";33;7;4;44
2017;"LUIS GOMES (RN)";"RN";"LUIS GOMES";79;38;9;126
2017;"MACAIBA (RN)";"RN";"MACAIBA";869;148;78;1095
2017;"MACAU (RN)";"RN";"MACAU";203;39;66;308
2017;"MAJOR SALES (RN)";"RN";"MAJOR SALES";18;13;2;33
2017;"MARCELINO VIEIRA (RN)";"RN";"MARCELINO VIEIRA";28;18;4;50
2017;"MARTINS (RN)";"RN";"MARTINS";57;12;10;79
2017;"MAXARANGUAPE (RN)";"RN";"MAXARANGUAPE";26;9;11;46
2017;"MESSIAS TARGINO (RN)";"RN";"MESSIAS TARGINO";43;10;4;57
2017;"MONTANHAS (RN)";"RN";"MONTANHAS";62;9;21;92
2017;"MONTE ALEGRE (RN)";"RN";"MONTE ALEGRE";131;19;43;193
2017;"MONTE DAS GAMELEIRAS (RN)";"RN";"MONTE DAS GAMELEIRAS";16;2;9;27
2017;"MOSSORO (RN)";"RN";"MOSSORO";4012;299;367;4678
2017;"NATAL (RN)";"RN";"NATAL";7114;1307;2713;11134
2017;"NISIA FLORESTA (RN)";"RN";"NISIA FLORESTA";92;47;63;202
2017;"NOVA CRUZ (RN)";"RN";"NOVA CRUZ";470;53;89;612
2017;"OLHO D AGUA DO BORGES (RN)";"RN";"OLHO D AGUA DO BORGES";27;4;1;32
2017;"OURO BRANCO (RN)";"RN";"OURO BRANCO";51;14;5;70
2017;"PARANA (RN)";"RN";"PARANA";25;13;4;42
2017;"PARAU (RN)";"RN";"PARAU";18;14;2;34
2017;"PARAZINHO (RN)";"RN";"PARAZINHO";29;4;17;50
2017;"PARELHAS (RN)";"RN";"PARELHAS";506;36;44;586
2017;"PARNAMIRIM (RN)";"RN";"PARNAMIRIM";2122;407;447;2976
2017;"PASSA E FICA (RN)";"RN";"PASSA E FICA";190;60;42;292
2017;"PASSAGEM (RN)";"RN";"PASSAGEM";17;8;3;28
2017;"PATU (RN)";"RN";"PATU";156;26;6;188
2017;"PAU DOS FERROS (RN)";"RN";"PAU DOS FERROS";654;55;30;739
2017;"PEDRA GRANDE (RN)";"RN";"PEDRA GRANDE";13;2;7;22
2017;"PEDRA PRETA (RN)";"RN";"PEDRA PRETA";39;3;10;52
2017;"PEDRO AVELINO (RN)";"RN";"PEDRO AVELINO";33;4;6;43
2017;"PEDRO VELHO (RN)";"RN";"PEDRO VELHO";48;7;15;70
2017;"PENDENCIAS (RN)";"RN";"PENDENCIAS";73;16;16;105
2017;"PILOES (RN)";"RN";"PILOES";21;4;2;27
2017;"POCO BRANCO (RN)";"RN";"POCO BRANCO";36;8;14;58
2017;"PORTALEGRE (RN)";"RN";"PORTALEGRE";49;15;6;70
2017;"PORTO DO MANGUE (RN)";"RN";"PORTO DO MANGUE";26;18;8;52
2017;"PUREZA (RN)";"RN";"PUREZA";89;6;24;119
2017;"RAFAEL FERNANDES (RN)";"RN";"RAFAEL FERNANDES";40;6;1;47
2017;"RAFAEL GODEIRO (RN)";"RN";"RAFAEL GODEIRO";13;2;2;17
2017;"RIACHO DA CRUZ (RN)";"RN";"RIACHO DA CRUZ";10;4;1;15
2017;"RIACHO DE SANTANA (RN)";"RN";"RIACHO DE SANTANA";8;8;4;20
2017;"RIACHUELO (RN)";"RN";"RIACHUELO";35;3;8;46
2017;"RIO DO FOGO (RN)";"RN";"RIO DO FOGO";44;5;11;60
2017;"RODOLFO FERNANDES (RN)";"RN";"RODOLFO FERNANDES";48;8;4;60
2017;"RUY BARBOSA (RN)";"RN";"RUY BARBOSA";17;2;5;24
2017;"SANTA CRUZ (RN)";"RN";"SANTA CRUZ";577;35;48;660
2017;"SANTA MARIA (RN)";"RN";"SANTA MARIA";64;4;7;75
2017;"SANTANA DO MATOS (RN)";"RN";"SANTANA DO MATOS";81;10;12;103
2017;"SANTANA DO SERIDO (RN)";"RN";"SANTANA DO SERIDO";25;4;2;31
2017;"SANTO ANTONIO (RN)";"RN";"SANTO ANTONIO";146;62;40;248
2017;"SAO BENTO DO NORTE (RN)";"RN";"SAO BENTO DO NORTE";9;0;9;18
2017;"SAO BENTO DO TRAIRI (RN)";"RN";"SAO BENTO DO TRAIRI";15;1;7;23
2017;"SAO FERNANDO (RN)";"RN";"SAO FERNANDO";19;11;6;36
2017;"SAO FRANCISCO DO OESTE (RN)";"RN";"SAO FRANCISCO DO OESTE";36;3;3;42
2017;"SAO GONCALO DO AMARANTE (RN)";"RN";"SAO GONCALO DO AMARANTE";508;192;328;1028
2017;"SAO JOAO DO SABUGI (RN)";"RN";"SAO JOAO DO SABUGI";53;23;5;81
2017;"SAO JOSE DE MIPIBU (RN)";"RN";"SAO JOSE DE MIPIBU";393;52;69;514
2017;"SAO JOSE DO CAMPESTRE (RN)";"RN";"SAO JOSE DO CAMPESTRE";89;7;21;117
2017;"SAO JOSE DO SERIDO (RN)";"RN";"SAO JOSE DO SERIDO";38;13;2;53
2017;"SAO MIGUEL (RN)";"RN";"SAO MIGUEL";273;53;33;359
2017;"SAO MIGUEL DO GOSTOSO (RN)";"RN";"SAO MIGUEL DO GOSTOSO";36;12;19;67
2017;"SAO PAULO DO POTENGI (RN)";"RN";"SAO PAULO DO POTENGI";132;12;26;170
2017;"SAO PEDRO (RN)";"RN";"SAO PEDRO";36;4;10;50
2017;"SAO RAFAEL (RN)";"RN";"SAO RAFAEL";45;17;5;67
2017;"SAO TOME (RN)";"RN";"SAO TOME";76;3;27;106
2017;"SAO VICENTE (RN)";"RN";"SAO VICENTE";56;4;7;67
2017;"SENADOR ELOI DE SOUZA (RN)";"RN";"SENADOR ELOI DE SOUZA";26;4;14;44
2017;"SENADOR GEORGINO AVELINO (RN)";"RN";"SENADOR GEORGINO AVELINO";14;3;2;19
2017;"SERRA CAIADA (RN)";"RN";"SERRA CAIADA";62;10;16;88
2017;"SERRA DE SAO BENTO (RN)";"RN";"SERRA DE SAO BENTO";47;7;5;59
2017;"SERRA DO MEL (RN)";"RN";"SERRA DO MEL";116;11;17;144
2017;"SERRA NEGRA DO NORTE (RN)";"RN";"SERRA NEGRA DO NORTE";72;22;9;103
2017;"SERRINHA (RN)";"RN";"SERRINHA";35;15;9;59
2017;"SERRINHA DOS PINTOS (RN)";"RN";"SERRINHA DOS PINTOS";40;5;2;47
2017;"SEVERIANO MELO (RN)";"RN";"SEVERIANO MELO";40;11;7;58
2017;"SITIO NOVO (RN)";"RN";"SITIO NOVO";19;9;5;33
2017;"TABOLEIRO GRANDE (RN)";"RN";"TABOLEIRO GRANDE";8;8;3;19
2017;"TAIPU (RN)";"RN";"TAIPU";59;4;28;91
2017;"TANGARA (RN)";"RN";"TANGARA";158;9;47;214
2017;"TENENTE ANANIAS (RN)";"RN";"TENENTE ANANIAS";73;22;4;99
2017;"TENENTE LAURENTINO CRUZ (RN)";"RN";"TENENTE LAURENTINO CRUZ";53;11;6;70
2017;"TIBAU (RN)";"RN";"TIBAU";35;11;24;70
2017;"TIBAU DO SUL (RN)";"RN";"TIBAU DO SUL";56;51;20;127
2017;"TIMBAUBA DOS BATISTAS (RN)";"RN";"TIMBAUBA DOS BATISTAS";13;7;3;23
2017;"TOUROS (RN)";"RN";"TOUROS";185;35;58;278
2017;"TRIUNFO POTIGUAR (RN)";"RN";"TRIUNFO POTIGUAR";17;7;3;27
2017;"UMARIZAL (RN)";"RN";"UMARIZAL";76;31;6;113
2017;"UPANEMA (RN)";"RN";"UPANEMA";100;13;16;129
2017;"VARZEA (RN)";"RN";"VARZEA";17;3;7;27
2017;"VENHA VER (RN)";"RN";"VENHA VER";19;10;6;35
2017;"VERA CRUZ (RN)";"RN";"VERA CRUZ";175;10;22;207
2017;"VICOSA (RN)";"RN";"VICOSA";8;1;1;10
2017;"VILA FLOR (RN)";"RN";"VILA FLOR";13;2;3;18
2017;"ALTA FLORESTA D OESTE (RO)";"RO";"ALTA FLORESTA D OESTE";530;17;92;639
2017;"ALTO ALEGRE DOS PARECIS (RO)";"RO";"ALTO ALEGRE DOS PARECIS";162;15;37;214
2017;"ALTO PARAISO (RO)";"RO";"ALTO PARAISO";329;9;75;413
2017;"ALVORADA D OESTE (RO)";"RO";"ALVORADA D OESTE";283;8;66;357
2017;"ARIQUEMES (RO)";"RO";"ARIQUEMES";2126;35;226;2387
2017;"BURITIS (RO)";"RO";"BURITIS";557;8;54;619
2017;"CABIXI (RO)";"RO";"CABIXI";115;5;25;145
2017;"CACAULANDIA (RO)";"RO";"CACAULANDIA";86;4;29;119
2017;"CACOAL (RO)";"RO";"CACOAL";1884;77;317;2278
2017;"CAMPO NOVO DE RONDONIA (RO)";"RO";"CAMPO NOVO DE RONDONIA";96;9;52;157
2017;"CANDEIAS DO JAMARI (RO)";"RO";"CANDEIAS DO JAMARI";245;8;34;287
2017;"CASTANHEIRAS (RO)";"RO";"CASTANHEIRAS";43;2;17;62
2017;"CEREJEIRAS (RO)";"RO";"CEREJEIRAS";377;6;54;437
2017;"CHUPINGUAIA (RO)";"RO";"CHUPINGUAIA";127;8;81;216
2017;"COLORADO DO OESTE (RO)";"RO";"COLORADO DO OESTE";422;17;65;504
2017;"CORUMBIARA (RO)";"RO";"CORUMBIARA";130;8;24;162
2017;"COSTA MARQUES (RO)";"RO";"COSTA MARQUES";174;7;28;209
2017;"CUJUBIM (RO)";"RO";"CUJUBIM";281;7;41;329
2017;"ESPIGAO D OESTE (RO)";"RO";"ESPIGAO D OESTE";692;7;135;834
2017;"GOVERNADOR JORGE TEIXEIRA (RO)";"RO";"GOVERNADOR JORGE TEIXEIRA";67;3;31;101
2017;"GUAJARA MIRIM (RO)";"RO";"GUAJARA MIRIM";815;13;30;858
2017;"ITAPUA DO OESTE (RO)";"RO";"ITAPUA DO OESTE";187;6;64;257
2017;"JARU (RO)";"RO";"JARU";1022;24;220;1266
2017;"JI PARANA (RO)";"RO";"JI PARANA";3191;94;711;3996
2017;"MACHADINHO D OESTE (RO)";"RO";"MACHADINHO D OESTE";435;16;79;530
2017;"MINISTRO ANDREAZZA (RO)";"RO";"MINISTRO ANDREAZZA";247;3;19;269
2017;"MIRANTE DA SERRA (RO)";"RO";"MIRANTE DA SERRA";189;7;33;229
2017;"MONTE NEGRO (RO)";"RO";"MONTE NEGRO";312;18;90;420
2017;"NOVA BRASILANDIA D OESTE (RO)";"RO";"NOVA BRASILANDIA D OESTE";258;10;91;359
2017;"NOVA DO MAMORE (RO)";"RO";"NOVA DO MAMORE";351;4;34;389
2017;"NOVA UNIAO (RO)";"RO";"NOVA UNIAO";105;1;38;144
2017;"NOVO HORIZONTE DO OESTE (RO)";"RO";"NOVO HORIZONTE DO OESTE";119;1;19;139
2017;"OURO PRETO DO OESTE (RO)";"RO";"OURO PRETO DO OESTE";804;29;128;961
2017;"PARECIS (RO)";"RO";"PARECIS";98;3;33;134
2017;"PIMENTA BUENO (RO)";"RO";"PIMENTA BUENO";1129;42;103;1274
2017;"PIMENTEIRAS DO OESTE (RO)";"RO";"PIMENTEIRAS DO OESTE";37;1;20;58
2017;"PORTO VELHO (RO)";"RO";"PORTO VELHO";7340;524;1843;9707
2017;"PRESIDENTE MEDICI (RO)";"RO";"PRESIDENTE MEDICI";358;11;69;438
2017;"PRIMAVERA DE RONDONIA (RO)";"RO";"PRIMAVERA DE RONDONIA";54;4;15;73
2017;"RIO CRESPO (RO)";"RO";"RIO CRESPO";59;3;20;82
2017;"ROLIM DE MOURA (RO)";"RO";"ROLIM DE MOURA";1206;37;146;1389
2017;"SANTA LUZIA D OESTE (RO)";"RO";"SANTA LUZIA D OESTE";223;3;53;279
2017;"SAO FELIPE D OESTE (RO)";"RO";"SAO FELIPE D OESTE";91;4;29;124
2017;"SAO FRANCISCO DO GUAPORE (RO)";"RO";"SAO FRANCISCO DO GUAPORE";415;9;79;503
2017;"SAO MIGUEL DO GUAPORE (RO)";"RO";"SAO MIGUEL DO GUAPORE";302;14;73;389
2017;"SERINGUEIRAS (RO)";"RO";"SERINGUEIRAS";237;4;51;292
2017;"TEIXEIROPOLIS (RO)";"RO";"TEIXEIROPOLIS";65;1;15;81
2017;"THEOBROMA (RO)";"RO";"THEOBROMA";121;3;24;148
2017;"URUPA (RO)";"RO";"URUPA";131;3;108;242
2017;"VALE DO ANARI (RO)";"RO";"VALE DO ANARI";115;8;32;155
2017;"VALE DO PARAISO (RO)";"RO";"VALE DO PARAISO";112;2;23;137
2017;"VILHENA (RO)";"RO";"VILHENA";1668;69;178;1915
2017;"ALTO ALEGRE (RR)";"RR";"ALTO ALEGRE";73;12;17;102
2017;"AMAJARI (RR)";"RR";"AMAJARI";31;7;4;42
2017;"BOA VISTA (RR)";"RR";"BOA VISTA";3826;532;926;5284
2017;"BONFIM (RR)";"RR";"BONFIM";17;2;11;30
2017;"CANTA (RR)";"RR";"CANTA";64;10;13;87
2017;"CARACARAI (RR)";"RR";"CARACARAI";127;11;12;150
2017;"CAROEBE (RR)";"RR";"CAROEBE";65;9;31;105
2017;"IRACEMA (RR)";"RR";"IRACEMA";29;16;1;46
2017;"MUCAJAI (RR)";"RR";"MUCAJAI";129;44;47;220
2017;"NORMANDIA (RR)";"RR";"NORMANDIA";12;0;2;14
2017;"PACARAIMA (RR)";"RR";"PACARAIMA";185;4;12;201
2017;"RORAINOPOLIS (RR)";"RR";"RORAINOPOLIS";227;27;36;290
2017;"SAO JOAO DA BALIZA (RR)";"RR";"SAO JOAO DA BALIZA";53;5;8;66
2017;"SAO LUIZ (RR)";"RR";"SAO LUIZ";44;4;5;53
2017;"UIRAMUTA (RR)";"RR";"UIRAMUTA";2;0;0;2
2017;"ACEGUA (RS)";"RS";"ACEGUA";93;18;21;132
2017;"AGUA SANTA (RS)";"RS";"AGUA SANTA";210;13;23;246
2017;"AGUDO (RS)";"RS";"AGUDO";328;15;63;406
2017;"AJURICABA (RS)";"RS";"AJURICABA";452;24;31;507
2017;"ALECRIM (RS)";"RS";"ALECRIM";102;8;37;147
2017;"ALEGRETE (RS)";"RS";"ALEGRETE";1036;52;267;1355
2017;"ALEGRIA (RS)";"RS";"ALEGRIA";107;6;28;141
2017;"ALMIRANTE TAMANDARE DO SUL (RS)";"RS";"ALMIRANTE TAMANDARE DO SUL";117;13;5;135
2017;"ALPESTRE (RS)";"RS";"ALPESTRE";174;22;60;256
2017;"ALTO ALEGRE (RS)";"RS";"ALTO ALEGRE";115;6;7;128
2017;"ALTO FELIZ (RS)";"RS";"ALTO FELIZ";123;15;17;155
2017;"ALVORADA (RS)";"RS";"ALVORADA";1783;213;608;2604
2017;"AMARAL FERRADOR (RS)";"RS";"AMARAL FERRADOR";146;17;29;192
2017;"AMETISTA DO SUL (RS)";"RS";"AMETISTA DO SUL";96;8;45;149
2017;"ANDRE DA ROCHA (RS)";"RS";"ANDRE DA ROCHA";63;9;9;81
2017;"ANTA GORDA (RS)";"RS";"ANTA GORDA";278;24;23;325
2017;"ANTONIO PRADO (RS)";"RS";"ANTONIO PRADO";721;20;43;784
2017;"ARAMBARE (RS)";"RS";"ARAMBARE";97;6;14;117
2017;"ARARICA (RS)";"RS";"ARARICA";109;11;17;137
2017;"ARATIBA (RS)";"RS";"ARATIBA";205;35;43;283
2017;"ARROIO DO MEIO (RS)";"RS";"ARROIO DO MEIO";603;45;61;709
2017;"ARROIO DO PADRE (RS)";"RS";"ARROIO DO PADRE";129;4;14;147
2017;"ARROIO DO SAL (RS)";"RS";"ARROIO DO SAL";130;10;17;157
2017;"ARROIO DO TIGRE (RS)";"RS";"ARROIO DO TIGRE";320;31;51;402
2017;"ARROIO DOS RATOS (RS)";"RS";"ARROIO DOS RATOS";259;26;83;368
2017;"ARROIO GRANDE (RS)";"RS";"ARROIO GRANDE";301;26;77;404
2017;"ARVOREZINHA (RS)";"RS";"ARVOREZINHA";544;41;57;642
2017;"AUGUSTO PESTANA (RS)";"RS";"AUGUSTO PESTANA";530;15;38;583
2017;"AUREA (RS)";"RS";"AUREA";199;4;10;213
2017;"BAGE (RS)";"RS";"BAGE";1405;252;400;2057
2017;"BALNEARIO PINHAL (RS)";"RS";"BALNEARIO PINHAL";134;13;28;175
2017;"BARAO (RS)";"RS";"BARAO";204;24;52;280
2017;"BARAO DE COTEGIPE (RS)";"RS";"BARAO DE COTEGIPE";285;12;19;316
2017;"BARAO DO TRIUNFO (RS)";"RS";"BARAO DO TRIUNFO";135;17;65;217
2017;"BARRA DO GUARITA (RS)";"RS";"BARRA DO GUARITA";38;6;8;52
2017;"BARRA DO QUARAI (RS)";"RS";"BARRA DO QUARAI";41;5;15;61
2017;"BARRA DO RIBEIRO (RS)";"RS";"BARRA DO RIBEIRO";242;17;62;321
2017;"BARRA DO RIO AZUL (RS)";"RS";"BARRA DO RIO AZUL";38;10;11;59
2017;"BARRA FUNDA (RS)";"RS";"BARRA FUNDA";192;3;25;220
2017;"BARRACAO (RS)";"RS";"BARRACAO";171;8;23;202
2017;"BARROS CASSAL (RS)";"RS";"BARROS CASSAL";212;31;75;318
2017;"BENJAMIN CONSTANT DO SUL (RS)";"RS";"BENJAMIN CONSTANT DO SUL";29;4;16;49
2017;"BENTO GONCALVES (RS)";"RS";"BENTO GONCALVES";3313;290;371;3974
2017;"BOA VISTA DAS MISSOES (RS)";"RS";"BOA VISTA DAS MISSOES";112;4;13;129
2017;"BOA VISTA DO BURICA (RS)";"RS";"BOA VISTA DO BURICA";253;12;30;295
2017;"BOA VISTA DO CADEADO (RS)";"RS";"BOA VISTA DO CADEADO";145;2;20;167
2017;"BOA VISTA DO INCRA (RS)";"RS";"BOA VISTA DO INCRA";96;2;12;110
2017;"BOA VISTA DO SUL (RS)";"RS";"BOA VISTA DO SUL";343;10;14;367
2017;"BOM JESUS (RS)";"RS";"BOM JESUS";317;46;68;431
2017;"BOM PRINCIPIO (RS)";"RS";"BOM PRINCIPIO";512;37;40;589
2017;"BOM PROGRESSO (RS)";"RS";"BOM PROGRESSO";58;8;9;75
2017;"BOM RETIRO DO SUL (RS)";"RS";"BOM RETIRO DO SUL";214;15;56;285
2017;"BOQUEIRAO DO LEAO (RS)";"RS";"BOQUEIRAO DO LEAO";201;15;22;238
2017;"BOSSOROCA (RS)";"RS";"BOSSOROCA";229;6;23;258
2017;"BOZANO (RS)";"RS";"BOZANO";180;4;7;191
2017;"BRAGA (RS)";"RS";"BRAGA";103;5;22;130
2017;"BROCHIER (RS)";"RS";"BROCHIER";306;12;29;347
2017;"BUTIA (RS)";"RS";"BUTIA";468;49;160;677
2017;"CACAPAVA DO SUL (RS)";"RS";"CACAPAVA DO SUL";792;73;165;1030
2017;"CACEQUI (RS)";"RS";"CACEQUI";172;22;25;219
2017;"CACHOEIRA DO SUL (RS)";"RS";"CACHOEIRA DO SUL";1406;136;248;1790
2017;"CACHOEIRINHA (RS)";"RS";"CACHOEIRINHA";2368;238;545;3151
2017;"CACIQUE DOBLE (RS)";"RS";"CACIQUE DOBLE";132;4;14;150
2017;"CAIBATE (RS)";"RS";"CAIBATE";160;8;7;175
2017;"CAICARA (RS)";"RS";"CAICARA";100;9;21;130
2017;"CAMAQUA (RS)";"RS";"CAMAQUA";1455;76;280;1811
2017;"CAMARGO (RS)";"RS";"CAMARGO";271;5;21;297
2017;"CAMBARA DO SUL (RS)";"RS";"CAMBARA DO SUL";265;18;44;327
2017;"CAMPESTRE DA SERRA (RS)";"RS";"CAMPESTRE DA SERRA";198;4;16;218
2017;"CAMPINA DAS MISSOES (RS)";"RS";"CAMPINA DAS MISSOES";177;9;41;227
2017;"CAMPINAS DO SUL (RS)";"RS";"CAMPINAS DO SUL";224;15;26;265
2017;"CAMPO BOM (RS)";"RS";"CAMPO BOM";872;104;96;1072
2017;"CAMPO NOVO (RS)";"RS";"CAMPO NOVO";191;17;33;241
2017;"CAMPOS BORGES (RS)";"RS";"CAMPOS BORGES";179;14;21;214
2017;"CANDELARIA (RS)";"RS";"CANDELARIA";501;34;124;659
2017;"CANDIDO GODOI (RS)";"RS";"CANDIDO GODOI";299;15;21;335
2017;"CANDIOTA (RS)";"RS";"CANDIOTA";171;44;64;279
2017;"CANELA (RS)";"RS";"CANELA";615;109;124;848
2017;"CANGUCU (RS)";"RS";"CANGUCU";1333;142;241;1716
2017;"CANOAS (RS)";"RS";"CANOAS";4758;541;1064;6363
2017;"CANUDOS DO VALE (RS)";"RS";"CANUDOS DO VALE";25;17;5;47
2017;"CAPAO BONITO DO SUL (RS)";"RS";"CAPAO BONITO DO SUL";60;4;6;70
2017;"CAPAO DA CANOA (RS)";"RS";"CAPAO DA CANOA";574;77;129;780
2017;"CAPAO DO CIPO (RS)";"RS";"CAPAO DO CIPO";144;4;14;162
2017;"CAPAO DO LEAO (RS)";"RS";"CAPAO DO LEAO";537;30;36;603
2017;"CAPELA DE SANTANA (RS)";"RS";"CAPELA DE SANTANA";232;13;22;267
2017;"CAPITAO (RS)";"RS";"CAPITAO";79;5;12;96
2017;"CAPIVARI DO SUL (RS)";"RS";"CAPIVARI DO SUL";182;14;12;208
2017;"CARAA (RS)";"RS";"CARAA";119;10;29;158
2017;"CARAZINHO (RS)";"RS";"CARAZINHO";1429;97;215;1741
2017;"CARLOS BARBOSA (RS)";"RS";"CARLOS BARBOSA";924;52;143;1119
2017;"CARLOS GOMES (RS)";"RS";"CARLOS GOMES";42;4;8;54
2017;"CASCA (RS)";"RS";"CASCA";438;23;37;498
2017;"CASEIROS (RS)";"RS";"CASEIROS";195;9;17;221
2017;"CATUIPE (RS)";"RS";"CATUIPE";444;14;42;500
2017;"CAXIAS DO SUL (RS)";"RS";"CAXIAS DO SUL";9272;1530;1767;12569
2017;"CENTENARIO (RS)";"RS";"CENTENARIO";128;7;11;146
2017;"CERRITO (RS)";"RS";"CERRITO";244;17;22;283
2017;"CERRO BRANCO (RS)";"RS";"CERRO BRANCO";73;10;21;104
2017;"CERRO GRANDE (RS)";"RS";"CERRO GRANDE";53;1;13;67
2017;"CERRO GRANDE DO SUL (RS)";"RS";"CERRO GRANDE DO SUL";316;18;29;363
2017;"CERRO LARGO (RS)";"RS";"CERRO LARGO";395;12;39;446
2017;"CHAPADA (RS)";"RS";"CHAPADA";419;48;36;503
2017;"CHARQUEADAS (RS)";"RS";"CHARQUEADAS";415;85;127;627
2017;"CHARRUA (RS)";"RS";"CHARRUA";109;5;11;125
2017;"CHIAPETTA (RS)";"RS";"CHIAPETTA";172;9;15;196
2017;"CHUI (RS)";"RS";"CHUI";126;14;5;145
2017;"CHUVISCA (RS)";"RS";"CHUVISCA";146;7;38;191
2017;"CIDREIRA (RS)";"RS";"CIDREIRA";107;17;42;166
2017;"CIRIACO (RS)";"RS";"CIRIACO";179;13;22;214
2017;"COLINAS (RS)";"RS";"COLINAS";68;10;11;89
2017;"COLORADO (RS)";"RS";"COLORADO";262;16;14;292
2017;"CONDOR (RS)";"RS";"CONDOR";313;21;39;373
2017;"CONSTANTINA (RS)";"RS";"CONSTANTINA";442;20;91;553
2017;"COQUEIRO BAIXO (RS)";"RS";"COQUEIRO BAIXO";21;5;5;31
2017;"COQUEIROS DO SUL (RS)";"RS";"COQUEIROS DO SUL";154;8;10;172
2017;"CORONEL BARROS (RS)";"RS";"CORONEL BARROS";134;0;9;143
2017;"CORONEL BICACO (RS)";"RS";"CORONEL BICACO";266;16;28;310
2017;"CORONEL PILAR (RS)";"RS";"CORONEL PILAR";229;10;6;245
2017;"COTIPORA (RS)";"RS";"COTIPORA";280;9;15;304
2017;"COXILHA (RS)";"RS";"COXILHA";148;6;17;171
2017;"CRISSIUMAL (RS)";"RS";"CRISSIUMAL";362;19;52;433
2017;"CRISTAL (RS)";"RS";"CRISTAL";262;12;63;337
2017;"CRISTAL DO SUL (RS)";"RS";"CRISTAL DO SUL";60;10;20;90
2017;"CRUZ ALTA (RS)";"RS";"CRUZ ALTA";1296;110;148;1554
2017;"CRUZALTENSE (RS)";"RS";"CRUZALTENSE";76;6;11;93
2017;"CRUZEIRO DO SUL (RS)";"RS";"CRUZEIRO DO SUL";506;11;22;539
2017;"DAVID CANABARRO (RS)";"RS";"DAVID CANABARRO";191;10;28;229
2017;"DERRUBADAS (RS)";"RS";"DERRUBADAS";124;6;17;147
2017;"DEZESSEIS DE NOVEMBRO (RS)";"RS";"DEZESSEIS DE NOVEMBRO";65;6;9;80
2017;"DILERMANDO DE AGUIAR (RS)";"RS";"DILERMANDO DE AGUIAR";49;1;28;78
2017;"DOIS IRMAOS (RS)";"RS";"DOIS IRMAOS";499;28;115;642
2017;"DOIS IRMAOS DAS MISSOES (RS)";"RS";"DOIS IRMAOS DAS MISSOES";83;6;7;96
2017;"DOIS LAJEADOS (RS)";"RS";"DOIS LAJEADOS";155;5;18;178
2017;"DOM FELICIANO (RS)";"RS";"DOM FELICIANO";264;16;95;375
2017;"DOM PEDRITO (RS)";"RS";"DOM PEDRITO";683;45;50;778
2017;"DOM PEDRO DE ALCANTARA (RS)";"RS";"DOM PEDRO DE ALCANTARA";123;4;7;134
2017;"DONA FRANCISCA (RS)";"RS";"DONA FRANCISCA";53;3;7;63
2017;"DOUTOR MAURICIO CARDOSO (RS)";"RS";"DOUTOR MAURICIO CARDOSO";233;16;17;266
2017;"DOUTOR RICARDO (RS)";"RS";"DOUTOR RICARDO";73;9;7;89
2017;"ELDORADO DO SUL (RS)";"RS";"ELDORADO DO SUL";788;46;73;907
2017;"ENCANTADO (RS)";"RS";"ENCANTADO";727;62;127;916
2017;"ENCRUZILHADA DO SUL (RS)";"RS";"ENCRUZILHADA DO SUL";466;28;212;706
2017;"ENGENHO VELHO (RS)";"RS";"ENGENHO VELHO";43;2;14;59
2017;"ENTRE IJUIS (RS)";"RS";"ENTRE IJUIS";426;11;29;466
2017;"ENTRE RIOS DO SUL (RS)";"RS";"ENTRE RIOS DO SUL";70;14;20;104
2017;"EREBANGO (RS)";"RS";"EREBANGO";136;3;4;143
2017;"ERECHIM (RS)";"RS";"ERECHIM";2208;343;519;3070
2017;"ERNESTINA (RS)";"RS";"ERNESTINA";176;20;17;213
2017;"ERVAL GRANDE (RS)";"RS";"ERVAL GRANDE";146;27;27;200
2017;"ERVAL SECO (RS)";"RS";"ERVAL SECO";176;6;41;223
2017;"ESMERALDA (RS)";"RS";"ESMERALDA";112;2;18;132
2017;"ESPERANCA DO SUL (RS)";"RS";"ESPERANCA DO SUL";66;3;16;85
2017;"ESPUMOSO (RS)";"RS";"ESPUMOSO";839;50;87;976
2017;"ESTACAO (RS)";"RS";"ESTACAO";240;13;23;276
2017;"ESTANCIA VELHA (RS)";"RS";"ESTANCIA VELHA";891;86;118;1095
2017;"ESTEIO (RS)";"RS";"ESTEIO";1076;125;276;1477
2017;"ESTRELA (RS)";"RS";"ESTRELA";1137;49;72;1258
2017;"ESTRELA VELHA (RS)";"RS";"ESTRELA VELHA";153;8;23;184
2017;"EUGENIO DE CASTRO (RS)";"RS";"EUGENIO DE CASTRO";113;10;14;137
2017;"FAGUNDES VARELA (RS)";"RS";"FAGUNDES VARELA";129;4;20;153
2017;"FARROUPILHA (RS)";"RS";"FARROUPILHA";2360;261;231;2852
2017;"FAXINAL DO SOTURNO (RS)";"RS";"FAXINAL DO SOTURNO";165;4;17;186
2017;"FAXINALZINHO (RS)";"RS";"FAXINALZINHO";67;7;12;86
2017;"FAZENDA VILANOVA (RS)";"RS";"FAZENDA VILANOVA";162;10;28;200
2017;"FELIZ (RS)";"RS";"FELIZ";468;37;93;598
2017;"FLORES DA CUNHA (RS)";"RS";"FLORES DA CUNHA";1648;76;139;1863
2017;"FLORIANO PEIXOTO (RS)";"RS";"FLORIANO PEIXOTO";77;9;21;107
2017;"FONTOURA XAVIER (RS)";"RS";"FONTOURA XAVIER";245;25;56;326
2017;"FORMIGUEIRO (RS)";"RS";"FORMIGUEIRO";198;2;25;225
2017;"FORQUETINHA (RS)";"RS";"FORQUETINHA";71;5;4;80
2017;"FORTALEZA DOS VALOS (RS)";"RS";"FORTALEZA DOS VALOS";293;5;20;318
2017;"FREDERICO WESTPHALEN (RS)";"RS";"FREDERICO WESTPHALEN";849;47;102;998
2017;"GARIBALDI (RS)";"RS";"GARIBALDI";1452;96;140;1688
2017;"GARRUCHOS (RS)";"RS";"GARRUCHOS";54;9;17;80
2017;"GAURAMA (RS)";"RS";"GAURAMA";246;27;21;294
2017;"GENERAL CAMARA (RS)";"RS";"GENERAL CAMARA";118;12;35;165
2017;"GENTIL (RS)";"RS";"GENTIL";111;9;18;138
2017;"GETULIO VARGAS (RS)";"RS";"GETULIO VARGAS";538;41;46;625
2017;"GIRUA (RS)";"RS";"GIRUA";633;52;53;738
2017;"GLORINHA (RS)";"RS";"GLORINHA";217;25;15;257
2017;"GRAMADO (RS)";"RS";"GRAMADO";735;155;153;1043
2017;"GRAMADO DOS LOUREIROS (RS)";"RS";"GRAMADO DOS LOUREIROS";49;4;13;66
2017;"GRAMADO XAVIER (RS)";"RS";"GRAMADO XAVIER";72;7;10;89
2017;"GRAVATAI (RS)";"RS";"GRAVATAI";3724;555;671;4950
2017;"GUABIJU (RS)";"RS";"GUABIJU";53;7;9;69
2017;"GUAIBA (RS)";"RS";"GUAIBA";1145;246;459;1850
2017;"GUAPORE (RS)";"RS";"GUAPORE";532;47;91;670
2017;"GUARANI DAS MISSOES (RS)";"RS";"GUARANI DAS MISSOES";298;5;36;339
2017;"HARMONIA (RS)";"RS";"HARMONIA";260;10;8;278
2017;"HERVAL (RS)";"RS";"HERVAL";126;16;15;157
2017;"HERVEIRAS (RS)";"RS";"HERVEIRAS";64;2;3;69
2017;"HORIZONTINA (RS)";"RS";"HORIZONTINA";440;37;65;542
2017;"HULHA NEGRA (RS)";"RS";"HULHA NEGRA";96;8;28;132
2017;"HUMAITA (RS)";"RS";"HUMAITA";170;15;10;195
2017;"IBARAMA (RS)";"RS";"IBARAMA";101;6;19;126
2017;"IBIACA (RS)";"RS";"IBIACA";300;10;31;341
2017;"IBIRAIARAS (RS)";"RS";"IBIRAIARAS";538;13;32;583
2017;"IBIRAPUITA (RS)";"RS";"IBIRAPUITA";154;13;54;221
2017;"IBIRUBA (RS)";"RS";"IBIRUBA";1077;63;98;1238
2017;"IGREJINHA (RS)";"RS";"IGREJINHA";538;43;84;665
2017;"IJUI (RS)";"RS";"IJUI";2004;163;138;2305
2017;"ILOPOLIS (RS)";"RS";"ILOPOLIS";247;11;14;272
2017;"IMBE (RS)";"RS";"IMBE";316;25;69;410
2017;"IMIGRANTE (RS)";"RS";"IMIGRANTE";111;15;19;145
2017;"INDEPENDENCIA (RS)";"RS";"INDEPENDENCIA";294;13;52;359
2017;"INHACORA (RS)";"RS";"INHACORA";76;6;9;91
2017;"IPE (RS)";"RS";"IPE";318;32;34;384
2017;"IPIRANGA DO SUL (RS)";"RS";"IPIRANGA DO SUL";143;10;14;167
2017;"IRAI (RS)";"RS";"IRAI";157;9;24;190
2017;"ITAARA (RS)";"RS";"ITAARA";138;7;23;168
2017;"ITACURUBI (RS)";"RS";"ITACURUBI";58;9;14;81
2017;"ITAPUCA (RS)";"RS";"ITAPUCA";69;6;10;85
2017;"ITAQUI (RS)";"RS";"ITAQUI";719;33;103;855
2017;"ITATI (RS)";"RS";"ITATI";82;3;9;94
2017;"ITATIBA DO SUL (RS)";"RS";"ITATIBA DO SUL";85;12;12;109
2017;"IVORA (RS)";"RS";"IVORA";83;5;8;96
2017;"IVOTI (RS)";"RS";"IVOTI";581;53;111;745
2017;"JABOTICABA (RS)";"RS";"JABOTICABA";98;6;29;133
2017;"JACUIZINHO (RS)";"RS";"JACUIZINHO";77;3;17;97
2017;"JACUTINGA (RS)";"RS";"JACUTINGA";134;8;10;152
2017;"JAGUARAO (RS)";"RS";"JAGUARAO";352;28;56;436
2017;"JAGUARI (RS)";"RS";"JAGUARI";332;30;65;427
2017;"JAQUIRANA (RS)";"RS";"JAQUIRANA";167;13;19;199
2017;"JARI (RS)";"RS";"JARI";102;7;17;126
2017;"JOIA (RS)";"RS";"JOIA";390;20;52;462
2017;"JULIO DE CASTILHOS (RS)";"RS";"JULIO DE CASTILHOS";701;28;78;807
2017;"LAGOA BONITA DO SUL (RS)";"RS";"LAGOA BONITA DO SUL";63;10;14;87
2017;"LAGOA DOS TRES CANTOS (RS)";"RS";"LAGOA DOS TRES CANTOS";111;6;6;123
2017;"LAGOA VERMELHA (RS)";"RS";"LAGOA VERMELHA";735;75;88;898
2017;"LAGOAO (RS)";"RS";"LAGOAO";108;9;44;161
2017;"LAJEADO (RS)";"RS";"LAJEADO";2340;171;279;2790
2017;"LAJEADO DO BUGRE (RS)";"RS";"LAJEADO DO BUGRE";32;5;16;53
2017;"LAVRAS DO SUL (RS)";"RS";"LAVRAS DO SUL";114;11;29;154
2017;"LIBERATO SALZANO (RS)";"RS";"LIBERATO SALZANO";145;5;34;184
2017;"LINDOLFO COLLOR (RS)";"RS";"LINDOLFO COLLOR";136;15;20;171
2017;"LINHA NOVA (RS)";"RS";"LINHA NOVA";84;12;5;101
2017;"MACAMBARA (RS)";"RS";"MACAMBARA";45;3;38;86
2017;"MACHADINHO (RS)";"RS";"MACHADINHO";150;10;28;188
2017;"MAMPITUBA (RS)";"RS";"MAMPITUBA";29;3;13;45
2017;"MANOEL VIANA (RS)";"RS";"MANOEL VIANA";196;8;17;221
2017;"MAQUINE (RS)";"RS";"MAQUINE";270;16;21;307
2017;"MARATA (RS)";"RS";"MARATA";137;10;24;171
2017;"MARAU (RS)";"RS";"MARAU";1213;103;205;1521
2017;"MARCELINO RAMOS (RS)";"RS";"MARCELINO RAMOS";137;24;32;193
2017;"MARIANA PIMENTEL (RS)";"RS";"MARIANA PIMENTEL";162;13;30;205
2017;"MARIANO MORO (RS)";"RS";"MARIANO MORO";78;12;13;103
2017;"MARQUES DE SOUZA (RS)";"RS";"MARQUES DE SOUZA";136;13;19;168
2017;"MATA (RS)";"RS";"MATA";122;8;26;156
2017;"MATO CASTELHANO (RS)";"RS";"MATO CASTELHANO";156;21;22;199
2017;"MATO LEITAO (RS)";"RS";"MATO LEITAO";155;11;11;177
2017;"MATO QUEIMADO (RS)";"RS";"MATO QUEIMADO";101;7;7;115
2017;"MAXIMILIANO DE ALMEIDA (RS)";"RS";"MAXIMILIANO DE ALMEIDA";165;18;65;248
2017;"MINAS DO LEAO (RS)";"RS";"MINAS DO LEAO";119;15;36;170
2017;"MIRAGUAI (RS)";"RS";"MIRAGUAI";121;5;34;160
2017;"MONTAURI (RS)";"RS";"MONTAURI";76;3;5;84
2017;"MONTE ALEGRE DOS CAMPOS (RS)";"RS";"MONTE ALEGRE DOS CAMPOS";112;6;30;148
2017;"MONTE BELO DO SUL (RS)";"RS";"MONTE BELO DO SUL";278;5;21;304
2017;"MONTENEGRO (RS)";"RS";"MONTENEGRO";1457;161;194;1812
2017;"MORMACO (RS)";"RS";"MORMACO";108;5;12;125
2017;"MORRINHOS DO SUL (RS)";"RS";"MORRINHOS DO SUL";169;2;7;178
2017;"MORRO REDONDO (RS)";"RS";"MORRO REDONDO";256;6;27;289
2017;"MORRO REUTER (RS)";"RS";"MORRO REUTER";203;13;24;240
2017;"MOSTARDAS (RS)";"RS";"MOSTARDAS";362;16;70;448
2017;"MUCUM (RS)";"RS";"MUCUM";96;13;18;127
2017;"MUITOS CAPOES (RS)";"RS";"MUITOS CAPOES";110;5;6;121
2017;"MULITERNO (RS)";"RS";"MULITERNO";113;4;10;127
2017;"NAO ME TOQUE (RS)";"RS";"NAO ME TOQUE";614;47;71;732
2017;"NICOLAU VERGUEIRO (RS)";"RS";"NICOLAU VERGUEIRO";117;6;18;141
2017;"NONOAI (RS)";"RS";"NONOAI";259;18;61;338
2017;"NOVA ALVORADA (RS)";"RS";"NOVA ALVORADA";206;6;18;230
2017;"NOVA ARACA (RS)";"RS";"NOVA ARACA";163;16;41;220
2017;"NOVA BASSANO (RS)";"RS";"NOVA BASSANO";548;32;59;639
2017;"NOVA BOA VISTA (RS)";"RS";"NOVA BOA VISTA";96;10;12;118
2017;"NOVA BRESCIA (RS)";"RS";"NOVA BRESCIA";151;11;14;176
2017;"NOVA CANDELARIA (RS)";"RS";"NOVA CANDELARIA";91;5;9;105
2017;"NOVA ESPERANCA DO SUL (RS)";"RS";"NOVA ESPERANCA DO SUL";104;14;38;156
2017;"NOVA HARTZ (RS)";"RS";"NOVA HARTZ";206;31;140;377
2017;"NOVA PADUA (RS)";"RS";"NOVA PADUA";364;3;6;373
2017;"NOVA PALMA (RS)";"RS";"NOVA PALMA";319;17;39;375
2017;"NOVA PETROPOLIS (RS)";"RS";"NOVA PETROPOLIS";569;38;70;677
2017;"NOVA PRATA (RS)";"RS";"NOVA PRATA";707;25;84;816
2017;"NOVA RAMADA (RS)";"RS";"NOVA RAMADA";144;11;11;166
2017;"NOVA ROMA DO SUL (RS)";"RS";"NOVA ROMA DO SUL";346;7;30;383
2017;"NOVA SANTA RITA (RS)";"RS";"NOVA SANTA RITA";1065;54;62;1181
2017;"NOVO BARREIRO (RS)";"RS";"NOVO BARREIRO";168;7;14;189
2017;"NOVO CABRAIS (RS)";"RS";"NOVO CABRAIS";112;4;9;125
2017;"NOVO HAMBURGO (RS)";"RS";"NOVO HAMBURGO";3315;336;505;4156
2017;"NOVO MACHADO (RS)";"RS";"NOVO MACHADO";204;18;17;239
2017;"NOVO TIRADENTES (RS)";"RS";"NOVO TIRADENTES";52;4;8;64
2017;"NOVO XINGU (RS)";"RS";"NOVO XINGU";53;10;10;73
2017;"OSORIO (RS)";"RS";"OSORIO";994;67;107;1168
2017;"PAIM FILHO (RS)";"RS";"PAIM FILHO";151;5;30;186
2017;"PALMARES DO SUL (RS)";"RS";"PALMARES DO SUL";203;21;53;277
2017;"PALMEIRA DAS MISSOES (RS)";"RS";"PALMEIRA DAS MISSOES";1080;33;108;1221
2017;"PALMITINHO (RS)";"RS";"PALMITINHO";238;19;55;312
2017;"PANAMBI (RS)";"RS";"PANAMBI";1139;72;140;1351
2017;"PANTANO GRANDE (RS)";"RS";"PANTANO GRANDE";351;12;37;400
2017;"PARAI (RS)";"RS";"PARAI";574;13;19;606
2017;"PARAISO DO SUL (RS)";"RS";"PARAISO DO SUL";114;8;23;145
2017;"PARECI NOVO (RS)";"RS";"PARECI NOVO";456;9;18;483
2017;"PAROBE (RS)";"RS";"PAROBE";655;89;197;941
2017;"PASSA SETE (RS)";"RS";"PASSA SETE";108;4;35;147
2017;"PASSO DO SOBRADO (RS)";"RS";"PASSO DO SOBRADO";154;7;50;211
2017;"PASSO FUNDO (RS)";"RS";"PASSO FUNDO";3803;270;436;4509
2017;"PAULO BENTO (RS)";"RS";"PAULO BENTO";101;16;10;127
2017;"PAVERAMA (RS)";"RS";"PAVERAMA";225;47;48;320
2017;"PEDRAS ALTAS (RS)";"RS";"PEDRAS ALTAS";26;15;8;49
2017;"PEDRO OSORIO (RS)";"RS";"PEDRO OSORIO";129;14;34;177
2017;"PEJUCARA (RS)";"RS";"PEJUCARA";255;4;17;276
2017;"PELOTAS (RS)";"RS";"PELOTAS";5831;469;1245;7545
2017;"PICADA CAFE (RS)";"RS";"PICADA CAFE";110;23;57;190
2017;"PINHAL (RS)";"RS";"PINHAL";122;2;10;134
2017;"PINHAL DA SERRA (RS)";"RS";"PINHAL DA SERRA";66;11;21;98
2017;"PINHAL GRANDE (RS)";"RS";"PINHAL GRANDE";156;12;31;199
2017;"PINHEIRINHO DO VALE (RS)";"RS";"PINHEIRINHO DO VALE";62;5;28;95
2017;"PINHEIRO MACHADO (RS)";"RS";"PINHEIRO MACHADO";176;14;55;245
2017;"PINTO BANDEIRA (RS)";"RS";"PINTO BANDEIRA";129;10;6;145
2017;"PIRAPO (RS)";"RS";"PIRAPO";46;8;14;68
2017;"PIRATINI (RS)";"RS";"PIRATINI";316;57;147;520
2017;"PLANALTO (RS)";"RS";"PLANALTO";254;9;39;302
2017;"POCO DAS ANTAS (RS)";"RS";"POCO DAS ANTAS";119;11;17;147
2017;"PONTAO (RS)";"RS";"PONTAO";173;4;23;200
2017;"PONTE PRETA (RS)";"RS";"PONTE PRETA";82;8;12;102
2017;"PORTAO (RS)";"RS";"PORTAO";1680;126;133;1939
2017;"PORTO ALEGRE (RS)";"RS";"PORTO ALEGRE";16279;2363;5209;23851
2017;"PORTO LUCENA (RS)";"RS";"PORTO LUCENA";106;15;18;139
2017;"PORTO MAUA (RS)";"RS";"PORTO MAUA";65;5;7;77
2017;"PORTO VERA CRUZ (RS)";"RS";"PORTO VERA CRUZ";17;4;11;32
2017;"PORTO XAVIER (RS)";"RS";"PORTO XAVIER";214;28;51;293
2017;"POUSO NOVO (RS)";"RS";"POUSO NOVO";48;10;10;68
2017;"PRESIDENTE LUCENA (RS)";"RS";"PRESIDENTE LUCENA";190;7;18;215
2017;"PROGRESSO (RS)";"RS";"PROGRESSO";126;16;33;175
2017;"PROTASIO ALVES (RS)";"RS";"PROTASIO ALVES";51;5;8;64
2017;"PUTINGA (RS)";"RS";"PUTINGA";139;10;11;160
2017;"QUARAI (RS)";"RS";"QUARAI";232;31;60;323
2017;"QUATRO IRMAOS (RS)";"RS";"QUATRO IRMAOS";65;12;7;84
2017;"QUEVEDOS (RS)";"RS";"QUEVEDOS";59;12;10;81
2017;"QUINZE DE NOVEMBRO (RS)";"RS";"QUINZE DE NOVEMBRO";238;31;35;304
2017;"REDENTORA (RS)";"RS";"REDENTORA";127;20;20;167
2017;"RELVADO (RS)";"RS";"RELVADO";55;10;4;69
2017;"RESTINGA SECA (RS)";"RS";"RESTINGA SECA";363;16;61;440
2017;"RIO DOS INDIOS (RS)";"RS";"RIO DOS INDIOS";95;6;29;130
2017;"RIO GRANDE (RS)";"RS";"RIO GRANDE";2490;263;811;3564
2017;"RIO PARDO (RS)";"RS";"RIO PARDO";566;78;121;765
2017;"RIOZINHO (RS)";"RS";"RIOZINHO";56;12;30;98
2017;"ROCA SALES (RS)";"RS";"ROCA SALES";187;23;41;251
2017;"RODEIO BONITO (RS)";"RS";"RODEIO BONITO";189;9;36;234
2017;"ROLADOR (RS)";"RS";"ROLADOR";67;4;6;77
2017;"ROLANTE (RS)";"RS";"ROLANTE";306;36;108;450
2017;"RONDA ALTA (RS)";"RS";"RONDA ALTA";350;14;39;403
2017;"RONDINHA (RS)";"RS";"RONDINHA";200;12;22;234
2017;"ROQUE GONZALES (RS)";"RS";"ROQUE GONZALES";165;7;30;202
2017;"ROSARIO DO SUL (RS)";"RS";"ROSARIO DO SUL";591;61;109;761
2017;"SAGRADA FAMILIA (RS)";"RS";"SAGRADA FAMILIA";46;5;8;59
2017;"SALDANHA MARINHO (RS)";"RS";"SALDANHA MARINHO";183;7;7;197
2017;"SALTO DO JACUI (RS)";"RS";"SALTO DO JACUI";246;27;35;308
2017;"SALVADOR DAS MISSOES (RS)";"RS";"SALVADOR DAS MISSOES";133;4;8;145
2017;"SALVADOR DO SUL (RS)";"RS";"SALVADOR DO SUL";324;21;32;377
2017;"SANANDUVA (RS)";"RS";"SANANDUVA";758;34;80;872
2017;"SANTA BARBARA DO SUL (RS)";"RS";"SANTA BARBARA DO SUL";403;19;34;456
2017;"SANTA CECILIA DO SUL (RS)";"RS";"SANTA CECILIA DO SUL";83;4;17;104
2017;"SANTA CLARA DO SUL (RS)";"RS";"SANTA CLARA DO SUL";138;27;15;180
2017;"SANTA CRUZ DO SUL (RS)";"RS";"SANTA CRUZ DO SUL";2309;184;630;3123
2017;"SANTA MARGARIDA DO SUL (RS)";"RS";"SANTA MARGARIDA DO SUL";69;5;12;86
2017;"SANTA MARIA (RS)";"RS";"SANTA MARIA";3859;431;1100;5390
2017;"SANTA MARIA DO HERVAL (RS)";"RS";"SANTA MARIA DO HERVAL";265;27;61;353
2017;"SANTA ROSA (RS)";"RS";"SANTA ROSA";1782;102;223;2107
2017;"SANTA TEREZA (RS)";"RS";"SANTA TEREZA";113;5;5;123
2017;"SANTA VITORIA DO PALMAR (RS)";"RS";"SANTA VITORIA DO PALMAR";688;25;75;788
2017;"SANTANA DA BOA VISTA (RS)";"RS";"SANTANA DA BOA VISTA";108;22;50;180
2017;"SANTANA DO LIVRAMENTO (RS)";"RS";"SANTANA DO LIVRAMENTO";921;124;252;1297
2017;"SANTIAGO (RS)";"RS";"SANTIAGO";1026;131;116;1273
2017;"SANTO ANGELO (RS)";"RS";"SANTO ANGELO";1414;107;128;1649
2017;"SANTO ANTONIO DA PATRULHA (RS)";"RS";"SANTO ANTONIO DA PATRULHA";1035;66;206;1307
2017;"SANTO ANTONIO DAS MISSOES (RS)";"RS";"SANTO ANTONIO DAS MISSOES";277;66;53;396
2017;"SANTO ANTONIO DO PALMA (RS)";"RS";"SANTO ANTONIO DO PALMA";66;4;15;85
2017;"SANTO ANTONIO DO PLANALTO (RS)";"RS";"SANTO ANTONIO DO PLANALTO";110;3;9;122
2017;"SANTO AUGUSTO (RS)";"RS";"SANTO AUGUSTO";596;50;37;683
2017;"SANTO CRISTO (RS)";"RS";"SANTO CRISTO";591;24;57;672
2017;"SANTO EXPEDITO DO SUL (RS)";"RS";"SANTO EXPEDITO DO SUL";118;2;12;132
2017;"SAO BORJA (RS)";"RS";"SAO BORJA";1205;74;124;1403
2017;"SAO DOMINGOS DO SUL (RS)";"RS";"SAO DOMINGOS DO SUL";127;6;16;149
2017;"SAO FRANCISCO DE ASSIS (RS)";"RS";"SAO FRANCISCO DE ASSIS";391;43;123;557
2017;"SAO FRANCISCO DE PAULA (RS)";"RS";"SAO FRANCISCO DE PAULA";617;51;86;754
2017;"SAO GABRIEL (RS)";"RS";"SAO GABRIEL";987;44;142;1173
2017;"SAO JERONIMO (RS)";"RS";"SAO JERONIMO";341;31;125;497
2017;"SAO JOAO DA URTIGA (RS)";"RS";"SAO JOAO DA URTIGA";178;6;21;205
2017;"SAO JOAO DO POLESINE (RS)";"RS";"SAO JOAO DO POLESINE";97;1;6;104
2017;"SAO JORGE (RS)";"RS";"SAO JORGE";159;7;17;183
2017;"SAO JOSE DAS MISSOES (RS)";"RS";"SAO JOSE DAS MISSOES";47;5;9;61
2017;"SAO JOSE DO HERVAL (RS)";"RS";"SAO JOSE DO HERVAL";81;3;13;97
2017;"SAO JOSE DO HORTENCIO (RS)";"RS";"SAO JOSE DO HORTENCIO";207;11;32;250
2017;"SAO JOSE DO INHACORA (RS)";"RS";"SAO JOSE DO INHACORA";61;5;7;73
2017;"SAO JOSE DO NORTE (RS)";"RS";"SAO JOSE DO NORTE";445;16;125;586
2017;"SAO JOSE DO OURO (RS)";"RS";"SAO JOSE DO OURO";378;8;49;435
2017;"SAO JOSE DO SUL (RS)";"RS";"SAO JOSE DO SUL";161;7;14;182
2017;"SAO JOSE DOS AUSENTES (RS)";"RS";"SAO JOSE DOS AUSENTES";133;9;25;167
2017;"SAO LEOPOLDO (RS)";"RS";"SAO LEOPOLDO";2372;304;404;3080
2017;"SAO LOURENCO DO SUL (RS)";"RS";"SAO LOURENCO DO SUL";1071;60;163;1294
2017;"SAO LUIZ GONZAGA (RS)";"RS";"SAO LUIZ GONZAGA";719;78;104;901
2017;"SAO MARCOS (RS)";"RS";"SAO MARCOS";813;33;130;976
2017;"SAO MARTINHO (RS)";"RS";"SAO MARTINHO";275;8;23;306
2017;"SAO MARTINHO DA SERRA (RS)";"RS";"SAO MARTINHO DA SERRA";71;7;7;85
2017;"SAO MIGUEL DAS MISSOES (RS)";"RS";"SAO MIGUEL DAS MISSOES";299;26;43;368
2017;"SAO NICOLAU (RS)";"RS";"SAO NICOLAU";90;10;18;118
2017;"SAO PAULO DAS MISSOES (RS)";"RS";"SAO PAULO DAS MISSOES";126;7;38;171
2017;"SAO PEDRO DA SERRA (RS)";"RS";"SAO PEDRO DA SERRA";115;12;18;145
2017;"SAO PEDRO DAS MISSOES (RS)";"RS";"SAO PEDRO DAS MISSOES";50;5;8;63
2017;"SAO PEDRO DO BUTIA (RS)";"RS";"SAO PEDRO DO BUTIA";146;3;16;165
2017;"SAO PEDRO DO SUL (RS)";"RS";"SAO PEDRO DO SUL";355;53;52;460
2017;"SAO SEBASTIAO DO CAI (RS)";"RS";"SAO SEBASTIAO DO CAI";806;38;68;912
2017;"SAO SEPE (RS)";"RS";"SAO SEPE";519;61;126;706
2017;"SAO VALENTIM (RS)";"RS";"SAO VALENTIM";77;14;13;104
2017;"SAO VALENTIM DO SUL (RS)";"RS";"SAO VALENTIM DO SUL";86;7;10;103
2017;"SAO VALERIO DO SUL (RS)";"RS";"SAO VALERIO DO SUL";46;2;9;57
2017;"SAO VENDELINO (RS)";"RS";"SAO VENDELINO";81;14;11;106
2017;"SAO VICENTE DO SUL (RS)";"RS";"SAO VICENTE DO SUL";161;9;58;228
2017;"SAPIRANGA (RS)";"RS";"SAPIRANGA";985;101;197;1283
2017;"SAPUCAIA DO SUL (RS)";"RS";"SAPUCAIA DO SUL";1796;154;144;2094
2017;"SARANDI (RS)";"RS";"SARANDI";661;33;76;770
2017;"SEBERI (RS)";"RS";"SEBERI";358;10;62;430
2017;"SEDE NOVA (RS)";"RS";"SEDE NOVA";121;10;13;144
2017;"SEGREDO (RS)";"RS";"SEGREDO";219;7;53;279
2017;"SELBACH (RS)";"RS";"SELBACH";360;16;23;399
2017;"SENADOR SALGADO FILHO (RS)";"RS";"SENADOR SALGADO FILHO";156;12;14;182
2017;"SENTINELA DO SUL (RS)";"RS";"SENTINELA DO SUL";184;2;17;203
2017;"SERAFINA CORREA (RS)";"RS";"SERAFINA CORREA";402;44;77;523
2017;"SERIO (RS)";"RS";"SERIO";67;4;6;77
2017;"SERTAO (RS)";"RS";"SERTAO";301;20;45;366
2017;"SERTAO SANTANA (RS)";"RS";"SERTAO SANTANA";180;4;28;212
2017;"SETE DE SETEMBRO (RS)";"RS";"SETE DE SETEMBRO";99;4;11;114
2017;"SEVERIANO DE ALMEIDA (RS)";"RS";"SEVERIANO DE ALMEIDA";122;15;15;152
2017;"SILVEIRA MARTINS (RS)";"RS";"SILVEIRA MARTINS";139;2;10;151
2017;"SINIMBU (RS)";"RS";"SINIMBU";147;4;6;157
2017;"SOBRADINHO (RS)";"RS";"SOBRADINHO";345;15;55;415
2017;"SOLEDADE (RS)";"RS";"SOLEDADE";686;49;142;877
2017;"TABAI (RS)";"RS";"TABAI";222;16;18;256
2017;"TAPEJARA (RS)";"RS";"TAPEJARA";891;42;131;1064
2017;"TAPERA (RS)";"RS";"TAPERA";448;29;33;510
2017;"TAPES (RS)";"RS";"TAPES";306;23;36;365
2017;"TAQUARA (RS)";"RS";"TAQUARA";903;65;274;1242
2017;"TAQUARI (RS)";"RS";"TAQUARI";479;46;167;692
2017;"TAQUARUCU DO SUL (RS)";"RS";"TAQUARUCU DO SUL";78;3;13;94
2017;"TAVARES (RS)";"RS";"TAVARES";166;20;24;210
2017;"TENENTE PORTELA (RS)";"RS";"TENENTE PORTELA";335;19;64;418
2017;"TERRA DE AREIA (RS)";"RS";"TERRA DE AREIA";357;13;37;407
2017;"TEUTONIA (RS)";"RS";"TEUTONIA";766;34;109;909
2017;"TIO HUGO (RS)";"RS";"TIO HUGO";147;8;17;172
2017;"TIRADENTES DO SUL (RS)";"RS";"TIRADENTES DO SUL";132;6;13;151
2017;"TOROPI (RS)";"RS";"TOROPI";70;10;20;100
2017;"TORRES (RS)";"RS";"TORRES";490;29;108;627
2017;"TRAMANDAI (RS)";"RS";"TRAMANDAI";706;107;174;987
2017;"TRAVESSEIRO (RS)";"RS";"TRAVESSEIRO";45;11;13;69
2017;"TRES ARROIOS (RS)";"RS";"TRES ARROIOS";123;11;5;139
2017;"TRES CACHOEIRAS (RS)";"RS";"TRES CACHOEIRAS";640;15;28;683
2017;"TRES COROAS (RS)";"RS";"TRES COROAS";300;40;82;422
2017;"TRES DE MAIO (RS)";"RS";"TRES DE MAIO";811;48;88;947
2017;"TRES FORQUILHAS (RS)";"RS";"TRES FORQUILHAS";104;1;7;112
2017;"TRES PALMEIRAS (RS)";"RS";"TRES PALMEIRAS";95;5;31;131
2017;"TRES PASSOS (RS)";"RS";"TRES PASSOS";558;29;137;724
2017;"TRINDADE DO SUL (RS)";"RS";"TRINDADE DO SUL";146;20;25;191
2017;"TRIUNFO (RS)";"RS";"TRIUNFO";637;130;271;1038
2017;"TUCUNDUVA (RS)";"RS";"TUCUNDUVA";289;15;15;319
2017;"TUNAS (RS)";"RS";"TUNAS";73;7;24;104
2017;"TUPANCI DO SUL (RS)";"RS";"TUPANCI DO SUL";69;3;17;89
2017;"TUPANCIRETA (RS)";"RS";"TUPANCIRETA";707;85;76;868
2017;"TUPANDI (RS)";"RS";"TUPANDI";112;37;46;195
2017;"TUPARENDI (RS)";"RS";"TUPARENDI";344;17;29;390
2017;"TURUCU (RS)";"RS";"TURUCU";124;9;14;147
2017;"UBIRETAMA (RS)";"RS";"UBIRETAMA";105;10;5;120
2017;"UNIAO DA SERRA (RS)";"RS";"UNIAO DA SERRA";65;6;9;80
2017;"UNISTALDA (RS)";"RS";"UNISTALDA";62;10;20;92
2017;"URUGUAIANA (RS)";"RS";"URUGUAIANA";1980;120;194;2294
2017;"VACARIA (RS)";"RS";"VACARIA";1853;201;580;2634
2017;"VALE DO SOL (RS)";"RS";"VALE DO SOL";206;10;54;270
2017;"VALE REAL (RS)";"RS";"VALE REAL";219;12;12;243
2017;"VALE VERDE (RS)";"RS";"VALE VERDE";73;5;14;92
2017;"VANINI (RS)";"RS";"VANINI";101;10;17;128
2017;"VENANCIO AIRES (RS)";"RS";"VENANCIO AIRES";1254;119;213;1586
2017;"VERA CRUZ (RS)";"RS";"VERA CRUZ";492;42;149;683
2017;"VERANOPOLIS (RS)";"RS";"VERANOPOLIS";973;43;73;1089
2017;"VESPASIANO CORREA (RS)";"RS";"VESPASIANO CORREA";116;9;12;137
2017;"VIADUTOS (RS)";"RS";"VIADUTOS";164;11;24;199
2017;"VIAMAO (RS)";"RS";"VIAMAO";2393;378;674;3445
2017;"VICENTE DUTRA (RS)";"RS";"VICENTE DUTRA";72;2;19;93
2017;"VICTOR GRAEFF (RS)";"RS";"VICTOR GRAEFF";185;15;9;209
2017;"VILA FLORES (RS)";"RS";"VILA FLORES";197;14;18;229
2017;"VILA LANGARO (RS)";"RS";"VILA LANGARO";122;6;15;143
2017;"VILA MARIA (RS)";"RS";"VILA MARIA";308;8;44;360
2017;"VILA NOVA DO SUL (RS)";"RS";"VILA NOVA DO SUL";123;9;14;146
2017;"VISTA ALEGRE (RS)";"RS";"VISTA ALEGRE";86;5;11;102
2017;"VISTA ALEGRE DO PRATA (RS)";"RS";"VISTA ALEGRE DO PRATA";47;10;4;61
2017;"VISTA GAUCHA (RS)";"RS";"VISTA GAUCHA";82;1;13;96
2017;"VITORIA DAS MISSOES (RS)";"RS";"VITORIA DAS MISSOES";140;2;17;159
2017;"WESTFALIA (RS)";"RS";"WESTFALIA";156;13;16;185
2017;"XANGRI LA (RS)";"RS";"XANGRI LA";227;14;20;261
2017;"ABDON BATISTA (SC)";"SC";"ABDON BATISTA";82;4;13;99
2017;"ABELARDO LUZ (SC)";"SC";"ABELARDO LUZ";446;25;124;595
2017;"AGROLANDIA (SC)";"SC";"AGROLANDIA";269;18;21;308
2017;"AGRONOMICA (SC)";"SC";"AGRONOMICA";165;6;11;182
2017;"AGUA DOCE (SC)";"SC";"AGUA DOCE";244;31;32;307
2017;"AGUAS DE CHAPECO (SC)";"SC";"AGUAS DE CHAPECO";81;9;30;120
2017;"AGUAS FRIAS (SC)";"SC";"AGUAS FRIAS";63;5;6;74
2017;"AGUAS MORNAS (SC)";"SC";"AGUAS MORNAS";318;7;19;344
2017;"ALFREDO WAGNER (SC)";"SC";"ALFREDO WAGNER";326;24;21;371
2017;"ALTO BELA VISTA (SC)";"SC";"ALTO BELA VISTA";65;10;8;83
2017;"ANCHIETA (SC)";"SC";"ANCHIETA";226;15;24;265
2017;"ANGELINA (SC)";"SC";"ANGELINA";260;20;18;298
2017;"ANITA GARIBALDI (SC)";"SC";"ANITA GARIBALDI";151;15;37;203
2017;"ANITAPOLIS (SC)";"SC";"ANITAPOLIS";143;6;14;163
2017;"ANTONIO CARLOS (SC)";"SC";"ANTONIO CARLOS";686;6;13;705
2017;"APIUNA (SC)";"SC";"APIUNA";203;32;19;254
2017;"ARABUTA (SC)";"SC";"ARABUTA";145;10;36;191
2017;"ARAQUARI (SC)";"SC";"ARAQUARI";883;68;66;1017
2017;"ARARANGUA (SC)";"SC";"ARARANGUA";1446;84;174;1704
2017;"ARMAZEM (SC)";"SC";"ARMAZEM";290;15;20;325
2017;"ARROIO TRINTA (SC)";"SC";"ARROIO TRINTA";197;10;21;228
2017;"ARVOREDO (SC)";"SC";"ARVOREDO";51;22;7;80
2017;"ASCURRA (SC)";"SC";"ASCURRA";259;21;35;315
2017;"ATALANTA (SC)";"SC";"ATALANTA";98;2;7;107
2017;"AURORA (SC)";"SC";"AURORA";208;4;21;233
2017;"BALNEARIO ARROIO DO SILVA (SC)";"SC";"BALNEARIO ARROIO DO SILVA";141;11;17;169
2017;"BALNEARIO BARRA DO SUL (SC)";"SC";"BALNEARIO BARRA DO SUL";168;12;10;190
2017;"BALNEARIO CAMBORIU (SC)";"SC";"BALNEARIO CAMBORIU";952;287;314;1553
2017;"BALNEARIO DE PICARRAS (SC)";"SC";"BALNEARIO DE PICARRAS";345;43;58;446
2017;"BALNEARIO GAIVOTA (SC)";"SC";"BALNEARIO GAIVOTA";214;9;28;251
2017;"BALNEARIO RINCAO (SC)";"SC";"BALNEARIO RINCAO";103;10;9;122
2017;"BANDEIRANTE (SC)";"SC";"BANDEIRANTE";55;6;17;78
2017;"BARRA BONITA (SC)";"SC";"BARRA BONITA";42;6;9;57
2017;"BARRA VELHA (SC)";"SC";"BARRA VELHA";569;45;51;665
2017;"BELA VISTA DO TOLDO (SC)";"SC";"BELA VISTA DO TOLDO";111;5;41;157
2017;"BELMONTE (SC)";"SC";"BELMONTE";76;9;6;91
2017;"BENEDITO NOVO (SC)";"SC";"BENEDITO NOVO";333;46;32;411
2017;"BIGUACU (SC)";"SC";"BIGUACU";1439;86;151;1676
2017;"BLUMENAU (SC)";"SC";"BLUMENAU";5595;470;999;7064
2017;"BOCAINA DO SUL (SC)";"SC";"BOCAINA DO SUL";67;3;16;86
2017;"BOM JARDIM DA SERRA (SC)";"SC";"BOM JARDIM DA SERRA";173;11;27;211
2017;"BOM JESUS (SC)";"SC";"BOM JESUS";78;3;9;90
2017;"BOM JESUS DO OESTE (SC)";"SC";"BOM JESUS DO OESTE";71;5;10;86
2017;"BOM RETIRO (SC)";"SC";"BOM RETIRO";227;19;41;287
2017;"BOMBINHAS (SC)";"SC";"BOMBINHAS";196;56;29;281
2017;"BOTUVERA (SC)";"SC";"BOTUVERA";223;7;15;245
2017;"BRACO DO NORTE (SC)";"SC";"BRACO DO NORTE";1239;57;78;1374
2017;"BRACO DO TROMBUDO (SC)";"SC";"BRACO DO TROMBUDO";142;7;9;158
2017;"BRUNOPOLIS (SC)";"SC";"BRUNOPOLIS";120;6;12;138
2017;"BRUSQUE (SC)";"SC";"BRUSQUE";2580;171;178;2929
2017;"CACADOR (SC)";"SC";"CACADOR";2204;148;806;3158
2017;"CAIBI (SC)";"SC";"CAIBI";185;8;23;216
2017;"CALMON (SC)";"SC";"CALMON";41;13;25;79
2017;"CAMBORIU (SC)";"SC";"CAMBORIU";1218;64;41;1323
2017;"CAMPO ALEGRE (SC)";"SC";"CAMPO ALEGRE";443;21;17;481
2017;"CAMPO BELO DO SUL (SC)";"SC";"CAMPO BELO DO SUL";224;15;47;286
2017;"CAMPO ERE (SC)";"SC";"CAMPO ERE";333;11;36;380
2017;"CAMPOS NOVOS (SC)";"SC";"CAMPOS NOVOS";1134;110;117;1361
2017;"CANELINHA (SC)";"SC";"CANELINHA";521;14;10;545
2017;"CANOINHAS (SC)";"SC";"CANOINHAS";1365;81;169;1615
2017;"CAPAO ALTO (SC)";"SC";"CAPAO ALTO";78;10;16;104
2017;"CAPINZAL (SC)";"SC";"CAPINZAL";505;48;69;622
2017;"CAPIVARI DE BAIXO (SC)";"SC";"CAPIVARI DE BAIXO";379;21;28;428
2017;"CATANDUVAS (SC)";"SC";"CATANDUVAS";428;27;40;495
2017;"CAXAMBU DO SUL (SC)";"SC";"CAXAMBU DO SUL";128;5;13;146
2017;"CELSO RAMOS (SC)";"SC";"CELSO RAMOS";84;8;6;98
2017;"CERRO NEGRO (SC)";"SC";"CERRO NEGRO";73;9;19;101
2017;"CHAPADAO DO LAGEADO (SC)";"SC";"CHAPADAO DO LAGEADO";47;6;11;64
2017;"CHAPECO (SC)";"SC";"CHAPECO";4599;339;461;5399
2017;"COCAL DO SUL (SC)";"SC";"COCAL DO SUL";329;19;24;372
2017;"CONCORDIA (SC)";"SC";"CONCORDIA";2722;170;268;3160
2017;"CORDILHEIRA ALTA (SC)";"SC";"CORDILHEIRA ALTA";335;27;19;381
2017;"CORONEL FREITAS (SC)";"SC";"CORONEL FREITAS";299;13;28;340
2017;"CORONEL MARTINS (SC)";"SC";"CORONEL MARTINS";55;7;11;73
2017;"CORREIA PINTO (SC)";"SC";"CORREIA PINTO";442;51;73;566
2017;"CORUPA (SC)";"SC";"CORUPA";449;6;38;493
2017;"CRICIUMA (SC)";"SC";"CRICIUMA";3502;340;446;4288
2017;"CUNHA PORA (SC)";"SC";"CUNHA PORA";430;21;64;515
2017;"CUNHATAI (SC)";"SC";"CUNHATAI";48;4;10;62
2017;"CURITIBANOS (SC)";"SC";"CURITIBANOS";1044;104;151;1299
2017;"DESCANSO (SC)";"SC";"DESCANSO";233;19;32;284
2017;"DIONISIO CERQUEIRA (SC)";"SC";"DIONISIO CERQUEIRA";205;26;21;252
2017;"DONA EMMA (SC)";"SC";"DONA EMMA";132;15;10;157
2017;"DOUTOR PEDRINHO (SC)";"SC";"DOUTOR PEDRINHO";141;7;4;152
2017;"ENTRE RIOS (SC)";"SC";"ENTRE RIOS";39;3;33;75
2017;"ERMO (SC)";"SC";"ERMO";106;4;8;118
2017;"ERVAL VELHO (SC)";"SC";"ERVAL VELHO";127;8;24;159
2017;"FAXINAL DOS GUEDES (SC)";"SC";"FAXINAL DOS GUEDES";405;23;43;471
2017;"FLOR DO SERTAO (SC)";"SC";"FLOR DO SERTAO";28;10;17;55
2017;"FLORIANOPOLIS (SC)";"SC";"FLORIANOPOLIS";3811;939;1969;6719
2017;"FORMOSA DO SUL (SC)";"SC";"FORMOSA DO SUL";62;6;16;84
2017;"FORQUILHINHA (SC)";"SC";"FORQUILHINHA";610;27;38;675
2017;"FRAIBURGO (SC)";"SC";"FRAIBURGO";939;57;220;1216
2017;"FREI ROGERIO (SC)";"SC";"FREI ROGERIO";93;11;18;122
2017;"GALVAO (SC)";"SC";"GALVAO";106;7;15;128
2017;"GAROPABA (SC)";"SC";"GAROPABA";308;31;42;381
2017;"GARUVA (SC)";"SC";"GARUVA";592;38;51;681
2017;"GASPAR (SC)";"SC";"GASPAR";1410;72;71;1553
2017;"GOVERNADOR CELSO RAMOS (SC)";"SC";"GOVERNADOR CELSO RAMOS";178;23;18;219
2017;"GRAO PARA (SC)";"SC";"GRAO PARA";277;11;13;301
2017;"GRAVATAL (SC)";"SC";"GRAVATAL";324;19;21;364
2017;"GUABIRUBA (SC)";"SC";"GUABIRUBA";326;22;21;369
2017;"GUARACIABA (SC)";"SC";"GUARACIABA";268;13;40;321
2017;"GUARAMIRIM (SC)";"SC";"GUARAMIRIM";1097;39;35;1171
2017;"GUARUJA DO SUL (SC)";"SC";"GUARUJA DO SUL";171;14;24;209
2017;"GUATAMBU (SC)";"SC";"GUATAMBU";139;16;26;181
2017;"HERVAL D OESTE (SC)";"SC";"HERVAL D OESTE";369;40;69;478
2017;"IBIAM (SC)";"SC";"IBIAM";77;5;16;98
2017;"IBICARE (SC)";"SC";"IBICARE";170;12;10;192
2017;"IBIRAMA (SC)";"SC";"IBIRAMA";514;70;89;673
2017;"ICARA (SC)";"SC";"ICARA";1898;108;145;2151
2017;"ILHOTA (SC)";"SC";"ILHOTA";388;28;26;442
2017;"IMARUI (SC)";"SC";"IMARUI";177;29;31;237
2017;"IMBITUBA (SC)";"SC";"IMBITUBA";705;75;107;887
2017;"IMBUIA (SC)";"SC";"IMBUIA";191;8;23;222
2017;"INDAIAL (SC)";"SC";"INDAIAL";1596;101;139;1836
2017;"IOMERE (SC)";"SC";"IOMERE";169;6;9;184
2017;"IPIRA (SC)";"SC";"IPIRA";136;7;20;163
2017;"IPORA DO OESTE (SC)";"SC";"IPORA DO OESTE";271;24;54;349
2017;"IPUACU (SC)";"SC";"IPUACU";117;11;42;170
2017;"IPUMIRIM (SC)";"SC";"IPUMIRIM";289;44;29;362
2017;"IRACEMINHA (SC)";"SC";"IRACEMINHA";117;7;28;152
2017;"IRANI (SC)";"SC";"IRANI";381;25;66;472
2017;"IRATI (SC)";"SC";"IRATI";38;8;8;54
2017;"IRINEOPOLIS (SC)";"SC";"IRINEOPOLIS";301;15;16;332
2017;"ITA (SC)";"SC";"ITA";118;16;43;177
2017;"ITAIOPOLIS (SC)";"SC";"ITAIOPOLIS";688;35;102;825
2017;"ITAJAI (SC)";"SC";"ITAJAI";4615;294;404;5313
2017;"ITAPEMA (SC)";"SC";"ITAPEMA";648;67;53;768
2017;"ITAPIRANGA (SC)";"SC";"ITAPIRANGA";377;24;82;483
2017;"ITAPOA (SC)";"SC";"ITAPOA";274;26;18;318
2017;"ITUPORANGA (SC)";"SC";"ITUPORANGA";735;38;70;843
2017;"JABORA (SC)";"SC";"JABORA";152;17;27;196
2017;"JACINTO MACHADO (SC)";"SC";"JACINTO MACHADO";461;14;38;513
2017;"JAGUARUNA (SC)";"SC";"JAGUARUNA";518;30;66;614
2017;"JARAGUA DO SUL (SC)";"SC";"JARAGUA DO SUL";2650;245;414;3309
2017;"JARDINOPOLIS (SC)";"SC";"JARDINOPOLIS";24;5;6;35
2017;"JOACABA (SC)";"SC";"JOACABA";882;69;47;998
2017;"JOINVILLE (SC)";"SC";"JOINVILLE";8436;764;862;10062
2017;"JOSE BOITEUX (SC)";"SC";"JOSE BOITEUX";127;25;10;162
2017;"JUPIA (SC)";"SC";"JUPIA";52;5;9;66
2017;"LACERDOPOLIS (SC)";"SC";"LACERDOPOLIS";121;6;7;134
2017;"LAGEADO GRANDE (SC)";"SC";"LAGEADO GRANDE";42;2;6;50
2017;"LAGES (SC)";"SC";"LAGES";3499;296;400;4195
2017;"LAGUNA (SC)";"SC";"LAGUNA";566;132;104;802
2017;"LAURENTINO (SC)";"SC";"LAURENTINO";324;5;10;339
2017;"LAURO MULLER (SC)";"SC";"LAURO MULLER";498;29;51;578
2017;"LEBON REGIS (SC)";"SC";"LEBON REGIS";273;25;58;356
2017;"LEOBERTO LEAL (SC)";"SC";"LEOBERTO LEAL";120;14;5;139
2017;"LINDOIA DO SUL (SC)";"SC";"LINDOIA DO SUL";151;11;45;207
2017;"LONTRAS (SC)";"SC";"LONTRAS";352;24;43;419
2017;"LUIZ ALVES (SC)";"SC";"LUIZ ALVES";491;14;28;533
2017;"LUZERNA (SC)";"SC";"LUZERNA";160;13;26;199
2017;"MACIEIRA (SC)";"SC";"MACIEIRA";95;7;16;118
2017;"MAFRA (SC)";"SC";"MAFRA";1487;103;163;1753
2017;"MAJOR GERCINO (SC)";"SC";"MAJOR GERCINO";144;7;12;163
2017;"MAJOR VIEIRA (SC)";"SC";"MAJOR VIEIRA";226;4;16;246
2017;"MARACAJA (SC)";"SC";"MARACAJA";247;2;14;263
2017;"MARAVILHA (SC)";"SC";"MARAVILHA";872;37;73;982
2017;"MAREMA (SC)";"SC";"MAREMA";67;7;9;83
2017;"MASSARANDUBA (SC)";"SC";"MASSARANDUBA";572;27;51;650
2017;"MATOS COSTA (SC)";"SC";"MATOS COSTA";60;9;19;88
2017;"MELEIRO (SC)";"SC";"MELEIRO";285;11;22;318
2017;"MIRIM DOCE (SC)";"SC";"MIRIM DOCE";67;3;10;80
2017;"MODELO (SC)";"SC";"MODELO";141;11;12;164
2017;"MONDAI (SC)";"SC";"MONDAI";189;14;63;266
2017;"MONTE CARLO (SC)";"SC";"MONTE CARLO";171;20;101;292
2017;"MONTE CASTELO (SC)";"SC";"MONTE CASTELO";192;17;23;232
2017;"MORRO DA FUMACA (SC)";"SC";"MORRO DA FUMACA";863;31;38;932
2017;"MORRO GRANDE (SC)";"SC";"MORRO GRANDE";145;4;12;161
2017;"NAVEGANTES (SC)";"SC";"NAVEGANTES";905;121;77;1103
2017;"NOVA ERECHIM (SC)";"SC";"NOVA ERECHIM";130;6;10;146
2017;"NOVA ITABERABA (SC)";"SC";"NOVA ITABERABA";128;3;18;149
2017;"NOVA TRENTO (SC)";"SC";"NOVA TRENTO";304;48;40;392
2017;"NOVA VENEZA (SC)";"SC";"NOVA VENEZA";468;38;42;548
2017;"NOVO HORIZONTE (SC)";"SC";"NOVO HORIZONTE";59;10;21;90
2017;"ORLEANS (SC)";"SC";"ORLEANS";894;36;47;977
2017;"OTACILIO COSTA (SC)";"SC";"OTACILIO COSTA";496;43;68;607
2017;"OURO (SC)";"SC";"OURO";256;34;35;325
2017;"OURO VERDE (SC)";"SC";"OURO VERDE";94;2;9;105
2017;"PAIAL (SC)";"SC";"PAIAL";23;1;13;37
2017;"PAINEL (SC)";"SC";"PAINEL";45;5;11;61
2017;"PALHOCA (SC)";"SC";"PALHOCA";2557;204;394;3155
2017;"PALMA SOLA (SC)";"SC";"PALMA SOLA";210;8;33;251
2017;"PALMEIRA (SC)";"SC";"PALMEIRA";108;8;5;121
2017;"PALMITOS (SC)";"SC";"PALMITOS";421;50;57;528
2017;"PAPANDUVA (SC)";"SC";"PAPANDUVA";576;19;96;691
2017;"PARAISO (SC)";"SC";"PARAISO";102;6;13;121
2017;"PASSO DE TORRES (SC)";"SC";"PASSO DE TORRES";174;12;20;206
2017;"PASSOS MAIA (SC)";"SC";"PASSOS MAIA";137;4;31;172
2017;"PAULO LOPES (SC)";"SC";"PAULO LOPES";271;20;48;339
2017;"PEDRAS GRANDES (SC)";"SC";"PEDRAS GRANDES";247;23;15;285
2017;"PENHA (SC)";"SC";"PENHA";418;52;59;529
2017;"PERITIBA (SC)";"SC";"PERITIBA";97;5;18;120
2017;"PESCARIA BRAVA (SC)";"SC";"PESCARIA BRAVA";102;6;6;114
2017;"PETROLANDIA (SC)";"SC";"PETROLANDIA";189;12;25;226
2017;"PINHALZINHO (SC)";"SC";"PINHALZINHO";558;25;56;639
2017;"PINHEIRO PRETO (SC)";"SC";"PINHEIRO PRETO";292;9;16;317
2017;"PIRATUBA (SC)";"SC";"PIRATUBA";123;11;32;166
2017;"PLANALTO ALEGRE (SC)";"SC";"PLANALTO ALEGRE";81;7;5;93
2017;"POMERODE (SC)";"SC";"POMERODE";699;37;89;825
2017;"PONTE ALTA (SC)";"SC";"PONTE ALTA";148;10;16;174
2017;"PONTE ALTA DO NORTE (SC)";"SC";"PONTE ALTA DO NORTE";101;6;11;118
2017;"PONTE SERRADA (SC)";"SC";"PONTE SERRADA";368;49;128;545
2017;"PORTO BELO (SC)";"SC";"PORTO BELO";290;41;30;361
2017;"PORTO UNIAO (SC)";"SC";"PORTO UNIAO";712;34;43;789
2017;"POUSO REDONDO (SC)";"SC";"POUSO REDONDO";536;24;45;605
2017;"PRAIA GRANDE (SC)";"SC";"PRAIA GRANDE";274;9;29;312
2017;"PRESIDENTE CASTELO BRANCO (SC)";"SC";"PRESIDENTE CASTELO BRANCO";80;5;8;93
2017;"PRESIDENTE GETULIO (SC)";"SC";"PRESIDENTE GETULIO";396;49;67;512
2017;"PRESIDENTE NEREU (SC)";"SC";"PRESIDENTE NEREU";44;9;8;61
2017;"PRINCESA (SC)";"SC";"PRINCESA";63;3;12;78
2017;"QUILOMBO (SC)";"SC";"QUILOMBO";231;33;54;318
2017;"RANCHO QUEIMADO (SC)";"SC";"RANCHO QUEIMADO";162;7;6;175
2017;"RIO DAS ANTAS (SC)";"SC";"RIO DAS ANTAS";211;9;32;252
2017;"RIO DO CAMPO (SC)";"SC";"RIO DO CAMPO";196;14;19;229
2017;"RIO DO OESTE (SC)";"SC";"RIO DO OESTE";218;20;21;259
2017;"RIO DO SUL (SC)";"SC";"RIO DO SUL";1485;81;115;1681
2017;"RIO DOS CEDROS (SC)";"SC";"RIO DOS CEDROS";287;34;30;351
2017;"RIO FORTUNA (SC)";"SC";"RIO FORTUNA";296;7;17;320
2017;"RIO NEGRINHO (SC)";"SC";"RIO NEGRINHO";1152;66;126;1344
2017;"RIO RUFINO (SC)";"SC";"RIO RUFINO";60;7;24;91
2017;"RIQUEZA (SC)";"SC";"RIQUEZA";146;7;25;178
2017;"RODEIO (SC)";"SC";"RODEIO";283;16;28;327
2017;"ROMELANDIA (SC)";"SC";"ROMELANDIA";99;5;34;138
2017;"SALETE (SC)";"SC";"SALETE";200;11;27;238
2017;"SALTINHO (SC)";"SC";"SALTINHO";69;7;22;98
2017;"SALTO VELOSO (SC)";"SC";"SALTO VELOSO";165;5;8;178
2017;"SANGAO (SC)";"SC";"SANGAO";495;17;16;528
2017;"SANTA CECILIA (SC)";"SC";"SANTA CECILIA";514;42;70;626
2017;"SANTA HELENA (SC)";"SC";"SANTA HELENA";65;15;18;98
2017;"SANTA ROSA DE LIMA (SC)";"SC";"SANTA ROSA DE LIMA";128;4;11;143
2017;"SANTA ROSA DO SUL (SC)";"SC";"SANTA ROSA DO SUL";290;13;27;330
2017;"SANTA TEREZINHA (SC)";"SC";"SANTA TEREZINHA";205;15;31;251
2017;"SANTA TEREZINHA DO PROGRESSO (SC)";"SC";"SANTA TEREZINHA DO PROGRESSO";51;8;16;75
2017;"SANTIAGO DO SUL (SC)";"SC";"SANTIAGO DO SUL";73;8;4;85
2017;"SANTO AMARO DA IMPERATRIZ (SC)";"SC";"SANTO AMARO DA IMPERATRIZ";694;29;73;796
2017;"SAO BENTO DO SUL (SC)";"SC";"SAO BENTO DO SUL";1719;161;188;2068
2017;"SAO BERNARDINO (SC)";"SC";"SAO BERNARDINO";55;10;20;85
2017;"SAO BONIFACIO (SC)";"SC";"SAO BONIFACIO";144;8;11;163
2017;"SAO CARLOS (SC)";"SC";"SAO CARLOS";236;17;53;306
2017;"SAO CRISTOVAO DO SUL (SC)";"SC";"SAO CRISTOVAO DO SUL";339;5;12;356
2017;"SAO DOMINGOS (SC)";"SC";"SAO DOMINGOS";362;27;61;450
2017;"SAO FRANCISCO DO SUL (SC)";"SC";"SAO FRANCISCO DO SUL";743;66;87;896
2017;"SAO JOAO BATISTA (SC)";"SC";"SAO JOAO BATISTA";620;36;59;715
2017;"SAO JOAO DO ITAPERIU (SC)";"SC";"SAO JOAO DO ITAPERIU";254;8;13;275
2017;"SAO JOAO DO OESTE (SC)";"SC";"SAO JOAO DO OESTE";194;13;20;227
2017;"SAO JOAO DO SUL (SC)";"SC";"SAO JOAO DO SUL";231;5;19;255
2017;"SAO JOAQUIM (SC)";"SC";"SAO JOAQUIM";1130;106;235;1471
2017;"SAO JOSE (SC)";"SC";"SAO JOSE";3663;265;234;4162
2017;"SAO JOSE DO CEDRO (SC)";"SC";"SAO JOSE DO CEDRO";423;22;69;514
2017;"SAO JOSE DO CERRITO (SC)";"SC";"SAO JOSE DO CERRITO";231;14;58;303
2017;"SAO LOURENCO D OESTE (SC)";"SC";"SAO LOURENCO D OESTE";863;56;91;1010
2017;"SAO LUDGERO (SC)";"SC";"SAO LUDGERO";624;14;29;667
2017;"SAO MARTINHO (SC)";"SC";"SAO MARTINHO";159;7;6;172
2017;"SAO MIGUEL D OESTE (SC)";"SC";"SAO MIGUEL D OESTE";1126;83;121;1330
2017;"SAO MIGUEL DA BOA VISTA (SC)";"SC";"SAO MIGUEL DA BOA VISTA";37;3;11;51
2017;"SAO PEDRO DE ALCANTARA (SC)";"SC";"SAO PEDRO DE ALCANTARA";157;7;5;169
2017;"SAUDADES (SC)";"SC";"SAUDADES";265;16;38;319
2017;"SCHROEDER (SC)";"SC";"SCHROEDER";252;11;20;283
2017;"SEARA (SC)";"SC";"SEARA";421;72;109;602
2017;"SERRA ALTA (SC)";"SC";"SERRA ALTA";69;12;15;96
2017;"SIDEROPOLIS (SC)";"SC";"SIDEROPOLIS";446;25;75;546
2017;"SOMBRIO (SC)";"SC";"SOMBRIO";781;73;87;941
2017;"SUL BRASIL (SC)";"SC";"SUL BRASIL";59;4;14;77
2017;"TAIO (SC)";"SC";"TAIO";626;24;68;718
2017;"TANGARA (SC)";"SC";"TANGARA";452;19;51;522
2017;"TIGRINHOS (SC)";"SC";"TIGRINHOS";38;2;10;50
2017;"TIJUCAS (SC)";"SC";"TIJUCAS";1057;57;53;1167
2017;"TIMBE DO SUL (SC)";"SC";"TIMBE DO SUL";170;14;20;204
2017;"TIMBO (SC)";"SC";"TIMBO";741;59;48;848
2017;"TIMBO GRANDE (SC)";"SC";"TIMBO GRANDE";200;10;30;240
2017;"TRES BARRAS (SC)";"SC";"TRES BARRAS";323;38;67;428
2017;"TREVISO (SC)";"SC";"TREVISO";121;9;9;139
2017;"TREZE DE MAIO (SC)";"SC";"TREZE DE MAIO";413;15;25;453
2017;"TREZE TILIAS (SC)";"SC";"TREZE TILIAS";334;21;46;401
2017;"TROMBUDO CENTRAL (SC)";"SC";"TROMBUDO CENTRAL";256;20;26;302
2017;"TUBARAO (SC)";"SC";"TUBARAO";2390;112;309;2811
2017;"TUNAPOLIS (SC)";"SC";"TUNAPOLIS";102;14;22;138
2017;"TURVO (SC)";"SC";"TURVO";517;26;47;590
2017;"UNIAO DO OESTE (SC)";"SC";"UNIAO DO OESTE";57;3;15;75
2017;"URUBICI (SC)";"SC";"URUBICI";310;26;52;388
2017;"URUPEMA (SC)";"SC";"URUPEMA";92;16;11;119
2017;"URUSSANGA (SC)";"SC";"URUSSANGA";506;45;93;644
2017;"VARGEAO (SC)";"SC";"VARGEAO";178;5;12;195
2017;"VARGEM (SC)";"SC";"VARGEM";73;0;14;87
2017;"VARGEM BONITA (SC)";"SC";"VARGEM BONITA";184;14;26;224
2017;"VIDAL RAMOS (SC)";"SC";"VIDAL RAMOS";173;16;21;210
2017;"VIDEIRA (SC)";"SC";"VIDEIRA";1723;130;170;2023
2017;"VITOR MEIRELES (SC)";"SC";"VITOR MEIRELES";99;22;20;141
2017;"WITMARSUM (SC)";"SC";"WITMARSUM";124;7;17;148
2017;"XANXERE (SC)";"SC";"XANXERE";1358;132;134;1624
2017;"XAVANTINA (SC)";"SC";"XAVANTINA";121;17;9;147
2017;"XAXIM (SC)";"SC";"XAXIM";750;63;148;961
2017;"ZORTEA (SC)";"SC";"ZORTEA";46;14;4;64
2017;"AMPARO DE SAO FRANCISCO (SE)";"SE";"AMPARO DE SAO FRANCISCO";9;12;2;23
2017;"AQUIDABA (SE)";"SE";"AQUIDABA";134;21;54;209
2017;"ARACAJU (SE)";"SE";"ARACAJU";5904;1043;2509;9456
2017;"ARAUA (SE)";"SE";"ARAUA";44;19;25;88
2017;"AREIA BRANCA (SE)";"SE";"AREIA BRANCA";167;25;22;214
2017;"BARRA DOS COQUEIROS (SE)";"SE";"BARRA DOS COQUEIROS";85;45;37;167
2017;"BOQUIM (SE)";"SE";"BOQUIM";207;24;51;282
2017;"BREJO GRANDE (SE)";"SE";"BREJO GRANDE";8;6;9;23
2017;"CAMPO DO BRITO (SE)";"SE";"CAMPO DO BRITO";444;18;68;530
2017;"CANHOBA (SE)";"SE";"CANHOBA";6;2;6;14
2017;"CANINDE DE SAO FRANCISCO (SE)";"SE";"CANINDE DE SAO FRANCISCO";217;79;26;322
2017;"CAPELA (SE)";"SE";"CAPELA";133;40;74;247
2017;"CARIRA (SE)";"SE";"CARIRA";302;33;105;440
2017;"CARMOPOLIS (SE)";"SE";"CARMOPOLIS";89;43;36;168
2017;"CEDRO DE SAO JOAO (SE)";"SE";"CEDRO DE SAO JOAO";25;6;5;36
2017;"CRISTINAPOLIS (SE)";"SE";"CRISTINAPOLIS";91;21;42;154
2017;"CUMBE (SE)";"SE";"CUMBE";32;11;17;60
2017;"DIVINA PASTORA (SE)";"SE";"DIVINA PASTORA";8;9;8;25
2017;"ESTANCIA (SE)";"SE";"ESTANCIA";574;194;282;1050
2017;"FEIRA NOVA (SE)";"SE";"FEIRA NOVA";22;10;7;39
2017;"FREI PAULO (SE)";"SE";"FREI PAULO";148;21;38;207
2017;"GARARU (SE)";"SE";"GARARU";52;15;29;96
2017;"GENERAL MAYNARD (SE)";"SE";"GENERAL MAYNARD";12;10;11;33
2017;"GRACCHO CARDOSO (SE)";"SE";"GRACCHO CARDOSO";20;9;11;40
2017;"ILHA DAS FLORES (SE)";"SE";"ILHA DAS FLORES";16;10;13;39
2017;"INDIAROBA (SE)";"SE";"INDIAROBA";38;21;21;80
2017;"ITABAIANA (SE)";"SE";"ITABAIANA";3283;144;203;3630
2017;"ITABAIANINHA (SE)";"SE";"ITABAIANINHA";590;70;71;731
2017;"ITABI (SE)";"SE";"ITABI";23;4;8;35
2017;"ITAPORANGA D AJUDA (SE)";"SE";"ITAPORANGA D AJUDA";320;38;82;440
2017;"JAPARATUBA (SE)";"SE";"JAPARATUBA";57;24;71;152
2017;"JAPOATA (SE)";"SE";"JAPOATA";55;13;41;109
2017;"LAGARTO (SE)";"SE";"LAGARTO";1138;149;240;1527
2017;"LARANJEIRAS (SE)";"SE";"LARANJEIRAS";135;63;45;243
2017;"MACAMBIRA (SE)";"SE";"MACAMBIRA";50;6;22;78
2017;"MALHADA DOS BOIS (SE)";"SE";"MALHADA DOS BOIS";15;5;10;30
2017;"MALHADOR (SE)";"SE";"MALHADOR";223;25;58;306
2017;"MARUIM (SE)";"SE";"MARUIM";50;28;31;109
2017;"MOITA BONITA (SE)";"SE";"MOITA BONITA";483;16;21;520
2017;"MONTE ALEGRE DE SERGIPE (SE)";"SE";"MONTE ALEGRE DE SERGIPE";163;43;44;250
2017;"MURIBECA (SE)";"SE";"MURIBECA";61;7;41;109
2017;"NEOPOLIS (SE)";"SE";"NEOPOLIS";56;20;32;108
2017;"NOSSA SENHORA APARECIDA (SE)";"SE";"NOSSA SENHORA APARECIDA";139;20;19;178
2017;"NOSSA SENHORA DA GLORIA (SE)";"SE";"NOSSA SENHORA DA GLORIA";482;69;174;725
2017;"NOSSA SENHORA DAS DORES (SE)";"SE";"NOSSA SENHORA DAS DORES";250;29;95;374
2017;"NOSSA SENHORA DE LOURDES (SE)";"SE";"NOSSA SENHORA DE LOURDES";34;5;12;51
2017;"NOSSA SENHORA DO SOCORRO (SE)";"SE";"NOSSA SENHORA DO SOCORRO";983;134;220;1337
2017;"PACATUBA (SE)";"SE";"PACATUBA";417;11;60;488
2017;"PEDRA MOLE (SE)";"SE";"PEDRA MOLE";8;4;4;16
2017;"PEDRINHAS (SE)";"SE";"PEDRINHAS";70;5;10;85
2017;"PINHAO (SE)";"SE";"PINHAO";22;14;10;46
2017;"PIRAMBU (SE)";"SE";"PIRAMBU";25;10;21;56
2017;"POCO REDONDO (SE)";"SE";"POCO REDONDO";178;63;75;316
2017;"POCO VERDE (SE)";"SE";"POCO VERDE";145;73;160;378
2017;"PORTO DA FOLHA (SE)";"SE";"PORTO DA FOLHA";141;40;38;219
2017;"PROPRIA (SE)";"SE";"PROPRIA";251;23;61;335
2017;"RIACHAO DO DANTAS (SE)";"SE";"RIACHAO DO DANTAS";41;5;20;66
2017;"RIACHUELO (SE)";"SE";"RIACHUELO";40;14;11;65
2017;"RIBEIROPOLIS (SE)";"SE";"RIBEIROPOLIS";271;46;78;395
2017;"ROSARIO DO CATETE (SE)";"SE";"ROSARIO DO CATETE";44;25;17;86
2017;"SALGADO (SE)";"SE";"SALGADO";145;19;134;298
2017;"SANTA LUZIA DO ITANHY (SE)";"SE";"SANTA LUZIA DO ITANHY";29;15;28;72
2017;"SANTA ROSA DE LIMA (SE)";"SE";"SANTA ROSA DE LIMA";29;5;11;45
2017;"SANTANA DO SAO FRANCISCO (SE)";"SE";"SANTANA DO SAO FRANCISCO";15;5;9;29
2017;"SANTO AMARO DAS BROTAS (SE)";"SE";"SANTO AMARO DAS BROTAS";17;7;20;44
2017;"SAO CRISTOVAO (SE)";"SE";"SAO CRISTOVAO";428;119;329;876
2017;"SAO DOMINGOS (SE)";"SE";"SAO DOMINGOS";141;12;32;185
2017;"SAO FRANCISCO (SE)";"SE";"SAO FRANCISCO";19;4;26;49
2017;"SAO MIGUEL DO ALEIXO (SE)";"SE";"SAO MIGUEL DO ALEIXO";48;3;6;57
2017;"SIMAO DIAS (SE)";"SE";"SIMAO DIAS";261;59;314;634
2017;"SIRIRI (SE)";"SE";"SIRIRI";36;9;40;85
2017;"TELHA (SE)";"SE";"TELHA";19;12;5;36
2017;"TOBIAS BARRETO (SE)";"SE";"TOBIAS BARRETO";360;97;241;698
2017;"TOMAR DO GERU (SE)";"SE";"TOMAR DO GERU";56;8;23;87
2017;"UMBAUBA (SE)";"SE";"UMBAUBA";316;43;47;406
2017;"ADAMANTINA (SP)";"SP";"ADAMANTINA";737;65;76;878
2017;"ADOLFO (SP)";"SP";"ADOLFO";77;2;27;106
2017;"AGUAI (SP)";"SP";"AGUAI";928;83;198;1209
2017;"AGUAS DA PRATA (SP)";"SP";"AGUAS DA PRATA";129;19;14;162
2017;"AGUAS DE LINDOIA (SP)";"SP";"AGUAS DE LINDOIA";200;82;98;380
2017;"AGUAS DE SANTA BARBARA (SP)";"SP";"AGUAS DE SANTA BARBARA";128;33;32;193
2017;"AGUAS DE SAO PEDRO (SP)";"SP";"AGUAS DE SAO PEDRO";38;11;6;55
2017;"AGUDOS (SP)";"SP";"AGUDOS";586;122;104;812
2017;"ALAMBARI (SP)";"SP";"ALAMBARI";93;18;8;119
2017;"ALFREDO MARCONDES (SP)";"SP";"ALFREDO MARCONDES";72;11;9;92
2017;"ALTAIR (SP)";"SP";"ALTAIR";74;5;38;117
2017;"ALTINOPOLIS (SP)";"SP";"ALTINOPOLIS";401;59;131;591
2017;"ALTO ALEGRE (SP)";"SP";"ALTO ALEGRE";107;4;47;158
2017;"ALUMINIO (SP)";"SP";"ALUMINIO";247;45;43;335
2017;"ALVARES FLORENCE (SP)";"SP";"ALVARES FLORENCE";63;3;17;83
2017;"ALVARES MACHADO (SP)";"SP";"ALVARES MACHADO";489;38;36;563
2017;"ALVARO DE CARVALHO (SP)";"SP";"ALVARO DE CARVALHO";35;6;30;71
2017;"ALVINLANDIA (SP)";"SP";"ALVINLANDIA";52;7;15;74
2017;"AMERICANA (SP)";"SP";"AMERICANA";3509;579;570;4658
2017;"AMERICO BRASILIENSE (SP)";"SP";"AMERICO BRASILIENSE";711;72;219;1002
2017;"AMERICO DE CAMPOS (SP)";"SP";"AMERICO DE CAMPOS";124;13;32;169
2017;"AMPARO (SP)";"SP";"AMPARO";1452;243;148;1843
2017;"ANALANDIA (SP)";"SP";"ANALANDIA";94;13;17;124
2017;"ANDRADINA (SP)";"SP";"ANDRADINA";1343;108;159;1610
2017;"ANGATUBA (SP)";"SP";"ANGATUBA";408;78;120;606
2017;"ANHEMBI (SP)";"SP";"ANHEMBI";101;22;23;146
2017;"ANHUMAS (SP)";"SP";"ANHUMAS";83;13;10;106
2017;"APARECIDA (SP)";"SP";"APARECIDA";862;82;529;1473
2017;"APARECIDA D OESTE (SP)";"SP";"APARECIDA D OESTE";102;13;26;141
2017;"APIAI (SP)";"SP";"APIAI";405;64;97;566
2017;"ARACARIGUAMA (SP)";"SP";"ARACARIGUAMA";601;71;57;729
2017;"ARACATUBA (SP)";"SP";"ARACATUBA";3684;325;697;4706
2017;"ARACOIABA DA SERRA (SP)";"SP";"ARACOIABA DA SERRA";562;114;34;710
2017;"ARAMINA (SP)";"SP";"ARAMINA";72;13;28;113
2017;"ARANDU (SP)";"SP";"ARANDU";68;12;25;105
2017;"ARAPEI (SP)";"SP";"ARAPEI";39;11;11;61
2017;"ARARAQUARA (SP)";"SP";"ARARAQUARA";3826;475;1194;5495
2017;"ARARAS (SP)";"SP";"ARARAS";2378;326;372;3076
2017;"ARCO IRIS (SP)";"SP";"ARCO IRIS";73;4;7;84
2017;"AREALVA (SP)";"SP";"AREALVA";197;8;29;234
2017;"AREIAS (SP)";"SP";"AREIAS";60;5;8;73
2017;"AREIOPOLIS (SP)";"SP";"AREIOPOLIS";153;38;137;328
2017;"ARIRANHA (SP)";"SP";"ARIRANHA";276;25;190;491
2017;"ARTUR NOGUEIRA (SP)";"SP";"ARTUR NOGUEIRA";1116;120;172;1408
2017;"ARUJA (SP)";"SP";"ARUJA";3103;346;465;3914
2017;"ASPASIA (SP)";"SP";"ASPASIA";26;7;5;38
2017;"ASSIS (SP)";"SP";"ASSIS";1942;196;384;2522
2017;"ATIBAIA (SP)";"SP";"ATIBAIA";2599;433;397;3429
2017;"AURIFLAMA (SP)";"SP";"AURIFLAMA";353;33;54;440
2017;"AVAI (SP)";"SP";"AVAI";83;15;23;121
2017;"AVANHANDAVA (SP)";"SP";"AVANHANDAVA";179;12;70;261
2017;"AVARE (SP)";"SP";"AVARE";1397;152;304;1853
2017;"BADY BASSITT (SP)";"SP";"BADY BASSITT";401;38;78;517
2017;"BALBINOS (SP)";"SP";"BALBINOS";24;2;8;34
2017;"BALSAMO (SP)";"SP";"BALSAMO";214;7;23;244
2017;"BANANAL (SP)";"SP";"BANANAL";176;23;38;237
2017;"BARAO DE ANTONINA (SP)";"SP";"BARAO DE ANTONINA";34;6;14;54
2017;"BARBOSA (SP)";"SP";"BARBOSA";122;11;46;179
2017;"BARIRI (SP)";"SP";"BARIRI";865;63;97;1025
2017;"BARRA BONITA (SP)";"SP";"BARRA BONITA";1017;84;264;1365
2017;"BARRA DO CHAPEU (SP)";"SP";"BARRA DO CHAPEU";68;7;17;92
2017;"BARRA DO TURVO (SP)";"SP";"BARRA DO TURVO";81;20;62;163
2017;"BARRETOS (SP)";"SP";"BARRETOS";2212;258;533;3003
2017;"BARRINHA (SP)";"SP";"BARRINHA";487;62;205;754
2017;"BARUERI (SP)";"SP";"BARUERI";6103;854;1259;8216
2017;"BASTOS (SP)";"SP";"BASTOS";906;35;109;1050
2017;"BATATAIS (SP)";"SP";"BATATAIS";1210;161;193;1564
2017;"BAURU (SP)";"SP";"BAURU";5967;500;1281;7748
2017;"BEBEDOURO (SP)";"SP";"BEBEDOURO";1719;171;317;2207
2017;"BENTO DE ABREU (SP)";"SP";"BENTO DE ABREU";64;11;14;89
2017;"BERNARDINO DE CAMPOS (SP)";"SP";"BERNARDINO DE CAMPOS";364;41;42;447
2017;"BERTIOGA (SP)";"SP";"BERTIOGA";545;75;101;721
2017;"BILAC (SP)";"SP";"BILAC";169;7;21;197
2017;"BIRIGUI (SP)";"SP";"BIRIGUI";1889;134;191;2214
2017;"BIRITIBA MIRIM (SP)";"SP";"BIRITIBA MIRIM";460;66;68;594
2017;"BOA ESPERANCA DO SUL (SP)";"SP";"BOA ESPERANCA DO SUL";346;48;114;508
2017;"BOCAINA (SP)";"SP";"BOCAINA";203;51;37;291
2017;"BOFETE (SP)";"SP";"BOFETE";223;60;58;341
2017;"BOITUVA (SP)";"SP";"BOITUVA";1530;190;158;1878
2017;"BOM JESUS DOS PERDOES (SP)";"SP";"BOM JESUS DOS PERDOES";568;80;73;721
2017;"BOM SUCESSO DE ITARARE (SP)";"SP";"BOM SUCESSO DE ITARARE";72;8;14;94
2017;"BORA (SP)";"SP";"BORA";43;2;8;53
2017;"BORACEIA (SP)";"SP";"BORACEIA";199;14;23;236
2017;"BORBOREMA (SP)";"SP";"BORBOREMA";390;38;92;520
2017;"BOREBI (SP)";"SP";"BOREBI";54;8;5;67
2017;"BOTUCATU (SP)";"SP";"BOTUCATU";1841;374;487;2702
2017;"BRAGANCA PAULISTA (SP)";"SP";"BRAGANCA PAULISTA";2978;412;394;3784
2017;"BRAUNA (SP)";"SP";"BRAUNA";85;11;76;172
2017;"BREJO ALEGRE (SP)";"SP";"BREJO ALEGRE";151;2;19;172
2017;"BRODOWSKI (SP)";"SP";"BRODOWSKI";647;41;57;745
2017;"BROTAS (SP)";"SP";"BROTAS";536;73;206;815
2017;"BURI (SP)";"SP";"BURI";508;49;96;653
2017;"BURITAMA (SP)";"SP";"BURITAMA";345;34;77;456
2017;"BURITIZAL (SP)";"SP";"BURITIZAL";124;17;33;174
2017;"CABRALIA PAULISTA (SP)";"SP";"CABRALIA PAULISTA";149;8;20;177
2017;"CABREUVA (SP)";"SP";"CABREUVA";1036;152;63;1251
2017;"CACAPAVA (SP)";"SP";"CACAPAVA";1201;311;201;1713
2017;"CACHOEIRA PAULISTA (SP)";"SP";"CACHOEIRA PAULISTA";425;111;26;562
2017;"CACONDE (SP)";"SP";"CACONDE";280;81;79;440
2017;"CAFELANDIA (SP)";"SP";"CAFELANDIA";303;30;86;419
2017;"CAIABU (SP)";"SP";"CAIABU";43;9;39;91
2017;"CAIEIRAS (SP)";"SP";"CAIEIRAS";1154;298;439;1891
2017;"CAIUA (SP)";"SP";"CAIUA";57;15;25;97
2017;"CAJAMAR (SP)";"SP";"CAJAMAR";1639;249;344;2232
2017;"CAJATI (SP)";"SP";"CAJATI";672;87;91;850
2017;"CAJOBI (SP)";"SP";"CAJOBI";247;11;97;355
2017;"CAJURU (SP)";"SP";"CAJURU";531;35;105;671
2017;"CAMPINA DO MONTE ALEGRE (SP)";"SP";"CAMPINA DO MONTE ALEGRE";92;21;30;143
2017;"CAMPINAS (SP)";"SP";"CAMPINAS";20276;3807;5518;29601
2017;"CAMPO LIMPO PAULISTA (SP)";"SP";"CAMPO LIMPO PAULISTA";689;118;41;848
2017;"CAMPOS DO JORDAO (SP)";"SP";"CAMPOS DO JORDAO";651;173;61;885
2017;"CAMPOS NOVOS PAULISTA (SP)";"SP";"CAMPOS NOVOS PAULISTA";112;7;35;154
2017;"CANANEIA (SP)";"SP";"CANANEIA";108;13;15;136
2017;"CANAS (SP)";"SP";"CANAS";143;11;10;164
2017;"CANDIDO MOTA (SP)";"SP";"CANDIDO MOTA";1021;68;75;1164
2017;"CANDIDO RODRIGUES (SP)";"SP";"CANDIDO RODRIGUES";112;11;12;135
2017;"CANITAR (SP)";"SP";"CANITAR";58;16;21;95
2017;"CAPAO BONITO (SP)";"SP";"CAPAO BONITO";1004;163;205;1372
2017;"CAPELA DO ALTO (SP)";"SP";"CAPELA DO ALTO";576;76;50;702
2017;"CAPIVARI (SP)";"SP";"CAPIVARI";1190;114;243;1547
2017;"CARAGUATATUBA (SP)";"SP";"CARAGUATATUBA";1663;177;133;1973
2017;"CARAPICUIBA (SP)";"SP";"CARAPICUIBA";3920;892;932;5744
2017;"CARDOSO (SP)";"SP";"CARDOSO";187;20;55;262
2017;"CASA BRANCA (SP)";"SP";"CASA BRANCA";605;72;108;785
2017;"CASSIA DOS COQUEIROS (SP)";"SP";"CASSIA DOS COQUEIROS";26;6;15;47
2017;"CASTILHO (SP)";"SP";"CASTILHO";256;43;124;423
2017;"CATANDUVA (SP)";"SP";"CATANDUVA";2959;281;491;3731
2017;"CATIGUA (SP)";"SP";"CATIGUA";91;11;33;135
2017;"CEDRAL (SP)";"SP";"CEDRAL";229;23;22;274
2017;"CERQUEIRA CESAR (SP)";"SP";"CERQUEIRA CESAR";417;48;148;613
2017;"CERQUILHO (SP)";"SP";"CERQUILHO";911;152;121;1184
2017;"CESARIO LANGE (SP)";"SP";"CESARIO LANGE";371;48;62;481
2017;"CHARQUEADA (SP)";"SP";"CHARQUEADA";452;43;101;596
2017;"CHAVANTES (SP)";"SP";"CHAVANTES";143;37;59;239
2017;"CLEMENTINA (SP)";"SP";"CLEMENTINA";311;12;63;386
2017;"COLINA (SP)";"SP";"COLINA";399;34;94;527
2017;"COLOMBIA (SP)";"SP";"COLOMBIA";143;35;69;247
2017;"CONCHAL (SP)";"SP";"CONCHAL";831;76;276;1183
2017;"CONCHAS (SP)";"SP";"CONCHAS";364;53;42;459
2017;"CORDEIROPOLIS (SP)";"SP";"CORDEIROPOLIS";774;81;54;909
2017;"COROADOS (SP)";"SP";"COROADOS";104;7;22;133
2017;"CORONEL MACEDO (SP)";"SP";"CORONEL MACEDO";67;15;24;106
2017;"CORUMBATAI (SP)";"SP";"CORUMBATAI";162;8;13;183
2017;"COSMOPOLIS (SP)";"SP";"COSMOPOLIS";845;265;259;1369
2017;"COSMORAMA (SP)";"SP";"COSMORAMA";235;15;49;299
2017;"COTIA (SP)";"SP";"COTIA";3300;869;900;5069
2017;"CRAVINHOS (SP)";"SP";"CRAVINHOS";975;51;170;1196
2017;"CRISTAIS PAULISTA (SP)";"SP";"CRISTAIS PAULISTA";142;12;29;183
2017;"CRUZALIA (SP)";"SP";"CRUZALIA";85;8;5;98
2017;"CRUZEIRO (SP)";"SP";"CRUZEIRO";799;178;58;1035
2017;"CUBATAO (SP)";"SP";"CUBATAO";2810;423;405;3638
2017;"CUNHA (SP)";"SP";"CUNHA";342;82;50;474
2017;"DESCALVADO (SP)";"SP";"DESCALVADO";1082;117;183;1382
2017;"DIADEMA (SP)";"SP";"DIADEMA";4416;686;677;5779
2017;"DIRCE REIS (SP)";"SP";"DIRCE REIS";70;5;8;83
2017;"DIVINOLANDIA (SP)";"SP";"DIVINOLANDIA";477;35;65;577
2017;"DOBRADA (SP)";"SP";"DOBRADA";70;22;88;180
2017;"DOIS CORREGOS (SP)";"SP";"DOIS CORREGOS";682;96;166;944
2017;"DOLCINOPOLIS (SP)";"SP";"DOLCINOPOLIS";35;5;8;48
2017;"DOURADO (SP)";"SP";"DOURADO";202;36;58;296
2017;"DRACENA (SP)";"SP";"DRACENA";1142;63;186;1391
2017;"DUARTINA (SP)";"SP";"DUARTINA";275;30;75;380
2017;"DUMONT (SP)";"SP";"DUMONT";356;10;54;420
2017;"ECHAPORA (SP)";"SP";"ECHAPORA";159;4;27;190
2017;"ELDORADO (SP)";"SP";"ELDORADO";294;32;66;392
2017;"ELIAS FAUSTO (SP)";"SP";"ELIAS FAUSTO";347;20;91;458
2017;"ELISIARIO (SP)";"SP";"ELISIARIO";53;9;11;73
2017;"EMBAUBA (SP)";"SP";"EMBAUBA";71;5;26;102
2017;"EMBU (SP)";"SP";"EMBU";2724;737;778;4239
2017;"EMBU GUACU (SP)";"SP";"EMBU GUACU";2459;285;332;3076
2017;"EMILIANOPOLIS (SP)";"SP";"EMILIANOPOLIS";52;3;14;69
2017;"ENGENHEIRO COELHO (SP)";"SP";"ENGENHEIRO COELHO";410;63;186;659
2017;"ESPIRITO SANTO DO PINHAL (SP)";"SP";"ESPIRITO SANTO DO PINHAL";669;136;73;878
2017;"ESPIRITO SANTO DO TURVO (SP)";"SP";"ESPIRITO SANTO DO TURVO";160;23;39;222
2017;"ESTIVA GERBI (SP)";"SP";"ESTIVA GERBI";270;18;31;319
2017;"ESTRELA D OESTE (SP)";"SP";"ESTRELA D OESTE";258;6;38;302
2017;"ESTRELA DO NORTE (SP)";"SP";"ESTRELA DO NORTE";27;0;8;35
2017;"EUCLIDES DA CUNHA PAULISTA (SP)";"SP";"EUCLIDES DA CUNHA PAULISTA";109;8;58;175
2017;"FARTURA (SP)";"SP";"FARTURA";336;42;49;427
2017;"FERNANDO PRESTES (SP)";"SP";"FERNANDO PRESTES";250;10;19;279
2017;"FERNANDOPOLIS (SP)";"SP";"FERNANDOPOLIS";1584;94;219;1897
2017;"FERNAO (SP)";"SP";"FERNAO";32;6;10;48
2017;"FERRAZ DE VASCONCELOS (SP)";"SP";"FERRAZ DE VASCONCELOS";2115;318;385;2818
2017;"FLORA RICA (SP)";"SP";"FLORA RICA";26;3;8;37
2017;"FLOREAL (SP)";"SP";"FLOREAL";63;9;8;80
2017;"FLORIDA PAULISTA (SP)";"SP";"FLORIDA PAULISTA";344;25;126;495
2017;"FLORINEA (SP)";"SP";"FLORINEA";52;7;11;70
2017;"FRANCA (SP)";"SP";"FRANCA";3762;444;710;4916
2017;"FRANCISCO MORATO (SP)";"SP";"FRANCISCO MORATO";602;259;243;1104
2017;"FRANCO DA ROCHA (SP)";"SP";"FRANCO DA ROCHA";951;263;206;1420
2017;"GABRIEL MONTEIRO (SP)";"SP";"GABRIEL MONTEIRO";64;2;13;79
2017;"GALIA (SP)";"SP";"GALIA";159;18;45;222
2017;"GARCA (SP)";"SP";"GARCA";782;107;120;1009
2017;"GASTAO VIDIGAL (SP)";"SP";"GASTAO VIDIGAL";63;7;67;137
2017;"GAVIAO PEIXOTO (SP)";"SP";"GAVIAO PEIXOTO";74;13;26;113
2017;"GENERAL SALGADO (SP)";"SP";"GENERAL SALGADO";274;21;97;392
2017;"GETULINA (SP)";"SP";"GETULINA";133;10;74;217
2017;"GLICERIO (SP)";"SP";"GLICERIO";139;10;34;183
2017;"GUAICARA (SP)";"SP";"GUAICARA";120;14;31;165
2017;"GUAIMBE (SP)";"SP";"GUAIMBE";138;5;33;176
2017;"GUAIRA (SP)";"SP";"GUAIRA";1334;108;216;1658
2017;"GUAPIACU (SP)";"SP";"GUAPIACU";470;30;76;576
2017;"GUAPIARA (SP)";"SP";"GUAPIARA";404;46;57;507
2017;"GUARA (SP)";"SP";"GUARA";242;46;187;475
2017;"GUARACAI (SP)";"SP";"GUARACAI";300;23;35;358
2017;"GUARACI (SP)";"SP";"GUARACI";210;19;87;316
2017;"GUARANI D OESTE (SP)";"SP";"GUARANI D OESTE";34;4;6;44
2017;"GUARANTA (SP)";"SP";"GUARANTA";96;6;45;147
2017;"GUARARAPES (SP)";"SP";"GUARARAPES";705;66;157;928
2017;"GUARAREMA (SP)";"SP";"GUARAREMA";550;81;83;714
2017;"GUARATINGUETA (SP)";"SP";"GUARATINGUETA";1355;407;210;1972
2017;"GUAREI (SP)";"SP";"GUAREI";319;30;91;440
2017;"GUARIBA (SP)";"SP";"GUARIBA";867;73;301;1241
2017;"GUARUJA (SP)";"SP";"GUARUJA";2186;449;430;3065
2017;"GUARULHOS (SP)";"SP";"GUARULHOS";20799;4026;4034;28859
2017;"GUATAPARA (SP)";"SP";"GUATAPARA";195;20;63;278
2017;"GUZOLANDIA (SP)";"SP";"GUZOLANDIA";86;5;32;123
2017;"HERCULANDIA (SP)";"SP";"HERCULANDIA";522;8;28;558
2017;"HOLAMBRA (SP)";"SP";"HOLAMBRA";403;60;110;573
2017;"HORTOLANDIA (SP)";"SP";"HORTOLANDIA";2352;555;594;3501
2017;"IACANGA (SP)";"SP";"IACANGA";274;43;49;366
2017;"IACRI (SP)";"SP";"IACRI";155;7;21;183
2017;"IARAS (SP)";"SP";"IARAS";70;19;34;123
2017;"IBATE (SP)";"SP";"IBATE";618;131;220;969
2017;"IBIRA (SP)";"SP";"IBIRA";177;21;52;250
2017;"IBIRAREMA (SP)";"SP";"IBIRAREMA";237;16;31;284
2017;"IBITINGA (SP)";"SP";"IBITINGA";912;116;200;1228
2017;"IBIUNA (SP)";"SP";"IBIUNA";2309;262;111;2682
2017;"ICEM (SP)";"SP";"ICEM";224;11;76;311
2017;"IEPE (SP)";"SP";"IEPE";199;12;37;248
2017;"IGARACU DO TIETE (SP)";"SP";"IGARACU DO TIETE";370;35;98;503
2017;"IGARAPAVA (SP)";"SP";"IGARAPAVA";597;50;124;771
2017;"IGARATA (SP)";"SP";"IGARATA";153;26;19;198
2017;"IGUAPE (SP)";"SP";"IGUAPE";260;50;119;429
2017;"ILHA COMPRIDA (SP)";"SP";"ILHA COMPRIDA";192;35;83;310
2017;"ILHA SOLTEIRA (SP)";"SP";"ILHA SOLTEIRA";272;34;89;395
2017;"ILHABELA (SP)";"SP";"ILHABELA";367;74;71;512
2017;"INDAIATUBA (SP)";"SP";"INDAIATUBA";3533;632;501;4666
2017;"INDIANA (SP)";"SP";"INDIANA";124;14;13;151
2017;"INDIAPORA (SP)";"SP";"INDIAPORA";76;5;18;99
2017;"INUBIA PAULISTA (SP)";"SP";"INUBIA PAULISTA";52;6;13;71
2017;"IPAUSSU (SP)";"SP";"IPAUSSU";205;28;62;295
2017;"IPERO (SP)";"SP";"IPERO";288;66;38;392
2017;"IPEUNA (SP)";"SP";"IPEUNA";191;28;42;261
2017;"IPIGUA (SP)";"SP";"IPIGUA";44;4;10;58
2017;"IPORANGA (SP)";"SP";"IPORANGA";30;21;9;60
2017;"IPUA (SP)";"SP";"IPUA";273;25;85;383
2017;"IRACEMAPOLIS (SP)";"SP";"IRACEMAPOLIS";575;71;109;755
2017;"IRAPUA (SP)";"SP";"IRAPUA";138;8;87;233
2017;"IRAPURU (SP)";"SP";"IRAPURU";108;12;28;148
2017;"ITABERA (SP)";"SP";"ITABERA";304;74;66;444
2017;"ITAI (SP)";"SP";"ITAI";573;87;203;863
2017;"ITAJOBI (SP)";"SP";"ITAJOBI";557;21;57;635
2017;"ITAJU (SP)";"SP";"ITAJU";72;3;23;98
2017;"ITANHAEM (SP)";"SP";"ITANHAEM";947;258;142;1347
2017;"ITAOCA (SP)";"SP";"ITAOCA";34;12;9;55
2017;"ITAPECERICA DA SERRA (SP)";"SP";"ITAPECERICA DA SERRA";2545;673;811;4029
2017;"ITAPETININGA (SP)";"SP";"ITAPETININGA";2976;500;522;3998
2017;"ITAPEVA (SP)";"SP";"ITAPEVA";2092;343;423;2858
2017;"ITAPEVI (SP)";"SP";"ITAPEVI";2104;453;221;2778
2017;"ITAPIRA (SP)";"SP";"ITAPIRA";1831;143;221;2195
2017;"ITAPIRAPUA PAULISTA (SP)";"SP";"ITAPIRAPUA PAULISTA";55;20;16;91
2017;"ITAPOLIS (SP)";"SP";"ITAPOLIS";1321;119;211;1651
2017;"ITAPORANGA (SP)";"SP";"ITAPORANGA";270;28;87;385
2017;"ITAPUI (SP)";"SP";"ITAPUI";389;45;69;503
2017;"ITAPURA (SP)";"SP";"ITAPURA";30;10;20;60
2017;"ITAQUAQUECETUBA (SP)";"SP";"ITAQUAQUECETUBA";3467;496;468;4431
2017;"ITARARE (SP)";"SP";"ITARARE";982;97;254;1333
2017;"ITARIRI (SP)";"SP";"ITARIRI";404;42;22;468
2017;"ITATIBA (SP)";"SP";"ITATIBA";2557;291;329;3177
2017;"ITATINGA (SP)";"SP";"ITATINGA";266;57;123;446
2017;"ITIRAPINA (SP)";"SP";"ITIRAPINA";322;50;61;433
2017;"ITIRAPUA (SP)";"SP";"ITIRAPUA";96;7;21;124
2017;"ITOBI (SP)";"SP";"ITOBI";175;36;95;306
2017;"ITU (SP)";"SP";"ITU";3243;520;686;4449
2017;"ITUPEVA (SP)";"SP";"ITUPEVA";1570;140;115;1825
2017;"ITUVERAVA (SP)";"SP";"ITUVERAVA";656;69;126;851
2017;"JABORANDI (SP)";"SP";"JABORANDI";181;11;43;235
2017;"JABOTICABAL (SP)";"SP";"JABOTICABAL";2110;118;213;2441
2017;"JACAREI (SP)";"SP";"JACAREI";2753;648;330;3731
2017;"JACI (SP)";"SP";"JACI";217;8;16;241
2017;"JACUPIRANGA (SP)";"SP";"JACUPIRANGA";421;67;460;948
2017;"JAGUARIUNA (SP)";"SP";"JAGUARIUNA";1160;97;173;1430
2017;"JALES (SP)";"SP";"JALES";1231;52;89;1372
2017;"JAMBEIRO (SP)";"SP";"JAMBEIRO";115;38;17;170
2017;"JANDIRA (SP)";"SP";"JANDIRA";1249;360;200;1809
2017;"JARDINOPOLIS (SP)";"SP";"JARDINOPOLIS";1083;119;159;1361
2017;"JARINU (SP)";"SP";"JARINU";670;71;65;806
2017;"JAU (SP)";"SP";"JAU";2544;357;502;3403
2017;"JERIQUARA (SP)";"SP";"JERIQUARA";71;7;24;102
2017;"JOANOPOLIS (SP)";"SP";"JOANOPOLIS";422;41;19;482
2017;"JOAO RAMALHO (SP)";"SP";"JOAO RAMALHO";38;9;22;69
2017;"JOSE BONIFACIO (SP)";"SP";"JOSE BONIFACIO";917;68;163;1148
2017;"JULIO MESQUITA (SP)";"SP";"JULIO MESQUITA";46;9;29;84
2017;"JUMIRIM (SP)";"SP";"JUMIRIM";103;12;6;121
2017;"JUNDIAI (SP)";"SP";"JUNDIAI";8137;870;1147;10154
2017;"JUNQUEIROPOLIS (SP)";"SP";"JUNQUEIROPOLIS";525;32;227;784
2017;"JUQUIA (SP)";"SP";"JUQUIA";448;34;26;508
2017;"JUQUITIBA (SP)";"SP";"JUQUITIBA";680;134;106;920
2017;"LAGOINHA (SP)";"SP";"LAGOINHA";162;27;25;214
2017;"LARANJAL PAULISTA (SP)";"SP";"LARANJAL PAULISTA";780;65;220;1065
2017;"LAVINIA (SP)";"SP";"LAVINIA";82;5;20;107
2017;"LAVRINHAS (SP)";"SP";"LAVRINHAS";92;18;12;122
2017;"LEME (SP)";"SP";"LEME";2535;199;580;3314
2017;"LENCOIS PAULISTA (SP)";"SP";"LENCOIS PAULISTA";1463;242;375;2080
2017;"LIMEIRA (SP)";"SP";"LIMEIRA";4959;979;731;6669
2017;"LINDOIA (SP)";"SP";"LINDOIA";213;31;31;275
2017;"LINS (SP)";"SP";"LINS";1296;135;194;1625
2017;"LORENA (SP)";"SP";"LORENA";984;236;35;1255
2017;"LOURDES (SP)";"SP";"LOURDES";22;3;18;43
2017;"LOUVEIRA (SP)";"SP";"LOUVEIRA";985;167;88;1240
2017;"LUCELIA (SP)";"SP";"LUCELIA";384;27;212;623
2017;"LUCIANOPOLIS (SP)";"SP";"LUCIANOPOLIS";52;11;16;79
2017;"LUIS ANTONIO (SP)";"SP";"LUIS ANTONIO";282;31;211;524
2017;"LUIZIANIA (SP)";"SP";"LUIZIANIA";76;2;32;110
2017;"LUPERCIO (SP)";"SP";"LUPERCIO";53;4;34;91
2017;"LUTECIA (SP)";"SP";"LUTECIA";46;7;13;66
2017;"MACATUBA (SP)";"SP";"MACATUBA";478;34;91;603
2017;"MACAUBAL (SP)";"SP";"MACAUBAL";163;16;23;202
2017;"MACEDONIA (SP)";"SP";"MACEDONIA";50;4;14;68
2017;"MAGDA (SP)";"SP";"MAGDA";117;16;12;145
2017;"MAIRINQUE (SP)";"SP";"MAIRINQUE";633;123;105;861
2017;"MAIRIPORA (SP)";"SP";"MAIRIPORA";2097;304;189;2590
2017;"MANDURI (SP)";"SP";"MANDURI";264;47;96;407
2017;"MARABA PAULISTA (SP)";"SP";"MARABA PAULISTA";40;8;19;67
2017;"MARACAI (SP)";"SP";"MARACAI";326;63;53;442
2017;"MARAPOAMA (SP)";"SP";"MARAPOAMA";158;8;12;178
2017;"MARIAPOLIS (SP)";"SP";"MARIAPOLIS";53;5;36;94
2017;"MARILIA (SP)";"SP";"MARILIA";3426;354;590;4370
2017;"MARINOPOLIS (SP)";"SP";"MARINOPOLIS";84;5;9;98
2017;"MARTINOPOLIS (SP)";"SP";"MARTINOPOLIS";497;51;136;684
2017;"MATAO (SP)";"SP";"MATAO";1653;125;434;2212
2017;"MAUA (SP)";"SP";"MAUA";4078;1105;1515;6698
2017;"MENDONCA (SP)";"SP";"MENDONCA";112;6;28;146
2017;"MERIDIANO (SP)";"SP";"MERIDIANO";181;11;21;213
2017;"MESOPOLIS (SP)";"SP";"MESOPOLIS";20;5;13;38
2017;"MIGUELOPOLIS (SP)";"SP";"MIGUELOPOLIS";276;18;90;384
2017;"MINEIROS DO TIETE (SP)";"SP";"MINEIROS DO TIETE";240;25;62;327
2017;"MIRA ESTRELA (SP)";"SP";"MIRA ESTRELA";50;9;23;82
2017;"MIRACATU (SP)";"SP";"MIRACATU";739;72;33;844
2017;"MIRANDOPOLIS (SP)";"SP";"MIRANDOPOLIS";529;44;209;782
2017;"MIRANTE DO PARANAPANEMA (SP)";"SP";"MIRANTE DO PARANAPANEMA";303;67;105;475
2017;"MIRASSOL (SP)";"SP";"MIRASSOL";1335;67;97;1499
2017;"MIRASSOLANDIA (SP)";"SP";"MIRASSOLANDIA";57;11;11;79
2017;"MOCOCA (SP)";"SP";"MOCOCA";1253;150;368;1771
2017;"MOGI DAS CRUZES (SP)";"SP";"MOGI DAS CRUZES";6590;944;1543;9077
2017;"MOGI GUACU (SP)";"SP";"MOGI GUACU";2629;520;616;3765
2017;"MOGI MIRIM (SP)";"SP";"MOGI MIRIM";2078;228;347;2653
2017;"MOMBUCA (SP)";"SP";"MOMBUCA";102;8;20;130
2017;"MONCOES (SP)";"SP";"MONCOES";78;13;13;104
2017;"MONGAGUA (SP)";"SP";"MONGAGUA";571;119;79;769
2017;"MONTE ALEGRE DO SUL (SP)";"SP";"MONTE ALEGRE DO SUL";242;51;54;347
2017;"MONTE ALTO (SP)";"SP";"MONTE ALTO";1554;93;106;1753
2017;"MONTE APRAZIVEL (SP)";"SP";"MONTE APRAZIVEL";640;60;262;962
2017;"MONTE AZUL PAULISTA (SP)";"SP";"MONTE AZUL PAULISTA";524;52;182;758
2017;"MONTE CASTELO (SP)";"SP";"MONTE CASTELO";87;7;12;106
2017;"MONTE MOR (SP)";"SP";"MONTE MOR";801;123;140;1064
2017;"MONTEIRO LOBATO (SP)";"SP";"MONTEIRO LOBATO";177;33;15;225
2017;"MORRO AGUDO (SP)";"SP";"MORRO AGUDO";775;54;186;1015
2017;"MORUNGABA (SP)";"SP";"MORUNGABA";406;63;31;500
2017;"MOTUCA (SP)";"SP";"MOTUCA";148;9;27;184
2017;"MUNICIPIO NAO INFORMADO (SP)";"SP";"MUNICIPIO NAO INFORMADO";0;0;0;0
2017;"MURUTINGA DO SUL (SP)";"SP";"MURUTINGA DO SUL";86;12;21;119
2017;"NANTES (SP)";"SP";"NANTES";24;11;18;53
2017;"NARANDIBA (SP)";"SP";"NARANDIBA";95;11;23;129
2017;"NATIVIDADE DA SERRA (SP)";"SP";"NATIVIDADE DA SERRA";98;60;9;167
2017;"NAZARE PAULISTA (SP)";"SP";"NAZARE PAULISTA";752;34;55;841
2017;"NEVES PAULISTA (SP)";"SP";"NEVES PAULISTA";194;12;32;238
2017;"NHANDEARA (SP)";"SP";"NHANDEARA";205;22;63;290
2017;"NIPOA (SP)";"SP";"NIPOA";120;11;36;167
2017;"NOVA ALIANCA (SP)";"SP";"NOVA ALIANCA";165;10;20;195
2017;"NOVA CAMPINA (SP)";"SP";"NOVA CAMPINA";88;20;25;133
2017;"NOVA CANAA PAULISTA (SP)";"SP";"NOVA CANAA PAULISTA";39;6;7;52
2017;"NOVA CASTILHO (SP)";"SP";"NOVA CASTILHO";23;3;4;30
2017;"NOVA EUROPA (SP)";"SP";"NOVA EUROPA";165;16;153;334
2017;"NOVA GRANADA (SP)";"SP";"NOVA GRANADA";377;68;118;563
2017;"NOVA GUATAPORANGA (SP)";"SP";"NOVA GUATAPORANGA";43;6;14;63
2017;"NOVA INDEPENDENCIA (SP)";"SP";"NOVA INDEPENDENCIA";66;7;13;86
2017;"NOVA LUZITANIA (SP)";"SP";"NOVA LUZITANIA";33;1;30;64
2017;"NOVA ODESSA (SP)";"SP";"NOVA ODESSA";964;156;133;1253
2017;"NOVAIS (SP)";"SP";"NOVAIS";105;6;42;153
2017;"NOVO HORIZONTE (SP)";"SP";"NOVO HORIZONTE";1244;57;325;1626
2017;"NUPORANGA (SP)";"SP";"NUPORANGA";233;22;61;316
2017;"OCAUCU (SP)";"SP";"OCAUCU";117;10;29;156
2017;"OLEO (SP)";"SP";"OLEO";39;17;9;65
2017;"OLIMPIA (SP)";"SP";"OLIMPIA";983;125;241;1349
2017;"ONDA VERDE (SP)";"SP";"ONDA VERDE";107;10;24;141
2017;"ORIENTE (SP)";"SP";"ORIENTE";104;17;21;142
2017;"ORINDIUVA (SP)";"SP";"ORINDIUVA";256;13;69;338
2017;"ORLANDIA (SP)";"SP";"ORLANDIA";977;63;312;1352
2017;"OSASCO (SP)";"SP";"OSASCO";10023;2235;2779;15037
2017;"OSCAR BRESSANE (SP)";"SP";"OSCAR BRESSANE";63;8;5;76
2017;"OSVALDO CRUZ (SP)";"SP";"OSVALDO CRUZ";525;40;124;689
2017;"OURINHOS (SP)";"SP";"OURINHOS";2241;169;617;3027
2017;"OURO VERDE (SP)";"SP";"OURO VERDE";125;7;61;193
2017;"OUROESTE (SP)";"SP";"OUROESTE";194;10;38;242
2017;"PACAEMBU (SP)";"SP";"PACAEMBU";198;27;40;265
2017;"PALESTINA (SP)";"SP";"PALESTINA";194;18;54;266
2017;"PALMARES PAULISTA (SP)";"SP";"PALMARES PAULISTA";91;24;116;231
2017;"PALMEIRA D OESTE (SP)";"SP";"PALMEIRA D OESTE";275;11;35;321
2017;"PALMITAL (SP)";"SP";"PALMITAL";688;42;67;797
2017;"PANORAMA (SP)";"SP";"PANORAMA";340;12;25;377
2017;"PARAGUACU PAULISTA (SP)";"SP";"PARAGUACU PAULISTA";909;166;136;1211
2017;"PARAIBUNA (SP)";"SP";"PARAIBUNA";262;81;70;413
2017;"PARAISO (SP)";"SP";"PARAISO";202;16;102;320
2017;"PARANAPANEMA (SP)";"SP";"PARANAPANEMA";622;59;86;767
2017;"PARANAPUA (SP)";"SP";"PARANAPUA";100;16;18;134
2017;"PARAPUA (SP)";"SP";"PARAPUA";321;12;62;395
2017;"PARDINHO (SP)";"SP";"PARDINHO";170;34;33;237
2017;"PARIQUERA ACU (SP)";"SP";"PARIQUERA ACU";437;39;19;495
2017;"PARISI (SP)";"SP";"PARISI";34;5;13;52
2017;"PATROCINIO PAULISTA (SP)";"SP";"PATROCINIO PAULISTA";291;19;60;370
2017;"PAULICEIA (SP)";"SP";"PAULICEIA";335;9;30;374
2017;"PAULINIA (SP)";"SP";"PAULINIA";2257;216;384;2857
2017;"PAULISTANIA (SP)";"SP";"PAULISTANIA";26;13;12;51
2017;"PAULO DE FARIA (SP)";"SP";"PAULO DE FARIA";101;15;50;166
2017;"PEDERNEIRAS (SP)";"SP";"PEDERNEIRAS";1163;117;237;1517
2017;"PEDRA BELA (SP)";"SP";"PEDRA BELA";236;12;14;262
2017;"PEDRANOPOLIS (SP)";"SP";"PEDRANOPOLIS";54;4;16;74
2017;"PEDREGULHO (SP)";"SP";"PEDREGULHO";332;52;138;522
2017;"PEDREIRA (SP)";"SP";"PEDREIRA";819;138;78;1035
2017;"PEDRINHAS PAULISTA (SP)";"SP";"PEDRINHAS PAULISTA";176;7;12;195
2017;"PEDRO DE TOLEDO (SP)";"SP";"PEDRO DE TOLEDO";185;52;20;257
2017;"PENAPOLIS (SP)";"SP";"PENAPOLIS";1423;106;307;1836
2017;"PEREIRA BARRETO (SP)";"SP";"PEREIRA BARRETO";415;53;118;586
2017;"PEREIRAS (SP)";"SP";"PEREIRAS";260;17;30;307
2017;"PERUIBE (SP)";"SP";"PERUIBE";721;237;105;1063
2017;"PIACATU (SP)";"SP";"PIACATU";99;3;23;125
2017;"PIEDADE (SP)";"SP";"PIEDADE";1618;169;122;1909
2017;"PILAR DO SUL (SP)";"SP";"PILAR DO SUL";1115;87;87;1289
2017;"PINDAMONHANGABA (SP)";"SP";"PINDAMONHANGABA";2046;477;181;2704
2017;"PINDORAMA (SP)";"SP";"PINDORAMA";331;38;63;432
2017;"PINHALZINHO (SP)";"SP";"PINHALZINHO";455;61;19;535
2017;"PIQUEROBI (SP)";"SP";"PIQUEROBI";53;5;11;69
2017;"PIQUETE (SP)";"SP";"PIQUETE";237;51;18;306
2017;"PIRACAIA (SP)";"SP";"PIRACAIA";541;92;41;674
2017;"PIRACICABA (SP)";"SP";"PIRACICABA";8013;962;1483;10458
2017;"PIRAJU (SP)";"SP";"PIRAJU";512;82;79;673
2017;"PIRAJUI (SP)";"SP";"PIRAJUI";325;21;92;438
2017;"PIRANGI (SP)";"SP";"PIRANGI";417;17;81;515
2017;"PIRAPORA DO BOM JESUS (SP)";"SP";"PIRAPORA DO BOM JESUS";308;58;99;465
2017;"PIRAPOZINHO (SP)";"SP";"PIRAPOZINHO";501;42;99;642
2017;"PIRASSUNUNGA (SP)";"SP";"PIRASSUNUNGA";1139;169;239;1547
2017;"PIRATININGA (SP)";"SP";"PIRATININGA";286;33;44;363
2017;"PITANGUEIRAS (SP)";"SP";"PITANGUEIRAS";991;54;327;1372
2017;"PLANALTO (SP)";"SP";"PLANALTO";170;12;62;244
2017;"PLATINA (SP)";"SP";"PLATINA";60;17;13;90
2017;"POA (SP)";"SP";"POA";1023;232;194;1449
2017;"POLONI (SP)";"SP";"POLONI";184;4;55;243
2017;"POMPEIA (SP)";"SP";"POMPEIA";305;18;52;375
2017;"PONGAI (SP)";"SP";"PONGAI";66;6;20;92
2017;"PONTAL (SP)";"SP";"PONTAL";1074;38;576;1688
2017;"PONTALINDA (SP)";"SP";"PONTALINDA";43;14;31;88
2017;"PONTES GESTAL (SP)";"SP";"PONTES GESTAL";109;6;32;147
2017;"POPULINA (SP)";"SP";"POPULINA";58;8;18;84
2017;"PORANGABA (SP)";"SP";"PORANGABA";184;14;18;216
2017;"PORTO FELIZ (SP)";"SP";"PORTO FELIZ";1415;127;206;1748
2017;"PORTO FERREIRA (SP)";"SP";"PORTO FERREIRA";1225;131;162;1518
2017;"POTIM (SP)";"SP";"POTIM";83;52;25;160
2017;"POTIRENDABA (SP)";"SP";"POTIRENDABA";558;22;88;668
2017;"PRACINHA (SP)";"SP";"PRACINHA";12;3;14;29
2017;"PRADOPOLIS (SP)";"SP";"PRADOPOLIS";413;25;262;700
2017;"PRAIA GRANDE (SP)";"SP";"PRAIA GRANDE";2495;424;405;3324
2017;"PRATANIA (SP)";"SP";"PRATANIA";133;24;72;229
2017;"PRESIDENTE ALVES (SP)";"SP";"PRESIDENTE ALVES";63;7;51;121
2017;"PRESIDENTE BERNARDES (SP)";"SP";"PRESIDENTE BERNARDES";273;41;54;368
2017;"PRESIDENTE EPITACIO (SP)";"SP";"PRESIDENTE EPITACIO";584;82;182;848
2017;"PRESIDENTE PRUDENTE (SP)";"SP";"PRESIDENTE PRUDENTE";4096;408;898;5402
2017;"PRESIDENTE VENCESLAU (SP)";"SP";"PRESIDENTE VENCESLAU";733;63;81;877
2017;"PROMISSAO (SP)";"SP";"PROMISSAO";804;181;189;1174
2017;"QUADRA (SP)";"SP";"QUADRA";72;11;20;103
2017;"QUATA (SP)";"SP";"QUATA";249;32;69;350
2017;"QUEIROZ (SP)";"SP";"QUEIROZ";25;9;12;46
2017;"QUELUZ (SP)";"SP";"QUELUZ";123;44;12;179
2017;"QUINTANA (SP)";"SP";"QUINTANA";208;17;26;251
2017;"RAFARD (SP)";"SP";"RAFARD";273;28;32;333
2017;"RANCHARIA (SP)";"SP";"RANCHARIA";647;77;111;835
2017;"REDENCAO DA SERRA (SP)";"SP";"REDENCAO DA SERRA";98;42;36;176
2017;"REGENTE FEIJO (SP)";"SP";"REGENTE FEIJO";413;43;37;493
2017;"REGINOPOLIS (SP)";"SP";"REGINOPOLIS";87;13;21;121
2017;"REGISTRO (SP)";"SP";"REGISTRO";1341;146;289;1776
2017;"RESTINGA (SP)";"SP";"RESTINGA";125;11;34;170
2017;"RIBEIRA (SP)";"SP";"RIBEIRA";32;13;13;58
2017;"RIBEIRAO BONITO (SP)";"SP";"RIBEIRAO BONITO";300;57;110;467
2017;"RIBEIRAO BRANCO (SP)";"SP";"RIBEIRAO BRANCO";221;52;73;346
2017;"RIBEIRAO CORRENTE (SP)";"SP";"RIBEIRAO CORRENTE";102;8;48;158
2017;"RIBEIRAO DO SUL (SP)";"SP";"RIBEIRAO DO SUL";154;14;17;185
2017;"RIBEIRAO DOS INDIOS (SP)";"SP";"RIBEIRAO DOS INDIOS";34;4;7;45
2017;"RIBEIRAO GRANDE (SP)";"SP";"RIBEIRAO GRANDE";82;28;16;126
2017;"RIBEIRAO PIRES (SP)";"SP";"RIBEIRAO PIRES";2965;514;481;3960
2017;"RIBEIRAO PRETO (SP)";"SP";"RIBEIRAO PRETO";11180;1078;1837;14095
2017;"RIFAINA (SP)";"SP";"RIFAINA";49;15;11;75
2017;"RINCAO (SP)";"SP";"RINCAO";265;25;50;340
2017;"RINOPOLIS (SP)";"SP";"RINOPOLIS";203;11;58;272
2017;"RIO CLARO (SP)";"SP";"RIO CLARO";3468;476;482;4426
2017;"RIO DAS PEDRAS (SP)";"SP";"RIO DAS PEDRAS";682;117;198;997
2017;"RIO GRANDE DA SERRA (SP)";"SP";"RIO GRANDE DA SERRA";528;222;101;851
2017;"RIOLANDIA (SP)";"SP";"RIOLANDIA";89;19;53;161
2017;"RIVERSUL (SP)";"SP";"RIVERSUL";84;35;35;154
2017;"ROSANA (SP)";"SP";"ROSANA";186;39;74;299
2017;"ROSEIRA (SP)";"SP";"ROSEIRA";141;90;22;253
2017;"RUBIACEA (SP)";"SP";"RUBIACEA";33;4;11;48
2017;"RUBINEIA (SP)";"SP";"RUBINEIA";36;12;13;61
2017;"SABINO (SP)";"SP";"SABINO";65;6;16;87
2017;"SAGRES (SP)";"SP";"SAGRES";23;2;6;31
2017;"SALES (SP)";"SP";"SALES";93;4;37;134
2017;"SALES OLIVEIRA (SP)";"SP";"SALES OLIVEIRA";276;17;61;354
2017;"SALESOPOLIS (SP)";"SP";"SALESOPOLIS";870;85;121;1076
2017;"SALMOURAO (SP)";"SP";"SALMOURAO";39;5;46;90
2017;"SALTINHO (SP)";"SP";"SALTINHO";393;22;14;429
2017;"SALTO (SP)";"SP";"SALTO";2459;298;167;2924
2017;"SALTO DE PIRAPORA (SP)";"SP";"SALTO DE PIRAPORA";765;97;101;963
2017;"SALTO GRANDE (SP)";"SP";"SALTO GRANDE";160;18;35;213
2017;"SANDOVALINA (SP)";"SP";"SANDOVALINA";67;6;21;94
2017;"SANTA ADELIA (SP)";"SP";"SANTA ADELIA";605;31;89;725
2017;"SANTA ALBERTINA (SP)";"SP";"SANTA ALBERTINA";148;7;28;183
2017;"SANTA BARBARA D OESTE (SP)";"SP";"SANTA BARBARA D OESTE";2532;459;389;3380
2017;"SANTA BRANCA (SP)";"SP";"SANTA BRANCA";142;43;37;222
2017;"SANTA CLARA D OESTE (SP)";"SP";"SANTA CLARA D OESTE";30;5;8;43
2017;"SANTA CRUZ DA CONCEICAO (SP)";"SP";"SANTA CRUZ DA CONCEICAO";154;12;16;182
2017;"SANTA CRUZ DA ESPERANCA (SP)";"SP";"SANTA CRUZ DA ESPERANCA";54;2;4;60
2017;"SANTA CRUZ DAS PALMEIRAS (SP)";"SP";"SANTA CRUZ DAS PALMEIRAS";604;53;245;902
2017;"SANTA CRUZ DO RIO PARDO (SP)";"SP";"SANTA CRUZ DO RIO PARDO";1548;117;114;1779
2017;"SANTA ERNESTINA (SP)";"SP";"SANTA ERNESTINA";72;29;91;192
2017;"SANTA FE DO SUL (SP)";"SP";"SANTA FE DO SUL";669;37;51;757
2017;"SANTA GERTRUDES (SP)";"SP";"SANTA GERTRUDES";629;58;39;726
2017;"SANTA ISABEL (SP)";"SP";"SANTA ISABEL";1264;116;123;1503
2017;"SANTA LUCIA (SP)";"SP";"SANTA LUCIA";122;28;47;197
2017;"SANTA MARIA DA SERRA (SP)";"SP";"SANTA MARIA DA SERRA";264;31;34;329
2017;"SANTA MERCEDES (SP)";"SP";"SANTA MERCEDES";58;9;9;76
2017;"SANTA RITA D OESTE (SP)";"SP";"SANTA RITA D OESTE";38;2;7;47
2017;"SANTA RITA DO PASSA QUATRO (SP)";"SP";"SANTA RITA DO PASSA QUATRO";568;80;58;706
2017;"SANTA ROSA DE VITERBO (SP)";"SP";"SANTA ROSA DE VITERBO";476;42;110;628
2017;"SANTA SALETE (SP)";"SP";"SANTA SALETE";49;3;8;60
2017;"SANTANA DA PONTE PENSA (SP)";"SP";"SANTANA DA PONTE PENSA";26;5;6;37
2017;"SANTANA DE PARNAIBA (SP)";"SP";"SANTANA DE PARNAIBA";2003;368;218;2589
2017;"SANTO ANASTACIO (SP)";"SP";"SANTO ANASTACIO";517;40;64;621
2017;"SANTO ANDRE (SP)";"SP";"SANTO ANDRE";9070;1665;1776;12511
2017;"SANTO ANTONIO DA ALEGRIA (SP)";"SP";"SANTO ANTONIO DA ALEGRIA";128;18;29;175
2017;"SANTO ANTONIO DE POSSE (SP)";"SP";"SANTO ANTONIO DE POSSE";900;78;167;1145
2017;"SANTO ANTONIO DO ARACANGUA (SP)";"SP";"SANTO ANTONIO DO ARACANGUA";202;32;96;330
2017;"SANTO ANTONIO DO JARDIM (SP)";"SP";"SANTO ANTONIO DO JARDIM";222;17;16;255
2017;"SANTO ANTONIO DO PINHAL (SP)";"SP";"SANTO ANTONIO DO PINHAL";176;27;13;216
2017;"SANTO EXPEDITO (SP)";"SP";"SANTO EXPEDITO";29;4;16;49
2017;"SANTOPOLIS DO AGUAPEI (SP)";"SP";"SANTOPOLIS DO AGUAPEI";70;5;31;106
2017;"SANTOS (SP)";"SP";"SANTOS";5482;952;675;7109
2017;"SAO BENTO DO SAPUCAI (SP)";"SP";"SAO BENTO DO SAPUCAI";186;53;14;253
2017;"SAO BERNARDO DO CAMPO (SP)";"SP";"SAO BERNARDO DO CAMPO";11745;2593;4073;18411
2017;"SAO CAETANO DO SUL (SP)";"SP";"SAO CAETANO DO SUL";2856;485;589;3930
2017;"SAO CARLOS (SP)";"SP";"SAO CARLOS";4056;461;445;4962
2017;"SAO FRANCISCO (SP)";"SP";"SAO FRANCISCO";43;5;18;66
2017;"SAO JOAO DA BOA VISTA (SP)";"SP";"SAO JOAO DA BOA VISTA";2079;293;118;2490
2017;"SAO JOAO DAS DUAS PONTES (SP)";"SP";"SAO JOAO DAS DUAS PONTES";29;9;5;43
2017;"SAO JOAO DE IRACEMA (SP)";"SP";"SAO JOAO DE IRACEMA";33;6;10;49
2017;"SAO JOAO DO PAU D ALHO (SP)";"SP";"SAO JOAO DO PAU D ALHO";40;6;7;53
2017;"SAO JOAQUIM DA BARRA (SP)";"SP";"SAO JOAQUIM DA BARRA";817;99;219;1135
2017;"SAO JOSE DA BELA VISTA (SP)";"SP";"SAO JOSE DA BELA VISTA";72;18;47;137
2017;"SAO JOSE DO BARREIRO (SP)";"SP";"SAO JOSE DO BARREIRO";50;15;4;69
2017;"SAO JOSE DO RIO PARDO (SP)";"SP";"SAO JOSE DO RIO PARDO";1269;116;165;1550
2017;"SAO JOSE DO RIO PRETO (SP)";"SP";"SAO JOSE DO RIO PRETO";8593;668;1607;10868
2017;"SAO JOSE DOS CAMPOS (SP)";"SP";"SAO JOSE DOS CAMPOS";7109;1973;1890;10972
2017;"SAO LOURENCO DA SERRA (SP)";"SP";"SAO LOURENCO DA SERRA";361;38;33;432
2017;"SAO LUIZ DO PARAITINGA (SP)";"SP";"SAO LUIZ DO PARAITINGA";223;39;29;291
2017;"SAO MANUEL (SP)";"SP";"SAO MANUEL";780;139;243;1162
2017;"SAO MIGUEL ARCANJO (SP)";"SP";"SAO MIGUEL ARCANJO";772;125;93;990
2017;"SAO PAULO (SP)";"SP";"SAO PAULO";129633;38203;44510;212346
2017;"SAO PEDRO (SP)";"SP";"SAO PEDRO";673;119;106;898
2017;"SAO PEDRO DO TURVO (SP)";"SP";"SAO PEDRO DO TURVO";181;24;50;255
2017;"SAO ROQUE (SP)";"SP";"SAO ROQUE";1239;265;224;1728
2017;"SAO SEBASTIAO (SP)";"SP";"SAO SEBASTIAO";986;146;179;1311
2017;"SAO SEBASTIAO DA GRAMA (SP)";"SP";"SAO SEBASTIAO DA GRAMA";270;37;48;355
2017;"SAO SIMAO (SP)";"SP";"SAO SIMAO";389;29;53;471
2017;"SAO VICENTE (SP)";"SP";"SAO VICENTE";2087;531;1018;3636
2017;"SARAPUI (SP)";"SP";"SARAPUI";183;29;20;232
2017;"SARUTAIA (SP)";"SP";"SARUTAIA";63;12;32;107
2017;"SEBASTIANOPOLIS DO SUL (SP)";"SP";"SEBASTIANOPOLIS DO SUL";272;3;18;293
2017;"SERRA AZUL (SP)";"SP";"SERRA AZUL";187;20;122;329
2017;"SERRA NEGRA (SP)";"SP";"SERRA NEGRA";488;74;49;611
2017;"SERRANA (SP)";"SP";"SERRANA";680;126;265;1071
2017;"SERTAOZINHO (SP)";"SP";"SERTAOZINHO";2768;190;713;3671
2017;"SETE BARRAS (SP)";"SP";"SETE BARRAS";261;37;34;332
2017;"SEVERINIA (SP)";"SP";"SEVERINIA";313;25;249;587
2017;"SILVEIRAS (SP)";"SP";"SILVEIRAS";91;23;7;121
2017;"SOCORRO (SP)";"SP";"SOCORRO";1003;153;60;1216
2017;"SOROCABA (SP)";"SP";"SOROCABA";8125;1535;1725;11385
2017;"SUD MENNUCCI (SP)";"SP";"SUD MENNUCCI";143;18;56;217
2017;"SUMARE (SP)";"SP";"SUMARE";2919;694;672;4285
2017;"SUZANAPOLIS (SP)";"SP";"SUZANAPOLIS";90;10;19;119
2017;"SUZANO (SP)";"SP";"SUZANO";3606;986;917;5509
2017;"TABAPUA (SP)";"SP";"TABAPUA";171;16;63;250
2017;"TABATINGA (SP)";"SP";"TABATINGA";358;28;203;589
2017;"TABOAO DA SERRA (SP)";"SP";"TABOAO DA SERRA";2757;991;561;4309
2017;"TACIBA (SP)";"SP";"TACIBA";94;16;25;135
2017;"TAGUAI (SP)";"SP";"TAGUAI";185;17;32;234
2017;"TAIACU (SP)";"SP";"TAIACU";154;10;27;191
2017;"TAIUVA (SP)";"SP";"TAIUVA";159;8;29;196
2017;"TAMBAU (SP)";"SP";"TAMBAU";587;59;77;723
2017;"TANABI (SP)";"SP";"TANABI";532;59;126;717
2017;"TAPIRAI (SP)";"SP";"TAPIRAI";217;21;12;250
2017;"TAPIRATIBA (SP)";"SP";"TAPIRATIBA";381;38;83;502
2017;"TAQUARAL (SP)";"SP";"TAQUARAL";64;6;21;91
2017;"TAQUARITINGA (SP)";"SP";"TAQUARITINGA";1671;111;354;2136
2017;"TAQUARITUBA (SP)";"SP";"TAQUARITUBA";834;66;117;1017
2017;"TAQUARIVAI (SP)";"SP";"TAQUARIVAI";124;13;19;156
2017;"TARABAI (SP)";"SP";"TARABAI";134;4;31;169
2017;"TARUMA (SP)";"SP";"TARUMA";376;38;182;596
2017;"TATUI (SP)";"SP";"TATUI";2418;203;690;3311
2017;"TAUBATE (SP)";"SP";"TAUBATE";3286;855;612;4753
2017;"TEJUPA (SP)";"SP";"TEJUPA";64;24;13;101
2017;"TEODORO SAMPAIO (SP)";"SP";"TEODORO SAMPAIO";355;44;311;710
2017;"TERRA ROXA (SP)";"SP";"TERRA ROXA";182;19;73;274
2017;"TIETE (SP)";"SP";"TIETE";1302;71;202;1575
2017;"TIMBURI (SP)";"SP";"TIMBURI";29;7;4;40
2017;"TORRE DE PEDRA (SP)";"SP";"TORRE DE PEDRA";56;10;9;75
2017;"TORRINHA (SP)";"SP";"TORRINHA";464;30;47;541
2017;"TRABIJU (SP)";"SP";"TRABIJU";50;10;9;69
2017;"TREMEMBE (SP)";"SP";"TREMEMBE";522;73;20;615
2017;"TRES FRONTEIRAS (SP)";"SP";"TRES FRONTEIRAS";76;24;16;116
2017;"TUIUTI (SP)";"SP";"TUIUTI";129;27;21;177
2017;"TUPA (SP)";"SP";"TUPA";1625;77;260;1962
2017;"TUPI PAULISTA (SP)";"SP";"TUPI PAULISTA";349;21;31;401
2017;"TURIUBA (SP)";"SP";"TURIUBA";28;3;13;44
2017;"TURMALINA (SP)";"SP";"TURMALINA";26;2;11;39
2017;"UBARANA (SP)";"SP";"UBARANA";143;4;40;187
2017;"UBATUBA (SP)";"SP";"UBATUBA";797;147;107;1051
2017;"UBIRAJARA (SP)";"SP";"UBIRAJARA";115;8;43;166
2017;"UCHOA (SP)";"SP";"UCHOA";178;16;50;244
2017;"UNIAO PAULISTA (SP)";"SP";"UNIAO PAULISTA";50;6;11;67
2017;"URANIA (SP)";"SP";"URANIA";170;22;35;227
2017;"URU (SP)";"SP";"URU";12;10;10;32
2017;"URUPES (SP)";"SP";"URUPES";397;21;52;470
2017;"VALENTIM GENTIL (SP)";"SP";"VALENTIM GENTIL";310;20;39;369
2017;"VALINHOS (SP)";"SP";"VALINHOS";2181;566;1941;4688
2017;"VALPARAISO (SP)";"SP";"VALPARAISO";479;34;168;681
2017;"VARGEM (SP)";"SP";"VARGEM";341;24;25;390
2017;"VARGEM GRANDE DO SUL (SP)";"SP";"VARGEM GRANDE DO SUL";1265;106;243;1614
2017;"VARGEM GRANDE PAULISTA (SP)";"SP";"VARGEM GRANDE PAULISTA";1005;120;77;1202
2017;"VARZEA PAULISTA (SP)";"SP";"VARZEA PAULISTA";1263;442;396;2101
2017;"VERA CRUZ (SP)";"SP";"VERA CRUZ";179;32;38;249
2017;"VINHEDO (SP)";"SP";"VINHEDO";1531;159;167;1857
2017;"VIRADOURO (SP)";"SP";"VIRADOURO";401;25;100;526
2017;"VISTA ALEGRE DO ALTO (SP)";"SP";"VISTA ALEGRE DO ALTO";433;38;146;617
2017;"VITORIA BRASIL (SP)";"SP";"VITORIA BRASIL";27;4;8;39
2017;"VOTORANTIM (SP)";"SP";"VOTORANTIM";1321;298;239;1858
2017;"VOTUPORANGA (SP)";"SP";"VOTUPORANGA";2116;167;248;2531
2017;"ZACARIAS (SP)";"SP";"ZACARIAS";59;5;25;89
2017;"ABREULANDIA (TO)";"TO";"ABREULANDIA";19;1;2;22
2017;"AGUIARNOPOLIS (TO)";"TO";"AGUIARNOPOLIS";62;5;16;83
2017;"ALIANCA DO TOCANTINS (TO)";"TO";"ALIANCA DO TOCANTINS";85;11;13;109
2017;"ALMAS (TO)";"TO";"ALMAS";73;1;9;83
2017;"ALVORADA (TO)";"TO";"ALVORADA";201;2;17;220
2017;"ANANAS (TO)";"TO";"ANANAS";86;1;32;119
2017;"ANGICO (TO)";"TO";"ANGICO";18;5;9;32
2017;"APARECIDA DO RIO NEGRO (TO)";"TO";"APARECIDA DO RIO NEGRO";66;13;5;84
2017;"ARAGOMINAS (TO)";"TO";"ARAGOMINAS";56;2;17;75
2017;"ARAGUACEMA (TO)";"TO";"ARAGUACEMA";32;3;12;47
2017;"ARAGUACU (TO)";"TO";"ARAGUACU";112;13;13;138
2017;"ARAGUAINA (TO)";"TO";"ARAGUAINA";3718;171;753;4642
2017;"ARAGUANA (TO)";"TO";"ARAGUANA";91;3;19;113
2017;"ARAGUATINS (TO)";"TO";"ARAGUATINS";327;54;84;465
2017;"ARAPOEMA (TO)";"TO";"ARAPOEMA";53;7;15;75
2017;"ARRAIAS (TO)";"TO";"ARRAIAS";45;0;8;53
2017;"AUGUSTINOPOLIS (TO)";"TO";"AUGUSTINOPOLIS";205;32;41;278
2017;"AURORA DO TOCANTINS (TO)";"TO";"AURORA DO TOCANTINS";11;0;5;16
2017;"AXIXA DO TOCANTINS (TO)";"TO";"AXIXA DO TOCANTINS";49;17;10;76
2017;"BABACULANDIA (TO)";"TO";"BABACULANDIA";230;15;22;267
2017;"BANDEIRANTES DO TOCANTINS (TO)";"TO";"BANDEIRANTES DO TOCANTINS";28;2;4;34
2017;"BARRA DO OURO (TO)";"TO";"BARRA DO OURO";17;0;2;19
2017;"BARROLANDIA (TO)";"TO";"BARROLANDIA";66;3;8;77
2017;"BERNARDO SAYAO (TO)";"TO";"BERNARDO SAYAO";34;1;7;42
2017;"BOM JESUS DO TOCANTINS (TO)";"TO";"BOM JESUS DO TOCANTINS";12;1;4;17
2017;"BRASILANDIA DO TOCANTINS (TO)";"TO";"BRASILANDIA DO TOCANTINS";19;2;2;23
2017;"BREJINHO DE NAZARE (TO)";"TO";"BREJINHO DE NAZARE";54;2;20;76
2017;"BURITI DO TOCANTINS (TO)";"TO";"BURITI DO TOCANTINS";51;12;6;69
2017;"CACHOEIRINHA (TO)";"TO";"CACHOEIRINHA";9;0;1;10
2017;"CAMPOS LINDOS (TO)";"TO";"CAMPOS LINDOS";70;0;8;78
2017;"CARIRI DO TOCANTINS (TO)";"TO";"CARIRI DO TOCANTINS";57;9;13;79
2017;"CARMOLANDIA (TO)";"TO";"CARMOLANDIA";202;17;95;314
2017;"CARRASCO BONITO (TO)";"TO";"CARRASCO BONITO";9;7;3;19
2017;"CASEARA (TO)";"TO";"CASEARA";32;4;8;44
2017;"CENTENARIO (TO)";"TO";"CENTENARIO";6;0;3;9
2017;"CHAPADA DA NATIVIDADE (TO)";"TO";"CHAPADA DA NATIVIDADE";29;1;11;41
2017;"CHAPADA DE AREIA (TO)";"TO";"CHAPADA DE AREIA";7;2;2;11
2017;"COLINAS DO TOCANTINS (TO)";"TO";"COLINAS DO TOCANTINS";602;13;77;692
2017;"COLMEIA (TO)";"TO";"COLMEIA";128;7;18;153
2017;"COMBINADO (TO)";"TO";"COMBINADO";25;1;11;37
2017;"CONCEICAO DO TOCANTINS (TO)";"TO";"CONCEICAO DO TOCANTINS";22;1;3;26
2017;"COUTO DE MAGALHAES (TO)";"TO";"COUTO DE MAGALHAES";32;6;12;50
2017;"CRISTALANDIA (TO)";"TO";"CRISTALANDIA";108;2;8;118
2017;"CRIXAS DO TOCANTINS (TO)";"TO";"CRIXAS DO TOCANTINS";18;1;3;22
2017;"DARCINOPOLIS (TO)";"TO";"DARCINOPOLIS";96;9;16;121
2017;"DIANOPOLIS (TO)";"TO";"DIANOPOLIS";264;22;79;365
2017;"DIVINOPOLIS DO TOCANTINS (TO)";"TO";"DIVINOPOLIS DO TOCANTINS";104;2;8;114
2017;"DOIS IRMAOS DO TOCANTINS (TO)";"TO";"DOIS IRMAOS DO TOCANTINS";45;9;16;70
2017;"DUERE (TO)";"TO";"DUERE";54;2;5;61
2017;"ESPERANTINA (TO)";"TO";"ESPERANTINA";27;10;13;50
2017;"FATIMA (TO)";"TO";"FATIMA";59;2;11;72
2017;"FIGUEIROPOLIS (TO)";"TO";"FIGUEIROPOLIS";94;4;9;107
2017;"FILADELFIA (TO)";"TO";"FILADELFIA";52;8;14;74
2017;"FORMOSO DO ARAGUAIA (TO)";"TO";"FORMOSO DO ARAGUAIA";282;11;37;330
2017;"FORTALEZA DO TABOCAO (TO)";"TO";"FORTALEZA DO TABOCAO";34;4;4;42
2017;"GOIANORTE (TO)";"TO";"GOIANORTE";40;2;15;57
2017;"GOIATINS (TO)";"TO";"GOIATINS";62;6;10;78
2017;"GUARAI (TO)";"TO";"GUARAI";450;23;40;513
2017;"GURUPI (TO)";"TO";"GURUPI";1701;52;254;2007
2017;"IPUEIRAS (TO)";"TO";"IPUEIRAS";10;1;2;13
2017;"ITACAJA (TO)";"TO";"ITACAJA";50;2;4;56
2017;"ITAGUATINS (TO)";"TO";"ITAGUATINS";33;4;15;52
2017;"ITAPIRATINS (TO)";"TO";"ITAPIRATINS";26;2;8;36
2017;"ITAPORA DO TOCANTINS (TO)";"TO";"ITAPORA DO TOCANTINS";21;3;7;31
2017;"JAU DO TOCANTINS (TO)";"TO";"JAU DO TOCANTINS";22;1;9;32
2017;"JUARINA (TO)";"TO";"JUARINA";10;3;7;20
2017;"LAGOA DA CONFUSAO (TO)";"TO";"LAGOA DA CONFUSAO";197;4;19;220
2017;"LAGOA DO TOCANTINS (TO)";"TO";"LAGOA DO TOCANTINS";10;0;4;14
2017;"LAJEADO (TO)";"TO";"LAJEADO";34;2;9;45
2017;"LAVANDEIRA (TO)";"TO";"LAVANDEIRA";4;1;2;7
2017;"LIZARDA (TO)";"TO";"LIZARDA";22;0;1;23
2017;"LUZINOPOLIS (TO)";"TO";"LUZINOPOLIS";13;2;3;18
2017;"MARIANOPOLIS DO TOCANTINS (TO)";"TO";"MARIANOPOLIS DO TOCANTINS";50;2;10;62
2017;"MATEIROS (TO)";"TO";"MATEIROS";26;1;5;32
2017;"MAURILANDIA DO TOCANTINS (TO)";"TO";"MAURILANDIA DO TOCANTINS";14;8;5;27
2017;"MIRACEMA DO TOCANTINS (TO)";"TO";"MIRACEMA DO TOCANTINS";196;20;39;255
2017;"MIRANORTE (TO)";"TO";"MIRANORTE";268;11;25;304
2017;"MONTE DO CARMO (TO)";"TO";"MONTE DO CARMO";30;6;9;45
2017;"MONTE SANTO DO TOCANTINS (TO)";"TO";"MONTE SANTO DO TOCANTINS";18;3;4;25
2017;"MURICILANDIA (TO)";"TO";"MURICILANDIA";14;4;6;24
2017;"NATIVIDADE (TO)";"TO";"NATIVIDADE";99;4;9;112
2017;"NAZARE (TO)";"TO";"NAZARE";24;3;6;33
2017;"NOVA OLINDA (TO)";"TO";"NOVA OLINDA";114;2;32;148
2017;"NOVA ROSALANDIA (TO)";"TO";"NOVA ROSALANDIA";30;1;4;35
2017;"NOVO ACORDO (TO)";"TO";"NOVO ACORDO";27;1;8;36
2017;"NOVO ALEGRE (TO)";"TO";"NOVO ALEGRE";11;1;4;16
2017;"NOVO JARDIM (TO)";"TO";"NOVO JARDIM";16;0;4;20
2017;"OLIVEIRA DE FATIMA (TO)";"TO";"OLIVEIRA DE FATIMA";12;1;5;18
2017;"PALMAS (TO)";"TO";"PALMAS";4793;327;1877;6997
2017;"PALMEIRANTE (TO)";"TO";"PALMEIRANTE";26;4;8;38
2017;"PALMEIRAS DO TOCANTINS (TO)";"TO";"PALMEIRAS DO TOCANTINS";41;6;11;58
2017;"PALMEIROPOLIS (TO)";"TO";"PALMEIROPOLIS";127;3;20;150
2017;"PARAISO DO TOCANTINS (TO)";"TO";"PARAISO DO TOCANTINS";1276;44;134;1454
2017;"PARANA (TO)";"TO";"PARANA";41;3;3;47
2017;"PAU D ARCO (TO)";"TO";"PAU D ARCO";28;1;8;37
2017;"PEDRO AFONSO (TO)";"TO";"PEDRO AFONSO";237;14;58;309
2017;"PEIXE (TO)";"TO";"PEIXE";95;12;47;154
2017;"PEQUIZEIRO (TO)";"TO";"PEQUIZEIRO";43;2;13;58
2017;"PINDORAMA DO TOCANTINS (TO)";"TO";"PINDORAMA DO TOCANTINS";23;1;9;33
2017;"PIRAQUE (TO)";"TO";"PIRAQUE";12;0;6;18
2017;"PIUM (TO)";"TO";"PIUM";59;5;13;77
2017;"PONTE ALTA DO BOM JESUS (TO)";"TO";"PONTE ALTA DO BOM JESUS";20;3;3;26
2017;"PONTE ALTA DO TOCANTINS (TO)";"TO";"PONTE ALTA DO TOCANTINS";26;2;5;33
2017;"PORTO ALEGRE DO TOCANTINS (TO)";"TO";"PORTO ALEGRE DO TOCANTINS";13;0;5;18
2017;"PORTO NACIONAL (TO)";"TO";"PORTO NACIONAL";826;81;193;1100
2017;"PRAIA NORTE (TO)";"TO";"PRAIA NORTE";13;4;5;22
2017;"PRESIDENTE KENNEDY (TO)";"TO";"PRESIDENTE KENNEDY";33;0;3;36
2017;"PUGMIL (TO)";"TO";"PUGMIL";29;2;1;32
2017;"RECURSOLANDIA (TO)";"TO";"RECURSOLANDIA";13;0;1;14
2017;"RIACHINHO (TO)";"TO";"RIACHINHO";121;8;76;205
2017;"RIO DA CONCEICAO (TO)";"TO";"RIO DA CONCEICAO";9;1;3;13
2017;"RIO DOS BOIS (TO)";"TO";"RIO DOS BOIS";17;4;4;25
2017;"RIO SONO (TO)";"TO";"RIO SONO";26;2;7;35
2017;"SAMPAIO (TO)";"TO";"SAMPAIO";57;2;5;64
2017;"SANDOLANDIA (TO)";"TO";"SANDOLANDIA";26;10;1;37
2017;"SANTA FE DO ARAGUAIA (TO)";"TO";"SANTA FE DO ARAGUAIA";74;9;21;104
2017;"SANTA MARIA DO TOCANTINS (TO)";"TO";"SANTA MARIA DO TOCANTINS";17;3;4;24
2017;"SANTA RITA DO TOCANTINS (TO)";"TO";"SANTA RITA DO TOCANTINS";14;1;4;19
2017;"SANTA ROSA DO TOCANTINS (TO)";"TO";"SANTA ROSA DO TOCANTINS";43;1;4;48
2017;"SANTA TEREZA DO TOCANTINS (TO)";"TO";"SANTA TEREZA DO TOCANTINS";23;1;4;28
2017;"SANTA TEREZINHA DO TOCANTINS (TO)";"TO";"SANTA TEREZINHA DO TOCANTINS";16;3;5;24
2017;"SAO BENTO DO TOCANTINS (TO)";"TO";"SAO BENTO DO TOCANTINS";28;4;11;43
2017;"SAO FELIX DO TOCANTINS (TO)";"TO";"SAO FELIX DO TOCANTINS";7;0;1;8
2017;"SAO MIGUEL DO TOCANTINS (TO)";"TO";"SAO MIGUEL DO TOCANTINS";113;12;43;168
2017;"SAO SALVADOR DO TOCANTINS (TO)";"TO";"SAO SALVADOR DO TOCANTINS";24;4;4;32
2017;"SAO SEBASTIAO DO TOCANTINS (TO)";"TO";"SAO SEBASTIAO DO TOCANTINS";16;2;2;20
2017;"SAO VALERIO DA NATIVIDADE (TO)";"TO";"SAO VALERIO DA NATIVIDADE";59;1;7;67
2017;"SILVANOPOLIS (TO)";"TO";"SILVANOPOLIS";55;1;6;62
2017;"SITIO NOVO DO TOCANTINS (TO)";"TO";"SITIO NOVO DO TOCANTINS";49;9;16;74
2017;"SUCUPIRA (TO)";"TO";"SUCUPIRA";15;0;7;22
2017;"TAGUATINGA (TO)";"TO";"TAGUATINGA";158;13;29;200
2017;"TAIPAS DO TOCANTINS (TO)";"TO";"TAIPAS DO TOCANTINS";7;0;2;9
2017;"TALISMA (TO)";"TO";"TALISMA";24;6;6;36
2017;"TOCANTINIA (TO)";"TO";"TOCANTINIA";27;1;8;36
2017;"TOCANTINOPOLIS (TO)";"TO";"TOCANTINOPOLIS";1183;272;396;1851
2017;"TUPIRAMA (TO)";"TO";"TUPIRAMA";24;4;4;32
2017;"TUPIRATINS (TO)";"TO";"TUPIRATINS";12;1;7;20
2017;"WANDERLANDIA (TO)";"TO";"WANDERLANDIA";67;4;11;82
2017;"XAMBIOA (TO)";"TO";"XAMBIOA";143;8;22;173
