"ano";"chave";"UF";"MUNICIPIO";"CAMINHAO";"MICRO_ONIBUS";"ONIBUS";"total"
2018;"ACRELANDIA (AC)";"AC";"ACRELANDIA";249;9;42;300
2018;"ASSIS BRASIL (AC)";"AC";"ASSIS BRASIL";21;3;2;26
2018;"BRASILEIA (AC)";"AC";"BRASILEIA";270;5;18;293
2018;"BUJARI (AC)";"AC";"BUJARI";108;5;12;125
2018;"CAPIXABA (AC)";"AC";"CAPIXABA";79;2;16;97
2018;"CRUZEIRO DO SUL (AC)";"AC";"CRUZEIRO DO SUL";713;60;78;851
2018;"EPITACIOLANDIA (AC)";"AC";"EPITACIOLANDIA";235;3;14;252
2018;"FEIJO (AC)";"AC";"FEIJO";115;1;7;123
2018;"JORDAO (AC)";"AC";"JORDAO";4;0;0;4
2018;"MANCIO LIMA (AC)";"AC";"MANCIO LIMA";95;4;14;113
2018;"MANOEL URBANO (AC)";"AC";"MANOEL URBANO";48;0;5;53
2018;"MARECHAL THAUMATURGO (AC)";"AC";"MARECHAL THAUMATURGO";13;0;9;22
2018;"PLACIDO DE CASTRO (AC)";"AC";"PLACIDO DE CASTRO";148;4;25;177
2018;"PORTO ACRE (AC)";"AC";"PORTO ACRE";171;2;43;216
2018;"PORTO WALTER (AC)";"AC";"PORTO WALTER";9;0;5;14
2018;"RIO BRANCO (AC)";"AC";"RIO BRANCO";4232;228;784;5244
2018;"RODRIGUES ALVES (AC)";"AC";"RODRIGUES ALVES";19;0;8;27
2018;"SANTA ROSA DO PURUS (AC)";"AC";"SANTA ROSA DO PURUS";4;0;3;7
2018;"SENA MADUREIRA (AC)";"AC";"SENA MADUREIRA";106;5;10;121
2018;"SENADOR GUIOMARD (AC)";"AC";"SENADOR GUIOMARD";349;9;33;391
2018;"TARAUACA (AC)";"AC";"TARAUACA";150;21;25;196
2018;"XAPURI (AC)";"AC";"XAPURI";68;5;6;79
2018;"AGUA BRANCA (AL)";"AL";"AGUA BRANCA";120;85;19;224
2018;"ANADIA (AL)";"AL";"ANADIA";46;40;43;129
2018;"ARAPIRACA (AL)";"AL";"ARAPIRACA";2950;410;445;3805
2018;"ATALAIA (AL)";"AL";"ATALAIA";205;47;142;394
2018;"BARRA DE SANTO ANTONIO (AL)";"AL";"BARRA DE SANTO ANTONIO";30;6;26;62
2018;"BARRA DE SAO MIGUEL (AL)";"AL";"BARRA DE SAO MIGUEL";30;5;9;44
2018;"BATALHA (AL)";"AL";"BATALHA";129;41;16;186
2018;"BELEM (AL)";"AL";"BELEM";9;22;5;36
2018;"BELO MONTE (AL)";"AL";"BELO MONTE";34;17;7;58
2018;"BOCA DA MATA (AL)";"AL";"BOCA DA MATA";203;67;95;365
2018;"BRANQUINHA (AL)";"AL";"BRANQUINHA";31;21;21;73
2018;"CACIMBINHAS (AL)";"AL";"CACIMBINHAS";83;45;13;141
2018;"CAJUEIRO (AL)";"AL";"CAJUEIRO";91;10;54;155
2018;"CAMPESTRE (AL)";"AL";"CAMPESTRE";36;58;9;103
2018;"CAMPO ALEGRE (AL)";"AL";"CAMPO ALEGRE";123;105;146;374
2018;"CAMPO GRANDE (AL)";"AL";"CAMPO GRANDE";49;15;20;84
2018;"CANAPI (AL)";"AL";"CANAPI";61;61;24;146
2018;"CAPELA (AL)";"AL";"CAPELA";65;5;60;130
2018;"CARNEIROS (AL)";"AL";"CARNEIROS";33;17;5;55
2018;"CHA PRETA (AL)";"AL";"CHA PRETA";29;10;6;45
2018;"COITE DO NOIA (AL)";"AL";"COITE DO NOIA";87;10;25;122
2018;"COLONIA LEOPOLDINA (AL)";"AL";"COLONIA LEOPOLDINA";92;26;37;155
2018;"COQUEIRO SECO (AL)";"AL";"COQUEIRO SECO";8;3;7;18
2018;"CORURIPE (AL)";"AL";"CORURIPE";355;78;228;661
2018;"CRAIBAS (AL)";"AL";"CRAIBAS";268;39;33;340
2018;"DELMIRO GOUVEIA (AL)";"AL";"DELMIRO GOUVEIA";670;464;100;1234
2018;"DOIS RIACHOS (AL)";"AL";"DOIS RIACHOS";87;22;12;121
2018;"ESTRELA DE ALAGOAS (AL)";"AL";"ESTRELA DE ALAGOAS";62;86;27;175
2018;"FEIRA GRANDE (AL)";"AL";"FEIRA GRANDE";105;5;47;157
2018;"FELIZ DESERTO (AL)";"AL";"FELIZ DESERTO";10;5;11;26
2018;"FLEXEIRAS (AL)";"AL";"FLEXEIRAS";36;19;44;99
2018;"GIRAU DO PONCIANO (AL)";"AL";"GIRAU DO PONCIANO";212;62;88;362
2018;"IBATEGUARA (AL)";"AL";"IBATEGUARA";49;65;16;130
2018;"IGACI (AL)";"AL";"IGACI";147;125;39;311
2018;"IGREJA NOVA (AL)";"AL";"IGREJA NOVA";83;22;106;211
2018;"INHAPI (AL)";"AL";"INHAPI";77;24;9;110
2018;"JACARE DOS HOMENS (AL)";"AL";"JACARE DOS HOMENS";38;11;16;65
2018;"JACUIPE (AL)";"AL";"JACUIPE";13;21;18;52
2018;"JAPARATINGA (AL)";"AL";"JAPARATINGA";20;22;13;55
2018;"JARAMATAIA (AL)";"AL";"JARAMATAIA";29;12;8;49
2018;"JEQUIA DA PRAIA (AL)";"AL";"JEQUIA DA PRAIA";37;7;40;84
2018;"JOAQUIM GOMES (AL)";"AL";"JOAQUIM GOMES";109;26;85;220
2018;"JUNDIA (AL)";"AL";"JUNDIA";17;5;15;37
2018;"JUNQUEIRO (AL)";"AL";"JUNQUEIRO";187;25;115;327
2018;"LAGOA DA CANOA (AL)";"AL";"LAGOA DA CANOA";95;27;43;165
2018;"LIMOEIRO DE ANADIA (AL)";"AL";"LIMOEIRO DE ANADIA";145;23;53;221
2018;"MACEIO (AL)";"AL";"MACEIO";7439;1179;2173;10791
2018;"MAJOR ISIDORO (AL)";"AL";"MAJOR ISIDORO";109;32;29;170
2018;"MAR VERMELHO (AL)";"AL";"MAR VERMELHO";13;1;9;23
2018;"MARAGOGI (AL)";"AL";"MARAGOGI";87;167;50;304
2018;"MARAVILHA (AL)";"AL";"MARAVILHA";63;53;10;126
2018;"MARECHAL DEODORO (AL)";"AL";"MARECHAL DEODORO";298;61;175;534
2018;"MARIBONDO (AL)";"AL";"MARIBONDO";70;15;17;102
2018;"MATA GRANDE (AL)";"AL";"MATA GRANDE";67;41;18;126
2018;"MATRIZ DE CAMARAGIBE (AL)";"AL";"MATRIZ DE CAMARAGIBE";145;30;134;309
2018;"MESSIAS (AL)";"AL";"MESSIAS";66;44;91;201
2018;"MINADOR DO NEGRAO (AL)";"AL";"MINADOR DO NEGRAO";59;15;8;82
2018;"MONTEIROPOLIS (AL)";"AL";"MONTEIROPOLIS";17;12;5;34
2018;"MURICI (AL)";"AL";"MURICI";133;26;97;256
2018;"NOVO LINO (AL)";"AL";"NOVO LINO";76;49;66;191
2018;"OLHO D AGUA DAS FLORES (AL)";"AL";"OLHO D AGUA DAS FLORES";133;96;35;264
2018;"OLHO D AGUA DO CASADO (AL)";"AL";"OLHO D AGUA DO CASADO";38;17;12;67
2018;"OLHO D AGUA GRANDE (AL)";"AL";"OLHO D AGUA GRANDE";15;2;14;31
2018;"OLIVENCA (AL)";"AL";"OLIVENCA";61;29;14;104
2018;"OURO BRANCO (AL)";"AL";"OURO BRANCO";94;62;33;189
2018;"PALESTINA (AL)";"AL";"PALESTINA";10;20;4;34
2018;"PALMEIRA DOS INDIOS (AL)";"AL";"PALMEIRA DOS INDIOS";655;313;82;1050
2018;"PAO DE ACUCAR (AL)";"AL";"PAO DE ACUCAR";70;66;17;153
2018;"PARICONHA (AL)";"AL";"PARICONHA";51;43;13;107
2018;"PARIPUEIRA (AL)";"AL";"PARIPUEIRA";65;6;19;90
2018;"PASSO DE CAMARAGIBE (AL)";"AL";"PASSO DE CAMARAGIBE";42;12;30;84
2018;"PAULO JACINTO (AL)";"AL";"PAULO JACINTO";15;8;8;31
2018;"PENEDO (AL)";"AL";"PENEDO";277;70;282;629
2018;"PIACABUCU (AL)";"AL";"PIACABUCU";32;14;22;68
2018;"PILAR (AL)";"AL";"PILAR";159;60;78;297
2018;"PINDOBA (AL)";"AL";"PINDOBA";8;1;4;13
2018;"PIRANHAS (AL)";"AL";"PIRANHAS";88;94;19;201
2018;"POCO DAS TRINCHEIRAS (AL)";"AL";"POCO DAS TRINCHEIRAS";78;64;25;167
2018;"PORTO CALVO (AL)";"AL";"PORTO CALVO";205;122;73;400
2018;"PORTO DE PEDRAS (AL)";"AL";"PORTO DE PEDRAS";20;9;10;39
2018;"PORTO REAL DO COLEGIO (AL)";"AL";"PORTO REAL DO COLEGIO";39;32;24;95
2018;"QUEBRANGULO (AL)";"AL";"QUEBRANGULO";38;13;14;65
2018;"RIO LARGO (AL)";"AL";"RIO LARGO";456;200;211;867
2018;"ROTEIRO (AL)";"AL";"ROTEIRO";15;24;12;51
2018;"SANTA LUZIA DO NORTE (AL)";"AL";"SANTA LUZIA DO NORTE";21;4;49;74
2018;"SANTANA DO IPANEMA (AL)";"AL";"SANTANA DO IPANEMA";446;250;50;746
2018;"SANTANA DO MUNDAU (AL)";"AL";"SANTANA DO MUNDAU";80;34;11;125
2018;"SAO BRAS (AL)";"AL";"SAO BRAS";8;4;7;19
2018;"SAO JOSE DA LAJE (AL)";"AL";"SAO JOSE DA LAJE";115;75;59;249
2018;"SAO JOSE DA TAPERA (AL)";"AL";"SAO JOSE DA TAPERA";137;92;41;270
2018;"SAO LUIS DO QUITUNDE (AL)";"AL";"SAO LUIS DO QUITUNDE";243;35;219;497
2018;"SAO MIGUEL DOS CAMPOS (AL)";"AL";"SAO MIGUEL DOS CAMPOS";421;160;177;758
2018;"SAO MIGUEL DOS MILAGRES (AL)";"AL";"SAO MIGUEL DOS MILAGRES";28;3;7;38
2018;"SAO SEBASTIAO (AL)";"AL";"SAO SEBASTIAO";170;39;171;380
2018;"SATUBA (AL)";"AL";"SATUBA";73;24;27;124
2018;"SENADOR RUI PALMEIRA (AL)";"AL";"SENADOR RUI PALMEIRA";41;22;16;79
2018;"TANQUE D ARCA (AL)";"AL";"TANQUE D ARCA";17;17;11;45
2018;"TAQUARANA (AL)";"AL";"TAQUARANA";122;71;43;236
2018;"TEOTONIO VILELA (AL)";"AL";"TEOTONIO VILELA";190;75;213;478
2018;"TRAIPU (AL)";"AL";"TRAIPU";106;13;24;143
2018;"UNIAO DOS PALMARES (AL)";"AL";"UNIAO DOS PALMARES";527;295;220;1042
2018;"VICOSA (AL)";"AL";"VICOSA";145;31;48;224
2018;"ALVARAES (AM)";"AM";"ALVARAES";9;0;3;12
2018;"AMATURA (AM)";"AM";"AMATURA";4;0;1;5
2018;"ANAMA (AM)";"AM";"ANAMA";1;0;6;7
2018;"ANORI (AM)";"AM";"ANORI";10;2;4;16
2018;"APUI (AM)";"AM";"APUI";182;4;33;219
2018;"ATALAIA DO NORTE (AM)";"AM";"ATALAIA DO NORTE";2;1;1;4
2018;"AUTAZES (AM)";"AM";"AUTAZES";41;4;25;70
2018;"BARCELOS (AM)";"AM";"BARCELOS";13;1;0;14
2018;"BARREIRINHA (AM)";"AM";"BARREIRINHA";9;0;6;15
2018;"BENJAMIN CONSTANT (AM)";"AM";"BENJAMIN CONSTANT";13;6;4;23
2018;"BERURI (AM)";"AM";"BERURI";10;0;0;10
2018;"BOA VISTA DO RAMOS (AM)";"AM";"BOA VISTA DO RAMOS";3;0;1;4
2018;"BOCA DO ACRE (AM)";"AM";"BOCA DO ACRE";64;4;8;76
2018;"BORBA (AM)";"AM";"BORBA";22;0;6;28
2018;"CAAPIRANGA (AM)";"AM";"CAAPIRANGA";13;2;8;23
2018;"CANUTAMA (AM)";"AM";"CANUTAMA";6;0;1;7
2018;"CARAUARI (AM)";"AM";"CARAUARI";47;1;1;49
2018;"CAREIRO (AM)";"AM";"CAREIRO";83;51;87;221
2018;"CAREIRO DA VARZEA (AM)";"AM";"CAREIRO DA VARZEA";32;25;46;103
2018;"COARI (AM)";"AM";"COARI";139;7;16;162
2018;"CODAJAS (AM)";"AM";"CODAJAS";9;2;4;15
2018;"EIRUNEPE (AM)";"AM";"EIRUNEPE";40;5;7;52
2018;"ENVIRA (AM)";"AM";"ENVIRA";17;0;5;22
2018;"FONTE BOA (AM)";"AM";"FONTE BOA";17;0;0;17
2018;"GUAJARA (AM)";"AM";"GUAJARA";7;0;9;16
2018;"HUMAITA (AM)";"AM";"HUMAITA";281;7;40;328
2018;"IPIXUNA (AM)";"AM";"IPIXUNA";4;0;3;7
2018;"IRANDUBA (AM)";"AM";"IRANDUBA";353;51;141;545
2018;"ITACOATIARA (AM)";"AM";"ITACOATIARA";392;43;173;608
2018;"ITAMARATI (AM)";"AM";"ITAMARATI";12;0;0;12
2018;"ITAPIRANGA (AM)";"AM";"ITAPIRANGA";25;4;7;36
2018;"JAPURA (AM)";"AM";"JAPURA";4;0;4;8
2018;"JURUA (AM)";"AM";"JURUA";10;0;4;14
2018;"JUTAI (AM)";"AM";"JUTAI";4;0;0;4
2018;"LABREA (AM)";"AM";"LABREA";51;4;7;62
2018;"MANACAPURU (AM)";"AM";"MANACAPURU";392;88;116;596
2018;"MANAQUIRI (AM)";"AM";"MANAQUIRI";13;8;9;30
2018;"MANAUS (AM)";"AM";"MANAUS";16421;2998;7831;27250
2018;"MANICORE (AM)";"AM";"MANICORE";54;1;19;74
2018;"MARAA (AM)";"AM";"MARAA";6;1;0;7
2018;"MAUES (AM)";"AM";"MAUES";55;4;24;83
2018;"NHAMUNDA (AM)";"AM";"NHAMUNDA";9;0;8;17
2018;"NOVA OLINDA DO NORTE (AM)";"AM";"NOVA OLINDA DO NORTE";21;6;10;37
2018;"NOVO AIRAO (AM)";"AM";"NOVO AIRAO";31;10;11;52
2018;"NOVO ARIPUANA (AM)";"AM";"NOVO ARIPUANA";29;2;8;39
2018;"PARINTINS (AM)";"AM";"PARINTINS";167;8;29;204
2018;"PAUINI (AM)";"AM";"PAUINI";3;1;1;5
2018;"PRESIDENTE FIGUEIREDO (AM)";"AM";"PRESIDENTE FIGUEIREDO";337;53;87;477
2018;"RIO PRETO DA EVA (AM)";"AM";"RIO PRETO DA EVA";169;22;78;269
2018;"SANTA ISABEL DO RIO NEGRO (AM)";"AM";"SANTA ISABEL DO RIO NEGRO";10;4;3;17
2018;"SANTO ANTONIO DO ICA (AM)";"AM";"SANTO ANTONIO DO ICA";11;0;0;11
2018;"SAO GABRIEL DA CACHOEIRA (AM)";"AM";"SAO GABRIEL DA CACHOEIRA";103;15;37;155
2018;"SAO PAULO DE OLIVENCA (AM)";"AM";"SAO PAULO DE OLIVENCA";9;0;5;14
2018;"SAO SEBASTIAO DO UATUMA (AM)";"AM";"SAO SEBASTIAO DO UATUMA";6;0;1;7
2018;"SILVES (AM)";"AM";"SILVES";12;8;4;24
2018;"TABATINGA (AM)";"AM";"TABATINGA";79;11;7;97
2018;"TAPAUA (AM)";"AM";"TAPAUA";6;0;2;8
2018;"TEFE (AM)";"AM";"TEFE";76;17;21;114
2018;"TONANTINS (AM)";"AM";"TONANTINS";6;0;1;7
2018;"UARINI (AM)";"AM";"UARINI";11;0;4;15
2018;"URUCARA (AM)";"AM";"URUCARA";21;3;2;26
2018;"URUCURITUBA (AM)";"AM";"URUCURITUBA";8;0;2;10
2018;"AMAPA (AP)";"AP";"AMAPA";11;2;2;15
2018;"CALCOENE (AP)";"AP";"CALCOENE";19;2;4;25
2018;"CUTIAS (AP)";"AP";"CUTIAS";4;1;0;5
2018;"FERREIRA GOMES (AP)";"AP";"FERREIRA GOMES";10;4;5;19
2018;"ITAUBAL (AP)";"AP";"ITAUBAL";9;0;5;14
2018;"LARANJAL DO JARI (AP)";"AP";"LARANJAL DO JARI";103;10;23;136
2018;"MACAPA (AP)";"AP";"MACAPA";3041;346;900;4287
2018;"MAZAGAO (AP)";"AP";"MAZAGAO";39;16;21;76
2018;"OIAPOQUE (AP)";"AP";"OIAPOQUE";77;7;21;105
2018;"PEDRA BRANCA DO AMAPARI (AP)";"AP";"PEDRA BRANCA DO AMAPARI";29;7;22;58
2018;"PORTO GRANDE (AP)";"AP";"PORTO GRANDE";68;5;19;92
2018;"PRACUUBA (AP)";"AP";"PRACUUBA";6;1;2;9
2018;"SANTANA (AP)";"AP";"SANTANA";664;47;180;891
2018;"SERRA DO NAVIO (AP)";"AP";"SERRA DO NAVIO";19;4;4;27
2018;"TARTARUGALZINHO (AP)";"AP";"TARTARUGALZINHO";26;5;5;36
2018;"VITORIA DO JARI (AP)";"AP";"VITORIA DO JARI";5;1;4;10
2018;"ABAIRA (BA)";"BA";"ABAIRA";64;28;15;107
2018;"ABARE (BA)";"BA";"ABARE";53;47;23;123
2018;"ACAJUTIBA (BA)";"BA";"ACAJUTIBA";79;15;23;117
2018;"ADUSTINA (BA)";"BA";"ADUSTINA";15;8;12;35
2018;"AGUA FRIA (BA)";"BA";"AGUA FRIA";36;22;50;108
2018;"AIQUARA (BA)";"BA";"AIQUARA";7;7;5;19
2018;"ALAGOINHAS (BA)";"BA";"ALAGOINHAS";1378;383;676;2437
2018;"ALCOBACA (BA)";"BA";"ALCOBACA";58;11;35;104
2018;"ALMADINA (BA)";"BA";"ALMADINA";19;4;6;29
2018;"AMARGOSA (BA)";"BA";"AMARGOSA";355;90;96;541
2018;"AMELIA RODRIGUES (BA)";"BA";"AMELIA RODRIGUES";257;132;41;430
2018;"AMERICA DOURADA (BA)";"BA";"AMERICA DOURADA";46;20;15;81
2018;"ANAGE (BA)";"BA";"ANAGE";133;94;54;281
2018;"ANDARAI (BA)";"BA";"ANDARAI";53;21;25;99
2018;"ANDORINHA (BA)";"BA";"ANDORINHA";91;20;58;169
2018;"ANGICAL (BA)";"BA";"ANGICAL";40;16;27;83
2018;"ANGUERA (BA)";"BA";"ANGUERA";25;9;15;49
2018;"ANTAS (BA)";"BA";"ANTAS";34;10;12;56
2018;"ANTONIO CARDOSO (BA)";"BA";"ANTONIO CARDOSO";12;31;23;66
2018;"ANTONIO GONCALVES (BA)";"BA";"ANTONIO GONCALVES";28;16;13;57
2018;"APORA (BA)";"BA";"APORA";56;38;45;139
2018;"APUAREMA (BA)";"BA";"APUAREMA";32;6;10;48
2018;"ARACAS (BA)";"BA";"ARACAS";94;27;37;158
2018;"ARACATU (BA)";"BA";"ARACATU";141;41;37;219
2018;"ARACI (BA)";"BA";"ARACI";312;29;78;419
2018;"ARAMARI (BA)";"BA";"ARAMARI";44;7;16;67
2018;"ARATACA (BA)";"BA";"ARATACA";34;2;5;41
2018;"ARATUIPE (BA)";"BA";"ARATUIPE";47;13;20;80
2018;"AURELINO LEAL (BA)";"BA";"AURELINO LEAL";58;7;15;80
2018;"BAIANOPOLIS (BA)";"BA";"BAIANOPOLIS";65;7;43;115
2018;"BAIXA GRANDE (BA)";"BA";"BAIXA GRANDE";119;82;59;260
2018;"BANZAE (BA)";"BA";"BANZAE";27;7;28;62
2018;"BARRA (BA)";"BA";"BARRA";106;42;41;189
2018;"BARRA DA ESTIVA (BA)";"BA";"BARRA DA ESTIVA";302;100;78;480
2018;"BARRA DO CHOCA (BA)";"BA";"BARRA DO CHOCA";153;233;38;424
2018;"BARRA DO MENDES (BA)";"BA";"BARRA DO MENDES";81;32;31;144
2018;"BARRA DO ROCHA (BA)";"BA";"BARRA DO ROCHA";15;7;6;28
2018;"BARREIRAS (BA)";"BA";"BARREIRAS";2470;235;480;3185
2018;"BARRO ALTO (BA)";"BA";"BARRO ALTO";61;21;26;108
2018;"BARRO PRETO (BA)";"BA";"BARRO PRETO";18;1;11;30
2018;"BARROCAS (BA)";"BA";"BARROCAS";118;13;34;165
2018;"BELMONTE (BA)";"BA";"BELMONTE";64;10;40;114
2018;"BELO CAMPO (BA)";"BA";"BELO CAMPO";142;30;47;219
2018;"BIRITINGA (BA)";"BA";"BIRITINGA";36;19;40;95
2018;"BOA NOVA (BA)";"BA";"BOA NOVA";46;68;28;142
2018;"BOA VISTA DO TUPIM (BA)";"BA";"BOA VISTA DO TUPIM";76;19;26;121
2018;"BOM JESUS DA LAPA (BA)";"BA";"BOM JESUS DA LAPA";510;89;166;765
2018;"BOM JESUS DA SERRA (BA)";"BA";"BOM JESUS DA SERRA";48;68;26;142
2018;"BONINAL (BA)";"BA";"BONINAL";107;37;41;185
2018;"BONITO (BA)";"BA";"BONITO";124;20;27;171
2018;"BOQUIRA (BA)";"BA";"BOQUIRA";150;17;77;244
2018;"BOTUPORA (BA)";"BA";"BOTUPORA";70;7;53;130
2018;"BREJOES (BA)";"BA";"BREJOES";102;12;43;157
2018;"BREJOLANDIA (BA)";"BA";"BREJOLANDIA";35;8;21;64
2018;"BROTAS DE MACAUBAS (BA)";"BA";"BROTAS DE MACAUBAS";34;67;27;128
2018;"BRUMADO (BA)";"BA";"BRUMADO";1772;289;371;2432
2018;"BUERAREMA (BA)";"BA";"BUERAREMA";153;13;54;220
2018;"BURITIRAMA (BA)";"BA";"BURITIRAMA";52;18;27;97
2018;"CAATIBA (BA)";"BA";"CAATIBA";19;5;3;27
2018;"CABACEIRAS DO PARAGUACU (BA)";"BA";"CABACEIRAS DO PARAGUACU";108;31;73;212
2018;"CACHOEIRA (BA)";"BA";"CACHOEIRA";126;131;91;348
2018;"CACULE (BA)";"BA";"CACULE";423;41;49;513
2018;"CAEM (BA)";"BA";"CAEM";34;28;20;82
2018;"CAETANOS (BA)";"BA";"CAETANOS";106;14;21;141
2018;"CAETITE (BA)";"BA";"CAETITE";622;163;162;947
2018;"CAFARNAUM (BA)";"BA";"CAFARNAUM";93;10;53;156
2018;"CAIRU (BA)";"BA";"CAIRU";20;17;12;49
2018;"CALDEIRAO GRANDE (BA)";"BA";"CALDEIRAO GRANDE";36;13;22;71
2018;"CAMACAN (BA)";"BA";"CAMACAN";195;29;50;274
2018;"CAMACARI (BA)";"BA";"CAMACARI";2465;525;1151;4141
2018;"CAMAMU (BA)";"BA";"CAMAMU";192;54;38;284
2018;"CAMPO ALEGRE DE LOURDES (BA)";"BA";"CAMPO ALEGRE DE LOURDES";63;10;19;92
2018;"CAMPO FORMOSO (BA)";"BA";"CAMPO FORMOSO";338;39;125;502
2018;"CANAPOLIS (BA)";"BA";"CANAPOLIS";23;33;12;68
2018;"CANARANA (BA)";"BA";"CANARANA";204;40;41;285
2018;"CANAVIEIRAS (BA)";"BA";"CANAVIEIRAS";104;15;20;139
2018;"CANDEAL (BA)";"BA";"CANDEAL";31;26;23;80
2018;"CANDEIAS (BA)";"BA";"CANDEIAS";872;392;399;1663
2018;"CANDIBA (BA)";"BA";"CANDIBA";75;2;25;102
2018;"CANDIDO SALES (BA)";"BA";"CANDIDO SALES";329;68;58;455
2018;"CANSANCAO (BA)";"BA";"CANSANCAO";229;71;88;388
2018;"CANUDOS (BA)";"BA";"CANUDOS";68;13;53;134
2018;"CAPELA DO ALTO ALEGRE (BA)";"BA";"CAPELA DO ALTO ALEGRE";90;33;28;151
2018;"CAPIM GROSSO (BA)";"BA";"CAPIM GROSSO";685;99;82;866
2018;"CARAIBAS (BA)";"BA";"CARAIBAS";74;42;26;142
2018;"CARAVELAS (BA)";"BA";"CARAVELAS";49;20;38;107
2018;"CARDEAL DA SILVA (BA)";"BA";"CARDEAL DA SILVA";29;13;26;68
2018;"CARINHANHA (BA)";"BA";"CARINHANHA";125;57;55;237
2018;"CASA NOVA (BA)";"BA";"CASA NOVA";395;238;243;876
2018;"CASTRO ALVES (BA)";"BA";"CASTRO ALVES";177;34;85;296
2018;"CATOLANDIA (BA)";"BA";"CATOLANDIA";11;3;9;23
2018;"CATU (BA)";"BA";"CATU";435;142;143;720
2018;"CATURAMA (BA)";"BA";"CATURAMA";51;11;19;81
2018;"CENTRAL (BA)";"BA";"CENTRAL";103;32;16;151
2018;"CHORROCHO (BA)";"BA";"CHORROCHO";49;5;16;70
2018;"CICERO DANTAS (BA)";"BA";"CICERO DANTAS";147;38;68;253
2018;"CIPO (BA)";"BA";"CIPO";54;16;24;94
2018;"COARACI (BA)";"BA";"COARACI";130;11;36;177
2018;"COCOS (BA)";"BA";"COCOS";110;7;42;159
2018;"CONCEICAO DA FEIRA (BA)";"BA";"CONCEICAO DA FEIRA";261;135;18;414
2018;"CONCEICAO DO ALMEIDA (BA)";"BA";"CONCEICAO DO ALMEIDA";136;49;39;224
2018;"CONCEICAO DO COITE (BA)";"BA";"CONCEICAO DO COITE";640;156;152;948
2018;"CONCEICAO DO JACUIPE (BA)";"BA";"CONCEICAO DO JACUIPE";407;168;37;612
2018;"CONDE (BA)";"BA";"CONDE";63;23;28;114
2018;"CONDEUBA (BA)";"BA";"CONDEUBA";131;59;75;265
2018;"CONTENDAS DO SINCORA (BA)";"BA";"CONTENDAS DO SINCORA";34;10;12;56
2018;"CORACAO DE MARIA (BA)";"BA";"CORACAO DE MARIA";131;55;77;263
2018;"CORDEIROS (BA)";"BA";"CORDEIROS";43;19;20;82
2018;"CORIBE (BA)";"BA";"CORIBE";52;24;30;106
2018;"CORONEL JOAO SA (BA)";"BA";"CORONEL JOAO SA";11;2;24;37
2018;"CORRENTINA (BA)";"BA";"CORRENTINA";155;39;90;284
2018;"COTEGIPE (BA)";"BA";"COTEGIPE";62;24;28;114
2018;"CRAVOLANDIA (BA)";"BA";"CRAVOLANDIA";23;9;8;40
2018;"CRISOPOLIS (BA)";"BA";"CRISOPOLIS";72;37;45;154
2018;"CRISTOPOLIS (BA)";"BA";"CRISTOPOLIS";67;13;38;118
2018;"CRUZ DAS ALMAS (BA)";"BA";"CRUZ DAS ALMAS";1203;391;116;1710
2018;"CURACA (BA)";"BA";"CURACA";109;54;49;212
2018;"DARIO MEIRA (BA)";"BA";"DARIO MEIRA";21;24;5;50
2018;"DIAS D AVILA (BA)";"BA";"DIAS D AVILA";715;176;443;1334
2018;"DOM BASILIO (BA)";"BA";"DOM BASILIO";373;35;42;450
2018;"DOM MACEDO COSTA (BA)";"BA";"DOM MACEDO COSTA";14;28;10;52
2018;"ELISIO MEDRADO (BA)";"BA";"ELISIO MEDRADO";45;30;18;93
2018;"ENCRUZILHADA (BA)";"BA";"ENCRUZILHADA";76;36;20;132
2018;"ENTRE RIOS (BA)";"BA";"ENTRE RIOS";274;108;153;535
2018;"ERICO CARDOSO (BA)";"BA";"ERICO CARDOSO";44;15;28;87
2018;"ESPLANADA (BA)";"BA";"ESPLANADA";150;47;112;309
2018;"EUCLIDES DA CUNHA (BA)";"BA";"EUCLIDES DA CUNHA";329;98;284;711
2018;"EUNAPOLIS (BA)";"BA";"EUNAPOLIS";1468;121;530;2119
2018;"FATIMA (BA)";"BA";"FATIMA";24;11;26;61
2018;"FEIRA DA MATA (BA)";"BA";"FEIRA DA MATA";21;12;13;46
2018;"FEIRA DE SANTANA (BA)";"BA";"FEIRA DE SANTANA";9141;1494;1448;12083
2018;"FILADELFIA (BA)";"BA";"FILADELFIA";151;16;33;200
2018;"FIRMINO ALVES (BA)";"BA";"FIRMINO ALVES";20;2;4;26
2018;"FLORESTA AZUL (BA)";"BA";"FLORESTA AZUL";43;8;3;54
2018;"FORMOSA DO RIO PRETO (BA)";"BA";"FORMOSA DO RIO PRETO";167;9;36;212
2018;"GANDU (BA)";"BA";"GANDU";338;213;34;585
2018;"GAVIAO (BA)";"BA";"GAVIAO";27;17;9;53
2018;"GENTIO DO OURO (BA)";"BA";"GENTIO DO OURO";29;18;9;56
2018;"GLORIA (BA)";"BA";"GLORIA";68;25;50;143
2018;"GONGOGI (BA)";"BA";"GONGOGI";17;7;5;29
2018;"GOVERNADOR MANGABEIRA (BA)";"BA";"GOVERNADOR MANGABEIRA";267;48;49;364
2018;"GUAJERU (BA)";"BA";"GUAJERU";38;37;19;94
2018;"GUANAMBI (BA)";"BA";"GUANAMBI";1379;113;253;1745
2018;"GUARATINGA (BA)";"BA";"GUARATINGA";91;10;42;143
2018;"HELIOPOLIS (BA)";"BA";"HELIOPOLIS";26;9;20;55
2018;"IACU (BA)";"BA";"IACU";176;32;43;251
2018;"IBIASSUCE (BA)";"BA";"IBIASSUCE";99;25;25;149
2018;"IBICARAI (BA)";"BA";"IBICARAI";148;22;36;206
2018;"IBICOARA (BA)";"BA";"IBICOARA";293;114;91;498
2018;"IBICUI (BA)";"BA";"IBICUI";58;24;19;101
2018;"IBIPEBA (BA)";"BA";"IBIPEBA";59;34;20;113
2018;"IBIPITANGA (BA)";"BA";"IBIPITANGA";102;32;46;180
2018;"IBIQUERA (BA)";"BA";"IBIQUERA";10;9;4;23
2018;"IBIRAPITANGA (BA)";"BA";"IBIRAPITANGA";78;56;19;153
2018;"IBIRAPUA (BA)";"BA";"IBIRAPUA";99;7;14;120
2018;"IBIRATAIA (BA)";"BA";"IBIRATAIA";91;55;22;168
2018;"IBITIARA (BA)";"BA";"IBITIARA";121;71;62;254
2018;"IBITITA (BA)";"BA";"IBITITA";60;17;29;106
2018;"IBOTIRAMA (BA)";"BA";"IBOTIRAMA";290;87;42;419
2018;"ICHU (BA)";"BA";"ICHU";42;26;15;83
2018;"IGAPORA (BA)";"BA";"IGAPORA";118;52;48;218
2018;"IGRAPIUNA (BA)";"BA";"IGRAPIUNA";50;33;26;109
2018;"IGUAI (BA)";"BA";"IGUAI";77;54;55;186
2018;"ILHEUS (BA)";"BA";"ILHEUS";866;203;304;1373
2018;"INHAMBUPE (BA)";"BA";"INHAMBUPE";231;110;117;458
2018;"IPECAETA (BA)";"BA";"IPECAETA";34;10;57;101
2018;"IPIAU (BA)";"BA";"IPIAU";428;68;92;588
2018;"IPIRA (BA)";"BA";"IPIRA";495;87;160;742
2018;"IPUPIARA (BA)";"BA";"IPUPIARA";84;31;8;123
2018;"IRAJUBA (BA)";"BA";"IRAJUBA";49;9;22;80
2018;"IRAMAIA (BA)";"BA";"IRAMAIA";48;15;22;85
2018;"IRAQUARA (BA)";"BA";"IRAQUARA";155;42;57;254
2018;"IRARA (BA)";"BA";"IRARA";172;36;88;296
2018;"IRECE (BA)";"BA";"IRECE";1122;152;295;1569
2018;"ITABELA (BA)";"BA";"ITABELA";324;25;125;474
2018;"ITABERABA (BA)";"BA";"ITABERABA";616;118;110;844
2018;"ITABUNA (BA)";"BA";"ITABUNA";2019;104;791;2914
2018;"ITACARE (BA)";"BA";"ITACARE";47;40;12;99
2018;"ITAETE (BA)";"BA";"ITAETE";85;28;29;142
2018;"ITAGI (BA)";"BA";"ITAGI";47;6;9;62
2018;"ITAGIBA (BA)";"BA";"ITAGIBA";40;61;21;122
2018;"ITAGIMIRIM (BA)";"BA";"ITAGIMIRIM";54;6;10;70
2018;"ITAGUACU DA BAHIA (BA)";"BA";"ITAGUACU DA BAHIA";32;14;8;54
2018;"ITAJU DO COLONIA (BA)";"BA";"ITAJU DO COLONIA";28;4;7;39
2018;"ITAJUIPE (BA)";"BA";"ITAJUIPE";90;31;22;143
2018;"ITAMARAJU (BA)";"BA";"ITAMARAJU";513;62;180;755
2018;"ITAMARI (BA)";"BA";"ITAMARI";48;12;2;62
2018;"ITAMBE (BA)";"BA";"ITAMBE";82;75;12;169
2018;"ITANAGRA (BA)";"BA";"ITANAGRA";28;1;13;42
2018;"ITANHEM (BA)";"BA";"ITANHEM";72;11;31;114
2018;"ITAPARICA (BA)";"BA";"ITAPARICA";55;35;41;131
2018;"ITAPE (BA)";"BA";"ITAPE";36;0;5;41
2018;"ITAPEBI (BA)";"BA";"ITAPEBI";61;4;8;73
2018;"ITAPETINGA (BA)";"BA";"ITAPETINGA";521;80;128;729
2018;"ITAPICURU (BA)";"BA";"ITAPICURU";65;17;54;136
2018;"ITAPITANGA (BA)";"BA";"ITAPITANGA";13;5;5;23
2018;"ITAQUARA (BA)";"BA";"ITAQUARA";45;7;16;68
2018;"ITARANTIM (BA)";"BA";"ITARANTIM";116;19;8;143
2018;"ITATIM (BA)";"BA";"ITATIM";249;37;36;322
2018;"ITIRUCU (BA)";"BA";"ITIRUCU";135;18;24;177
2018;"ITIUBA (BA)";"BA";"ITIUBA";149;57;92;298
2018;"ITORORO (BA)";"BA";"ITORORO";109;29;29;167
2018;"ITUACU (BA)";"BA";"ITUACU";193;81;65;339
2018;"ITUBERA (BA)";"BA";"ITUBERA";166;29;46;241
2018;"IUIU (BA)";"BA";"IUIU";52;17;14;83
2018;"JABORANDI (BA)";"BA";"JABORANDI";100;2;36;138
2018;"JACARACI (BA)";"BA";"JACARACI";57;21;39;117
2018;"JACOBINA (BA)";"BA";"JACOBINA";821;160;288;1269
2018;"JAGUAQUARA (BA)";"BA";"JAGUAQUARA";666;53;88;807
2018;"JAGUARARI (BA)";"BA";"JAGUARARI";309;103;97;509
2018;"JAGUARIPE (BA)";"BA";"JAGUARIPE";55;39;38;132
2018;"JANDAIRA (BA)";"BA";"JANDAIRA";26;5;17;48
2018;"JEQUIE (BA)";"BA";"JEQUIE";1939;185;448;2572
2018;"JEREMOABO (BA)";"BA";"JEREMOABO";103;40;63;206
2018;"JIQUIRICA (BA)";"BA";"JIQUIRICA";57;29;26;112
2018;"JITAUNA (BA)";"BA";"JITAUNA";36;15;22;73
2018;"JOAO DOURADO (BA)";"BA";"JOAO DOURADO";175;51;49;275
2018;"JUAZEIRO (BA)";"BA";"JUAZEIRO";2882;1074;1098;5054
2018;"JUCURUCU (BA)";"BA";"JUCURUCU";19;2;6;27
2018;"JUSSARA (BA)";"BA";"JUSSARA";73;25;23;121
2018;"JUSSARI (BA)";"BA";"JUSSARI";18;2;5;25
2018;"JUSSIAPE (BA)";"BA";"JUSSIAPE";69;38;29;136
2018;"LAFAIETE COUTINHO (BA)";"BA";"LAFAIETE COUTINHO";26;4;10;40
2018;"LAGEDO DO TABOCAL (BA)";"BA";"LAGEDO DO TABOCAL";47;9;12;68
2018;"LAGOA REAL (BA)";"BA";"LAGOA REAL";103;30;40;173
2018;"LAJE (BA)";"BA";"LAJE";189;116;54;359
2018;"LAJEDAO (BA)";"BA";"LAJEDAO";9;1;13;23
2018;"LAJEDINHO (BA)";"BA";"LAJEDINHO";13;8;16;37
2018;"LAMARAO (BA)";"BA";"LAMARAO";12;16;9;37
2018;"LAPAO (BA)";"BA";"LAPAO";175;21;55;251
2018;"LAURO DE FREITAS (BA)";"BA";"LAURO DE FREITAS";2496;490;719;3705
2018;"LENCOIS (BA)";"BA";"LENCOIS";42;29;5;76
2018;"LICINIO DE ALMEIDA (BA)";"BA";"LICINIO DE ALMEIDA";134;20;23;177
2018;"LIVRAMENTO DE NOSSA SENHORA (BA)";"BA";"LIVRAMENTO DE NOSSA SENHORA";565;79;158;802
2018;"LUIS EDUARDO MAGALHAES (BA)";"BA";"LUIS EDUARDO MAGALHAES";1856;129;261;2246
2018;"MACAJUBA (BA)";"BA";"MACAJUBA";38;31;41;110
2018;"MACARANI (BA)";"BA";"MACARANI";98;11;22;131
2018;"MACAUBAS (BA)";"BA";"MACAUBAS";281;44;265;590
2018;"MACURURE (BA)";"BA";"MACURURE";29;5;15;49
2018;"MADRE DE DEUS (BA)";"BA";"MADRE DE DEUS";109;53;32;194
2018;"MAETINGA (BA)";"BA";"MAETINGA";50;14;21;85
2018;"MAIQUINIQUE (BA)";"BA";"MAIQUINIQUE";56;10;16;82
2018;"MAIRI (BA)";"BA";"MAIRI";94;33;47;174
2018;"MALHADA (BA)";"BA";"MALHADA";52;29;26;107
2018;"MALHADA DE PEDRAS (BA)";"BA";"MALHADA DE PEDRAS";101;52;42;195
2018;"MANOEL VITORINO (BA)";"BA";"MANOEL VITORINO";72;26;25;123
2018;"MANSIDAO (BA)";"BA";"MANSIDAO";27;0;14;41
2018;"MARACAS (BA)";"BA";"MARACAS";283;42;67;392
2018;"MARAGOGIPE (BA)";"BA";"MARAGOGIPE";169;53;82;304
2018;"MARAU (BA)";"BA";"MARAU";43;5;11;59
2018;"MARCIONILIO SOUZA (BA)";"BA";"MARCIONILIO SOUZA";47;25;18;90
2018;"MASCOTE (BA)";"BA";"MASCOTE";54;8;12;74
2018;"MATA DE SAO JOAO (BA)";"BA";"MATA DE SAO JOAO";305;107;131;543
2018;"MATINA (BA)";"BA";"MATINA";27;17;35;79
2018;"MEDEIROS NETO (BA)";"BA";"MEDEIROS NETO";101;28;50;179
2018;"MIGUEL CALMON (BA)";"BA";"MIGUEL CALMON";98;47;46;191
2018;"MILAGRES (BA)";"BA";"MILAGRES";173;16;20;209
2018;"MIRANGABA (BA)";"BA";"MIRANGABA";75;18;52;145
2018;"MIRANTE (BA)";"BA";"MIRANTE";75;31;20;126
2018;"MONTE SANTO (BA)";"BA";"MONTE SANTO";308;98;202;608
2018;"MORPARA (BA)";"BA";"MORPARA";23;27;10;60
2018;"MORRO DO CHAPEU (BA)";"BA";"MORRO DO CHAPEU";232;75;34;341
2018;"MORTUGABA (BA)";"BA";"MORTUGABA";81;8;22;111
2018;"MUCUGE (BA)";"BA";"MUCUGE";118;29;74;221
2018;"MUCURI (BA)";"BA";"MUCURI";155;44;97;296
2018;"MULUNGU DO MORRO (BA)";"BA";"MULUNGU DO MORRO";102;10;20;132
2018;"MUNDO NOVO (BA)";"BA";"MUNDO NOVO";77;32;32;141
2018;"MUNIZ FERREIRA (BA)";"BA";"MUNIZ FERREIRA";62;44;12;118
2018;"MUQUEM DO SAO FRANCISCO (BA)";"BA";"MUQUEM DO SAO FRANCISCO";48;24;35;107
2018;"MURITIBA (BA)";"BA";"MURITIBA";149;54;43;246
2018;"MUTUIPE (BA)";"BA";"MUTUIPE";165;103;72;340
2018;"NAZARE (BA)";"BA";"NAZARE";276;86;47;409
2018;"NILO PECANHA (BA)";"BA";"NILO PECANHA";52;34;30;116
2018;"NORDESTINA (BA)";"BA";"NORDESTINA";92;18;34;144
2018;"NOVA CANAA (BA)";"BA";"NOVA CANAA";74;27;19;120
2018;"NOVA FATIMA (BA)";"BA";"NOVA FATIMA";88;14;14;116
2018;"NOVA IBIA (BA)";"BA";"NOVA IBIA";25;13;7;45
2018;"NOVA ITARANA (BA)";"BA";"NOVA ITARANA";39;11;8;58
2018;"NOVA REDENCAO (BA)";"BA";"NOVA REDENCAO";22;13;9;44
2018;"NOVA SOURE (BA)";"BA";"NOVA SOURE";87;13;41;141
2018;"NOVA VICOSA (BA)";"BA";"NOVA VICOSA";181;42;71;294
2018;"NOVO HORIZONTE (BA)";"BA";"NOVO HORIZONTE";66;22;20;108
2018;"NOVO TRIUNFO (BA)";"BA";"NOVO TRIUNFO";20;3;4;27
2018;"OLINDINA (BA)";"BA";"OLINDINA";103;53;75;231
2018;"OLIVEIRA DOS BREJINHOS (BA)";"BA";"OLIVEIRA DOS BREJINHOS";152;70;63;285
2018;"OURICANGAS (BA)";"BA";"OURICANGAS";31;10;27;68
2018;"OUROLANDIA (BA)";"BA";"OUROLANDIA";90;29;14;133
2018;"PALMAS DE MONTE ALTO (BA)";"BA";"PALMAS DE MONTE ALTO";81;15;48;144
2018;"PALMEIRAS (BA)";"BA";"PALMEIRAS";53;37;12;102
2018;"PARAMIRIM (BA)";"BA";"PARAMIRIM";228;47;93;368
2018;"PARATINGA (BA)";"BA";"PARATINGA";87;45;55;187
2018;"PARIPIRANGA (BA)";"BA";"PARIPIRANGA";71;10;47;128
2018;"PAU BRASIL (BA)";"BA";"PAU BRASIL";50;17;42;109
2018;"PAULO AFONSO (BA)";"BA";"PAULO AFONSO";859;329;424;1612
2018;"PE DE SERRA (BA)";"BA";"PE DE SERRA";83;23;35;141
2018;"PEDRAO (BA)";"BA";"PEDRAO";10;7;10;27
2018;"PEDRO ALEXANDRE (BA)";"BA";"PEDRO ALEXANDRE";5;6;14;25
2018;"PIATA (BA)";"BA";"PIATA";105;59;40;204
2018;"PILAO ARCADO (BA)";"BA";"PILAO ARCADO";51;41;8;100
2018;"PINDAI (BA)";"BA";"PINDAI";64;31;46;141
2018;"PINDOBACU (BA)";"BA";"PINDOBACU";66;47;34;147
2018;"PINTADAS (BA)";"BA";"PINTADAS";69;26;62;157
2018;"PIRAI DO NORTE (BA)";"BA";"PIRAI DO NORTE";33;8;3;44
2018;"PIRIPA (BA)";"BA";"PIRIPA";97;32;28;157
2018;"PIRITIBA (BA)";"BA";"PIRITIBA";90;31;27;148
2018;"PLANALTINO (BA)";"BA";"PLANALTINO";65;11;33;109
2018;"PLANALTO (BA)";"BA";"PLANALTO";137;68;71;276
2018;"POCOES (BA)";"BA";"POCOES";464;392;101;957
2018;"POJUCA (BA)";"BA";"POJUCA";405;124;87;616
2018;"PONTO NOVO (BA)";"BA";"PONTO NOVO";95;18;41;154
2018;"PORTO SEGURO (BA)";"BA";"PORTO SEGURO";838;385;418;1641
2018;"POTIRAGUA (BA)";"BA";"POTIRAGUA";53;8;7;68
2018;"PRADO (BA)";"BA";"PRADO";112;22;48;182
2018;"PRESIDENTE DUTRA (BA)";"BA";"PRESIDENTE DUTRA";83;10;14;107
2018;"PRESIDENTE JANIO QUADROS (BA)";"BA";"PRESIDENTE JANIO QUADROS";56;39;25;120
2018;"PRESIDENTE TANCREDO NEVES (BA)";"BA";"PRESIDENTE TANCREDO NEVES";346;231;43;620
2018;"QUEIMADAS (BA)";"BA";"QUEIMADAS";141;44;76;261
2018;"QUIJINGUE (BA)";"BA";"QUIJINGUE";71;30;87;188
2018;"QUIXABEIRA (BA)";"BA";"QUIXABEIRA";61;22;16;99
2018;"RAFAEL JAMBEIRO (BA)";"BA";"RAFAEL JAMBEIRO";83;42;83;208
2018;"REMANSO (BA)";"BA";"REMANSO";187;87;29;303
2018;"RETIROLANDIA (BA)";"BA";"RETIROLANDIA";116;19;23;158
2018;"RIACHAO DAS NEVES (BA)";"BA";"RIACHAO DAS NEVES";76;33;35;144
2018;"RIACHAO DO JACUIPE (BA)";"BA";"RIACHAO DO JACUIPE";385;55;44;484
2018;"RIACHO DE SANTANA (BA)";"BA";"RIACHO DE SANTANA";284;33;123;440
2018;"RIBEIRA DO AMPARO (BA)";"BA";"RIBEIRA DO AMPARO";15;23;42;80
2018;"RIBEIRA DO POMBAL (BA)";"BA";"RIBEIRA DO POMBAL";314;111;145;570
2018;"RIBEIRAO DO LARGO (BA)";"BA";"RIBEIRAO DO LARGO";30;25;9;64
2018;"RIO DE CONTAS (BA)";"BA";"RIO DE CONTAS";80;42;26;148
2018;"RIO DO ANTONIO (BA)";"BA";"RIO DO ANTONIO";212;34;27;273
2018;"RIO DO PIRES (BA)";"BA";"RIO DO PIRES";107;16;23;146
2018;"RIO REAL (BA)";"BA";"RIO REAL";232;28;70;330
2018;"RODELAS (BA)";"BA";"RODELAS";41;9;7;57
2018;"RUY BARBOSA (BA)";"BA";"RUY BARBOSA";166;81;40;287
2018;"SALINAS DA MARGARIDA (BA)";"BA";"SALINAS DA MARGARIDA";30;15;13;58
2018;"SALVADOR (BA)";"BA";"SALVADOR";17839;4181;8615;30635
2018;"SANTA BARBARA (BA)";"BA";"SANTA BARBARA";87;23;35;145
2018;"SANTA BRIGIDA (BA)";"BA";"SANTA BRIGIDA";28;37;29;94
2018;"SANTA CRUZ CABRALIA (BA)";"BA";"SANTA CRUZ CABRALIA";113;50;42;205
2018;"SANTA CRUZ DA VITORIA (BA)";"BA";"SANTA CRUZ DA VITORIA";16;7;4;27
2018;"SANTA INES (BA)";"BA";"SANTA INES";44;18;6;68
2018;"SANTA LUZIA (BA)";"BA";"SANTA LUZIA";44;6;6;56
2018;"SANTA MARIA DA VITORIA (BA)";"BA";"SANTA MARIA DA VITORIA";446;64;85;595
2018;"SANTA RITA DE CASSIA (BA)";"BA";"SANTA RITA DE CASSIA";68;13;18;99
2018;"SANTA TERESINHA (BA)";"BA";"SANTA TERESINHA";46;17;40;103
2018;"SANTALUZ (BA)";"BA";"SANTALUZ";369;48;67;484
2018;"SANTANA (BA)";"BA";"SANTANA";179;22;73;274
2018;"SANTANOPOLIS (BA)";"BA";"SANTANOPOLIS";31;11;16;58
2018;"SANTO AMARO (BA)";"BA";"SANTO AMARO";272;154;150;576
2018;"SANTO ANTONIO DE JESUS (BA)";"BA";"SANTO ANTONIO DE JESUS";2470;297;248;3015
2018;"SANTO ESTEVAO (BA)";"BA";"SANTO ESTEVAO";345;115;90;550
2018;"SAO DESIDERIO (BA)";"BA";"SAO DESIDERIO";350;48;136;534
2018;"SAO DOMINGOS (BA)";"BA";"SAO DOMINGOS";51;4;9;64
2018;"SAO FELIPE (BA)";"BA";"SAO FELIPE";319;55;64;438
2018;"SAO FELIX (BA)";"BA";"SAO FELIX";55;24;18;97
2018;"SAO FELIX DO CORIBE (BA)";"BA";"SAO FELIX DO CORIBE";176;24;36;236
2018;"SAO FRANCISCO DO CONDE (BA)";"BA";"SAO FRANCISCO DO CONDE";164;106;85;355
2018;"SAO GABRIEL (BA)";"BA";"SAO GABRIEL";46;13;27;86
2018;"SAO GONCALO DOS CAMPOS (BA)";"BA";"SAO GONCALO DOS CAMPOS";285;260;52;597
2018;"SAO JOSE DA VITORIA (BA)";"BA";"SAO JOSE DA VITORIA";18;0;7;25
2018;"SAO JOSE DO JACUIPE (BA)";"BA";"SAO JOSE DO JACUIPE";96;23;11;130
2018;"SAO MIGUEL DAS MATAS (BA)";"BA";"SAO MIGUEL DAS MATAS";73;10;24;107
2018;"SAO SEBASTIAO DO PASSE (BA)";"BA";"SAO SEBASTIAO DO PASSE";244;248;151;643
2018;"SAPEACU (BA)";"BA";"SAPEACU";114;76;50;240
2018;"SATIRO DIAS (BA)";"BA";"SATIRO DIAS";26;20;21;67
2018;"SAUBARA (BA)";"BA";"SAUBARA";36;40;3;79
2018;"SAUDE (BA)";"BA";"SAUDE";50;33;21;104
2018;"SEABRA (BA)";"BA";"SEABRA";590;163;195;948
2018;"SEBASTIAO LARANJEIRAS (BA)";"BA";"SEBASTIAO LARANJEIRAS";36;6;32;74
2018;"SENHOR DO BONFIM (BA)";"BA";"SENHOR DO BONFIM";699;169;239;1107
2018;"SENTO SE (BA)";"BA";"SENTO SE";54;12;26;92
2018;"SERRA DO RAMALHO (BA)";"BA";"SERRA DO RAMALHO";124;41;63;228
2018;"SERRA DOURADA (BA)";"BA";"SERRA DOURADA";79;18;40;137
2018;"SERRA PRETA (BA)";"BA";"SERRA PRETA";61;23;68;152
2018;"SERRINHA (BA)";"BA";"SERRINHA";813;164;250;1227
2018;"SERROLANDIA (BA)";"BA";"SERROLANDIA";77;57;24;158
2018;"SIMOES FILHO (BA)";"BA";"SIMOES FILHO";2545;572;861;3978
2018;"SITIO DO MATO (BA)";"BA";"SITIO DO MATO";39;13;30;82
2018;"SITIO DO QUINTO (BA)";"BA";"SITIO DO QUINTO";20;5;13;38
2018;"SOBRADINHO (BA)";"BA";"SOBRADINHO";108;38;30;176
2018;"SOUTO SOARES (BA)";"BA";"SOUTO SOARES";134;19;33;186
2018;"TABOCAS DO BREJO VELHO (BA)";"BA";"TABOCAS DO BREJO VELHO";43;6;15;64
2018;"TANHACU (BA)";"BA";"TANHACU";312;82;64;458
2018;"TANQUE NOVO (BA)";"BA";"TANQUE NOVO";283;20;58;361
2018;"TANQUINHO (BA)";"BA";"TANQUINHO";31;26;16;73
2018;"TAPEROA (BA)";"BA";"TAPEROA";168;27;24;219
2018;"TAPIRAMUTA (BA)";"BA";"TAPIRAMUTA";62;15;22;99
2018;"TEIXEIRA DE FREITAS (BA)";"BA";"TEIXEIRA DE FREITAS";1676;138;416;2230
2018;"TEODORO SAMPAIO (BA)";"BA";"TEODORO SAMPAIO";16;17;14;47
2018;"TEOFILANDIA (BA)";"BA";"TEOFILANDIA";137;59;44;240
2018;"TEOLANDIA (BA)";"BA";"TEOLANDIA";185;49;21;255
2018;"TERRA NOVA (BA)";"BA";"TERRA NOVA";29;18;21;68
2018;"TREMEDAL (BA)";"BA";"TREMEDAL";71;32;53;156
2018;"TUCANO (BA)";"BA";"TUCANO";337;61;124;522
2018;"UAUA (BA)";"BA";"UAUA";265;45;42;352
2018;"UBAIRA (BA)";"BA";"UBAIRA";139;47;56;242
2018;"UBAITABA (BA)";"BA";"UBAITABA";213;24;24;261
2018;"UBATA (BA)";"BA";"UBATA";220;26;23;269
2018;"UIBAI (BA)";"BA";"UIBAI";71;13;21;105
2018;"UMBURANAS (BA)";"BA";"UMBURANAS";70;33;25;128
2018;"UNA (BA)";"BA";"UNA";75;15;140;230
2018;"URANDI (BA)";"BA";"URANDI";153;17;38;208
2018;"URUCUCA (BA)";"BA";"URUCUCA";114;12;18;144
2018;"UTINGA (BA)";"BA";"UTINGA";83;15;24;122
2018;"VALENCA (BA)";"BA";"VALENCA";878;311;164;1353
2018;"VALENTE (BA)";"BA";"VALENTE";207;24;41;272
2018;"VARZEA DA ROCA (BA)";"BA";"VARZEA DA ROCA";63;20;25;108
2018;"VARZEA DO POCO (BA)";"BA";"VARZEA DO POCO";98;21;13;132
2018;"VARZEA NOVA (BA)";"BA";"VARZEA NOVA";77;19;20;116
2018;"VARZEDO (BA)";"BA";"VARZEDO";85;17;34;136
2018;"VERA CRUZ (BA)";"BA";"VERA CRUZ";213;198;66;477
2018;"VEREDA (BA)";"BA";"VEREDA";11;7;3;21
2018;"VITORIA DA CONQUISTA (BA)";"BA";"VITORIA DA CONQUISTA";4896;1144;1667;7707
2018;"WAGNER (BA)";"BA";"WAGNER";44;6;17;67
2018;"WANDERLEY (BA)";"BA";"WANDERLEY";86;10;22;118
2018;"WENCESLAU GUIMARAES (BA)";"BA";"WENCESLAU GUIMARAES";138;34;21;193
2018;"XIQUE XIQUE (BA)";"BA";"XIQUE XIQUE";181;48;37;266
2018;"ABAIARA (CE)";"CE";"ABAIARA";47;29;8;84
2018;"ACARAPE (CE)";"CE";"ACARAPE";103;15;114;232
2018;"ACARAU (CE)";"CE";"ACARAU";266;50;78;394
2018;"ACOPIARA (CE)";"CE";"ACOPIARA";421;88;66;575
2018;"AIUABA (CE)";"CE";"AIUABA";39;7;7;53
2018;"ALCANTARAS (CE)";"CE";"ALCANTARAS";62;19;25;106
2018;"ALTANEIRA (CE)";"CE";"ALTANEIRA";48;20;6;74
2018;"ALTO SANTO (CE)";"CE";"ALTO SANTO";159;13;24;196
2018;"AMONTADA (CE)";"CE";"AMONTADA";217;46;48;311
2018;"ANTONINA DO NORTE (CE)";"CE";"ANTONINA DO NORTE";65;1;8;74
2018;"APUIARES (CE)";"CE";"APUIARES";104;10;20;134
2018;"AQUIRAZ (CE)";"CE";"AQUIRAZ";867;137;138;1142
2018;"ARACATI (CE)";"CE";"ARACATI";618;149;166;933
2018;"ARACOIABA (CE)";"CE";"ARACOIABA";143;24;39;206
2018;"ARARENDA (CE)";"CE";"ARARENDA";39;23;21;83
2018;"ARARIPE (CE)";"CE";"ARARIPE";136;92;73;301
2018;"ARATUBA (CE)";"CE";"ARATUBA";94;1;21;116
2018;"ARNEIROZ (CE)";"CE";"ARNEIROZ";47;13;5;65
2018;"ASSARE (CE)";"CE";"ASSARE";131;59;16;206
2018;"AURORA (CE)";"CE";"AURORA";121;32;20;173
2018;"BAIXIO (CE)";"CE";"BAIXIO";26;22;19;67
2018;"BANABUIU (CE)";"CE";"BANABUIU";217;11;30;258
2018;"BARBALHA (CE)";"CE";"BARBALHA";431;125;111;667
2018;"BARREIRA (CE)";"CE";"BARREIRA";170;12;24;206
2018;"BARRO (CE)";"CE";"BARRO";116;38;20;174
2018;"BARROQUINHA (CE)";"CE";"BARROQUINHA";66;49;9;124
2018;"BATURITE (CE)";"CE";"BATURITE";241;26;45;312
2018;"BEBERIBE (CE)";"CE";"BEBERIBE";344;88;105;537
2018;"BELA CRUZ (CE)";"CE";"BELA CRUZ";152;15;50;217
2018;"BOA VIAGEM (CE)";"CE";"BOA VIAGEM";654;39;98;791
2018;"BREJO SANTO (CE)";"CE";"BREJO SANTO";603;106;69;778
2018;"CAMOCIM (CE)";"CE";"CAMOCIM";254;59;42;355
2018;"CAMPOS SALES (CE)";"CE";"CAMPOS SALES";263;108;68;439
2018;"CANINDE (CE)";"CE";"CANINDE";659;87;229;975
2018;"CAPISTRANO (CE)";"CE";"CAPISTRANO";79;11;24;114
2018;"CARIDADE (CE)";"CE";"CARIDADE";91;10;20;121
2018;"CARIRE (CE)";"CE";"CARIRE";92;14;32;138
2018;"CARIRIACU (CE)";"CE";"CARIRIACU";111;47;16;174
2018;"CARIUS (CE)";"CE";"CARIUS";63;28;8;99
2018;"CARNAUBAL (CE)";"CE";"CARNAUBAL";85;34;13;132
2018;"CASCAVEL (CE)";"CE";"CASCAVEL";572;87;185;844
2018;"CATARINA (CE)";"CE";"CATARINA";60;4;2;66
2018;"CATUNDA (CE)";"CE";"CATUNDA";54;14;8;76
2018;"CAUCAIA (CE)";"CE";"CAUCAIA";2186;359;474;3019
2018;"CEDRO (CE)";"CE";"CEDRO";134;50;45;229
2018;"CHAVAL (CE)";"CE";"CHAVAL";41;25;11;77
2018;"CHORO (CE)";"CE";"CHORO";84;12;99;195
2018;"CHOROZINHO (CE)";"CE";"CHOROZINHO";162;25;46;233
2018;"COREAU (CE)";"CE";"COREAU";118;19;44;181
2018;"CRATEUS (CE)";"CE";"CRATEUS";451;122;140;713
2018;"CRATO (CE)";"CE";"CRATO";1199;270;157;1626
2018;"CROATA (CE)";"CE";"CROATA";78;33;17;128
2018;"CRUZ (CE)";"CE";"CRUZ";209;31;126;366
2018;"DEPUTADO IRAPUAN PINHEIRO (CE)";"CE";"DEPUTADO IRAPUAN PINHEIRO";29;9;15;53
2018;"ERERE (CE)";"CE";"ERERE";11;5;6;22
2018;"EUSEBIO (CE)";"CE";"EUSEBIO";1787;71;146;2004
2018;"FARIAS BRITO (CE)";"CE";"FARIAS BRITO";139;38;24;201
2018;"FORQUILHA (CE)";"CE";"FORQUILHA";158;28;55;241
2018;"FORTALEZA (CE)";"CE";"FORTALEZA";22265;3361;6969;32595
2018;"FORTIM (CE)";"CE";"FORTIM";60;25;28;113
2018;"FRECHEIRINHA (CE)";"CE";"FRECHEIRINHA";108;27;35;170
2018;"GENERAL SAMPAIO (CE)";"CE";"GENERAL SAMPAIO";35;5;10;50
2018;"GRACA (CE)";"CE";"GRACA";37;16;14;67
2018;"GRANJA (CE)";"CE";"GRANJA";263;167;49;479
2018;"GRANJEIRO (CE)";"CE";"GRANJEIRO";16;4;2;22
2018;"GROAIRAS (CE)";"CE";"GROAIRAS";82;22;32;136
2018;"GUAIUBA (CE)";"CE";"GUAIUBA";106;30;13;149
2018;"GUARACIABA DO NORTE (CE)";"CE";"GUARACIABA DO NORTE";524;71;39;634
2018;"GUARAMIRANGA (CE)";"CE";"GUARAMIRANGA";39;3;12;54
2018;"HIDROLANDIA (CE)";"CE";"HIDROLANDIA";188;27;23;238
2018;"HORIZONTE (CE)";"CE";"HORIZONTE";564;90;109;763
2018;"IBARETAMA (CE)";"CE";"IBARETAMA";158;7;27;192
2018;"IBIAPINA (CE)";"CE";"IBIAPINA";226;30;32;288
2018;"IBICUITINGA (CE)";"CE";"IBICUITINGA";100;9;25;134
2018;"ICAPUI (CE)";"CE";"ICAPUI";127;27;67;221
2018;"ICO (CE)";"CE";"ICO";407;110;97;614
2018;"IGUATU (CE)";"CE";"IGUATU";1128;81;180;1389
2018;"INDEPENDENCIA (CE)";"CE";"INDEPENDENCIA";268;12;27;307
2018;"IPAPORANGA (CE)";"CE";"IPAPORANGA";43;12;11;66
2018;"IPAUMIRIM (CE)";"CE";"IPAUMIRIM";316;74;40;430
2018;"IPU (CE)";"CE";"IPU";348;33;31;412
2018;"IPUEIRAS (CE)";"CE";"IPUEIRAS";113;52;15;180
2018;"IRACEMA (CE)";"CE";"IRACEMA";71;15;30;116
2018;"IRAUCUBA (CE)";"CE";"IRAUCUBA";124;29;46;199
2018;"ITAICABA (CE)";"CE";"ITAICABA";39;4;16;59
2018;"ITAITINGA (CE)";"CE";"ITAITINGA";488;73;89;650
2018;"ITAPAJE (CE)";"CE";"ITAPAJE";377;49;59;485
2018;"ITAPIPOCA (CE)";"CE";"ITAPIPOCA";1036;105;139;1280
2018;"ITAPIUNA (CE)";"CE";"ITAPIUNA";72;13;33;118
2018;"ITAREMA (CE)";"CE";"ITAREMA";179;21;53;253
2018;"ITATIRA (CE)";"CE";"ITATIRA";233;21;57;311
2018;"JAGUARETAMA (CE)";"CE";"JAGUARETAMA";178;16;27;221
2018;"JAGUARIBARA (CE)";"CE";"JAGUARIBARA";126;17;18;161
2018;"JAGUARIBE (CE)";"CE";"JAGUARIBE";425;66;39;530
2018;"JAGUARUANA (CE)";"CE";"JAGUARUANA";304;35;29;368
2018;"JARDIM (CE)";"CE";"JARDIM";192;90;45;327
2018;"JATI (CE)";"CE";"JATI";63;176;25;264
2018;"JIJOCA DE JERICOACOARA (CE)";"CE";"JIJOCA DE JERICOACOARA";106;22;23;151
2018;"JUAZEIRO DO NORTE (CE)";"CE";"JUAZEIRO DO NORTE";2113;226;315;2654
2018;"JUCAS (CE)";"CE";"JUCAS";141;9;41;191
2018;"LAVRAS DA MANGABEIRA (CE)";"CE";"LAVRAS DA MANGABEIRA";138;30;40;208
2018;"LIMOEIRO DO NORTE (CE)";"CE";"LIMOEIRO DO NORTE";872;48;167;1087
2018;"MADALENA (CE)";"CE";"MADALENA";189;15;37;241
2018;"MARACANAU (CE)";"CE";"MARACANAU";2348;259;459;3066
2018;"MARANGUAPE (CE)";"CE";"MARANGUAPE";746;182;312;1240
2018;"MARCO (CE)";"CE";"MARCO";333;19;30;382
2018;"MARTINOPOLE (CE)";"CE";"MARTINOPOLE";44;24;3;71
2018;"MASSAPE (CE)";"CE";"MASSAPE";125;41;114;280
2018;"MAURITI (CE)";"CE";"MAURITI";192;78;76;346
2018;"MERUOCA (CE)";"CE";"MERUOCA";53;25;30;108
2018;"MILAGRES (CE)";"CE";"MILAGRES";135;81;33;249
2018;"MILHA (CE)";"CE";"MILHA";100;17;34;151
2018;"MIRAIMA (CE)";"CE";"MIRAIMA";35;6;13;54
2018;"MISSAO VELHA (CE)";"CE";"MISSAO VELHA";291;74;37;402
2018;"MOMBACA (CE)";"CE";"MOMBACA";294;51;45;390
2018;"MONSENHOR TABOSA (CE)";"CE";"MONSENHOR TABOSA";104;10;9;123
2018;"MORADA NOVA (CE)";"CE";"MORADA NOVA";621;79;136;836
2018;"MORAUJO (CE)";"CE";"MORAUJO";26;6;10;42
2018;"MORRINHOS (CE)";"CE";"MORRINHOS";123;18;28;169
2018;"MUCAMBO (CE)";"CE";"MUCAMBO";47;20;16;83
2018;"MULUNGU (CE)";"CE";"MULUNGU";74;8;15;97
2018;"NOVA OLINDA (CE)";"CE";"NOVA OLINDA";131;33;16;180
2018;"NOVA RUSSAS (CE)";"CE";"NOVA RUSSAS";229;47;22;298
2018;"NOVO ORIENTE (CE)";"CE";"NOVO ORIENTE";87;39;27;153
2018;"OCARA (CE)";"CE";"OCARA";211;15;60;286
2018;"OROS (CE)";"CE";"OROS";156;33;32;221
2018;"PACAJUS (CE)";"CE";"PACAJUS";759;110;172;1041
2018;"PACATUBA (CE)";"CE";"PACATUBA";305;92;54;451
2018;"PACOTI (CE)";"CE";"PACOTI";112;6;17;135
2018;"PACUJA (CE)";"CE";"PACUJA";25;5;9;39
2018;"PALHANO (CE)";"CE";"PALHANO";95;18;14;127
2018;"PALMACIA (CE)";"CE";"PALMACIA";49;14;24;87
2018;"PARACURU (CE)";"CE";"PARACURU";239;25;46;310
2018;"PARAIPABA (CE)";"CE";"PARAIPABA";321;17;36;374
2018;"PARAMBU (CE)";"CE";"PARAMBU";276;13;25;314
2018;"PARAMOTI (CE)";"CE";"PARAMOTI";68;8;21;97
2018;"PEDRA BRANCA (CE)";"CE";"PEDRA BRANCA";611;43;44;698
2018;"PENAFORTE (CE)";"CE";"PENAFORTE";112;58;28;198
2018;"PENTECOSTE (CE)";"CE";"PENTECOSTE";317;29;36;382
2018;"PEREIRO (CE)";"CE";"PEREIRO";122;14;34;170
2018;"PINDORETAMA (CE)";"CE";"PINDORETAMA";193;18;40;251
2018;"PIQUET CARNEIRO (CE)";"CE";"PIQUET CARNEIRO";65;10;16;91
2018;"PIRES FERREIRA (CE)";"CE";"PIRES FERREIRA";25;13;8;46
2018;"PORANGA (CE)";"CE";"PORANGA";31;12;7;50
2018;"PORTEIRAS (CE)";"CE";"PORTEIRAS";73;489;92;654
2018;"POTENGI (CE)";"CE";"POTENGI";81;8;12;101
2018;"POTIRETAMA (CE)";"CE";"POTIRETAMA";60;6;8;74
2018;"QUITERIANOPOLIS (CE)";"CE";"QUITERIANOPOLIS";93;19;9;121
2018;"QUIXADA (CE)";"CE";"QUIXADA";1077;80;166;1323
2018;"QUIXELO (CE)";"CE";"QUIXELO";76;22;46;144
2018;"QUIXERAMOBIM (CE)";"CE";"QUIXERAMOBIM";671;48;170;889
2018;"QUIXERE (CE)";"CE";"QUIXERE";307;15;48;370
2018;"REDENCAO (CE)";"CE";"REDENCAO";261;52;72;385
2018;"RERIUTABA (CE)";"CE";"RERIUTABA";122;36;29;187
2018;"RUSSAS (CE)";"CE";"RUSSAS";1020;70;193;1283
2018;"SABOEIRO (CE)";"CE";"SABOEIRO";54;9;13;76
2018;"SALITRE (CE)";"CE";"SALITRE";181;18;44;243
2018;"SANTA QUITERIA (CE)";"CE";"SANTA QUITERIA";336;67;45;448
2018;"SANTANA DO ACARAU (CE)";"CE";"SANTANA DO ACARAU";178;72;65;315
2018;"SANTANA DO CARIRI (CE)";"CE";"SANTANA DO CARIRI";97;43;29;169
2018;"SAO BENEDITO (CE)";"CE";"SAO BENEDITO";533;131;101;765
2018;"SAO GONCALO DO AMARANTE (CE)";"CE";"SAO GONCALO DO AMARANTE";466;103;160;729
2018;"SAO JOAO DO JAGUARIBE (CE)";"CE";"SAO JOAO DO JAGUARIBE";47;3;11;61
2018;"SAO LUIS DO CURU (CE)";"CE";"SAO LUIS DO CURU";74;4;13;91
2018;"SENADOR POMPEU (CE)";"CE";"SENADOR POMPEU";209;31;72;312
2018;"SENADOR SA (CE)";"CE";"SENADOR SA";32;8;18;58
2018;"SOBRAL (CE)";"CE";"SOBRAL";1804;263;483;2550
2018;"SOLONOPOLE (CE)";"CE";"SOLONOPOLE";106;18;26;150
2018;"TABULEIRO DO NORTE (CE)";"CE";"TABULEIRO DO NORTE";408;41;56;505
2018;"TAMBORIL (CE)";"CE";"TAMBORIL";150;30;30;210
2018;"TARRAFAS (CE)";"CE";"TARRAFAS";29;10;8;47
2018;"TAUA (CE)";"CE";"TAUA";584;139;60;783
2018;"TEJUCUOCA (CE)";"CE";"TEJUCUOCA";121;14;29;164
2018;"TIANGUA (CE)";"CE";"TIANGUA";1534;178;255;1967
2018;"TRAIRI (CE)";"CE";"TRAIRI";283;32;89;404
2018;"TURURU (CE)";"CE";"TURURU";75;13;14;102
2018;"UBAJARA (CE)";"CE";"UBAJARA";308;26;87;421
2018;"UMARI (CE)";"CE";"UMARI";15;6;8;29
2018;"UMIRIM (CE)";"CE";"UMIRIM";61;39;46;146
2018;"URUBURETAMA (CE)";"CE";"URUBURETAMA";106;14;34;154
2018;"URUOCA (CE)";"CE";"URUOCA";101;21;19;141
2018;"VARJOTA (CE)";"CE";"VARJOTA";169;48;15;232
2018;"VARZEA ALEGRE (CE)";"CE";"VARZEA ALEGRE";299;58;62;419
2018;"VICOSA DO CEARA (CE)";"CE";"VICOSA DO CEARA";462;59;97;618
2018;"BRASILIA (DF)";"DF";"BRASILIA";23986;5896;12738;42620
2018;"AFONSO CLAUDIO (ES)";"ES";"AFONSO CLAUDIO";786;116;107;1009
2018;"AGUA DOCE DO NORTE (ES)";"ES";"AGUA DOCE DO NORTE";146;36;42;224
2018;"AGUIA BRANCA (ES)";"ES";"AGUIA BRANCA";200;17;62;279
2018;"ALEGRE (ES)";"ES";"ALEGRE";302;83;45;430
2018;"ALFREDO CHAVES (ES)";"ES";"ALFREDO CHAVES";556;49;48;653
2018;"ALTO RIO NOVO (ES)";"ES";"ALTO RIO NOVO";129;23;23;175
2018;"ANCHIETA (ES)";"ES";"ANCHIETA";397;97;69;563
2018;"APIACA (ES)";"ES";"APIACA";207;34;8;249
2018;"ARACRUZ (ES)";"ES";"ARACRUZ";1538;242;539;2319
2018;"ATILIO VIVACQUA (ES)";"ES";"ATILIO VIVACQUA";223;20;30;273
2018;"BAIXO GUANDU (ES)";"ES";"BAIXO GUANDU";584;51;100;735
2018;"BARRA DE SAO FRANCISCO (ES)";"ES";"BARRA DE SAO FRANCISCO";648;60;148;856
2018;"BOA ESPERANCA (ES)";"ES";"BOA ESPERANCA";272;23;55;350
2018;"BOM JESUS DO NORTE (ES)";"ES";"BOM JESUS DO NORTE";378;55;38;471
2018;"BREJETUBA (ES)";"ES";"BREJETUBA";343;47;66;456
2018;"CACHOEIRO DE ITAPEMIRIM (ES)";"ES";"CACHOEIRO DE ITAPEMIRIM";5320;281;1727;7328
2018;"CARIACICA (ES)";"ES";"CARIACICA";6106;776;1549;8431
2018;"CASTELO (ES)";"ES";"CASTELO";1231;110;107;1448
2018;"COLATINA (ES)";"ES";"COLATINA";2642;211;633;3486
2018;"CONCEICAO DA BARRA (ES)";"ES";"CONCEICAO DA BARRA";286;22;145;453
2018;"CONCEICAO DO CASTELO (ES)";"ES";"CONCEICAO DO CASTELO";325;62;69;456
2018;"DIVINO DE SAO LOURENCO (ES)";"ES";"DIVINO DE SAO LOURENCO";77;11;13;101
2018;"DOMINGOS MARTINS (ES)";"ES";"DOMINGOS MARTINS";1441;141;90;1672
2018;"DORES DO RIO PRETO (ES)";"ES";"DORES DO RIO PRETO";168;26;19;213
2018;"ECOPORANGA (ES)";"ES";"ECOPORANGA";213;57;111;381
2018;"FUNDAO (ES)";"ES";"FUNDAO";368;67;47;482
2018;"GOVERNADOR LINDENBERG (ES)";"ES";"GOVERNADOR LINDENBERG";324;9;4;337
2018;"GUACUI (ES)";"ES";"GUACUI";814;76;74;964
2018;"GUARAPARI (ES)";"ES";"GUARAPARI";1429;335;297;2061
2018;"IBATIBA (ES)";"ES";"IBATIBA";671;107;96;874
2018;"IBIRACU (ES)";"ES";"IBIRACU";392;31;45;468
2018;"IBITIRAMA (ES)";"ES";"IBITIRAMA";175;40;30;245
2018;"ICONHA (ES)";"ES";"ICONHA";586;32;74;692
2018;"IRUPI (ES)";"ES";"IRUPI";276;55;37;368
2018;"ITAGUACU (ES)";"ES";"ITAGUACU";331;21;74;426
2018;"ITAPEMIRIM (ES)";"ES";"ITAPEMIRIM";656;57;85;798
2018;"ITARANA (ES)";"ES";"ITARANA";471;41;45;557
2018;"IUNA (ES)";"ES";"IUNA";581;113;78;772
2018;"JAGUARE (ES)";"ES";"JAGUARE";523;29;88;640
2018;"JERONIMO MONTEIRO (ES)";"ES";"JERONIMO MONTEIRO";122;27;20;169
2018;"JOAO NEIVA (ES)";"ES";"JOAO NEIVA";340;31;37;408
2018;"LARANJA DA TERRA (ES)";"ES";"LARANJA DA TERRA";365;27;33;425
2018;"LINHARES (ES)";"ES";"LINHARES";3057;220;621;3898
2018;"MANTENOPOLIS (ES)";"ES";"MANTENOPOLIS";220;32;35;287
2018;"MARATAIZES (ES)";"ES";"MARATAIZES";1218;65;110;1393
2018;"MARECHAL FLORIANO (ES)";"ES";"MARECHAL FLORIANO";877;56;53;986
2018;"MARILANDIA (ES)";"ES";"MARILANDIA";441;25;28;494
2018;"MIMOSO DO SUL (ES)";"ES";"MIMOSO DO SUL";388;80;97;565
2018;"MONTANHA (ES)";"ES";"MONTANHA";287;24;117;428
2018;"MUCURICI (ES)";"ES";"MUCURICI";99;12;25;136
2018;"MUNIZ FREIRE (ES)";"ES";"MUNIZ FREIRE";302;59;52;413
2018;"MUQUI (ES)";"ES";"MUQUI";224;31;41;296
2018;"NOVA VENECIA (ES)";"ES";"NOVA VENECIA";1055;58;186;1299
2018;"PANCAS (ES)";"ES";"PANCAS";336;39;24;399
2018;"PEDRO CANARIO (ES)";"ES";"PEDRO CANARIO";799;67;356;1222
2018;"PINHEIROS (ES)";"ES";"PINHEIROS";329;22;160;511
2018;"PIUMA (ES)";"ES";"PIUMA";318;43;17;378
2018;"PONTO BELO (ES)";"ES";"PONTO BELO";67;14;21;102
2018;"PRESIDENTE KENNEDY (ES)";"ES";"PRESIDENTE KENNEDY";408;27;22;457
2018;"RIO BANANAL (ES)";"ES";"RIO BANANAL";734;19;49;802
2018;"RIO NOVO DO SUL (ES)";"ES";"RIO NOVO DO SUL";371;26;31;428
2018;"SANTA LEOPOLDINA (ES)";"ES";"SANTA LEOPOLDINA";514;54;37;605
2018;"SANTA MARIA DE JETIBA (ES)";"ES";"SANTA MARIA DE JETIBA";2916;98;104;3118
2018;"SANTA TERESA (ES)";"ES";"SANTA TERESA";835;64;134;1033
2018;"SAO DOMINGOS DO NORTE (ES)";"ES";"SAO DOMINGOS DO NORTE";278;18;49;345
2018;"SAO GABRIEL DA PALHA (ES)";"ES";"SAO GABRIEL DA PALHA";801;48;179;1028
2018;"SAO JOSE DO CALCADO (ES)";"ES";"SAO JOSE DO CALCADO";112;34;24;170
2018;"SAO MATEUS (ES)";"ES";"SAO MATEUS";1364;131;426;1921
2018;"SAO ROQUE DO CANAA (ES)";"ES";"SAO ROQUE DO CANAA";372;26;37;435
2018;"SERRA (ES)";"ES";"SERRA";9091;838;2190;12119
2018;"SOORETAMA (ES)";"ES";"SOORETAMA";370;20;68;458
2018;"VARGEM ALTA (ES)";"ES";"VARGEM ALTA";605;47;68;720
2018;"VENDA NOVA DO IMIGRANTE (ES)";"ES";"VENDA NOVA DO IMIGRANTE";919;29;133;1081
2018;"VIANA (ES)";"ES";"VIANA";1389;127;382;1898
2018;"VILA PAVAO (ES)";"ES";"VILA PAVAO";183;9;33;225
2018;"VILA VALERIO (ES)";"ES";"VILA VALERIO";415;31;103;549
2018;"VILA VELHA (ES)";"ES";"VILA VELHA";4469;988;895;6352
2018;"VITORIA (ES)";"ES";"VITORIA";4362;1019;945;6326
2018;"ABADIA DE GOIAS (GO)";"GO";"ABADIA DE GOIAS";157;9;13;179
2018;"ABADIANIA (GO)";"GO";"ABADIANIA";312;43;36;391
2018;"ACREUNA (GO)";"GO";"ACREUNA";456;19;125;600
2018;"ADELANDIA (GO)";"GO";"ADELANDIA";42;2;6;50
2018;"AGUA FRIA DE GOIAS (GO)";"GO";"AGUA FRIA DE GOIAS";61;9;24;94
2018;"AGUA LIMPA (GO)";"GO";"AGUA LIMPA";24;7;2;33
2018;"AGUAS LINDAS DE GOIAS (GO)";"GO";"AGUAS LINDAS DE GOIAS";1388;226;751;2365
2018;"ALEXANIA (GO)";"GO";"ALEXANIA";545;54;54;653
2018;"ALOANDIA (GO)";"GO";"ALOANDIA";30;2;5;37
2018;"ALTO HORIZONTE (GO)";"GO";"ALTO HORIZONTE";74;4;17;95
2018;"ALTO PARAISO DE GOIAS (GO)";"GO";"ALTO PARAISO DE GOIAS";82;11;16;109
2018;"ALVORADA DO NORTE (GO)";"GO";"ALVORADA DO NORTE";171;13;17;201
2018;"AMARALINA (GO)";"GO";"AMARALINA";13;4;14;31
2018;"AMERICANO DO BRASIL (GO)";"GO";"AMERICANO DO BRASIL";78;9;26;113
2018;"AMORINOPOLIS (GO)";"GO";"AMORINOPOLIS";41;7;12;60
2018;"ANAPOLIS (GO)";"GO";"ANAPOLIS";9933;357;1774;12064
2018;"ANHANGUERA (GO)";"GO";"ANHANGUERA";9;0;2;11
2018;"ANICUNS (GO)";"GO";"ANICUNS";407;32;102;541
2018;"APARECIDA DE GOIANIA (GO)";"GO";"APARECIDA DE GOIANIA";7616;498;709;8823
2018;"APARECIDA DO RIO DOCE (GO)";"GO";"APARECIDA DO RIO DOCE";73;15;11;99
2018;"APORE (GO)";"GO";"APORE";113;15;32;160
2018;"ARACU (GO)";"GO";"ARACU";37;10;14;61
2018;"ARAGARCAS (GO)";"GO";"ARAGARCAS";539;17;33;589
2018;"ARAGOIANIA (GO)";"GO";"ARAGOIANIA";111;5;10;126
2018;"ARAGUAPAZ (GO)";"GO";"ARAGUAPAZ";114;14;19;147
2018;"ARENOPOLIS (GO)";"GO";"ARENOPOLIS";27;16;9;52
2018;"ARUANA (GO)";"GO";"ARUANA";79;4;24;107
2018;"AURILANDIA (GO)";"GO";"AURILANDIA";35;5;3;43
2018;"AVELINOPOLIS (GO)";"GO";"AVELINOPOLIS";57;3;3;63
2018;"BALIZA (GO)";"GO";"BALIZA";12;2;8;22
2018;"BARRO ALTO (GO)";"GO";"BARRO ALTO";182;31;89;302
2018;"BELA VISTA DE GOIAS (GO)";"GO";"BELA VISTA DE GOIAS";537;55;57;649
2018;"BOM JARDIM DE GOIAS (GO)";"GO";"BOM JARDIM DE GOIAS";166;8;38;212
2018;"BOM JESUS (GO)";"GO";"BOM JESUS";489;70;136;695
2018;"BONFINOPOLIS (GO)";"GO";"BONFINOPOLIS";77;9;12;98
2018;"BONOPOLIS (GO)";"GO";"BONOPOLIS";23;3;13;39
2018;"BRAZABRANTES (GO)";"GO";"BRAZABRANTES";75;3;10;88
2018;"BRITANIA (GO)";"GO";"BRITANIA";107;10;14;131
2018;"BURITI ALEGRE (GO)";"GO";"BURITI ALEGRE";250;36;21;307
2018;"BURITI DE GOIAS (GO)";"GO";"BURITI DE GOIAS";26;9;2;37
2018;"BURITINOPOLIS (GO)";"GO";"BURITINOPOLIS";27;2;8;37
2018;"CABECEIRAS (GO)";"GO";"CABECEIRAS";163;10;32;205
2018;"CACHOEIRA ALTA (GO)";"GO";"CACHOEIRA ALTA";173;22;74;269
2018;"CACHOEIRA DE GOIAS (GO)";"GO";"CACHOEIRA DE GOIAS";11;1;2;14
2018;"CACHOEIRA DOURADA (GO)";"GO";"CACHOEIRA DOURADA";126;15;47;188
2018;"CACU (GO)";"GO";"CACU";323;32;42;397
2018;"CAIAPONIA (GO)";"GO";"CAIAPONIA";273;12;15;300
2018;"CALDAS NOVAS (GO)";"GO";"CALDAS NOVAS";880;130;129;1139
2018;"CALDAZINHA (GO)";"GO";"CALDAZINHA";37;6;3;46
2018;"CAMPESTRE DE GOIAS (GO)";"GO";"CAMPESTRE DE GOIAS";49;2;7;58
2018;"CAMPINACU (GO)";"GO";"CAMPINACU";48;2;6;56
2018;"CAMPINORTE (GO)";"GO";"CAMPINORTE";209;19;26;254
2018;"CAMPO ALEGRE DE GOIAS (GO)";"GO";"CAMPO ALEGRE DE GOIAS";179;26;29;234
2018;"CAMPO LIMPO DE GOIAS (GO)";"GO";"CAMPO LIMPO DE GOIAS";195;4;7;206
2018;"CAMPOS BELOS (GO)";"GO";"CAMPOS BELOS";315;17;64;396
2018;"CAMPOS VERDES (GO)";"GO";"CAMPOS VERDES";47;9;3;59
2018;"CARMO DO RIO VERDE (GO)";"GO";"CARMO DO RIO VERDE";128;19;57;204
2018;"CASTELANDIA (GO)";"GO";"CASTELANDIA";70;7;12;89
2018;"CATALAO (GO)";"GO";"CATALAO";2142;225;412;2779
2018;"CATURAI (GO)";"GO";"CATURAI";51;3;9;63
2018;"CAVALCANTE (GO)";"GO";"CAVALCANTE";57;3;6;66
2018;"CERES (GO)";"GO";"CERES";520;26;59;605
2018;"CEZARINA (GO)";"GO";"CEZARINA";157;12;26;195
2018;"CHAPADAO DO CEU (GO)";"GO";"CHAPADAO DO CEU";371;17;32;420
2018;"CIDADE OCIDENTAL (GO)";"GO";"CIDADE OCIDENTAL";235;81;116;432
2018;"COCALZINHO DE GOIAS (GO)";"GO";"COCALZINHO DE GOIAS";244;34;37;315
2018;"COLINAS DO SUL (GO)";"GO";"COLINAS DO SUL";27;4;1;32
2018;"CORREGO DO OURO (GO)";"GO";"CORREGO DO OURO";23;4;2;29
2018;"CORUMBA DE GOIAS (GO)";"GO";"CORUMBA DE GOIAS";119;19;36;174
2018;"CORUMBAIBA (GO)";"GO";"CORUMBAIBA";176;27;9;212
2018;"CRISTALINA (GO)";"GO";"CRISTALINA";1913;108;534;2555
2018;"CRISTIANOPOLIS (GO)";"GO";"CRISTIANOPOLIS";69;8;4;81
2018;"CRIXAS (GO)";"GO";"CRIXAS";194;21;23;238
2018;"CROMINIA (GO)";"GO";"CROMINIA";62;10;4;76
2018;"CUMARI (GO)";"GO";"CUMARI";31;9;4;44
2018;"DAMIANOPOLIS (GO)";"GO";"DAMIANOPOLIS";34;4;17;55
2018;"DAMOLANDIA (GO)";"GO";"DAMOLANDIA";58;6;9;73
2018;"DAVINOPOLIS (GO)";"GO";"DAVINOPOLIS";35;6;4;45
2018;"DIORAMA (GO)";"GO";"DIORAMA";18;5;7;30
2018;"DIVINOPOLIS DE GOIAS (GO)";"GO";"DIVINOPOLIS DE GOIAS";42;5;10;57
2018;"DOVERLANDIA (GO)";"GO";"DOVERLANDIA";157;18;41;216
2018;"EDEALINA (GO)";"GO";"EDEALINA";87;16;13;116
2018;"EDEIA (GO)";"GO";"EDEIA";297;18;27;342
2018;"ESTRELA DO NORTE (GO)";"GO";"ESTRELA DO NORTE";44;2;3;49
2018;"FAINA (GO)";"GO";"FAINA";76;17;11;104
2018;"FAZENDA NOVA (GO)";"GO";"FAZENDA NOVA";57;11;11;79
2018;"FIRMINOPOLIS (GO)";"GO";"FIRMINOPOLIS";128;5;7;140
2018;"FLORES DE GOIAS (GO)";"GO";"FLORES DE GOIAS";57;7;14;78
2018;"FORMOSA (GO)";"GO";"FORMOSA";3467;198;741;4406
2018;"FORMOSO (GO)";"GO";"FORMOSO";61;7;9;77
2018;"GAMELEIRA DE GOIAS (GO)";"GO";"GAMELEIRA DE GOIAS";41;5;19;65
2018;"GOIANAPOLIS (GO)";"GO";"GOIANAPOLIS";252;27;33;312
2018;"GOIANDIRA (GO)";"GO";"GOIANDIRA";60;13;6;79
2018;"GOIANESIA (GO)";"GO";"GOIANESIA";1183;116;314;1613
2018;"GOIANIA (GO)";"GO";"GOIANIA";24956;2100;6767;33823
2018;"GOIANIRA (GO)";"GO";"GOIANIRA";456;39;109;604
2018;"GOIAS (GO)";"GO";"GOIAS";273;19;61;353
2018;"GOIATUBA (GO)";"GO";"GOIATUBA";858;59;150;1067
2018;"GOUVELANDIA (GO)";"GO";"GOUVELANDIA";71;9;12;92
2018;"GUAPO (GO)";"GO";"GUAPO";297;26;59;382
2018;"GUARAITA (GO)";"GO";"GUARAITA";26;2;3;31
2018;"GUARANI DE GOIAS (GO)";"GO";"GUARANI DE GOIAS";17;6;10;33
2018;"GUARINOS (GO)";"GO";"GUARINOS";11;8;3;22
2018;"HEITORAI (GO)";"GO";"HEITORAI";45;3;5;53
2018;"HIDROLANDIA (GO)";"GO";"HIDROLANDIA";680;30;50;760
2018;"HIDROLINA (GO)";"GO";"HIDROLINA";33;2;4;39
2018;"IACIARA (GO)";"GO";"IACIARA";156;20;26;202
2018;"INACIOLANDIA (GO)";"GO";"INACIOLANDIA";74;8;17;99
2018;"INDIARA (GO)";"GO";"INDIARA";267;20;42;329
2018;"INHUMAS (GO)";"GO";"INHUMAS";1216;90;201;1507
2018;"IPAMERI (GO)";"GO";"IPAMERI";523;89;93;705
2018;"IPIRANGA DE GOIAS (GO)";"GO";"IPIRANGA DE GOIAS";34;6;7;47
2018;"IPORA (GO)";"GO";"IPORA";597;45;59;701
2018;"ISRAELANDIA (GO)";"GO";"ISRAELANDIA";44;6;8;58
2018;"ITABERAI (GO)";"GO";"ITABERAI";969;58;117;1144
2018;"ITAGUARI (GO)";"GO";"ITAGUARI";64;12;14;90
2018;"ITAGUARU (GO)";"GO";"ITAGUARU";111;12;12;135
2018;"ITAJA (GO)";"GO";"ITAJA";120;11;22;153
2018;"ITAPACI (GO)";"GO";"ITAPACI";255;28;105;388
2018;"ITAPIRAPUA (GO)";"GO";"ITAPIRAPUA";84;13;12;109
2018;"ITAPURANGA (GO)";"GO";"ITAPURANGA";437;37;72;546
2018;"ITARUMA (GO)";"GO";"ITARUMA";99;23;20;142
2018;"ITAUCU (GO)";"GO";"ITAUCU";131;10;13;154
2018;"ITUMBIARA (GO)";"GO";"ITUMBIARA";2076;254;453;2783
2018;"IVOLANDIA (GO)";"GO";"IVOLANDIA";13;4;1;18
2018;"JANDAIA (GO)";"GO";"JANDAIA";126;8;19;153
2018;"JARAGUA (GO)";"GO";"JARAGUA";495;40;52;587
2018;"JATAI (GO)";"GO";"JATAI";2473;176;295;2944
2018;"JAUPACI (GO)";"GO";"JAUPACI";29;6;8;43
2018;"JESUPOLIS (GO)";"GO";"JESUPOLIS";24;4;7;35
2018;"JOVIANIA (GO)";"GO";"JOVIANIA";161;17;27;205
2018;"JUSSARA (GO)";"GO";"JUSSARA";494;24;27;545
2018;"LAGOA SANTA (GO)";"GO";"LAGOA SANTA";22;6;8;36
2018;"LEOPOLDO DE BULHOES (GO)";"GO";"LEOPOLDO DE BULHOES";254;21;15;290
2018;"LUZIANIA (GO)";"GO";"LUZIANIA";2517;299;585;3401
2018;"MAIRIPOTABA (GO)";"GO";"MAIRIPOTABA";37;9;4;50
2018;"MAMBAI (GO)";"GO";"MAMBAI";98;6;32;136
2018;"MARA ROSA (GO)";"GO";"MARA ROSA";164;13;17;194
2018;"MARZAGAO (GO)";"GO";"MARZAGAO";32;3;5;40
2018;"MATRINCHA (GO)";"GO";"MATRINCHA";55;9;12;76
2018;"MAURILANDIA (GO)";"GO";"MAURILANDIA";396;17;124;537
2018;"MIMOSO DE GOIAS (GO)";"GO";"MIMOSO DE GOIAS";9;6;6;21
2018;"MINACU (GO)";"GO";"MINACU";517;51;49;617
2018;"MINEIROS (GO)";"GO";"MINEIROS";1464;97;189;1750
2018;"MOIPORA (GO)";"GO";"MOIPORA";9;0;1;10
2018;"MONTE ALEGRE DE GOIAS (GO)";"GO";"MONTE ALEGRE DE GOIAS";30;6;9;45
2018;"MONTES CLAROS DE GOIAS (GO)";"GO";"MONTES CLAROS DE GOIAS";118;20;35;173
2018;"MONTIVIDIU (GO)";"GO";"MONTIVIDIU";387;46;78;511
2018;"MONTIVIDIU DO NORTE (GO)";"GO";"MONTIVIDIU DO NORTE";27;4;18;49
2018;"MORRINHOS (GO)";"GO";"MORRINHOS";933;75;157;1165
2018;"MORRO AGUDO DE GOIAS (GO)";"GO";"MORRO AGUDO DE GOIAS";53;5;6;64
2018;"MOSSAMEDES (GO)";"GO";"MOSSAMEDES";49;11;7;67
2018;"MOZARLANDIA (GO)";"GO";"MOZARLANDIA";159;24;51;234
2018;"MUNDO NOVO (GO)";"GO";"MUNDO NOVO";59;7;24;90
2018;"MUTUNOPOLIS (GO)";"GO";"MUTUNOPOLIS";42;6;18;66
2018;"NAZARIO (GO)";"GO";"NAZARIO";115;11;18;144
2018;"NEROPOLIS (GO)";"GO";"NEROPOLIS";603;29;48;680
2018;"NIQUELANDIA (GO)";"GO";"NIQUELANDIA";719;92;170;981
2018;"NOVA AMERICA (GO)";"GO";"NOVA AMERICA";37;2;3;42
2018;"NOVA AURORA (GO)";"GO";"NOVA AURORA";43;7;5;55
2018;"NOVA CRIXAS (GO)";"GO";"NOVA CRIXAS";151;12;43;206
2018;"NOVA GLORIA (GO)";"GO";"NOVA GLORIA";130;10;27;167
2018;"NOVA IGUACU DE GOIAS (GO)";"GO";"NOVA IGUACU DE GOIAS";32;8;6;46
2018;"NOVA ROMA (GO)";"GO";"NOVA ROMA";9;4;6;19
2018;"NOVA VENEZA (GO)";"GO";"NOVA VENEZA";182;17;26;225
2018;"NOVO BRASIL (GO)";"GO";"NOVO BRASIL";32;7;5;44
2018;"NOVO GAMA (GO)";"GO";"NOVO GAMA";468;121;191;780
2018;"NOVO PLANALTO (GO)";"GO";"NOVO PLANALTO";52;13;5;70
2018;"ORIZONA (GO)";"GO";"ORIZONA";265;75;51;391
2018;"OURO VERDE DE GOIAS (GO)";"GO";"OURO VERDE DE GOIAS";127;2;16;145
2018;"OUVIDOR (GO)";"GO";"OUVIDOR";76;6;17;99
2018;"PADRE BERNARDO (GO)";"GO";"PADRE BERNARDO";467;37;97;601
2018;"PALESTINA DE GOIAS (GO)";"GO";"PALESTINA DE GOIAS";24;17;12;53
2018;"PALMEIRAS DE GOIAS (GO)";"GO";"PALMEIRAS DE GOIAS";440;27;139;606
2018;"PALMELO (GO)";"GO";"PALMELO";35;4;7;46
2018;"PALMINOPOLIS (GO)";"GO";"PALMINOPOLIS";70;3;6;79
2018;"PANAMA (GO)";"GO";"PANAMA";66;14;10;90
2018;"PARANAIGUARA (GO)";"GO";"PARANAIGUARA";127;20;16;163
2018;"PARAUNA (GO)";"GO";"PARAUNA";218;33;49;300
2018;"PEROLANDIA (GO)";"GO";"PEROLANDIA";58;8;11;77
2018;"PETROLINA DE GOIAS (GO)";"GO";"PETROLINA DE GOIAS";192;7;22;221
2018;"PILAR DE GOIAS (GO)";"GO";"PILAR DE GOIAS";31;5;7;43
2018;"PIRACANJUBA (GO)";"GO";"PIRACANJUBA";524;43;49;616
2018;"PIRANHAS (GO)";"GO";"PIRANHAS";243;21;42;306
2018;"PIRENOPOLIS (GO)";"GO";"PIRENOPOLIS";338;70;40;448
2018;"PIRES DO RIO (GO)";"GO";"PIRES DO RIO";590;34;71;695
2018;"PLANALTINA (GO)";"GO";"PLANALTINA";745;104;430;1279
2018;"PONTALINA (GO)";"GO";"PONTALINA";345;28;41;414
2018;"PORANGATU (GO)";"GO";"PORANGATU";805;67;99;971
2018;"PORTEIRAO (GO)";"GO";"PORTEIRAO";122;13;46;181
2018;"PORTELANDIA (GO)";"GO";"PORTELANDIA";63;27;4;94
2018;"POSSE (GO)";"GO";"POSSE";811;77;139;1027
2018;"PROFESSOR JAMIL (GO)";"GO";"PROFESSOR JAMIL";42;3;6;51
2018;"QUIRINOPOLIS (GO)";"GO";"QUIRINOPOLIS";1065;77;277;1419
2018;"RIALMA (GO)";"GO";"RIALMA";325;29;45;399
2018;"RIANAPOLIS (GO)";"GO";"RIANAPOLIS";103;5;9;117
2018;"RIO QUENTE (GO)";"GO";"RIO QUENTE";52;22;58;132
2018;"RIO VERDE (GO)";"GO";"RIO VERDE";4043;423;613;5079
2018;"RUBIATABA (GO)";"GO";"RUBIATABA";385;39;107;531
2018;"SANCLERLANDIA (GO)";"GO";"SANCLERLANDIA";135;10;8;153
2018;"SANTA BARBARA DE GOIAS (GO)";"GO";"SANTA BARBARA DE GOIAS";125;9;12;146
2018;"SANTA CRUZ DE GOIAS (GO)";"GO";"SANTA CRUZ DE GOIAS";16;5;4;25
2018;"SANTA FE DE GOIAS (GO)";"GO";"SANTA FE DE GOIAS";45;9;6;60
2018;"SANTA HELENA DE GOIAS (GO)";"GO";"SANTA HELENA DE GOIAS";1013;65;310;1388
2018;"SANTA ISABEL (GO)";"GO";"SANTA ISABEL";13;12;6;31
2018;"SANTA RITA DO ARAGUAIA (GO)";"GO";"SANTA RITA DO ARAGUAIA";138;17;13;168
2018;"SANTA RITA DO NOVO DESTINO (GO)";"GO";"SANTA RITA DO NOVO DESTINO";29;15;11;55
2018;"SANTA ROSA DE GOIAS (GO)";"GO";"SANTA ROSA DE GOIAS";41;4;5;50
2018;"SANTA TEREZA DE GOIAS (GO)";"GO";"SANTA TEREZA DE GOIAS";46;4;7;57
2018;"SANTA TEREZINHA DE GOIAS (GO)";"GO";"SANTA TEREZINHA DE GOIAS";124;10;24;158
2018;"SANTO ANTONIO DA BARRA (GO)";"GO";"SANTO ANTONIO DA BARRA";45;19;20;84
2018;"SANTO ANTONIO DE GOIAS (GO)";"GO";"SANTO ANTONIO DE GOIAS";99;6;21;126
2018;"SANTO ANTONIO DO DESCOBERTO (GO)";"GO";"SANTO ANTONIO DO DESCOBERTO";346;73;208;627
2018;"SAO DOMINGOS (GO)";"GO";"SAO DOMINGOS";51;9;42;102
2018;"SAO FRANCISCO DE GOIAS (GO)";"GO";"SAO FRANCISCO DE GOIAS";59;9;13;81
2018;"SAO JOAO D ALIANCA (GO)";"GO";"SAO JOAO D ALIANCA";167;9;24;200
2018;"SAO JOAO DA PARAUNA (GO)";"GO";"SAO JOAO DA PARAUNA";28;2;3;33
2018;"SAO LUIS DE MONTES BELOS (GO)";"GO";"SAO LUIS DE MONTES BELOS";512;42;102;656
2018;"SAO LUIZ DO NORTE (GO)";"GO";"SAO LUIZ DO NORTE";67;9;23;99
2018;"SAO MIGUEL DO ARAGUAIA (GO)";"GO";"SAO MIGUEL DO ARAGUAIA";397;27;83;507
2018;"SAO MIGUEL DO PASSA QUATRO (GO)";"GO";"SAO MIGUEL DO PASSA QUATRO";61;5;6;72
2018;"SAO PATRICIO (GO)";"GO";"SAO PATRICIO";13;2;6;21
2018;"SAO SIMAO (GO)";"GO";"SAO SIMAO";243;47;73;363
2018;"SENADOR CANEDO (GO)";"GO";"SENADOR CANEDO";1095;116;125;1336
2018;"SERRANOPOLIS (GO)";"GO";"SERRANOPOLIS";140;18;22;180
2018;"SILVANIA (GO)";"GO";"SILVANIA";470;48;56;574
2018;"SIMOLANDIA (GO)";"GO";"SIMOLANDIA";162;3;14;179
2018;"SITIO D ABADIA (GO)";"GO";"SITIO D ABADIA";14;3;8;25
2018;"TAQUARAL DE GOIAS (GO)";"GO";"TAQUARAL DE GOIAS";35;6;9;50
2018;"TERESINA DE GOIAS (GO)";"GO";"TERESINA DE GOIAS";19;1;2;22
2018;"TEREZOPOLIS DE GOIAS (GO)";"GO";"TEREZOPOLIS DE GOIAS";119;6;26;151
2018;"TRES RANCHOS (GO)";"GO";"TRES RANCHOS";46;10;5;61
2018;"TRINDADE (GO)";"GO";"TRINDADE";1363;92;166;1621
2018;"TROMBAS (GO)";"GO";"TROMBAS";46;6;16;68
2018;"TURVANIA (GO)";"GO";"TURVANIA";70;7;9;86
2018;"TURVELANDIA (GO)";"GO";"TURVELANDIA";97;15;24;136
2018;"UIRAPURU (GO)";"GO";"UIRAPURU";19;9;7;35
2018;"URUACU (GO)";"GO";"URUACU";698;43;113;854
2018;"URUANA (GO)";"GO";"URUANA";343;10;22;375
2018;"URUTAI (GO)";"GO";"URUTAI";35;3;11;49
2018;"VALPARAISO DE GOIAS (GO)";"GO";"VALPARAISO DE GOIAS";797;239;286;1322
2018;"VARJAO (GO)";"GO";"VARJAO";64;3;8;75
2018;"VIANOPOLIS (GO)";"GO";"VIANOPOLIS";612;46;54;712
2018;"VICENTINOPOLIS (GO)";"GO";"VICENTINOPOLIS";206;11;76;293
2018;"VILA BOA (GO)";"GO";"VILA BOA";36;3;34;73
2018;"VILA PROPICIO (GO)";"GO";"VILA PROPICIO";38;19;28;85
2018;"ACAILANDIA (MA)";"MA";"ACAILANDIA";1807;132;276;2215
2018;"AFONSO CUNHA (MA)";"MA";"AFONSO CUNHA";10;1;6;17
2018;"AGUA DOCE DO MARANHAO (MA)";"MA";"AGUA DOCE DO MARANHAO";4;4;11;19
2018;"ALCANTARA (MA)";"MA";"ALCANTARA";55;31;51;137
2018;"ALDEIAS ALTAS (MA)";"MA";"ALDEIAS ALTAS";51;3;29;83
2018;"ALTAMIRA DO MARANHAO (MA)";"MA";"ALTAMIRA DO MARANHAO";23;3;3;29
2018;"ALTO ALEGRE DO MARANHAO (MA)";"MA";"ALTO ALEGRE DO MARANHAO";74;32;3;109
2018;"ALTO ALEGRE DO PINDARE (MA)";"MA";"ALTO ALEGRE DO PINDARE";46;11;4;61
2018;"ALTO PARNAIBA (MA)";"MA";"ALTO PARNAIBA";87;3;8;98
2018;"AMAPA DO MARANHAO (MA)";"MA";"AMAPA DO MARANHAO";19;2;4;25
2018;"AMARANTE DO MARANHAO (MA)";"MA";"AMARANTE DO MARANHAO";144;13;10;167
2018;"ANAJATUBA (MA)";"MA";"ANAJATUBA";43;7;13;63
2018;"ANAPURUS (MA)";"MA";"ANAPURUS";66;2;24;92
2018;"APICUM ACU (MA)";"MA";"APICUM ACU";18;10;5;33
2018;"ARAGUANA (MA)";"MA";"ARAGUANA";20;0;8;28
2018;"ARAIOSES (MA)";"MA";"ARAIOSES";33;6;29;68
2018;"ARAME (MA)";"MA";"ARAME";121;10;3;134
2018;"ARARI (MA)";"MA";"ARARI";109;12;11;132
2018;"AXIXA (MA)";"MA";"AXIXA";25;6;12;43
2018;"BACABAL (MA)";"MA";"BACABAL";972;99;96;1167
2018;"BACABEIRA (MA)";"MA";"BACABEIRA";133;11;36;180
2018;"BACURI (MA)";"MA";"BACURI";16;7;8;31
2018;"BACURITUBA (MA)";"MA";"BACURITUBA";5;0;6;11
2018;"BALSAS (MA)";"MA";"BALSAS";1957;71;160;2188
2018;"BARAO DE GRAJAU (MA)";"MA";"BARAO DE GRAJAU";85;4;12;101
2018;"BARRA DO CORDA (MA)";"MA";"BARRA DO CORDA";789;30;25;844
2018;"BARREIRINHAS (MA)";"MA";"BARREIRINHAS";100;9;30;139
2018;"BELA VISTA DO MARANHAO (MA)";"MA";"BELA VISTA DO MARANHAO";49;4;5;58
2018;"BELAGUA (MA)";"MA";"BELAGUA";4;5;3;12
2018;"BENEDITO LEITE (MA)";"MA";"BENEDITO LEITE";10;5;2;17
2018;"BEQUIMAO (MA)";"MA";"BEQUIMAO";102;18;20;140
2018;"BERNARDO DO MEARIM (MA)";"MA";"BERNARDO DO MEARIM";41;1;5;47
2018;"BOA VISTA DO GURUPI (MA)";"MA";"BOA VISTA DO GURUPI";15;5;3;23
2018;"BOM JARDIM (MA)";"MA";"BOM JARDIM";132;10;10;152
2018;"BOM JESUS DAS SELVAS (MA)";"MA";"BOM JESUS DAS SELVAS";150;7;9;166
2018;"BOM LUGAR (MA)";"MA";"BOM LUGAR";41;15;12;68
2018;"BREJO (MA)";"MA";"BREJO";88;17;14;119
2018;"BREJO DE AREIA (MA)";"MA";"BREJO DE AREIA";27;4;6;37
2018;"BURITI (MA)";"MA";"BURITI";31;15;20;66
2018;"BURITI BRAVO (MA)";"MA";"BURITI BRAVO";50;3;9;62
2018;"BURITICUPU (MA)";"MA";"BURITICUPU";503;56;22;581
2018;"BURITIRANA (MA)";"MA";"BURITIRANA";37;5;2;44
2018;"CACHOEIRA GRANDE (MA)";"MA";"CACHOEIRA GRANDE";7;2;8;17
2018;"CAJAPIO (MA)";"MA";"CAJAPIO";10;1;3;14
2018;"CAJARI (MA)";"MA";"CAJARI";11;3;6;20
2018;"CAMPESTRE DO MARANHAO (MA)";"MA";"CAMPESTRE DO MARANHAO";50;18;37;105
2018;"CANDIDO MENDES (MA)";"MA";"CANDIDO MENDES";14;7;3;24
2018;"CANTANHEDE (MA)";"MA";"CANTANHEDE";29;4;9;42
2018;"CAPINZAL DO NORTE (MA)";"MA";"CAPINZAL DO NORTE";42;17;4;63
2018;"CAROLINA (MA)";"MA";"CAROLINA";103;8;13;124
2018;"CARUTAPERA (MA)";"MA";"CARUTAPERA";47;22;14;83
2018;"CAXIAS (MA)";"MA";"CAXIAS";947;83;176;1206
2018;"CEDRAL (MA)";"MA";"CEDRAL";15;0;8;23
2018;"CENTRAL DO MARANHAO (MA)";"MA";"CENTRAL DO MARANHAO";14;6;4;24
2018;"CENTRO DO GUILHERME (MA)";"MA";"CENTRO DO GUILHERME";21;0;4;25
2018;"CENTRO NOVO DO MARANHAO (MA)";"MA";"CENTRO NOVO DO MARANHAO";37;2;11;50
2018;"CHAPADINHA (MA)";"MA";"CHAPADINHA";401;29;23;453
2018;"CIDELANDIA (MA)";"MA";"CIDELANDIA";69;8;14;91
2018;"CODO (MA)";"MA";"CODO";719;31;60;810
2018;"COELHO NETO (MA)";"MA";"COELHO NETO";118;23;46;187
2018;"COLINAS (MA)";"MA";"COLINAS";187;23;21;231
2018;"CONCEICAO DO LAGO ACU (MA)";"MA";"CONCEICAO DO LAGO ACU";28;5;1;34
2018;"COROATA (MA)";"MA";"COROATA";231;55;27;313
2018;"CURURUPU (MA)";"MA";"CURURUPU";47;16;12;75
2018;"DAVINOPOLIS (MA)";"MA";"DAVINOPOLIS";99;2;6;107
2018;"DOM PEDRO (MA)";"MA";"DOM PEDRO";447;9;40;496
2018;"DUQUE BACELAR (MA)";"MA";"DUQUE BACELAR";6;1;9;16
2018;"ESPERANTINOPOLIS (MA)";"MA";"ESPERANTINOPOLIS";92;17;5;114
2018;"ESTREITO (MA)";"MA";"ESTREITO";240;20;31;291
2018;"FEIRA NOVA DO MARANHAO (MA)";"MA";"FEIRA NOVA DO MARANHAO";24;1;7;32
2018;"FERNANDO FALCAO (MA)";"MA";"FERNANDO FALCAO";24;2;10;36
2018;"FORMOSA DA SERRA NEGRA (MA)";"MA";"FORMOSA DA SERRA NEGRA";53;5;9;67
2018;"FORTALEZA DOS NOGUEIRAS (MA)";"MA";"FORTALEZA DOS NOGUEIRAS";109;14;10;133
2018;"FORTUNA (MA)";"MA";"FORTUNA";46;20;4;70
2018;"GODOFREDO VIANA (MA)";"MA";"GODOFREDO VIANA";10;12;11;33
2018;"GONCALVES DIAS (MA)";"MA";"GONCALVES DIAS";70;8;11;89
2018;"GOVERNADOR ARCHER (MA)";"MA";"GOVERNADOR ARCHER";33;10;9;52
2018;"GOVERNADOR EDISON LOBAO (MA)";"MA";"GOVERNADOR EDISON LOBAO";100;0;24;124
2018;"GOVERNADOR EUGENIO BARROS (MA)";"MA";"GOVERNADOR EUGENIO BARROS";52;12;20;84
2018;"GOVERNADOR LUIZ ROCHA (MA)";"MA";"GOVERNADOR LUIZ ROCHA";21;3;5;29
2018;"GOVERNADOR NEWTON BELLO (MA)";"MA";"GOVERNADOR NEWTON BELLO";19;0;2;21
2018;"GOVERNADOR NUNES FREIRE (MA)";"MA";"GOVERNADOR NUNES FREIRE";107;7;7;121
2018;"GRACA ARANHA (MA)";"MA";"GRACA ARANHA";16;5;4;25
2018;"GRAJAU (MA)";"MA";"GRAJAU";555;43;60;658
2018;"GUIMARAES (MA)";"MA";"GUIMARAES";18;4;17;39
2018;"HUMBERTO DE CAMPOS (MA)";"MA";"HUMBERTO DE CAMPOS";24;15;8;47
2018;"ICATU (MA)";"MA";"ICATU";27;4;15;46
2018;"IGARAPE DO MEIO (MA)";"MA";"IGARAPE DO MEIO";43;7;10;60
2018;"IGARAPE GRANDE (MA)";"MA";"IGARAPE GRANDE";69;11;8;88
2018;"IMPERATRIZ (MA)";"MA";"IMPERATRIZ";4354;301;528;5183
2018;"ITAIPAVA DO GRAJAU (MA)";"MA";"ITAIPAVA DO GRAJAU";29;6;9;44
2018;"ITAPECURU MIRIM (MA)";"MA";"ITAPECURU MIRIM";405;39;40;484
2018;"ITINGA DO MARANHAO (MA)";"MA";"ITINGA DO MARANHAO";170;8;17;195
2018;"JATOBA (MA)";"MA";"JATOBA";8;4;15;27
2018;"JENIPAPO DOS VIEIRAS (MA)";"MA";"JENIPAPO DOS VIEIRAS";60;5;12;77
2018;"JOAO LISBOA (MA)";"MA";"JOAO LISBOA";150;12;14;176
2018;"JOSELANDIA (MA)";"MA";"JOSELANDIA";78;14;8;100
2018;"JUNCO DO MARANHAO (MA)";"MA";"JUNCO DO MARANHAO";13;12;6;31
2018;"LAGO DA PEDRA (MA)";"MA";"LAGO DA PEDRA";304;53;22;379
2018;"LAGO DO JUNCO (MA)";"MA";"LAGO DO JUNCO";20;2;13;35
2018;"LAGO DOS RODRIGUES (MA)";"MA";"LAGO DOS RODRIGUES";52;12;8;72
2018;"LAGO VERDE (MA)";"MA";"LAGO VERDE";35;0;11;46
2018;"LAGOA DO MATO (MA)";"MA";"LAGOA DO MATO";29;0;12;41
2018;"LAGOA GRANDE DO MARANHAO (MA)";"MA";"LAGOA GRANDE DO MARANHAO";37;1;3;41
2018;"LAJEADO NOVO (MA)";"MA";"LAJEADO NOVO";25;8;5;38
2018;"LIMA CAMPOS (MA)";"MA";"LIMA CAMPOS";93;38;9;140
2018;"LORETO (MA)";"MA";"LORETO";30;9;11;50
2018;"LUIS DOMINGUES (MA)";"MA";"LUIS DOMINGUES";5;2;4;11
2018;"MAGALHAES DE ALMEIDA (MA)";"MA";"MAGALHAES DE ALMEIDA";20;2;13;35
2018;"MARACACUME (MA)";"MA";"MARACACUME";86;53;8;147
2018;"MARAJA DO SENA (MA)";"MA";"MARAJA DO SENA";13;0;2;15
2018;"MARANHAOZINHO (MA)";"MA";"MARANHAOZINHO";52;2;3;57
2018;"MATA ROMA (MA)";"MA";"MATA ROMA";59;7;24;90
2018;"MATINHA (MA)";"MA";"MATINHA";57;18;10;85
2018;"MATOES (MA)";"MA";"MATOES";47;7;27;81
2018;"MATOES DO NORTE (MA)";"MA";"MATOES DO NORTE";21;5;6;32
2018;"MILAGRES DO MARANHAO (MA)";"MA";"MILAGRES DO MARANHAO";10;3;9;22
2018;"MIRADOR (MA)";"MA";"MIRADOR";51;5;5;61
2018;"MIRANDA DO NORTE (MA)";"MA";"MIRANDA DO NORTE";164;7;15;186
2018;"MIRINZAL (MA)";"MA";"MIRINZAL";49;5;6;60
2018;"MONCAO (MA)";"MA";"MONCAO";32;6;9;47
2018;"MONTES ALTOS (MA)";"MA";"MONTES ALTOS";43;1;2;46
2018;"MORROS (MA)";"MA";"MORROS";25;4;9;38
2018;"NINA RODRIGUES (MA)";"MA";"NINA RODRIGUES";14;3;8;25
2018;"NOVA COLINAS (MA)";"MA";"NOVA COLINAS";24;4;12;40
2018;"NOVA IORQUE (MA)";"MA";"NOVA IORQUE";16;1;2;19
2018;"NOVA OLINDA DO MARANHAO (MA)";"MA";"NOVA OLINDA DO MARANHAO";64;14;7;85
2018;"OLHO D AGUA DAS CUNHAS (MA)";"MA";"OLHO D AGUA DAS CUNHAS";76;15;18;109
2018;"OLINDA NOVA DO MARANHAO (MA)";"MA";"OLINDA NOVA DO MARANHAO";46;2;11;59
2018;"PACO DO LUMIAR (MA)";"MA";"PACO DO LUMIAR";485;130;172;787
2018;"PALMEIRANDIA (MA)";"MA";"PALMEIRANDIA";27;2;11;40
2018;"PARAIBANO (MA)";"MA";"PARAIBANO";97;17;7;121
2018;"PARNARAMA (MA)";"MA";"PARNARAMA";54;3;10;67
2018;"PASSAGEM FRANCA (MA)";"MA";"PASSAGEM FRANCA";51;6;7;64
2018;"PASTOS BONS (MA)";"MA";"PASTOS BONS";147;13;10;170
2018;"PAULINO NEVES (MA)";"MA";"PAULINO NEVES";5;3;12;20
2018;"PAULO RAMOS (MA)";"MA";"PAULO RAMOS";87;9;7;103
2018;"PEDREIRAS (MA)";"MA";"PEDREIRAS";397;74;44;515
2018;"PEDRO DO ROSARIO (MA)";"MA";"PEDRO DO ROSARIO";24;1;10;35
2018;"PENALVA (MA)";"MA";"PENALVA";44;4;4;52
2018;"PERI MIRIM (MA)";"MA";"PERI MIRIM";29;11;10;50
2018;"PERITORO (MA)";"MA";"PERITORO";63;70;13;146
2018;"PINDARE MIRIM (MA)";"MA";"PINDARE MIRIM";105;22;18;145
2018;"PINHEIRO (MA)";"MA";"PINHEIRO";521;47;100;668
2018;"PIO XII (MA)";"MA";"PIO XII";121;8;9;138
2018;"PIRAPEMAS (MA)";"MA";"PIRAPEMAS";26;5;4;35
2018;"POCAO DE PEDRAS (MA)";"MA";"POCAO DE PEDRAS";61;19;7;87
2018;"PORTO FRANCO (MA)";"MA";"PORTO FRANCO";138;16;13;167
2018;"PORTO RICO DO MARANHAO (MA)";"MA";"PORTO RICO DO MARANHAO";4;0;3;7
2018;"PRESIDENTE DUTRA (MA)";"MA";"PRESIDENTE DUTRA";532;32;32;596
2018;"PRESIDENTE JUSCELINO (MA)";"MA";"PRESIDENTE JUSCELINO";11;3;4;18
2018;"PRESIDENTE MEDICI (MA)";"MA";"PRESIDENTE MEDICI";16;7;3;26
2018;"PRESIDENTE SARNEY (MA)";"MA";"PRESIDENTE SARNEY";18;9;11;38
2018;"PRESIDENTE VARGAS (MA)";"MA";"PRESIDENTE VARGAS";24;5;6;35
2018;"PRIMEIRA CRUZ (MA)";"MA";"PRIMEIRA CRUZ";2;1;5;8
2018;"RAPOSA (MA)";"MA";"RAPOSA";134;7;61;202
2018;"RIACHAO (MA)";"MA";"RIACHAO";109;13;24;146
2018;"RIBAMAR FIQUENE (MA)";"MA";"RIBAMAR FIQUENE";35;3;5;43
2018;"ROSARIO (MA)";"MA";"ROSARIO";231;28;55;314
2018;"SAMBAIBA (MA)";"MA";"SAMBAIBA";26;5;9;40
2018;"SANTA FILOMENA DO MARANHAO (MA)";"MA";"SANTA FILOMENA DO MARANHAO";10;7;6;23
2018;"SANTA HELENA (MA)";"MA";"SANTA HELENA";108;14;18;140
2018;"SANTA INES (MA)";"MA";"SANTA INES";876;182;120;1178
2018;"SANTA LUZIA (MA)";"MA";"SANTA LUZIA";323;94;15;432
2018;"SANTA LUZIA DO PARUA (MA)";"MA";"SANTA LUZIA DO PARUA";136;19;13;168
2018;"SANTA QUITERIA DO MARANHAO (MA)";"MA";"SANTA QUITERIA DO MARANHAO";48;5;21;74
2018;"SANTA RITA (MA)";"MA";"SANTA RITA";186;11;21;218
2018;"SANTANA DO MARANHAO (MA)";"MA";"SANTANA DO MARANHAO";12;3;9;24
2018;"SANTO AMARO DO MARANHAO (MA)";"MA";"SANTO AMARO DO MARANHAO";6;3;2;11
2018;"SANTO ANTONIO DOS LOPES (MA)";"MA";"SANTO ANTONIO DOS LOPES";138;13;13;164
2018;"SAO BENEDITO DO RIO PRETO (MA)";"MA";"SAO BENEDITO DO RIO PRETO";25;9;6;40
2018;"SAO BENTO (MA)";"MA";"SAO BENTO";168;43;21;232
2018;"SAO BERNARDO (MA)";"MA";"SAO BERNARDO";90;7;25;122
2018;"SAO DOMINGOS DO AZEITAO (MA)";"MA";"SAO DOMINGOS DO AZEITAO";63;3;4;70
2018;"SAO DOMINGOS DO MARANHAO (MA)";"MA";"SAO DOMINGOS DO MARANHAO";282;6;22;310
2018;"SAO FELIX DE BALSAS (MA)";"MA";"SAO FELIX DE BALSAS";8;2;2;12
2018;"SAO FRANCISCO DO BREJAO (MA)";"MA";"SAO FRANCISCO DO BREJAO";67;4;9;80
2018;"SAO FRANCISCO DO MARANHAO (MA)";"MA";"SAO FRANCISCO DO MARANHAO";10;0;2;12
2018;"SAO JOAO BATISTA (MA)";"MA";"SAO JOAO BATISTA";35;7;12;54
2018;"SAO JOAO DO CARU (MA)";"MA";"SAO JOAO DO CARU";37;2;3;42
2018;"SAO JOAO DO PARAISO (MA)";"MA";"SAO JOAO DO PARAISO";40;4;8;52
2018;"SAO JOAO DO SOTER (MA)";"MA";"SAO JOAO DO SOTER";33;4;13;50
2018;"SAO JOAO DOS PATOS (MA)";"MA";"SAO JOAO DOS PATOS";211;13;10;234
2018;"SAO JOSE DE RIBAMAR (MA)";"MA";"SAO JOSE DE RIBAMAR";897;167;351;1415
2018;"SAO JOSE DOS BASILIOS (MA)";"MA";"SAO JOSE DOS BASILIOS";20;3;6;29
2018;"SAO LUIS (MA)";"MA";"SAO LUIS";10335;1427;4470;16232
2018;"SAO LUIS GONZAGA DO MARANHAO (MA)";"MA";"SAO LUIS GONZAGA DO MARANHAO";41;11;10;62
2018;"SAO MATEUS DO MARANHAO (MA)";"MA";"SAO MATEUS DO MARANHAO";132;45;27;204
2018;"SAO PEDRO DA AGUA BRANCA (MA)";"MA";"SAO PEDRO DA AGUA BRANCA";23;8;7;38
2018;"SAO PEDRO DOS CRENTES (MA)";"MA";"SAO PEDRO DOS CRENTES";50;1;8;59
2018;"SAO RAIMUNDO DAS MANGABEIRAS (MA)";"MA";"SAO RAIMUNDO DAS MANGABEIRAS";180;13;55;248
2018;"SAO RAIMUNDO DO DOCA BEZERRA (MA)";"MA";"SAO RAIMUNDO DO DOCA BEZERRA";21;1;2;24
2018;"SAO ROBERTO (MA)";"MA";"SAO ROBERTO";18;5;4;27
2018;"SAO VICENTE FERRER (MA)";"MA";"SAO VICENTE FERRER";40;2;5;47
2018;"SATUBINHA (MA)";"MA";"SATUBINHA";18;6;2;26
2018;"SENADOR ALEXANDRE COSTA (MA)";"MA";"SENADOR ALEXANDRE COSTA";26;11;9;46
2018;"SENADOR LA ROCQUE (MA)";"MA";"SENADOR LA ROCQUE";86;4;5;95
2018;"SERRANO DO MARANHAO (MA)";"MA";"SERRANO DO MARANHAO";6;1;10;17
2018;"SITIO NOVO (MA)";"MA";"SITIO NOVO";85;4;10;99
2018;"SUCUPIRA DO NORTE (MA)";"MA";"SUCUPIRA DO NORTE";31;3;6;40
2018;"SUCUPIRA DO RIACHAO (MA)";"MA";"SUCUPIRA DO RIACHAO";11;7;6;24
2018;"TASSO FRAGOSO (MA)";"MA";"TASSO FRAGOSO";87;6;7;100
2018;"TIMBIRAS (MA)";"MA";"TIMBIRAS";46;3;10;59
2018;"TIMON (MA)";"MA";"TIMON";728;49;174;951
2018;"TRIZIDELA DO VALE (MA)";"MA";"TRIZIDELA DO VALE";181;34;13;228
2018;"TUFILANDIA (MA)";"MA";"TUFILANDIA";10;5;1;16
2018;"TUNTUM (MA)";"MA";"TUNTUM";162;11;21;194
2018;"TURIACU (MA)";"MA";"TURIACU";48;5;8;61
2018;"TURILANDIA (MA)";"MA";"TURILANDIA";15;5;4;24
2018;"TUTOIA (MA)";"MA";"TUTOIA";94;23;16;133
2018;"URBANO SANTOS (MA)";"MA";"URBANO SANTOS";94;10;20;124
2018;"VARGEM GRANDE (MA)";"MA";"VARGEM GRANDE";155;8;19;182
2018;"VIANA (MA)";"MA";"VIANA";234;11;12;257
2018;"VILA NOVA DOS MARTIRIOS (MA)";"MA";"VILA NOVA DOS MARTIRIOS";53;6;8;67
2018;"VITORIA DO MEARIM (MA)";"MA";"VITORIA DO MEARIM";116;8;12;136
2018;"VITORINO FREIRE (MA)";"MA";"VITORINO FREIRE";130;15;12;157
2018;"ZE DOCA (MA)";"MA";"ZE DOCA";258;28;43;329
2018;"ABADIA DOS DOURADOS (MG)";"MG";"ABADIA DOS DOURADOS";190;37;19;246
2018;"ABAETE (MG)";"MG";"ABAETE";502;45;195;742
2018;"ABRE CAMPO (MG)";"MG";"ABRE CAMPO";253;16;54;323
2018;"ACAIACA (MG)";"MG";"ACAIACA";41;9;12;62
2018;"ACUCENA (MG)";"MG";"ACUCENA";54;16;45;115
2018;"AGUA BOA (MG)";"MG";"AGUA BOA";85;19;42;146
2018;"AGUA COMPRIDA (MG)";"MG";"AGUA COMPRIDA";39;11;13;63
2018;"AGUANIL (MG)";"MG";"AGUANIL";83;8;9;100
2018;"AGUAS FORMOSAS (MG)";"MG";"AGUAS FORMOSAS";117;32;53;202
2018;"AGUAS VERMELHAS (MG)";"MG";"AGUAS VERMELHAS";93;28;35;156
2018;"AIMORES (MG)";"MG";"AIMORES";202;39;50;291
2018;"AIURUOCA (MG)";"MG";"AIURUOCA";121;29;15;165
2018;"ALAGOA (MG)";"MG";"ALAGOA";43;1;20;64
2018;"ALBERTINA (MG)";"MG";"ALBERTINA";53;22;8;83
2018;"ALEM PARAIBA (MG)";"MG";"ALEM PARAIBA";1597;137;85;1819
2018;"ALFENAS (MG)";"MG";"ALFENAS";1376;160;268;1804
2018;"ALFREDO VASCONCELOS (MG)";"MG";"ALFREDO VASCONCELOS";186;18;33;237
2018;"ALMENARA (MG)";"MG";"ALMENARA";323;98;161;582
2018;"ALPERCATA (MG)";"MG";"ALPERCATA";91;5;8;104
2018;"ALPINOPOLIS (MG)";"MG";"ALPINOPOLIS";539;49;100;688
2018;"ALTEROSA (MG)";"MG";"ALTEROSA";312;37;67;416
2018;"ALTO CAPARAO (MG)";"MG";"ALTO CAPARAO";100;24;25;149
2018;"ALTO JEQUITIBA (MG)";"MG";"ALTO JEQUITIBA";119;10;20;149
2018;"ALTO RIO DOCE (MG)";"MG";"ALTO RIO DOCE";144;29;38;211
2018;"ALVARENGA (MG)";"MG";"ALVARENGA";46;6;21;73
2018;"ALVINOPOLIS (MG)";"MG";"ALVINOPOLIS";233;22;28;283
2018;"ALVORADA DE MINAS (MG)";"MG";"ALVORADA DE MINAS";26;22;22;70
2018;"AMPARO DA SERRA (MG)";"MG";"AMPARO DA SERRA";56;5;46;107
2018;"ANDRADAS (MG)";"MG";"ANDRADAS";1209;126;122;1457
2018;"ANDRELANDIA (MG)";"MG";"ANDRELANDIA";163;39;29;231
2018;"ANGELANDIA (MG)";"MG";"ANGELANDIA";99;13;40;152
2018;"ANTONIO CARLOS (MG)";"MG";"ANTONIO CARLOS";199;31;44;274
2018;"ANTONIO DIAS (MG)";"MG";"ANTONIO DIAS";122;22;64;208
2018;"ANTONIO PRADO DE MINAS (MG)";"MG";"ANTONIO PRADO DE MINAS";20;8;5;33
2018;"ARACAI (MG)";"MG";"ARACAI";22;9;9;40
2018;"ARACITABA (MG)";"MG";"ARACITABA";13;4;5;22
2018;"ARACUAI (MG)";"MG";"ARACUAI";287;25;135;447
2018;"ARAGUARI (MG)";"MG";"ARAGUARI";2577;452;231;3260
2018;"ARANTINA (MG)";"MG";"ARANTINA";52;8;3;63
2018;"ARAPONGA (MG)";"MG";"ARAPONGA";82;8;18;108
2018;"ARAPORA (MG)";"MG";"ARAPORA";274;17;66;357
2018;"ARAPUA (MG)";"MG";"ARAPUA";62;4;21;87
2018;"ARAUJOS (MG)";"MG";"ARAUJOS";153;16;13;182
2018;"ARAXA (MG)";"MG";"ARAXA";1883;257;364;2504
2018;"ARCEBURGO (MG)";"MG";"ARCEBURGO";175;29;76;280
2018;"ARCOS (MG)";"MG";"ARCOS";1343;119;312;1774
2018;"AREADO (MG)";"MG";"AREADO";257;31;91;379
2018;"ARGIRITA (MG)";"MG";"ARGIRITA";29;5;10;44
2018;"ARICANDUVA (MG)";"MG";"ARICANDUVA";26;4;15;45
2018;"ARINOS (MG)";"MG";"ARINOS";412;36;142;590
2018;"ASTOLFO DUTRA (MG)";"MG";"ASTOLFO DUTRA";252;8;28;288
2018;"ATALEIA (MG)";"MG";"ATALEIA";100;30;48;178
2018;"AUGUSTO DE LIMA (MG)";"MG";"AUGUSTO DE LIMA";37;6;20;63
2018;"BAEPENDI (MG)";"MG";"BAEPENDI";435;80;34;549
2018;"BALDIM (MG)";"MG";"BALDIM";196;10;26;232
2018;"BAMBUI (MG)";"MG";"BAMBUI";564;65;99;728
2018;"BANDEIRA (MG)";"MG";"BANDEIRA";23;11;16;50
2018;"BANDEIRA DO SUL (MG)";"MG";"BANDEIRA DO SUL";126;27;12;165
2018;"BARAO DE COCAIS (MG)";"MG";"BARAO DE COCAIS";527;104;96;727
2018;"BARAO D0 MONTE ALTO (MG)";"MG";"BARAO D0 MONTE ALTO";60;7;15;82
2018;"BARBACENA (MG)";"MG";"BARBACENA";1908;336;231;2475
2018;"BARRA LONGA (MG)";"MG";"BARRA LONGA";44;5;17;66
2018;"BARROSO (MG)";"MG";"BARROSO";467;35;41;543
2018;"BELA VISTA DE MINAS (MG)";"MG";"BELA VISTA DE MINAS";191;13;23;227
2018;"BELMIRO BRAGA (MG)";"MG";"BELMIRO BRAGA";87;13;11;111
2018;"BELO HORIZONTE (MG)";"MG";"BELO HORIZONTE";35328;6332;8767;50427
2018;"BELO ORIENTE (MG)";"MG";"BELO ORIENTE";260;28;106;394
2018;"BELO VALE (MG)";"MG";"BELO VALE";309;29;37;375
2018;"BERILO (MG)";"MG";"BERILO";87;13;47;147
2018;"BERIZAL (MG)";"MG";"BERIZAL";43;11;12;66
2018;"BERTOPOLIS (MG)";"MG";"BERTOPOLIS";13;6;7;26
2018;"BETIM (MG)";"MG";"BETIM";6070;833;1345;8248
2018;"BIAS FORTES (MG)";"MG";"BIAS FORTES";29;3;8;40
2018;"BICAS (MG)";"MG";"BICAS";248;33;40;321
2018;"BIQUINHAS (MG)";"MG";"BIQUINHAS";62;9;5;76
2018;"BOA ESPERANCA (MG)";"MG";"BOA ESPERANCA";861;132;230;1223
2018;"BOCAINA DE MINAS (MG)";"MG";"BOCAINA DE MINAS";117;19;17;153
2018;"BOCAIUVA (MG)";"MG";"BOCAIUVA";605;88;218;911
2018;"BOM DESPACHO (MG)";"MG";"BOM DESPACHO";1194;97;478;1769
2018;"BOM JARDIM DE MINAS (MG)";"MG";"BOM JARDIM DE MINAS";165;20;24;209
2018;"BOM JESUS DA PENHA (MG)";"MG";"BOM JESUS DA PENHA";169;23;19;211
2018;"BOM JESUS DO AMPARO (MG)";"MG";"BOM JESUS DO AMPARO";96;11;22;129
2018;"BOM JESUS DO GALHO (MG)";"MG";"BOM JESUS DO GALHO";123;10;27;160
2018;"BOM REPOUSO (MG)";"MG";"BOM REPOUSO";212;12;24;248
2018;"BOM SUCESSO (MG)";"MG";"BOM SUCESSO";232;33;66;331
2018;"BONFIM (MG)";"MG";"BONFIM";166;18;24;208
2018;"BONFINOPOLIS DE MINAS (MG)";"MG";"BONFINOPOLIS DE MINAS";101;5;35;141
2018;"BONITO DE MINAS (MG)";"MG";"BONITO DE MINAS";47;9;37;93
2018;"BORDA DA MATA (MG)";"MG";"BORDA DA MATA";310;42;74;426
2018;"BOTELHOS (MG)";"MG";"BOTELHOS";275;94;55;424
2018;"BOTUMIRIM (MG)";"MG";"BOTUMIRIM";44;12;31;87
2018;"BRAS PIRES (MG)";"MG";"BRAS PIRES";66;8;13;87
2018;"BRASILANDIA DE MINAS (MG)";"MG";"BRASILANDIA DE MINAS";260;27;146;433
2018;"BRASILIA DE MINAS (MG)";"MG";"BRASILIA DE MINAS";330;31;100;461
2018;"BRASOPOLIS (MG)";"MG";"BRASOPOLIS";246;46;51;343
2018;"BRAUNAS (MG)";"MG";"BRAUNAS";27;10;24;61
2018;"BRUMADINHO (MG)";"MG";"BRUMADINHO";980;133;291;1404
2018;"BUENO BRANDAO (MG)";"MG";"BUENO BRANDAO";242;48;27;317
2018;"BUENOPOLIS (MG)";"MG";"BUENOPOLIS";118;14;41;173
2018;"BUGRE (MG)";"MG";"BUGRE";30;4;13;47
2018;"BURITIS (MG)";"MG";"BURITIS";341;19;124;484
2018;"BURITIZEIRO (MG)";"MG";"BURITIZEIRO";287;48;136;471
2018;"CABECEIRA GRANDE (MG)";"MG";"CABECEIRA GRANDE";66;10;14;90
2018;"CABO VERDE (MG)";"MG";"CABO VERDE";196;58;52;306
2018;"CACHOEIRA DA PRATA (MG)";"MG";"CACHOEIRA DA PRATA";62;4;9;75
2018;"CACHOEIRA DE MINAS (MG)";"MG";"CACHOEIRA DE MINAS";155;33;23;211
2018;"CACHOEIRA DE PAJEU (MG)";"MG";"CACHOEIRA DE PAJEU";44;20;21;85
2018;"CACHOEIRA DOURADA (MG)";"MG";"CACHOEIRA DOURADA";18;15;4;37
2018;"CAETANOPOLIS (MG)";"MG";"CAETANOPOLIS";159;22;56;237
2018;"CAETE (MG)";"MG";"CAETE";604;137;74;815
2018;"CAIANA (MG)";"MG";"CAIANA";57;13;12;82
2018;"CAJURI (MG)";"MG";"CAJURI";82;6;13;101
2018;"CALDAS (MG)";"MG";"CALDAS";329;58;33;420
2018;"CAMACHO (MG)";"MG";"CAMACHO";57;10;29;96
2018;"CAMANDUCAIA (MG)";"MG";"CAMANDUCAIA";558;55;71;684
2018;"CAMBUI (MG)";"MG";"CAMBUI";698;80;118;896
2018;"CAMBUQUIRA (MG)";"MG";"CAMBUQUIRA";184;45;48;277
2018;"CAMPANARIO (MG)";"MG";"CAMPANARIO";23;5;6;34
2018;"CAMPANHA (MG)";"MG";"CAMPANHA";319;66;68;453
2018;"CAMPESTRE (MG)";"MG";"CAMPESTRE";601;71;82;754
2018;"CAMPINA VERDE (MG)";"MG";"CAMPINA VERDE";273;52;57;382
2018;"CAMPO AZUL (MG)";"MG";"CAMPO AZUL";12;4;13;29
2018;"CAMPO BELO (MG)";"MG";"CAMPO BELO";1399;100;141;1640
2018;"CAMPO DO MEIO (MG)";"MG";"CAMPO DO MEIO";154;28;87;269
2018;"CAMPO FLORIDO (MG)";"MG";"CAMPO FLORIDO";228;44;81;353
2018;"CAMPOS ALTOS (MG)";"MG";"CAMPOS ALTOS";389;51;116;556
2018;"CAMPOS GERAIS (MG)";"MG";"CAMPOS GERAIS";458;46;162;666
2018;"CANA VERDE (MG)";"MG";"CANA VERDE";83;6;22;111
2018;"CANAA (MG)";"MG";"CANAA";71;4;10;85
2018;"CANAPOLIS (MG)";"MG";"CANAPOLIS";274;20;100;394
2018;"CANDEIAS (MG)";"MG";"CANDEIAS";300;46;62;408
2018;"CANTAGALO (MG)";"MG";"CANTAGALO";33;6;11;50
2018;"CAPARAO (MG)";"MG";"CAPARAO";79;5;15;99
2018;"CAPELA NOVA (MG)";"MG";"CAPELA NOVA";34;19;10;63
2018;"CAPELINHA (MG)";"MG";"CAPELINHA";847;67;227;1141
2018;"CAPETINGA (MG)";"MG";"CAPETINGA";198;31;44;273
2018;"CAPIM BRANCO (MG)";"MG";"CAPIM BRANCO";100;24;12;136
2018;"CAPINOPOLIS (MG)";"MG";"CAPINOPOLIS";298;35;74;407
2018;"CAPITAO ANDRADE (MG)";"MG";"CAPITAO ANDRADE";56;6;10;72
2018;"CAPITAO ENEAS (MG)";"MG";"CAPITAO ENEAS";104;6;39;149
2018;"CAPITOLIO (MG)";"MG";"CAPITOLIO";180;32;38;250
2018;"CAPUTIRA (MG)";"MG";"CAPUTIRA";150;18;63;231
2018;"CARAI (MG)";"MG";"CARAI";94;68;66;228
2018;"CARANAIBA (MG)";"MG";"CARANAIBA";26;16;20;62
2018;"CARANDAI (MG)";"MG";"CARANDAI";652;80;121;853
2018;"CARANGOLA (MG)";"MG";"CARANGOLA";438;73;69;580
2018;"CARATINGA (MG)";"MG";"CARATINGA";1460;113;519;2092
2018;"CARBONITA (MG)";"MG";"CARBONITA";178;20;58;256
2018;"CAREACU (MG)";"MG";"CAREACU";147;10;19;176
2018;"CARLOS CHAGAS (MG)";"MG";"CARLOS CHAGAS";174;45;60;279
2018;"CARMESIA (MG)";"MG";"CARMESIA";84;3;1302;1389
2018;"CARMO DA CACHOEIRA (MG)";"MG";"CARMO DA CACHOEIRA";192;52;62;306
2018;"CARMO DA MATA (MG)";"MG";"CARMO DA MATA";154;35;61;250
2018;"CARMO DE MINAS (MG)";"MG";"CARMO DE MINAS";154;53;37;244
2018;"CARMO DO CAJURU (MG)";"MG";"CARMO DO CAJURU";467;65;115;647
2018;"CARMO DO PARANAIBA (MG)";"MG";"CARMO DO PARANAIBA";762;93;138;993
2018;"CARMO DO RIO CLARO (MG)";"MG";"CARMO DO RIO CLARO";440;38;108;586
2018;"CARMOPOLIS DE MINAS (MG)";"MG";"CARMOPOLIS DE MINAS";600;76;82;758
2018;"CARNEIRINHO (MG)";"MG";"CARNEIRINHO";201;26;79;306
2018;"CARRANCAS (MG)";"MG";"CARRANCAS";60;10;11;81
2018;"CARVALHOPOLIS (MG)";"MG";"CARVALHOPOLIS";50;13;10;73
2018;"CARVALHOS (MG)";"MG";"CARVALHOS";90;10;12;112
2018;"CASA GRANDE (MG)";"MG";"CASA GRANDE";48;3;8;59
2018;"CASCALHO RICO (MG)";"MG";"CASCALHO RICO";60;28;5;93
2018;"CASSIA (MG)";"MG";"CASSIA";469;75;84;628
2018;"CATAGUASES (MG)";"MG";"CATAGUASES";865;110;181;1156
2018;"CATAS ALTAS (MG)";"MG";"CATAS ALTAS";136;33;10;179
2018;"CATAS ALTAS DA NORUEGA (MG)";"MG";"CATAS ALTAS DA NORUEGA";55;5;14;74
2018;"CATUJI (MG)";"MG";"CATUJI";44;24;28;96
2018;"CATUTI (MG)";"MG";"CATUTI";43;8;30;81
2018;"CAXAMBU (MG)";"MG";"CAXAMBU";234;55;32;321
2018;"CEDRO DO ABAETE (MG)";"MG";"CEDRO DO ABAETE";12;2;4;18
2018;"CENTRAL DE MINAS (MG)";"MG";"CENTRAL DE MINAS";96;10;22;128
2018;"CENTRALINA (MG)";"MG";"CENTRALINA";143;9;20;172
2018;"CHACARA (MG)";"MG";"CHACARA";45;5;20;70
2018;"CHALE (MG)";"MG";"CHALE";94;10;16;120
2018;"CHAPADA DO NORTE (MG)";"MG";"CHAPADA DO NORTE";55;20;32;107
2018;"CHAPADA GAUCHA (MG)";"MG";"CHAPADA GAUCHA";222;13;71;306
2018;"CHIADOR (MG)";"MG";"CHIADOR";223;30;11;264
2018;"CIPOTANEA (MG)";"MG";"CIPOTANEA";79;7;22;108
2018;"CLARAVAL (MG)";"MG";"CLARAVAL";124;12;25;161
2018;"CLARO DOS POCOES (MG)";"MG";"CLARO DOS POCOES";106;18;70;194
2018;"CLAUDIO (MG)";"MG";"CLAUDIO";928;61;70;1059
2018;"COIMBRA (MG)";"MG";"COIMBRA";148;7;16;171
2018;"COLUNA (MG)";"MG";"COLUNA";71;5;20;96
2018;"COMENDADOR GOMES (MG)";"MG";"COMENDADOR GOMES";65;16;18;99
2018;"COMERCINHO (MG)";"MG";"COMERCINHO";32;15;25;72
2018;"CONCEICAO DA APARECIDA (MG)";"MG";"CONCEICAO DA APARECIDA";200;17;38;255
2018;"CONCEICAO DA BARRA DE MINAS (MG)";"MG";"CONCEICAO DA BARRA DE MINAS";48;20;12;80
2018;"CONCEICAO DAS ALAGOAS (MG)";"MG";"CONCEICAO DAS ALAGOAS";560;65;141;766
2018;"CONCEICAO DAS PEDRAS (MG)";"MG";"CONCEICAO DAS PEDRAS";29;9;8;46
2018;"CONCEICAO DE IPANEMA (MG)";"MG";"CONCEICAO DE IPANEMA";59;11;8;78
2018;"CONCEICAO DO MATO DENTRO (MG)";"MG";"CONCEICAO DO MATO DENTRO";206;52;216;474
2018;"CONCEICAO DO PARA (MG)";"MG";"CONCEICAO DO PARA";89;14;22;125
2018;"CONCEICAO DO RIO VERDE (MG)";"MG";"CONCEICAO DO RIO VERDE";217;80;44;341
2018;"CONCEICAO DOS OUROS (MG)";"MG";"CONCEICAO DOS OUROS";275;26;20;321
2018;"CONEGO MARINHO (MG)";"MG";"CONEGO MARINHO";30;7;27;64
2018;"CONFINS (MG)";"MG";"CONFINS";205;29;57;291
2018;"CONGONHAL (MG)";"MG";"CONGONHAL";308;12;16;336
2018;"CONGONHAS (MG)";"MG";"CONGONHAS";1109;186;146;1441
2018;"CONGONHAS DO NORTE (MG)";"MG";"CONGONHAS DO NORTE";65;7;15;87
2018;"CONQUISTA (MG)";"MG";"CONQUISTA";173;25;40;238
2018;"CONSELHEIRO LAFAIETE (MG)";"MG";"CONSELHEIRO LAFAIETE";1570;363;643;2576
2018;"CONSELHEIRO PENA (MG)";"MG";"CONSELHEIRO PENA";254;13;68;335
2018;"CONSOLACAO (MG)";"MG";"CONSOLACAO";17;8;4;29
2018;"CONTAGEM (MG)";"MG";"CONTAGEM";14539;1739;3009;19287
2018;"COQUEIRAL (MG)";"MG";"COQUEIRAL";145;18;28;191
2018;"CORACAO DE JESUS (MG)";"MG";"CORACAO DE JESUS";233;12;127;372
2018;"CORDISBURGO (MG)";"MG";"CORDISBURGO";117;19;22;158
2018;"CORDISLANDIA (MG)";"MG";"CORDISLANDIA";42;19;10;71
2018;"CORINTO (MG)";"MG";"CORINTO";395;31;99;525
2018;"COROACI (MG)";"MG";"COROACI";94;9;20;123
2018;"COROMANDEL (MG)";"MG";"COROMANDEL";749;117;116;982
2018;"CORONEL FABRICIANO (MG)";"MG";"CORONEL FABRICIANO";1241;229;566;2036
2018;"CORONEL MURTA (MG)";"MG";"CORONEL MURTA";40;9;19;68
2018;"CORONEL PACHECO (MG)";"MG";"CORONEL PACHECO";33;4;9;46
2018;"CORONEL XAVIER CHAVES (MG)";"MG";"CORONEL XAVIER CHAVES";88;8;4;100
2018;"CORREGO DANTA (MG)";"MG";"CORREGO DANTA";52;3;18;73
2018;"CORREGO DO BOM JESUS (MG)";"MG";"CORREGO DO BOM JESUS";50;12;14;76
2018;"CORREGO FUNDO (MG)";"MG";"CORREGO FUNDO";358;27;32;417
2018;"CORREGO NOVO (MG)";"MG";"CORREGO NOVO";14;3;11;28
2018;"COUTO DE MAGALHAES DE MINAS (MG)";"MG";"COUTO DE MAGALHAES DE MINAS";63;4;14;81
2018;"CRISOLITA (MG)";"MG";"CRISOLITA";14;14;11;39
2018;"CRISTAIS (MG)";"MG";"CRISTAIS";189;30;35;254
2018;"CRISTALIA (MG)";"MG";"CRISTALIA";37;5;34;76
2018;"CRISTIANO OTONI (MG)";"MG";"CRISTIANO OTONI";138;16;24;178
2018;"CRISTINA (MG)";"MG";"CRISTINA";105;31;21;157
2018;"CRUCILANDIA (MG)";"MG";"CRUCILANDIA";170;12;18;200
2018;"CRUZEIRO DA FORTALEZA (MG)";"MG";"CRUZEIRO DA FORTALEZA";114;10;20;144
2018;"CRUZILIA (MG)";"MG";"CRUZILIA";405;48;61;514
2018;"CUPARAQUE (MG)";"MG";"CUPARAQUE";63;7;8;78
2018;"CURRAL DE DENTRO (MG)";"MG";"CURRAL DE DENTRO";77;11;24;112
2018;"CURVELO (MG)";"MG";"CURVELO";1345;86;1617;3048
2018;"DATAS (MG)";"MG";"DATAS";52;5;21;78
2018;"DELFIM MOREIRA (MG)";"MG";"DELFIM MOREIRA";88;15;30;133
2018;"DELFINOPOLIS (MG)";"MG";"DELFINOPOLIS";137;20;27;184
2018;"DELTA (MG)";"MG";"DELTA";500;48;177;725
2018;"DESCOBERTO (MG)";"MG";"DESCOBERTO";41;10;3;54
2018;"DESTERRO DE ENTRE RIOS (MG)";"MG";"DESTERRO DE ENTRE RIOS";142;21;31;194
2018;"DESTERRO DO MELO (MG)";"MG";"DESTERRO DO MELO";45;13;21;79
2018;"DIAMANTINA (MG)";"MG";"DIAMANTINA";479;106;371;956
2018;"DIOGO DE VASCONCELOS (MG)";"MG";"DIOGO DE VASCONCELOS";21;7;12;40
2018;"DIONISIO (MG)";"MG";"DIONISIO";45;7;24;76
2018;"DIVINESIA (MG)";"MG";"DIVINESIA";101;7;13;121
2018;"DIVINO (MG)";"MG";"DIVINO";316;27;60;403
2018;"DIVINO DAS LARANJEIRAS (MG)";"MG";"DIVINO DAS LARANJEIRAS";53;1;9;63
2018;"DIVINOLANDIA DE MINAS (MG)";"MG";"DIVINOLANDIA DE MINAS";85;6;19;110
2018;"DIVINOPOLIS (MG)";"MG";"DIVINOPOLIS";3377;302;782;4461
2018;"DIVISA ALEGRE (MG)";"MG";"DIVISA ALEGRE";67;9;11;87
2018;"DIVISA NOVA (MG)";"MG";"DIVISA NOVA";109;36;47;192
2018;"DIVISOPOLIS (MG)";"MG";"DIVISOPOLIS";74;17;14;105
2018;"DOM BOSCO (MG)";"MG";"DOM BOSCO";32;11;17;60
2018;"DOM CAVATI (MG)";"MG";"DOM CAVATI";163;5;16;184
2018;"DOM JOAQUIM (MG)";"MG";"DOM JOAQUIM";30;8;13;51
2018;"DOM SILVERIO (MG)";"MG";"DOM SILVERIO";77;10;14;101
2018;"DOM VICOSO (MG)";"MG";"DOM VICOSO";34;14;14;62
2018;"DONA EUZEBIA (MG)";"MG";"DONA EUZEBIA";338;6;6;350
2018;"DORES DE CAMPOS (MG)";"MG";"DORES DE CAMPOS";137;30;39;206
2018;"DORES DE GUANHAES (MG)";"MG";"DORES DE GUANHAES";53;8;27;88
2018;"DORES DO INDAIA (MG)";"MG";"DORES DO INDAIA";256;46;22;324
2018;"DORES DO TURVO (MG)";"MG";"DORES DO TURVO";80;6;21;107
2018;"DORESOPOLIS (MG)";"MG";"DORESOPOLIS";17;6;6;29
2018;"DOURADOQUARA (MG)";"MG";"DOURADOQUARA";32;7;3;42
2018;"DURANDE (MG)";"MG";"DURANDE";121;12;33;166
2018;"ELOI MENDES (MG)";"MG";"ELOI MENDES";622;90;65;777
2018;"ENGENHEIRO CALDAS (MG)";"MG";"ENGENHEIRO CALDAS";165;9;21;195
2018;"ENGENHEIRO NAVARRO (MG)";"MG";"ENGENHEIRO NAVARRO";72;7;28;107
2018;"ENTRE FOLHAS (MG)";"MG";"ENTRE FOLHAS";73;6;17;96
2018;"ENTRE RIOS DE MINAS (MG)";"MG";"ENTRE RIOS DE MINAS";315;28;65;408
2018;"ERVALIA (MG)";"MG";"ERVALIA";388;28;75;491
2018;"ESMERALDAS (MG)";"MG";"ESMERALDAS";566;62;326;954
2018;"ESPERA FELIZ (MG)";"MG";"ESPERA FELIZ";429;44;67;540
2018;"ESPINOSA (MG)";"MG";"ESPINOSA";405;49;135;589
2018;"ESPIRITO SANTO DO DOURADO (MG)";"MG";"ESPIRITO SANTO DO DOURADO";121;9;12;142
2018;"ESTIVA (MG)";"MG";"ESTIVA";301;24;28;353
2018;"ESTRELA DALVA (MG)";"MG";"ESTRELA DALVA";33;5;4;42
2018;"ESTRELA DO INDAIA (MG)";"MG";"ESTRELA DO INDAIA";54;9;8;71
2018;"ESTRELA DO SUL (MG)";"MG";"ESTRELA DO SUL";119;24;22;165
2018;"EUGENOPOLIS (MG)";"MG";"EUGENOPOLIS";157;41;41;239
2018;"EWBANK DA CAMARA (MG)";"MG";"EWBANK DA CAMARA";50;3;6;59
2018;"EXTREMA (MG)";"MG";"EXTREMA";582;151;194;927
2018;"FAMA (MG)";"MG";"FAMA";19;5;2;26
2018;"FARIA LEMOS (MG)";"MG";"FARIA LEMOS";27;7;3;37
2018;"FELICIO DOS SANTOS (MG)";"MG";"FELICIO DOS SANTOS";52;19;32;103
2018;"FELISBURGO (MG)";"MG";"FELISBURGO";28;11;18;57
2018;"FELIXLANDIA (MG)";"MG";"FELIXLANDIA";259;20;67;346
2018;"FERNANDES TOURINHO (MG)";"MG";"FERNANDES TOURINHO";25;10;13;48
2018;"FERROS (MG)";"MG";"FERROS";118;22;60;200
2018;"FERVEDOURO (MG)";"MG";"FERVEDOURO";177;12;19;208
2018;"FLORESTAL (MG)";"MG";"FLORESTAL";118;12;39;169
2018;"FORMIGA (MG)";"MG";"FORMIGA";1810;208;241;2259
2018;"FORMOSO (MG)";"MG";"FORMOSO";50;6;43;99
2018;"FORTALEZA DE MINAS (MG)";"MG";"FORTALEZA DE MINAS";74;21;18;113
2018;"FORTUNA DE MINAS (MG)";"MG";"FORTUNA DE MINAS";34;6;13;53
2018;"FRANCISCO BADARO (MG)";"MG";"FRANCISCO BADARO";60;11;39;110
2018;"FRANCISCO DUMONT (MG)";"MG";"FRANCISCO DUMONT";79;7;38;124
2018;"FRANCISCO SA (MG)";"MG";"FRANCISCO SA";302;27;144;473
2018;"FRANCISCOPOLIS (MG)";"MG";"FRANCISCOPOLIS";23;10;21;54
2018;"FREI GASPAR (MG)";"MG";"FREI GASPAR";33;10;15;58
2018;"FREI INOCENCIO (MG)";"MG";"FREI INOCENCIO";97;9;30;136
2018;"FREI LAGONEGRO (MG)";"MG";"FREI LAGONEGRO";13;2;16;31
2018;"FRONTEIRA (MG)";"MG";"FRONTEIRA";254;42;90;386
2018;"FRONTEIRA DOS VALES (MG)";"MG";"FRONTEIRA DOS VALES";15;5;6;26
2018;"FRUTA DE LEITE (MG)";"MG";"FRUTA DE LEITE";25;7;35;67
2018;"FRUTAL (MG)";"MG";"FRUTAL";1653;156;224;2033
2018;"FUNILANDIA (MG)";"MG";"FUNILANDIA";60;2;24;86
2018;"GALILEIA (MG)";"MG";"GALILEIA";71;5;13;89
2018;"GAMELEIRAS (MG)";"MG";"GAMELEIRAS";36;6;20;62
2018;"GLAUCILANDIA (MG)";"MG";"GLAUCILANDIA";7;1;8;16
2018;"GOIABEIRA (MG)";"MG";"GOIABEIRA";40;9;6;55
2018;"GOIANA (MG)";"MG";"GOIANA";36;7;9;52
2018;"GONCALVES (MG)";"MG";"GONCALVES";103;16;10;129
2018;"GONZAGA (MG)";"MG";"GONZAGA";48;7;13;68
2018;"GOUVEA (MG)";"MG";"GOUVEA";146;18;43;207
2018;"GOVERNADOR VALADARES (MG)";"MG";"GOVERNADOR VALADARES";3470;362;420;4252
2018;"GRAO MOGOL (MG)";"MG";"GRAO MOGOL";111;32;94;237
2018;"GRUPIARA (MG)";"MG";"GRUPIARA";14;5;7;26
2018;"GUANHAES (MG)";"MG";"GUANHAES";631;68;137;836
2018;"GUAPE (MG)";"MG";"GUAPE";282;27;80;389
2018;"GUARACIABA (MG)";"MG";"GUARACIABA";101;23;52;176
2018;"GUARACIAMA (MG)";"MG";"GUARACIAMA";63;5;17;85
2018;"GUARANESIA (MG)";"MG";"GUARANESIA";443;86;133;662
2018;"GUARANI (MG)";"MG";"GUARANI";89;23;17;129
2018;"GUARARA (MG)";"MG";"GUARARA";59;14;5;78
2018;"GUARDA MOR (MG)";"MG";"GUARDA MOR";144;25;38;207
2018;"GUAXUPE (MG)";"MG";"GUAXUPE";954;106;151;1211
2018;"GUIDOVAL (MG)";"MG";"GUIDOVAL";174;3;12;189
2018;"GUIMARANIA (MG)";"MG";"GUIMARANIA";187;20;57;264
2018;"GUIRICEMA (MG)";"MG";"GUIRICEMA";273;15;26;314
2018;"GURINHATA (MG)";"MG";"GURINHATA";116;16;39;171
2018;"HELIODORA (MG)";"MG";"HELIODORA";97;17;22;136
2018;"IAPU (MG)";"MG";"IAPU";173;17;31;221
2018;"IBERTIOGA (MG)";"MG";"IBERTIOGA";71;28;10;109
2018;"IBIA (MG)";"MG";"IBIA";481;60;122;663
2018;"IBIAI (MG)";"MG";"IBIAI";68;11;15;94
2018;"IBIRACATU (MG)";"MG";"IBIRACATU";19;4;22;45
2018;"IBIRACI (MG)";"MG";"IBIRACI";432;42;53;527
2018;"IBIRITE (MG)";"MG";"IBIRITE";1532;298;394;2224
2018;"IBITIURA DE MINAS (MG)";"MG";"IBITIURA DE MINAS";117;6;7;130
2018;"IBITURUNA (MG)";"MG";"IBITURUNA";35;5;5;45
2018;"ICARAI DE MINAS (MG)";"MG";"ICARAI DE MINAS";36;2;22;60
2018;"IGARAPE (MG)";"MG";"IGARAPE";926;71;173;1170
2018;"IGARATINGA (MG)";"MG";"IGARATINGA";542;11;24;577
2018;"IGUATAMA (MG)";"MG";"IGUATAMA";140;23;22;185
2018;"IJACI (MG)";"MG";"IJACI";222;7;28;257
2018;"ILICINEA (MG)";"MG";"ILICINEA";277;19;48;344
2018;"IMBE DE MINAS (MG)";"MG";"IMBE DE MINAS";52;11;22;85
2018;"INCONFIDENTES (MG)";"MG";"INCONFIDENTES";96;27;34;157
2018;"INDAIABIRA (MG)";"MG";"INDAIABIRA";91;15;34;140
2018;"INDIANOPOLIS (MG)";"MG";"INDIANOPOLIS";116;49;21;186
2018;"INGAI (MG)";"MG";"INGAI";20;18;16;54
2018;"INHAPIM (MG)";"MG";"INHAPIM";468;34;89;591
2018;"INHAUMA (MG)";"MG";"INHAUMA";125;7;24;156
2018;"INIMUTABA (MG)";"MG";"INIMUTABA";48;7;14;69
2018;"IPABA (MG)";"MG";"IPABA";99;19;31;149
2018;"IPANEMA (MG)";"MG";"IPANEMA";281;32;54;367
2018;"IPATINGA (MG)";"MG";"IPATINGA";3329;700;753;4782
2018;"IPIACU (MG)";"MG";"IPIACU";77;3;13;93
2018;"IPUIUNA (MG)";"MG";"IPUIUNA";451;47;43;541
2018;"IRAI DE MINAS (MG)";"MG";"IRAI DE MINAS";261;24;38;323
2018;"ITABIRA (MG)";"MG";"ITABIRA";1840;346;538;2724
2018;"ITABIRINHA (MG)";"MG";"ITABIRINHA";180;8;39;227
2018;"ITABIRITO (MG)";"MG";"ITABIRITO";1033;258;437;1728
2018;"ITACAMBIRA (MG)";"MG";"ITACAMBIRA";19;3;11;33
2018;"ITACARAMBI (MG)";"MG";"ITACARAMBI";153;13;62;228
2018;"ITAGUARA (MG)";"MG";"ITAGUARA";485;24;87;596
2018;"ITAIPE (MG)";"MG";"ITAIPE";90;22;29;141
2018;"ITAJUBA (MG)";"MG";"ITAJUBA";917;120;130;1167
2018;"ITAMARANDIBA (MG)";"MG";"ITAMARANDIBA";783;75;178;1036
2018;"ITAMARATI DE MINAS (MG)";"MG";"ITAMARATI DE MINAS";107;15;12;134
2018;"ITAMBACURI (MG)";"MG";"ITAMBACURI";214;39;63;316
2018;"ITAMBE DO MATO DENTRO (MG)";"MG";"ITAMBE DO MATO DENTRO";26;6;8;40
2018;"ITAMOGI (MG)";"MG";"ITAMOGI";337;27;49;413
2018;"ITAMONTE (MG)";"MG";"ITAMONTE";340;29;35;404
2018;"ITANHANDU (MG)";"MG";"ITANHANDU";507;40;31;578
2018;"ITANHOMI (MG)";"MG";"ITANHOMI";137;17;31;185
2018;"ITAOBIM (MG)";"MG";"ITAOBIM";234;39;46;319
2018;"ITAPAGIPE (MG)";"MG";"ITAPAGIPE";287;25;56;368
2018;"ITAPECERICA (MG)";"MG";"ITAPECERICA";402;65;63;530
2018;"ITAPEVA (MG)";"MG";"ITAPEVA";263;38;24;325
2018;"ITATIAIUCU (MG)";"MG";"ITATIAIUCU";369;25;48;442
2018;"ITAU DE MINAS (MG)";"MG";"ITAU DE MINAS";313;40;52;405
2018;"ITAUNA (MG)";"MG";"ITAUNA";1652;259;280;2191
2018;"ITAVERAVA (MG)";"MG";"ITAVERAVA";59;11;25;95
2018;"ITINGA (MG)";"MG";"ITINGA";78;28;46;152
2018;"ITUETA (MG)";"MG";"ITUETA";82;10;23;115
2018;"ITUIUTABA (MG)";"MG";"ITUIUTABA";1510;294;374;2178
2018;"ITUMIRIM (MG)";"MG";"ITUMIRIM";72;31;10;113
2018;"ITURAMA (MG)";"MG";"ITURAMA";951;104;344;1399
2018;"ITUTINGA (MG)";"MG";"ITUTINGA";70;27;7;104
2018;"JABOTICATUBAS (MG)";"MG";"JABOTICATUBAS";329;24;73;426
2018;"JACINTO (MG)";"MG";"JACINTO";44;11;42;97
2018;"JACUI (MG)";"MG";"JACUI";191;20;41;252
2018;"JACUTINGA (MG)";"MG";"JACUTINGA";467;101;93;661
2018;"JAGUARACU (MG)";"MG";"JAGUARACU";57;2;8;67
2018;"JAIBA (MG)";"MG";"JAIBA";478;26;217;721
2018;"JAMPRUCA (MG)";"MG";"JAMPRUCA";23;7;30;60
2018;"JANAUBA (MG)";"MG";"JANAUBA";914;45;187;1146
2018;"JANUARIA (MG)";"MG";"JANUARIA";501;36;179;716
2018;"JAPARAIBA (MG)";"MG";"JAPARAIBA";98;13;22;133
2018;"JAPONVAR (MG)";"MG";"JAPONVAR";60;14;22;96
2018;"JECEABA (MG)";"MG";"JECEABA";127;36;16;179
2018;"JENIPAPO DE MINAS (MG)";"MG";"JENIPAPO DE MINAS";39;13;34;86
2018;"JEQUERI (MG)";"MG";"JEQUERI";158;13;62;233
2018;"JEQUITAI (MG)";"MG";"JEQUITAI";73;3;38;114
2018;"JEQUITIBA (MG)";"MG";"JEQUITIBA";110;16;46;172
2018;"JEQUITINHONHA (MG)";"MG";"JEQUITINHONHA";118;59;49;226
2018;"JESUANIA (MG)";"MG";"JESUANIA";82;24;14;120
2018;"JOAIMA (MG)";"MG";"JOAIMA";73;15;42;130
2018;"JOANESIA (MG)";"MG";"JOANESIA";22;9;17;48
2018;"JOAO MONLEVADE (MG)";"MG";"JOAO MONLEVADE";1420;148;271;1839
2018;"JOAO PINHEIRO (MG)";"MG";"JOAO PINHEIRO";1176;80;348;1604
2018;"JOAQUIM FELICIO (MG)";"MG";"JOAQUIM FELICIO";56;2;16;74
2018;"JORDANIA (MG)";"MG";"JORDANIA";43;18;27;88
2018;"JOSE GONCALVES DE MINAS (MG)";"MG";"JOSE GONCALVES DE MINAS";32;14;22;68
2018;"JOSE RAYDAN (MG)";"MG";"JOSE RAYDAN";40;2;19;61
2018;"JOSENOPOLIS (MG)";"MG";"JOSENOPOLIS";26;6;24;56
2018;"JUATUBA (MG)";"MG";"JUATUBA";339;55;261;655
2018;"JUIZ DE FORA (MG)";"MG";"JUIZ DE FORA";6376;884;1836;9096
2018;"JURAMENTO (MG)";"MG";"JURAMENTO";23;4;17;44
2018;"JURUAIA (MG)";"MG";"JURUAIA";130;23;37;190
2018;"JUVENILIA (MG)";"MG";"JUVENILIA";42;4;16;62
2018;"LADAINHA (MG)";"MG";"LADAINHA";71;24;54;149
2018;"LAGAMAR (MG)";"MG";"LAGAMAR";131;38;23;192
2018;"LAGOA DA PRATA (MG)";"MG";"LAGOA DA PRATA";1269;84;173;1526
2018;"LAGOA DOS PATOS (MG)";"MG";"LAGOA DOS PATOS";43;0;16;59
2018;"LAGOA DOURADA (MG)";"MG";"LAGOA DOURADA";459;47;165;671
2018;"LAGOA FORMOSA (MG)";"MG";"LAGOA FORMOSA";487;27;117;631
2018;"LAGOA GRANDE (MG)";"MG";"LAGOA GRANDE";152;11;77;240
2018;"LAGOA SANTA (MG)";"MG";"LAGOA SANTA";888;146;126;1160
2018;"LAJINHA (MG)";"MG";"LAJINHA";366;61;71;498
2018;"LAMBARI (MG)";"MG";"LAMBARI";443;74;39;556
2018;"LAMIM (MG)";"MG";"LAMIM";48;1;10;59
2018;"LARANJAL (MG)";"MG";"LARANJAL";123;8;9;140
2018;"LASSANCE (MG)";"MG";"LASSANCE";62;22;17;101
2018;"LAVRAS (MG)";"MG";"LAVRAS";1462;217;312;1991
2018;"LEANDRO FERREIRA (MG)";"MG";"LEANDRO FERREIRA";52;11;11;74
2018;"LEME DO PRADO (MG)";"MG";"LEME DO PRADO";35;8;21;64
2018;"LEOPOLDINA (MG)";"MG";"LEOPOLDINA";779;88;96;963
2018;"LIBERDADE (MG)";"MG";"LIBERDADE";151;22;15;188
2018;"LIMA DUARTE (MG)";"MG";"LIMA DUARTE";252;41;37;330
2018;"LIMEIRA DO OESTE (MG)";"MG";"LIMEIRA DO OESTE";193;35;74;302
2018;"LONTRA (MG)";"MG";"LONTRA";40;6;17;63
2018;"LUISBURGO (MG)";"MG";"LUISBURGO";62;11;27;100
2018;"LUISLANDIA (MG)";"MG";"LUISLANDIA";27;9;24;60
2018;"LUMINARIAS (MG)";"MG";"LUMINARIAS";146;10;45;201
2018;"LUZ (MG)";"MG";"LUZ";403;58;42;503
2018;"MACHACALIS (MG)";"MG";"MACHACALIS";41;4;17;62
2018;"MACHADO (MG)";"MG";"MACHADO";872;178;145;1195
2018;"MADRE DE DEUS DE MINAS (MG)";"MG";"MADRE DE DEUS DE MINAS";123;20;18;161
2018;"MALACACHETA (MG)";"MG";"MALACACHETA";130;19;72;221
2018;"MAMONAS (MG)";"MG";"MAMONAS";116;13;35;164
2018;"MANGA (MG)";"MG";"MANGA";169;17;64;250
2018;"MANHUACU (MG)";"MG";"MANHUACU";1897;184;230;2311
2018;"MANHUMIRIM (MG)";"MG";"MANHUMIRIM";408;60;56;524
2018;"MANTENA (MG)";"MG";"MANTENA";579;47;93;719
2018;"MAR DE ESPANHA (MG)";"MG";"MAR DE ESPANHA";285;29;27;341
2018;"MARAVILHAS (MG)";"MG";"MARAVILHAS";200;18;17;235
2018;"MARIA DA FE (MG)";"MG";"MARIA DA FE";283;24;41;348
2018;"MARIANA (MG)";"MG";"MARIANA";744;280;306;1330
2018;"MARILAC (MG)";"MG";"MARILAC";27;3;20;50
2018;"MARIO CAMPOS (MG)";"MG";"MARIO CAMPOS";285;28;25;338
2018;"MARIPA DE MINAS (MG)";"MG";"MARIPA DE MINAS";70;12;6;88
2018;"MARLIERIA (MG)";"MG";"MARLIERIA";46;7;14;67
2018;"MARMELOPOLIS (MG)";"MG";"MARMELOPOLIS";48;12;12;72
2018;"MARTINHO CAMPOS (MG)";"MG";"MARTINHO CAMPOS";440;33;81;554
2018;"MARTINS SOARES (MG)";"MG";"MARTINS SOARES";184;10;27;221
2018;"MATA VERDE (MG)";"MG";"MATA VERDE";77;58;12;147
2018;"MATERLANDIA (MG)";"MG";"MATERLANDIA";20;6;5;31
2018;"MATEUS LEME (MG)";"MG";"MATEUS LEME";627;106;123;856
2018;"MATHIAS LOBATO (MG)";"MG";"MATHIAS LOBATO";35;3;9;47
2018;"MATIAS BARBOSA (MG)";"MG";"MATIAS BARBOSA";796;47;51;894
2018;"MATIAS CARDOSO (MG)";"MG";"MATIAS CARDOSO";52;7;35;94
2018;"MATIPO (MG)";"MG";"MATIPO";352;36;65;453
2018;"MATO VERDE (MG)";"MG";"MATO VERDE";199;9;52;260
2018;"MATOZINHOS (MG)";"MG";"MATOZINHOS";464;119;144;727
2018;"MATUTINA (MG)";"MG";"MATUTINA";87;25;11;123
2018;"MEDEIROS (MG)";"MG";"MEDEIROS";96;25;10;131
2018;"MEDINA (MG)";"MG";"MEDINA";182;68;48;298
2018;"MENDES PIMENTEL (MG)";"MG";"MENDES PIMENTEL";49;10;18;77
2018;"MERCES (MG)";"MG";"MERCES";206;35;25;266
2018;"MESQUITA (MG)";"MG";"MESQUITA";34;20;17;71
2018;"MINAS NOVAS (MG)";"MG";"MINAS NOVAS";193;37;131;361
2018;"MINDURI (MG)";"MG";"MINDURI";94;12;8;114
2018;"MIRABELA (MG)";"MG";"MIRABELA";186;29;46;261
2018;"MIRADOURO (MG)";"MG";"MIRADOURO";116;16;35;167
2018;"MIRAI (MG)";"MG";"MIRAI";197;14;26;237
2018;"MIRAVANIA (MG)";"MG";"MIRAVANIA";21;4;19;44
2018;"MOEDA (MG)";"MG";"MOEDA";120;19;71;210
2018;"MOEMA (MG)";"MG";"MOEMA";224;21;126;371
2018;"MONJOLOS (MG)";"MG";"MONJOLOS";11;2;10;23
2018;"MONSENHOR PAULO (MG)";"MG";"MONSENHOR PAULO";220;32;17;269
2018;"MONTALVANIA (MG)";"MG";"MONTALVANIA";187;22;115;324
2018;"MONTE ALEGRE DE MINAS (MG)";"MG";"MONTE ALEGRE DE MINAS";689;88;81;858
2018;"MONTE AZUL (MG)";"MG";"MONTE AZUL";199;16;90;305
2018;"MONTE BELO (MG)";"MG";"MONTE BELO";332;43;62;437
2018;"MONTE CARMELO (MG)";"MG";"MONTE CARMELO";1557;153;203;1913
2018;"MONTE FORMOSO (MG)";"MG";"MONTE FORMOSO";33;31;59;123
2018;"MONTE SANTO DE MINAS (MG)";"MG";"MONTE SANTO DE MINAS";592;72;130;794
2018;"MONTE SIAO (MG)";"MG";"MONTE SIAO";347;61;48;456
2018;"MONTES CLAROS (MG)";"MG";"MONTES CLAROS";4788;440;1245;6473
2018;"MONTEZUMA (MG)";"MG";"MONTEZUMA";68;11;47;126
2018;"MORADA NOVA DE MINAS (MG)";"MG";"MORADA NOVA DE MINAS";144;26;30;200
2018;"MORRO DA GARCA (MG)";"MG";"MORRO DA GARCA";46;10;21;77
2018;"MORRO DO PILAR (MG)";"MG";"MORRO DO PILAR";39;10;4;53
2018;"MUNHOZ (MG)";"MG";"MUNHOZ";191;21;12;224
2018;"MURIAE (MG)";"MG";"MURIAE";1548;153;225;1926
2018;"MUTUM (MG)";"MG";"MUTUM";287;37;105;429
2018;"MUZAMBINHO (MG)";"MG";"MUZAMBINHO";539;101;60;700
2018;"NACIP RAYDAN (MG)";"MG";"NACIP RAYDAN";12;2;7;21
2018;"NANUQUE (MG)";"MG";"NANUQUE";582;75;234;891
2018;"NAQUE (MG)";"MG";"NAQUE";49;5;21;75
2018;"NATALANDIA (MG)";"MG";"NATALANDIA";34;1;23;58
2018;"NATERCIA (MG)";"MG";"NATERCIA";107;14;25;146
2018;"NAZARENO (MG)";"MG";"NAZARENO";250;25;46;321
2018;"NEPOMUCENO (MG)";"MG";"NEPOMUCENO";547;61;133;741
2018;"NINHEIRA (MG)";"MG";"NINHEIRA";70;14;49;133
2018;"NOVA BELEM (MG)";"MG";"NOVA BELEM";43;2;17;62
2018;"NOVA ERA (MG)";"MG";"NOVA ERA";268;62;81;411
2018;"NOVA LIMA (MG)";"MG";"NOVA LIMA";1833;407;279;2519
2018;"NOVA MODICA (MG)";"MG";"NOVA MODICA";22;4;14;40
2018;"NOVA PONTE (MG)";"MG";"NOVA PONTE";302;73;85;460
2018;"NOVA PORTEIRINHA (MG)";"MG";"NOVA PORTEIRINHA";46;4;21;71
2018;"NOVA RESENDE (MG)";"MG";"NOVA RESENDE";486;28;99;613
2018;"NOVA SERRANA (MG)";"MG";"NOVA SERRANA";644;79;135;858
2018;"NOVA UNIAO (MG)";"MG";"NOVA UNIAO";210;10;29;249
2018;"NOVO CRUZEIRO (MG)";"MG";"NOVO CRUZEIRO";250;55;210;515
2018;"NOVO ORIENTE DE MINAS (MG)";"MG";"NOVO ORIENTE DE MINAS";45;40;29;114
2018;"NOVORIZONTE (MG)";"MG";"NOVORIZONTE";88;2;27;117
2018;"OLARIA (MG)";"MG";"OLARIA";24;6;12;42
2018;"OLHOS D AGUA (MG)";"MG";"OLHOS D AGUA";122;18;63;203
2018;"OLIMPIO NORONHA (MG)";"MG";"OLIMPIO NORONHA";31;12;10;53
2018;"OLIVEIRA (MG)";"MG";"OLIVEIRA";852;119;139;1110
2018;"OLIVEIRA FORTES (MG)";"MG";"OLIVEIRA FORTES";25;6;5;36
2018;"ONCA DE PITANGUI (MG)";"MG";"ONCA DE PITANGUI";27;12;16;55
2018;"ORATORIOS (MG)";"MG";"ORATORIOS";117;6;26;149
2018;"ORIZANIA (MG)";"MG";"ORIZANIA";103;16;21;140
2018;"OURO BRANCO (MG)";"MG";"OURO BRANCO";506;123;191;820
2018;"OURO FINO (MG)";"MG";"OURO FINO";741;110;135;986
2018;"OURO PRETO (MG)";"MG";"OURO PRETO";1155;277;295;1727
2018;"OURO VERDE DE MINAS (MG)";"MG";"OURO VERDE DE MINAS";31;5;14;50
2018;"PADRE CARVALHO (MG)";"MG";"PADRE CARVALHO";31;7;33;71
2018;"PADRE PARAISO (MG)";"MG";"PADRE PARAISO";159;93;89;341
2018;"PAI PEDRO (MG)";"MG";"PAI PEDRO";20;3;35;58
2018;"PAINEIRAS (MG)";"MG";"PAINEIRAS";89;19;14;122
2018;"PAINS (MG)";"MG";"PAINS";286;21;34;341
2018;"PAIVA (MG)";"MG";"PAIVA";9;5;2;16
2018;"PALMA (MG)";"MG";"PALMA";125;7;10;142
2018;"PALMOPOLIS (MG)";"MG";"PALMOPOLIS";27;12;22;61
2018;"PAPAGAIOS (MG)";"MG";"PAPAGAIOS";622;22;83;727
2018;"PARA DE MINAS (MG)";"MG";"PARA DE MINAS";2453;200;241;2894
2018;"PARACATU (MG)";"MG";"PARACATU";1722;216;506;2444
2018;"PARAGUACU (MG)";"MG";"PARAGUACU";370;62;49;481
2018;"PARAISOPOLIS (MG)";"MG";"PARAISOPOLIS";411;61;48;520
2018;"PARAOPEBA (MG)";"MG";"PARAOPEBA";506;35;57;598
2018;"PASSA QUATRO (MG)";"MG";"PASSA QUATRO";431;43;38;512
2018;"PASSA TEMPO (MG)";"MG";"PASSA TEMPO";234;34;32;300
2018;"PASSA VINTE (MG)";"MG";"PASSA VINTE";343;39;21;403
2018;"PASSABEM (MG)";"MG";"PASSABEM";14;3;5;22
2018;"PASSOS (MG)";"MG";"PASSOS";2267;227;493;2987
2018;"PATIS (MG)";"MG";"PATIS";21;7;19;47
2018;"PATOS DE MINAS (MG)";"MG";"PATOS DE MINAS";3574;214;442;4230
2018;"PATROCINIO (MG)";"MG";"PATROCINIO";2066;210;603;2879
2018;"PATROCINIO DO MURIAE (MG)";"MG";"PATROCINIO DO MURIAE";119;15;10;144
2018;"PAULA CANDIDO (MG)";"MG";"PAULA CANDIDO";96;13;20;129
2018;"PAULISTAS (MG)";"MG";"PAULISTAS";68;6;9;83
2018;"PAVAO (MG)";"MG";"PAVAO";55;23;15;93
2018;"PECANHA (MG)";"MG";"PECANHA";155;17;70;242
2018;"PEDRA AZUL (MG)";"MG";"PEDRA AZUL";190;27;60;277
2018;"PEDRA BONITA (MG)";"MG";"PEDRA BONITA";104;12;25;141
2018;"PEDRA DO ANTA (MG)";"MG";"PEDRA DO ANTA";38;3;22;63
2018;"PEDRA DO INDAIA (MG)";"MG";"PEDRA DO INDAIA";112;17;11;140
2018;"PEDRA DOURADA (MG)";"MG";"PEDRA DOURADA";17;8;21;46
2018;"PEDRALVA (MG)";"MG";"PEDRALVA";211;35;31;277
2018;"PEDRAS DE MARIA DA CRUZ (MG)";"MG";"PEDRAS DE MARIA DA CRUZ";42;7;39;88
2018;"PEDRINOPOLIS (MG)";"MG";"PEDRINOPOLIS";55;14;11;80
2018;"PEDRO LEOPOLDO (MG)";"MG";"PEDRO LEOPOLDO";1294;209;172;1675
2018;"PEDRO TEIXEIRA (MG)";"MG";"PEDRO TEIXEIRA";19;8;6;33
2018;"PEQUERI (MG)";"MG";"PEQUERI";88;7;6;101
2018;"PEQUI (MG)";"MG";"PEQUI";71;23;8;102
2018;"PERDIGAO (MG)";"MG";"PERDIGAO";175;13;15;203
2018;"PERDIZES (MG)";"MG";"PERDIZES";368;72;73;513
2018;"PERDOES (MG)";"MG";"PERDOES";575;44;99;718
2018;"PERIQUITO (MG)";"MG";"PERIQUITO";58;4;30;92
2018;"PESCADOR (MG)";"MG";"PESCADOR";20;7;12;39
2018;"PIAU (MG)";"MG";"PIAU";66;12;10;88
2018;"PIEDADE DE CARATINGA (MG)";"MG";"PIEDADE DE CARATINGA";220;12;29;261
2018;"PIEDADE DE PONTE NOVA (MG)";"MG";"PIEDADE DE PONTE NOVA";41;6;21;68
2018;"PIEDADE DO RIO GRANDE (MG)";"MG";"PIEDADE DO RIO GRANDE";66;13;8;87
2018;"PIEDADE DOS GERAIS (MG)";"MG";"PIEDADE DOS GERAIS";113;9;17;139
2018;"PIMENTA (MG)";"MG";"PIMENTA";267;17;31;315
2018;"PINGO D AGUA (MG)";"MG";"PINGO D AGUA";30;3;10;43
2018;"PINTOPOLIS (MG)";"MG";"PINTOPOLIS";26;5;20;51
2018;"PIRACEMA (MG)";"MG";"PIRACEMA";140;12;24;176
2018;"PIRAJUBA (MG)";"MG";"PIRAJUBA";206;27;17;250
2018;"PIRANGA (MG)";"MG";"PIRANGA";172;35;94;301
2018;"PIRANGUCU (MG)";"MG";"PIRANGUCU";80;26;32;138
2018;"PIRANGUINHO (MG)";"MG";"PIRANGUINHO";241;28;34;303
2018;"PIRAPETINGA (MG)";"MG";"PIRAPETINGA";597;33;60;690
2018;"PIRAPORA (MG)";"MG";"PIRAPORA";629;68;210;907
2018;"PIRAUBA (MG)";"MG";"PIRAUBA";142;20;20;182
2018;"PITANGUI (MG)";"MG";"PITANGUI";597;105;112;814
2018;"PIUMHI (MG)";"MG";"PIUMHI";879;86;101;1066
2018;"PLANURA (MG)";"MG";"PLANURA";191;21;84;296
2018;"POCO FUNDO (MG)";"MG";"POCO FUNDO";365;66;37;468
2018;"POCOS DE CALDAS (MG)";"MG";"POCOS DE CALDAS";2913;671;490;4074
2018;"POCRANE (MG)";"MG";"POCRANE";101;10;21;132
2018;"POMPEU (MG)";"MG";"POMPEU";512;35;170;717
2018;"PONTE NOVA (MG)";"MG";"PONTE NOVA";1223;103;175;1501
2018;"PONTO CHIQUE (MG)";"MG";"PONTO CHIQUE";12;1;9;22
2018;"PONTO DOS VOLANTES (MG)";"MG";"PONTO DOS VOLANTES";55;18;45;118
2018;"PORTEIRINHA (MG)";"MG";"PORTEIRINHA";501;38;279;818
2018;"PORTO FIRME (MG)";"MG";"PORTO FIRME";80;9;30;119
2018;"POTE (MG)";"MG";"POTE";100;24;43;167
2018;"POUSO ALEGRE (MG)";"MG";"POUSO ALEGRE";2936;357;530;3823
2018;"POUSO ALTO (MG)";"MG";"POUSO ALTO";125;22;16;163
2018;"PRADOS (MG)";"MG";"PRADOS";147;23;21;191
2018;"PRATA (MG)";"MG";"PRATA";516;152;127;795
2018;"PRATAPOLIS (MG)";"MG";"PRATAPOLIS";260;23;36;319
2018;"PRATINHA (MG)";"MG";"PRATINHA";90;15;11;116
2018;"PRESIDENTE BERNARDES (MG)";"MG";"PRESIDENTE BERNARDES";31;9;13;53
2018;"PRESIDENTE JUSCELINO (MG)";"MG";"PRESIDENTE JUSCELINO";65;4;22;91
2018;"PRESIDENTE KUBITSCHEK (MG)";"MG";"PRESIDENTE KUBITSCHEK";31;13;10;54
2018;"PRESIDENTE OLEGARIO (MG)";"MG";"PRESIDENTE OLEGARIO";295;32;137;464
2018;"PRUDENTE DE MORAIS (MG)";"MG";"PRUDENTE DE MORAIS";135;21;16;172
2018;"QUARTEL GERAL (MG)";"MG";"QUARTEL GERAL";52;6;10;68
2018;"QUELUZITA (MG)";"MG";"QUELUZITA";21;9;7;37
2018;"RAPOSOS (MG)";"MG";"RAPOSOS";91;58;32;181
2018;"RAUL SOARES (MG)";"MG";"RAUL SOARES";303;51;86;440
2018;"RECREIO (MG)";"MG";"RECREIO";201;33;29;263
2018;"REDUTO (MG)";"MG";"REDUTO";106;8;16;130
2018;"RESENDE COSTA (MG)";"MG";"RESENDE COSTA";260;24;38;322
2018;"RESPLENDOR (MG)";"MG";"RESPLENDOR";202;44;50;296
2018;"RESSAQUINHA (MG)";"MG";"RESSAQUINHA";199;14;31;244
2018;"RIACHINHO (MG)";"MG";"RIACHINHO";106;6;30;142
2018;"RIACHO DOS MACHADOS (MG)";"MG";"RIACHO DOS MACHADOS";65;7;45;117
2018;"RIBEIRAO DAS NEVES (MG)";"MG";"RIBEIRAO DAS NEVES";2845;682;705;4232
2018;"RIBEIRAO VERMELHO (MG)";"MG";"RIBEIRAO VERMELHO";45;12;5;62
2018;"RIO ACIMA (MG)";"MG";"RIO ACIMA";143;33;18;194
2018;"RIO CASCA (MG)";"MG";"RIO CASCA";224;13;47;284
2018;"RIO DO PRADO (MG)";"MG";"RIO DO PRADO";16;8;17;41
2018;"RIO DOCE (MG)";"MG";"RIO DOCE";25;10;10;45
2018;"RIO ESPERA (MG)";"MG";"RIO ESPERA";49;2;18;69
2018;"RIO MANSO (MG)";"MG";"RIO MANSO";199;7;16;222
2018;"RIO NOVO (MG)";"MG";"RIO NOVO";202;29;44;275
2018;"RIO PARANAIBA (MG)";"MG";"RIO PARANAIBA";350;29;162;541
2018;"RIO PARDO DE MINAS (MG)";"MG";"RIO PARDO DE MINAS";257;56;220;533
2018;"RIO PIRACICABA (MG)";"MG";"RIO PIRACICABA";200;26;34;260
2018;"RIO POMBA (MG)";"MG";"RIO POMBA";298;40;50;388
2018;"RIO PRETO (MG)";"MG";"RIO PRETO";555;44;61;660
2018;"RIO VERMELHO (MG)";"MG";"RIO VERMELHO";91;48;53;192
2018;"RITAPOLIS (MG)";"MG";"RITAPOLIS";42;15;10;67
2018;"ROCHEDO DE MINAS (MG)";"MG";"ROCHEDO DE MINAS";30;6;4;40
2018;"RODEIRO (MG)";"MG";"RODEIRO";314;10;30;354
2018;"ROMARIA (MG)";"MG";"ROMARIA";55;25;14;94
2018;"ROSARIO DA LIMEIRA (MG)";"MG";"ROSARIO DA LIMEIRA";90;7;43;140
2018;"RUBELITA (MG)";"MG";"RUBELITA";25;9;15;49
2018;"RUBIM (MG)";"MG";"RUBIM";27;5;36;68
2018;"SABARA (MG)";"MG";"SABARA";842;231;409;1482
2018;"SABINOPOLIS (MG)";"MG";"SABINOPOLIS";173;47;84;304
2018;"SACRAMENTO (MG)";"MG";"SACRAMENTO";597;102;103;802
2018;"SALINAS (MG)";"MG";"SALINAS";515;55;177;747
2018;"SALTO DA DIVISA (MG)";"MG";"SALTO DA DIVISA";15;11;15;41
2018;"SANTA BARBARA (MG)";"MG";"SANTA BARBARA";452;98;113;663
2018;"SANTA BARBARA DO LESTE (MG)";"MG";"SANTA BARBARA DO LESTE";212;11;14;237
2018;"SANTA BARBARA DO MONTE VERDE (MG)";"MG";"SANTA BARBARA DO MONTE VERDE";619;53;136;808
2018;"SANTA BARBARA DO TUGURIO (MG)";"MG";"SANTA BARBARA DO TUGURIO";78;32;47;157
2018;"SANTA CRUZ DE MINAS (MG)";"MG";"SANTA CRUZ DE MINAS";92;15;9;116
2018;"SANTA CRUZ DE SALINAS (MG)";"MG";"SANTA CRUZ DE SALINAS";31;8;33;72
2018;"SANTA CRUZ DO ESCALVADO (MG)";"MG";"SANTA CRUZ DO ESCALVADO";48;15;23;86
2018;"SANTA EFIGENIA DE MINAS (MG)";"MG";"SANTA EFIGENIA DE MINAS";34;9;10;53
2018;"SANTA FE DE MINAS (MG)";"MG";"SANTA FE DE MINAS";9;2;9;20
2018;"SANTA HELENA DE MINAS (MG)";"MG";"SANTA HELENA DE MINAS";15;6;14;35
2018;"SANTA JULIANA (MG)";"MG";"SANTA JULIANA";548;55;91;694
2018;"SANTA LUZIA (MG)";"MG";"SANTA LUZIA";2045;398;746;3189
2018;"SANTA MARGARIDA (MG)";"MG";"SANTA MARGARIDA";299;33;60;392
2018;"SANTA MARIA DE ITABIRA (MG)";"MG";"SANTA MARIA DE ITABIRA";144;26;62;232
2018;"SANTA MARIA DO SALTO (MG)";"MG";"SANTA MARIA DO SALTO";11;7;13;31
2018;"SANTA MARIA DO SUACUI (MG)";"MG";"SANTA MARIA DO SUACUI";109;9;63;181
2018;"SANTA RITA DE CALDAS (MG)";"MG";"SANTA RITA DE CALDAS";353;33;25;411
2018;"SANTA RITA DE IBITIPOCA (MG)";"MG";"SANTA RITA DE IBITIPOCA";63;19;7;89
2018;"SANTA RITA DE JACUTINGA (MG)";"MG";"SANTA RITA DE JACUTINGA";120;10;9;139
2018;"SANTA RITA DE MINAS (MG)";"MG";"SANTA RITA DE MINAS";135;16;27;178
2018;"SANTA RITA DO ITUETO (MG)";"MG";"SANTA RITA DO ITUETO";116;13;23;152
2018;"SANTA RITA DO SAPUCAI (MG)";"MG";"SANTA RITA DO SAPUCAI";483;115;104;702
2018;"SANTA ROSA DA SERRA (MG)";"MG";"SANTA ROSA DA SERRA";82;12;21;115
2018;"SANTA VITORIA (MG)";"MG";"SANTA VITORIA";479;76;74;629
2018;"SANTANA DA VARGEM (MG)";"MG";"SANTANA DA VARGEM";125;13;32;170
2018;"SANTANA DE CATAGUASES (MG)";"MG";"SANTANA DE CATAGUASES";38;10;8;56
2018;"SANTANA DE PIRAPAMA (MG)";"MG";"SANTANA DE PIRAPAMA";94;8;35;137
2018;"SANTANA DO DESERTO (MG)";"MG";"SANTANA DO DESERTO";80;21;16;117
2018;"SANTANA DO GARAMBEU (MG)";"MG";"SANTANA DO GARAMBEU";22;11;9;42
2018;"SANTANA DO JACARE (MG)";"MG";"SANTANA DO JACARE";66;9;22;97
2018;"SANTANA DO MANHUACU (MG)";"MG";"SANTANA DO MANHUACU";297;11;26;334
2018;"SANTANA DO PARAISO (MG)";"MG";"SANTANA DO PARAISO";215;26;44;285
2018;"SANTANA DO RIACHO (MG)";"MG";"SANTANA DO RIACHO";62;15;9;86
2018;"SANTANA DOS MONTES (MG)";"MG";"SANTANA DOS MONTES";48;7;11;66
2018;"SANTO ANTONIO DO AMPARO (MG)";"MG";"SANTO ANTONIO DO AMPARO";361;57;112;530
2018;"SANTO ANTONIO DO AVENTUREIRO (MG)";"MG";"SANTO ANTONIO DO AVENTUREIRO";83;3;11;97
2018;"SANTO ANTONIO DO GRAMA (MG)";"MG";"SANTO ANTONIO DO GRAMA";61;11;12;84
2018;"SANTO ANTONIO DO ITAMBE (MG)";"MG";"SANTO ANTONIO DO ITAMBE";20;8;18;46
2018;"SANTO ANTONIO DO JACINTO (MG)";"MG";"SANTO ANTONIO DO JACINTO";52;6;46;104
2018;"SANTO ANTONIO DO MONTE (MG)";"MG";"SANTO ANTONIO DO MONTE";571;68;116;755
2018;"SANTO ANTONIO DO RETIRO (MG)";"MG";"SANTO ANTONIO DO RETIRO";75;5;46;126
2018;"SANTO ANTONIO DO RIO ABAIXO (MG)";"MG";"SANTO ANTONIO DO RIO ABAIXO";15;7;12;34
2018;"SANTO HIPOLITO (MG)";"MG";"SANTO HIPOLITO";28;8;7;43
2018;"SANTOS DUMONT (MG)";"MG";"SANTOS DUMONT";466;114;158;738
2018;"SAO BENTO ABADE (MG)";"MG";"SAO BENTO ABADE";48;25;36;109
2018;"SAO BRAS DO SUACUI (MG)";"MG";"SAO BRAS DO SUACUI";58;7;12;77
2018;"SAO DOMINGOS DAS DORES (MG)";"MG";"SAO DOMINGOS DAS DORES";147;14;19;180
2018;"SAO DOMINGOS DO PRATA (MG)";"MG";"SAO DOMINGOS DO PRATA";343;23;91;457
2018;"SAO FELIX DE MINAS (MG)";"MG";"SAO FELIX DE MINAS";28;3;16;47
2018;"SAO FRANCISCO (MG)";"MG";"SAO FRANCISCO";344;38;207;589
2018;"SAO FRANCISCO DE PAULA (MG)";"MG";"SAO FRANCISCO DE PAULA";94;29;26;149
2018;"SAO FRANCISCO DE SALES (MG)";"MG";"SAO FRANCISCO DE SALES";90;13;30;133
2018;"SAO FRANCISCO DO GLORIA (MG)";"MG";"SAO FRANCISCO DO GLORIA";74;15;13;102
2018;"SAO GERALDO (MG)";"MG";"SAO GERALDO";204;12;23;239
2018;"SAO GERALDO DA PIEDADE (MG)";"MG";"SAO GERALDO DA PIEDADE";28;7;13;48
2018;"SAO GERALDO DO BAIXIO (MG)";"MG";"SAO GERALDO DO BAIXIO";21;6;10;37
2018;"SAO GONCALO DO ABAETE (MG)";"MG";"SAO GONCALO DO ABAETE";116;25;32;173
2018;"SAO GONCALO DO PARA (MG)";"MG";"SAO GONCALO DO PARA";282;27;38;347
2018;"SAO GONCALO DO RIO ABAIXO (MG)";"MG";"SAO GONCALO DO RIO ABAIXO";223;61;60;344
2018;"SAO GONCALO DO RIO PRETO (MG)";"MG";"SAO GONCALO DO RIO PRETO";32;10;9;51
2018;"SAO GONCALO DO SAPUCAI (MG)";"MG";"SAO GONCALO DO SAPUCAI";512;54;94;660
2018;"SAO GOTARDO (MG)";"MG";"SAO GOTARDO";1097;123;309;1529
2018;"SAO JOAO BATISTA DO GLORIA (MG)";"MG";"SAO JOAO BATISTA DO GLORIA";165;13;20;198
2018;"SAO JOAO DA LAGOA (MG)";"MG";"SAO JOAO DA LAGOA";45;20;16;81
2018;"SAO JOAO DA MATA (MG)";"MG";"SAO JOAO DA MATA";69;26;5;100
2018;"SAO JOAO DA PONTE (MG)";"MG";"SAO JOAO DA PONTE";92;14;78;184
2018;"SAO JOAO DAS MISSOES (MG)";"MG";"SAO JOAO DAS MISSOES";43;7;29;79
2018;"SAO JOAO DEL REI (MG)";"MG";"SAO JOAO DEL REI";1285;256;240;1781
2018;"SAO JOAO DO MANHUACU (MG)";"MG";"SAO JOAO DO MANHUACU";201;13;52;266
2018;"SAO JOAO DO MANTENINHA (MG)";"MG";"SAO JOAO DO MANTENINHA";92;15;10;117
2018;"SAO JOAO DO ORIENTE (MG)";"MG";"SAO JOAO DO ORIENTE";124;8;11;143
2018;"SAO JOAO DO PACUI (MG)";"MG";"SAO JOAO DO PACUI";22;8;11;41
2018;"SAO JOAO DO PARAISO (MG)";"MG";"SAO JOAO DO PARAISO";243;58;126;427
2018;"SAO JOAO EVANGELISTA (MG)";"MG";"SAO JOAO EVANGELISTA";143;25;53;221
2018;"SAO JOAO NEPOMUCENO (MG)";"MG";"SAO JOAO NEPOMUCENO";307;52;28;387
2018;"SAO JOAQUIM DE BICAS (MG)";"MG";"SAO JOAQUIM DE BICAS";644;67;66;777
2018;"SAO JOSE DA BARRA (MG)";"MG";"SAO JOSE DA BARRA";130;17;38;185
2018;"SAO JOSE DA LAPA (MG)";"MG";"SAO JOSE DA LAPA";850;142;352;1344
2018;"SAO JOSE DA SAFIRA (MG)";"MG";"SAO JOSE DA SAFIRA";10;1;8;19
2018;"SAO JOSE DA VARGINHA (MG)";"MG";"SAO JOSE DA VARGINHA";67;0;20;87
2018;"SAO JOSE DO ALEGRE (MG)";"MG";"SAO JOSE DO ALEGRE";45;11;8;64
2018;"SAO JOSE DO DIVINO (MG)";"MG";"SAO JOSE DO DIVINO";22;7;17;46
2018;"SAO JOSE DO GOIABAL (MG)";"MG";"SAO JOSE DO GOIABAL";58;7;42;107
2018;"SAO JOSE DO JACURI (MG)";"MG";"SAO JOSE DO JACURI";47;6;7;60
2018;"SAO JOSE DO MANTIMENTO (MG)";"MG";"SAO JOSE DO MANTIMENTO";43;1;5;49
2018;"SAO LOURENCO (MG)";"MG";"SAO LOURENCO";617;82;67;766
2018;"SAO MIGUEL DO ANTA (MG)";"MG";"SAO MIGUEL DO ANTA";94;14;14;122
2018;"SAO PEDRO DA UNIAO (MG)";"MG";"SAO PEDRO DA UNIAO";134;19;19;172
2018;"SAO PEDRO DO SUACUI (MG)";"MG";"SAO PEDRO DO SUACUI";46;5;9;60
2018;"SAO PEDRO DOS FERROS (MG)";"MG";"SAO PEDRO DOS FERROS";107;11;44;162
2018;"SAO ROMAO (MG)";"MG";"SAO ROMAO";51;3;19;73
2018;"SAO ROQUE DE MINAS (MG)";"MG";"SAO ROQUE DE MINAS";232;21;31;284
2018;"SAO SEBASTIAO DA BELA VISTA (MG)";"MG";"SAO SEBASTIAO DA BELA VISTA";122;15;19;156
2018;"SAO SEBASTIAO DA VARGEM ALEGRE (MG)";"MG";"SAO SEBASTIAO DA VARGEM ALEGRE";45;7;11;63
2018;"SAO SEBASTIAO DO ANTA (MG)";"MG";"SAO SEBASTIAO DO ANTA";77;9;12;98
2018;"SAO SEBASTIAO DO MARANHAO (MG)";"MG";"SAO SEBASTIAO DO MARANHAO";31;15;30;76
2018;"SAO SEBASTIAO DO OESTE (MG)";"MG";"SAO SEBASTIAO DO OESTE";196;14;62;272
2018;"SAO SEBASTIAO DO PARAISO (MG)";"MG";"SAO SEBASTIAO DO PARAISO";1749;150;265;2164
2018;"SAO SEBASTIAO DO RIO PRETO (MG)";"MG";"SAO SEBASTIAO DO RIO PRETO";9;5;6;20
2018;"SAO SEBASTIAO DO RIO VERDE (MG)";"MG";"SAO SEBASTIAO DO RIO VERDE";21;5;10;36
2018;"SAO TIAGO (MG)";"MG";"SAO TIAGO";288;23;34;345
2018;"SAO TOMAS DE AQUINO (MG)";"MG";"SAO TOMAS DE AQUINO";113;27;18;158
2018;"SAO TOME DAS LETRAS (MG)";"MG";"SAO TOME DAS LETRAS";101;17;32;150
2018;"SAO VICENTE DE MINAS (MG)";"MG";"SAO VICENTE DE MINAS";134;26;9;169
2018;"SAPUCAI MIRIM (MG)";"MG";"SAPUCAI MIRIM";236;35;13;284
2018;"SARDOA (MG)";"MG";"SARDOA";73;12;16;101
2018;"SARZEDO (MG)";"MG";"SARZEDO";926;79;127;1132
2018;"SEM PEIXE (MG)";"MG";"SEM PEIXE";18;3;15;36
2018;"SENADOR AMARAL (MG)";"MG";"SENADOR AMARAL";144;8;18;170
2018;"SENADOR CORTES (MG)";"MG";"SENADOR CORTES";27;4;4;35
2018;"SENADOR FIRMINO (MG)";"MG";"SENADOR FIRMINO";132;14;38;184
2018;"SENADOR JOSE BENTO (MG)";"MG";"SENADOR JOSE BENTO";15;0;8;23
2018;"SENADOR MODESTINO GONCALVES (MG)";"MG";"SENADOR MODESTINO GONCALVES";35;5;15;55
2018;"SENHORA DE OLIVEIRA (MG)";"MG";"SENHORA DE OLIVEIRA";83;5;14;102
2018;"SENHORA DO PORTO (MG)";"MG";"SENHORA DO PORTO";28;9;19;56
2018;"SENHORA DOS REMEDIOS (MG)";"MG";"SENHORA DOS REMEDIOS";154;41;31;226
2018;"SERICITA (MG)";"MG";"SERICITA";116;3;9;128
2018;"SERITINGA (MG)";"MG";"SERITINGA";30;4;5;39
2018;"SERRA AZUL DE MINAS (MG)";"MG";"SERRA AZUL DE MINAS";22;8;13;43
2018;"SERRA DA SAUDADE (MG)";"MG";"SERRA DA SAUDADE";10;6;3;19
2018;"SERRA DO SALITRE (MG)";"MG";"SERRA DO SALITRE";317;23;117;457
2018;"SERRA DOS AIMORES (MG)";"MG";"SERRA DOS AIMORES";85;4;33;122
2018;"SERRANIA (MG)";"MG";"SERRANIA";137;24;28;189
2018;"SERRANOPOLIS DE MINAS (MG)";"MG";"SERRANOPOLIS DE MINAS";25;1;28;54
2018;"SERRANOS (MG)";"MG";"SERRANOS";27;9;5;41
2018;"SERRO (MG)";"MG";"SERRO";228;29;88;345
2018;"SETE LAGOAS (MG)";"MG";"SETE LAGOAS";3664;467;805;4936
2018;"SETUBINHA (MG)";"MG";"SETUBINHA";38;10;42;90
2018;"SILVEIRANIA (MG)";"MG";"SILVEIRANIA";26;4;8;38
2018;"SILVIANOPOLIS (MG)";"MG";"SILVIANOPOLIS";105;19;18;142
2018;"SIMAO PEREIRA (MG)";"MG";"SIMAO PEREIRA";74;18;8;100
2018;"SIMONESIA (MG)";"MG";"SIMONESIA";351;21;55;427
2018;"SOBRALIA (MG)";"MG";"SOBRALIA";44;5;13;62
2018;"SOLEDADE DE MINAS (MG)";"MG";"SOLEDADE DE MINAS";58;24;5;87
2018;"TABULEIRO (MG)";"MG";"TABULEIRO";80;11;15;106
2018;"TAIOBEIRAS (MG)";"MG";"TAIOBEIRAS";874;55;239;1168
2018;"TAPARUBA (MG)";"MG";"TAPARUBA";34;3;13;50
2018;"TAPIRA (MG)";"MG";"TAPIRA";191;20;34;245
2018;"TAPIRAI (MG)";"MG";"TAPIRAI";21;9;6;36
2018;"TAQUARACU DE MINAS (MG)";"MG";"TAQUARACU DE MINAS";121;10;19;150
2018;"TARUMIRIM (MG)";"MG";"TARUMIRIM";164;20;36;220
2018;"TEIXEIRAS (MG)";"MG";"TEIXEIRAS";186;18;18;222
2018;"TEOFILO OTONI (MG)";"MG";"TEOFILO OTONI";1667;247;212;2126
2018;"TIMOTEO (MG)";"MG";"TIMOTEO";937;204;157;1298
2018;"TIRADENTES (MG)";"MG";"TIRADENTES";128;28;12;168
2018;"TIROS (MG)";"MG";"TIROS";206;19;19;244
2018;"TOCANTINS (MG)";"MG";"TOCANTINS";276;18;25;319
2018;"TOCOS DO MOJI (MG)";"MG";"TOCOS DO MOJI";64;12;15;91
2018;"TOLEDO (MG)";"MG";"TOLEDO";158;11;24;193
2018;"TOMBOS (MG)";"MG";"TOMBOS";153;42;43;238
2018;"TRES CORACOES (MG)";"MG";"TRES CORACOES";1177;124;240;1541
2018;"TRES MARIAS (MG)";"MG";"TRES MARIAS";445;57;131;633
2018;"TRES PONTAS (MG)";"MG";"TRES PONTAS";1099;155;244;1498
2018;"TUMIRITINGA (MG)";"MG";"TUMIRITINGA";40;6;13;59
2018;"TUPACIGUARA (MG)";"MG";"TUPACIGUARA";672;103;94;869
2018;"TURMALINA (MG)";"MG";"TURMALINA";396;42;102;540
2018;"TURVOLANDIA (MG)";"MG";"TURVOLANDIA";132;37;15;184
2018;"UBA (MG)";"MG";"UBA";2095;124;207;2426
2018;"UBAI (MG)";"MG";"UBAI";53;12;55;120
2018;"UBAPORANGA (MG)";"MG";"UBAPORANGA";213;12;40;265
2018;"UBERABA (MG)";"MG";"UBERABA";5296;1153;1091;7540
2018;"UBERLANDIA (MG)";"MG";"UBERLANDIA";11696;1349;1757;14802
2018;"UMBURATIBA (MG)";"MG";"UMBURATIBA";14;4;6;24
2018;"UNAI (MG)";"MG";"UNAI";1797;115;535;2447
2018;"UNIAO DE MINAS (MG)";"MG";"UNIAO DE MINAS";63;10;43;116
2018;"URUANA DE MINAS (MG)";"MG";"URUANA DE MINAS";27;3;18;48
2018;"URUCANIA (MG)";"MG";"URUCANIA";214;10;69;293
2018;"URUCUIA (MG)";"MG";"URUCUIA";109;8;49;166
2018;"VARGEM ALEGRE (MG)";"MG";"VARGEM ALEGRE";81;6;17;104
2018;"VARGEM BONITA (MG)";"MG";"VARGEM BONITA";44;5;9;58
2018;"VARGEM GRANDE DO RIO PARDO (MG)";"MG";"VARGEM GRANDE DO RIO PARDO";70;8;24;102
2018;"VARGINHA (MG)";"MG";"VARGINHA";2280;229;299;2808
2018;"VARJAO DE MINAS (MG)";"MG";"VARJAO DE MINAS";114;20;68;202
2018;"VARZEA DA PALMA (MG)";"MG";"VARZEA DA PALMA";541;23;122;686
2018;"VARZELANDIA (MG)";"MG";"VARZELANDIA";71;14;70;155
2018;"VAZANTE (MG)";"MG";"VAZANTE";403;51;78;532
2018;"VERDELANDIA (MG)";"MG";"VERDELANDIA";19;3;15;37
2018;"VEREDINHA (MG)";"MG";"VEREDINHA";75;15;25;115
2018;"VERISSIMO (MG)";"MG";"VERISSIMO";40;32;10;82
2018;"VERMELHO NOVO (MG)";"MG";"VERMELHO NOVO";124;11;33;168
2018;"VESPASIANO (MG)";"MG";"VESPASIANO";1370;296;258;1924
2018;"VICOSA (MG)";"MG";"VICOSA";812;179;226;1217
2018;"VIEIRAS (MG)";"MG";"VIEIRAS";50;15;9;74
2018;"VIRGEM DA LAPA (MG)";"MG";"VIRGEM DA LAPA";75;12;37;124
2018;"VIRGINIA (MG)";"MG";"VIRGINIA";213;26;16;255
2018;"VIRGINOPOLIS (MG)";"MG";"VIRGINOPOLIS";139;12;41;192
2018;"VIRGOLANDIA (MG)";"MG";"VIRGOLANDIA";25;7;14;46
2018;"VISCONDE DO RIO BRANCO (MG)";"MG";"VISCONDE DO RIO BRANCO";1195;61;82;1338
2018;"VOLTA GRANDE (MG)";"MG";"VOLTA GRANDE";78;13;12;103
2018;"WENCESLAU BRAZ (MG)";"MG";"WENCESLAU BRAZ";40;8;12;60
2018;"AGUA CLARA (MS)";"MS";"AGUA CLARA";446;36;123;605
2018;"ALCINOPOLIS (MS)";"MS";"ALCINOPOLIS";118;21;19;158
2018;"AMAMBAI (MS)";"MS";"AMAMBAI";867;34;86;987
2018;"ANASTACIO (MS)";"MS";"ANASTACIO";488;27;41;556
2018;"ANAURILANDIA (MS)";"MS";"ANAURILANDIA";128;23;65;216
2018;"ANGELICA (MS)";"MS";"ANGELICA";311;49;82;442
2018;"ANTONIO JOAO (MS)";"MS";"ANTONIO JOAO";146;9;31;186
2018;"APARECIDA DO TABOADO (MS)";"MS";"APARECIDA DO TABOADO";481;50;71;602
2018;"AQUIDAUANA (MS)";"MS";"AQUIDAUANA";437;25;91;553
2018;"ARAL MOREIRA (MS)";"MS";"ARAL MOREIRA";245;14;31;290
2018;"BANDEIRANTES (MS)";"MS";"BANDEIRANTES";247;15;55;317
2018;"BATAGUASSU (MS)";"MS";"BATAGUASSU";483;48;255;786
2018;"BATAYPORA (MS)";"MS";"BATAYPORA";211;14;32;257
2018;"BELA VISTA (MS)";"MS";"BELA VISTA";349;52;74;475
2018;"BODOQUENA (MS)";"MS";"BODOQUENA";108;28;45;181
2018;"BONITO (MS)";"MS";"BONITO";371;83;92;546
2018;"BRASILANDIA (MS)";"MS";"BRASILANDIA";298;32;103;433
2018;"CAARAPO (MS)";"MS";"CAARAPO";699;20;191;910
2018;"CAMAPUA (MS)";"MS";"CAMAPUA";399;52;48;499
2018;"CAMPO GRANDE (MS)";"MS";"CAMPO GRANDE";15980;1063;2333;19376
2018;"CARACOL (MS)";"MS";"CARACOL";79;18;17;114
2018;"CASSILANDIA (MS)";"MS";"CASSILANDIA";524;33;55;612
2018;"CHAPADAO DO SUL (MS)";"MS";"CHAPADAO DO SUL";1001;38;136;1175
2018;"CORGUINHO (MS)";"MS";"CORGUINHO";69;19;27;115
2018;"CORONEL SAPUCAIA (MS)";"MS";"CORONEL SAPUCAIA";380;12;39;431
2018;"CORUMBA (MS)";"MS";"CORUMBA";1006;88;269;1363
2018;"COSTA RICA (MS)";"MS";"COSTA RICA";595;31;160;786
2018;"COXIM (MS)";"MS";"COXIM";692;28;92;812
2018;"DEODAPOLIS (MS)";"MS";"DEODAPOLIS";307;29;110;446
2018;"DOIS IRMAOS DO BURITI (MS)";"MS";"DOIS IRMAOS DO BURITI";171;34;39;244
2018;"DOURADINA (MS)";"MS";"DOURADINA";319;13;24;356
2018;"DOURADOS (MS)";"MS";"DOURADOS";4487;287;680;5454
2018;"ELDORADO (MS)";"MS";"ELDORADO";285;21;40;346
2018;"FATIMA DO SUL (MS)";"MS";"FATIMA DO SUL";500;17;44;561
2018;"FIGUEIRAO (MS)";"MS";"FIGUEIRAO";65;32;5;102
2018;"GLORIA DE DOURADOS (MS)";"MS";"GLORIA DE DOURADOS";217;10;29;256
2018;"GUIA LOPES DA LAGUNA (MS)";"MS";"GUIA LOPES DA LAGUNA";237;23;29;289
2018;"IGUATEMI (MS)";"MS";"IGUATEMI";291;10;76;377
2018;"INOCENCIA (MS)";"MS";"INOCENCIA";226;11;47;284
2018;"ITAPORA (MS)";"MS";"ITAPORA";514;31;50;595
2018;"ITAQUIRAI (MS)";"MS";"ITAQUIRAI";293;12;131;436
2018;"IVINHEMA (MS)";"MS";"IVINHEMA";759;84;301;1144
2018;"JAPORA (MS)";"MS";"JAPORA";52;3;25;80
2018;"JARAGUARI (MS)";"MS";"JARAGUARI";89;12;19;120
2018;"JARDIM (MS)";"MS";"JARDIM";553;28;71;652
2018;"JATEI (MS)";"MS";"JATEI";70;8;46;124
2018;"JUTI (MS)";"MS";"JUTI";119;15;32;166
2018;"LADARIO (MS)";"MS";"LADARIO";179;31;68;278
2018;"LAGUNA CARAPA (MS)";"MS";"LAGUNA CARAPA";231;5;30;266
2018;"MARACAJU (MS)";"MS";"MARACAJU";1239;49;160;1448
2018;"MIRANDA (MS)";"MS";"MIRANDA";410;39;133;582
2018;"MUNDO NOVO (MS)";"MS";"MUNDO NOVO";335;49;28;412
2018;"NAVIRAI (MS)";"MS";"NAVIRAI";1085;52;195;1332
2018;"NIOAQUE (MS)";"MS";"NIOAQUE";220;25;70;315
2018;"NOVA ALVORADA DO SUL (MS)";"MS";"NOVA ALVORADA DO SUL";413;30;82;525
2018;"NOVA ANDRADINA (MS)";"MS";"NOVA ANDRADINA";1191;47;279;1517
2018;"NOVO HORIZONTE DO SUL (MS)";"MS";"NOVO HORIZONTE DO SUL";89;9;25;123
2018;"PARAISO DAS AGUAS (MS)";"MS";"PARAISO DAS AGUAS";103;21;18;142
2018;"PARANAIBA (MS)";"MS";"PARANAIBA";944;47;125;1116
2018;"PARANHOS (MS)";"MS";"PARANHOS";118;8;36;162
2018;"PEDRO GOMES (MS)";"MS";"PEDRO GOMES";125;10;18;153
2018;"PONTA PORA (MS)";"MS";"PONTA PORA";2231;136;372;2739
2018;"PORTO MURTINHO (MS)";"MS";"PORTO MURTINHO";96;20;31;147
2018;"RIBAS DO RIO PARDO (MS)";"MS";"RIBAS DO RIO PARDO";692;62;96;850
2018;"RIO BRILHANTE (MS)";"MS";"RIO BRILHANTE";757;53;151;961
2018;"RIO NEGRO (MS)";"MS";"RIO NEGRO";96;11;11;118
2018;"RIO VERDE DE MATO GROSSO (MS)";"MS";"RIO VERDE DE MATO GROSSO";430;31;38;499
2018;"ROCHEDO (MS)";"MS";"ROCHEDO";82;5;14;101
2018;"SANTA RITA DO PARDO (MS)";"MS";"SANTA RITA DO PARDO";156;16;43;215
2018;"SAO GABRIEL DO OESTE (MS)";"MS";"SAO GABRIEL DO OESTE";1126;34;100;1260
2018;"SELVIRIA (MS)";"MS";"SELVIRIA";121;17;31;169
2018;"SETE QUEDAS (MS)";"MS";"SETE QUEDAS";281;11;23;315
2018;"SIDROLANDIA (MS)";"MS";"SIDROLANDIA";768;181;333;1282
2018;"SONORA (MS)";"MS";"SONORA";272;29;114;415
2018;"TACURU (MS)";"MS";"TACURU";138;9;22;169
2018;"TAQUARUSSU (MS)";"MS";"TAQUARUSSU";58;6;16;80
2018;"TERENOS (MS)";"MS";"TERENOS";402;18;64;484
2018;"TRES LAGOAS (MS)";"MS";"TRES LAGOAS";2051;248;392;2691
2018;"VICENTINA (MS)";"MS";"VICENTINA";170;10;110;290
2018;"ACORIZAL (MT)";"MT";"ACORIZAL";23;5;3;31
2018;"AGUA BOA (MT)";"MT";"AGUA BOA";740;30;58;828
2018;"ALTA FLORESTA (MT)";"MT";"ALTA FLORESTA";1536;41;155;1732
2018;"ALTO ARAGUAIA (MT)";"MT";"ALTO ARAGUAIA";248;26;44;318
2018;"ALTO BOA VISTA (MT)";"MT";"ALTO BOA VISTA";68;0;8;76
2018;"ALTO GARCAS (MT)";"MT";"ALTO GARCAS";326;19;61;406
2018;"ALTO PARAGUAI (MT)";"MT";"ALTO PARAGUAI";51;9;8;68
2018;"ALTO TAQUARI (MT)";"MT";"ALTO TAQUARI";277;25;31;333
2018;"APIACAS (MT)";"MT";"APIACAS";169;9;12;190
2018;"ARAGUAIANA (MT)";"MT";"ARAGUAIANA";22;2;5;29
2018;"ARAGUAINHA (MT)";"MT";"ARAGUAINHA";11;2;1;14
2018;"ARAPUTANGA (MT)";"MT";"ARAPUTANGA";295;13;31;339
2018;"ARENAPOLIS (MT)";"MT";"ARENAPOLIS";253;12;68;333
2018;"ARIPUANA (MT)";"MT";"ARIPUANA";496;12;59;567
2018;"BARAO DE MELGACO (MT)";"MT";"BARAO DE MELGACO";20;3;7;30
2018;"BARRA DO BUGRES (MT)";"MT";"BARRA DO BUGRES";669;22;181;872
2018;"BARRA DO GARCAS (MT)";"MT";"BARRA DO GARCAS";1018;36;246;1300
2018;"BOM JESUS DO ARAGUAIA (MT)";"MT";"BOM JESUS DO ARAGUAIA";89;3;23;115
2018;"BRASNORTE (MT)";"MT";"BRASNORTE";425;10;73;508
2018;"CACERES (MT)";"MT";"CACERES";1149;61;367;1577
2018;"CAMPINAPOLIS (MT)";"MT";"CAMPINAPOLIS";141;6;24;171
2018;"CAMPO NOVO DO PARECIS (MT)";"MT";"CAMPO NOVO DO PARECIS";932;64;198;1194
2018;"CAMPO VERDE (MT)";"MT";"CAMPO VERDE";1142;59;183;1384
2018;"CAMPOS DE JULIO (MT)";"MT";"CAMPOS DE JULIO";277;11;51;339
2018;"CANABRAVA DO NORTE (MT)";"MT";"CANABRAVA DO NORTE";47;0;10;57
2018;"CANARANA (MT)";"MT";"CANARANA";662;19;46;727
2018;"CARLINDA (MT)";"MT";"CARLINDA";178;2;30;210
2018;"CASTANHEIRA (MT)";"MT";"CASTANHEIRA";182;3;33;218
2018;"CHAPADA DOS GUIMARAES (MT)";"MT";"CHAPADA DOS GUIMARAES";260;38;59;357
2018;"CLAUDIA (MT)";"MT";"CLAUDIA";461;7;37;505
2018;"COCALINHO (MT)";"MT";"COCALINHO";58;1;11;70
2018;"COLIDER (MT)";"MT";"COLIDER";957;28;144;1129
2018;"COLNIZA (MT)";"MT";"COLNIZA";503;1;42;546
2018;"COMODORO (MT)";"MT";"COMODORO";692;16;104;812
2018;"CONFRESA (MT)";"MT";"CONFRESA";425;7;77;509
2018;"CONQUISTA D OESTE (MT)";"MT";"CONQUISTA D OESTE";71;5;14;90
2018;"COTRIGUACU (MT)";"MT";"COTRIGUACU";180;7;44;231
2018;"CUIABA (MT)";"MT";"CUIABA";10733;916;3270;14919
2018;"CURVELANDIA (MT)";"MT";"CURVELANDIA";119;1;24;144
2018;"DENISE (MT)";"MT";"DENISE";97;7;34;138
2018;"DIAMANTINO (MT)";"MT";"DIAMANTINO";677;22;106;805
2018;"DOM AQUINO (MT)";"MT";"DOM AQUINO";145;10;29;184
2018;"FELIZ NATAL (MT)";"MT";"FELIZ NATAL";310;5;29;344
2018;"FIGUEIROPOLIS D OESTE (MT)";"MT";"FIGUEIROPOLIS D OESTE";81;3;11;95
2018;"GAUCHA DO NORTE (MT)";"MT";"GAUCHA DO NORTE";176;5;30;211
2018;"GENERAL CARNEIRO (MT)";"MT";"GENERAL CARNEIRO";28;7;9;44
2018;"GLORIA D OESTE (MT)";"MT";"GLORIA D OESTE";73;3;19;95
2018;"GUARANTA DO NORTE (MT)";"MT";"GUARANTA DO NORTE";1034;20;100;1154
2018;"GUIRATINGA (MT)";"MT";"GUIRATINGA";221;17;18;256
2018;"INDIAVAI (MT)";"MT";"INDIAVAI";25;3;8;36
2018;"IPIRANGA DO NORTE (MT)";"MT";"IPIRANGA DO NORTE";190;9;14;213
2018;"ITANHANGA (MT)";"MT";"ITANHANGA";216;7;15;238
2018;"ITAUBA (MT)";"MT";"ITAUBA";145;12;14;171
2018;"ITIQUIRA (MT)";"MT";"ITIQUIRA";187;28;84;299
2018;"JACIARA (MT)";"MT";"JACIARA";727;52;169;948
2018;"JANGADA (MT)";"MT";"JANGADA";74;10;22;106
2018;"JAURU (MT)";"MT";"JAURU";176;12;48;236
2018;"JUARA (MT)";"MT";"JUARA";987;26;93;1106
2018;"JUINA (MT)";"MT";"JUINA";1152;20;100;1272
2018;"JURUENA (MT)";"MT";"JURUENA";220;2;20;242
2018;"JUSCIMEIRA (MT)";"MT";"JUSCIMEIRA";175;7;71;253
2018;"LAMBARI D OESTE (MT)";"MT";"LAMBARI D OESTE";102;2;34;138
2018;"LUCAS DO RIO VERDE (MT)";"MT";"LUCAS DO RIO VERDE";1971;68;177;2216
2018;"LUCIARA (MT)";"MT";"LUCIARA";13;1;3;17
2018;"MARCELANDIA (MT)";"MT";"MARCELANDIA";454;11;28;493
2018;"MATUPA (MT)";"MT";"MATUPA";515;10;57;582
2018;"MIRASSOL D OESTE (MT)";"MT";"MIRASSOL D OESTE";955;14;110;1079
2018;"NOBRES (MT)";"MT";"NOBRES";359;39;58;456
2018;"NORTELANDIA (MT)";"MT";"NORTELANDIA";89;9;23;121
2018;"NOSSA SENHORA DO LIVRAMENTO (MT)";"MT";"NOSSA SENHORA DO LIVRAMENTO";131;13;37;181
2018;"NOVA BANDEIRANTES (MT)";"MT";"NOVA BANDEIRANTES";254;4;38;296
2018;"NOVA BRASILANDIA (MT)";"MT";"NOVA BRASILANDIA";86;2;13;101
2018;"NOVA CANAA DO NORTE (MT)";"MT";"NOVA CANAA DO NORTE";289;7;68;364
2018;"NOVA GUARITA (MT)";"MT";"NOVA GUARITA";131;2;20;153
2018;"NOVA LACERDA (MT)";"MT";"NOVA LACERDA";168;4;34;206
2018;"NOVA MARILANDIA (MT)";"MT";"NOVA MARILANDIA";62;6;9;77
2018;"NOVA MARINGA (MT)";"MT";"NOVA MARINGA";139;6;15;160
2018;"NOVA MONTE VERDE (MT)";"MT";"NOVA MONTE VERDE";204;4;14;222
2018;"NOVA MUTUM (MT)";"MT";"NOVA MUTUM";1281;27;150;1458
2018;"NOVA NAZARE (MT)";"MT";"NOVA NAZARE";13;6;5;24
2018;"NOVA OLIMPIA (MT)";"MT";"NOVA OLIMPIA";420;14;152;586
2018;"NOVA SANTA HELENA (MT)";"MT";"NOVA SANTA HELENA";79;7;15;101
2018;"NOVA UBIRATA (MT)";"MT";"NOVA UBIRATA";281;25;40;346
2018;"NOVA XAVANTINA (MT)";"MT";"NOVA XAVANTINA";515;30;45;590
2018;"NOVO HORIZONTE DO NORTE (MT)";"MT";"NOVO HORIZONTE DO NORTE";60;1;11;72
2018;"NOVO MUNDO (MT)";"MT";"NOVO MUNDO";145;5;26;176
2018;"NOVO SANTO ANTONIO (MT)";"MT";"NOVO SANTO ANTONIO";5;1;2;8
2018;"NOVO SAO JOAQUIM (MT)";"MT";"NOVO SAO JOAQUIM";124;7;18;149
2018;"PARANAITA (MT)";"MT";"PARANAITA";277;13;78;368
2018;"PARANATINGA (MT)";"MT";"PARANATINGA";565;27;93;685
2018;"PEDRA PRETA (MT)";"MT";"PEDRA PRETA";390;12;62;464
2018;"PEIXOTO DE AZEVEDO (MT)";"MT";"PEIXOTO DE AZEVEDO";519;16;90;625
2018;"PLANALTO DA SERRA (MT)";"MT";"PLANALTO DA SERRA";35;2;12;49
2018;"POCONE (MT)";"MT";"POCONE";615;32;47;694
2018;"PONTAL DO ARAGUAIA (MT)";"MT";"PONTAL DO ARAGUAIA";43;4;4;51
2018;"PONTE BRANCA (MT)";"MT";"PONTE BRANCA";12;1;1;14
2018;"PONTES E LACERDA (MT)";"MT";"PONTES E LACERDA";1072;28;143;1243
2018;"PORTO ALEGRE DO NORTE (MT)";"MT";"PORTO ALEGRE DO NORTE";131;7;37;175
2018;"PORTO DOS GAUCHOS (MT)";"MT";"PORTO DOS GAUCHOS";175;18;10;203
2018;"PORTO ESPERIDIAO (MT)";"MT";"PORTO ESPERIDIAO";173;14;62;249
2018;"PORTO ESTRELA (MT)";"MT";"PORTO ESTRELA";39;4;12;55
2018;"POXOREO (MT)";"MT";"POXOREO";190;26;53;269
2018;"PRIMAVERA DO LESTE (MT)";"MT";"PRIMAVERA DO LESTE";2314;107;231;2652
2018;"QUERENCIA (MT)";"MT";"QUERENCIA";495;36;81;612
2018;"RESERVA DO CABACAL (MT)";"MT";"RESERVA DO CABACAL";20;1;7;28
2018;"RIBEIRAO CASCALHEIRA (MT)";"MT";"RIBEIRAO CASCALHEIRA";166;13;21;200
2018;"RIBEIRAOZINHO (MT)";"MT";"RIBEIRAOZINHO";23;2;9;34
2018;"RIO BRANCO (MT)";"MT";"RIO BRANCO";96;4;35;135
2018;"RONDOLANDIA (MT)";"MT";"RONDOLANDIA";79;4;25;108
2018;"RONDONOPOLIS (MT)";"MT";"RONDONOPOLIS";4919;201;538;5658
2018;"ROSARIO OESTE (MT)";"MT";"ROSARIO OESTE";192;19;51;262
2018;"SALTO DO CEU (MT)";"MT";"SALTO DO CEU";65;6;23;94
2018;"SANTA CARMEM (MT)";"MT";"SANTA CARMEM";183;9;20;212
2018;"SANTA CRUZ DO XINGU (MT)";"MT";"SANTA CRUZ DO XINGU";17;4;9;30
2018;"SANTA RITA DO TRIVELATO (MT)";"MT";"SANTA RITA DO TRIVELATO";102;3;16;121
2018;"SANTA TEREZINHA (MT)";"MT";"SANTA TEREZINHA";16;2;19;37
2018;"SANTO AFONSO (MT)";"MT";"SANTO AFONSO";36;4;13;53
2018;"SANTO ANTONIO DO LESTE (MT)";"MT";"SANTO ANTONIO DO LESTE";73;8;24;105
2018;"SANTO ANTONIO DO LEVERGER (MT)";"MT";"SANTO ANTONIO DO LEVERGER";157;13;15;185
2018;"SAO FELIX DO ARAGUAIA (MT)";"MT";"SAO FELIX DO ARAGUAIA";66;21;31;118
2018;"SAO JOSE DO POVO (MT)";"MT";"SAO JOSE DO POVO";23;4;6;33
2018;"SAO JOSE DO RIO CLARO (MT)";"MT";"SAO JOSE DO RIO CLARO";389;15;60;464
2018;"SAO JOSE DO XINGU (MT)";"MT";"SAO JOSE DO XINGU";46;3;15;64
2018;"SAO JOSE DOS QUATRO MARCOS (MT)";"MT";"SAO JOSE DOS QUATRO MARCOS";527;16;82;625
2018;"SAO PEDRO DA CIPA (MT)";"MT";"SAO PEDRO DA CIPA";30;8;25;63
2018;"SAPEZAL (MT)";"MT";"SAPEZAL";678;50;125;853
2018;"SERRA NOVA DOURADA (MT)";"MT";"SERRA NOVA DOURADA";7;2;4;13
2018;"SINOP (MT)";"MT";"SINOP";3949;144;235;4328
2018;"SORRISO (MT)";"MT";"SORRISO";2724;106;235;3065
2018;"TABAPORA (MT)";"MT";"TABAPORA";199;4;30;233
2018;"TANGARA DA SERRA (MT)";"MT";"TANGARA DA SERRA";2247;98;241;2586
2018;"TAPURAH (MT)";"MT";"TAPURAH";408;8;44;460
2018;"TERRA NOVA DO NORTE (MT)";"MT";"TERRA NOVA DO NORTE";313;12;40;365
2018;"TESOURO (MT)";"MT";"TESOURO";23;6;5;34
2018;"TORIXOREU (MT)";"MT";"TORIXOREU";51;7;6;64
2018;"UNIAO DO SUL (MT)";"MT";"UNIAO DO SUL";119;3;10;132
2018;"VALE DE SAO DOMINGOS (MT)";"MT";"VALE DE SAO DOMINGOS";27;0;15;42
2018;"VARZEA GRANDE (MT)";"MT";"VARZEA GRANDE";5420;357;672;6449
2018;"VERA (MT)";"MT";"VERA";309;2;34;345
2018;"VILA BELA DA SANTISSIMA TRINDA (MT)";"MT";"VILA BELA DA SANTISSIMA TRINDA";179;5;57;241
2018;"VILA RICA (MT)";"MT";"VILA RICA";387;3;44;434
2018;"ABAETETUBA (PA)";"PA";"ABAETETUBA";411;32;285;728
2018;"ABEL FIGUEIREDO (PA)";"PA";"ABEL FIGUEIREDO";72;5;5;82
2018;"ACARA (PA)";"PA";"ACARA";104;13;100;217
2018;"AFUA (PA)";"PA";"AFUA";1;0;0;1
2018;"AGUA AZUL DO NORTE (PA)";"PA";"AGUA AZUL DO NORTE";108;11;34;153
2018;"ALENQUER (PA)";"PA";"ALENQUER";215;6;86;307
2018;"ALMEIRIM (PA)";"PA";"ALMEIRIM";255;24;101;380
2018;"ALTAMIRA (PA)";"PA";"ALTAMIRA";2042;198;466;2706
2018;"ANAJAS (PA)";"PA";"ANAJAS";0;1;1;2
2018;"ANANINDEUA (PA)";"PA";"ANANINDEUA";4558;411;1650;6619
2018;"ANAPU (PA)";"PA";"ANAPU";188;18;21;227
2018;"AUGUSTO CORREA (PA)";"PA";"AUGUSTO CORREA";91;5;83;179
2018;"AURORA DO PARA (PA)";"PA";"AURORA DO PARA";104;14;82;200
2018;"AVEIRO (PA)";"PA";"AVEIRO";5;0;6;11
2018;"BAGRE (PA)";"PA";"BAGRE";1;0;2;3
2018;"BAIAO (PA)";"PA";"BAIAO";68;6;28;102
2018;"BANNACH (PA)";"PA";"BANNACH";27;1;6;34
2018;"BARCARENA (PA)";"PA";"BARCARENA";1140;172;817;2129
2018;"BELEM (PA)";"PA";"BELEM";8859;2097;3814;14770
2018;"BELTERRA (PA)";"PA";"BELTERRA";64;12;75;151
2018;"BENEVIDES (PA)";"PA";"BENEVIDES";1023;66;176;1265
2018;"BOM JESUS DO TOCANTINS (PA)";"PA";"BOM JESUS DO TOCANTINS";88;10;10;108
2018;"BONITO (PA)";"PA";"BONITO";66;4;92;162
2018;"BRAGANCA (PA)";"PA";"BRAGANCA";508;41;221;770
2018;"BRASIL NOVO (PA)";"PA";"BRASIL NOVO";203;12;13;228
2018;"BREJO GRANDE DO ARAGUAIA (PA)";"PA";"BREJO GRANDE DO ARAGUAIA";31;4;11;46
2018;"BREU BRANCO (PA)";"PA";"BREU BRANCO";332;14;131;477
2018;"BREVES (PA)";"PA";"BREVES";70;2;11;83
2018;"BUJARU (PA)";"PA";"BUJARU";47;10;40;97
2018;"CACHOEIRA DO ARARI (PA)";"PA";"CACHOEIRA DO ARARI";17;2;19;38
2018;"CACHOEIRA DO PIRIA (PA)";"PA";"CACHOEIRA DO PIRIA";49;5;32;86
2018;"CAMETA (PA)";"PA";"CAMETA";169;10;85;264
2018;"CANAA DOS CARAJAS (PA)";"PA";"CANAA DOS CARAJAS";463;95;258;816
2018;"CAPANEMA (PA)";"PA";"CAPANEMA";821;32;129;982
2018;"CAPITAO POCO (PA)";"PA";"CAPITAO POCO";493;22;124;639
2018;"CASTANHAL (PA)";"PA";"CASTANHAL";2976;171;463;3610
2018;"CHAVES (PA)";"PA";"CHAVES";1;0;0;1
2018;"COLARES (PA)";"PA";"COLARES";10;0;4;14
2018;"CONCEICAO DO ARAGUAIA (PA)";"PA";"CONCEICAO DO ARAGUAIA";483;43;122;648
2018;"CONCORDIA DO PARA (PA)";"PA";"CONCORDIA DO PARA";175;13;84;272
2018;"CUMARU DO NORTE (PA)";"PA";"CUMARU DO NORTE";31;2;10;43
2018;"CURIONOPOLIS (PA)";"PA";"CURIONOPOLIS";322;123;34;479
2018;"CURRALINHO (PA)";"PA";"CURRALINHO";2;0;2;4
2018;"CURUA (PA)";"PA";"CURUA";11;1;5;17
2018;"CURUCA (PA)";"PA";"CURUCA";62;15;26;103
2018;"DOM ELISEU (PA)";"PA";"DOM ELISEU";597;71;56;724
2018;"ELDORADO DOS CARAJAS (PA)";"PA";"ELDORADO DOS CARAJAS";229;57;29;315
2018;"FARO (PA)";"PA";"FARO";4;1;1;6
2018;"FLORESTA DO ARAGUAIA (PA)";"PA";"FLORESTA DO ARAGUAIA";238;3;23;264
2018;"GARRAFAO DO NORTE (PA)";"PA";"GARRAFAO DO NORTE";137;10;27;174
2018;"GOIANESIA DO PARA (PA)";"PA";"GOIANESIA DO PARA";326;25;49;400
2018;"GURUPA (PA)";"PA";"GURUPA";12;0;3;15
2018;"IGARAPE ACU (PA)";"PA";"IGARAPE ACU";249;81;131;461
2018;"IGARAPE MIRI (PA)";"PA";"IGARAPE MIRI";112;25;49;186
2018;"INHANGAPI (PA)";"PA";"INHANGAPI";41;2;31;74
2018;"IPIXUNA DO PARA (PA)";"PA";"IPIXUNA DO PARA";97;13;61;171
2018;"IRITUIA (PA)";"PA";"IRITUIA";113;9;64;186
2018;"ITAITUBA (PA)";"PA";"ITAITUBA";1415;47;176;1638
2018;"ITUPIRANGA (PA)";"PA";"ITUPIRANGA";238;94;41;373
2018;"JACAREACANGA (PA)";"PA";"JACAREACANGA";45;2;5;52
2018;"JACUNDA (PA)";"PA";"JACUNDA";637;23;60;720
2018;"JURUTI (PA)";"PA";"JURUTI";106;12;38;156
2018;"LIMOEIRO DO AJURU (PA)";"PA";"LIMOEIRO DO AJURU";3;0;5;8
2018;"MAE DO RIO (PA)";"PA";"MAE DO RIO";375;31;87;493
2018;"MAGALHAES BARATA (PA)";"PA";"MAGALHAES BARATA";14;8;12;34
2018;"MARABA (PA)";"PA";"MARABA";3783;274;744;4801
2018;"MARACANA (PA)";"PA";"MARACANA";32;14;37;83
2018;"MARAPANIM (PA)";"PA";"MARAPANIM";43;14;38;95
2018;"MARITUBA (PA)";"PA";"MARITUBA";976;95;580;1651
2018;"MEDICILANDIA (PA)";"PA";"MEDICILANDIA";224;9;43;276
2018;"MELGACO (PA)";"PA";"MELGACO";8;1;4;13
2018;"MOCAJUBA (PA)";"PA";"MOCAJUBA";23;3;15;41
2018;"MOJU (PA)";"PA";"MOJU";266;21;273;560
2018;"MOJUI DOS CAMPOS (PA)";"PA";"MOJUI DOS CAMPOS";68;1;42;111
2018;"MONTE ALEGRE (PA)";"PA";"MONTE ALEGRE";358;16;216;590
2018;"MUANA (PA)";"PA";"MUANA";6;3;12;21
2018;"NOVA ESPERANCA DO PIRIA (PA)";"PA";"NOVA ESPERANCA DO PIRIA";106;8;28;142
2018;"NOVA IPIXUNA (PA)";"PA";"NOVA IPIXUNA";177;2;29;208
2018;"NOVA TIMBOTEUA (PA)";"PA";"NOVA TIMBOTEUA";88;8;22;118
2018;"NOVO PROGRESSO (PA)";"PA";"NOVO PROGRESSO";945;12;51;1008
2018;"NOVO REPARTIMENTO (PA)";"PA";"NOVO REPARTIMENTO";548;41;72;661
2018;"OBIDOS (PA)";"PA";"OBIDOS";224;9;74;307
2018;"OEIRAS DO PARA (PA)";"PA";"OEIRAS DO PARA";11;1;12;24
2018;"ORIXIMINA (PA)";"PA";"ORIXIMINA";366;15;47;428
2018;"OUREM (PA)";"PA";"OUREM";174;4;20;198
2018;"OURILANDIA DO NORTE (PA)";"PA";"OURILANDIA DO NORTE";339;11;44;394
2018;"PACAJA (PA)";"PA";"PACAJA";172;31;15;218
2018;"PALESTINA DO PARA (PA)";"PA";"PALESTINA DO PARA";28;7;5;40
2018;"PARAGOMINAS (PA)";"PA";"PARAGOMINAS";1959;101;267;2327
2018;"PARAUAPEBAS (PA)";"PA";"PARAUAPEBAS";2661;612;1308;4581
2018;"PAU D ARCO (PA)";"PA";"PAU D ARCO";32;13;9;54
2018;"PEIXE BOI (PA)";"PA";"PEIXE BOI";34;11;21;66
2018;"PICARRA (PA)";"PA";"PICARRA";39;1;8;48
2018;"PLACAS (PA)";"PA";"PLACAS";114;5;4;123
2018;"PONTA DE PEDRAS (PA)";"PA";"PONTA DE PEDRAS";22;2;6;30
2018;"PORTEL (PA)";"PA";"PORTEL";23;2;11;36
2018;"PORTO DE MOZ (PA)";"PA";"PORTO DE MOZ";28;1;7;36
2018;"PRAINHA (PA)";"PA";"PRAINHA";40;1;8;49
2018;"PRIMAVERA (PA)";"PA";"PRIMAVERA";36;7;27;70
2018;"QUATIPURU (PA)";"PA";"QUATIPURU";12;6;18;36
2018;"REDENCAO (PA)";"PA";"REDENCAO";1996;107;224;2327
2018;"RIO MARIA (PA)";"PA";"RIO MARIA";350;32;61;443
2018;"RONDON DO PARA (PA)";"PA";"RONDON DO PARA";549;47;30;626
2018;"RUROPOLIS (PA)";"PA";"RUROPOLIS";268;11;28;307
2018;"SALINOPOLIS (PA)";"PA";"SALINOPOLIS";334;51;135;520
2018;"SALVATERRA (PA)";"PA";"SALVATERRA";57;38;33;128
2018;"SANTA BARBARA DO PARA (PA)";"PA";"SANTA BARBARA DO PARA";82;24;113;219
2018;"SANTA CRUZ DO ARARI (PA)";"PA";"SANTA CRUZ DO ARARI";5;1;1;7
2018;"SANTA ISABEL DO PARA (PA)";"PA";"SANTA ISABEL DO PARA";774;59;171;1004
2018;"SANTA LUZIA DO PARA (PA)";"PA";"SANTA LUZIA DO PARA";128;15;40;183
2018;"SANTA MARIA DAS BARREIRAS (PA)";"PA";"SANTA MARIA DAS BARREIRAS";141;6;45;192
2018;"SANTA MARIA DO PARA (PA)";"PA";"SANTA MARIA DO PARA";388;23;69;480
2018;"SANTANA DO ARAGUAIA (PA)";"PA";"SANTANA DO ARAGUAIA";369;17;57;443
2018;"SANTAREM (PA)";"PA";"SANTAREM";3267;151;926;4344
2018;"SANTAREM NOVO (PA)";"PA";"SANTAREM NOVO";11;4;18;33
2018;"SANTO ANTONIO DO TAUA (PA)";"PA";"SANTO ANTONIO DO TAUA";163;26;110;299
2018;"SAO CAETANO DE ODIVELAS (PA)";"PA";"SAO CAETANO DE ODIVELAS";28;4;18;50
2018;"SAO DOMINGOS DO ARAGUAIA (PA)";"PA";"SAO DOMINGOS DO ARAGUAIA";186;26;31;243
2018;"SAO DOMINGOS DO CAPIM (PA)";"PA";"SAO DOMINGOS DO CAPIM";51;0;38;89
2018;"SAO FELIX DO XINGU (PA)";"PA";"SAO FELIX DO XINGU";415;11;47;473
2018;"SAO FRANCISCO DO PARA (PA)";"PA";"SAO FRANCISCO DO PARA";65;36;28;129
2018;"SAO GERALDO DO ARAGUAIA (PA)";"PA";"SAO GERALDO DO ARAGUAIA";157;10;20;187
2018;"SAO JOAO DA PONTA (PA)";"PA";"SAO JOAO DA PONTA";4;3;9;16
2018;"SAO JOAO DE PIRABAS (PA)";"PA";"SAO JOAO DE PIRABAS";39;10;31;80
2018;"SAO JOAO DO ARAGUAIA (PA)";"PA";"SAO JOAO DO ARAGUAIA";38;14;13;65
2018;"SAO MIGUEL DO GUAMA (PA)";"PA";"SAO MIGUEL DO GUAMA";512;26;137;675
2018;"SAO SEBASTIAO DA BOA VISTA (PA)";"PA";"SAO SEBASTIAO DA BOA VISTA";5;0;1;6
2018;"SAPUCAIA (PA)";"PA";"SAPUCAIA";54;5;13;72
2018;"SENADOR JOSE PORFIRIO (PA)";"PA";"SENADOR JOSE PORFIRIO";45;3;10;58
2018;"SOURE (PA)";"PA";"SOURE";36;3;17;56
2018;"TAILANDIA (PA)";"PA";"TAILANDIA";862;37;233;1132
2018;"TERRA ALTA (PA)";"PA";"TERRA ALTA";24;19;17;60
2018;"TERRA SANTA (PA)";"PA";"TERRA SANTA";33;0;3;36
2018;"TOME ACU (PA)";"PA";"TOME ACU";591;19;172;782
2018;"TRACUATEUA (PA)";"PA";"TRACUATEUA";54;5;66;125
2018;"TRAIRAO (PA)";"PA";"TRAIRAO";182;3;19;204
2018;"TUCUMA (PA)";"PA";"TUCUMA";752;21;111;884
2018;"TUCURUI (PA)";"PA";"TUCURUI";977;86;245;1308
2018;"ULIANOPOLIS (PA)";"PA";"ULIANOPOLIS";239;31;53;323
2018;"URUARA (PA)";"PA";"URUARA";570;22;37;629
2018;"VIGIA (PA)";"PA";"VIGIA";154;20;90;264
2018;"VISEU (PA)";"PA";"VISEU";96;7;61;164
2018;"VITORIA DO XINGU (PA)";"PA";"VITORIA DO XINGU";63;26;25;114
2018;"XINGUARA (PA)";"PA";"XINGUARA";1205;24;137;1366
2018;"AGUA BRANCA (PB)";"PB";"AGUA BRANCA";17;16;6;39
2018;"AGUIAR (PB)";"PB";"AGUIAR";16;8;3;27
2018;"ALAGOA GRANDE (PB)";"PB";"ALAGOA GRANDE";125;36;46;207
2018;"ALAGOA NOVA (PB)";"PB";"ALAGOA NOVA";176;36;12;224
2018;"ALAGOINHA (PB)";"PB";"ALAGOINHA";46;20;43;109
2018;"ALCANTIL (PB)";"PB";"ALCANTIL";70;14;16;100
2018;"ALGODAO DE JANDAIRA (PB)";"PB";"ALGODAO DE JANDAIRA";36;1;6;43
2018;"ALHANDRA (PB)";"PB";"ALHANDRA";196;25;49;270
2018;"AMPARO (PB)";"PB";"AMPARO";14;10;5;29
2018;"APARECIDA (PB)";"PB";"APARECIDA";42;5;19;66
2018;"ARACAGI (PB)";"PB";"ARACAGI";90;4;62;156
2018;"ARARA (PB)";"PB";"ARARA";97;8;20;125
2018;"ARARUNA (PB)";"PB";"ARARUNA";96;45;17;158
2018;"AREIA (PB)";"PB";"AREIA";129;42;31;202
2018;"AREIA DE BARAUNAS (PB)";"PB";"AREIA DE BARAUNAS";7;4;2;13
2018;"AREIAL (PB)";"PB";"AREIAL";53;13;12;78
2018;"AROEIRAS (PB)";"PB";"AROEIRAS";100;76;25;201
2018;"ASSUNCAO (PB)";"PB";"ASSUNCAO";30;5;5;40
2018;"BAIA DA TRAICAO (PB)";"PB";"BAIA DA TRAICAO";16;9;16;41
2018;"BANANEIRAS (PB)";"PB";"BANANEIRAS";131;36;34;201
2018;"BARAUNA (PB)";"PB";"BARAUNA";23;4;7;34
2018;"BARRA DE SANTA ROSA (PB)";"PB";"BARRA DE SANTA ROSA";98;9;22;129
2018;"BARRA DE SANTANA (PB)";"PB";"BARRA DE SANTANA";101;9;20;130
2018;"BARRA DE SAO MIGUEL (PB)";"PB";"BARRA DE SAO MIGUEL";15;4;6;25
2018;"BAYEUX (PB)";"PB";"BAYEUX";719;57;189;965
2018;"BELEM (PB)";"PB";"BELEM";147;11;16;174
2018;"BELEM DO BREJO DO CRUZ (PB)";"PB";"BELEM DO BREJO DO CRUZ";20;9;4;33
2018;"BERNARDINO BATISTA (PB)";"PB";"BERNARDINO BATISTA";7;2;5;14
2018;"BOA VENTURA (PB)";"PB";"BOA VENTURA";17;5;2;24
2018;"BOA VISTA (PB)";"PB";"BOA VISTA";103;8;24;135
2018;"BOM JESUS (PB)";"PB";"BOM JESUS";11;0;3;14
2018;"BOM SUCESSO (PB)";"PB";"BOM SUCESSO";11;4;9;24
2018;"BONITO DE SANTA FE (PB)";"PB";"BONITO DE SANTA FE";39;16;3;58
2018;"BOQUEIRAO (PB)";"PB";"BOQUEIRAO";239;17;28;284
2018;"BORBOREMA (PB)";"PB";"BORBOREMA";43;7;3;53
2018;"BREJO DO CRUZ (PB)";"PB";"BREJO DO CRUZ";62;11;8;81
2018;"BREJO DOS SANTOS (PB)";"PB";"BREJO DOS SANTOS";24;4;4;32
2018;"CAAPORA (PB)";"PB";"CAAPORA";64;11;19;94
2018;"CABACEIRAS (PB)";"PB";"CABACEIRAS";32;6;19;57
2018;"CABEDELO (PB)";"PB";"CABEDELO";517;49;41;607
2018;"CACHOEIRA DOS INDIOS (PB)";"PB";"CACHOEIRA DOS INDIOS";21;6;9;36
2018;"CACIMBA DE AREIA (PB)";"PB";"CACIMBA DE AREIA";6;7;5;18
2018;"CACIMBA DE DENTRO (PB)";"PB";"CACIMBA DE DENTRO";83;16;35;134
2018;"CACIMBAS (PB)";"PB";"CACIMBAS";6;13;5;24
2018;"CAICARA (PB)";"PB";"CAICARA";19;4;5;28
2018;"CAJAZEIRAS (PB)";"PB";"CAJAZEIRAS";437;57;68;562
2018;"CAJAZEIRINHAS (PB)";"PB";"CAJAZEIRINHAS";4;0;3;7
2018;"CALDAS BRANDAO (PB)";"PB";"CALDAS BRANDAO";42;3;9;54
2018;"CAMALAU (PB)";"PB";"CAMALAU";38;9;16;63
2018;"CAMPINA GRANDE (PB)";"PB";"CAMPINA GRANDE";4322;372;886;5580
2018;"CAPIM (PB)";"PB";"CAPIM";36;12;18;66
2018;"CARAUBAS (PB)";"PB";"CARAUBAS";16;12;4;32
2018;"CARRAPATEIRA (PB)";"PB";"CARRAPATEIRA";7;0;3;10
2018;"CASSERENGUE (PB)";"PB";"CASSERENGUE";47;11;17;75
2018;"CATINGUEIRA (PB)";"PB";"CATINGUEIRA";19;5;2;26
2018;"CATOLE DO ROCHA (PB)";"PB";"CATOLE DO ROCHA";239;56;17;312
2018;"CATURITE (PB)";"PB";"CATURITE";117;20;15;152
2018;"CONCEICAO (PB)";"PB";"CONCEICAO";108;34;10;152
2018;"CONDADO (PB)";"PB";"CONDADO";36;7;9;52
2018;"CONDE (PB)";"PB";"CONDE";145;28;21;194
2018;"CONGO (PB)";"PB";"CONGO";26;12;6;44
2018;"COREMAS (PB)";"PB";"COREMAS";76;26;10;112
2018;"COXIXOLA (PB)";"PB";"COXIXOLA";6;9;2;17
2018;"CRUZ DO ESPIRITO SANTO (PB)";"PB";"CRUZ DO ESPIRITO SANTO";30;8;29;67
2018;"CUBATI (PB)";"PB";"CUBATI";38;9;6;53
2018;"CUITE (PB)";"PB";"CUITE";86;11;20;117
2018;"CUITE DE MAMANGUAPE (PB)";"PB";"CUITE DE MAMANGUAPE";21;11;39;71
2018;"CUITEGI (PB)";"PB";"CUITEGI";24;3;4;31
2018;"CURRAL DE CIMA (PB)";"PB";"CURRAL DE CIMA";17;5;21;43
2018;"CURRAL VELHO (PB)";"PB";"CURRAL VELHO";9;3;2;14
2018;"DAMIAO (PB)";"PB";"DAMIAO";37;8;7;52
2018;"DESTERRO (PB)";"PB";"DESTERRO";26;16;6;48
2018;"DIAMANTE (PB)";"PB";"DIAMANTE";19;5;5;29
2018;"DONA INES (PB)";"PB";"DONA INES";53;15;24;92
2018;"DUAS ESTRADAS (PB)";"PB";"DUAS ESTRADAS";12;6;5;23
2018;"EMAS (PB)";"PB";"EMAS";11;6;5;22
2018;"ESPERANCA (PB)";"PB";"ESPERANCA";561;29;93;683
2018;"FAGUNDES (PB)";"PB";"FAGUNDES";44;14;32;90
2018;"FREI MARTINHO (PB)";"PB";"FREI MARTINHO";9;2;6;17
2018;"GADO BRAVO (PB)";"PB";"GADO BRAVO";54;33;20;107
2018;"GUARABIRA (PB)";"PB";"GUARABIRA";582;81;224;887
2018;"GURINHEM (PB)";"PB";"GURINHEM";56;11;29;96
2018;"GURJAO (PB)";"PB";"GURJAO";23;3;6;32
2018;"IBIARA (PB)";"PB";"IBIARA";13;3;4;20
2018;"IGARACY (PB)";"PB";"IGARACY";19;9;5;33
2018;"IMACULADA (PB)";"PB";"IMACULADA";17;14;6;37
2018;"INGA (PB)";"PB";"INGA";134;15;38;187
2018;"ITABAIANA (PB)";"PB";"ITABAIANA";154;19;42;215
2018;"ITAPORANGA (PB)";"PB";"ITAPORANGA";154;41;27;222
2018;"ITAPOROROCA (PB)";"PB";"ITAPOROROCA";133;5;38;176
2018;"ITATUBA (PB)";"PB";"ITATUBA";41;4;16;61
2018;"JACARAU (PB)";"PB";"JACARAU";70;7;23;100
2018;"JERICO (PB)";"PB";"JERICO";29;7;3;39
2018;"JOAO PESSOA (PB)";"PB";"JOAO PESSOA";6142;1130;2430;9702
2018;"JUAREZ TAVORA (PB)";"PB";"JUAREZ TAVORA";33;6;14;53
2018;"JUAZEIRINHO (PB)";"PB";"JUAZEIRINHO";82;17;19;118
2018;"JUNCO DO SERIDO (PB)";"PB";"JUNCO DO SERIDO";59;4;5;68
2018;"JURIPIRANGA (PB)";"PB";"JURIPIRANGA";55;4;23;82
2018;"JURU (PB)";"PB";"JURU";18;6;3;27
2018;"LAGOA (PB)";"PB";"LAGOA";17;3;6;26
2018;"LAGOA DE DENTRO (PB)";"PB";"LAGOA DE DENTRO";51;8;17;76
2018;"LAGOA SECA (PB)";"PB";"LAGOA SECA";270;45;18;333
2018;"LASTRO (PB)";"PB";"LASTRO";7;5;4;16
2018;"LIVRAMENTO (PB)";"PB";"LIVRAMENTO";41;6;6;53
2018;"LOGRADOURO (PB)";"PB";"LOGRADOURO";5;3;9;17
2018;"LUCENA (PB)";"PB";"LUCENA";29;5;25;59
2018;"MAE D AGUA (PB)";"PB";"MAE D AGUA";5;2;4;11
2018;"MALTA (PB)";"PB";"MALTA";12;8;3;23
2018;"MAMANGUAPE (PB)";"PB";"MAMANGUAPE";477;19;106;602
2018;"MANAIRA (PB)";"PB";"MANAIRA";30;15;3;48
2018;"MARCACAO (PB)";"PB";"MARCACAO";6;4;16;26
2018;"MARI (PB)";"PB";"MARI";119;10;59;188
2018;"MARIZOPOLIS (PB)";"PB";"MARIZOPOLIS";44;5;2;51
2018;"MASSARANDUBA (PB)";"PB";"MASSARANDUBA";50;32;14;96
2018;"MATARACA (PB)";"PB";"MATARACA";49;5;19;73
2018;"MATINHAS (PB)";"PB";"MATINHAS";15;3;4;22
2018;"MATO GROSSO (PB)";"PB";"MATO GROSSO";11;2;3;16
2018;"MATUREIA (PB)";"PB";"MATUREIA";22;36;9;67
2018;"MOGEIRO (PB)";"PB";"MOGEIRO";37;6;8;51
2018;"MONTADAS (PB)";"PB";"MONTADAS";58;7;8;73
2018;"MONTE HOREBE (PB)";"PB";"MONTE HOREBE";9;4;5;18
2018;"MONTEIRO (PB)";"PB";"MONTEIRO";317;83;65;465
2018;"MULUNGU (PB)";"PB";"MULUNGU";60;8;20;88
2018;"NATUBA (PB)";"PB";"NATUBA";35;8;6;49
2018;"NAZAREZINHO (PB)";"PB";"NAZAREZINHO";27;9;5;41
2018;"NOVA FLORESTA (PB)";"PB";"NOVA FLORESTA";36;8;9;53
2018;"NOVA OLINDA (PB)";"PB";"NOVA OLINDA";26;7;6;39
2018;"NOVA PALMEIRA (PB)";"PB";"NOVA PALMEIRA";35;1;4;40
2018;"OLHO D AGUA (PB)";"PB";"OLHO D AGUA";11;5;5;21
2018;"OLIVEDOS (PB)";"PB";"OLIVEDOS";45;4;12;61
2018;"OURO VELHO (PB)";"PB";"OURO VELHO";16;9;6;31
2018;"PARARI (PB)";"PB";"PARARI";8;2;2;12
2018;"PASSAGEM (PB)";"PB";"PASSAGEM";19;3;3;25
2018;"PATOS (PB)";"PB";"PATOS";698;149;62;909
2018;"PAULISTA (PB)";"PB";"PAULISTA";71;13;14;98
2018;"PEDRA BRANCA (PB)";"PB";"PEDRA BRANCA";12;7;5;24
2018;"PEDRA LAVRADA (PB)";"PB";"PEDRA LAVRADA";47;4;12;63
2018;"PEDRAS DE FOGO (PB)";"PB";"PEDRAS DE FOGO";304;40;101;445
2018;"PEDRO REGIS (PB)";"PB";"PEDRO REGIS";18;1;5;24
2018;"PIANCO (PB)";"PB";"PIANCO";95;22;7;124
2018;"PICUI (PB)";"PB";"PICUI";131;16;55;202
2018;"PILAR (PB)";"PB";"PILAR";34;4;13;51
2018;"PILOES (PB)";"PB";"PILOES";32;2;13;47
2018;"PILOEZINHOS (PB)";"PB";"PILOEZINHOS";12;3;6;21
2018;"PIRPIRITUBA (PB)";"PB";"PIRPIRITUBA";44;0;15;59
2018;"PITIMBU (PB)";"PB";"PITIMBU";40;34;11;85
2018;"POCINHOS (PB)";"PB";"POCINHOS";155;26;32;213
2018;"POCO DANTAS (PB)";"PB";"POCO DANTAS";8;1;5;14
2018;"POCO DE JOSE DE MOURA (PB)";"PB";"POCO DE JOSE DE MOURA";7;4;6;17
2018;"POMBAL (PB)";"PB";"POMBAL";345;65;20;430
2018;"PRATA (PB)";"PB";"PRATA";30;12;5;47
2018;"PRINCESA ISABEL (PB)";"PB";"PRINCESA ISABEL";131;113;25;269
2018;"PUXINANA (PB)";"PB";"PUXINANA";83;37;15;135
2018;"QUEIMADAS (PB)";"PB";"QUEIMADAS";517;120;96;733
2018;"QUIXABA (PB)";"PB";"QUIXABA";9;1;4;14
2018;"REMIGIO (PB)";"PB";"REMIGIO";281;8;31;320
2018;"RIACHAO (PB)";"PB";"RIACHAO";7;2;6;15
2018;"RIACHAO DO BACAMARTE (PB)";"PB";"RIACHAO DO BACAMARTE";30;4;5;39
2018;"RIACHAO DO POCO (PB)";"PB";"RIACHAO DO POCO";26;0;17;43
2018;"RIACHO DE SANTO ANTONIO (PB)";"PB";"RIACHO DE SANTO ANTONIO";17;7;3;27
2018;"RIACHO DOS CAVALOS (PB)";"PB";"RIACHO DOS CAVALOS";31;4;6;41
2018;"RIO TINTO (PB)";"PB";"RIO TINTO";113;15;53;181
2018;"SALGADINHO (PB)";"PB";"SALGADINHO";5;4;5;14
2018;"SALGADO DE SAO FELIX (PB)";"PB";"SALGADO DE SAO FELIX";25;9;14;48
2018;"SANTA CECILIA (PB)";"PB";"SANTA CECILIA";64;11;15;90
2018;"SANTA CRUZ (PB)";"PB";"SANTA CRUZ";18;2;17;37
2018;"SANTA HELENA (PB)";"PB";"SANTA HELENA";12;4;12;28
2018;"SANTA INES (PB)";"PB";"SANTA INES";11;3;3;17
2018;"SANTA LUZIA (PB)";"PB";"SANTA LUZIA";157;17;17;191
2018;"SANTA RITA (PB)";"PB";"SANTA RITA";947;100;300;1347
2018;"SANTA TERESINHA (PB)";"PB";"SANTA TERESINHA";27;3;5;35
2018;"SANTANA DE MANGUEIRA (PB)";"PB";"SANTANA DE MANGUEIRA";2;1;3;6
2018;"SANTANA DOS GARROTES (PB)";"PB";"SANTANA DOS GARROTES";20;13;4;37
2018;"SANTAREM (PB)";"PB";"SANTAREM";7;3;4;14
2018;"SANTO ANDRE (PB)";"PB";"SANTO ANDRE";18;5;25;48
2018;"SAO BENTINHO (PB)";"PB";"SAO BENTINHO";22;6;3;31
2018;"SAO BENTO (PB)";"PB";"SAO BENTO";222;34;31;287
2018;"SAO DOMINGOS DE POMBAL (PB)";"PB";"SAO DOMINGOS DE POMBAL";8;7;6;21
2018;"SAO DOMINGOS DO CARIRI (PB)";"PB";"SAO DOMINGOS DO CARIRI";8;7;5;20
2018;"SAO FRANCISCO (PB)";"PB";"SAO FRANCISCO";11;2;4;17
2018;"SAO JOAO DO CARIRI (PB)";"PB";"SAO JOAO DO CARIRI";35;5;10;50
2018;"SAO JOAO DO RIO DO PEIXE (PB)";"PB";"SAO JOAO DO RIO DO PEIXE";74;11;23;108
2018;"SAO JOAO DO TIGRE (PB)";"PB";"SAO JOAO DO TIGRE";16;3;5;24
2018;"SAO JOSE DA LAGOA TAPADA (PB)";"PB";"SAO JOSE DA LAGOA TAPADA";30;7;7;44
2018;"SAO JOSE DE CAIANA (PB)";"PB";"SAO JOSE DE CAIANA";11;10;7;28
2018;"SAO JOSE DE ESPINHARAS (PB)";"PB";"SAO JOSE DE ESPINHARAS";21;4;6;31
2018;"SAO JOSE DE PIRANHAS (PB)";"PB";"SAO JOSE DE PIRANHAS";56;18;10;84
2018;"SAO JOSE DE PRINCESA (PB)";"PB";"SAO JOSE DE PRINCESA";7;22;3;32
2018;"SAO JOSE DO BONFIM (PB)";"PB";"SAO JOSE DO BONFIM";11;2;4;17
2018;"SAO JOSE DO BREJO DO CRUZ (PB)";"PB";"SAO JOSE DO BREJO DO CRUZ";3;2;2;7
2018;"SAO JOSE DO SABUGI (PB)";"PB";"SAO JOSE DO SABUGI";24;2;6;32
2018;"SAO JOSE DOS CORDEIROS (PB)";"PB";"SAO JOSE DOS CORDEIROS";19;8;5;32
2018;"SAO JOSE DOS RAMOS (PB)";"PB";"SAO JOSE DOS RAMOS";23;0;13;36
2018;"SAO MAMEDE (PB)";"PB";"SAO MAMEDE";31;3;5;39
2018;"SAO MIGUEL DE TAIPU (PB)";"PB";"SAO MIGUEL DE TAIPU";25;0;8;33
2018;"SAO SEBASTIAO DE LAGOA DE ROCA (PB)";"PB";"SAO SEBASTIAO DE LAGOA DE ROCA";127;21;17;165
2018;"SAO SEBASTIAO DO UMBUZEIRO (PB)";"PB";"SAO SEBASTIAO DO UMBUZEIRO";12;4;4;20
2018;"SAO VICENTE DO SERIDO (PB)";"PB";"SAO VICENTE DO SERIDO";37;9;12;58
2018;"SAPE (PB)";"PB";"SAPE";413;33;119;565
2018;"SERRA BRANCA (PB)";"PB";"SERRA BRANCA";115;24;9;148
2018;"SERRA DA RAIZ (PB)";"PB";"SERRA DA RAIZ";9;1;7;17
2018;"SERRA GRANDE (PB)";"PB";"SERRA GRANDE";7;3;5;15
2018;"SERRA REDONDA (PB)";"PB";"SERRA REDONDA";31;12;5;48
2018;"SERRARIA (PB)";"PB";"SERRARIA";22;8;11;41
2018;"SERTAOZINHO (PB)";"PB";"SERTAOZINHO";12;4;17;33
2018;"SOBRADO (PB)";"PB";"SOBRADO";84;4;8;96
2018;"SOLANEA (PB)";"PB";"SOLANEA";262;44;43;349
2018;"SOLEDADE (PB)";"PB";"SOLEDADE";183;22;33;238
2018;"SOSSEGO (PB)";"PB";"SOSSEGO";27;5;6;38
2018;"SOUSA (PB)";"PB";"SOUSA";937;55;84;1076
2018;"SUME (PB)";"PB";"SUME";135;28;23;186
2018;"TACIMA (PB)";"PB";"TACIMA";38;6;18;62
2018;"TAPEROA (PB)";"PB";"TAPEROA";97;25;12;134
2018;"TAVARES (PB)";"PB";"TAVARES";26;14;12;52
2018;"TEIXEIRA (PB)";"PB";"TEIXEIRA";102;24;20;146
2018;"TENORIO (PB)";"PB";"TENORIO";14;1;4;19
2018;"TRIUNFO (PB)";"PB";"TRIUNFO";27;6;6;39
2018;"UIRAUNA (PB)";"PB";"UIRAUNA";81;14;5;100
2018;"UMBUZEIRO (PB)";"PB";"UMBUZEIRO";70;31;30;131
2018;"VARZEA (PB)";"PB";"VARZEA";16;6;4;26
2018;"VIEIROPOLIS (PB)";"PB";"VIEIROPOLIS";9;5;11;25
2018;"VISTA SERRANA (PB)";"PB";"VISTA SERRANA";17;2;5;24
2018;"ZABELE (PB)";"PB";"ZABELE";20;13;9;42
2018;"ABREU E LIMA (PE)";"PE";"ABREU E LIMA";636;88;391;1115
2018;"AFOGADOS DA INGAZEIRA (PE)";"PE";"AFOGADOS DA INGAZEIRA";507;108;91;706
2018;"AFRANIO (PE)";"PE";"AFRANIO";227;22;25;274
2018;"AGRESTINA (PE)";"PE";"AGRESTINA";212;51;31;294
2018;"AGUA PRETA (PE)";"PE";"AGUA PRETA";169;66;78;313
2018;"AGUAS BELAS (PE)";"PE";"AGUAS BELAS";370;86;58;514
2018;"ALAGOINHA (PE)";"PE";"ALAGOINHA";156;57;19;232
2018;"ALIANCA (PE)";"PE";"ALIANCA";181;25;143;349
2018;"ALTINHO (PE)";"PE";"ALTINHO";103;72;37;212
2018;"AMARAJI (PE)";"PE";"AMARAJI";128;31;57;216
2018;"ANGELIM (PE)";"PE";"ANGELIM";52;36;8;96
2018;"ARACOIABA (PE)";"PE";"ARACOIABA";90;28;97;215
2018;"ARARIPINA (PE)";"PE";"ARARIPINA";1108;91;83;1282
2018;"ARCOVERDE (PE)";"PE";"ARCOVERDE";1242;220;143;1605
2018;"BARRA DE GUABIRABA (PE)";"PE";"BARRA DE GUABIRABA";73;23;15;111
2018;"BARREIROS (PE)";"PE";"BARREIROS";283;37;78;398
2018;"BELEM DE MARIA (PE)";"PE";"BELEM DE MARIA";89;43;19;151
2018;"BELEM DE SAO FRANCISCO (PE)";"PE";"BELEM DE SAO FRANCISCO";119;38;24;181
2018;"BELO JARDIM (PE)";"PE";"BELO JARDIM";917;425;110;1452
2018;"BETANIA (PE)";"PE";"BETANIA";57;17;13;87
2018;"BEZERROS (PE)";"PE";"BEZERROS";898;174;113;1185
2018;"BODOCO (PE)";"PE";"BODOCO";255;11;26;292
2018;"BOM CONSELHO (PE)";"PE";"BOM CONSELHO";327;67;48;442
2018;"BOM JARDIM (PE)";"PE";"BOM JARDIM";290;331;55;676
2018;"BONITO (PE)";"PE";"BONITO";416;99;53;568
2018;"BREJAO (PE)";"PE";"BREJAO";72;23;16;111
2018;"BREJINHO (PE)";"PE";"BREJINHO";59;18;9;86
2018;"BREJO DA MADRE DE DEUS (PE)";"PE";"BREJO DA MADRE DE DEUS";442;471;21;934
2018;"BUENOS AIRES (PE)";"PE";"BUENOS AIRES";67;15;23;105
2018;"BUIQUE (PE)";"PE";"BUIQUE";294;127;53;474
2018;"CABO DE SANTO AGOSTINHO (PE)";"PE";"CABO DE SANTO AGOSTINHO";1531;277;520;2328
2018;"CABROBO (PE)";"PE";"CABROBO";282;22;29;333
2018;"CACHOEIRINHA (PE)";"PE";"CACHOEIRINHA";229;77;15;321
2018;"CAETES (PE)";"PE";"CAETES";319;76;46;441
2018;"CALCADO (PE)";"PE";"CALCADO";82;17;25;124
2018;"CALUMBI (PE)";"PE";"CALUMBI";59;6;8;73
2018;"CAMARAGIBE (PE)";"PE";"CAMARAGIBE";780;218;179;1177
2018;"CAMOCIM DE SAO FELIX (PE)";"PE";"CAMOCIM DE SAO FELIX";155;49;12;216
2018;"CAMUTANGA (PE)";"PE";"CAMUTANGA";99;4;19;122
2018;"CANHOTINHO (PE)";"PE";"CANHOTINHO";226;98;19;343
2018;"CAPOEIRAS (PE)";"PE";"CAPOEIRAS";280;62;28;370
2018;"CARNAIBA (PE)";"PE";"CARNAIBA";162;63;29;254
2018;"CARNAUBEIRA DA PENHA (PE)";"PE";"CARNAUBEIRA DA PENHA";50;14;7;71
2018;"CARPINA (PE)";"PE";"CARPINA";994;146;171;1311
2018;"CARUARU (PE)";"PE";"CARUARU";4923;939;789;6651
2018;"CASINHAS (PE)";"PE";"CASINHAS";92;141;21;254
2018;"CATENDE (PE)";"PE";"CATENDE";199;80;85;364
2018;"CEDRO (PE)";"PE";"CEDRO";43;7;14;64
2018;"CHA DE ALEGRIA (PE)";"PE";"CHA DE ALEGRIA";51;27;39;117
2018;"CHA GRANDE (PE)";"PE";"CHA GRANDE";330;68;34;432
2018;"CONDADO (PE)";"PE";"CONDADO";153;20;67;240
2018;"CORRENTES (PE)";"PE";"CORRENTES";82;51;16;149
2018;"CORTES (PE)";"PE";"CORTES";185;53;39;277
2018;"CUMARU (PE)";"PE";"CUMARU";187;113;19;319
2018;"CUPIRA (PE)";"PE";"CUPIRA";294;107;22;423
2018;"CUSTODIA (PE)";"PE";"CUSTODIA";394;103;44;541
2018;"DORMENTES (PE)";"PE";"DORMENTES";328;15;34;377
2018;"ESCADA (PE)";"PE";"ESCADA";381;91;159;631
2018;"EXU (PE)";"PE";"EXU";329;9;36;374
2018;"FEIRA NOVA (PE)";"PE";"FEIRA NOVA";268;58;27;353
2018;"FERNANDO DE NORONHA (PE)";"PE";"FERNANDO DE NORONHA";12;21;8;41
2018;"FERREIROS (PE)";"PE";"FERREIROS";92;1;51;144
2018;"FLORES (PE)";"PE";"FLORES";130;51;19;200
2018;"FLORESTA (PE)";"PE";"FLORESTA";510;33;38;581
2018;"FREI MIGUELINHO (PE)";"PE";"FREI MIGUELINHO";248;145;24;417
2018;"GAMELEIRA (PE)";"PE";"GAMELEIRA";89;16;66;171
2018;"GARANHUNS (PE)";"PE";"GARANHUNS";1784;320;165;2269
2018;"GLORIA DO GOITA (PE)";"PE";"GLORIA DO GOITA";210;73;50;333
2018;"GOIANA (PE)";"PE";"GOIANA";818;235;156;1209
2018;"GRANITO (PE)";"PE";"GRANITO";33;1;14;48
2018;"GRAVATA (PE)";"PE";"GRAVATA";1051;152;100;1303
2018;"IATI (PE)";"PE";"IATI";97;43;30;170
2018;"IBIMIRIM (PE)";"PE";"IBIMIRIM";214;61;24;299
2018;"IBIRAJUBA (PE)";"PE";"IBIRAJUBA";53;13;9;75
2018;"IGARASSU (PE)";"PE";"IGARASSU";957;130;594;1681
2018;"IGUARACI (PE)";"PE";"IGUARACI";140;32;34;206
2018;"ILHA DE ITAMARACA (PE)";"PE";"ILHA DE ITAMARACA";86;16;21;123
2018;"INAJA (PE)";"PE";"INAJA";74;16;15;105
2018;"INGAZEIRA (PE)";"PE";"INGAZEIRA";37;13;6;56
2018;"IPOJUCA (PE)";"PE";"IPOJUCA";749;341;411;1501
2018;"IPUBI (PE)";"PE";"IPUBI";293;14;36;343
2018;"ITACURUBA (PE)";"PE";"ITACURUBA";29;5;7;41
2018;"ITAIBA (PE)";"PE";"ITAIBA";171;46;27;244
2018;"ITAMBE (PE)";"PE";"ITAMBE";422;49;149;620
2018;"ITAPETIM (PE)";"PE";"ITAPETIM";83;8;11;102
2018;"ITAPISSUMA (PE)";"PE";"ITAPISSUMA";129;34;30;193
2018;"ITAQUITINGA (PE)";"PE";"ITAQUITINGA";43;22;43;108
2018;"JABOATAO DOS GUARARAPES (PE)";"PE";"JABOATAO DOS GUARARAPES";5631;742;2109;8482
2018;"JAQUEIRA (PE)";"PE";"JAQUEIRA";62;10;29;101
2018;"JATAUBA (PE)";"PE";"JATAUBA";195;222;16;433
2018;"JATOBA (PE)";"PE";"JATOBA";55;26;16;97
2018;"JOAO ALFREDO (PE)";"PE";"JOAO ALFREDO";271;631;28;930
2018;"JOAQUIM NABUCO (PE)";"PE";"JOAQUIM NABUCO";83;20;58;161
2018;"JUCATI (PE)";"PE";"JUCATI";127;32;31;190
2018;"JUPI (PE)";"PE";"JUPI";239;48;52;339
2018;"JUREMA (PE)";"PE";"JUREMA";83;47;18;148
2018;"LAGOA DO CARRO (PE)";"PE";"LAGOA DO CARRO";107;13;24;144
2018;"LAGOA DO ITAENGA (PE)";"PE";"LAGOA DO ITAENGA";440;51;64;555
2018;"LAGOA DO OURO (PE)";"PE";"LAGOA DO OURO";52;29;18;99
2018;"LAGOA DOS GATOS (PE)";"PE";"LAGOA DOS GATOS";112;43;9;164
2018;"LAGOA GRANDE (PE)";"PE";"LAGOA GRANDE";176;7;19;202
2018;"LAJEDO (PE)";"PE";"LAJEDO";632;115;63;810
2018;"LIMOEIRO (PE)";"PE";"LIMOEIRO";557;152;89;798
2018;"MACAPARANA (PE)";"PE";"MACAPARANA";218;16;53;287
2018;"MACHADOS (PE)";"PE";"MACHADOS";182;44;21;247
2018;"MANARI (PE)";"PE";"MANARI";62;24;12;98
2018;"MARAIAL (PE)";"PE";"MARAIAL";128;21;30;179
2018;"MIRANDIBA (PE)";"PE";"MIRANDIBA";125;5;11;141
2018;"MOREILANDIA (PE)";"PE";"MOREILANDIA";70;5;10;85
2018;"MORENO (PE)";"PE";"MORENO";754;166;147;1067
2018;"NAZARE DA MATA (PE)";"PE";"NAZARE DA MATA";235;30;61;326
2018;"OLINDA (PE)";"PE";"OLINDA";3103;442;1387;4932
2018;"OROBO (PE)";"PE";"OROBO";220;226;79;525
2018;"OROCO (PE)";"PE";"OROCO";97;2;14;113
2018;"OURICURI (PE)";"PE";"OURICURI";700;41;117;858
2018;"PALMARES (PE)";"PE";"PALMARES";521;102;213;836
2018;"PALMEIRINA (PE)";"PE";"PALMEIRINA";24;21;7;52
2018;"PANELAS (PE)";"PE";"PANELAS";120;82;25;227
2018;"PARANATAMA (PE)";"PE";"PARANATAMA";149;42;23;214
2018;"PARNAMIRIM (PE)";"PE";"PARNAMIRIM";302;10;31;343
2018;"PASSIRA (PE)";"PE";"PASSIRA";301;153;34;488
2018;"PAUDALHO (PE)";"PE";"PAUDALHO";595;47;86;728
2018;"PAULISTA (PE)";"PE";"PAULISTA";1688;379;337;2404
2018;"PEDRA (PE)";"PE";"PEDRA";183;73;26;282
2018;"PESQUEIRA (PE)";"PE";"PESQUEIRA";817;165;150;1132
2018;"PETROLANDIA (PE)";"PE";"PETROLANDIA";364;20;62;446
2018;"PETROLINA (PE)";"PE";"PETROLINA";4473;280;609;5362
2018;"POCAO (PE)";"PE";"POCAO";66;50;14;130
2018;"POMBOS (PE)";"PE";"POMBOS";500;66;66;632
2018;"PRIMAVERA (PE)";"PE";"PRIMAVERA";97;14;46;157
2018;"QUIPAPA (PE)";"PE";"QUIPAPA";107;37;46;190
2018;"QUIXABA (PE)";"PE";"QUIXABA";49;28;12;89
2018;"RECIFE (PE)";"PE";"RECIFE";19666;2474;3934;26074
2018;"RIACHO DAS ALMAS (PE)";"PE";"RIACHO DAS ALMAS";393;118;29;540
2018;"RIBEIRAO (PE)";"PE";"RIBEIRAO";261;52;110;423
2018;"RIO FORMOSO (PE)";"PE";"RIO FORMOSO";113;39;86;238
2018;"SAIRE (PE)";"PE";"SAIRE";107;13;21;141
2018;"SALGADINHO (PE)";"PE";"SALGADINHO";20;62;6;88
2018;"SALGUEIRO (PE)";"PE";"SALGUEIRO";566;56;83;705
2018;"SALOA (PE)";"PE";"SALOA";81;40;14;135
2018;"SANHARO (PE)";"PE";"SANHARO";160;42;43;245
2018;"SANTA CRUZ (PE)";"PE";"SANTA CRUZ";194;7;28;229
2018;"SANTA CRUZ DA BAIXA VERDE (PE)";"PE";"SANTA CRUZ DA BAIXA VERDE";214;12;11;237
2018;"SANTA CRUZ DO CAPIBARIBE (PE)";"PE";"SANTA CRUZ DO CAPIBARIBE";1051;419;76;1546
2018;"SANTA FILOMENA (PE)";"PE";"SANTA FILOMENA";145;11;33;189
2018;"SANTA MARIA DA BOA VISTA (PE)";"PE";"SANTA MARIA DA BOA VISTA";285;19;80;384
2018;"SANTA MARIA DO CAMBUCA (PE)";"PE";"SANTA MARIA DO CAMBUCA";221;121;31;373
2018;"SANTA TEREZINHA (PE)";"PE";"SANTA TEREZINHA";90;16;8;114
2018;"SAO BENEDITO DO SUL (PE)";"PE";"SAO BENEDITO DO SUL";33;15;17;65
2018;"SAO BENTO DO UNA (PE)";"PE";"SAO BENTO DO UNA";1056;89;132;1277
2018;"SAO CAITANO (PE)";"PE";"SAO CAITANO";424;288;42;754
2018;"SAO JOAO (PE)";"PE";"SAO JOAO";137;67;34;238
2018;"SAO JOAQUIM DO MONTE (PE)";"PE";"SAO JOAQUIM DO MONTE";93;47;28;168
2018;"SAO JOSE DA COROA GRANDE (PE)";"PE";"SAO JOSE DA COROA GRANDE";74;21;37;132
2018;"SAO JOSE DO BELMONTE (PE)";"PE";"SAO JOSE DO BELMONTE";338;41;59;438
2018;"SAO JOSE DO EGITO (PE)";"PE";"SAO JOSE DO EGITO";528;54;74;656
2018;"SAO LOURENCO DA MATA (PE)";"PE";"SAO LOURENCO DA MATA";439;111;534;1084
2018;"SAO VICENTE FERRER (PE)";"PE";"SAO VICENTE FERRER";199;14;20;233
2018;"SERRA TALHADA (PE)";"PE";"SERRA TALHADA";1638;128;92;1858
2018;"SERRITA (PE)";"PE";"SERRITA";102;6;15;123
2018;"SERTANIA (PE)";"PE";"SERTANIA";492;83;63;638
2018;"SIRINHAEM (PE)";"PE";"SIRINHAEM";231;41;100;372
2018;"SOLIDAO (PE)";"PE";"SOLIDAO";26;5;9;40
2018;"SURUBIM (PE)";"PE";"SURUBIM";919;720;119;1758
2018;"TABIRA (PE)";"PE";"TABIRA";298;54;51;403
2018;"TACAIMBO (PE)";"PE";"TACAIMBO";115;49;21;185
2018;"TACARATU (PE)";"PE";"TACARATU";74;42;13;129
2018;"TAMANDARE (PE)";"PE";"TAMANDARE";73;33;34;140
2018;"TAQUARITINGA DO NORTE (PE)";"PE";"TAQUARITINGA DO NORTE";345;104;46;495
2018;"TEREZINHA (PE)";"PE";"TEREZINHA";29;15;20;64
2018;"TERRA NOVA (PE)";"PE";"TERRA NOVA";76;1;11;88
2018;"TIMBAUBA (PE)";"PE";"TIMBAUBA";647;44;122;813
2018;"TORITAMA (PE)";"PE";"TORITAMA";327;81;36;444
2018;"TRACUNHAEM (PE)";"PE";"TRACUNHAEM";56;25;19;100
2018;"TRINDADE (PE)";"PE";"TRINDADE";389;48;21;458
2018;"TRIUNFO (PE)";"PE";"TRIUNFO";261;28;15;304
2018;"TUPANATINGA (PE)";"PE";"TUPANATINGA";150;57;30;237
2018;"TUPARETAMA (PE)";"PE";"TUPARETAMA";119;41;20;180
2018;"VENTUROSA (PE)";"PE";"VENTUROSA";201;49;14;264
2018;"VERDEJANTE (PE)";"PE";"VERDEJANTE";72;8;19;99
2018;"VERTENTE DO LERIO (PE)";"PE";"VERTENTE DO LERIO";94;117;18;229
2018;"VERTENTES (PE)";"PE";"VERTENTES";234;92;26;352
2018;"VICENCIA (PE)";"PE";"VICENCIA";312;20;88;420
2018;"VITORIA DE SANTO ANTAO (PE)";"PE";"VITORIA DE SANTO ANTAO";2399;167;383;2949
2018;"XEXEU (PE)";"PE";"XEXEU";76;19;41;136
2018;"ACAUA (PI)";"PI";"ACAUA";132;28;33;193
2018;"AGRICOLANDIA (PI)";"PI";"AGRICOLANDIA";20;4;8;32
2018;"AGUA BRANCA (PI)";"PI";"AGUA BRANCA";217;19;30;266
2018;"ALAGOINHA DO PIAUI (PI)";"PI";"ALAGOINHA DO PIAUI";69;5;5;79
2018;"ALEGRETE DO PIAUI (PI)";"PI";"ALEGRETE DO PIAUI";49;5;4;58
2018;"ALTO LONGA (PI)";"PI";"ALTO LONGA";57;12;37;106
2018;"ALTOS (PI)";"PI";"ALTOS";313;17;67;397
2018;"ALVORADA DO GURGUEIA (PI)";"PI";"ALVORADA DO GURGUEIA";24;3;10;37
2018;"AMARANTE (PI)";"PI";"AMARANTE";89;17;27;133
2018;"ANGICAL DO PIAUI (PI)";"PI";"ANGICAL DO PIAUI";29;4;11;44
2018;"ANISIO DE ABREU (PI)";"PI";"ANISIO DE ABREU";57;15;14;86
2018;"ANTONIO ALMEIDA (PI)";"PI";"ANTONIO ALMEIDA";30;4;6;40
2018;"AROAZES (PI)";"PI";"AROAZES";23;8;11;42
2018;"AROEIRAS DO ITAIM (PI)";"PI";"AROEIRAS DO ITAIM";15;0;13;28
2018;"ARRAIAL (PI)";"PI";"ARRAIAL";14;2;4;20
2018;"ASSUNCAO DO PIAUI (PI)";"PI";"ASSUNCAO DO PIAUI";13;0;4;17
2018;"AVELINO LOPES (PI)";"PI";"AVELINO LOPES";35;11;7;53
2018;"BAIXA GRANDE DO RIBEIRO (PI)";"PI";"BAIXA GRANDE DO RIBEIRO";122;3;20;145
2018;"BARRA D ALCANTARA (PI)";"PI";"BARRA D ALCANTARA";21;3;5;29
2018;"BARRAS (PI)";"PI";"BARRAS";170;19;107;296
2018;"BARREIRAS DO PIAUI (PI)";"PI";"BARREIRAS DO PIAUI";6;1;2;9
2018;"BARRO DURO (PI)";"PI";"BARRO DURO";54;6;6;66
2018;"BATALHA (PI)";"PI";"BATALHA";100;14;24;138
2018;"BELA VISTA DO PIAUI (PI)";"PI";"BELA VISTA DO PIAUI";18;2;7;27
2018;"BELEM DO PIAUI (PI)";"PI";"BELEM DO PIAUI";40;3;3;46
2018;"BENEDITINOS (PI)";"PI";"BENEDITINOS";41;3;15;59
2018;"BERTOLINIA (PI)";"PI";"BERTOLINIA";29;12;14;55
2018;"BETANIA DO PIAUI (PI)";"PI";"BETANIA DO PIAUI";93;21;15;129
2018;"BOA HORA (PI)";"PI";"BOA HORA";22;2;12;36
2018;"BOCAINA (PI)";"PI";"BOCAINA";12;9;4;25
2018;"BOM JESUS (PI)";"PI";"BOM JESUS";344;18;30;392
2018;"BOM PRINCIPIO DO PIAUI (PI)";"PI";"BOM PRINCIPIO DO PIAUI";13;4;11;28
2018;"BONFIM DO PIAUI (PI)";"PI";"BONFIM DO PIAUI";50;4;10;64
2018;"BOQUEIRAO DO PIAUI (PI)";"PI";"BOQUEIRAO DO PIAUI";20;2;5;27
2018;"BRASILEIRA (PI)";"PI";"BRASILEIRA";29;7;11;47
2018;"BREJO DO PIAUI (PI)";"PI";"BREJO DO PIAUI";13;6;3;22
2018;"BURITI DOS LOPES (PI)";"PI";"BURITI DOS LOPES";64;12;24;100
2018;"BURITI DOS MONTES (PI)";"PI";"BURITI DOS MONTES";17;10;5;32
2018;"CABECEIRAS DO PIAUI (PI)";"PI";"CABECEIRAS DO PIAUI";32;3;30;65
2018;"CAJAZEIRAS DO PIAUI (PI)";"PI";"CAJAZEIRAS DO PIAUI";6;0;2;8
2018;"CAJUEIRO DA PRAIA (PI)";"PI";"CAJUEIRO DA PRAIA";17;3;16;36
2018;"CALDEIRAO GRANDE DO PIAUI (PI)";"PI";"CALDEIRAO GRANDE DO PIAUI";47;20;16;83
2018;"CAMPINAS DO PIAUI (PI)";"PI";"CAMPINAS DO PIAUI";12;6;2;20
2018;"CAMPO ALEGRE DO FIDALGO (PI)";"PI";"CAMPO ALEGRE DO FIDALGO";39;5;4;48
2018;"CAMPO GRANDE DO PIAUI (PI)";"PI";"CAMPO GRANDE DO PIAUI";57;14;5;76
2018;"CAMPO LARGO DO PIAUI (PI)";"PI";"CAMPO LARGO DO PIAUI";11;2;5;18
2018;"CAMPO MAIOR (PI)";"PI";"CAMPO MAIOR";482;41;99;622
2018;"CANAVIEIRA (PI)";"PI";"CANAVIEIRA";4;3;1;8
2018;"CANTO DO BURITI (PI)";"PI";"CANTO DO BURITI";127;41;23;191
2018;"CAPITAO DE CAMPOS (PI)";"PI";"CAPITAO DE CAMPOS";45;4;14;63
2018;"CAPITAO GERVASIO OLIVEIRA (PI)";"PI";"CAPITAO GERVASIO OLIVEIRA";30;3;8;41
2018;"CARACOL (PI)";"PI";"CARACOL";77;7;8;92
2018;"CARAUBAS DO PIAUI (PI)";"PI";"CARAUBAS DO PIAUI";30;4;10;44
2018;"CARIDADE DO PIAUI (PI)";"PI";"CARIDADE DO PIAUI";26;1;7;34
2018;"CASTELO DO PIAUI (PI)";"PI";"CASTELO DO PIAUI";78;17;27;122
2018;"CAXINGO (PI)";"PI";"CAXINGO";18;4;9;31
2018;"COCAL (PI)";"PI";"COCAL";196;29;38;263
2018;"COCAL DE TELHA (PI)";"PI";"COCAL DE TELHA";11;5;5;21
2018;"COCAL DOS ALVES (PI)";"PI";"COCAL DOS ALVES";10;15;4;29
2018;"COIVARAS (PI)";"PI";"COIVARAS";14;2;6;22
2018;"COLONIA DO GURGUEIA (PI)";"PI";"COLONIA DO GURGUEIA";21;14;3;38
2018;"COLONIA DO PIAUI (PI)";"PI";"COLONIA DO PIAUI";18;8;9;35
2018;"CONCEICAO DO CANINDE (PI)";"PI";"CONCEICAO DO CANINDE";21;4;5;30
2018;"CORONEL JOSE DIAS (PI)";"PI";"CORONEL JOSE DIAS";20;11;6;37
2018;"CORRENTE (PI)";"PI";"CORRENTE";522;42;78;642
2018;"CRISTALANDIA DO PIAUI (PI)";"PI";"CRISTALANDIA DO PIAUI";25;6;4;35
2018;"CRISTINO CASTRO (PI)";"PI";"CRISTINO CASTRO";56;6;17;79
2018;"CURIMATA (PI)";"PI";"CURIMATA";71;3;9;83
2018;"CURRAIS (PI)";"PI";"CURRAIS";6;2;2;10
2018;"CURRAL NOVO DO PIAUI (PI)";"PI";"CURRAL NOVO DO PIAUI";23;4;4;31
2018;"CURRALINHOS (PI)";"PI";"CURRALINHOS";7;0;2;9
2018;"DEMERVAL LOBAO (PI)";"PI";"DEMERVAL LOBAO";92;8;42;142
2018;"DIRCEU ARCOVERDE (PI)";"PI";"DIRCEU ARCOVERDE";89;13;8;110
2018;"DOM EXPEDITO LOPES (PI)";"PI";"DOM EXPEDITO LOPES";82;9;7;98
2018;"DOM INOCENCIO (PI)";"PI";"DOM INOCENCIO";98;26;21;145
2018;"DOMINGOS MOURAO (PI)";"PI";"DOMINGOS MOURAO";5;1;5;11
2018;"ELESBAO VELOSO (PI)";"PI";"ELESBAO VELOSO";81;12;10;103
2018;"ELISEU MARTINS (PI)";"PI";"ELISEU MARTINS";14;5;3;22
2018;"ESPERANTINA (PI)";"PI";"ESPERANTINA";260;31;67;358
2018;"FARTURA DO PIAUI (PI)";"PI";"FARTURA DO PIAUI";28;11;4;43
2018;"FLORES DO PIAUI (PI)";"PI";"FLORES DO PIAUI";15;7;3;25
2018;"FLORESTA DO PIAUI (PI)";"PI";"FLORESTA DO PIAUI";14;4;5;23
2018;"FLORIANO (PI)";"PI";"FLORIANO";1207;128;83;1418
2018;"FRANCINOPOLIS (PI)";"PI";"FRANCINOPOLIS";20;15;2;37
2018;"FRANCISCO AYRES (PI)";"PI";"FRANCISCO AYRES";10;10;7;27
2018;"FRANCISCO MACEDO (PI)";"PI";"FRANCISCO MACEDO";41;10;9;60
2018;"FRANCISCO SANTOS (PI)";"PI";"FRANCISCO SANTOS";85;9;8;102
2018;"FRONTEIRAS (PI)";"PI";"FRONTEIRAS";163;30;16;209
2018;"GEMINIANO (PI)";"PI";"GEMINIANO";43;14;11;68
2018;"GILBUES (PI)";"PI";"GILBUES";19;8;14;41
2018;"GUADALUPE (PI)";"PI";"GUADALUPE";100;16;9;125
2018;"GUARIBAS (PI)";"PI";"GUARIBAS";14;1;5;20
2018;"HUGO NAPOLEAO (PI)";"PI";"HUGO NAPOLEAO";10;0;2;12
2018;"ILHA GRANDE (PI)";"PI";"ILHA GRANDE";16;7;9;32
2018;"INHUMA (PI)";"PI";"INHUMA";123;8;21;152
2018;"IPIRANGA DO PIAUI (PI)";"PI";"IPIRANGA DO PIAUI";68;15;10;93
2018;"ISAIAS COELHO (PI)";"PI";"ISAIAS COELHO";19;1;8;28
2018;"ITAINOPOLIS (PI)";"PI";"ITAINOPOLIS";63;30;24;117
2018;"ITAUEIRA (PI)";"PI";"ITAUEIRA";77;11;5;93
2018;"JACOBINA DO PIAUI (PI)";"PI";"JACOBINA DO PIAUI";82;5;1;88
2018;"JAICOS (PI)";"PI";"JAICOS";154;25;15;194
2018;"JARDIM DO MULATO (PI)";"PI";"JARDIM DO MULATO";11;1;3;15
2018;"JATOBA DO PIAUI (PI)";"PI";"JATOBA DO PIAUI";39;1;14;54
2018;"JERUMENHA (PI)";"PI";"JERUMENHA";23;2;1;26
2018;"JOAO COSTA (PI)";"PI";"JOAO COSTA";8;0;3;11
2018;"JOAQUIM PIRES (PI)";"PI";"JOAQUIM PIRES";49;6;15;70
2018;"JOCA MARQUES (PI)";"PI";"JOCA MARQUES";11;1;6;18
2018;"JOSE DE FREITAS (PI)";"PI";"JOSE DE FREITAS";152;16;101;269
2018;"JUAZEIRO DO PIAUI (PI)";"PI";"JUAZEIRO DO PIAUI";26;3;6;35
2018;"JULIO BORGES (PI)";"PI";"JULIO BORGES";17;6;5;28
2018;"JUREMA (PI)";"PI";"JUREMA";25;3;23;51
2018;"LAGOA ALEGRE (PI)";"PI";"LAGOA ALEGRE";16;2;27;45
2018;"LAGOA DE SAO FRANCISCO (PI)";"PI";"LAGOA DE SAO FRANCISCO";12;6;3;21
2018;"LAGOA DO BARRO DO PIAUI (PI)";"PI";"LAGOA DO BARRO DO PIAUI";34;10;11;55
2018;"LAGOA DO PIAUI (PI)";"PI";"LAGOA DO PIAUI";18;0;8;26
2018;"LAGOA DO SITIO (PI)";"PI";"LAGOA DO SITIO";16;3;4;23
2018;"LAGOINHA DO PIAUI (PI)";"PI";"LAGOINHA DO PIAUI";6;0;3;9
2018;"LANDRI SALES (PI)";"PI";"LANDRI SALES";25;5;1;31
2018;"LUIS CORREIA (PI)";"PI";"LUIS CORREIA";96;23;64;183
2018;"LUZILANDIA (PI)";"PI";"LUZILANDIA";134;37;53;224
2018;"MADEIRO (PI)";"PI";"MADEIRO";11;4;3;18
2018;"MANOEL EMIDIO (PI)";"PI";"MANOEL EMIDIO";18;3;6;27
2018;"MARCOLANDIA (PI)";"PI";"MARCOLANDIA";632;61;15;708
2018;"MARCOS PARENTE (PI)";"PI";"MARCOS PARENTE";13;2;3;18
2018;"MASSAPE DO PIAUI (PI)";"PI";"MASSAPE DO PIAUI";26;1;5;32
2018;"MATIAS OLIMPIO (PI)";"PI";"MATIAS OLIMPIO";35;7;8;50
2018;"MIGUEL ALVES (PI)";"PI";"MIGUEL ALVES";66;6;39;111
2018;"MIGUEL LEAO (PI)";"PI";"MIGUEL LEAO";7;0;1;8
2018;"MILTON BRANDAO (PI)";"PI";"MILTON BRANDAO";17;3;6;26
2018;"MONSENHOR GIL (PI)";"PI";"MONSENHOR GIL";38;6;8;52
2018;"MONSENHOR HIPOLITO (PI)";"PI";"MONSENHOR HIPOLITO";55;13;7;75
2018;"MONTE ALEGRE DO PIAUI (PI)";"PI";"MONTE ALEGRE DO PIAUI";32;4;12;48
2018;"MORRO CABECA NO TEMPO (PI)";"PI";"MORRO CABECA NO TEMPO";7;1;4;12
2018;"MORRO DO CHAPEU DO PIAUI (PI)";"PI";"MORRO DO CHAPEU DO PIAUI";7;8;14;29
2018;"MURICI DOS PORTELAS (PI)";"PI";"MURICI DOS PORTELAS";13;1;9;23
2018;"NAZARE DO PIAUI (PI)";"PI";"NAZARE DO PIAUI";25;14;7;46
2018;"NAZARIA (PI)";"PI";"NAZARIA";21;0;12;33
2018;"NOSSA SENHORA DE NAZARE (PI)";"PI";"NOSSA SENHORA DE NAZARE";19;6;14;39
2018;"NOSSA SENHORA DOS REMEDIOS (PI)";"PI";"NOSSA SENHORA DOS REMEDIOS";14;4;5;23
2018;"NOVA SANTA RITA (PI)";"PI";"NOVA SANTA RITA";3;5;5;13
2018;"NOVO ORIENTE DO PIAUI (PI)";"PI";"NOVO ORIENTE DO PIAUI";19;5;12;36
2018;"NOVO SANTO ANTONIO (PI)";"PI";"NOVO SANTO ANTONIO";14;1;4;19
2018;"OEIRAS (PI)";"PI";"OEIRAS";373;86;55;514
2018;"OLHO D AGUA DO PIAUI (PI)";"PI";"OLHO D AGUA DO PIAUI";7;2;3;12
2018;"PADRE MARCOS (PI)";"PI";"PADRE MARCOS";115;12;8;135
2018;"PAES LANDIM (PI)";"PI";"PAES LANDIM";10;9;3;22
2018;"PAJEU DO PIAUI (PI)";"PI";"PAJEU DO PIAUI";13;8;3;24
2018;"PALMEIRA DO PIAUI (PI)";"PI";"PALMEIRA DO PIAUI";44;3;6;53
2018;"PALMEIRAIS (PI)";"PI";"PALMEIRAIS";20;3;14;37
2018;"PAQUETA (PI)";"PI";"PAQUETA";24;6;7;37
2018;"PARNAGUA (PI)";"PI";"PARNAGUA";27;5;5;37
2018;"PARNAIBA (PI)";"PI";"PARNAIBA";1388;122;333;1843
2018;"PASSAGEM FRANCA DO PIAUI (PI)";"PI";"PASSAGEM FRANCA DO PIAUI";11;2;6;19
2018;"PATOS DO PIAUI (PI)";"PI";"PATOS DO PIAUI";25;4;9;38
2018;"PAU D ARCO DO PIAUI (PI)";"PI";"PAU D ARCO DO PIAUI";11;0;7;18
2018;"PAULISTANA (PI)";"PI";"PAULISTANA";520;108;136;764
2018;"PAVUSSU (PI)";"PI";"PAVUSSU";17;2;2;21
2018;"PEDRO II (PI)";"PI";"PEDRO II";154;47;24;225
2018;"PEDRO LAURENTINO (PI)";"PI";"PEDRO LAURENTINO";5;2;2;9
2018;"PICOS (PI)";"PI";"PICOS";1886;167;112;2165
2018;"PIMENTEIRAS (PI)";"PI";"PIMENTEIRAS";50;11;7;68
2018;"PIO IX (PI)";"PI";"PIO IX";132;14;20;166
2018;"PIRACURUCA (PI)";"PI";"PIRACURUCA";319;21;73;413
2018;"PIRIPIRI (PI)";"PI";"PIRIPIRI";421;75;185;681
2018;"PORTO (PI)";"PI";"PORTO";15;6;5;26
2018;"PORTO ALEGRE DO PIAUI (PI)";"PI";"PORTO ALEGRE DO PIAUI";11;5;2;18
2018;"PRATA DO PIAUI (PI)";"PI";"PRATA DO PIAUI";11;1;2;14
2018;"QUEIMADA NOVA (PI)";"PI";"QUEIMADA NOVA";113;10;33;156
2018;"REDENCAO DO GURGUEIA (PI)";"PI";"REDENCAO DO GURGUEIA";21;6;14;41
2018;"REGENERACAO (PI)";"PI";"REGENERACAO";102;10;18;130
2018;"RIACHO FRIO (PI)";"PI";"RIACHO FRIO";8;3;6;17
2018;"RIBEIRA DO PIAUI (PI)";"PI";"RIBEIRA DO PIAUI";13;3;3;19
2018;"RIBEIRO GONCALVES (PI)";"PI";"RIBEIRO GONCALVES";30;1;4;35
2018;"RIO GRANDE DO PIAUI (PI)";"PI";"RIO GRANDE DO PIAUI";28;10;6;44
2018;"SANTA CRUZ DO PIAUI (PI)";"PI";"SANTA CRUZ DO PIAUI";29;23;5;57
2018;"SANTA CRUZ DOS MILAGRES (PI)";"PI";"SANTA CRUZ DOS MILAGRES";9;1;3;13
2018;"SANTA FILOMENA (PI)";"PI";"SANTA FILOMENA";35;0;6;41
2018;"SANTA LUZ (PI)";"PI";"SANTA LUZ";15;2;5;22
2018;"SANTA ROSA DO PIAUI (PI)";"PI";"SANTA ROSA DO PIAUI";18;10;14;42
2018;"SANTANA DO PIAUI (PI)";"PI";"SANTANA DO PIAUI";31;14;16;61
2018;"SANTO ANTONIO DE LISBOA (PI)";"PI";"SANTO ANTONIO DE LISBOA";60;16;6;82
2018;"SANTO ANTONIO DOS MILAGRES (PI)";"PI";"SANTO ANTONIO DOS MILAGRES";3;3;2;8
2018;"SANTO INACIO DO PIAUI (PI)";"PI";"SANTO INACIO DO PIAUI";14;8;2;24
2018;"SAO BRAZ DO PIAUI (PI)";"PI";"SAO BRAZ DO PIAUI";39;4;6;49
2018;"SAO FELIX DO PIAUI (PI)";"PI";"SAO FELIX DO PIAUI";8;2;3;13
2018;"SAO FRANCISCO DE ASSIS DO PIAU (PI)";"PI";"SAO FRANCISCO DE ASSIS DO PIAU";24;7;7;38
2018;"SAO FRANCISCO DO PIAUI (PI)";"PI";"SAO FRANCISCO DO PIAUI";12;15;8;35
2018;"SAO GONCALO DO GURGUEIA (PI)";"PI";"SAO GONCALO DO GURGUEIA";5;1;1;7
2018;"SAO GONCALO DO PIAUI (PI)";"PI";"SAO GONCALO DO PIAUI";16;4;4;24
2018;"SAO JOAO DA CANABRAVA (PI)";"PI";"SAO JOAO DA CANABRAVA";21;11;6;38
2018;"SAO JOAO DA FRONTEIRA (PI)";"PI";"SAO JOAO DA FRONTEIRA";7;2;7;16
2018;"SAO JOAO DA SERRA (PI)";"PI";"SAO JOAO DA SERRA";24;0;3;27
2018;"SAO JOAO DA VARJOTA (PI)";"PI";"SAO JOAO DA VARJOTA";7;8;6;21
2018;"SAO JOAO DO ARRAIAL (PI)";"PI";"SAO JOAO DO ARRAIAL";16;4;9;29
2018;"SAO JOAO DO PIAUI (PI)";"PI";"SAO JOAO DO PIAUI";142;40;23;205
2018;"SAO JOSE DO DIVINO (PI)";"PI";"SAO JOSE DO DIVINO";34;4;5;43
2018;"SAO JOSE DO PEIXE (PI)";"PI";"SAO JOSE DO PEIXE";10;1;5;16
2018;"SAO JOSE DO PIAUI (PI)";"PI";"SAO JOSE DO PIAUI";37;11;10;58
2018;"SAO JULIAO (PI)";"PI";"SAO JULIAO";41;12;5;58
2018;"SAO LOURENCO DO PIAUI (PI)";"PI";"SAO LOURENCO DO PIAUI";11;5;6;22
2018;"SAO LUIS DO PIAUI (PI)";"PI";"SAO LUIS DO PIAUI";13;5;2;20
2018;"SAO MIGUEL DA BAIXA GRANDE (PI)";"PI";"SAO MIGUEL DA BAIXA GRANDE";11;3;4;18
2018;"SAO MIGUEL DO FIDALGO (PI)";"PI";"SAO MIGUEL DO FIDALGO";7;2;4;13
2018;"SAO MIGUEL DO TAPUIO (PI)";"PI";"SAO MIGUEL DO TAPUIO";54;5;24;83
2018;"SAO PEDRO DO PIAUI (PI)";"PI";"SAO PEDRO DO PIAUI";58;5;9;72
2018;"SAO RAIMUNDO NONATO (PI)";"PI";"SAO RAIMUNDO NONATO";921;211;158;1290
2018;"SEBASTIAO BARROS (PI)";"PI";"SEBASTIAO BARROS";11;2;3;16
2018;"SEBASTIAO LEAL (PI)";"PI";"SEBASTIAO LEAL";50;3;3;56
2018;"SIGEFREDO PACHECO (PI)";"PI";"SIGEFREDO PACHECO";48;13;12;73
2018;"SIMOES (PI)";"PI";"SIMOES";137;18;14;169
2018;"SIMPLICIO MENDES (PI)";"PI";"SIMPLICIO MENDES";83;16;12;111
2018;"SOCORRO DO PIAUI (PI)";"PI";"SOCORRO DO PIAUI";10;7;3;20
2018;"SUSSUAPARA (PI)";"PI";"SUSSUAPARA";56;23;9;88
2018;"TAMBORIL DO PIAUI (PI)";"PI";"TAMBORIL DO PIAUI";6;4;2;12
2018;"TANQUE DO PIAUI (PI)";"PI";"TANQUE DO PIAUI";15;3;4;22
2018;"TERESINA (PI)";"PI";"TERESINA";11791;1214;3996;17001
2018;"UNIAO (PI)";"PI";"UNIAO";189;59;82;330
2018;"URUCUI (PI)";"PI";"URUCUI";217;15;28;260
2018;"VALENCA DO PIAUI (PI)";"PI";"VALENCA DO PIAUI";199;40;37;276
2018;"VARZEA BRANCA (PI)";"PI";"VARZEA BRANCA";44;13;29;86
2018;"VARZEA GRANDE (PI)";"PI";"VARZEA GRANDE";18;4;4;26
2018;"VERA MENDES (PI)";"PI";"VERA MENDES";22;5;4;31
2018;"VILA NOVA DO PIAUI (PI)";"PI";"VILA NOVA DO PIAUI";25;11;5;41
2018;"WALL FERRAZ (PI)";"PI";"WALL FERRAZ";17;17;9;43
2018;"ABATIA (PR)";"PR";"ABATIA";164;8;49;221
2018;"ADRIANOPOLIS (PR)";"PR";"ADRIANOPOLIS";132;7;28;167
2018;"AGUDOS DO SUL (PR)";"PR";"AGUDOS DO SUL";504;24;46;574
2018;"ALMIRANTE TAMANDARE (PR)";"PR";"ALMIRANTE TAMANDARE";1713;115;264;2092
2018;"ALTAMIRA DO PARANA (PR)";"PR";"ALTAMIRA DO PARANA";57;6;15;78
2018;"ALTO PARAISO (PR)";"PR";"ALTO PARAISO";65;14;14;93
2018;"ALTO PARANA (PR)";"PR";"ALTO PARANA";341;23;109;473
2018;"ALTO PIQUIRI (PR)";"PR";"ALTO PIQUIRI";221;14;56;291
2018;"ALTONIA (PR)";"PR";"ALTONIA";526;37;57;620
2018;"ALVORADA DO SUL (PR)";"PR";"ALVORADA DO SUL";344;9;67;420
2018;"AMAPORA (PR)";"PR";"AMAPORA";85;4;55;144
2018;"AMPERE (PR)";"PR";"AMPERE";543;23;60;626
2018;"ANAHY (PR)";"PR";"ANAHY";110;1;10;121
2018;"ANDIRA (PR)";"PR";"ANDIRA";597;22;101;720
2018;"ANGULO (PR)";"PR";"ANGULO";95;5;11;111
2018;"ANTONINA (PR)";"PR";"ANTONINA";133;19;44;196
2018;"ANTONIO OLINTO (PR)";"PR";"ANTONIO OLINTO";235;8;43;286
2018;"APUCARANA (PR)";"PR";"APUCARANA";2689;414;351;3454
2018;"ARAPONGAS (PR)";"PR";"ARAPONGAS";3413;272;189;3874
2018;"ARAPOTI (PR)";"PR";"ARAPOTI";780;41;83;904
2018;"ARAPUA (PR)";"PR";"ARAPUA";134;7;30;171
2018;"ARARUNA (PR)";"PR";"ARARUNA";469;24;48;541
2018;"ARAUCARIA (PR)";"PR";"ARAUCARIA";3062;368;628;4058
2018;"ARIRANHA DO IVAI (PR)";"PR";"ARIRANHA DO IVAI";65;3;21;89
2018;"ASSAI (PR)";"PR";"ASSAI";514;32;51;597
2018;"ASSIS CHATEAUBRIAND (PR)";"PR";"ASSIS CHATEAUBRIAND";1330;64;85;1479
2018;"ASTORGA (PR)";"PR";"ASTORGA";773;52;112;937
2018;"ATALAIA (PR)";"PR";"ATALAIA";136;12;35;183
2018;"BALSA NOVA (PR)";"PR";"BALSA NOVA";429;43;168;640
2018;"BANDEIRANTES (PR)";"PR";"BANDEIRANTES";943;66;119;1128
2018;"BARBOSA FERRAZ (PR)";"PR";"BARBOSA FERRAZ";255;11;41;307
2018;"BARRA DO JACARE (PR)";"PR";"BARRA DO JACARE";67;8;17;92
2018;"BARRACAO (PR)";"PR";"BARRACAO";298;35;54;387
2018;"BELA VISTA DO CAROBA (PR)";"PR";"BELA VISTA DO CAROBA";87;6;27;120
2018;"BELA VISTA DO PARAISO (PR)";"PR";"BELA VISTA DO PARAISO";479;36;71;586
2018;"BITURUNA (PR)";"PR";"BITURUNA";551;33;215;799
2018;"BOA ESPERANCA (PR)";"PR";"BOA ESPERANCA";214;9;20;243
2018;"BOA ESPERANCA DO IGUACU (PR)";"PR";"BOA ESPERANCA DO IGUACU";75;7;16;98
2018;"BOA VENTURA DE SAO ROQUE (PR)";"PR";"BOA VENTURA DE SAO ROQUE";252;23;50;325
2018;"BOA VISTA DA APARECIDA (PR)";"PR";"BOA VISTA DA APARECIDA";202;21;35;258
2018;"BOCAIUVA DO SUL (PR)";"PR";"BOCAIUVA DO SUL";375;20;31;426
2018;"BOM JESUS DO SUL (PR)";"PR";"BOM JESUS DO SUL";49;10;14;73
2018;"BOM SUCESSO (PR)";"PR";"BOM SUCESSO";142;12;62;216
2018;"BOM SUCESSO DO SUL (PR)";"PR";"BOM SUCESSO DO SUL";149;10;13;172
2018;"BORRAZOPOLIS (PR)";"PR";"BORRAZOPOLIS";336;5;21;362
2018;"BRAGANEY (PR)";"PR";"BRAGANEY";212;6;29;247
2018;"BRASILANDIA DO SUL (PR)";"PR";"BRASILANDIA DO SUL";97;6;13;116
2018;"CAFEARA (PR)";"PR";"CAFEARA";57;8;17;82
2018;"CAFELANDIA (PR)";"PR";"CAFELANDIA";775;79;115;969
2018;"CAFEZAL DO SUL (PR)";"PR";"CAFEZAL DO SUL";106;5;31;142
2018;"CALIFORNIA (PR)";"PR";"CALIFORNIA";323;15;33;371
2018;"CAMBARA (PR)";"PR";"CAMBARA";875;59;105;1039
2018;"CAMBE (PR)";"PR";"CAMBE";2181;306;155;2642
2018;"CAMBIRA (PR)";"PR";"CAMBIRA";321;8;34;363
2018;"CAMPINA DA LAGOA (PR)";"PR";"CAMPINA DA LAGOA";525;31;58;614
2018;"CAMPINA DO SIMAO (PR)";"PR";"CAMPINA DO SIMAO";145;4;39;188
2018;"CAMPINA GRANDE DO SUL (PR)";"PR";"CAMPINA GRANDE DO SUL";887;90;91;1068
2018;"CAMPO BONITO (PR)";"PR";"CAMPO BONITO";127;9;20;156
2018;"CAMPO DO TENENTE (PR)";"PR";"CAMPO DO TENENTE";179;13;58;250
2018;"CAMPO LARGO (PR)";"PR";"CAMPO LARGO";2621;346;499;3466
2018;"CAMPO MAGRO (PR)";"PR";"CAMPO MAGRO";645;87;52;784
2018;"CAMPO MOURAO (PR)";"PR";"CAMPO MOURAO";2619;125;656;3400
2018;"CANDIDO DE ABREU (PR)";"PR";"CANDIDO DE ABREU";351;12;62;425
2018;"CANDOI (PR)";"PR";"CANDOI";504;20;133;657
2018;"CANTAGALO (PR)";"PR";"CANTAGALO";314;16;69;399
2018;"CAPANEMA (PR)";"PR";"CAPANEMA";552;21;89;662
2018;"CAPITAO LEONIDAS MARQUES (PR)";"PR";"CAPITAO LEONIDAS MARQUES";679;30;79;788
2018;"CARAMBEI (PR)";"PR";"CARAMBEI";751;82;83;916
2018;"CARLOPOLIS (PR)";"PR";"CARLOPOLIS";366;38;93;497
2018;"CASCAVEL (PR)";"PR";"CASCAVEL";8425;509;1111;10045
2018;"CASTRO (PR)";"PR";"CASTRO";2241;268;399;2908
2018;"CATANDUVAS (PR)";"PR";"CATANDUVAS";265;19;51;335
2018;"CENTENARIO DO SUL (PR)";"PR";"CENTENARIO DO SUL";181;33;90;304
2018;"CERRO AZUL (PR)";"PR";"CERRO AZUL";583;32;76;691
2018;"CEU AZUL (PR)";"PR";"CEU AZUL";413;18;59;490
2018;"CHOPINZINHO (PR)";"PR";"CHOPINZINHO";700;42;109;851
2018;"CIANORTE (PR)";"PR";"CIANORTE";1784;96;278;2158
2018;"CIDADE GAUCHA (PR)";"PR";"CIDADE GAUCHA";327;26;103;456
2018;"CLEVELANDIA (PR)";"PR";"CLEVELANDIA";665;50;60;775
2018;"COLOMBO (PR)";"PR";"COLOMBO";4534;398;597;5529
2018;"COLORADO (PR)";"PR";"COLORADO";656;60;183;899
2018;"CONGONHINHAS (PR)";"PR";"CONGONHINHAS";159;7;45;211
2018;"CONSELHEIRO MAIRINCK (PR)";"PR";"CONSELHEIRO MAIRINCK";60;7;14;81
2018;"CONTENDA (PR)";"PR";"CONTENDA";855;24;66;945
2018;"CORBELIA (PR)";"PR";"CORBELIA";857;31;71;959
2018;"CORNELIO PROCOPIO (PR)";"PR";"CORNELIO PROCOPIO";1158;127;152;1437
2018;"CORONEL DOMINGOS SOARES (PR)";"PR";"CORONEL DOMINGOS SOARES";188;11;39;238
2018;"CORONEL VIVIDA (PR)";"PR";"CORONEL VIVIDA";838;44;128;1010
2018;"CORUMBATAI DO SUL (PR)";"PR";"CORUMBATAI DO SUL";85;2;29;116
2018;"CRUZ MACHADO (PR)";"PR";"CRUZ MACHADO";744;19;109;872
2018;"CRUZEIRO DO IGUACU (PR)";"PR";"CRUZEIRO DO IGUACU";107;8;26;141
2018;"CRUZEIRO DO OESTE (PR)";"PR";"CRUZEIRO DO OESTE";584;31;99;714
2018;"CRUZEIRO DO SUL (PR)";"PR";"CRUZEIRO DO SUL";102;8;22;132
2018;"CRUZMALTINA (PR)";"PR";"CRUZMALTINA";110;6;13;129
2018;"CURITIBA (PR)";"PR";"CURITIBA";38301;3945;6707;48953
2018;"CURIUVA (PR)";"PR";"CURIUVA";323;26;94;443
2018;"DIAMANTE D OESTE (PR)";"PR";"DIAMANTE D OESTE";80;14;43;137
2018;"DIAMANTE DO NORTE (PR)";"PR";"DIAMANTE DO NORTE";80;6;35;121
2018;"DIAMANTE DO SUL (PR)";"PR";"DIAMANTE DO SUL";42;6;17;65
2018;"DOIS VIZINHOS (PR)";"PR";"DOIS VIZINHOS";1337;120;166;1623
2018;"DOURADINA (PR)";"PR";"DOURADINA";390;14;28;432
2018;"DOUTOR CAMARGO (PR)";"PR";"DOUTOR CAMARGO";205;7;68;280
2018;"DOUTOR ULYSSES (PR)";"PR";"DOUTOR ULYSSES";97;8;32;137
2018;"ENEAS MARQUES (PR)";"PR";"ENEAS MARQUES";223;5;34;262
2018;"ENGENHEIRO BELTRAO (PR)";"PR";"ENGENHEIRO BELTRAO";568;23;111;702
2018;"ENTRE RIOS DO OESTE (PR)";"PR";"ENTRE RIOS DO OESTE";173;6;14;193
2018;"ESPERANCA NOVA (PR)";"PR";"ESPERANCA NOVA";37;10;9;56
2018;"ESPIGAO ALTO DO IGUACU (PR)";"PR";"ESPIGAO ALTO DO IGUACU";99;8;15;122
2018;"FAROL (PR)";"PR";"FAROL";117;4;21;142
2018;"FAXINAL (PR)";"PR";"FAXINAL";525;22;60;607
2018;"FAZENDA RIO GRANDE (PR)";"PR";"FAZENDA RIO GRANDE";1496;87;327;1910
2018;"FENIX (PR)";"PR";"FENIX";150;5;20;175
2018;"FERNANDES PINHEIRO (PR)";"PR";"FERNANDES PINHEIRO";142;8;31;181
2018;"FIGUEIRA (PR)";"PR";"FIGUEIRA";159;14;47;220
2018;"FLOR DA SERRA DO SUL (PR)";"PR";"FLOR DA SERRA DO SUL";121;4;31;156
2018;"FLORAI (PR)";"PR";"FLORAI";179;9;25;213
2018;"FLORESTA (PR)";"PR";"FLORESTA";302;21;39;362
2018;"FLORESTOPOLIS (PR)";"PR";"FLORESTOPOLIS";210;42;129;381
2018;"FLORIDA (PR)";"PR";"FLORIDA";80;10;27;117
2018;"FORMOSA DO OESTE (PR)";"PR";"FORMOSA DO OESTE";319;13;30;362
2018;"FOZ DO IGUACU (PR)";"PR";"FOZ DO IGUACU";3898;1217;1490;6605
2018;"FOZ DO JORDAO (PR)";"PR";"FOZ DO JORDAO";87;10;24;121
2018;"FRANCISCO ALVES (PR)";"PR";"FRANCISCO ALVES";197;8;36;241
2018;"FRANCISCO BELTRAO (PR)";"PR";"FRANCISCO BELTRAO";2406;206;266;2878
2018;"GENERAL CARNEIRO (PR)";"PR";"GENERAL CARNEIRO";506;48;100;654
2018;"GODOY MOREIRA (PR)";"PR";"GODOY MOREIRA";69;5;17;91
2018;"GOIOERE (PR)";"PR";"GOIOERE";686;54;61;801
2018;"GOIOXIM (PR)";"PR";"GOIOXIM";150;17;45;212
2018;"GRANDES RIOS (PR)";"PR";"GRANDES RIOS";129;10;21;160
2018;"GUAIRA (PR)";"PR";"GUAIRA";1167;44;630;1841
2018;"GUAIRACA (PR)";"PR";"GUAIRACA";142;14;35;191
2018;"GUAMIRANGA (PR)";"PR";"GUAMIRANGA";195;20;39;254
2018;"GUAPIRAMA (PR)";"PR";"GUAPIRAMA";136;4;27;167
2018;"GUAPOREMA (PR)";"PR";"GUAPOREMA";56;3;14;73
2018;"GUARACI (PR)";"PR";"GUARACI";125;5;43;173
2018;"GUARANIACU (PR)";"PR";"GUARANIACU";492;47;69;608
2018;"GUARAPUAVA (PR)";"PR";"GUARAPUAVA";5042;583;561;6186
2018;"GUARAQUECABA (PR)";"PR";"GUARAQUECABA";38;4;17;59
2018;"GUARATUBA (PR)";"PR";"GUARATUBA";519;52;67;638
2018;"HONORIO SERPA (PR)";"PR";"HONORIO SERPA";129;8;42;179
2018;"IBAITI (PR)";"PR";"IBAITI";668;64;180;912
2018;"IBEMA (PR)";"PR";"IBEMA";170;17;17;204
2018;"IBIPORA (PR)";"PR";"IBIPORA";1249;106;199;1554
2018;"ICARAIMA (PR)";"PR";"ICARAIMA";198;18;51;267
2018;"IGUARACU (PR)";"PR";"IGUARACU";122;12;17;151
2018;"IGUATU (PR)";"PR";"IGUATU";59;2;10;71
2018;"IMBAU (PR)";"PR";"IMBAU";261;25;40;326
2018;"IMBITUVA (PR)";"PR";"IMBITUVA";891;54;78;1023
2018;"INACIO MARTINS (PR)";"PR";"INACIO MARTINS";309;38;53;400
2018;"INAJA (PR)";"PR";"INAJA";32;6;19;57
2018;"INDIANOPOLIS (PR)";"PR";"INDIANOPOLIS";196;10;17;223
2018;"IPIRANGA (PR)";"PR";"IPIRANGA";396;37;104;537
2018;"IPORA (PR)";"PR";"IPORA";469;15;49;533
2018;"IRACEMA DO OESTE (PR)";"PR";"IRACEMA DO OESTE";88;4;9;101
2018;"IRATI (PR)";"PR";"IRATI";1817;133;173;2123
2018;"IRETAMA (PR)";"PR";"IRETAMA";243;5;50;298
2018;"ITAGUAJE (PR)";"PR";"ITAGUAJE";80;12;30;122
2018;"ITAIPULANDIA (PR)";"PR";"ITAIPULANDIA";266;36;51;353
2018;"ITAMBARACA (PR)";"PR";"ITAMBARACA";201;14;35;250
2018;"ITAMBE (PR)";"PR";"ITAMBE";207;6;37;250
2018;"ITAPEJARA D OESTE (PR)";"PR";"ITAPEJARA D OESTE";413;19;53;485
2018;"ITAPERUCU (PR)";"PR";"ITAPERUCU";677;95;105;877
2018;"ITAUNA DO SUL (PR)";"PR";"ITAUNA DO SUL";54;9;17;80
2018;"IVAI (PR)";"PR";"IVAI";411;16;56;483
2018;"IVAIPORA (PR)";"PR";"IVAIPORA";1059;45;123;1227
2018;"IVATE (PR)";"PR";"IVATE";248;10;82;340
2018;"IVATUBA (PR)";"PR";"IVATUBA";67;5;9;81
2018;"JABOTI (PR)";"PR";"JABOTI";82;12;24;118
2018;"JACAREZINHO (PR)";"PR";"JACAREZINHO";645;139;164;948
2018;"JAGUAPITA (PR)";"PR";"JAGUAPITA";424;39;94;557
2018;"JAGUARIAIVA (PR)";"PR";"JAGUARIAIVA";803;83;143;1029
2018;"JANDAIA DO SUL (PR)";"PR";"JANDAIA DO SUL";698;50;70;818
2018;"JANIOPOLIS (PR)";"PR";"JANIOPOLIS";166;8;33;207
2018;"JAPIRA (PR)";"PR";"JAPIRA";66;7;22;95
2018;"JAPURA (PR)";"PR";"JAPURA";337;14;30;381
2018;"JARDIM ALEGRE (PR)";"PR";"JARDIM ALEGRE";311;15;49;375
2018;"JARDIM OLINDA (PR)";"PR";"JARDIM OLINDA";45;3;10;58
2018;"JATAIZINHO (PR)";"PR";"JATAIZINHO";385;30;31;446
2018;"JESUITAS (PR)";"PR";"JESUITAS";363;21;45;429
2018;"JOAQUIM TAVORA (PR)";"PR";"JOAQUIM TAVORA";310;19;41;370
2018;"JUNDIAI DO SUL (PR)";"PR";"JUNDIAI DO SUL";37;4;26;67
2018;"JURANDA (PR)";"PR";"JURANDA";352;7;17;376
2018;"JUSSARA (PR)";"PR";"JUSSARA";197;6;48;251
2018;"KALORE (PR)";"PR";"KALORE";172;20;24;216
2018;"LAPA (PR)";"PR";"LAPA";1390;134;235;1759
2018;"LARANJAL (PR)";"PR";"LARANJAL";76;9;29;114
2018;"LARANJEIRAS DO SUL (PR)";"PR";"LARANJEIRAS DO SUL";952;51;120;1123
2018;"LEOPOLIS (PR)";"PR";"LEOPOLIS";93;7;11;111
2018;"LIDIANOPOLIS (PR)";"PR";"LIDIANOPOLIS";118;8;27;153
2018;"LINDOESTE (PR)";"PR";"LINDOESTE";125;15;34;174
2018;"LOANDA (PR)";"PR";"LOANDA";474;30;70;574
2018;"LOBATO (PR)";"PR";"LOBATO";179;8;38;225
2018;"LONDRINA (PR)";"PR";"LONDRINA";9481;856;1979;12316
2018;"LUIZIANA (PR)";"PR";"LUIZIANA";223;8;27;258
2018;"LUNARDELLI (PR)";"PR";"LUNARDELLI";122;11;15;148
2018;"LUPIONOPOLIS (PR)";"PR";"LUPIONOPOLIS";108;17;66;191
2018;"MALLET (PR)";"PR";"MALLET";518;16;74;608
2018;"MAMBORE (PR)";"PR";"MAMBORE";679;9;52;740
2018;"MANDAGUACU (PR)";"PR";"MANDAGUACU";545;31;66;642
2018;"MANDAGUARI (PR)";"PR";"MANDAGUARI";926;72;88;1086
2018;"MANDIRITUBA (PR)";"PR";"MANDIRITUBA";1204;49;96;1349
2018;"MANFRINOPOLIS (PR)";"PR";"MANFRINOPOLIS";47;8;25;80
2018;"MANGUEIRINHA (PR)";"PR";"MANGUEIRINHA";606;38;103;747
2018;"MANOEL RIBAS (PR)";"PR";"MANOEL RIBAS";442;20;45;507
2018;"MARECHAL CANDIDO RONDON (PR)";"PR";"MARECHAL CANDIDO RONDON";1722;119;229;2070
2018;"MARIA HELENA (PR)";"PR";"MARIA HELENA";144;12;38;194
2018;"MARIALVA (PR)";"PR";"MARIALVA";1061;63;115;1239
2018;"MARILANDIA DO SUL (PR)";"PR";"MARILANDIA DO SUL";288;21;41;350
2018;"MARILENA (PR)";"PR";"MARILENA";143;7;37;187
2018;"MARILUZ (PR)";"PR";"MARILUZ";212;17;82;311
2018;"MARINGA (PR)";"PR";"MARINGA";10179;550;952;11681
2018;"MARIOPOLIS (PR)";"PR";"MARIOPOLIS";269;22;45;336
2018;"MARIPA (PR)";"PR";"MARIPA";380;16;14;410
2018;"MARMELEIRO (PR)";"PR";"MARMELEIRO";474;32;65;571
2018;"MARQUINHO (PR)";"PR";"MARQUINHO";88;6;26;120
2018;"MARUMBI (PR)";"PR";"MARUMBI";116;9;32;157
2018;"MATELANDIA (PR)";"PR";"MATELANDIA";709;27;89;825
2018;"MATINHOS (PR)";"PR";"MATINHOS";400;61;55;516
2018;"MATO RICO (PR)";"PR";"MATO RICO";102;5;17;124
2018;"MAUA DA SERRA (PR)";"PR";"MAUA DA SERRA";275;14;31;320
2018;"MEDIANEIRA (PR)";"PR";"MEDIANEIRA";1441;91;139;1671
2018;"MERCEDES (PR)";"PR";"MERCEDES";294;6;32;332
2018;"MIRADOR (PR)";"PR";"MIRADOR";19;4;12;35
2018;"MIRASELVA (PR)";"PR";"MIRASELVA";45;12;35;92
2018;"MISSAL (PR)";"PR";"MISSAL";432;28;56;516
2018;"MOREIRA SALES (PR)";"PR";"MOREIRA SALES";326;16;108;450
2018;"MORRETES (PR)";"PR";"MORRETES";255;21;43;319
2018;"MUNHOZ DE MELLO (PR)";"PR";"MUNHOZ DE MELLO";90;8;13;111
2018;"NOSSA SENHORA DAS GRACAS (PR)";"PR";"NOSSA SENHORA DAS GRACAS";48;10;39;97
2018;"NOVA ALIANCA DO IVAI (PR)";"PR";"NOVA ALIANCA DO IVAI";27;6;8;41
2018;"NOVA AMERICA DA COLINA (PR)";"PR";"NOVA AMERICA DA COLINA";115;7;31;153
2018;"NOVA AURORA (PR)";"PR";"NOVA AURORA";514;16;55;585
2018;"NOVA CANTU (PR)";"PR";"NOVA CANTU";166;4;33;203
2018;"NOVA ESPERANCA (PR)";"PR";"NOVA ESPERANCA";860;53;98;1011
2018;"NOVA ESPERANCA DO SUDOESTE (PR)";"PR";"NOVA ESPERANCA DO SUDOESTE";212;17;29;258
2018;"NOVA FATIMA (PR)";"PR";"NOVA FATIMA";333;8;52;393
2018;"NOVA LARANJEIRAS (PR)";"PR";"NOVA LARANJEIRAS";201;9;43;253
2018;"NOVA LONDRINA (PR)";"PR";"NOVA LONDRINA";388;27;71;486
2018;"NOVA OLIMPIA (PR)";"PR";"NOVA OLIMPIA";134;15;33;182
2018;"NOVA PRATA DO IGUACU (PR)";"PR";"NOVA PRATA DO IGUACU";321;19;49;389
2018;"NOVA SANTA BARBARA (PR)";"PR";"NOVA SANTA BARBARA";149;13;12;174
2018;"NOVA SANTA ROSA (PR)";"PR";"NOVA SANTA ROSA";471;20;24;515
2018;"NOVA TEBAS (PR)";"PR";"NOVA TEBAS";149;10;31;190
2018;"NOVO ITACOLOMI (PR)";"PR";"NOVO ITACOLOMI";108;4;13;125
2018;"ORTIGUEIRA (PR)";"PR";"ORTIGUEIRA";536;53;107;696
2018;"OURIZONA (PR)";"PR";"OURIZONA";104;3;21;128
2018;"OURO VERDE DO OESTE (PR)";"PR";"OURO VERDE DO OESTE";188;11;20;219
2018;"PAICANDU (PR)";"PR";"PAICANDU";659;49;65;773
2018;"PALMAS (PR)";"PR";"PALMAS";1148;97;131;1376
2018;"PALMEIRA (PR)";"PR";"PALMEIRA";1121;74;106;1301
2018;"PALMITAL (PR)";"PR";"PALMITAL";327;16;80;423
2018;"PALOTINA (PR)";"PR";"PALOTINA";1424;67;258;1749
2018;"PARAISO DO NORTE (PR)";"PR";"PARAISO DO NORTE";299;18;79;396
2018;"PARANACITY (PR)";"PR";"PARANACITY";306;22;63;391
2018;"PARANAGUA (PR)";"PR";"PARANAGUA";2074;185;224;2483
2018;"PARANAPOEMA (PR)";"PR";"PARANAPOEMA";78;7;20;105
2018;"PARANAVAI (PR)";"PR";"PARANAVAI";2251;164;270;2685
2018;"PATO BRAGADO (PR)";"PR";"PATO BRAGADO";192;10;22;224
2018;"PATO BRANCO (PR)";"PR";"PATO BRANCO";2447;177;430;3054
2018;"PAULA FREITAS (PR)";"PR";"PAULA FREITAS";206;8;31;245
2018;"PAULO FRONTIN (PR)";"PR";"PAULO FRONTIN";309;7;31;347
2018;"PEABIRU (PR)";"PR";"PEABIRU";395;21;39;455
2018;"PEROBAL (PR)";"PR";"PEROBAL";147;12;35;194
2018;"PEROLA (PR)";"PR";"PEROLA";251;19;23;293
2018;"PEROLA D OESTE (PR)";"PR";"PEROLA D OESTE";234;4;29;267
2018;"PIEN (PR)";"PR";"PIEN";485;33;31;549
2018;"PINHAIS (PR)";"PR";"PINHAIS";2339;267;493;3099
2018;"PINHAL DO SAO BENTO (PR)";"PR";"PINHAL DO SAO BENTO";49;4;21;74
2018;"PINHALAO (PR)";"PR";"PINHALAO";147;10;27;184
2018;"PINHAO (PR)";"PR";"PINHAO";689;97;146;932
2018;"PIRAI DO SUL (PR)";"PR";"PIRAI DO SUL";534;65;137;736
2018;"PIRAQUARA (PR)";"PR";"PIRAQUARA";697;130;248;1075
2018;"PITANGA (PR)";"PR";"PITANGA";1120;49;151;1320
2018;"PITANGUEIRAS (PR)";"PR";"PITANGUEIRAS";57;9;36;102
2018;"PLANALTINA DO PARANA (PR)";"PR";"PLANALTINA DO PARANA";116;6;29;151
2018;"PLANALTO (PR)";"PR";"PLANALTO";453;20;52;525
2018;"PONTA GROSSA (PR)";"PR";"PONTA GROSSA";6727;824;1277;8828
2018;"PONTAL DO PARANA (PR)";"PR";"PONTAL DO PARANA";349;42;77;468
2018;"PORECATU (PR)";"PR";"PORECATU";299;39;183;521
2018;"PORTO AMAZONAS (PR)";"PR";"PORTO AMAZONAS";95;14;21;130
2018;"PORTO BARREIRO (PR)";"PR";"PORTO BARREIRO";101;9;33;143
2018;"PORTO RICO (PR)";"PR";"PORTO RICO";29;4;12;45
2018;"PORTO VITORIA (PR)";"PR";"PORTO VITORIA";179;4;18;201
2018;"PRADO FERREIRA (PR)";"PR";"PRADO FERREIRA";116;6;18;140
2018;"PRANCHITA (PR)";"PR";"PRANCHITA";320;13;24;357
2018;"PRESIDENTE CASTELO BRANCO (PR)";"PR";"PRESIDENTE CASTELO BRANCO";134;10;31;175
2018;"PRIMEIRO DE MAIO (PR)";"PR";"PRIMEIRO DE MAIO";353;19;39;411
2018;"PRUDENTOPOLIS (PR)";"PR";"PRUDENTOPOLIS";1579;75;195;1849
2018;"QUARTO CENTENARIO (PR)";"PR";"QUARTO CENTENARIO";135;5;10;150
2018;"QUATIGUA (PR)";"PR";"QUATIGUA";379;20;23;422
2018;"QUATRO BARRAS (PR)";"PR";"QUATRO BARRAS";764;47;128;939
2018;"QUATRO PONTES (PR)";"PR";"QUATRO PONTES";202;6;9;217
2018;"QUEDAS DO IGUACU (PR)";"PR";"QUEDAS DO IGUACU";841;43;195;1079
2018;"QUERENCIA DO NORTE (PR)";"PR";"QUERENCIA DO NORTE";260;9;40;309
2018;"QUINTA DO SOL (PR)";"PR";"QUINTA DO SOL";157;6;26;189
2018;"QUITANDINHA (PR)";"PR";"QUITANDINHA";585;13;113;711
2018;"RAMILANDIA (PR)";"PR";"RAMILANDIA";58;6;20;84
2018;"RANCHO ALEGRE (PR)";"PR";"RANCHO ALEGRE";117;8;21;146
2018;"RANCHO ALEGRE D OESTE (PR)";"PR";"RANCHO ALEGRE D OESTE";90;4;15;109
2018;"REALEZA (PR)";"PR";"REALEZA";707;35;54;796
2018;"REBOUCAS (PR)";"PR";"REBOUCAS";332;24;68;424
2018;"RENASCENCA (PR)";"PR";"RENASCENCA";298;12;44;354
2018;"RESERVA (PR)";"PR";"RESERVA";746;42;127;915
2018;"RESERVA DO IGUACU (PR)";"PR";"RESERVA DO IGUACU";92;14;28;134
2018;"RIBEIRAO CLARO (PR)";"PR";"RIBEIRAO CLARO";237;46;42;325
2018;"RIBEIRAO DO PINHAL (PR)";"PR";"RIBEIRAO DO PINHAL";255;39;86;380
2018;"RIO AZUL (PR)";"PR";"RIO AZUL";375;17;52;444
2018;"RIO BOM (PR)";"PR";"RIO BOM";96;7;14;117
2018;"RIO BONITO DO IGUACU (PR)";"PR";"RIO BONITO DO IGUACU";371;14;107;492
2018;"RIO BRANCO DO IVAI (PR)";"PR";"RIO BRANCO DO IVAI";44;7;15;66
2018;"RIO BRANCO DO SUL (PR)";"PR";"RIO BRANCO DO SUL";773;132;186;1091
2018;"RIO NEGRO (PR)";"PR";"RIO NEGRO";1237;105;89;1431
2018;"ROLANDIA (PR)";"PR";"ROLANDIA";1701;156;140;1997
2018;"RONCADOR (PR)";"PR";"RONCADOR";420;8;47;475
2018;"RONDON (PR)";"PR";"RONDON";327;18;86;431
2018;"ROSARIO DO IVAI (PR)";"PR";"ROSARIO DO IVAI";114;15;30;159
2018;"SABAUDIA (PR)";"PR";"SABAUDIA";256;14;30;300
2018;"SALGADO FILHO (PR)";"PR";"SALGADO FILHO";108;7;38;153
2018;"SALTO DO ITARARE (PR)";"PR";"SALTO DO ITARARE";137;10;23;170
2018;"SALTO DO LONTRA (PR)";"PR";"SALTO DO LONTRA";363;11;47;421
2018;"SANTA AMELIA (PR)";"PR";"SANTA AMELIA";73;10;23;106
2018;"SANTA CECILIA DO PAVAO (PR)";"PR";"SANTA CECILIA DO PAVAO";111;8;16;135
2018;"SANTA CRUZ DO MONTE CASTELO (PR)";"PR";"SANTA CRUZ DO MONTE CASTELO";245;14;55;314
2018;"SANTA FE (PR)";"PR";"SANTA FE";310;19;46;375
2018;"SANTA HELENA (PR)";"PR";"SANTA HELENA";760;74;169;1003
2018;"SANTA INES (PR)";"PR";"SANTA INES";19;10;9;38
2018;"SANTA ISABEL DO IVAI (PR)";"PR";"SANTA ISABEL DO IVAI";209;22;41;272
2018;"SANTA IZABEL DO OESTE (PR)";"PR";"SANTA IZABEL DO OESTE";269;29;45;343
2018;"SANTA LUCIA (PR)";"PR";"SANTA LUCIA";143;3;17;163
2018;"SANTA MARIA DO OESTE (PR)";"PR";"SANTA MARIA DO OESTE";298;20;36;354
2018;"SANTA MARIANA (PR)";"PR";"SANTA MARIANA";334;29;53;416
2018;"SANTA MONICA (PR)";"PR";"SANTA MONICA";54;8;18;80
2018;"SANTA TEREZA DO OESTE (PR)";"PR";"SANTA TEREZA DO OESTE";295;21;31;347
2018;"SANTA TEREZINHA DE ITAIPU (PR)";"PR";"SANTA TEREZINHA DE ITAIPU";517;55;75;647
2018;"SANTANA DO ITARARE (PR)";"PR";"SANTANA DO ITARARE";125;11;29;165
2018;"SANTO ANTONIO DA PLATINA (PR)";"PR";"SANTO ANTONIO DA PLATINA";782;101;243;1126
2018;"SANTO ANTONIO DO CAIUA (PR)";"PR";"SANTO ANTONIO DO CAIUA";25;5;17;47
2018;"SANTO ANTONIO DO PARAISO (PR)";"PR";"SANTO ANTONIO DO PARAISO";82;7;18;107
2018;"SANTO ANTONIO DO SUDOESTE (PR)";"PR";"SANTO ANTONIO DO SUDOESTE";499;20;50;569
2018;"SANTO INACIO (PR)";"PR";"SANTO INACIO";168;12;26;206
2018;"SAO CARLOS DO IVAI (PR)";"PR";"SAO CARLOS DO IVAI";233;8;37;278
2018;"SAO JERONIMO DA SERRA (PR)";"PR";"SAO JERONIMO DA SERRA";228;18;32;278
2018;"SAO JOAO (PR)";"PR";"SAO JOAO";460;24;64;548
2018;"SAO JOAO DO CAIUA (PR)";"PR";"SAO JOAO DO CAIUA";95;10;47;152
2018;"SAO JOAO DO IVAI (PR)";"PR";"SAO JOAO DO IVAI";395;15;42;452
2018;"SAO JOAO DO TRIUNFO (PR)";"PR";"SAO JOAO DO TRIUNFO";306;15;61;382
2018;"SAO JORGE D OESTE (PR)";"PR";"SAO JORGE D OESTE";280;15;61;356
2018;"SAO JORGE DO IVAI (PR)";"PR";"SAO JORGE DO IVAI";297;11;24;332
2018;"SAO JORGE DO PATROCINIO (PR)";"PR";"SAO JORGE DO PATROCINIO";155;11;28;194
2018;"SAO JOSE DA BOA VISTA (PR)";"PR";"SAO JOSE DA BOA VISTA";130;9;32;171
2018;"SAO JOSE DAS PALMEIRAS (PR)";"PR";"SAO JOSE DAS PALMEIRAS";99;11;42;152
2018;"SAO JOSE DOS PINHAIS (PR)";"PR";"SAO JOSE DOS PINHAIS";8068;690;923;9681
2018;"SAO MANOEL DO PARANA (PR)";"PR";"SAO MANOEL DO PARANA";61;3;11;75
2018;"SAO MATEUS DO SUL (PR)";"PR";"SAO MATEUS DO SUL";1185;110;207;1502
2018;"SAO MIGUEL DO IGUACU (PR)";"PR";"SAO MIGUEL DO IGUACU";968;68;91;1127
2018;"SAO PEDRO DO IGUACU (PR)";"PR";"SAO PEDRO DO IGUACU";205;10;46;261
2018;"SAO PEDRO DO IVAI (PR)";"PR";"SAO PEDRO DO IVAI";371;15;52;438
2018;"SAO PEDRO DO PARANA (PR)";"PR";"SAO PEDRO DO PARANA";51;8;9;68
2018;"SAO SEBASTIAO DA AMOREIRA (PR)";"PR";"SAO SEBASTIAO DA AMOREIRA";217;9;59;285
2018;"SAO TOME (PR)";"PR";"SAO TOME";168;13;35;216
2018;"SAPOPEMA (PR)";"PR";"SAPOPEMA";133;8;20;161
2018;"SARANDI (PR)";"PR";"SARANDI";1232;116;197;1545
2018;"SAUDADE DO IGUACU (PR)";"PR";"SAUDADE DO IGUACU";116;18;30;164
2018;"SENGES (PR)";"PR";"SENGES";596;32;76;704
2018;"SERRANOPOLIS DO IGUACU (PR)";"PR";"SERRANOPOLIS DO IGUACU";170;16;14;200
2018;"SERTANEJA (PR)";"PR";"SERTANEJA";225;16;41;282
2018;"SERTANOPOLIS (PR)";"PR";"SERTANOPOLIS";690;23;78;791
2018;"SIQUEIRA CAMPOS (PR)";"PR";"SIQUEIRA CAMPOS";468;24;80;572
2018;"SULINA (PR)";"PR";"SULINA";96;6;16;118
2018;"TAMARANA (PR)";"PR";"TAMARANA";359;20;60;439
2018;"TAMBOARA (PR)";"PR";"TAMBOARA";104;11;17;132
2018;"TAPEJARA (PR)";"PR";"TAPEJARA";467;16;124;607
2018;"TAPIRA (PR)";"PR";"TAPIRA";174;8;36;218
2018;"TEIXEIRA SOARES (PR)";"PR";"TEIXEIRA SOARES";244;21;130;395
2018;"TELEMACO BORBA (PR)";"PR";"TELEMACO BORBA";1189;247;249;1685
2018;"TERRA BOA (PR)";"PR";"TERRA BOA";412;23;132;567
2018;"TERRA RICA (PR)";"PR";"TERRA RICA";428;26;113;567
2018;"TERRA ROXA (PR)";"PR";"TERRA ROXA";642;25;71;738
2018;"TIBAGI (PR)";"PR";"TIBAGI";419;52;84;555
2018;"TIJUCAS DO SUL (PR)";"PR";"TIJUCAS DO SUL";567;21;50;638
2018;"TOLEDO (PR)";"PR";"TOLEDO";3715;297;273;4285
2018;"TOMAZINA (PR)";"PR";"TOMAZINA";127;12;34;173
2018;"TRES BARRAS DO PARANA (PR)";"PR";"TRES BARRAS DO PARANA";393;10;46;449
2018;"TUNAS DO PARANA (PR)";"PR";"TUNAS DO PARANA";144;15;55;214
2018;"TUNEIRAS DO OESTE (PR)";"PR";"TUNEIRAS DO OESTE";170;23;73;266
2018;"TUPASSI (PR)";"PR";"TUPASSI";390;15;42;447
2018;"TURVO (PR)";"PR";"TURVO";475;33;92;600
2018;"UBIRATA (PR)";"PR";"UBIRATA";800;34;87;921
2018;"UMUARAMA (PR)";"PR";"UMUARAMA";2968;98;310;3376
2018;"UNIAO DA VITORIA (PR)";"PR";"UNIAO DA VITORIA";1632;80;104;1816
2018;"UNIFLOR (PR)";"PR";"UNIFLOR";62;4;14;80
2018;"URAI (PR)";"PR";"URAI";365;27;28;420
2018;"VENTANIA (PR)";"PR";"VENTANIA";193;22;36;251
2018;"VERA CRUZ DO OESTE (PR)";"PR";"VERA CRUZ DO OESTE";327;15;26;368
2018;"VERE (PR)";"PR";"VERE";287;11;25;323
2018;"VIRMOND (PR)";"PR";"VIRMOND";136;2;27;165
2018;"VITORINO (PR)";"PR";"VITORINO";323;14;41;378
2018;"WENCESLAU BRAZ (PR)";"PR";"WENCESLAU BRAZ";559;34;94;687
2018;"XAMBRE (PR)";"PR";"XAMBRE";157;13;21;191
2018;"ANGRA DOS REIS (RJ)";"RJ";"ANGRA DOS REIS";1276;223;374;1873
2018;"APERIBE (RJ)";"RJ";"APERIBE";145;19;14;178
2018;"ARARUAMA (RJ)";"RJ";"ARARUAMA";1911;304;182;2397
2018;"AREAL (RJ)";"RJ";"AREAL";193;44;44;281
2018;"ARMACAO DE BUZIOS (RJ)";"RJ";"ARMACAO DE BUZIOS";372;342;73;787
2018;"ARRAIAL DO CABO (RJ)";"RJ";"ARRAIAL DO CABO";204;63;17;284
2018;"BARRA DO PIRAI (RJ)";"RJ";"BARRA DO PIRAI";1406;238;305;1949
2018;"BARRA MANSA (RJ)";"RJ";"BARRA MANSA";1972;276;653;2901
2018;"BELFORD ROXO (RJ)";"RJ";"BELFORD ROXO";2092;528;799;3419
2018;"BOM JARDIM (RJ)";"RJ";"BOM JARDIM";690;70;57;817
2018;"BOM JESUS DO ITABAPOANA (RJ)";"RJ";"BOM JESUS DO ITABAPOANA";304;62;65;431
2018;"CABO FRIO (RJ)";"RJ";"CABO FRIO";3108;375;455;3938
2018;"CACHOEIRAS DE MACACU (RJ)";"RJ";"CACHOEIRAS DE MACACU";984;213;57;1254
2018;"CAMBUCI (RJ)";"RJ";"CAMBUCI";134;28;33;195
2018;"CAMPOS DOS GOYTACAZES (RJ)";"RJ";"CAMPOS DOS GOYTACAZES";6863;1153;1437;9453
2018;"CANTAGALO (RJ)";"RJ";"CANTAGALO";221;52;48;321
2018;"CARAPEBUS (RJ)";"RJ";"CARAPEBUS";150;35;27;212
2018;"CARDOSO MOREIRA (RJ)";"RJ";"CARDOSO MOREIRA";176;32;61;269
2018;"CARMO (RJ)";"RJ";"CARMO";158;37;19;214
2018;"CASIMIRO DE ABREU (RJ)";"RJ";"CASIMIRO DE ABREU";651;111;32;794
2018;"COMENDADOR LEVY GASPARIAN (RJ)";"RJ";"COMENDADOR LEVY GASPARIAN";164;37;21;222
2018;"CONCEICAO DE MACABU (RJ)";"RJ";"CONCEICAO DE MACABU";194;43;58;295
2018;"CORDEIRO (RJ)";"RJ";"CORDEIRO";288;55;57;400
2018;"DUAS BARRAS (RJ)";"RJ";"DUAS BARRAS";156;49;10;215
2018;"DUQUE DE CAXIAS (RJ)";"RJ";"DUQUE DE CAXIAS";9673;1119;3893;14685
2018;"ENGENHEIRO PAULO DE FRONTIN (RJ)";"RJ";"ENGENHEIRO PAULO DE FRONTIN";133;31;18;182
2018;"GUAPIMIRIM (RJ)";"RJ";"GUAPIMIRIM";461;82;55;598
2018;"IGUABA GRANDE (RJ)";"RJ";"IGUABA GRANDE";193;86;35;314
2018;"ITABORAI (RJ)";"RJ";"ITABORAI";3227;754;584;4565
2018;"ITAGUAI (RJ)";"RJ";"ITAGUAI";1711;323;325;2359
2018;"ITALVA (RJ)";"RJ";"ITALVA";211;33;34;278
2018;"ITAOCARA (RJ)";"RJ";"ITAOCARA";383;54;45;482
2018;"ITAPERUNA (RJ)";"RJ";"ITAPERUNA";1065;149;119;1333
2018;"ITATIAIA (RJ)";"RJ";"ITATIAIA";161;81;49;291
2018;"JAPERI (RJ)";"RJ";"JAPERI";524;77;46;647
2018;"LAJE DO MURIAE (RJ)";"RJ";"LAJE DO MURIAE";40;8;18;66
2018;"MACAE (RJ)";"RJ";"MACAE";3110;1053;910;5073
2018;"MACUCO (RJ)";"RJ";"MACUCO";191;15;12;218
2018;"MAGE (RJ)";"RJ";"MAGE";2030;482;198;2710
2018;"MANGARATIBA (RJ)";"RJ";"MANGARATIBA";208;154;136;498
2018;"MARICA (RJ)";"RJ";"MARICA";1280;464;420;2164
2018;"MENDES (RJ)";"RJ";"MENDES";213;61;56;330
2018;"MESQUITA (RJ)";"RJ";"MESQUITA";851;141;700;1692
2018;"MIGUEL PEREIRA (RJ)";"RJ";"MIGUEL PEREIRA";393;79;51;523
2018;"MIRACEMA (RJ)";"RJ";"MIRACEMA";271;42;36;349
2018;"MUNICIPIO NAO INFORMADO (RJ)";"RJ";"MUNICIPIO NAO INFORMADO";1;0;0;1
2018;"NATIVIDADE (RJ)";"RJ";"NATIVIDADE";90;22;47;159
2018;"NILOPOLIS (RJ)";"RJ";"NILOPOLIS";663;152;330;1145
2018;"NITEROI (RJ)";"RJ";"NITEROI";2797;1255;2494;6546
2018;"NOVA FRIBURGO (RJ)";"RJ";"NOVA FRIBURGO";3753;311;357;4421
2018;"NOVA IGUACU (RJ)";"RJ";"NOVA IGUACU";6693;1679;1743;10115
2018;"PARACAMBI (RJ)";"RJ";"PARACAMBI";728;100;110;938
2018;"PARAIBA DO SUL (RJ)";"RJ";"PARAIBA DO SUL";620;127;102;849
2018;"PARATI (RJ)";"RJ";"PARATI";226;106;58;390
2018;"PATY DO ALFERES (RJ)";"RJ";"PATY DO ALFERES";517;59;82;658
2018;"PETROPOLIS (RJ)";"RJ";"PETROPOLIS";3599;714;987;5300
2018;"PINHEIRAL (RJ)";"RJ";"PINHEIRAL";222;64;168;454
2018;"PIRAI (RJ)";"RJ";"PIRAI";395;92;73;560
2018;"PORCIUNCULA (RJ)";"RJ";"PORCIUNCULA";70;23;27;120
2018;"PORTO REAL (RJ)";"RJ";"PORTO REAL";237;43;20;300
2018;"QUATIS (RJ)";"RJ";"QUATIS";160;74;34;268
2018;"QUEIMADOS (RJ)";"RJ";"QUEIMADOS";692;236;317;1245
2018;"QUISSAMA (RJ)";"RJ";"QUISSAMA";231;43;120;394
2018;"RESENDE (RJ)";"RJ";"RESENDE";1546;287;548;2381
2018;"RIO BONITO (RJ)";"RJ";"RIO BONITO";3326;344;143;3813
2018;"RIO CLARO (RJ)";"RJ";"RIO CLARO";142;29;24;195
2018;"RIO DAS FLORES (RJ)";"RJ";"RIO DAS FLORES";58;31;25;114
2018;"RIO DAS OSTRAS (RJ)";"RJ";"RIO DAS OSTRAS";1178;782;147;2107
2018;"RIO DE JANEIRO (RJ)";"RJ";"RIO DE JANEIRO";42907;17645;17327;77879
2018;"SANTA MARIA MADALENA (RJ)";"RJ";"SANTA MARIA MADALENA";84;30;24;138
2018;"SANTO ANTONIO DE PADUA (RJ)";"RJ";"SANTO ANTONIO DE PADUA";602;113;40;755
2018;"SAO FIDELIS (RJ)";"RJ";"SAO FIDELIS";420;59;76;555
2018;"SAO FRANCISCO DE ITABAPOANA (RJ)";"RJ";"SAO FRANCISCO DE ITABAPOANA";451;129;109;689
2018;"SAO GONCALO (RJ)";"RJ";"SAO GONCALO";5371;1920;3090;10381
2018;"SAO JOAO DA BARRA (RJ)";"RJ";"SAO JOAO DA BARRA";675;92;80;847
2018;"SAO JOAO DE MERITI (RJ)";"RJ";"SAO JOAO DE MERITI";3724;580;1268;5572
2018;"SAO JOSE DE UBA (RJ)";"RJ";"SAO JOSE DE UBA";49;13;11;73
2018;"SAO JOSE DO VALE DO RIO PRETO (RJ)";"RJ";"SAO JOSE DO VALE DO RIO PRETO";752;38;50;840
2018;"SAO PEDRO DA ALDEIA (RJ)";"RJ";"SAO PEDRO DA ALDEIA";972;118;130;1220
2018;"SAO SEBASTIAO DO ALTO (RJ)";"RJ";"SAO SEBASTIAO DO ALTO";130;30;8;168
2018;"SAPUCAIA (RJ)";"RJ";"SAPUCAIA";132;23;14;169
2018;"SAQUAREMA (RJ)";"RJ";"SAQUAREMA";881;171;156;1208
2018;"SEROPEDICA (RJ)";"RJ";"SEROPEDICA";1481;92;262;1835
2018;"SILVA JARDIM (RJ)";"RJ";"SILVA JARDIM";313;60;49;422
2018;"SUMIDOURO (RJ)";"RJ";"SUMIDOURO";392;27;24;443
2018;"TANGUA (RJ)";"RJ";"TANGUA";379;56;70;505
2018;"TERESOPOLIS (RJ)";"RJ";"TERESOPOLIS";2540;335;285;3160
2018;"TRAJANO DE MORAIS (RJ)";"RJ";"TRAJANO DE MORAIS";112;29;24;165
2018;"TRES RIOS (RJ)";"RJ";"TRES RIOS";1028;133;229;1390
2018;"VALENCA (RJ)";"RJ";"VALENCA";406;157;114;677
2018;"VARRE SAI (RJ)";"RJ";"VARRE SAI";64;22;9;95
2018;"VASSOURAS (RJ)";"RJ";"VASSOURAS";585;97;105;787
2018;"VOLTA REDONDA (RJ)";"RJ";"VOLTA REDONDA";2334;452;655;3441
2018;"ACARI (RN)";"RN";"ACARI";114;11;13;138
2018;"AFONSO BEZERRA (RN)";"RN";"AFONSO BEZERRA";36;6;17;59
2018;"AGUA NOVA (RN)";"RN";"AGUA NOVA";10;12;2;24
2018;"ALEXANDRIA (RN)";"RN";"ALEXANDRIA";138;35;17;190
2018;"ALMINO AFONSO (RN)";"RN";"ALMINO AFONSO";26;8;1;35
2018;"ALTO DO RODRIGUES (RN)";"RN";"ALTO DO RODRIGUES";187;18;29;234
2018;"ANGICOS (RN)";"RN";"ANGICOS";125;23;13;161
2018;"ANTONIO MARTINS (RN)";"RN";"ANTONIO MARTINS";37;9;5;51
2018;"APODI (RN)";"RN";"APODI";375;45;55;475
2018;"AREIA BRANCA (RN)";"RN";"AREIA BRANCA";150;41;71;262
2018;"ARES (RN)";"RN";"ARES";60;8;43;111
2018;"ASSU (RN)";"RN";"ASSU";725;63;98;886
2018;"BAIA FORMOSA (RN)";"RN";"BAIA FORMOSA";52;4;27;83
2018;"BARAUNA (RN)";"RN";"BARAUNA";626;33;49;708
2018;"BARCELONA (RN)";"RN";"BARCELONA";25;4;4;33
2018;"BENTO FERNANDES (RN)";"RN";"BENTO FERNANDES";15;8;12;35
2018;"BOA SAUDE (RN)";"RN";"BOA SAUDE";93;7;13;113
2018;"BODO (RN)";"RN";"BODO";7;8;5;20
2018;"BOM JESUS (RN)";"RN";"BOM JESUS";62;7;10;79
2018;"BREJINHO (RN)";"RN";"BREJINHO";132;10;21;163
2018;"CAICARA DO NORTE (RN)";"RN";"CAICARA DO NORTE";20;2;6;28
2018;"CAICARA DO RIO DO VENTO (RN)";"RN";"CAICARA DO RIO DO VENTO";24;4;4;32
2018;"CAICO (RN)";"RN";"CAICO";2472;154;74;2700
2018;"CAMPO GRANDE (RN)";"RN";"CAMPO GRANDE";62;11;10;83
2018;"CAMPO REDONDO (RN)";"RN";"CAMPO REDONDO";75;17;15;107
2018;"CANGUARETAMA (RN)";"RN";"CANGUARETAMA";206;40;87;333
2018;"CARAUBAS (RN)";"RN";"CARAUBAS";180;46;22;248
2018;"CARNAUBA DOS DANTAS (RN)";"RN";"CARNAUBA DOS DANTAS";239;11;9;259
2018;"CARNAUBAIS (RN)";"RN";"CARNAUBAIS";51;20;15;86
2018;"CEARA MIRIM (RN)";"RN";"CEARA MIRIM";392;69;160;621
2018;"CERRO CORA (RN)";"RN";"CERRO CORA";124;14;16;154
2018;"CORONEL EZEQUIEL (RN)";"RN";"CORONEL EZEQUIEL";79;10;4;93
2018;"CORONEL JOAO PESSOA (RN)";"RN";"CORONEL JOAO PESSOA";15;4;3;22
2018;"CRUZETA (RN)";"RN";"CRUZETA";98;18;16;132
2018;"CURRAIS NOVOS (RN)";"RN";"CURRAIS NOVOS";819;70;69;958
2018;"DOUTOR SEVERIANO (RN)";"RN";"DOUTOR SEVERIANO";38;9;13;60
2018;"ENCANTO (RN)";"RN";"ENCANTO";19;7;8;34
2018;"EQUADOR (RN)";"RN";"EQUADOR";180;7;3;190
2018;"ESPIRITO SANTO (RN)";"RN";"ESPIRITO SANTO";24;3;20;47
2018;"EXTREMOZ (RN)";"RN";"EXTREMOZ";112;41;54;207
2018;"FELIPE GUERRA (RN)";"RN";"FELIPE GUERRA";33;10;11;54
2018;"FERNANDO PEDROZA (RN)";"RN";"FERNANDO PEDROZA";29;4;2;35
2018;"FLORANIA (RN)";"RN";"FLORANIA";74;13;8;95
2018;"FRANCISCO DANTAS (RN)";"RN";"FRANCISCO DANTAS";24;4;3;31
2018;"FRUTUOSO GOMES (RN)";"RN";"FRUTUOSO GOMES";28;14;4;46
2018;"GALINHOS (RN)";"RN";"GALINHOS";16;4;4;24
2018;"GOIANINHA (RN)";"RN";"GOIANINHA";211;59;113;383
2018;"GOVERNADOR DIX SEPT ROSADO (RN)";"RN";"GOVERNADOR DIX SEPT ROSADO";202;26;21;249
2018;"GROSSOS (RN)";"RN";"GROSSOS";69;4;22;95
2018;"GUAMARE (RN)";"RN";"GUAMARE";140;22;46;208
2018;"IELMO MARINHO (RN)";"RN";"IELMO MARINHO";68;6;28;102
2018;"IPANGUACU (RN)";"RN";"IPANGUACU";113;27;48;188
2018;"IPUEIRA (RN)";"RN";"IPUEIRA";18;7;6;31
2018;"ITAJA (RN)";"RN";"ITAJA";110;4;6;120
2018;"ITAU (RN)";"RN";"ITAU";42;14;1;57
2018;"JACANA (RN)";"RN";"JACANA";543;65;31;639
2018;"JANDAIRA (RN)";"RN";"JANDAIRA";58;1;16;75
2018;"JANDUIS (RN)";"RN";"JANDUIS";26;8;4;38
2018;"JAPI (RN)";"RN";"JAPI";78;19;13;110
2018;"JARDIM DE ANGICOS (RN)";"RN";"JARDIM DE ANGICOS";10;1;4;15
2018;"JARDIM DE PIRANHAS (RN)";"RN";"JARDIM DE PIRANHAS";129;36;10;175
2018;"JARDIM DO SERIDO (RN)";"RN";"JARDIM DO SERIDO";171;23;54;248
2018;"JOAO CAMARA (RN)";"RN";"JOAO CAMARA";399;31;55;485
2018;"JOAO DIAS (RN)";"RN";"JOAO DIAS";9;2;1;12
2018;"JOSE DA PENHA (RN)";"RN";"JOSE DA PENHA";40;18;4;62
2018;"JUCURUTU (RN)";"RN";"JUCURUTU";179;56;10;245
2018;"JUNDIA (RN)";"RN";"JUNDIA";17;5;10;32
2018;"LAGOA DANTA (RN)";"RN";"LAGOA DANTA";61;11;19;91
2018;"LAGOA DE PEDRAS (RN)";"RN";"LAGOA DE PEDRAS";41;5;19;65
2018;"LAGOA DE VELHOS (RN)";"RN";"LAGOA DE VELHOS";28;0;2;30
2018;"LAGOA NOVA (RN)";"RN";"LAGOA NOVA";121;34;23;178
2018;"LAGOA SALGADA (RN)";"RN";"LAGOA SALGADA";136;5;11;152
2018;"LAJES (RN)";"RN";"LAJES";72;6;12;90
2018;"LAJES PINTADAS (RN)";"RN";"LAJES PINTADAS";26;11;5;42
2018;"LUCRECIA (RN)";"RN";"LUCRECIA";30;7;4;41
2018;"LUIS GOMES (RN)";"RN";"LUIS GOMES";108;41;10;159
2018;"MACAIBA (RN)";"RN";"MACAIBA";915;153;79;1147
2018;"MACAU (RN)";"RN";"MACAU";204;42;62;308
2018;"MAJOR SALES (RN)";"RN";"MAJOR SALES";20;12;2;34
2018;"MARCELINO VIEIRA (RN)";"RN";"MARCELINO VIEIRA";33;21;4;58
2018;"MARTINS (RN)";"RN";"MARTINS";59;11;10;80
2018;"MAXARANGUAPE (RN)";"RN";"MAXARANGUAPE";27;8;11;46
2018;"MESSIAS TARGINO (RN)";"RN";"MESSIAS TARGINO";44;12;4;60
2018;"MONTANHAS (RN)";"RN";"MONTANHAS";66;9;21;96
2018;"MONTE ALEGRE (RN)";"RN";"MONTE ALEGRE";136;18;42;196
2018;"MONTE DAS GAMELEIRAS (RN)";"RN";"MONTE DAS GAMELEIRAS";19;2;11;32
2018;"MOSSORO (RN)";"RN";"MOSSORO";4196;293;387;4876
2018;"NATAL (RN)";"RN";"NATAL";7262;1282;2756;11300
2018;"NISIA FLORESTA (RN)";"RN";"NISIA FLORESTA";98;46;64;208
2018;"NOVA CRUZ (RN)";"RN";"NOVA CRUZ";487;57;97;641
2018;"OLHO D AGUA DO BORGES (RN)";"RN";"OLHO D AGUA DO BORGES";29;4;2;35
2018;"OURO BRANCO (RN)";"RN";"OURO BRANCO";66;15;7;88
2018;"PARANA (RN)";"RN";"PARANA";26;14;5;45
2018;"PARAU (RN)";"RN";"PARAU";16;15;2;33
2018;"PARAZINHO (RN)";"RN";"PARAZINHO";30;4;19;53
2018;"PARELHAS (RN)";"RN";"PARELHAS";564;37;46;647
2018;"PARNAMIRIM (RN)";"RN";"PARNAMIRIM";2172;406;470;3048
2018;"PASSA E FICA (RN)";"RN";"PASSA E FICA";214;58;49;321
2018;"PASSAGEM (RN)";"RN";"PASSAGEM";15;8;5;28
2018;"PATU (RN)";"RN";"PATU";174;27;8;209
2018;"PAU DOS FERROS (RN)";"RN";"PAU DOS FERROS";715;61;34;810
2018;"PEDRA GRANDE (RN)";"RN";"PEDRA GRANDE";14;2;8;24
2018;"PEDRA PRETA (RN)";"RN";"PEDRA PRETA";37;3;9;49
2018;"PEDRO AVELINO (RN)";"RN";"PEDRO AVELINO";34;3;6;43
2018;"PEDRO VELHO (RN)";"RN";"PEDRO VELHO";50;8;16;74
2018;"PENDENCIAS (RN)";"RN";"PENDENCIAS";72;15;15;102
2018;"PILOES (RN)";"RN";"PILOES";24;5;2;31
2018;"POCO BRANCO (RN)";"RN";"POCO BRANCO";32;10;13;55
2018;"PORTALEGRE (RN)";"RN";"PORTALEGRE";47;20;6;73
2018;"PORTO DO MANGUE (RN)";"RN";"PORTO DO MANGUE";29;16;7;52
2018;"PUREZA (RN)";"RN";"PUREZA";95;6;28;129
2018;"RAFAEL FERNANDES (RN)";"RN";"RAFAEL FERNANDES";56;8;1;65
2018;"RAFAEL GODEIRO (RN)";"RN";"RAFAEL GODEIRO";12;2;4;18
2018;"RIACHO DA CRUZ (RN)";"RN";"RIACHO DA CRUZ";8;5;2;15
2018;"RIACHO DE SANTANA (RN)";"RN";"RIACHO DE SANTANA";10;9;4;23
2018;"RIACHUELO (RN)";"RN";"RIACHUELO";38;2;8;48
2018;"RIO DO FOGO (RN)";"RN";"RIO DO FOGO";45;6;11;62
2018;"RODOLFO FERNANDES (RN)";"RN";"RODOLFO FERNANDES";57;9;4;70
2018;"RUY BARBOSA (RN)";"RN";"RUY BARBOSA";14;2;6;22
2018;"SANTA CRUZ (RN)";"RN";"SANTA CRUZ";602;35;46;683
2018;"SANTA MARIA (RN)";"RN";"SANTA MARIA";67;4;8;79
2018;"SANTANA DO MATOS (RN)";"RN";"SANTANA DO MATOS";90;12;12;114
2018;"SANTANA DO SERIDO (RN)";"RN";"SANTANA DO SERIDO";28;4;2;34
2018;"SANTO ANTONIO (RN)";"RN";"SANTO ANTONIO";144;57;40;241
2018;"SAO BENTO DO NORTE (RN)";"RN";"SAO BENTO DO NORTE";9;1;9;19
2018;"SAO BENTO DO TRAIRI (RN)";"RN";"SAO BENTO DO TRAIRI";15;2;9;26
2018;"SAO FERNANDO (RN)";"RN";"SAO FERNANDO";17;12;5;34
2018;"SAO FRANCISCO DO OESTE (RN)";"RN";"SAO FRANCISCO DO OESTE";35;4;5;44
2018;"SAO GONCALO DO AMARANTE (RN)";"RN";"SAO GONCALO DO AMARANTE";516;170;314;1000
2018;"SAO JOAO DO SABUGI (RN)";"RN";"SAO JOAO DO SABUGI";47;21;5;73
2018;"SAO JOSE DE MIPIBU (RN)";"RN";"SAO JOSE DE MIPIBU";434;53;74;561
2018;"SAO JOSE DO CAMPESTRE (RN)";"RN";"SAO JOSE DO CAMPESTRE";87;6;21;114
2018;"SAO JOSE DO SERIDO (RN)";"RN";"SAO JOSE DO SERIDO";43;13;2;58
2018;"SAO MIGUEL (RN)";"RN";"SAO MIGUEL";276;61;38;375
2018;"SAO MIGUEL DO GOSTOSO (RN)";"RN";"SAO MIGUEL DO GOSTOSO";36;11;20;67
2018;"SAO PAULO DO POTENGI (RN)";"RN";"SAO PAULO DO POTENGI";127;13;31;171
2018;"SAO PEDRO (RN)";"RN";"SAO PEDRO";32;3;10;45
2018;"SAO RAFAEL (RN)";"RN";"SAO RAFAEL";48;18;5;71
2018;"SAO TOME (RN)";"RN";"SAO TOME";77;4;27;108
2018;"SAO VICENTE (RN)";"RN";"SAO VICENTE";57;5;7;69
2018;"SENADOR ELOI DE SOUZA (RN)";"RN";"SENADOR ELOI DE SOUZA";29;6;14;49
2018;"SENADOR GEORGINO AVELINO (RN)";"RN";"SENADOR GEORGINO AVELINO";17;5;3;25
2018;"SERRA CAIADA (RN)";"RN";"SERRA CAIADA";60;10;16;86
2018;"SERRA DE SAO BENTO (RN)";"RN";"SERRA DE SAO BENTO";52;7;5;64
2018;"SERRA DO MEL (RN)";"RN";"SERRA DO MEL";128;12;16;156
2018;"SERRA NEGRA DO NORTE (RN)";"RN";"SERRA NEGRA DO NORTE";67;23;10;100
2018;"SERRINHA (RN)";"RN";"SERRINHA";42;17;11;70
2018;"SERRINHA DOS PINTOS (RN)";"RN";"SERRINHA DOS PINTOS";43;8;2;53
2018;"SEVERIANO MELO (RN)";"RN";"SEVERIANO MELO";42;12;8;62
2018;"SITIO NOVO (RN)";"RN";"SITIO NOVO";22;10;3;35
2018;"TABOLEIRO GRANDE (RN)";"RN";"TABOLEIRO GRANDE";7;9;3;19
2018;"TAIPU (RN)";"RN";"TAIPU";56;4;32;92
2018;"TANGARA (RN)";"RN";"TANGARA";166;8;42;216
2018;"TENENTE ANANIAS (RN)";"RN";"TENENTE ANANIAS";80;22;6;108
2018;"TENENTE LAURENTINO CRUZ (RN)";"RN";"TENENTE LAURENTINO CRUZ";56;12;6;74
2018;"TIBAU (RN)";"RN";"TIBAU";40;11;27;78
2018;"TIBAU DO SUL (RN)";"RN";"TIBAU DO SUL";62;54;23;139
2018;"TIMBAUBA DOS BATISTAS (RN)";"RN";"TIMBAUBA DOS BATISTAS";12;6;4;22
2018;"TOUROS (RN)";"RN";"TOUROS";191;38;61;290
2018;"TRIUNFO POTIGUAR (RN)";"RN";"TRIUNFO POTIGUAR";18;7;3;28
2018;"UMARIZAL (RN)";"RN";"UMARIZAL";77;32;6;115
2018;"UPANEMA (RN)";"RN";"UPANEMA";102;12;16;130
2018;"VARZEA (RN)";"RN";"VARZEA";18;4;7;29
2018;"VENHA VER (RN)";"RN";"VENHA VER";19;9;6;34
2018;"VERA CRUZ (RN)";"RN";"VERA CRUZ";183;9;26;218
2018;"VICOSA (RN)";"RN";"VICOSA";8;1;1;10
2018;"VILA FLOR (RN)";"RN";"VILA FLOR";15;2;2;19
2018;"ALTA FLORESTA D OESTE (RO)";"RO";"ALTA FLORESTA D OESTE";523;17;94;634
2018;"ALTO ALEGRE DOS PARECIS (RO)";"RO";"ALTO ALEGRE DOS PARECIS";161;17;39;217
2018;"ALTO PARAISO (RO)";"RO";"ALTO PARAISO";329;9;78;416
2018;"ALVORADA D OESTE (RO)";"RO";"ALVORADA D OESTE";286;9;67;362
2018;"ARIQUEMES (RO)";"RO";"ARIQUEMES";2117;42;228;2387
2018;"BURITIS (RO)";"RO";"BURITIS";558;9;56;623
2018;"CABIXI (RO)";"RO";"CABIXI";115;5;25;145
2018;"CACAULANDIA (RO)";"RO";"CACAULANDIA";80;5;29;114
2018;"CACOAL (RO)";"RO";"CACOAL";1862;80;335;2277
2018;"CAMPO NOVO DE RONDONIA (RO)";"RO";"CAMPO NOVO DE RONDONIA";101;9;60;170
2018;"CANDEIAS DO JAMARI (RO)";"RO";"CANDEIAS DO JAMARI";260;10;35;305
2018;"CASTANHEIRAS (RO)";"RO";"CASTANHEIRAS";41;2;18;61
2018;"CEREJEIRAS (RO)";"RO";"CEREJEIRAS";379;7;53;439
2018;"CHUPINGUAIA (RO)";"RO";"CHUPINGUAIA";126;7;87;220
2018;"COLORADO DO OESTE (RO)";"RO";"COLORADO DO OESTE";423;19;70;512
2018;"CORUMBIARA (RO)";"RO";"CORUMBIARA";145;8;25;178
2018;"COSTA MARQUES (RO)";"RO";"COSTA MARQUES";203;7;31;241
2018;"CUJUBIM (RO)";"RO";"CUJUBIM";278;7;40;325
2018;"ESPIGAO D OESTE (RO)";"RO";"ESPIGAO D OESTE";712;7;144;863
2018;"GOVERNADOR JORGE TEIXEIRA (RO)";"RO";"GOVERNADOR JORGE TEIXEIRA";73;3;31;107
2018;"GUAJARA MIRIM (RO)";"RO";"GUAJARA MIRIM";784;15;30;829
2018;"ITAPUA DO OESTE (RO)";"RO";"ITAPUA DO OESTE";195;8;68;271
2018;"JARU (RO)";"RO";"JARU";1053;27;225;1305
2018;"JI PARANA (RO)";"RO";"JI PARANA";3217;92;723;4032
2018;"MACHADINHO D OESTE (RO)";"RO";"MACHADINHO D OESTE";445;16;78;539
2018;"MINISTRO ANDREAZZA (RO)";"RO";"MINISTRO ANDREAZZA";236;4;20;260
2018;"MIRANTE DA SERRA (RO)";"RO";"MIRANTE DA SERRA";185;9;32;226
2018;"MONTE NEGRO (RO)";"RO";"MONTE NEGRO";331;17;94;442
2018;"NOVA BRASILANDIA D OESTE (RO)";"RO";"NOVA BRASILANDIA D OESTE";259;12;99;370
2018;"NOVA DO MAMORE (RO)";"RO";"NOVA DO MAMORE";351;4;34;389
2018;"NOVA UNIAO (RO)";"RO";"NOVA UNIAO";115;1;40;156
2018;"NOVO HORIZONTE DO OESTE (RO)";"RO";"NOVO HORIZONTE DO OESTE";118;1;18;137
2018;"OURO PRETO DO OESTE (RO)";"RO";"OURO PRETO DO OESTE";811;29;131;971
2018;"PARECIS (RO)";"RO";"PARECIS";97;3;30;130
2018;"PIMENTA BUENO (RO)";"RO";"PIMENTA BUENO";1156;41;104;1301
2018;"PIMENTEIRAS DO OESTE (RO)";"RO";"PIMENTEIRAS DO OESTE";34;1;24;59
2018;"PORTO VELHO (RO)";"RO";"PORTO VELHO";7608;538;1885;10031
2018;"PRESIDENTE MEDICI (RO)";"RO";"PRESIDENTE MEDICI";393;12;79;484
2018;"PRIMAVERA DE RONDONIA (RO)";"RO";"PRIMAVERA DE RONDONIA";57;5;15;77
2018;"RIO CRESPO (RO)";"RO";"RIO CRESPO";58;3;19;80
2018;"ROLIM DE MOURA (RO)";"RO";"ROLIM DE MOURA";1246;39;163;1448
2018;"SANTA LUZIA D OESTE (RO)";"RO";"SANTA LUZIA D OESTE";221;3;53;277
2018;"SAO FELIPE D OESTE (RO)";"RO";"SAO FELIPE D OESTE";94;4;30;128
2018;"SAO FRANCISCO DO GUAPORE (RO)";"RO";"SAO FRANCISCO DO GUAPORE";474;9;82;565
2018;"SAO MIGUEL DO GUAPORE (RO)";"RO";"SAO MIGUEL DO GUAPORE";329;13;76;418
2018;"SERINGUEIRAS (RO)";"RO";"SERINGUEIRAS";243;5;53;301
2018;"TEIXEIROPOLIS (RO)";"RO";"TEIXEIROPOLIS";63;1;17;81
2018;"THEOBROMA (RO)";"RO";"THEOBROMA";129;3;26;158
2018;"URUPA (RO)";"RO";"URUPA";152;3;118;273
2018;"VALE DO ANARI (RO)";"RO";"VALE DO ANARI";106;7;37;150
2018;"VALE DO PARAISO (RO)";"RO";"VALE DO PARAISO";130;2;24;156
2018;"VILHENA (RO)";"RO";"VILHENA";1635;73;192;1900
2018;"ALTO ALEGRE (RR)";"RR";"ALTO ALEGRE";79;12;15;106
2018;"AMAJARI (RR)";"RR";"AMAJARI";33;7;4;44
2018;"BOA VISTA (RR)";"RR";"BOA VISTA";4010;541;938;5489
2018;"BONFIM (RR)";"RR";"BONFIM";18;2;11;31
2018;"CANTA (RR)";"RR";"CANTA";71;11;13;95
2018;"CARACARAI (RR)";"RR";"CARACARAI";129;12;11;152
2018;"CAROEBE (RR)";"RR";"CAROEBE";70;10;31;111
2018;"IRACEMA (RR)";"RR";"IRACEMA";30;17;1;48
2018;"MUCAJAI (RR)";"RR";"MUCAJAI";130;45;48;223
2018;"NORMANDIA (RR)";"RR";"NORMANDIA";14;0;2;16
2018;"PACARAIMA (RR)";"RR";"PACARAIMA";190;4;13;207
2018;"RORAINOPOLIS (RR)";"RR";"RORAINOPOLIS";253;25;41;319
2018;"SAO JOAO DA BALIZA (RR)";"RR";"SAO JOAO DA BALIZA";52;5;8;65
2018;"SAO LUIZ (RR)";"RR";"SAO LUIZ";51;4;5;60
2018;"UIRAMUTA (RR)";"RR";"UIRAMUTA";3;0;0;3
2018;"ACEGUA (RS)";"RS";"ACEGUA";92;18;21;131
2018;"AGUA SANTA (RS)";"RS";"AGUA SANTA";219;14;25;258
2018;"AGUDO (RS)";"RS";"AGUDO";330;15;71;416
2018;"AJURICABA (RS)";"RS";"AJURICABA";478;25;32;535
2018;"ALECRIM (RS)";"RS";"ALECRIM";108;8;39;155
2018;"ALEGRETE (RS)";"RS";"ALEGRETE";1062;54;269;1385
2018;"ALEGRIA (RS)";"RS";"ALEGRIA";112;5;30;147
2018;"ALMIRANTE TAMANDARE DO SUL (RS)";"RS";"ALMIRANTE TAMANDARE DO SUL";135;13;5;153
2018;"ALPESTRE (RS)";"RS";"ALPESTRE";182;21;59;262
2018;"ALTO ALEGRE (RS)";"RS";"ALTO ALEGRE";123;6;6;135
2018;"ALTO FELIZ (RS)";"RS";"ALTO FELIZ";127;17;17;161
2018;"ALVORADA (RS)";"RS";"ALVORADA";1739;222;631;2592
2018;"AMARAL FERRADOR (RS)";"RS";"AMARAL FERRADOR";149;17;28;194
2018;"AMETISTA DO SUL (RS)";"RS";"AMETISTA DO SUL";108;7;48;163
2018;"ANDRE DA ROCHA (RS)";"RS";"ANDRE DA ROCHA";67;12;10;89
2018;"ANTA GORDA (RS)";"RS";"ANTA GORDA";288;26;23;337
2018;"ANTONIO PRADO (RS)";"RS";"ANTONIO PRADO";716;21;45;782
2018;"ARAMBARE (RS)";"RS";"ARAMBARE";94;5;14;113
2018;"ARARICA (RS)";"RS";"ARARICA";111;11;17;139
2018;"ARATIBA (RS)";"RS";"ARATIBA";208;36;43;287
2018;"ARROIO DO MEIO (RS)";"RS";"ARROIO DO MEIO";637;47;58;742
2018;"ARROIO DO PADRE (RS)";"RS";"ARROIO DO PADRE";141;3;17;161
2018;"ARROIO DO SAL (RS)";"RS";"ARROIO DO SAL";129;11;18;158
2018;"ARROIO DO TIGRE (RS)";"RS";"ARROIO DO TIGRE";330;28;49;407
2018;"ARROIO DOS RATOS (RS)";"RS";"ARROIO DOS RATOS";259;27;86;372
2018;"ARROIO GRANDE (RS)";"RS";"ARROIO GRANDE";304;27;75;406
2018;"ARVOREZINHA (RS)";"RS";"ARVOREZINHA";558;41;58;657
2018;"AUGUSTO PESTANA (RS)";"RS";"AUGUSTO PESTANA";552;18;38;608
2018;"AUREA (RS)";"RS";"AUREA";204;4;9;217
2018;"BAGE (RS)";"RS";"BAGE";1465;258;390;2113
2018;"BALNEARIO PINHAL (RS)";"RS";"BALNEARIO PINHAL";146;14;34;194
2018;"BARAO (RS)";"RS";"BARAO";217;24;50;291
2018;"BARAO DE COTEGIPE (RS)";"RS";"BARAO DE COTEGIPE";293;13;21;327
2018;"BARAO DO TRIUNFO (RS)";"RS";"BARAO DO TRIUNFO";145;19;68;232
2018;"BARRA DO GUARITA (RS)";"RS";"BARRA DO GUARITA";36;6;9;51
2018;"BARRA DO QUARAI (RS)";"RS";"BARRA DO QUARAI";39;6;15;60
2018;"BARRA DO RIBEIRO (RS)";"RS";"BARRA DO RIBEIRO";252;17;63;332
2018;"BARRA DO RIO AZUL (RS)";"RS";"BARRA DO RIO AZUL";44;11;13;68
2018;"BARRA FUNDA (RS)";"RS";"BARRA FUNDA";193;2;26;221
2018;"BARRACAO (RS)";"RS";"BARRACAO";177;10;23;210
2018;"BARROS CASSAL (RS)";"RS";"BARROS CASSAL";218;35;86;339
2018;"BENJAMIN CONSTANT DO SUL (RS)";"RS";"BENJAMIN CONSTANT DO SUL";31;5;17;53
2018;"BENTO GONCALVES (RS)";"RS";"BENTO GONCALVES";3272;300;374;3946
2018;"BOA VISTA DAS MISSOES (RS)";"RS";"BOA VISTA DAS MISSOES";109;5;13;127
2018;"BOA VISTA DO BURICA (RS)";"RS";"BOA VISTA DO BURICA";268;13;32;313
2018;"BOA VISTA DO CADEADO (RS)";"RS";"BOA VISTA DO CADEADO";152;2;20;174
2018;"BOA VISTA DO INCRA (RS)";"RS";"BOA VISTA DO INCRA";108;3;12;123
2018;"BOA VISTA DO SUL (RS)";"RS";"BOA VISTA DO SUL";360;11;15;386
2018;"BOM JESUS (RS)";"RS";"BOM JESUS";324;52;71;447
2018;"BOM PRINCIPIO (RS)";"RS";"BOM PRINCIPIO";507;37;40;584
2018;"BOM PROGRESSO (RS)";"RS";"BOM PROGRESSO";60;8;9;77
2018;"BOM RETIRO DO SUL (RS)";"RS";"BOM RETIRO DO SUL";222;16;58;296
2018;"BOQUEIRAO DO LEAO (RS)";"RS";"BOQUEIRAO DO LEAO";194;17;23;234
2018;"BOSSOROCA (RS)";"RS";"BOSSOROCA";242;7;23;272
2018;"BOZANO (RS)";"RS";"BOZANO";190;4;7;201
2018;"BRAGA (RS)";"RS";"BRAGA";108;5;24;137
2018;"BROCHIER (RS)";"RS";"BROCHIER";319;14;31;364
2018;"BUTIA (RS)";"RS";"BUTIA";473;50;167;690
2018;"CACAPAVA DO SUL (RS)";"RS";"CACAPAVA DO SUL";817;78;172;1067
2018;"CACEQUI (RS)";"RS";"CACEQUI";177;26;28;231
2018;"CACHOEIRA DO SUL (RS)";"RS";"CACHOEIRA DO SUL";1426;142;250;1818
2018;"CACHOEIRINHA (RS)";"RS";"CACHOEIRINHA";2405;245;561;3211
2018;"CACIQUE DOBLE (RS)";"RS";"CACIQUE DOBLE";128;6;15;149
2018;"CAIBATE (RS)";"RS";"CAIBATE";172;8;8;188
2018;"CAICARA (RS)";"RS";"CAICARA";100;8;21;129
2018;"CAMAQUA (RS)";"RS";"CAMAQUA";1474;69;283;1826
2018;"CAMARGO (RS)";"RS";"CAMARGO";273;5;21;299
2018;"CAMBARA DO SUL (RS)";"RS";"CAMBARA DO SUL";258;18;47;323
2018;"CAMPESTRE DA SERRA (RS)";"RS";"CAMPESTRE DA SERRA";210;3;16;229
2018;"CAMPINA DAS MISSOES (RS)";"RS";"CAMPINA DAS MISSOES";184;11;42;237
2018;"CAMPINAS DO SUL (RS)";"RS";"CAMPINAS DO SUL";235;13;24;272
2018;"CAMPO BOM (RS)";"RS";"CAMPO BOM";873;110;93;1076
2018;"CAMPO NOVO (RS)";"RS";"CAMPO NOVO";204;18;30;252
2018;"CAMPOS BORGES (RS)";"RS";"CAMPOS BORGES";192;13;23;228
2018;"CANDELARIA (RS)";"RS";"CANDELARIA";511;39;126;676
2018;"CANDIDO GODOI (RS)";"RS";"CANDIDO GODOI";327;13;22;362
2018;"CANDIOTA (RS)";"RS";"CANDIOTA";196;50;66;312
2018;"CANELA (RS)";"RS";"CANELA";621;106;132;859
2018;"CANGUCU (RS)";"RS";"CANGUCU";1356;146;259;1761
2018;"CANOAS (RS)";"RS";"CANOAS";4738;531;1121;6390
2018;"CANUDOS DO VALE (RS)";"RS";"CANUDOS DO VALE";32;15;7;54
2018;"CAPAO BONITO DO SUL (RS)";"RS";"CAPAO BONITO DO SUL";64;6;5;75
2018;"CAPAO DA CANOA (RS)";"RS";"CAPAO DA CANOA";614;80;130;824
2018;"CAPAO DO CIPO (RS)";"RS";"CAPAO DO CIPO";149;3;11;163
2018;"CAPAO DO LEAO (RS)";"RS";"CAPAO DO LEAO";540;29;37;606
2018;"CAPELA DE SANTANA (RS)";"RS";"CAPELA DE SANTANA";229;12;28;269
2018;"CAPITAO (RS)";"RS";"CAPITAO";83;6;10;99
2018;"CAPIVARI DO SUL (RS)";"RS";"CAPIVARI DO SUL";179;14;14;207
2018;"CARAA (RS)";"RS";"CARAA";127;10;31;168
2018;"CARAZINHO (RS)";"RS";"CARAZINHO";1450;99;216;1765
2018;"CARLOS BARBOSA (RS)";"RS";"CARLOS BARBOSA";911;52;148;1111
2018;"CARLOS GOMES (RS)";"RS";"CARLOS GOMES";46;4;10;60
2018;"CASCA (RS)";"RS";"CASCA";498;20;41;559
2018;"CASEIROS (RS)";"RS";"CASEIROS";193;8;18;219
2018;"CATUIPE (RS)";"RS";"CATUIPE";485;18;44;547
2018;"CAXIAS DO SUL (RS)";"RS";"CAXIAS DO SUL";9311;1518;1790;12619
2018;"CENTENARIO (RS)";"RS";"CENTENARIO";138;9;13;160
2018;"CERRITO (RS)";"RS";"CERRITO";244;17;24;285
2018;"CERRO BRANCO (RS)";"RS";"CERRO BRANCO";70;12;22;104
2018;"CERRO GRANDE (RS)";"RS";"CERRO GRANDE";55;1;12;68
2018;"CERRO GRANDE DO SUL (RS)";"RS";"CERRO GRANDE DO SUL";322;19;31;372
2018;"CERRO LARGO (RS)";"RS";"CERRO LARGO";414;11;41;466
2018;"CHAPADA (RS)";"RS";"CHAPADA";453;51;37;541
2018;"CHARQUEADAS (RS)";"RS";"CHARQUEADAS";425;86;130;641
2018;"CHARRUA (RS)";"RS";"CHARRUA";114;6;14;134
2018;"CHIAPETTA (RS)";"RS";"CHIAPETTA";176;14;15;205
2018;"CHUI (RS)";"RS";"CHUI";131;16;7;154
2018;"CHUVISCA (RS)";"RS";"CHUVISCA";152;7;40;199
2018;"CIDREIRA (RS)";"RS";"CIDREIRA";111;17;43;171
2018;"CIRIACO (RS)";"RS";"CIRIACO";184;16;23;223
2018;"COLINAS (RS)";"RS";"COLINAS";77;11;13;101
2018;"COLORADO (RS)";"RS";"COLORADO";278;18;13;309
2018;"CONDOR (RS)";"RS";"CONDOR";329;21;39;389
2018;"CONSTANTINA (RS)";"RS";"CONSTANTINA";461;20;91;572
2018;"COQUEIRO BAIXO (RS)";"RS";"COQUEIRO BAIXO";24;6;6;36
2018;"COQUEIROS DO SUL (RS)";"RS";"COQUEIROS DO SUL";160;8;10;178
2018;"CORONEL BARROS (RS)";"RS";"CORONEL BARROS";156;0;9;165
2018;"CORONEL BICACO (RS)";"RS";"CORONEL BICACO";272;17;28;317
2018;"CORONEL PILAR (RS)";"RS";"CORONEL PILAR";230;9;8;247
2018;"COTIPORA (RS)";"RS";"COTIPORA";279;9;15;303
2018;"COXILHA (RS)";"RS";"COXILHA";160;5;16;181
2018;"CRISSIUMAL (RS)";"RS";"CRISSIUMAL";352;21;52;425
2018;"CRISTAL (RS)";"RS";"CRISTAL";258;13;63;334
2018;"CRISTAL DO SUL (RS)";"RS";"CRISTAL DO SUL";62;10;19;91
2018;"CRUZ ALTA (RS)";"RS";"CRUZ ALTA";1327;116;153;1596
2018;"CRUZALTENSE (RS)";"RS";"CRUZALTENSE";83;5;12;100
2018;"CRUZEIRO DO SUL (RS)";"RS";"CRUZEIRO DO SUL";546;10;22;578
2018;"DAVID CANABARRO (RS)";"RS";"DAVID CANABARRO";194;10;28;232
2018;"DERRUBADAS (RS)";"RS";"DERRUBADAS";131;6;15;152
2018;"DEZESSEIS DE NOVEMBRO (RS)";"RS";"DEZESSEIS DE NOVEMBRO";66;6;9;81
2018;"DILERMANDO DE AGUIAR (RS)";"RS";"DILERMANDO DE AGUIAR";51;1;32;84
2018;"DOIS IRMAOS (RS)";"RS";"DOIS IRMAOS";511;25;112;648
2018;"DOIS IRMAOS DAS MISSOES (RS)";"RS";"DOIS IRMAOS DAS MISSOES";90;6;8;104
2018;"DOIS LAJEADOS (RS)";"RS";"DOIS LAJEADOS";153;6;19;178
2018;"DOM FELICIANO (RS)";"RS";"DOM FELICIANO";258;16;97;371
2018;"DOM PEDRITO (RS)";"RS";"DOM PEDRITO";716;47;50;813
2018;"DOM PEDRO DE ALCANTARA (RS)";"RS";"DOM PEDRO DE ALCANTARA";121;4;7;132
2018;"DONA FRANCISCA (RS)";"RS";"DONA FRANCISCA";54;3;8;65
2018;"DOUTOR MAURICIO CARDOSO (RS)";"RS";"DOUTOR MAURICIO CARDOSO";240;15;18;273
2018;"DOUTOR RICARDO (RS)";"RS";"DOUTOR RICARDO";71;8;8;87
2018;"ELDORADO DO SUL (RS)";"RS";"ELDORADO DO SUL";865;54;69;988
2018;"ENCANTADO (RS)";"RS";"ENCANTADO";738;67;143;948
2018;"ENCRUZILHADA DO SUL (RS)";"RS";"ENCRUZILHADA DO SUL";498;30;223;751
2018;"ENGENHO VELHO (RS)";"RS";"ENGENHO VELHO";45;3;14;62
2018;"ENTRE IJUIS (RS)";"RS";"ENTRE IJUIS";460;12;30;502
2018;"ENTRE RIOS DO SUL (RS)";"RS";"ENTRE RIOS DO SUL";71;14;19;104
2018;"EREBANGO (RS)";"RS";"EREBANGO";142;3;5;150
2018;"ERECHIM (RS)";"RS";"ERECHIM";2248;347;556;3151
2018;"ERNESTINA (RS)";"RS";"ERNESTINA";178;21;19;218
2018;"ERVAL GRANDE (RS)";"RS";"ERVAL GRANDE";147;28;27;202
2018;"ERVAL SECO (RS)";"RS";"ERVAL SECO";189;8;40;237
2018;"ESMERALDA (RS)";"RS";"ESMERALDA";115;2;16;133
2018;"ESPERANCA DO SUL (RS)";"RS";"ESPERANCA DO SUL";68;4;17;89
2018;"ESPUMOSO (RS)";"RS";"ESPUMOSO";869;52;88;1009
2018;"ESTACAO (RS)";"RS";"ESTACAO";239;12;27;278
2018;"ESTANCIA VELHA (RS)";"RS";"ESTANCIA VELHA";895;87;132;1114
2018;"ESTEIO (RS)";"RS";"ESTEIO";1085;124;271;1480
2018;"ESTRELA (RS)";"RS";"ESTRELA";1133;55;71;1259
2018;"ESTRELA VELHA (RS)";"RS";"ESTRELA VELHA";163;8;25;196
2018;"EUGENIO DE CASTRO (RS)";"RS";"EUGENIO DE CASTRO";119;9;15;143
2018;"FAGUNDES VARELA (RS)";"RS";"FAGUNDES VARELA";130;5;20;155
2018;"FARROUPILHA (RS)";"RS";"FARROUPILHA";2395;263;255;2913
2018;"FAXINAL DO SOTURNO (RS)";"RS";"FAXINAL DO SOTURNO";172;4;16;192
2018;"FAXINALZINHO (RS)";"RS";"FAXINALZINHO";65;5;15;85
2018;"FAZENDA VILANOVA (RS)";"RS";"FAZENDA VILANOVA";159;10;32;201
2018;"FELIZ (RS)";"RS";"FELIZ";493;36;92;621
2018;"FLORES DA CUNHA (RS)";"RS";"FLORES DA CUNHA";1660;80;149;1889
2018;"FLORIANO PEIXOTO (RS)";"RS";"FLORIANO PEIXOTO";82;6;22;110
2018;"FONTOURA XAVIER (RS)";"RS";"FONTOURA XAVIER";254;24;60;338
2018;"FORMIGUEIRO (RS)";"RS";"FORMIGUEIRO";205;2;24;231
2018;"FORQUETINHA (RS)";"RS";"FORQUETINHA";74;6;6;86
2018;"FORTALEZA DOS VALOS (RS)";"RS";"FORTALEZA DOS VALOS";298;5;22;325
2018;"FREDERICO WESTPHALEN (RS)";"RS";"FREDERICO WESTPHALEN";892;49;101;1042
2018;"GARIBALDI (RS)";"RS";"GARIBALDI";1521;91;140;1752
2018;"GARRUCHOS (RS)";"RS";"GARRUCHOS";57;9;17;83
2018;"GAURAMA (RS)";"RS";"GAURAMA";251;28;21;300
2018;"GENERAL CAMARA (RS)";"RS";"GENERAL CAMARA";120;15;35;170
2018;"GENTIL (RS)";"RS";"GENTIL";117;9;19;145
2018;"GETULIO VARGAS (RS)";"RS";"GETULIO VARGAS";537;39;51;627
2018;"GIRUA (RS)";"RS";"GIRUA";656;54;53;763
2018;"GLORINHA (RS)";"RS";"GLORINHA";240;20;16;276
2018;"GRAMADO (RS)";"RS";"GRAMADO";730;154;152;1036
2018;"GRAMADO DOS LOUREIROS (RS)";"RS";"GRAMADO DOS LOUREIROS";48;3;15;66
2018;"GRAMADO XAVIER (RS)";"RS";"GRAMADO XAVIER";80;6;10;96
2018;"GRAVATAI (RS)";"RS";"GRAVATAI";3714;560;707;4981
2018;"GUABIJU (RS)";"RS";"GUABIJU";55;5;12;72
2018;"GUAIBA (RS)";"RS";"GUAIBA";1194;243;449;1886
2018;"GUAPORE (RS)";"RS";"GUAPORE";534;47;93;674
2018;"GUARANI DAS MISSOES (RS)";"RS";"GUARANI DAS MISSOES";317;6;37;360
2018;"HARMONIA (RS)";"RS";"HARMONIA";265;9;8;282
2018;"HERVAL (RS)";"RS";"HERVAL";135;15;17;167
2018;"HERVEIRAS (RS)";"RS";"HERVEIRAS";69;2;3;74
2018;"HORIZONTINA (RS)";"RS";"HORIZONTINA";456;42;70;568
2018;"HULHA NEGRA (RS)";"RS";"HULHA NEGRA";96;9;28;133
2018;"HUMAITA (RS)";"RS";"HUMAITA";185;11;12;208
2018;"IBARAMA (RS)";"RS";"IBARAMA";103;7;20;130
2018;"IBIACA (RS)";"RS";"IBIACA";310;11;32;353
2018;"IBIRAIARAS (RS)";"RS";"IBIRAIARAS";550;13;36;599
2018;"IBIRAPUITA (RS)";"RS";"IBIRAPUITA";157;12;54;223
2018;"IBIRUBA (RS)";"RS";"IBIRUBA";1089;68;100;1257
2018;"IGREJINHA (RS)";"RS";"IGREJINHA";558;48;76;682
2018;"IJUI (RS)";"RS";"IJUI";1996;166;135;2297
2018;"ILOPOLIS (RS)";"RS";"ILOPOLIS";253;13;15;281
2018;"IMBE (RS)";"RS";"IMBE";332;25;74;431
2018;"IMIGRANTE (RS)";"RS";"IMIGRANTE";109;15;18;142
2018;"INDEPENDENCIA (RS)";"RS";"INDEPENDENCIA";299;12;51;362
2018;"INHACORA (RS)";"RS";"INHACORA";82;6;9;97
2018;"IPE (RS)";"RS";"IPE";337;30;37;404
2018;"IPIRANGA DO SUL (RS)";"RS";"IPIRANGA DO SUL";150;12;14;176
2018;"IRAI (RS)";"RS";"IRAI";164;8;21;193
2018;"ITAARA (RS)";"RS";"ITAARA";141;7;23;171
2018;"ITACURUBI (RS)";"RS";"ITACURUBI";66;9;12;87
2018;"ITAPUCA (RS)";"RS";"ITAPUCA";74;7;11;92
2018;"ITAQUI (RS)";"RS";"ITAQUI";729;36;111;876
2018;"ITATI (RS)";"RS";"ITATI";77;2;9;88
2018;"ITATIBA DO SUL (RS)";"RS";"ITATIBA DO SUL";86;13;11;110
2018;"IVORA (RS)";"RS";"IVORA";87;4;8;99
2018;"IVOTI (RS)";"RS";"IVOTI";584;55;115;754
2018;"JABOTICABA (RS)";"RS";"JABOTICABA";102;8;33;143
2018;"JACUIZINHO (RS)";"RS";"JACUIZINHO";81;3;19;103
2018;"JACUTINGA (RS)";"RS";"JACUTINGA";145;8;9;162
2018;"JAGUARAO (RS)";"RS";"JAGUARAO";367;31;66;464
2018;"JAGUARI (RS)";"RS";"JAGUARI";353;31;64;448
2018;"JAQUIRANA (RS)";"RS";"JAQUIRANA";171;10;19;200
2018;"JARI (RS)";"RS";"JARI";111;8;17;136
2018;"JOIA (RS)";"RS";"JOIA";393;22;53;468
2018;"JULIO DE CASTILHOS (RS)";"RS";"JULIO DE CASTILHOS";731;30;84;845
2018;"LAGOA BONITA DO SUL (RS)";"RS";"LAGOA BONITA DO SUL";70;9;11;90
2018;"LAGOA DOS TRES CANTOS (RS)";"RS";"LAGOA DOS TRES CANTOS";116;8;6;130
2018;"LAGOA VERMELHA (RS)";"RS";"LAGOA VERMELHA";751;75;90;916
2018;"LAGOAO (RS)";"RS";"LAGOAO";109;9;45;163
2018;"LAJEADO (RS)";"RS";"LAJEADO";2355;173;280;2808
2018;"LAJEADO DO BUGRE (RS)";"RS";"LAJEADO DO BUGRE";34;6;15;55
2018;"LAVRAS DO SUL (RS)";"RS";"LAVRAS DO SUL";117;11;30;158
2018;"LIBERATO SALZANO (RS)";"RS";"LIBERATO SALZANO";154;7;34;195
2018;"LINDOLFO COLLOR (RS)";"RS";"LINDOLFO COLLOR";143;16;19;178
2018;"LINHA NOVA (RS)";"RS";"LINHA NOVA";88;13;5;106
2018;"MACAMBARA (RS)";"RS";"MACAMBARA";51;4;40;95
2018;"MACHADINHO (RS)";"RS";"MACHADINHO";156;9;33;198
2018;"MAMPITUBA (RS)";"RS";"MAMPITUBA";31;5;12;48
2018;"MANOEL VIANA (RS)";"RS";"MANOEL VIANA";204;9;16;229
2018;"MAQUINE (RS)";"RS";"MAQUINE";278;17;19;314
2018;"MARATA (RS)";"RS";"MARATA";141;11;24;176
2018;"MARAU (RS)";"RS";"MARAU";1204;111;216;1531
2018;"MARCELINO RAMOS (RS)";"RS";"MARCELINO RAMOS";139;26;33;198
2018;"MARIANA PIMENTEL (RS)";"RS";"MARIANA PIMENTEL";166;13;33;212
2018;"MARIANO MORO (RS)";"RS";"MARIANO MORO";79;13;15;107
2018;"MARQUES DE SOUZA (RS)";"RS";"MARQUES DE SOUZA";137;14;19;170
2018;"MATA (RS)";"RS";"MATA";128;7;28;163
2018;"MATO CASTELHANO (RS)";"RS";"MATO CASTELHANO";162;22;22;206
2018;"MATO LEITAO (RS)";"RS";"MATO LEITAO";158;14;12;184
2018;"MATO QUEIMADO (RS)";"RS";"MATO QUEIMADO";104;8;8;120
2018;"MAXIMILIANO DE ALMEIDA (RS)";"RS";"MAXIMILIANO DE ALMEIDA";172;19;62;253
2018;"MINAS DO LEAO (RS)";"RS";"MINAS DO LEAO";122;15;37;174
2018;"MIRAGUAI (RS)";"RS";"MIRAGUAI";120;6;35;161
2018;"MONTAURI (RS)";"RS";"MONTAURI";80;4;5;89
2018;"MONTE ALEGRE DOS CAMPOS (RS)";"RS";"MONTE ALEGRE DOS CAMPOS";122;7;29;158
2018;"MONTE BELO DO SUL (RS)";"RS";"MONTE BELO DO SUL";289;7;22;318
2018;"MONTENEGRO (RS)";"RS";"MONTENEGRO";1500;166;184;1850
2018;"MORMACO (RS)";"RS";"MORMACO";109;6;14;129
2018;"MORRINHOS DO SUL (RS)";"RS";"MORRINHOS DO SUL";176;1;7;184
2018;"MORRO REDONDO (RS)";"RS";"MORRO REDONDO";266;5;26;297
2018;"MORRO REUTER (RS)";"RS";"MORRO REUTER";211;16;26;253
2018;"MOSTARDAS (RS)";"RS";"MOSTARDAS";372;21;76;469
2018;"MUCUM (RS)";"RS";"MUCUM";100;14;20;134
2018;"MUITOS CAPOES (RS)";"RS";"MUITOS CAPOES";115;6;8;129
2018;"MULITERNO (RS)";"RS";"MULITERNO";120;3;12;135
2018;"NAO ME TOQUE (RS)";"RS";"NAO ME TOQUE";601;45;78;724
2018;"NICOLAU VERGUEIRO (RS)";"RS";"NICOLAU VERGUEIRO";115;6;18;139
2018;"NONOAI (RS)";"RS";"NONOAI";260;17;60;337
2018;"NOVA ALVORADA (RS)";"RS";"NOVA ALVORADA";212;6;19;237
2018;"NOVA ARACA (RS)";"RS";"NOVA ARACA";158;18;36;212
2018;"NOVA BASSANO (RS)";"RS";"NOVA BASSANO";544;27;59;630
2018;"NOVA BOA VISTA (RS)";"RS";"NOVA BOA VISTA";107;10;14;131
2018;"NOVA BRESCIA (RS)";"RS";"NOVA BRESCIA";150;11;16;177
2018;"NOVA CANDELARIA (RS)";"RS";"NOVA CANDELARIA";94;8;10;112
2018;"NOVA ESPERANCA DO SUL (RS)";"RS";"NOVA ESPERANCA DO SUL";108;13;42;163
2018;"NOVA HARTZ (RS)";"RS";"NOVA HARTZ";205;30;137;372
2018;"NOVA PADUA (RS)";"RS";"NOVA PADUA";371;4;6;381
2018;"NOVA PALMA (RS)";"RS";"NOVA PALMA";334;15;43;392
2018;"NOVA PETROPOLIS (RS)";"RS";"NOVA PETROPOLIS";571;36;69;676
2018;"NOVA PRATA (RS)";"RS";"NOVA PRATA";724;28;84;836
2018;"NOVA RAMADA (RS)";"RS";"NOVA RAMADA";151;13;11;175
2018;"NOVA ROMA DO SUL (RS)";"RS";"NOVA ROMA DO SUL";354;6;28;388
2018;"NOVA SANTA RITA (RS)";"RS";"NOVA SANTA RITA";1064;59;63;1186
2018;"NOVO BARREIRO (RS)";"RS";"NOVO BARREIRO";178;7;15;200
2018;"NOVO CABRAIS (RS)";"RS";"NOVO CABRAIS";118;4;10;132
2018;"NOVO HAMBURGO (RS)";"RS";"NOVO HAMBURGO";3336;355;497;4188
2018;"NOVO MACHADO (RS)";"RS";"NOVO MACHADO";209;20;19;248
2018;"NOVO TIRADENTES (RS)";"RS";"NOVO TIRADENTES";57;5;10;72
2018;"NOVO XINGU (RS)";"RS";"NOVO XINGU";61;11;11;83
2018;"OSORIO (RS)";"RS";"OSORIO";998;69;108;1175
2018;"PAIM FILHO (RS)";"RS";"PAIM FILHO";158;4;30;192
2018;"PALMARES DO SUL (RS)";"RS";"PALMARES DO SUL";205;18;52;275
2018;"PALMEIRA DAS MISSOES (RS)";"RS";"PALMEIRA DAS MISSOES";1119;37;113;1269
2018;"PALMITINHO (RS)";"RS";"PALMITINHO";236;20;53;309
2018;"PANAMBI (RS)";"RS";"PANAMBI";1158;77;143;1378
2018;"PANTANO GRANDE (RS)";"RS";"PANTANO GRANDE";351;14;38;403
2018;"PARAI (RS)";"RS";"PARAI";580;13;19;612
2018;"PARAISO DO SUL (RS)";"RS";"PARAISO DO SUL";117;7;25;149
2018;"PARECI NOVO (RS)";"RS";"PARECI NOVO";460;9;18;487
2018;"PAROBE (RS)";"RS";"PAROBE";676;92;208;976
2018;"PASSA SETE (RS)";"RS";"PASSA SETE";118;5;37;160
2018;"PASSO DO SOBRADO (RS)";"RS";"PASSO DO SOBRADO";158;7;54;219
2018;"PASSO FUNDO (RS)";"RS";"PASSO FUNDO";3855;280;414;4549
2018;"PAULO BENTO (RS)";"RS";"PAULO BENTO";107;16;9;132
2018;"PAVERAMA (RS)";"RS";"PAVERAMA";225;47;50;322
2018;"PEDRAS ALTAS (RS)";"RS";"PEDRAS ALTAS";27;13;8;48
2018;"PEDRO OSORIO (RS)";"RS";"PEDRO OSORIO";133;16;35;184
2018;"PEJUCARA (RS)";"RS";"PEJUCARA";262;5;19;286
2018;"PELOTAS (RS)";"RS";"PELOTAS";5849;503;1266;7618
2018;"PICADA CAFE (RS)";"RS";"PICADA CAFE";112;23;60;195
2018;"PINHAL (RS)";"RS";"PINHAL";127;4;10;141
2018;"PINHAL DA SERRA (RS)";"RS";"PINHAL DA SERRA";73;10;20;103
2018;"PINHAL GRANDE (RS)";"RS";"PINHAL GRANDE";160;10;32;202
2018;"PINHEIRINHO DO VALE (RS)";"RS";"PINHEIRINHO DO VALE";62;7;27;96
2018;"PINHEIRO MACHADO (RS)";"RS";"PINHEIRO MACHADO";181;15;62;258
2018;"PINTO BANDEIRA (RS)";"RS";"PINTO BANDEIRA";146;11;6;163
2018;"PIRAPO (RS)";"RS";"PIRAPO";57;9;14;80
2018;"PIRATINI (RS)";"RS";"PIRATINI";328;61;156;545
2018;"PLANALTO (RS)";"RS";"PLANALTO";267;11;38;316
2018;"POCO DAS ANTAS (RS)";"RS";"POCO DAS ANTAS";118;10;17;145
2018;"PONTAO (RS)";"RS";"PONTAO";179;9;26;214
2018;"PONTE PRETA (RS)";"RS";"PONTE PRETA";80;12;12;104
2018;"PORTAO (RS)";"RS";"PORTAO";1725;120;134;1979
2018;"PORTO ALEGRE (RS)";"RS";"PORTO ALEGRE";16152;2340;5156;23648
2018;"PORTO LUCENA (RS)";"RS";"PORTO LUCENA";109;15;18;142
2018;"PORTO MAUA (RS)";"RS";"PORTO MAUA";71;5;6;82
2018;"PORTO VERA CRUZ (RS)";"RS";"PORTO VERA CRUZ";21;4;11;36
2018;"PORTO XAVIER (RS)";"RS";"PORTO XAVIER";214;30;53;297
2018;"POUSO NOVO (RS)";"RS";"POUSO NOVO";51;9;10;70
2018;"PRESIDENTE LUCENA (RS)";"RS";"PRESIDENTE LUCENA";199;7;19;225
2018;"PROGRESSO (RS)";"RS";"PROGRESSO";133;18;36;187
2018;"PROTASIO ALVES (RS)";"RS";"PROTASIO ALVES";51;4;9;64
2018;"PUTINGA (RS)";"RS";"PUTINGA";145;12;9;166
2018;"QUARAI (RS)";"RS";"QUARAI";237;34;61;332
2018;"QUATRO IRMAOS (RS)";"RS";"QUATRO IRMAOS";67;12;8;87
2018;"QUEVEDOS (RS)";"RS";"QUEVEDOS";61;11;11;83
2018;"QUINZE DE NOVEMBRO (RS)";"RS";"QUINZE DE NOVEMBRO";259;32;33;324
2018;"REDENTORA (RS)";"RS";"REDENTORA";144;21;20;185
2018;"RELVADO (RS)";"RS";"RELVADO";59;9;6;74
2018;"RESTINGA SECA (RS)";"RS";"RESTINGA SECA";388;16;66;470
2018;"RIO DOS INDIOS (RS)";"RS";"RIO DOS INDIOS";100;8;30;138
2018;"RIO GRANDE (RS)";"RS";"RIO GRANDE";2496;268;776;3540
2018;"RIO PARDO (RS)";"RS";"RIO PARDO";564;84;119;767
2018;"RIOZINHO (RS)";"RS";"RIOZINHO";56;13;35;104
2018;"ROCA SALES (RS)";"RS";"ROCA SALES";188;22;44;254
2018;"RODEIO BONITO (RS)";"RS";"RODEIO BONITO";196;8;36;240
2018;"ROLADOR (RS)";"RS";"ROLADOR";71;4;6;81
2018;"ROLANTE (RS)";"RS";"ROLANTE";313;36;108;457
2018;"RONDA ALTA (RS)";"RS";"RONDA ALTA";367;14;38;419
2018;"RONDINHA (RS)";"RS";"RONDINHA";200;12;22;234
2018;"ROQUE GONZALES (RS)";"RS";"ROQUE GONZALES";164;6;31;201
2018;"ROSARIO DO SUL (RS)";"RS";"ROSARIO DO SUL";604;61;116;781
2018;"SAGRADA FAMILIA (RS)";"RS";"SAGRADA FAMILIA";42;4;9;55
2018;"SALDANHA MARINHO (RS)";"RS";"SALDANHA MARINHO";189;9;9;207
2018;"SALTO DO JACUI (RS)";"RS";"SALTO DO JACUI";237;29;33;299
2018;"SALVADOR DAS MISSOES (RS)";"RS";"SALVADOR DAS MISSOES";135;6;9;150
2018;"SALVADOR DO SUL (RS)";"RS";"SALVADOR DO SUL";325;22;31;378
2018;"SANANDUVA (RS)";"RS";"SANANDUVA";749;33;83;865
2018;"SANTA BARBARA DO SUL (RS)";"RS";"SANTA BARBARA DO SUL";412;18;35;465
2018;"SANTA CECILIA DO SUL (RS)";"RS";"SANTA CECILIA DO SUL";88;4;15;107
2018;"SANTA CLARA DO SUL (RS)";"RS";"SANTA CLARA DO SUL";144;29;16;189
2018;"SANTA CRUZ DO SUL (RS)";"RS";"SANTA CRUZ DO SUL";2340;184;687;3211
2018;"SANTA MARGARIDA DO SUL (RS)";"RS";"SANTA MARGARIDA DO SUL";70;4;12;86
2018;"SANTA MARIA (RS)";"RS";"SANTA MARIA";3946;440;1092;5478
2018;"SANTA MARIA DO HERVAL (RS)";"RS";"SANTA MARIA DO HERVAL";290;25;60;375
2018;"SANTA ROSA (RS)";"RS";"SANTA ROSA";1833;109;228;2170
2018;"SANTA TEREZA (RS)";"RS";"SANTA TEREZA";114;6;5;125
2018;"SANTA VITORIA DO PALMAR (RS)";"RS";"SANTA VITORIA DO PALMAR";723;29;79;831
2018;"SANTANA DA BOA VISTA (RS)";"RS";"SANTANA DA BOA VISTA";127;22;53;202
2018;"SANTANA DO LIVRAMENTO (RS)";"RS";"SANTANA DO LIVRAMENTO";955;130;260;1345
2018;"SANTIAGO (RS)";"RS";"SANTIAGO";1063;138;117;1318
2018;"SANTO ANGELO (RS)";"RS";"SANTO ANGELO";1418;114;132;1664
2018;"SANTO ANTONIO DA PATRULHA (RS)";"RS";"SANTO ANTONIO DA PATRULHA";1036;73;211;1320
2018;"SANTO ANTONIO DAS MISSOES (RS)";"RS";"SANTO ANTONIO DAS MISSOES";275;66;58;399
2018;"SANTO ANTONIO DO PALMA (RS)";"RS";"SANTO ANTONIO DO PALMA";68;4;13;85
2018;"SANTO ANTONIO DO PLANALTO (RS)";"RS";"SANTO ANTONIO DO PLANALTO";114;4;7;125
2018;"SANTO AUGUSTO (RS)";"RS";"SANTO AUGUSTO";599;49;34;682
2018;"SANTO CRISTO (RS)";"RS";"SANTO CRISTO";608;22;54;684
2018;"SANTO EXPEDITO DO SUL (RS)";"RS";"SANTO EXPEDITO DO SUL";121;2;13;136
2018;"SAO BORJA (RS)";"RS";"SAO BORJA";1259;80;125;1464
2018;"SAO DOMINGOS DO SUL (RS)";"RS";"SAO DOMINGOS DO SUL";130;6;15;151
2018;"SAO FRANCISCO DE ASSIS (RS)";"RS";"SAO FRANCISCO DE ASSIS";414;42;126;582
2018;"SAO FRANCISCO DE PAULA (RS)";"RS";"SAO FRANCISCO DE PAULA";651;51;96;798
2018;"SAO GABRIEL (RS)";"RS";"SAO GABRIEL";992;49;146;1187
2018;"SAO JERONIMO (RS)";"RS";"SAO JERONIMO";356;40;128;524
2018;"SAO JOAO DA URTIGA (RS)";"RS";"SAO JOAO DA URTIGA";187;7;26;220
2018;"SAO JOAO DO POLESINE (RS)";"RS";"SAO JOAO DO POLESINE";103;2;6;111
2018;"SAO JORGE (RS)";"RS";"SAO JORGE";155;9;18;182
2018;"SAO JOSE DAS MISSOES (RS)";"RS";"SAO JOSE DAS MISSOES";48;4;9;61
2018;"SAO JOSE DO HERVAL (RS)";"RS";"SAO JOSE DO HERVAL";82;4;14;100
2018;"SAO JOSE DO HORTENCIO (RS)";"RS";"SAO JOSE DO HORTENCIO";221;11;34;266
2018;"SAO JOSE DO INHACORA (RS)";"RS";"SAO JOSE DO INHACORA";67;5;11;83
2018;"SAO JOSE DO NORTE (RS)";"RS";"SAO JOSE DO NORTE";455;16;141;612
2018;"SAO JOSE DO OURO (RS)";"RS";"SAO JOSE DO OURO";393;8;48;449
2018;"SAO JOSE DO SUL (RS)";"RS";"SAO JOSE DO SUL";159;9;20;188
2018;"SAO JOSE DOS AUSENTES (RS)";"RS";"SAO JOSE DOS AUSENTES";136;10;25;171
2018;"SAO LEOPOLDO (RS)";"RS";"SAO LEOPOLDO";2555;308;431;3294
2018;"SAO LOURENCO DO SUL (RS)";"RS";"SAO LOURENCO DO SUL";1117;66;174;1357
2018;"SAO LUIZ GONZAGA (RS)";"RS";"SAO LUIZ GONZAGA";731;82;109;922
2018;"SAO MARCOS (RS)";"RS";"SAO MARCOS";827;37;135;999
2018;"SAO MARTINHO (RS)";"RS";"SAO MARTINHO";272;7;23;302
2018;"SAO MARTINHO DA SERRA (RS)";"RS";"SAO MARTINHO DA SERRA";73;7;7;87
2018;"SAO MIGUEL DAS MISSOES (RS)";"RS";"SAO MIGUEL DAS MISSOES";309;27;47;383
2018;"SAO NICOLAU (RS)";"RS";"SAO NICOLAU";90;12;18;120
2018;"SAO PAULO DAS MISSOES (RS)";"RS";"SAO PAULO DAS MISSOES";136;8;37;181
2018;"SAO PEDRO DA SERRA (RS)";"RS";"SAO PEDRO DA SERRA";117;13;20;150
2018;"SAO PEDRO DAS MISSOES (RS)";"RS";"SAO PEDRO DAS MISSOES";49;5;8;62
2018;"SAO PEDRO DO BUTIA (RS)";"RS";"SAO PEDRO DO BUTIA";158;3;20;181
2018;"SAO PEDRO DO SUL (RS)";"RS";"SAO PEDRO DO SUL";371;57;55;483
2018;"SAO SEBASTIAO DO CAI (RS)";"RS";"SAO SEBASTIAO DO CAI";801;41;68;910
2018;"SAO SEPE (RS)";"RS";"SAO SEPE";529;62;130;721
2018;"SAO VALENTIM (RS)";"RS";"SAO VALENTIM";86;13;13;112
2018;"SAO VALENTIM DO SUL (RS)";"RS";"SAO VALENTIM DO SUL";87;9;11;107
2018;"SAO VALERIO DO SUL (RS)";"RS";"SAO VALERIO DO SUL";48;2;9;59
2018;"SAO VENDELINO (RS)";"RS";"SAO VENDELINO";79;15;13;107
2018;"SAO VICENTE DO SUL (RS)";"RS";"SAO VICENTE DO SUL";166;9;58;233
2018;"SAPIRANGA (RS)";"RS";"SAPIRANGA";994;113;196;1303
2018;"SAPUCAIA DO SUL (RS)";"RS";"SAPUCAIA DO SUL";1826;158;149;2133
2018;"SARANDI (RS)";"RS";"SARANDI";690;35;86;811
2018;"SEBERI (RS)";"RS";"SEBERI";357;12;68;437
2018;"SEDE NOVA (RS)";"RS";"SEDE NOVA";125;13;13;151
2018;"SEGREDO (RS)";"RS";"SEGREDO";224;8;55;287
2018;"SELBACH (RS)";"RS";"SELBACH";371;15;26;412
2018;"SENADOR SALGADO FILHO (RS)";"RS";"SENADOR SALGADO FILHO";168;11;14;193
2018;"SENTINELA DO SUL (RS)";"RS";"SENTINELA DO SUL";194;5;20;219
2018;"SERAFINA CORREA (RS)";"RS";"SERAFINA CORREA";416;46;82;544
2018;"SERIO (RS)";"RS";"SERIO";72;3;6;81
2018;"SERTAO (RS)";"RS";"SERTAO";304;21;43;368
2018;"SERTAO SANTANA (RS)";"RS";"SERTAO SANTANA";185;3;29;217
2018;"SETE DE SETEMBRO (RS)";"RS";"SETE DE SETEMBRO";109;4;11;124
2018;"SEVERIANO DE ALMEIDA (RS)";"RS";"SEVERIANO DE ALMEIDA";123;13;16;152
2018;"SILVEIRA MARTINS (RS)";"RS";"SILVEIRA MARTINS";138;2;10;150
2018;"SINIMBU (RS)";"RS";"SINIMBU";145;5;6;156
2018;"SOBRADINHO (RS)";"RS";"SOBRADINHO";351;16;69;436
2018;"SOLEDADE (RS)";"RS";"SOLEDADE";697;48;151;896
2018;"TABAI (RS)";"RS";"TABAI";225;17;20;262
2018;"TAPEJARA (RS)";"RS";"TAPEJARA";920;39;133;1092
2018;"TAPERA (RS)";"RS";"TAPERA";445;27;36;508
2018;"TAPES (RS)";"RS";"TAPES";309;25;40;374
2018;"TAQUARA (RS)";"RS";"TAQUARA";926;71;282;1279
2018;"TAQUARI (RS)";"RS";"TAQUARI";489;49;168;706
2018;"TAQUARUCU DO SUL (RS)";"RS";"TAQUARUCU DO SUL";80;4;14;98
2018;"TAVARES (RS)";"RS";"TAVARES";160;22;28;210
2018;"TENENTE PORTELA (RS)";"RS";"TENENTE PORTELA";357;20;76;453
2018;"TERRA DE AREIA (RS)";"RS";"TERRA DE AREIA";355;10;44;409
2018;"TEUTONIA (RS)";"RS";"TEUTONIA";794;40;107;941
2018;"TIO HUGO (RS)";"RS";"TIO HUGO";152;9;20;181
2018;"TIRADENTES DO SUL (RS)";"RS";"TIRADENTES DO SUL";132;4;13;149
2018;"TOROPI (RS)";"RS";"TOROPI";72;9;20;101
2018;"TORRES (RS)";"RS";"TORRES";502;35;114;651
2018;"TRAMANDAI (RS)";"RS";"TRAMANDAI";698;105;188;991
2018;"TRAVESSEIRO (RS)";"RS";"TRAVESSEIRO";47;11;13;71
2018;"TRES ARROIOS (RS)";"RS";"TRES ARROIOS";126;11;5;142
2018;"TRES CACHOEIRAS (RS)";"RS";"TRES CACHOEIRAS";650;13;30;693
2018;"TRES COROAS (RS)";"RS";"TRES COROAS";317;41;83;441
2018;"TRES DE MAIO (RS)";"RS";"TRES DE MAIO";836;48;90;974
2018;"TRES FORQUILHAS (RS)";"RS";"TRES FORQUILHAS";107;4;7;118
2018;"TRES PALMEIRAS (RS)";"RS";"TRES PALMEIRAS";96;6;29;131
2018;"TRES PASSOS (RS)";"RS";"TRES PASSOS";583;32;138;753
2018;"TRINDADE DO SUL (RS)";"RS";"TRINDADE DO SUL";155;22;26;203
2018;"TRIUNFO (RS)";"RS";"TRIUNFO";651;126;261;1038
2018;"TUCUNDUVA (RS)";"RS";"TUCUNDUVA";297;14;15;326
2018;"TUNAS (RS)";"RS";"TUNAS";82;8;25;115
2018;"TUPANCI DO SUL (RS)";"RS";"TUPANCI DO SUL";72;4;17;93
2018;"TUPANCIRETA (RS)";"RS";"TUPANCIRETA";736;90;83;909
2018;"TUPANDI (RS)";"RS";"TUPANDI";119;39;47;205
2018;"TUPARENDI (RS)";"RS";"TUPARENDI";358;18;31;407
2018;"TURUCU (RS)";"RS";"TURUCU";131;9;15;155
2018;"UBIRETAMA (RS)";"RS";"UBIRETAMA";109;10;5;124
2018;"UNIAO DA SERRA (RS)";"RS";"UNIAO DA SERRA";68;5;8;81
2018;"UNISTALDA (RS)";"RS";"UNISTALDA";63;12;19;94
2018;"URUGUAIANA (RS)";"RS";"URUGUAIANA";2045;124;190;2359
2018;"VACARIA (RS)";"RS";"VACARIA";1883;201;610;2694
2018;"VALE DO SOL (RS)";"RS";"VALE DO SOL";208;11;53;272
2018;"VALE REAL (RS)";"RS";"VALE REAL";225;15;12;252
2018;"VALE VERDE (RS)";"RS";"VALE VERDE";71;5;14;90
2018;"VANINI (RS)";"RS";"VANINI";101;12;18;131
2018;"VENANCIO AIRES (RS)";"RS";"VENANCIO AIRES";1289;130;229;1648
2018;"VERA CRUZ (RS)";"RS";"VERA CRUZ";510;44;152;706
2018;"VERANOPOLIS (RS)";"RS";"VERANOPOLIS";971;42;71;1084
2018;"VESPASIANO CORREA (RS)";"RS";"VESPASIANO CORREA";130;9;12;151
2018;"VIADUTOS (RS)";"RS";"VIADUTOS";168;12;24;204
2018;"VIAMAO (RS)";"RS";"VIAMAO";2402;391;689;3482
2018;"VICENTE DUTRA (RS)";"RS";"VICENTE DUTRA";72;1;21;94
2018;"VICTOR GRAEFF (RS)";"RS";"VICTOR GRAEFF";188;15;9;212
2018;"VILA FLORES (RS)";"RS";"VILA FLORES";196;15;19;230
2018;"VILA LANGARO (RS)";"RS";"VILA LANGARO";131;5;15;151
2018;"VILA MARIA (RS)";"RS";"VILA MARIA";337;7;47;391
2018;"VILA NOVA DO SUL (RS)";"RS";"VILA NOVA DO SUL";142;12;14;168
2018;"VISTA ALEGRE (RS)";"RS";"VISTA ALEGRE";90;6;11;107
2018;"VISTA ALEGRE DO PRATA (RS)";"RS";"VISTA ALEGRE DO PRATA";49;12;4;65
2018;"VISTA GAUCHA (RS)";"RS";"VISTA GAUCHA";89;1;15;105
2018;"VITORIA DAS MISSOES (RS)";"RS";"VITORIA DAS MISSOES";147;2;17;166
2018;"WESTFALIA (RS)";"RS";"WESTFALIA";163;13;18;194
2018;"XANGRI LA (RS)";"RS";"XANGRI LA";226;13;20;259
2018;"ABDON BATISTA (SC)";"SC";"ABDON BATISTA";83;4;13;100
2018;"ABELARDO LUZ (SC)";"SC";"ABELARDO LUZ";454;26;128;608
2018;"AGROLANDIA (SC)";"SC";"AGROLANDIA";283;17;22;322
2018;"AGRONOMICA (SC)";"SC";"AGRONOMICA";169;6;11;186
2018;"AGUA DOCE (SC)";"SC";"AGUA DOCE";252;35;35;322
2018;"AGUAS DE CHAPECO (SC)";"SC";"AGUAS DE CHAPECO";81;8;33;122
2018;"AGUAS FRIAS (SC)";"SC";"AGUAS FRIAS";70;7;7;84
2018;"AGUAS MORNAS (SC)";"SC";"AGUAS MORNAS";317;6;19;342
2018;"ALFREDO WAGNER (SC)";"SC";"ALFREDO WAGNER";332;24;21;377
2018;"ALTO BELA VISTA (SC)";"SC";"ALTO BELA VISTA";67;10;10;87
2018;"ANCHIETA (SC)";"SC";"ANCHIETA";225;14;26;265
2018;"ANGELINA (SC)";"SC";"ANGELINA";254;23;23;300
2018;"ANITA GARIBALDI (SC)";"SC";"ANITA GARIBALDI";155;14;37;206
2018;"ANITAPOLIS (SC)";"SC";"ANITAPOLIS";149;6;16;171
2018;"ANTONIO CARLOS (SC)";"SC";"ANTONIO CARLOS";698;7;17;722
2018;"APIUNA (SC)";"SC";"APIUNA";215;37;24;276
2018;"ARABUTA (SC)";"SC";"ARABUTA";150;13;36;199
2018;"ARAQUARI (SC)";"SC";"ARAQUARI";922;74;71;1067
2018;"ARARANGUA (SC)";"SC";"ARARANGUA";1437;84;164;1685
2018;"ARMAZEM (SC)";"SC";"ARMAZEM";297;14;21;332
2018;"ARROIO TRINTA (SC)";"SC";"ARROIO TRINTA";199;13;19;231
2018;"ARVOREDO (SC)";"SC";"ARVOREDO";61;34;9;104
2018;"ASCURRA (SC)";"SC";"ASCURRA";268;21;41;330
2018;"ATALANTA (SC)";"SC";"ATALANTA";99;1;8;108
2018;"AURORA (SC)";"SC";"AURORA";223;5;20;248
2018;"BALNEARIO ARROIO DO SILVA (SC)";"SC";"BALNEARIO ARROIO DO SILVA";140;12;17;169
2018;"BALNEARIO BARRA DO SUL (SC)";"SC";"BALNEARIO BARRA DO SUL";184;13;13;210
2018;"BALNEARIO CAMBORIU (SC)";"SC";"BALNEARIO CAMBORIU";924;294;295;1513
2018;"BALNEARIO DE PICARRAS (SC)";"SC";"BALNEARIO DE PICARRAS";338;44;58;440
2018;"BALNEARIO GAIVOTA (SC)";"SC";"BALNEARIO GAIVOTA";222;13;27;262
2018;"BALNEARIO RINCAO (SC)";"SC";"BALNEARIO RINCAO";111;13;10;134
2018;"BANDEIRANTE (SC)";"SC";"BANDEIRANTE";56;6;17;79
2018;"BARRA BONITA (SC)";"SC";"BARRA BONITA";42;6;9;57
2018;"BARRA VELHA (SC)";"SC";"BARRA VELHA";640;46;58;744
2018;"BELA VISTA DO TOLDO (SC)";"SC";"BELA VISTA DO TOLDO";115;8;41;164
2018;"BELMONTE (SC)";"SC";"BELMONTE";81;9;6;96
2018;"BENEDITO NOVO (SC)";"SC";"BENEDITO NOVO";338;44;32;414
2018;"BIGUACU (SC)";"SC";"BIGUACU";1506;88;140;1734
2018;"BLUMENAU (SC)";"SC";"BLUMENAU";5676;470;980;7126
2018;"BOCAINA DO SUL (SC)";"SC";"BOCAINA DO SUL";71;3;16;90
2018;"BOM JARDIM DA SERRA (SC)";"SC";"BOM JARDIM DA SERRA";172;16;27;215
2018;"BOM JESUS (SC)";"SC";"BOM JESUS";75;3;11;89
2018;"BOM JESUS DO OESTE (SC)";"SC";"BOM JESUS DO OESTE";75;6;10;91
2018;"BOM RETIRO (SC)";"SC";"BOM RETIRO";220;21;40;281
2018;"BOMBINHAS (SC)";"SC";"BOMBINHAS";204;60;37;301
2018;"BOTUVERA (SC)";"SC";"BOTUVERA";226;8;17;251
2018;"BRACO DO NORTE (SC)";"SC";"BRACO DO NORTE";1247;51;81;1379
2018;"BRACO DO TROMBUDO (SC)";"SC";"BRACO DO TROMBUDO";146;7;10;163
2018;"BRUNOPOLIS (SC)";"SC";"BRUNOPOLIS";130;4;12;146
2018;"BRUSQUE (SC)";"SC";"BRUSQUE";2662;168;197;3027
2018;"CACADOR (SC)";"SC";"CACADOR";2194;155;762;3111
2018;"CAIBI (SC)";"SC";"CAIBI";182;7;20;209
2018;"CALMON (SC)";"SC";"CALMON";45;14;26;85
2018;"CAMBORIU (SC)";"SC";"CAMBORIU";1212;67;47;1326
2018;"CAMPO ALEGRE (SC)";"SC";"CAMPO ALEGRE";452;21;18;491
2018;"CAMPO BELO DO SUL (SC)";"SC";"CAMPO BELO DO SUL";230;14;52;296
2018;"CAMPO ERE (SC)";"SC";"CAMPO ERE";355;17;36;408
2018;"CAMPOS NOVOS (SC)";"SC";"CAMPOS NOVOS";1152;118;125;1395
2018;"CANELINHA (SC)";"SC";"CANELINHA";530;16;12;558
2018;"CANOINHAS (SC)";"SC";"CANOINHAS";1347;81;180;1608
2018;"CAPAO ALTO (SC)";"SC";"CAPAO ALTO";79;8;17;104
2018;"CAPINZAL (SC)";"SC";"CAPINZAL";525;54;67;646
2018;"CAPIVARI DE BAIXO (SC)";"SC";"CAPIVARI DE BAIXO";389;23;25;437
2018;"CATANDUVAS (SC)";"SC";"CATANDUVAS";451;32;44;527
2018;"CAXAMBU DO SUL (SC)";"SC";"CAXAMBU DO SUL";131;5;13;149
2018;"CELSO RAMOS (SC)";"SC";"CELSO RAMOS";81;8;8;97
2018;"CERRO NEGRO (SC)";"SC";"CERRO NEGRO";71;7;21;99
2018;"CHAPADAO DO LAGEADO (SC)";"SC";"CHAPADAO DO LAGEADO";57;7;11;75
2018;"CHAPECO (SC)";"SC";"CHAPECO";4655;343;461;5459
2018;"COCAL DO SUL (SC)";"SC";"COCAL DO SUL";341;21;27;389
2018;"CONCORDIA (SC)";"SC";"CONCORDIA";2823;176;263;3262
2018;"CORDILHEIRA ALTA (SC)";"SC";"CORDILHEIRA ALTA";335;28;19;382
2018;"CORONEL FREITAS (SC)";"SC";"CORONEL FREITAS";306;13;33;352
2018;"CORONEL MARTINS (SC)";"SC";"CORONEL MARTINS";54;7;10;71
2018;"CORREIA PINTO (SC)";"SC";"CORREIA PINTO";452;58;78;588
2018;"CORUPA (SC)";"SC";"CORUPA";454;9;37;500
2018;"CRICIUMA (SC)";"SC";"CRICIUMA";3526;339;436;4301
2018;"CUNHA PORA (SC)";"SC";"CUNHA PORA";437;20;66;523
2018;"CUNHATAI (SC)";"SC";"CUNHATAI";54;3;10;67
2018;"CURITIBANOS (SC)";"SC";"CURITIBANOS";1079;99;159;1337
2018;"DESCANSO (SC)";"SC";"DESCANSO";235;18;35;288
2018;"DIONISIO CERQUEIRA (SC)";"SC";"DIONISIO CERQUEIRA";203;24;21;248
2018;"DONA EMMA (SC)";"SC";"DONA EMMA";134;16;13;163
2018;"DOUTOR PEDRINHO (SC)";"SC";"DOUTOR PEDRINHO";144;7;6;157
2018;"ENTRE RIOS (SC)";"SC";"ENTRE RIOS";40;3;30;73
2018;"ERMO (SC)";"SC";"ERMO";106;3;10;119
2018;"ERVAL VELHO (SC)";"SC";"ERVAL VELHO";129;11;26;166
2018;"FAXINAL DOS GUEDES (SC)";"SC";"FAXINAL DOS GUEDES";410;21;45;476
2018;"FLOR DO SERTAO (SC)";"SC";"FLOR DO SERTAO";27;10;16;53
2018;"FLORIANOPOLIS (SC)";"SC";"FLORIANOPOLIS";3796;917;1901;6614
2018;"FORMOSA DO SUL (SC)";"SC";"FORMOSA DO SUL";64;4;17;85
2018;"FORQUILHINHA (SC)";"SC";"FORQUILHINHA";623;29;39;691
2018;"FRAIBURGO (SC)";"SC";"FRAIBURGO";962;59;233;1254
2018;"FREI ROGERIO (SC)";"SC";"FREI ROGERIO";101;10;19;130
2018;"GALVAO (SC)";"SC";"GALVAO";113;6;16;135
2018;"GAROPABA (SC)";"SC";"GAROPABA";315;34;60;409
2018;"GARUVA (SC)";"SC";"GARUVA";590;33;54;677
2018;"GASPAR (SC)";"SC";"GASPAR";1451;68;69;1588
2018;"GOVERNADOR CELSO RAMOS (SC)";"SC";"GOVERNADOR CELSO RAMOS";210;25;19;254
2018;"GRAO PARA (SC)";"SC";"GRAO PARA";289;8;18;315
2018;"GRAVATAL (SC)";"SC";"GRAVATAL";332;17;21;370
2018;"GUABIRUBA (SC)";"SC";"GUABIRUBA";349;23;23;395
2018;"GUARACIABA (SC)";"SC";"GUARACIABA";273;13;42;328
2018;"GUARAMIRIM (SC)";"SC";"GUARAMIRIM";1096;33;30;1159
2018;"GUARUJA DO SUL (SC)";"SC";"GUARUJA DO SUL";184;13;24;221
2018;"GUATAMBU (SC)";"SC";"GUATAMBU";160;18;26;204
2018;"HERVAL D OESTE (SC)";"SC";"HERVAL D OESTE";397;43;68;508
2018;"IBIAM (SC)";"SC";"IBIAM";76;4;17;97
2018;"IBICARE (SC)";"SC";"IBICARE";174;12;10;196
2018;"IBIRAMA (SC)";"SC";"IBIRAMA";498;73;97;668
2018;"ICARA (SC)";"SC";"ICARA";1891;109;151;2151
2018;"ILHOTA (SC)";"SC";"ILHOTA";409;28;30;467
2018;"IMARUI (SC)";"SC";"IMARUI";174;29;31;234
2018;"IMBITUBA (SC)";"SC";"IMBITUBA";771;82;101;954
2018;"IMBUIA (SC)";"SC";"IMBUIA";195;8;21;224
2018;"INDAIAL (SC)";"SC";"INDAIAL";1651;106;145;1902
2018;"IOMERE (SC)";"SC";"IOMERE";169;6;9;184
2018;"IPIRA (SC)";"SC";"IPIRA";135;7;19;161
2018;"IPORA DO OESTE (SC)";"SC";"IPORA DO OESTE";285;32;55;372
2018;"IPUACU (SC)";"SC";"IPUACU";126;10;42;178
2018;"IPUMIRIM (SC)";"SC";"IPUMIRIM";296;43;34;373
2018;"IRACEMINHA (SC)";"SC";"IRACEMINHA";127;9;25;161
2018;"IRANI (SC)";"SC";"IRANI";401;25;73;499
2018;"IRATI (SC)";"SC";"IRATI";43;8;8;59
2018;"IRINEOPOLIS (SC)";"SC";"IRINEOPOLIS";313;14;19;346
2018;"ITA (SC)";"SC";"ITA";125;16;43;184
2018;"ITAIOPOLIS (SC)";"SC";"ITAIOPOLIS";703;30;110;843
2018;"ITAJAI (SC)";"SC";"ITAJAI";4618;297;390;5305
2018;"ITAPEMA (SC)";"SC";"ITAPEMA";666;73;53;792
2018;"ITAPIRANGA (SC)";"SC";"ITAPIRANGA";396;26;82;504
2018;"ITAPOA (SC)";"SC";"ITAPOA";289;30;22;341
2018;"ITUPORANGA (SC)";"SC";"ITUPORANGA";761;33;74;868
2018;"JABORA (SC)";"SC";"JABORA";156;16;27;199
2018;"JACINTO MACHADO (SC)";"SC";"JACINTO MACHADO";457;12;42;511
2018;"JAGUARUNA (SC)";"SC";"JAGUARUNA";521;30;74;625
2018;"JARAGUA DO SUL (SC)";"SC";"JARAGUA DO SUL";2663;244;446;3353
2018;"JARDINOPOLIS (SC)";"SC";"JARDINOPOLIS";26;7;8;41
2018;"JOACABA (SC)";"SC";"JOACABA";868;65;50;983
2018;"JOINVILLE (SC)";"SC";"JOINVILLE";8362;791;887;10040
2018;"JOSE BOITEUX (SC)";"SC";"JOSE BOITEUX";128;25;10;163
2018;"JUPIA (SC)";"SC";"JUPIA";57;7;10;74
2018;"LACERDOPOLIS (SC)";"SC";"LACERDOPOLIS";126;5;7;138
2018;"LAGEADO GRANDE (SC)";"SC";"LAGEADO GRANDE";46;2;4;52
2018;"LAGES (SC)";"SC";"LAGES";3557;294;404;4255
2018;"LAGUNA (SC)";"SC";"LAGUNA";561;130;96;787
2018;"LAURENTINO (SC)";"SC";"LAURENTINO";332;8;10;350
2018;"LAURO MULLER (SC)";"SC";"LAURO MULLER";494;30;51;575
2018;"LEBON REGIS (SC)";"SC";"LEBON REGIS";287;27;65;379
2018;"LEOBERTO LEAL (SC)";"SC";"LEOBERTO LEAL";122;14;5;141
2018;"LINDOIA DO SUL (SC)";"SC";"LINDOIA DO SUL";147;12;42;201
2018;"LONTRAS (SC)";"SC";"LONTRAS";375;25;40;440
2018;"LUIZ ALVES (SC)";"SC";"LUIZ ALVES";513;15;28;556
2018;"LUZERNA (SC)";"SC";"LUZERNA";154;15;25;194
2018;"MACIEIRA (SC)";"SC";"MACIEIRA";101;8;16;125
2018;"MAFRA (SC)";"SC";"MAFRA";1480;106;165;1751
2018;"MAJOR GERCINO (SC)";"SC";"MAJOR GERCINO";140;7;13;160
2018;"MAJOR VIEIRA (SC)";"SC";"MAJOR VIEIRA";223;5;16;244
2018;"MARACAJA (SC)";"SC";"MARACAJA";250;3;16;269
2018;"MARAVILHA (SC)";"SC";"MARAVILHA";873;35;78;986
2018;"MAREMA (SC)";"SC";"MAREMA";66;7;10;83
2018;"MASSARANDUBA (SC)";"SC";"MASSARANDUBA";614;34;40;688
2018;"MATOS COSTA (SC)";"SC";"MATOS COSTA";68;7;21;96
2018;"MELEIRO (SC)";"SC";"MELEIRO";273;12;25;310
2018;"MIRIM DOCE (SC)";"SC";"MIRIM DOCE";69;3;12;84
2018;"MODELO (SC)";"SC";"MODELO";140;10;12;162
2018;"MONDAI (SC)";"SC";"MONDAI";194;12;64;270
2018;"MONTE CARLO (SC)";"SC";"MONTE CARLO";180;22;101;303
2018;"MONTE CASTELO (SC)";"SC";"MONTE CASTELO";197;17;26;240
2018;"MORRO DA FUMACA (SC)";"SC";"MORRO DA FUMACA";856;31;39;926
2018;"MORRO GRANDE (SC)";"SC";"MORRO GRANDE";145;4;13;162
2018;"NAVEGANTES (SC)";"SC";"NAVEGANTES";929;127;73;1129
2018;"NOVA ERECHIM (SC)";"SC";"NOVA ERECHIM";138;6;13;157
2018;"NOVA ITABERABA (SC)";"SC";"NOVA ITABERABA";131;6;16;153
2018;"NOVA TRENTO (SC)";"SC";"NOVA TRENTO";318;52;41;411
2018;"NOVA VENEZA (SC)";"SC";"NOVA VENEZA";469;39;45;553
2018;"NOVO HORIZONTE (SC)";"SC";"NOVO HORIZONTE";68;13;19;100
2018;"ORLEANS (SC)";"SC";"ORLEANS";917;43;50;1010
2018;"OTACILIO COSTA (SC)";"SC";"OTACILIO COSTA";527;45;72;644
2018;"OURO (SC)";"SC";"OURO";261;30;32;323
2018;"OURO VERDE (SC)";"SC";"OURO VERDE";95;2;8;105
2018;"PAIAL (SC)";"SC";"PAIAL";24;1;14;39
2018;"PAINEL (SC)";"SC";"PAINEL";44;5;9;58
2018;"PALHOCA (SC)";"SC";"PALHOCA";2654;208;412;3274
2018;"PALMA SOLA (SC)";"SC";"PALMA SOLA";218;8;36;262
2018;"PALMEIRA (SC)";"SC";"PALMEIRA";120;8;6;134
2018;"PALMITOS (SC)";"SC";"PALMITOS";428;54;65;547
2018;"PAPANDUVA (SC)";"SC";"PAPANDUVA";573;18;96;687
2018;"PARAISO (SC)";"SC";"PARAISO";111;7;12;130
2018;"PASSO DE TORRES (SC)";"SC";"PASSO DE TORRES";184;13;24;221
2018;"PASSOS MAIA (SC)";"SC";"PASSOS MAIA";136;5;53;194
2018;"PAULO LOPES (SC)";"SC";"PAULO LOPES";277;16;63;356
2018;"PEDRAS GRANDES (SC)";"SC";"PEDRAS GRANDES";255;24;16;295
2018;"PENHA (SC)";"SC";"PENHA";418;51;62;531
2018;"PERITIBA (SC)";"SC";"PERITIBA";109;7;16;132
2018;"PESCARIA BRAVA (SC)";"SC";"PESCARIA BRAVA";126;5;6;137
2018;"PETROLANDIA (SC)";"SC";"PETROLANDIA";197;10;23;230
2018;"PINHALZINHO (SC)";"SC";"PINHALZINHO";563;26;66;655
2018;"PINHEIRO PRETO (SC)";"SC";"PINHEIRO PRETO";321;8;16;345
2018;"PIRATUBA (SC)";"SC";"PIRATUBA";122;10;31;163
2018;"PLANALTO ALEGRE (SC)";"SC";"PLANALTO ALEGRE";83;7;6;96
2018;"POMERODE (SC)";"SC";"POMERODE";689;36;87;812
2018;"PONTE ALTA (SC)";"SC";"PONTE ALTA";154;13;17;184
2018;"PONTE ALTA DO NORTE (SC)";"SC";"PONTE ALTA DO NORTE";103;6;10;119
2018;"PONTE SERRADA (SC)";"SC";"PONTE SERRADA";359;51;124;534
2018;"PORTO BELO (SC)";"SC";"PORTO BELO";323;39;39;401
2018;"PORTO UNIAO (SC)";"SC";"PORTO UNIAO";743;40;46;829
2018;"POUSO REDONDO (SC)";"SC";"POUSO REDONDO";536;21;50;607
2018;"PRAIA GRANDE (SC)";"SC";"PRAIA GRANDE";284;10;26;320
2018;"PRESIDENTE CASTELO BRANCO (SC)";"SC";"PRESIDENTE CASTELO BRANCO";78;4;8;90
2018;"PRESIDENTE GETULIO (SC)";"SC";"PRESIDENTE GETULIO";392;51;66;509
2018;"PRESIDENTE NEREU (SC)";"SC";"PRESIDENTE NEREU";45;7;7;59
2018;"PRINCESA (SC)";"SC";"PRINCESA";66;2;12;80
2018;"QUILOMBO (SC)";"SC";"QUILOMBO";242;32;55;329
2018;"RANCHO QUEIMADO (SC)";"SC";"RANCHO QUEIMADO";165;7;8;180
2018;"RIO DAS ANTAS (SC)";"SC";"RIO DAS ANTAS";219;11;35;265
2018;"RIO DO CAMPO (SC)";"SC";"RIO DO CAMPO";201;13;20;234
2018;"RIO DO OESTE (SC)";"SC";"RIO DO OESTE";225;18;22;265
2018;"RIO DO SUL (SC)";"SC";"RIO DO SUL";1443;87;121;1651
2018;"RIO DOS CEDROS (SC)";"SC";"RIO DOS CEDROS";295;34;34;363
2018;"RIO FORTUNA (SC)";"SC";"RIO FORTUNA";301;9;17;327
2018;"RIO NEGRINHO (SC)";"SC";"RIO NEGRINHO";1134;75;127;1336
2018;"RIO RUFINO (SC)";"SC";"RIO RUFINO";62;7;23;92
2018;"RIQUEZA (SC)";"SC";"RIQUEZA";151;6;28;185
2018;"RODEIO (SC)";"SC";"RODEIO";283;19;27;329
2018;"ROMELANDIA (SC)";"SC";"ROMELANDIA";100;7;31;138
2018;"SALETE (SC)";"SC";"SALETE";207;10;28;245
2018;"SALTINHO (SC)";"SC";"SALTINHO";71;8;26;105
2018;"SALTO VELOSO (SC)";"SC";"SALTO VELOSO";170;8;10;188
2018;"SANGAO (SC)";"SC";"SANGAO";490;18;17;525
2018;"SANTA CECILIA (SC)";"SC";"SANTA CECILIA";532;43;69;644
2018;"SANTA HELENA (SC)";"SC";"SANTA HELENA";66;17;16;99
2018;"SANTA ROSA DE LIMA (SC)";"SC";"SANTA ROSA DE LIMA";130;4;12;146
2018;"SANTA ROSA DO SUL (SC)";"SC";"SANTA ROSA DO SUL";296;13;29;338
2018;"SANTA TEREZINHA (SC)";"SC";"SANTA TEREZINHA";211;17;31;259
2018;"SANTA TEREZINHA DO PROGRESSO (SC)";"SC";"SANTA TEREZINHA DO PROGRESSO";49;5;18;72
2018;"SANTIAGO DO SUL (SC)";"SC";"SANTIAGO DO SUL";72;9;5;86
2018;"SANTO AMARO DA IMPERATRIZ (SC)";"SC";"SANTO AMARO DA IMPERATRIZ";700;32;71;803
2018;"SAO BENTO DO SUL (SC)";"SC";"SAO BENTO DO SUL";1727;167;195;2089
2018;"SAO BERNARDINO (SC)";"SC";"SAO BERNARDINO";58;7;23;88
2018;"SAO BONIFACIO (SC)";"SC";"SAO BONIFACIO";151;8;11;170
2018;"SAO CARLOS (SC)";"SC";"SAO CARLOS";237;20;53;310
2018;"SAO CRISTOVAO DO SUL (SC)";"SC";"SAO CRISTOVAO DO SUL";338;6;14;358
2018;"SAO DOMINGOS (SC)";"SC";"SAO DOMINGOS";385;26;65;476
2018;"SAO FRANCISCO DO SUL (SC)";"SC";"SAO FRANCISCO DO SUL";772;69;96;937
2018;"SAO JOAO BATISTA (SC)";"SC";"SAO JOAO BATISTA";629;39;59;727
2018;"SAO JOAO DO ITAPERIU (SC)";"SC";"SAO JOAO DO ITAPERIU";261;7;13;281
2018;"SAO JOAO DO OESTE (SC)";"SC";"SAO JOAO DO OESTE";195;15;21;231
2018;"SAO JOAO DO SUL (SC)";"SC";"SAO JOAO DO SUL";239;6;20;265
2018;"SAO JOAQUIM (SC)";"SC";"SAO JOAQUIM";1167;118;247;1532
2018;"SAO JOSE (SC)";"SC";"SAO JOSE";3582;264;234;4080
2018;"SAO JOSE DO CEDRO (SC)";"SC";"SAO JOSE DO CEDRO";432;19;75;526
2018;"SAO JOSE DO CERRITO (SC)";"SC";"SAO JOSE DO CERRITO";238;17;61;316
2018;"SAO LOURENCO D OESTE (SC)";"SC";"SAO LOURENCO D OESTE";885;65;100;1050
2018;"SAO LUDGERO (SC)";"SC";"SAO LUDGERO";660;16;27;703
2018;"SAO MARTINHO (SC)";"SC";"SAO MARTINHO";166;6;6;178
2018;"SAO MIGUEL D OESTE (SC)";"SC";"SAO MIGUEL D OESTE";1134;74;122;1330
2018;"SAO MIGUEL DA BOA VISTA (SC)";"SC";"SAO MIGUEL DA BOA VISTA";37;3;11;51
2018;"SAO PEDRO DE ALCANTARA (SC)";"SC";"SAO PEDRO DE ALCANTARA";160;8;5;173
2018;"SAUDADES (SC)";"SC";"SAUDADES";270;14;42;326
2018;"SCHROEDER (SC)";"SC";"SCHROEDER";263;15;25;303
2018;"SEARA (SC)";"SC";"SEARA";424;70;108;602
2018;"SERRA ALTA (SC)";"SC";"SERRA ALTA";71;11;15;97
2018;"SIDEROPOLIS (SC)";"SC";"SIDEROPOLIS";443;26;73;542
2018;"SOMBRIO (SC)";"SC";"SOMBRIO";797;75;95;967
2018;"SUL BRASIL (SC)";"SC";"SUL BRASIL";64;5;13;82
2018;"TAIO (SC)";"SC";"TAIO";639;21;72;732
2018;"TANGARA (SC)";"SC";"TANGARA";447;15;52;514
2018;"TIGRINHOS (SC)";"SC";"TIGRINHOS";38;3;11;52
2018;"TIJUCAS (SC)";"SC";"TIJUCAS";1094;63;58;1215
2018;"TIMBE DO SUL (SC)";"SC";"TIMBE DO SUL";177;15;20;212
2018;"TIMBO (SC)";"SC";"TIMBO";758;68;49;875
2018;"TIMBO GRANDE (SC)";"SC";"TIMBO GRANDE";201;10;41;252
2018;"TRES BARRAS (SC)";"SC";"TRES BARRAS";331;36;68;435
2018;"TREVISO (SC)";"SC";"TREVISO";128;10;9;147
2018;"TREZE DE MAIO (SC)";"SC";"TREZE DE MAIO";414;16;27;457
2018;"TREZE TILIAS (SC)";"SC";"TREZE TILIAS";349;24;50;423
2018;"TROMBUDO CENTRAL (SC)";"SC";"TROMBUDO CENTRAL";252;22;25;299
2018;"TUBARAO (SC)";"SC";"TUBARAO";2412;121;314;2847
2018;"TUNAPOLIS (SC)";"SC";"TUNAPOLIS";111;14;24;149
2018;"TURVO (SC)";"SC";"TURVO";520;27;44;591
2018;"UNIAO DO OESTE (SC)";"SC";"UNIAO DO OESTE";59;4;16;79
2018;"URUBICI (SC)";"SC";"URUBICI";301;29;54;384
2018;"URUPEMA (SC)";"SC";"URUPEMA";87;18;10;115
2018;"URUSSANGA (SC)";"SC";"URUSSANGA";508;45;93;646
2018;"VARGEAO (SC)";"SC";"VARGEAO";178;4;13;195
2018;"VARGEM (SC)";"SC";"VARGEM";71;0;14;85
2018;"VARGEM BONITA (SC)";"SC";"VARGEM BONITA";197;13;23;233
2018;"VIDAL RAMOS (SC)";"SC";"VIDAL RAMOS";187;16;20;223
2018;"VIDEIRA (SC)";"SC";"VIDEIRA";1813;133;175;2121
2018;"VITOR MEIRELES (SC)";"SC";"VITOR MEIRELES";100;19;22;141
2018;"WITMARSUM (SC)";"SC";"WITMARSUM";132;7;16;155
2018;"XANXERE (SC)";"SC";"XANXERE";1353;130;130;1613
2018;"XAVANTINA (SC)";"SC";"XAVANTINA";126;18;10;154
2018;"XAXIM (SC)";"SC";"XAXIM";778;72;154;1004
2018;"ZORTEA (SC)";"SC";"ZORTEA";50;15;6;71
2018;"AMPARO DE SAO FRANCISCO (SE)";"SE";"AMPARO DE SAO FRANCISCO";9;13;3;25
2018;"AQUIDABA (SE)";"SE";"AQUIDABA";138;19;52;209
2018;"ARACAJU (SE)";"SE";"ARACAJU";6016;1051;2586;9653
2018;"ARAUA (SE)";"SE";"ARAUA";46;20;30;96
2018;"AREIA BRANCA (SE)";"SE";"AREIA BRANCA";158;27;22;207
2018;"BARRA DOS COQUEIROS (SE)";"SE";"BARRA DOS COQUEIROS";88;49;47;184
2018;"BOQUIM (SE)";"SE";"BOQUIM";218;23;54;295
2018;"BREJO GRANDE (SE)";"SE";"BREJO GRANDE";8;6;14;28
2018;"CAMPO DO BRITO (SE)";"SE";"CAMPO DO BRITO";522;17;79;618
2018;"CANHOBA (SE)";"SE";"CANHOBA";6;3;6;15
2018;"CANINDE DE SAO FRANCISCO (SE)";"SE";"CANINDE DE SAO FRANCISCO";213;79;26;318
2018;"CAPELA (SE)";"SE";"CAPELA";141;38;70;249
2018;"CARIRA (SE)";"SE";"CARIRA";305;34;114;453
2018;"CARMOPOLIS (SE)";"SE";"CARMOPOLIS";99;44;51;194
2018;"CEDRO DE SAO JOAO (SE)";"SE";"CEDRO DE SAO JOAO";22;6;5;33
2018;"CRISTINAPOLIS (SE)";"SE";"CRISTINAPOLIS";103;20;46;169
2018;"CUMBE (SE)";"SE";"CUMBE";32;12;16;60
2018;"DIVINA PASTORA (SE)";"SE";"DIVINA PASTORA";9;8;9;26
2018;"ESTANCIA (SE)";"SE";"ESTANCIA";576;190;275;1041
2018;"FEIRA NOVA (SE)";"SE";"FEIRA NOVA";21;11;7;39
2018;"FREI PAULO (SE)";"SE";"FREI PAULO";148;19;40;207
2018;"GARARU (SE)";"SE";"GARARU";49;16;29;94
2018;"GENERAL MAYNARD (SE)";"SE";"GENERAL MAYNARD";12;12;11;35
2018;"GRACCHO CARDOSO (SE)";"SE";"GRACCHO CARDOSO";21;10;9;40
2018;"ILHA DAS FLORES (SE)";"SE";"ILHA DAS FLORES";17;10;13;40
2018;"INDIAROBA (SE)";"SE";"INDIAROBA";39;22;22;83
2018;"ITABAIANA (SE)";"SE";"ITABAIANA";3358;144;208;3710
2018;"ITABAIANINHA (SE)";"SE";"ITABAIANINHA";595;76;77;748
2018;"ITABI (SE)";"SE";"ITABI";23;4;8;35
2018;"ITAPORANGA D AJUDA (SE)";"SE";"ITAPORANGA D AJUDA";322;44;84;450
2018;"JAPARATUBA (SE)";"SE";"JAPARATUBA";61;26;75;162
2018;"JAPOATA (SE)";"SE";"JAPOATA";59;15;47;121
2018;"LAGARTO (SE)";"SE";"LAGARTO";1160;153;255;1568
2018;"LARANJEIRAS (SE)";"SE";"LARANJEIRAS";134;62;43;239
2018;"MACAMBIRA (SE)";"SE";"MACAMBIRA";56;5;23;84
2018;"MALHADA DOS BOIS (SE)";"SE";"MALHADA DOS BOIS";17;5;11;33
2018;"MALHADOR (SE)";"SE";"MALHADOR";223;26;58;307
2018;"MARUIM (SE)";"SE";"MARUIM";53;26;36;115
2018;"MOITA BONITA (SE)";"SE";"MOITA BONITA";475;18;23;516
2018;"MONTE ALEGRE DE SERGIPE (SE)";"SE";"MONTE ALEGRE DE SERGIPE";173;39;47;259
2018;"MURIBECA (SE)";"SE";"MURIBECA";56;8;42;106
2018;"NEOPOLIS (SE)";"SE";"NEOPOLIS";53;20;35;108
2018;"NOSSA SENHORA APARECIDA (SE)";"SE";"NOSSA SENHORA APARECIDA";146;24;22;192
2018;"NOSSA SENHORA DA GLORIA (SE)";"SE";"NOSSA SENHORA DA GLORIA";505;66;189;760
2018;"NOSSA SENHORA DAS DORES (SE)";"SE";"NOSSA SENHORA DAS DORES";255;33;136;424
2018;"NOSSA SENHORA DE LOURDES (SE)";"SE";"NOSSA SENHORA DE LOURDES";32;5;12;49
2018;"NOSSA SENHORA DO SOCORRO (SE)";"SE";"NOSSA SENHORA DO SOCORRO";1053;130;224;1407
2018;"PACATUBA (SE)";"SE";"PACATUBA";419;10;60;489
2018;"PEDRA MOLE (SE)";"SE";"PEDRA MOLE";6;3;4;13
2018;"PEDRINHAS (SE)";"SE";"PEDRINHAS";69;6;12;87
2018;"PINHAO (SE)";"SE";"PINHAO";23;16;10;49
2018;"PIRAMBU (SE)";"SE";"PIRAMBU";28;8;24;60
2018;"POCO REDONDO (SE)";"SE";"POCO REDONDO";180;58;77;315
2018;"POCO VERDE (SE)";"SE";"POCO VERDE";147;75;121;343
2018;"PORTO DA FOLHA (SE)";"SE";"PORTO DA FOLHA";138;44;39;221
2018;"PROPRIA (SE)";"SE";"PROPRIA";258;25;60;343
2018;"RIACHAO DO DANTAS (SE)";"SE";"RIACHAO DO DANTAS";40;5;21;66
2018;"RIACHUELO (SE)";"SE";"RIACHUELO";39;14;10;63
2018;"RIBEIROPOLIS (SE)";"SE";"RIBEIROPOLIS";275;43;78;396
2018;"ROSARIO DO CATETE (SE)";"SE";"ROSARIO DO CATETE";46;23;16;85
2018;"SALGADO (SE)";"SE";"SALGADO";148;18;140;306
2018;"SANTA LUZIA DO ITANHY (SE)";"SE";"SANTA LUZIA DO ITANHY";27;14;27;68
2018;"SANTA ROSA DE LIMA (SE)";"SE";"SANTA ROSA DE LIMA";25;5;10;40
2018;"SANTANA DO SAO FRANCISCO (SE)";"SE";"SANTANA DO SAO FRANCISCO";14;5;9;28
2018;"SANTO AMARO DAS BROTAS (SE)";"SE";"SANTO AMARO DAS BROTAS";20;7;19;46
2018;"SAO CRISTOVAO (SE)";"SE";"SAO CRISTOVAO";447;122;338;907
2018;"SAO DOMINGOS (SE)";"SE";"SAO DOMINGOS";153;13;31;197
2018;"SAO FRANCISCO (SE)";"SE";"SAO FRANCISCO";22;3;23;48
2018;"SAO MIGUEL DO ALEIXO (SE)";"SE";"SAO MIGUEL DO ALEIXO";46;3;7;56
2018;"SIMAO DIAS (SE)";"SE";"SIMAO DIAS";276;59;313;648
2018;"SIRIRI (SE)";"SE";"SIRIRI";35;8;64;107
2018;"TELHA (SE)";"SE";"TELHA";18;12;6;36
2018;"TOBIAS BARRETO (SE)";"SE";"TOBIAS BARRETO";358;96;260;714
2018;"TOMAR DO GERU (SE)";"SE";"TOMAR DO GERU";56;8;23;87
2018;"UMBAUBA (SE)";"SE";"UMBAUBA";317;45;49;411
2018;"ADAMANTINA (SP)";"SP";"ADAMANTINA";740;66;79;885
2018;"ADOLFO (SP)";"SP";"ADOLFO";71;3;29;103
2018;"AGUAI (SP)";"SP";"AGUAI";939;81;218;1238
2018;"AGUAS DA PRATA (SP)";"SP";"AGUAS DA PRATA";129;20;14;163
2018;"AGUAS DE LINDOIA (SP)";"SP";"AGUAS DE LINDOIA";200;88;97;385
2018;"AGUAS DE SANTA BARBARA (SP)";"SP";"AGUAS DE SANTA BARBARA";133;37;39;209
2018;"AGUAS DE SAO PEDRO (SP)";"SP";"AGUAS DE SAO PEDRO";38;10;6;54
2018;"AGUDOS (SP)";"SP";"AGUDOS";569;134;118;821
2018;"ALAMBARI (SP)";"SP";"ALAMBARI";99;18;8;125
2018;"ALFREDO MARCONDES (SP)";"SP";"ALFREDO MARCONDES";77;11;8;96
2018;"ALTAIR (SP)";"SP";"ALTAIR";73;6;38;117
2018;"ALTINOPOLIS (SP)";"SP";"ALTINOPOLIS";413;59;126;598
2018;"ALTO ALEGRE (SP)";"SP";"ALTO ALEGRE";101;4;47;152
2018;"ALUMINIO (SP)";"SP";"ALUMINIO";239;53;45;337
2018;"ALVARES FLORENCE (SP)";"SP";"ALVARES FLORENCE";65;6;17;88
2018;"ALVARES MACHADO (SP)";"SP";"ALVARES MACHADO";490;37;36;563
2018;"ALVARO DE CARVALHO (SP)";"SP";"ALVARO DE CARVALHO";35;8;30;73
2018;"ALVINLANDIA (SP)";"SP";"ALVINLANDIA";50;7;15;72
2018;"AMERICANA (SP)";"SP";"AMERICANA";3479;530;554;4563
2018;"AMERICO BRASILIENSE (SP)";"SP";"AMERICO BRASILIENSE";693;72;216;981
2018;"AMERICO DE CAMPOS (SP)";"SP";"AMERICO DE CAMPOS";128;14;34;176
2018;"AMPARO (SP)";"SP";"AMPARO";1457;245;155;1857
2018;"ANALANDIA (SP)";"SP";"ANALANDIA";94;17;17;128
2018;"ANDRADINA (SP)";"SP";"ANDRADINA";1319;117;174;1610
2018;"ANGATUBA (SP)";"SP";"ANGATUBA";423;79;126;628
2018;"ANHEMBI (SP)";"SP";"ANHEMBI";106;28;26;160
2018;"ANHUMAS (SP)";"SP";"ANHUMAS";78;16;9;103
2018;"APARECIDA (SP)";"SP";"APARECIDA";824;85;525;1434
2018;"APARECIDA D OESTE (SP)";"SP";"APARECIDA D OESTE";106;12;30;148
2018;"APIAI (SP)";"SP";"APIAI";416;71;99;586
2018;"ARACARIGUAMA (SP)";"SP";"ARACARIGUAMA";570;68;59;697
2018;"ARACATUBA (SP)";"SP";"ARACATUBA";3657;322;800;4779
2018;"ARACOIABA DA SERRA (SP)";"SP";"ARACOIABA DA SERRA";589;133;35;757
2018;"ARAMINA (SP)";"SP";"ARAMINA";85;14;29;128
2018;"ARANDU (SP)";"SP";"ARANDU";69;13;27;109
2018;"ARAPEI (SP)";"SP";"ARAPEI";45;10;11;66
2018;"ARARAQUARA (SP)";"SP";"ARARAQUARA";3909;482;1266;5657
2018;"ARARAS (SP)";"SP";"ARARAS";2409;341;376;3126
2018;"ARCO IRIS (SP)";"SP";"ARCO IRIS";75;4;8;87
2018;"AREALVA (SP)";"SP";"AREALVA";199;24;35;258
2018;"AREIAS (SP)";"SP";"AREIAS";58;3;8;69
2018;"AREIOPOLIS (SP)";"SP";"AREIOPOLIS";161;40;147;348
2018;"ARIRANHA (SP)";"SP";"ARIRANHA";275;26;185;486
2018;"ARTUR NOGUEIRA (SP)";"SP";"ARTUR NOGUEIRA";1089;124;171;1384
2018;"ARUJA (SP)";"SP";"ARUJA";2993;309;433;3735
2018;"ASPASIA (SP)";"SP";"ASPASIA";26;7;5;38
2018;"ASSIS (SP)";"SP";"ASSIS";1971;196;400;2567
2018;"ATIBAIA (SP)";"SP";"ATIBAIA";2614;432;361;3407
2018;"AURIFLAMA (SP)";"SP";"AURIFLAMA";366;34;57;457
2018;"AVAI (SP)";"SP";"AVAI";85;19;25;129
2018;"AVANHANDAVA (SP)";"SP";"AVANHANDAVA";181;13;74;268
2018;"AVARE (SP)";"SP";"AVARE";1433;152;295;1880
2018;"BADY BASSITT (SP)";"SP";"BADY BASSITT";396;35;76;507
2018;"BALBINOS (SP)";"SP";"BALBINOS";26;2;8;36
2018;"BALSAMO (SP)";"SP";"BALSAMO";230;8;27;265
2018;"BANANAL (SP)";"SP";"BANANAL";201;23;39;263
2018;"BARAO DE ANTONINA (SP)";"SP";"BARAO DE ANTONINA";33;6;14;53
2018;"BARBOSA (SP)";"SP";"BARBOSA";120;9;41;170
2018;"BARIRI (SP)";"SP";"BARIRI";894;66;94;1054
2018;"BARRA BONITA (SP)";"SP";"BARRA BONITA";993;81;274;1348
2018;"BARRA DO CHAPEU (SP)";"SP";"BARRA DO CHAPEU";66;11;18;95
2018;"BARRA DO TURVO (SP)";"SP";"BARRA DO TURVO";78;23;60;161
2018;"BARRETOS (SP)";"SP";"BARRETOS";2264;270;537;3071
2018;"BARRINHA (SP)";"SP";"BARRINHA";497;71;208;776
2018;"BARUERI (SP)";"SP";"BARUERI";6111;873;1258;8242
2018;"BASTOS (SP)";"SP";"BASTOS";928;40;115;1083
2018;"BATATAIS (SP)";"SP";"BATATAIS";1235;137;193;1565
2018;"BAURU (SP)";"SP";"BAURU";6047;515;1319;7881
2018;"BEBEDOURO (SP)";"SP";"BEBEDOURO";1738;182;326;2246
2018;"BENTO DE ABREU (SP)";"SP";"BENTO DE ABREU";64;11;15;90
2018;"BERNARDINO DE CAMPOS (SP)";"SP";"BERNARDINO DE CAMPOS";395;41;43;479
2018;"BERTIOGA (SP)";"SP";"BERTIOGA";541;78;103;722
2018;"BILAC (SP)";"SP";"BILAC";172;5;25;202
2018;"BIRIGUI (SP)";"SP";"BIRIGUI";1901;144;186;2231
2018;"BIRITIBA MIRIM (SP)";"SP";"BIRITIBA MIRIM";464;66;63;593
2018;"BOA ESPERANCA DO SUL (SP)";"SP";"BOA ESPERANCA DO SUL";346;46;113;505
2018;"BOCAINA (SP)";"SP";"BOCAINA";203;47;38;288
2018;"BOFETE (SP)";"SP";"BOFETE";241;61;57;359
2018;"BOITUVA (SP)";"SP";"BOITUVA";1588;189;155;1932
2018;"BOM JESUS DOS PERDOES (SP)";"SP";"BOM JESUS DOS PERDOES";599;80;72;751
2018;"BOM SUCESSO DE ITARARE (SP)";"SP";"BOM SUCESSO DE ITARARE";78;8;15;101
2018;"BORA (SP)";"SP";"BORA";44;3;7;54
2018;"BORACEIA (SP)";"SP";"BORACEIA";202;13;21;236
2018;"BORBOREMA (SP)";"SP";"BORBOREMA";418;44;108;570
2018;"BOREBI (SP)";"SP";"BOREBI";56;8;6;70
2018;"BOTUCATU (SP)";"SP";"BOTUCATU";1876;381;475;2732
2018;"BRAGANCA PAULISTA (SP)";"SP";"BRAGANCA PAULISTA";3038;415;396;3849
2018;"BRAUNA (SP)";"SP";"BRAUNA";85;11;81;177
2018;"BREJO ALEGRE (SP)";"SP";"BREJO ALEGRE";159;2;19;180
2018;"BRODOWSKI (SP)";"SP";"BRODOWSKI";641;38;61;740
2018;"BROTAS (SP)";"SP";"BROTAS";541;67;209;817
2018;"BURI (SP)";"SP";"BURI";532;53;103;688
2018;"BURITAMA (SP)";"SP";"BURITAMA";360;37;78;475
2018;"BURITIZAL (SP)";"SP";"BURITIZAL";123;18;34;175
2018;"CABRALIA PAULISTA (SP)";"SP";"CABRALIA PAULISTA";147;8;18;173
2018;"CABREUVA (SP)";"SP";"CABREUVA";1032;153;59;1244
2018;"CACAPAVA (SP)";"SP";"CACAPAVA";1207;282;193;1682
2018;"CACHOEIRA PAULISTA (SP)";"SP";"CACHOEIRA PAULISTA";418;102;27;547
2018;"CACONDE (SP)";"SP";"CACONDE";285;85;75;445
2018;"CAFELANDIA (SP)";"SP";"CAFELANDIA";322;32;86;440
2018;"CAIABU (SP)";"SP";"CAIABU";44;7;42;93
2018;"CAIEIRAS (SP)";"SP";"CAIEIRAS";1116;304;423;1843
2018;"CAIUA (SP)";"SP";"CAIUA";59;16;25;100
2018;"CAJAMAR (SP)";"SP";"CAJAMAR";1660;254;349;2263
2018;"CAJATI (SP)";"SP";"CAJATI";673;91;94;858
2018;"CAJOBI (SP)";"SP";"CAJOBI";257;11;99;367
2018;"CAJURU (SP)";"SP";"CAJURU";544;42;116;702
2018;"CAMPINA DO MONTE ALEGRE (SP)";"SP";"CAMPINA DO MONTE ALEGRE";101;20;30;151
2018;"CAMPINAS (SP)";"SP";"CAMPINAS";20428;3871;5520;29819
2018;"CAMPO LIMPO PAULISTA (SP)";"SP";"CAMPO LIMPO PAULISTA";692;125;42;859
2018;"CAMPOS DO JORDAO (SP)";"SP";"CAMPOS DO JORDAO";666;182;70;918
2018;"CAMPOS NOVOS PAULISTA (SP)";"SP";"CAMPOS NOVOS PAULISTA";118;6;40;164
2018;"CANANEIA (SP)";"SP";"CANANEIA";109;13;15;137
2018;"CANAS (SP)";"SP";"CANAS";150;10;10;170
2018;"CANDIDO MOTA (SP)";"SP";"CANDIDO MOTA";1052;72;80;1204
2018;"CANDIDO RODRIGUES (SP)";"SP";"CANDIDO RODRIGUES";120;12;13;145
2018;"CANITAR (SP)";"SP";"CANITAR";56;15;22;93
2018;"CAPAO BONITO (SP)";"SP";"CAPAO BONITO";1027;175;211;1413
2018;"CAPELA DO ALTO (SP)";"SP";"CAPELA DO ALTO";580;75;48;703
2018;"CAPIVARI (SP)";"SP";"CAPIVARI";1190;123;319;1632
2018;"CARAGUATATUBA (SP)";"SP";"CARAGUATATUBA";1672;178;132;1982
2018;"CARAPICUIBA (SP)";"SP";"CARAPICUIBA";3972;894;972;5838
2018;"CARDOSO (SP)";"SP";"CARDOSO";194;23;57;274
2018;"CASA BRANCA (SP)";"SP";"CASA BRANCA";615;70;112;797
2018;"CASSIA DOS COQUEIROS (SP)";"SP";"CASSIA DOS COQUEIROS";31;6;16;53
2018;"CASTILHO (SP)";"SP";"CASTILHO";254;42;119;415
2018;"CATANDUVA (SP)";"SP";"CATANDUVA";2939;297;519;3755
2018;"CATIGUA (SP)";"SP";"CATIGUA";84;12;34;130
2018;"CEDRAL (SP)";"SP";"CEDRAL";241;27;22;290
2018;"CERQUEIRA CESAR (SP)";"SP";"CERQUEIRA CESAR";424;50;154;628
2018;"CERQUILHO (SP)";"SP";"CERQUILHO";939;164;118;1221
2018;"CESARIO LANGE (SP)";"SP";"CESARIO LANGE";384;44;71;499
2018;"CHARQUEADA (SP)";"SP";"CHARQUEADA";453;44;100;597
2018;"CHAVANTES (SP)";"SP";"CHAVANTES";141;41;65;247
2018;"CLEMENTINA (SP)";"SP";"CLEMENTINA";314;13;64;391
2018;"COLINA (SP)";"SP";"COLINA";398;35;97;530
2018;"COLOMBIA (SP)";"SP";"COLOMBIA";149;37;69;255
2018;"CONCHAL (SP)";"SP";"CONCHAL";843;79;289;1211
2018;"CONCHAS (SP)";"SP";"CONCHAS";375;55;47;477
2018;"CORDEIROPOLIS (SP)";"SP";"CORDEIROPOLIS";772;80;61;913
2018;"COROADOS (SP)";"SP";"COROADOS";117;8;23;148
2018;"CORONEL MACEDO (SP)";"SP";"CORONEL MACEDO";70;15;24;109
2018;"CORUMBATAI (SP)";"SP";"CORUMBATAI";166;8;15;189
2018;"COSMOPOLIS (SP)";"SP";"COSMOPOLIS";843;273;235;1351
2018;"COSMORAMA (SP)";"SP";"COSMORAMA";232;15;49;296
2018;"COTIA (SP)";"SP";"COTIA";3222;863;828;4913
2018;"CRAVINHOS (SP)";"SP";"CRAVINHOS";968;58;176;1202
2018;"CRISTAIS PAULISTA (SP)";"SP";"CRISTAIS PAULISTA";149;14;32;195
2018;"CRUZALIA (SP)";"SP";"CRUZALIA";83;8;5;96
2018;"CRUZEIRO (SP)";"SP";"CRUZEIRO";776;194;55;1025
2018;"CUBATAO (SP)";"SP";"CUBATAO";2815;417;403;3635
2018;"CUNHA (SP)";"SP";"CUNHA";353;91;53;497
2018;"DESCALVADO (SP)";"SP";"DESCALVADO";1091;121;193;1405
2018;"DIADEMA (SP)";"SP";"DIADEMA";4423;676;665;5764
2018;"DIRCE REIS (SP)";"SP";"DIRCE REIS";69;7;8;84
2018;"DIVINOLANDIA (SP)";"SP";"DIVINOLANDIA";479;32;69;580
2018;"DOBRADA (SP)";"SP";"DOBRADA";74;24;89;187
2018;"DOIS CORREGOS (SP)";"SP";"DOIS CORREGOS";672;98;173;943
2018;"DOLCINOPOLIS (SP)";"SP";"DOLCINOPOLIS";30;5;11;46
2018;"DOURADO (SP)";"SP";"DOURADO";204;41;62;307
2018;"DRACENA (SP)";"SP";"DRACENA";1162;59;132;1353
2018;"DUARTINA (SP)";"SP";"DUARTINA";281;32;83;396
2018;"DUMONT (SP)";"SP";"DUMONT";387;11;57;455
2018;"ECHAPORA (SP)";"SP";"ECHAPORA";170;5;32;207
2018;"ELDORADO (SP)";"SP";"ELDORADO";297;32;69;398
2018;"ELIAS FAUSTO (SP)";"SP";"ELIAS FAUSTO";369;19;96;484
2018;"ELISIARIO (SP)";"SP";"ELISIARIO";53;8;11;72
2018;"EMBAUBA (SP)";"SP";"EMBAUBA";73;5;27;105
2018;"EMBU (SP)";"SP";"EMBU";2712;760;765;4237
2018;"EMBU GUACU (SP)";"SP";"EMBU GUACU";2386;290;373;3049
2018;"EMILIANOPOLIS (SP)";"SP";"EMILIANOPOLIS";54;6;14;74
2018;"ENGENHEIRO COELHO (SP)";"SP";"ENGENHEIRO COELHO";437;73;197;707
2018;"ESPIRITO SANTO DO PINHAL (SP)";"SP";"ESPIRITO SANTO DO PINHAL";672;132;84;888
2018;"ESPIRITO SANTO DO TURVO (SP)";"SP";"ESPIRITO SANTO DO TURVO";161;26;37;224
2018;"ESTIVA GERBI (SP)";"SP";"ESTIVA GERBI";285;24;32;341
2018;"ESTRELA D OESTE (SP)";"SP";"ESTRELA D OESTE";249;8;39;296
2018;"ESTRELA DO NORTE (SP)";"SP";"ESTRELA DO NORTE";28;0;9;37
2018;"EUCLIDES DA CUNHA PAULISTA (SP)";"SP";"EUCLIDES DA CUNHA PAULISTA";107;9;57;173
2018;"FARTURA (SP)";"SP";"FARTURA";350;44;47;441
2018;"FERNANDO PRESTES (SP)";"SP";"FERNANDO PRESTES";249;9;20;278
2018;"FERNANDOPOLIS (SP)";"SP";"FERNANDOPOLIS";1608;101;221;1930
2018;"FERNAO (SP)";"SP";"FERNAO";33;7;13;53
2018;"FERRAZ DE VASCONCELOS (SP)";"SP";"FERRAZ DE VASCONCELOS";2094;327;480;2901
2018;"FLORA RICA (SP)";"SP";"FLORA RICA";26;3;13;42
2018;"FLOREAL (SP)";"SP";"FLOREAL";66;9;8;83
2018;"FLORIDA PAULISTA (SP)";"SP";"FLORIDA PAULISTA";341;27;130;498
2018;"FLORINEA (SP)";"SP";"FLORINEA";54;7;11;72
2018;"FRANCA (SP)";"SP";"FRANCA";3889;449;720;5058
2018;"FRANCISCO MORATO (SP)";"SP";"FRANCISCO MORATO";600;269;246;1115
2018;"FRANCO DA ROCHA (SP)";"SP";"FRANCO DA ROCHA";965;273;203;1441
2018;"GABRIEL MONTEIRO (SP)";"SP";"GABRIEL MONTEIRO";59;7;14;80
2018;"GALIA (SP)";"SP";"GALIA";168;26;50;244
2018;"GARCA (SP)";"SP";"GARCA";778;107;123;1008
2018;"GASTAO VIDIGAL (SP)";"SP";"GASTAO VIDIGAL";68;8;66;142
2018;"GAVIAO PEIXOTO (SP)";"SP";"GAVIAO PEIXOTO";76;16;30;122
2018;"GENERAL SALGADO (SP)";"SP";"GENERAL SALGADO";288;25;103;416
2018;"GETULINA (SP)";"SP";"GETULINA";134;12;76;222
2018;"GLICERIO (SP)";"SP";"GLICERIO";144;11;34;189
2018;"GUAICARA (SP)";"SP";"GUAICARA";125;14;35;174
2018;"GUAIMBE (SP)";"SP";"GUAIMBE";141;6;35;182
2018;"GUAIRA (SP)";"SP";"GUAIRA";1349;110;225;1684
2018;"GUAPIACU (SP)";"SP";"GUAPIACU";480;30;77;587
2018;"GUAPIARA (SP)";"SP";"GUAPIARA";416;48;64;528
2018;"GUARA (SP)";"SP";"GUARA";241;56;187;484
2018;"GUARACAI (SP)";"SP";"GUARACAI";294;24;34;352
2018;"GUARACI (SP)";"SP";"GUARACI";217;21;102;340
2018;"GUARANI D OESTE (SP)";"SP";"GUARANI D OESTE";37;4;8;49
2018;"GUARANTA (SP)";"SP";"GUARANTA";104;6;50;160
2018;"GUARARAPES (SP)";"SP";"GUARARAPES";712;70;160;942
2018;"GUARAREMA (SP)";"SP";"GUARAREMA";551;100;74;725
2018;"GUARATINGUETA (SP)";"SP";"GUARATINGUETA";1366;417;210;1993
2018;"GUAREI (SP)";"SP";"GUAREI";326;34;95;455
2018;"GUARIBA (SP)";"SP";"GUARIBA";867;80;317;1264
2018;"GUARUJA (SP)";"SP";"GUARUJA";2183;460;469;3112
2018;"GUARULHOS (SP)";"SP";"GUARULHOS";20522;4101;4114;28737
2018;"GUATAPARA (SP)";"SP";"GUATAPARA";194;20;60;274
2018;"GUZOLANDIA (SP)";"SP";"GUZOLANDIA";85;6;38;129
2018;"HERCULANDIA (SP)";"SP";"HERCULANDIA";519;9;32;560
2018;"HOLAMBRA (SP)";"SP";"HOLAMBRA";417;64;124;605
2018;"HORTOLANDIA (SP)";"SP";"HORTOLANDIA";2527;598;609;3734
2018;"IACANGA (SP)";"SP";"IACANGA";273;42;54;369
2018;"IACRI (SP)";"SP";"IACRI";156;7;21;184
2018;"IARAS (SP)";"SP";"IARAS";69;23;34;126
2018;"IBATE (SP)";"SP";"IBATE";642;134;213;989
2018;"IBIRA (SP)";"SP";"IBIRA";178;24;59;261
2018;"IBIRAREMA (SP)";"SP";"IBIRAREMA";249;21;33;303
2018;"IBITINGA (SP)";"SP";"IBITINGA";926;116;227;1269
2018;"IBIUNA (SP)";"SP";"IBIUNA";2371;270;117;2758
2018;"ICEM (SP)";"SP";"ICEM";248;10;77;335
2018;"IEPE (SP)";"SP";"IEPE";199;13;39;251
2018;"IGARACU DO TIETE (SP)";"SP";"IGARACU DO TIETE";374;40;99;513
2018;"IGARAPAVA (SP)";"SP";"IGARAPAVA";575;56;128;759
2018;"IGARATA (SP)";"SP";"IGARATA";160;28;19;207
2018;"IGUAPE (SP)";"SP";"IGUAPE";259;48;126;433
2018;"ILHA COMPRIDA (SP)";"SP";"ILHA COMPRIDA";202;34;88;324
2018;"ILHA SOLTEIRA (SP)";"SP";"ILHA SOLTEIRA";273;37;91;401
2018;"ILHABELA (SP)";"SP";"ILHABELA";381;78;74;533
2018;"INDAIATUBA (SP)";"SP";"INDAIATUBA";3571;636;481;4688
2018;"INDIANA (SP)";"SP";"INDIANA";122;16;12;150
2018;"INDIAPORA (SP)";"SP";"INDIAPORA";76;5;18;99
2018;"INUBIA PAULISTA (SP)";"SP";"INUBIA PAULISTA";59;6;14;79
2018;"IPAUSSU (SP)";"SP";"IPAUSSU";212;30;62;304
2018;"IPERO (SP)";"SP";"IPERO";303;67;39;409
2018;"IPEUNA (SP)";"SP";"IPEUNA";191;35;44;270
2018;"IPIGUA (SP)";"SP";"IPIGUA";56;4;13;73
2018;"IPORANGA (SP)";"SP";"IPORANGA";33;20;9;62
2018;"IPUA (SP)";"SP";"IPUA";282;26;91;399
2018;"IRACEMAPOLIS (SP)";"SP";"IRACEMAPOLIS";574;69;110;753
2018;"IRAPUA (SP)";"SP";"IRAPUA";140;9;91;240
2018;"IRAPURU (SP)";"SP";"IRAPURU";108;18;29;155
2018;"ITABERA (SP)";"SP";"ITABERA";328;85;73;486
2018;"ITAI (SP)";"SP";"ITAI";580;86;211;877
2018;"ITAJOBI (SP)";"SP";"ITAJOBI";591;23;61;675
2018;"ITAJU (SP)";"SP";"ITAJU";74;4;23;101
2018;"ITANHAEM (SP)";"SP";"ITANHAEM";1009;268;146;1423
2018;"ITAOCA (SP)";"SP";"ITAOCA";37;14;8;59
2018;"ITAPECERICA DA SERRA (SP)";"SP";"ITAPECERICA DA SERRA";2481;660;796;3937
2018;"ITAPETININGA (SP)";"SP";"ITAPETININGA";2987;484;528;3999
2018;"ITAPEVA (SP)";"SP";"ITAPEVA";2128;364;439;2931
2018;"ITAPEVI (SP)";"SP";"ITAPEVI";2108;503;217;2828
2018;"ITAPIRA (SP)";"SP";"ITAPIRA";1850;140;251;2241
2018;"ITAPIRAPUA PAULISTA (SP)";"SP";"ITAPIRAPUA PAULISTA";55;21;18;94
2018;"ITAPOLIS (SP)";"SP";"ITAPOLIS";1320;124;222;1666
2018;"ITAPORANGA (SP)";"SP";"ITAPORANGA";271;33;87;391
2018;"ITAPUI (SP)";"SP";"ITAPUI";393;48;75;516
2018;"ITAPURA (SP)";"SP";"ITAPURA";32;11;19;62
2018;"ITAQUAQUECETUBA (SP)";"SP";"ITAQUAQUECETUBA";3461;494;466;4421
2018;"ITARARE (SP)";"SP";"ITARARE";997;93;243;1333
2018;"ITARIRI (SP)";"SP";"ITARIRI";410;54;26;490
2018;"ITATIBA (SP)";"SP";"ITATIBA";2497;286;333;3116
2018;"ITATINGA (SP)";"SP";"ITATINGA";270;58;123;451
2018;"ITIRAPINA (SP)";"SP";"ITIRAPINA";335;61;63;459
2018;"ITIRAPUA (SP)";"SP";"ITIRAPUA";97;9;21;127
2018;"ITOBI (SP)";"SP";"ITOBI";182;38;102;322
2018;"ITU (SP)";"SP";"ITU";3273;524;704;4501
2018;"ITUPEVA (SP)";"SP";"ITUPEVA";1584;139;135;1858
2018;"ITUVERAVA (SP)";"SP";"ITUVERAVA";671;67;131;869
2018;"JABORANDI (SP)";"SP";"JABORANDI";191;12;45;248
2018;"JABOTICABAL (SP)";"SP";"JABOTICABAL";2181;120;211;2512
2018;"JACAREI (SP)";"SP";"JACAREI";2775;652;338;3765
2018;"JACI (SP)";"SP";"JACI";226;8;16;250
2018;"JACUPIRANGA (SP)";"SP";"JACUPIRANGA";434;68;463;965
2018;"JAGUARIUNA (SP)";"SP";"JAGUARIUNA";1112;96;159;1367
2018;"JALES (SP)";"SP";"JALES";1233;51;94;1378
2018;"JAMBEIRO (SP)";"SP";"JAMBEIRO";116;40;16;172
2018;"JANDIRA (SP)";"SP";"JANDIRA";1263;362;196;1821
2018;"JARDINOPOLIS (SP)";"SP";"JARDINOPOLIS";1108;118;162;1388
2018;"JARINU (SP)";"SP";"JARINU";688;74;63;825
2018;"JAU (SP)";"SP";"JAU";2542;361;550;3453
2018;"JERIQUARA (SP)";"SP";"JERIQUARA";74;8;24;106
2018;"JOANOPOLIS (SP)";"SP";"JOANOPOLIS";432;50;25;507
2018;"JOAO RAMALHO (SP)";"SP";"JOAO RAMALHO";39;10;28;77
2018;"JOSE BONIFACIO (SP)";"SP";"JOSE BONIFACIO";940;70;155;1165
2018;"JULIO MESQUITA (SP)";"SP";"JULIO MESQUITA";45;9;30;84
2018;"JUMIRIM (SP)";"SP";"JUMIRIM";106;13;6;125
2018;"JUNDIAI (SP)";"SP";"JUNDIAI";8054;858;1215;10127
2018;"JUNQUEIROPOLIS (SP)";"SP";"JUNQUEIROPOLIS";529;36;216;781
2018;"JUQUIA (SP)";"SP";"JUQUIA";464;34;30;528
2018;"JUQUITIBA (SP)";"SP";"JUQUITIBA";753;129;116;998
2018;"LAGOINHA (SP)";"SP";"LAGOINHA";158;28;25;211
2018;"LARANJAL PAULISTA (SP)";"SP";"LARANJAL PAULISTA";801;76;242;1119
2018;"LAVINIA (SP)";"SP";"LAVINIA";78;4;20;102
2018;"LAVRINHAS (SP)";"SP";"LAVRINHAS";94;18;16;128
2018;"LEME (SP)";"SP";"LEME";2549;241;596;3386
2018;"LENCOIS PAULISTA (SP)";"SP";"LENCOIS PAULISTA";1474;245;393;2112
2018;"LIMEIRA (SP)";"SP";"LIMEIRA";5015;984;718;6717
2018;"LINDOIA (SP)";"SP";"LINDOIA";213;30;30;273
2018;"LINS (SP)";"SP";"LINS";1301;131;205;1637
2018;"LORENA (SP)";"SP";"LORENA";981;224;42;1247
2018;"LOURDES (SP)";"SP";"LOURDES";23;3;17;43
2018;"LOUVEIRA (SP)";"SP";"LOUVEIRA";1027;163;106;1296
2018;"LUCELIA (SP)";"SP";"LUCELIA";400;30;211;641
2018;"LUCIANOPOLIS (SP)";"SP";"LUCIANOPOLIS";57;12;19;88
2018;"LUIS ANTONIO (SP)";"SP";"LUIS ANTONIO";283;32;226;541
2018;"LUIZIANIA (SP)";"SP";"LUIZIANIA";78;3;36;117
2018;"LUPERCIO (SP)";"SP";"LUPERCIO";52;4;34;90
2018;"LUTECIA (SP)";"SP";"LUTECIA";54;9;16;79
2018;"MACATUBA (SP)";"SP";"MACATUBA";473;35;93;601
2018;"MACAUBAL (SP)";"SP";"MACAUBAL";154;17;24;195
2018;"MACEDONIA (SP)";"SP";"MACEDONIA";50;5;13;68
2018;"MAGDA (SP)";"SP";"MAGDA";123;17;13;153
2018;"MAIRINQUE (SP)";"SP";"MAIRINQUE";629;124;100;853
2018;"MAIRIPORA (SP)";"SP";"MAIRIPORA";2136;288;175;2599
2018;"MANDURI (SP)";"SP";"MANDURI";264;37;105;406
2018;"MARABA PAULISTA (SP)";"SP";"MARABA PAULISTA";46;8;21;75
2018;"MARACAI (SP)";"SP";"MARACAI";329;59;57;445
2018;"MARAPOAMA (SP)";"SP";"MARAPOAMA";166;6;13;185
2018;"MARIAPOLIS (SP)";"SP";"MARIAPOLIS";54;8;36;98
2018;"MARILIA (SP)";"SP";"MARILIA";3478;377;605;4460
2018;"MARINOPOLIS (SP)";"SP";"MARINOPOLIS";83;6;11;100
2018;"MARTINOPOLIS (SP)";"SP";"MARTINOPOLIS";510;49;140;699
2018;"MATAO (SP)";"SP";"MATAO";1661;132;431;2224
2018;"MAUA (SP)";"SP";"MAUA";4172;1134;1511;6817
2018;"MENDONCA (SP)";"SP";"MENDONCA";121;8;29;158
2018;"MERIDIANO (SP)";"SP";"MERIDIANO";179;11;21;211
2018;"MESOPOLIS (SP)";"SP";"MESOPOLIS";17;6;15;38
2018;"MIGUELOPOLIS (SP)";"SP";"MIGUELOPOLIS";277;20;89;386
2018;"MINEIROS DO TIETE (SP)";"SP";"MINEIROS DO TIETE";246;30;57;333
2018;"MIRA ESTRELA (SP)";"SP";"MIRA ESTRELA";49;8;29;86
2018;"MIRACATU (SP)";"SP";"MIRACATU";762;80;33;875
2018;"MIRANDOPOLIS (SP)";"SP";"MIRANDOPOLIS";526;46;221;793
2018;"MIRANTE DO PARANAPANEMA (SP)";"SP";"MIRANTE DO PARANAPANEMA";314;60;104;478
2018;"MIRASSOL (SP)";"SP";"MIRASSOL";1328;66;98;1492
2018;"MIRASSOLANDIA (SP)";"SP";"MIRASSOLANDIA";65;18;11;94
2018;"MOCOCA (SP)";"SP";"MOCOCA";1273;156;372;1801
2018;"MOGI DAS CRUZES (SP)";"SP";"MOGI DAS CRUZES";6610;947;1411;8968
2018;"MOGI GUACU (SP)";"SP";"MOGI GUACU";2589;507;609;3705
2018;"MOGI MIRIM (SP)";"SP";"MOGI MIRIM";2094;232;283;2609
2018;"MOMBUCA (SP)";"SP";"MOMBUCA";100;8;20;128
2018;"MONCOES (SP)";"SP";"MONCOES";78;16;14;108
2018;"MONGAGUA (SP)";"SP";"MONGAGUA";554;115;104;773
2018;"MONTE ALEGRE DO SUL (SP)";"SP";"MONTE ALEGRE DO SUL";242;51;53;346
2018;"MONTE ALTO (SP)";"SP";"MONTE ALTO";1560;94;110;1764
2018;"MONTE APRAZIVEL (SP)";"SP";"MONTE APRAZIVEL";652;60;266;978
2018;"MONTE AZUL PAULISTA (SP)";"SP";"MONTE AZUL PAULISTA";549;57;176;782
2018;"MONTE CASTELO (SP)";"SP";"MONTE CASTELO";90;7;12;109
2018;"MONTE MOR (SP)";"SP";"MONTE MOR";869;120;139;1128
2018;"MONTEIRO LOBATO (SP)";"SP";"MONTEIRO LOBATO";168;27;15;210
2018;"MORRO AGUDO (SP)";"SP";"MORRO AGUDO";793;53;192;1038
2018;"MORUNGABA (SP)";"SP";"MORUNGABA";402;64;32;498
2018;"MOTUCA (SP)";"SP";"MOTUCA";150;8;27;185
2018;"MUNICIPIO NAO INFORMADO (SP)";"SP";"MUNICIPIO NAO INFORMADO";0;0;0;0
2018;"MURUTINGA DO SUL (SP)";"SP";"MURUTINGA DO SUL";93;15;21;129
2018;"NANTES (SP)";"SP";"NANTES";25;12;18;55
2018;"NARANDIBA (SP)";"SP";"NARANDIBA";94;9;24;127
2018;"NATIVIDADE DA SERRA (SP)";"SP";"NATIVIDADE DA SERRA";114;60;10;184
2018;"NAZARE PAULISTA (SP)";"SP";"NAZARE PAULISTA";771;39;66;876
2018;"NEVES PAULISTA (SP)";"SP";"NEVES PAULISTA";200;13;29;242
2018;"NHANDEARA (SP)";"SP";"NHANDEARA";201;24;67;292
2018;"NIPOA (SP)";"SP";"NIPOA";123;10;37;170
2018;"NOVA ALIANCA (SP)";"SP";"NOVA ALIANCA";172;12;19;203
2018;"NOVA CAMPINA (SP)";"SP";"NOVA CAMPINA";93;17;26;136
2018;"NOVA CANAA PAULISTA (SP)";"SP";"NOVA CANAA PAULISTA";40;8;7;55
2018;"NOVA CASTILHO (SP)";"SP";"NOVA CASTILHO";24;4;5;33
2018;"NOVA EUROPA (SP)";"SP";"NOVA EUROPA";179;13;153;345
2018;"NOVA GRANADA (SP)";"SP";"NOVA GRANADA";381;71;121;573
2018;"NOVA GUATAPORANGA (SP)";"SP";"NOVA GUATAPORANGA";40;6;14;60
2018;"NOVA INDEPENDENCIA (SP)";"SP";"NOVA INDEPENDENCIA";71;10;14;95
2018;"NOVA LUZITANIA (SP)";"SP";"NOVA LUZITANIA";37;1;28;66
2018;"NOVA ODESSA (SP)";"SP";"NOVA ODESSA";977;163;130;1270
2018;"NOVAIS (SP)";"SP";"NOVAIS";113;7;45;165
2018;"NOVO HORIZONTE (SP)";"SP";"NOVO HORIZONTE";1250;58;327;1635
2018;"NUPORANGA (SP)";"SP";"NUPORANGA";236;24;64;324
2018;"OCAUCU (SP)";"SP";"OCAUCU";122;11;28;161
2018;"OLEO (SP)";"SP";"OLEO";44;18;9;71
2018;"OLIMPIA (SP)";"SP";"OLIMPIA";990;130;233;1353
2018;"ONDA VERDE (SP)";"SP";"ONDA VERDE";113;10;27;150
2018;"ORIENTE (SP)";"SP";"ORIENTE";106;19;25;150
2018;"ORINDIUVA (SP)";"SP";"ORINDIUVA";270;16;62;348
2018;"ORLANDIA (SP)";"SP";"ORLANDIA";994;68;324;1386
2018;"OSASCO (SP)";"SP";"OSASCO";9878;2251;2722;14851
2018;"OSCAR BRESSANE (SP)";"SP";"OSCAR BRESSANE";72;8;8;88
2018;"OSVALDO CRUZ (SP)";"SP";"OSVALDO CRUZ";516;40;126;682
2018;"OURINHOS (SP)";"SP";"OURINHOS";2266;173;658;3097
2018;"OURO VERDE (SP)";"SP";"OURO VERDE";124;6;64;194
2018;"OUROESTE (SP)";"SP";"OUROESTE";197;11;38;246
2018;"PACAEMBU (SP)";"SP";"PACAEMBU";200;28;41;269
2018;"PALESTINA (SP)";"SP";"PALESTINA";195;18;50;263
2018;"PALMARES PAULISTA (SP)";"SP";"PALMARES PAULISTA";90;18;120;228
2018;"PALMEIRA D OESTE (SP)";"SP";"PALMEIRA D OESTE";275;12;37;324
2018;"PALMITAL (SP)";"SP";"PALMITAL";708;45;71;824
2018;"PANORAMA (SP)";"SP";"PANORAMA";344;16;28;388
2018;"PARAGUACU PAULISTA (SP)";"SP";"PARAGUACU PAULISTA";941;164;169;1274
2018;"PARAIBUNA (SP)";"SP";"PARAIBUNA";271;89;73;433
2018;"PARAISO (SP)";"SP";"PARAISO";212;16;106;334
2018;"PARANAPANEMA (SP)";"SP";"PARANAPANEMA";620;62;88;770
2018;"PARANAPUA (SP)";"SP";"PARANAPUA";107;18;20;145
2018;"PARAPUA (SP)";"SP";"PARAPUA";329;14;65;408
2018;"PARDINHO (SP)";"SP";"PARDINHO";175;37;32;244
2018;"PARIQUERA ACU (SP)";"SP";"PARIQUERA ACU";446;41;19;506
2018;"PARISI (SP)";"SP";"PARISI";35;6;16;57
2018;"PATROCINIO PAULISTA (SP)";"SP";"PATROCINIO PAULISTA";303;21;61;385
2018;"PAULICEIA (SP)";"SP";"PAULICEIA";338;12;33;383
2018;"PAULINIA (SP)";"SP";"PAULINIA";2281;222;365;2868
2018;"PAULISTANIA (SP)";"SP";"PAULISTANIA";29;14;13;56
2018;"PAULO DE FARIA (SP)";"SP";"PAULO DE FARIA";111;15;55;181
2018;"PEDERNEIRAS (SP)";"SP";"PEDERNEIRAS";1162;110;232;1504
2018;"PEDRA BELA (SP)";"SP";"PEDRA BELA";249;15;15;279
2018;"PEDRANOPOLIS (SP)";"SP";"PEDRANOPOLIS";53;5;16;74
2018;"PEDREGULHO (SP)";"SP";"PEDREGULHO";331;54;136;521
2018;"PEDREIRA (SP)";"SP";"PEDREIRA";829;140;78;1047
2018;"PEDRINHAS PAULISTA (SP)";"SP";"PEDRINHAS PAULISTA";187;9;11;207
2018;"PEDRO DE TOLEDO (SP)";"SP";"PEDRO DE TOLEDO";191;53;20;264
2018;"PENAPOLIS (SP)";"SP";"PENAPOLIS";1485;112;305;1902
2018;"PEREIRA BARRETO (SP)";"SP";"PEREIRA BARRETO";421;53;119;593
2018;"PEREIRAS (SP)";"SP";"PEREIRAS";250;19;32;301
2018;"PERUIBE (SP)";"SP";"PERUIBE";732;245;113;1090
2018;"PIACATU (SP)";"SP";"PIACATU";100;5;30;135
2018;"PIEDADE (SP)";"SP";"PIEDADE";1637;170;122;1929
2018;"PILAR DO SUL (SP)";"SP";"PILAR DO SUL";1159;85;86;1330
2018;"PINDAMONHANGABA (SP)";"SP";"PINDAMONHANGABA";2038;485;197;2720
2018;"PINDORAMA (SP)";"SP";"PINDORAMA";330;44;64;438
2018;"PINHALZINHO (SP)";"SP";"PINHALZINHO";467;61;24;552
2018;"PIQUEROBI (SP)";"SP";"PIQUEROBI";61;10;13;84
2018;"PIQUETE (SP)";"SP";"PIQUETE";244;52;16;312
2018;"PIRACAIA (SP)";"SP";"PIRACAIA";565;92;34;691
2018;"PIRACICABA (SP)";"SP";"PIRACICABA";7903;961;1488;10352
2018;"PIRAJU (SP)";"SP";"PIRAJU";525;91;80;696
2018;"PIRAJUI (SP)";"SP";"PIRAJUI";351;24;96;471
2018;"PIRANGI (SP)";"SP";"PIRANGI";414;18;83;515
2018;"PIRAPORA DO BOM JESUS (SP)";"SP";"PIRAPORA DO BOM JESUS";333;72;112;517
2018;"PIRAPOZINHO (SP)";"SP";"PIRAPOZINHO";516;45;107;668
2018;"PIRASSUNUNGA (SP)";"SP";"PIRASSUNUNGA";1148;174;237;1559
2018;"PIRATININGA (SP)";"SP";"PIRATININGA";295;33;44;372
2018;"PITANGUEIRAS (SP)";"SP";"PITANGUEIRAS";996;54;331;1381
2018;"PLANALTO (SP)";"SP";"PLANALTO";174;15;61;250
2018;"PLATINA (SP)";"SP";"PLATINA";64;15;15;94
2018;"POA (SP)";"SP";"POA";1007;235;202;1444
2018;"POLONI (SP)";"SP";"POLONI";191;5;58;254
2018;"POMPEIA (SP)";"SP";"POMPEIA";307;20;53;380
2018;"PONGAI (SP)";"SP";"PONGAI";66;8;22;96
2018;"PONTAL (SP)";"SP";"PONTAL";1085;41;573;1699
2018;"PONTALINDA (SP)";"SP";"PONTALINDA";43;15;31;89
2018;"PONTES GESTAL (SP)";"SP";"PONTES GESTAL";114;7;31;152
2018;"POPULINA (SP)";"SP";"POPULINA";64;8;18;90
2018;"PORANGABA (SP)";"SP";"PORANGABA";186;16;19;221
2018;"PORTO FELIZ (SP)";"SP";"PORTO FELIZ";1410;140;201;1751
2018;"PORTO FERREIRA (SP)";"SP";"PORTO FERREIRA";1241;129;173;1543
2018;"POTIM (SP)";"SP";"POTIM";87;60;25;172
2018;"POTIRENDABA (SP)";"SP";"POTIRENDABA";565;22;90;677
2018;"PRACINHA (SP)";"SP";"PRACINHA";14;6;15;35
2018;"PRADOPOLIS (SP)";"SP";"PRADOPOLIS";429;26;263;718
2018;"PRAIA GRANDE (SP)";"SP";"PRAIA GRANDE";2407;439;413;3259
2018;"PRATANIA (SP)";"SP";"PRATANIA";135;27;82;244
2018;"PRESIDENTE ALVES (SP)";"SP";"PRESIDENTE ALVES";60;9;51;120
2018;"PRESIDENTE BERNARDES (SP)";"SP";"PRESIDENTE BERNARDES";286;43;55;384
2018;"PRESIDENTE EPITACIO (SP)";"SP";"PRESIDENTE EPITACIO";564;87;187;838
2018;"PRESIDENTE PRUDENTE (SP)";"SP";"PRESIDENTE PRUDENTE";4089;422;898;5409
2018;"PRESIDENTE VENCESLAU (SP)";"SP";"PRESIDENTE VENCESLAU";732;67;83;882
2018;"PROMISSAO (SP)";"SP";"PROMISSAO";786;183;199;1168
2018;"QUADRA (SP)";"SP";"QUADRA";76;11;20;107
2018;"QUATA (SP)";"SP";"QUATA";253;33;79;365
2018;"QUEIROZ (SP)";"SP";"QUEIROZ";28;10;14;52
2018;"QUELUZ (SP)";"SP";"QUELUZ";127;45;14;186
2018;"QUINTANA (SP)";"SP";"QUINTANA";222;16;28;266
2018;"RAFARD (SP)";"SP";"RAFARD";262;28;31;321
2018;"RANCHARIA (SP)";"SP";"RANCHARIA";661;89;106;856
2018;"REDENCAO DA SERRA (SP)";"SP";"REDENCAO DA SERRA";100;58;38;196
2018;"REGENTE FEIJO (SP)";"SP";"REGENTE FEIJO";430;51;62;543
2018;"REGINOPOLIS (SP)";"SP";"REGINOPOLIS";86;26;21;133
2018;"REGISTRO (SP)";"SP";"REGISTRO";1333;134;313;1780
2018;"RESTINGA (SP)";"SP";"RESTINGA";132;8;35;175
2018;"RIBEIRA (SP)";"SP";"RIBEIRA";34;13;18;65
2018;"RIBEIRAO BONITO (SP)";"SP";"RIBEIRAO BONITO";308;55;112;475
2018;"RIBEIRAO BRANCO (SP)";"SP";"RIBEIRAO BRANCO";246;55;77;378
2018;"RIBEIRAO CORRENTE (SP)";"SP";"RIBEIRAO CORRENTE";117;10;53;180
2018;"RIBEIRAO DO SUL (SP)";"SP";"RIBEIRAO DO SUL";153;13;16;182
2018;"RIBEIRAO DOS INDIOS (SP)";"SP";"RIBEIRAO DOS INDIOS";34;3;6;43
2018;"RIBEIRAO GRANDE (SP)";"SP";"RIBEIRAO GRANDE";80;22;14;116
2018;"RIBEIRAO PIRES (SP)";"SP";"RIBEIRAO PIRES";2861;493;467;3821
2018;"RIBEIRAO PRETO (SP)";"SP";"RIBEIRAO PRETO";11393;1189;1971;14553
2018;"RIFAINA (SP)";"SP";"RIFAINA";54;16;10;80
2018;"RINCAO (SP)";"SP";"RINCAO";271;29;53;353
2018;"RINOPOLIS (SP)";"SP";"RINOPOLIS";220;14;59;293
2018;"RIO CLARO (SP)";"SP";"RIO CLARO";3466;507;554;4527
2018;"RIO DAS PEDRAS (SP)";"SP";"RIO DAS PEDRAS";691;120;196;1007
2018;"RIO GRANDE DA SERRA (SP)";"SP";"RIO GRANDE DA SERRA";509;219;97;825
2018;"RIOLANDIA (SP)";"SP";"RIOLANDIA";96;19;58;173
2018;"RIVERSUL (SP)";"SP";"RIVERSUL";88;38;39;165
2018;"ROSANA (SP)";"SP";"ROSANA";190;41;73;304
2018;"ROSEIRA (SP)";"SP";"ROSEIRA";147;77;21;245
2018;"RUBIACEA (SP)";"SP";"RUBIACEA";33;4;12;49
2018;"RUBINEIA (SP)";"SP";"RUBINEIA";42;13;15;70
2018;"SABINO (SP)";"SP";"SABINO";62;7;16;85
2018;"SAGRES (SP)";"SP";"SAGRES";24;3;6;33
2018;"SALES (SP)";"SP";"SALES";101;5;39;145
2018;"SALES OLIVEIRA (SP)";"SP";"SALES OLIVEIRA";279;18;61;358
2018;"SALESOPOLIS (SP)";"SP";"SALESOPOLIS";871;83;121;1075
2018;"SALMOURAO (SP)";"SP";"SALMOURAO";41;6;47;94
2018;"SALTINHO (SP)";"SP";"SALTINHO";399;29;15;443
2018;"SALTO (SP)";"SP";"SALTO";2527;297;167;2991
2018;"SALTO DE PIRAPORA (SP)";"SP";"SALTO DE PIRAPORA";762;88;107;957
2018;"SALTO GRANDE (SP)";"SP";"SALTO GRANDE";167;20;35;222
2018;"SANDOVALINA (SP)";"SP";"SANDOVALINA";79;6;22;107
2018;"SANTA ADELIA (SP)";"SP";"SANTA ADELIA";588;28;81;697
2018;"SANTA ALBERTINA (SP)";"SP";"SANTA ALBERTINA";140;8;27;175
2018;"SANTA BARBARA D OESTE (SP)";"SP";"SANTA BARBARA D OESTE";2582;453;416;3451
2018;"SANTA BRANCA (SP)";"SP";"SANTA BRANCA";142;44;38;224
2018;"SANTA CLARA D OESTE (SP)";"SP";"SANTA CLARA D OESTE";31;6;10;47
2018;"SANTA CRUZ DA CONCEICAO (SP)";"SP";"SANTA CRUZ DA CONCEICAO";153;8;17;178
2018;"SANTA CRUZ DA ESPERANCA (SP)";"SP";"SANTA CRUZ DA ESPERANCA";63;4;6;73
2018;"SANTA CRUZ DAS PALMEIRAS (SP)";"SP";"SANTA CRUZ DAS PALMEIRAS";611;52;256;919
2018;"SANTA CRUZ DO RIO PARDO (SP)";"SP";"SANTA CRUZ DO RIO PARDO";1581;119;114;1814
2018;"SANTA ERNESTINA (SP)";"SP";"SANTA ERNESTINA";72;19;94;185
2018;"SANTA FE DO SUL (SP)";"SP";"SANTA FE DO SUL";682;39;54;775
2018;"SANTA GERTRUDES (SP)";"SP";"SANTA GERTRUDES";616;56;41;713
2018;"SANTA ISABEL (SP)";"SP";"SANTA ISABEL";1279;116;121;1516
2018;"SANTA LUCIA (SP)";"SP";"SANTA LUCIA";125;28;53;206
2018;"SANTA MARIA DA SERRA (SP)";"SP";"SANTA MARIA DA SERRA";247;34;35;316
2018;"SANTA MERCEDES (SP)";"SP";"SANTA MERCEDES";52;9;9;70
2018;"SANTA RITA D OESTE (SP)";"SP";"SANTA RITA D OESTE";43;4;7;54
2018;"SANTA RITA DO PASSA QUATRO (SP)";"SP";"SANTA RITA DO PASSA QUATRO";588;86;57;731
2018;"SANTA ROSA DE VITERBO (SP)";"SP";"SANTA ROSA DE VITERBO";473;42;109;624
2018;"SANTA SALETE (SP)";"SP";"SANTA SALETE";47;3;8;58
2018;"SANTANA DA PONTE PENSA (SP)";"SP";"SANTANA DA PONTE PENSA";26;4;6;36
2018;"SANTANA DE PARNAIBA (SP)";"SP";"SANTANA DE PARNAIBA";1995;367;212;2574
2018;"SANTO ANASTACIO (SP)";"SP";"SANTO ANASTACIO";516;38;70;624
2018;"SANTO ANDRE (SP)";"SP";"SANTO ANDRE";8895;1615;1769;12279
2018;"SANTO ANTONIO DA ALEGRIA (SP)";"SP";"SANTO ANTONIO DA ALEGRIA";128;11;32;171
2018;"SANTO ANTONIO DE POSSE (SP)";"SP";"SANTO ANTONIO DE POSSE";921;82;172;1175
2018;"SANTO ANTONIO DO ARACANGUA (SP)";"SP";"SANTO ANTONIO DO ARACANGUA";203;33;91;327
2018;"SANTO ANTONIO DO JARDIM (SP)";"SP";"SANTO ANTONIO DO JARDIM";225;21;19;265
2018;"SANTO ANTONIO DO PINHAL (SP)";"SP";"SANTO ANTONIO DO PINHAL";187;28;12;227
2018;"SANTO EXPEDITO (SP)";"SP";"SANTO EXPEDITO";30;4;19;53
2018;"SANTOPOLIS DO AGUAPEI (SP)";"SP";"SANTOPOLIS DO AGUAPEI";67;7;36;110
2018;"SANTOS (SP)";"SP";"SANTOS";5420;936;693;7049
2018;"SAO BENTO DO SAPUCAI (SP)";"SP";"SAO BENTO DO SAPUCAI";191;55;13;259
2018;"SAO BERNARDO DO CAMPO (SP)";"SP";"SAO BERNARDO DO CAMPO";11486;2583;4135;18204
2018;"SAO CAETANO DO SUL (SP)";"SP";"SAO CAETANO DO SUL";2774;493;577;3844
2018;"SAO CARLOS (SP)";"SP";"SAO CARLOS";4049;477;446;4972
2018;"SAO FRANCISCO (SP)";"SP";"SAO FRANCISCO";46;5;17;68
2018;"SAO JOAO DA BOA VISTA (SP)";"SP";"SAO JOAO DA BOA VISTA";2091;289;122;2502
2018;"SAO JOAO DAS DUAS PONTES (SP)";"SP";"SAO JOAO DAS DUAS PONTES";28;11;5;44
2018;"SAO JOAO DE IRACEMA (SP)";"SP";"SAO JOAO DE IRACEMA";26;6;12;44
2018;"SAO JOAO DO PAU D ALHO (SP)";"SP";"SAO JOAO DO PAU D ALHO";38;8;7;53
2018;"SAO JOAQUIM DA BARRA (SP)";"SP";"SAO JOAQUIM DA BARRA";813;105;214;1132
2018;"SAO JOSE DA BELA VISTA (SP)";"SP";"SAO JOSE DA BELA VISTA";80;19;48;147
2018;"SAO JOSE DO BARREIRO (SP)";"SP";"SAO JOSE DO BARREIRO";46;12;5;63
2018;"SAO JOSE DO RIO PARDO (SP)";"SP";"SAO JOSE DO RIO PARDO";1293;121;168;1582
2018;"SAO JOSE DO RIO PRETO (SP)";"SP";"SAO JOSE DO RIO PRETO";8497;649;1633;10779
2018;"SAO JOSE DOS CAMPOS (SP)";"SP";"SAO JOSE DOS CAMPOS";7099;1959;1880;10938
2018;"SAO LOURENCO DA SERRA (SP)";"SP";"SAO LOURENCO DA SERRA";361;41;33;435
2018;"SAO LUIZ DO PARAITINGA (SP)";"SP";"SAO LUIZ DO PARAITINGA";222;43;27;292
2018;"SAO MANUEL (SP)";"SP";"SAO MANUEL";808;135;231;1174
2018;"SAO MIGUEL ARCANJO (SP)";"SP";"SAO MIGUEL ARCANJO";773;133;91;997
2018;"SAO PAULO (SP)";"SP";"SAO PAULO";132385;38626;45544;216555
2018;"SAO PEDRO (SP)";"SP";"SAO PEDRO";696;128;111;935
2018;"SAO PEDRO DO TURVO (SP)";"SP";"SAO PEDRO DO TURVO";187;26;49;262
2018;"SAO ROQUE (SP)";"SP";"SAO ROQUE";1253;254;224;1731
2018;"SAO SEBASTIAO (SP)";"SP";"SAO SEBASTIAO";942;141;171;1254
2018;"SAO SEBASTIAO DA GRAMA (SP)";"SP";"SAO SEBASTIAO DA GRAMA";274;36;51;361
2018;"SAO SIMAO (SP)";"SP";"SAO SIMAO";408;29;56;493
2018;"SAO VICENTE (SP)";"SP";"SAO VICENTE";2157;532;997;3686
2018;"SARAPUI (SP)";"SP";"SARAPUI";184;24;21;229
2018;"SARUTAIA (SP)";"SP";"SARUTAIA";66;14;35;115
2018;"SEBASTIANOPOLIS DO SUL (SP)";"SP";"SEBASTIANOPOLIS DO SUL";272;3;17;292
2018;"SERRA AZUL (SP)";"SP";"SERRA AZUL";195;21;127;343
2018;"SERRA NEGRA (SP)";"SP";"SERRA NEGRA";505;68;51;624
2018;"SERRANA (SP)";"SP";"SERRANA";706;131;274;1111
2018;"SERTAOZINHO (SP)";"SP";"SERTAOZINHO";2817;193;722;3732
2018;"SETE BARRAS (SP)";"SP";"SETE BARRAS";275;53;33;361
2018;"SEVERINIA (SP)";"SP";"SEVERINIA";329;28;259;616
2018;"SILVEIRAS (SP)";"SP";"SILVEIRAS";91;26;7;124
2018;"SOCORRO (SP)";"SP";"SOCORRO";1022;152;64;1238
2018;"SOROCABA (SP)";"SP";"SOROCABA";8140;1524;1691;11355
2018;"SUD MENNUCCI (SP)";"SP";"SUD MENNUCCI";153;19;59;231
2018;"SUMARE (SP)";"SP";"SUMARE";2974;721;700;4395
2018;"SUZANAPOLIS (SP)";"SP";"SUZANAPOLIS";96;9;21;126
2018;"SUZANO (SP)";"SP";"SUZANO";3624;1004;917;5545
2018;"TABAPUA (SP)";"SP";"TABAPUA";170;17;67;254
2018;"TABATINGA (SP)";"SP";"TABATINGA";363;33;211;607
2018;"TABOAO DA SERRA (SP)";"SP";"TABOAO DA SERRA";2692;980;543;4215
2018;"TACIBA (SP)";"SP";"TACIBA";101;12;25;138
2018;"TAGUAI (SP)";"SP";"TAGUAI";199;20;39;258
2018;"TAIACU (SP)";"SP";"TAIACU";160;12;29;201
2018;"TAIUVA (SP)";"SP";"TAIUVA";164;10;31;205
2018;"TAMBAU (SP)";"SP";"TAMBAU";601;61;81;743
2018;"TANABI (SP)";"SP";"TANABI";551;66;129;746
2018;"TAPIRAI (SP)";"SP";"TAPIRAI";214;22;13;249
2018;"TAPIRATIBA (SP)";"SP";"TAPIRATIBA";380;39;87;506
2018;"TAQUARAL (SP)";"SP";"TAQUARAL";65;6;24;95
2018;"TAQUARITINGA (SP)";"SP";"TAQUARITINGA";1693;118;363;2174
2018;"TAQUARITUBA (SP)";"SP";"TAQUARITUBA";851;64;122;1037
2018;"TAQUARIVAI (SP)";"SP";"TAQUARIVAI";122;16;21;159
2018;"TARABAI (SP)";"SP";"TARABAI";129;5;34;168
2018;"TARUMA (SP)";"SP";"TARUMA";376;47;185;608
2018;"TATUI (SP)";"SP";"TATUI";2500;209;685;3394
2018;"TAUBATE (SP)";"SP";"TAUBATE";3274;835;580;4689
2018;"TEJUPA (SP)";"SP";"TEJUPA";58;30;10;98
2018;"TEODORO SAMPAIO (SP)";"SP";"TEODORO SAMPAIO";380;45;316;741
2018;"TERRA ROXA (SP)";"SP";"TERRA ROXA";191;19;77;287
2018;"TIETE (SP)";"SP";"TIETE";1295;71;231;1597
2018;"TIMBURI (SP)";"SP";"TIMBURI";29;7;4;40
2018;"TORRE DE PEDRA (SP)";"SP";"TORRE DE PEDRA";53;12;9;74
2018;"TORRINHA (SP)";"SP";"TORRINHA";481;34;49;564
2018;"TRABIJU (SP)";"SP";"TRABIJU";51;12;9;72
2018;"TREMEMBE (SP)";"SP";"TREMEMBE";536;77;22;635
2018;"TRES FRONTEIRAS (SP)";"SP";"TRES FRONTEIRAS";79;17;16;112
2018;"TUIUTI (SP)";"SP";"TUIUTI";125;24;22;171
2018;"TUPA (SP)";"SP";"TUPA";1647;86;268;2001
2018;"TUPI PAULISTA (SP)";"SP";"TUPI PAULISTA";355;24;33;412
2018;"TURIUBA (SP)";"SP";"TURIUBA";30;4;15;49
2018;"TURMALINA (SP)";"SP";"TURMALINA";26;3;10;39
2018;"UBARANA (SP)";"SP";"UBARANA";145;4;43;192
2018;"UBATUBA (SP)";"SP";"UBATUBA";840;158;101;1099
2018;"UBIRAJARA (SP)";"SP";"UBIRAJARA";123;9;49;181
2018;"UCHOA (SP)";"SP";"UCHOA";182;15;50;247
2018;"UNIAO PAULISTA (SP)";"SP";"UNIAO PAULISTA";52;6;12;70
2018;"URANIA (SP)";"SP";"URANIA";170;22;36;228
2018;"URU (SP)";"SP";"URU";13;12;10;35
2018;"URUPES (SP)";"SP";"URUPES";420;22;53;495
2018;"VALENTIM GENTIL (SP)";"SP";"VALENTIM GENTIL";315;19;45;379
2018;"VALINHOS (SP)";"SP";"VALINHOS";2237;571;1987;4795
2018;"VALPARAISO (SP)";"SP";"VALPARAISO";475;37;164;676
2018;"VARGEM (SP)";"SP";"VARGEM";364;25;28;417
2018;"VARGEM GRANDE DO SUL (SP)";"SP";"VARGEM GRANDE DO SUL";1272;106;236;1614
2018;"VARGEM GRANDE PAULISTA (SP)";"SP";"VARGEM GRANDE PAULISTA";966;118;76;1160
2018;"VARZEA PAULISTA (SP)";"SP";"VARZEA PAULISTA";1234;454;421;2109
2018;"VERA CRUZ (SP)";"SP";"VERA CRUZ";180;35;40;255
2018;"VINHEDO (SP)";"SP";"VINHEDO";1530;158;172;1860
2018;"VIRADOURO (SP)";"SP";"VIRADOURO";415;27;107;549
2018;"VISTA ALEGRE DO ALTO (SP)";"SP";"VISTA ALEGRE DO ALTO";430;37;141;608
2018;"VITORIA BRASIL (SP)";"SP";"VITORIA BRASIL";26;5;9;40
2018;"VOTORANTIM (SP)";"SP";"VOTORANTIM";1319;278;248;1845
2018;"VOTUPORANGA (SP)";"SP";"VOTUPORANGA";2143;194;342;2679
2018;"ZACARIAS (SP)";"SP";"ZACARIAS";65;3;27;95
2018;"ABREULANDIA (TO)";"TO";"ABREULANDIA";23;1;2;26
2018;"AGUIARNOPOLIS (TO)";"TO";"AGUIARNOPOLIS";55;4;16;75
2018;"ALIANCA DO TOCANTINS (TO)";"TO";"ALIANCA DO TOCANTINS";89;11;14;114
2018;"ALMAS (TO)";"TO";"ALMAS";76;1;9;86
2018;"ALVORADA (TO)";"TO";"ALVORADA";208;3;20;231
2018;"ANANAS (TO)";"TO";"ANANAS";84;1;34;119
2018;"ANGICO (TO)";"TO";"ANGICO";23;5;9;37
2018;"APARECIDA DO RIO NEGRO (TO)";"TO";"APARECIDA DO RIO NEGRO";66;14;6;86
2018;"ARAGOMINAS (TO)";"TO";"ARAGOMINAS";54;2;17;73
2018;"ARAGUACEMA (TO)";"TO";"ARAGUACEMA";38;3;12;53
2018;"ARAGUACU (TO)";"TO";"ARAGUACU";126;13;14;153
2018;"ARAGUAINA (TO)";"TO";"ARAGUAINA";3689;162;768;4619
2018;"ARAGUANA (TO)";"TO";"ARAGUANA";92;2;19;113
2018;"ARAGUATINS (TO)";"TO";"ARAGUATINS";318;54;89;461
2018;"ARAPOEMA (TO)";"TO";"ARAPOEMA";54;7;15;76
2018;"ARRAIAS (TO)";"TO";"ARRAIAS";45;0;10;55
2018;"AUGUSTINOPOLIS (TO)";"TO";"AUGUSTINOPOLIS";199;33;44;276
2018;"AURORA DO TOCANTINS (TO)";"TO";"AURORA DO TOCANTINS";11;0;5;16
2018;"AXIXA DO TOCANTINS (TO)";"TO";"AXIXA DO TOCANTINS";50;13;11;74
2018;"BABACULANDIA (TO)";"TO";"BABACULANDIA";213;14;23;250
2018;"BANDEIRANTES DO TOCANTINS (TO)";"TO";"BANDEIRANTES DO TOCANTINS";30;3;4;37
2018;"BARRA DO OURO (TO)";"TO";"BARRA DO OURO";18;0;2;20
2018;"BARROLANDIA (TO)";"TO";"BARROLANDIA";70;4;9;83
2018;"BERNARDO SAYAO (TO)";"TO";"BERNARDO SAYAO";38;1;7;46
2018;"BOM JESUS DO TOCANTINS (TO)";"TO";"BOM JESUS DO TOCANTINS";11;1;4;16
2018;"BRASILANDIA DO TOCANTINS (TO)";"TO";"BRASILANDIA DO TOCANTINS";20;2;2;24
2018;"BREJINHO DE NAZARE (TO)";"TO";"BREJINHO DE NAZARE";57;3;21;81
2018;"BURITI DO TOCANTINS (TO)";"TO";"BURITI DO TOCANTINS";51;12;6;69
2018;"CACHOEIRINHA (TO)";"TO";"CACHOEIRINHA";9;0;1;10
2018;"CAMPOS LINDOS (TO)";"TO";"CAMPOS LINDOS";71;0;8;79
2018;"CARIRI DO TOCANTINS (TO)";"TO";"CARIRI DO TOCANTINS";61;7;18;86
2018;"CARMOLANDIA (TO)";"TO";"CARMOLANDIA";193;17;93;303
2018;"CARRASCO BONITO (TO)";"TO";"CARRASCO BONITO";11;5;3;19
2018;"CASEARA (TO)";"TO";"CASEARA";30;3;8;41
2018;"CENTENARIO (TO)";"TO";"CENTENARIO";7;0;3;10
2018;"CHAPADA DA NATIVIDADE (TO)";"TO";"CHAPADA DA NATIVIDADE";28;1;10;39
2018;"CHAPADA DE AREIA (TO)";"TO";"CHAPADA DE AREIA";7;2;2;11
2018;"COLINAS DO TOCANTINS (TO)";"TO";"COLINAS DO TOCANTINS";605;13;76;694
2018;"COLMEIA (TO)";"TO";"COLMEIA";130;7;19;156
2018;"COMBINADO (TO)";"TO";"COMBINADO";25;1;11;37
2018;"CONCEICAO DO TOCANTINS (TO)";"TO";"CONCEICAO DO TOCANTINS";21;1;3;25
2018;"COUTO DE MAGALHAES (TO)";"TO";"COUTO DE MAGALHAES";34;5;13;52
2018;"CRISTALANDIA (TO)";"TO";"CRISTALANDIA";110;2;8;120
2018;"CRIXAS DO TOCANTINS (TO)";"TO";"CRIXAS DO TOCANTINS";20;1;3;24
2018;"DARCINOPOLIS (TO)";"TO";"DARCINOPOLIS";103;9;16;128
2018;"DIANOPOLIS (TO)";"TO";"DIANOPOLIS";284;23;80;387
2018;"DIVINOPOLIS DO TOCANTINS (TO)";"TO";"DIVINOPOLIS DO TOCANTINS";107;2;8;117
2018;"DOIS IRMAOS DO TOCANTINS (TO)";"TO";"DOIS IRMAOS DO TOCANTINS";47;9;17;73
2018;"DUERE (TO)";"TO";"DUERE";54;6;5;65
2018;"ESPERANTINA (TO)";"TO";"ESPERANTINA";27;10;13;50
2018;"FATIMA (TO)";"TO";"FATIMA";62;2;11;75
2018;"FIGUEIROPOLIS (TO)";"TO";"FIGUEIROPOLIS";99;4;10;113
2018;"FILADELFIA (TO)";"TO";"FILADELFIA";53;9;13;75
2018;"FORMOSO DO ARAGUAIA (TO)";"TO";"FORMOSO DO ARAGUAIA";287;12;40;339
2018;"FORTALEZA DO TABOCAO (TO)";"TO";"FORTALEZA DO TABOCAO";33;4;4;41
2018;"GOIANORTE (TO)";"TO";"GOIANORTE";44;2;15;61
2018;"GOIATINS (TO)";"TO";"GOIATINS";62;6;11;79
2018;"GUARAI (TO)";"TO";"GUARAI";465;26;41;532
2018;"GURUPI (TO)";"TO";"GURUPI";1713;54;252;2019
2018;"IPUEIRAS (TO)";"TO";"IPUEIRAS";11;1;2;14
2018;"ITACAJA (TO)";"TO";"ITACAJA";57;2;4;63
2018;"ITAGUATINS (TO)";"TO";"ITAGUATINS";33;5;14;52
2018;"ITAPIRATINS (TO)";"TO";"ITAPIRATINS";26;2;10;38
2018;"ITAPORA DO TOCANTINS (TO)";"TO";"ITAPORA DO TOCANTINS";21;3;7;31
2018;"JAU DO TOCANTINS (TO)";"TO";"JAU DO TOCANTINS";24;2;9;35
2018;"JUARINA (TO)";"TO";"JUARINA";10;3;7;20
2018;"LAGOA DA CONFUSAO (TO)";"TO";"LAGOA DA CONFUSAO";215;5;26;246
2018;"LAGOA DO TOCANTINS (TO)";"TO";"LAGOA DO TOCANTINS";14;0;4;18
2018;"LAJEADO (TO)";"TO";"LAJEADO";35;2;10;47
2018;"LAVANDEIRA (TO)";"TO";"LAVANDEIRA";4;1;3;8
2018;"LIZARDA (TO)";"TO";"LIZARDA";21;0;1;22
2018;"LUZINOPOLIS (TO)";"TO";"LUZINOPOLIS";16;2;3;21
2018;"MARIANOPOLIS DO TOCANTINS (TO)";"TO";"MARIANOPOLIS DO TOCANTINS";53;2;10;65
2018;"MATEIROS (TO)";"TO";"MATEIROS";27;3;5;35
2018;"MAURILANDIA DO TOCANTINS (TO)";"TO";"MAURILANDIA DO TOCANTINS";13;9;7;29
2018;"MIRACEMA DO TOCANTINS (TO)";"TO";"MIRACEMA DO TOCANTINS";198;22;41;261
2018;"MIRANORTE (TO)";"TO";"MIRANORTE";279;12;28;319
2018;"MONTE DO CARMO (TO)";"TO";"MONTE DO CARMO";35;8;10;53
2018;"MONTE SANTO DO TOCANTINS (TO)";"TO";"MONTE SANTO DO TOCANTINS";20;3;4;27
2018;"MURICILANDIA (TO)";"TO";"MURICILANDIA";13;5;6;24
2018;"NATIVIDADE (TO)";"TO";"NATIVIDADE";106;4;9;119
2018;"NAZARE (TO)";"TO";"NAZARE";22;3;6;31
2018;"NOVA OLINDA (TO)";"TO";"NOVA OLINDA";123;2;29;154
2018;"NOVA ROSALANDIA (TO)";"TO";"NOVA ROSALANDIA";29;2;4;35
2018;"NOVO ACORDO (TO)";"TO";"NOVO ACORDO";31;1;10;42
2018;"NOVO ALEGRE (TO)";"TO";"NOVO ALEGRE";13;1;4;18
2018;"NOVO JARDIM (TO)";"TO";"NOVO JARDIM";17;2;4;23
2018;"OLIVEIRA DE FATIMA (TO)";"TO";"OLIVEIRA DE FATIMA";12;1;5;18
2018;"PALMAS (TO)";"TO";"PALMAS";4815;334;1888;7037
2018;"PALMEIRANTE (TO)";"TO";"PALMEIRANTE";25;3;8;36
2018;"PALMEIRAS DO TOCANTINS (TO)";"TO";"PALMEIRAS DO TOCANTINS";40;6;11;57
2018;"PALMEIROPOLIS (TO)";"TO";"PALMEIROPOLIS";128;4;22;154
2018;"PARAISO DO TOCANTINS (TO)";"TO";"PARAISO DO TOCANTINS";1282;44;136;1462
2018;"PARANA (TO)";"TO";"PARANA";43;5;3;51
2018;"PAU D ARCO (TO)";"TO";"PAU D ARCO";28;1;8;37
2018;"PEDRO AFONSO (TO)";"TO";"PEDRO AFONSO";249;14;54;317
2018;"PEIXE (TO)";"TO";"PEIXE";98;13;47;158
2018;"PEQUIZEIRO (TO)";"TO";"PEQUIZEIRO";43;2;14;59
2018;"PINDORAMA DO TOCANTINS (TO)";"TO";"PINDORAMA DO TOCANTINS";22;1;9;32
2018;"PIRAQUE (TO)";"TO";"PIRAQUE";12;0;7;19
2018;"PIUM (TO)";"TO";"PIUM";60;5;15;80
2018;"PONTE ALTA DO BOM JESUS (TO)";"TO";"PONTE ALTA DO BOM JESUS";27;3;3;33
2018;"PONTE ALTA DO TOCANTINS (TO)";"TO";"PONTE ALTA DO TOCANTINS";29;2;5;36
2018;"PORTO ALEGRE DO TOCANTINS (TO)";"TO";"PORTO ALEGRE DO TOCANTINS";12;0;6;18
2018;"PORTO NACIONAL (TO)";"TO";"PORTO NACIONAL";846;83;235;1164
2018;"PRAIA NORTE (TO)";"TO";"PRAIA NORTE";14;4;5;23
2018;"PRESIDENTE KENNEDY (TO)";"TO";"PRESIDENTE KENNEDY";30;0;3;33
2018;"PUGMIL (TO)";"TO";"PUGMIL";28;2;2;32
2018;"RECURSOLANDIA (TO)";"TO";"RECURSOLANDIA";13;0;1;14
2018;"RIACHINHO (TO)";"TO";"RIACHINHO";116;8;74;198
2018;"RIO DA CONCEICAO (TO)";"TO";"RIO DA CONCEICAO";9;1;3;13
2018;"RIO DOS BOIS (TO)";"TO";"RIO DOS BOIS";17;4;4;25
2018;"RIO SONO (TO)";"TO";"RIO SONO";31;2;7;40
2018;"SAMPAIO (TO)";"TO";"SAMPAIO";54;3;6;63
2018;"SANDOLANDIA (TO)";"TO";"SANDOLANDIA";26;10;1;37
2018;"SANTA FE DO ARAGUAIA (TO)";"TO";"SANTA FE DO ARAGUAIA";78;9;20;107
2018;"SANTA MARIA DO TOCANTINS (TO)";"TO";"SANTA MARIA DO TOCANTINS";17;3;3;23
2018;"SANTA RITA DO TOCANTINS (TO)";"TO";"SANTA RITA DO TOCANTINS";13;1;5;19
2018;"SANTA ROSA DO TOCANTINS (TO)";"TO";"SANTA ROSA DO TOCANTINS";49;1;4;54
2018;"SANTA TEREZA DO TOCANTINS (TO)";"TO";"SANTA TEREZA DO TOCANTINS";19;2;4;25
2018;"SANTA TEREZINHA DO TOCANTINS (TO)";"TO";"SANTA TEREZINHA DO TOCANTINS";18;3;5;26
2018;"SAO BENTO DO TOCANTINS (TO)";"TO";"SAO BENTO DO TOCANTINS";28;5;14;47
2018;"SAO FELIX DO TOCANTINS (TO)";"TO";"SAO FELIX DO TOCANTINS";7;1;1;9
2018;"SAO MIGUEL DO TOCANTINS (TO)";"TO";"SAO MIGUEL DO TOCANTINS";104;12;42;158
2018;"SAO SALVADOR DO TOCANTINS (TO)";"TO";"SAO SALVADOR DO TOCANTINS";24;4;4;32
2018;"SAO SEBASTIAO DO TOCANTINS (TO)";"TO";"SAO SEBASTIAO DO TOCANTINS";15;3;2;20
2018;"SAO VALERIO DA NATIVIDADE (TO)";"TO";"SAO VALERIO DA NATIVIDADE";61;2;9;72
2018;"SILVANOPOLIS (TO)";"TO";"SILVANOPOLIS";58;1;6;65
2018;"SITIO NOVO DO TOCANTINS (TO)";"TO";"SITIO NOVO DO TOCANTINS";48;8;16;72
2018;"SUCUPIRA (TO)";"TO";"SUCUPIRA";15;0;7;22
2018;"TAGUATINGA (TO)";"TO";"TAGUATINGA";192;13;29;234
2018;"TAIPAS DO TOCANTINS (TO)";"TO";"TAIPAS DO TOCANTINS";6;1;2;9
2018;"TALISMA (TO)";"TO";"TALISMA";25;5;7;37
2018;"TOCANTINIA (TO)";"TO";"TOCANTINIA";25;1;9;35
2018;"TOCANTINOPOLIS (TO)";"TO";"TOCANTINOPOLIS";1149;256;387;1792
2018;"TUPIRAMA (TO)";"TO";"TUPIRAMA";23;4;5;32
2018;"TUPIRATINS (TO)";"TO";"TUPIRATINS";11;1;9;21
2018;"WANDERLANDIA (TO)";"TO";"WANDERLANDIA";66;4;12;82
2018;"XAMBIOA (TO)";"TO";"XAMBIOA";143;10;22;175
