"ano";"chave";"UF";"MUNICIPIO";"CAMINHAO";"MICRO_ONIBUS";"ONIBUS";"total"
2019;"ACRELANDIA (AC)";"AC";"ACRELANDIA";335;10;42;387
2019;"ASSIS BRASIL (AC)";"AC";"ASSIS BRASIL";24;3;3;30
2019;"BRASILEIA (AC)";"AC";"BRASILEIA";274;5;19;298
2019;"BUJARI (AC)";"AC";"BUJARI";122;5;12;139
2019;"CAPIXABA (AC)";"AC";"CAPIXABA";86;3;16;105
2019;"CRUZEIRO DO SUL (AC)";"AC";"CRUZEIRO DO SUL";733;59;80;872
2019;"EPITACIOLANDIA (AC)";"AC";"EPITACIOLANDIA";253;6;16;275
2019;"FEIJO (AC)";"AC";"FEIJO";116;2;12;130
2019;"JORDAO (AC)";"AC";"JORDAO";5;0;0;5
2019;"MANCIO LIMA (AC)";"AC";"MANCIO LIMA";95;4;16;115
2019;"MANOEL URBANO (AC)";"AC";"MANOEL URBANO";50;0;6;56
2019;"MARECHAL THAUMATURGO (AC)";"AC";"MARECHAL THAUMATURGO";13;0;9;22
2019;"PLACIDO DE CASTRO (AC)";"AC";"PLACIDO DE CASTRO";155;5;27;187
2019;"PORTO ACRE (AC)";"AC";"PORTO ACRE";172;3;47;222
2019;"PORTO WALTER (AC)";"AC";"PORTO WALTER";9;0;5;14
2019;"RIO BRANCO (AC)";"AC";"RIO BRANCO";4262;237;832;5331
2019;"RODRIGUES ALVES (AC)";"AC";"RODRIGUES ALVES";17;1;9;27
2019;"SANTA ROSA DO PURUS (AC)";"AC";"SANTA ROSA DO PURUS";5;0;3;8
2019;"SENA MADUREIRA (AC)";"AC";"SENA MADUREIRA";115;4;10;129
2019;"SENADOR GUIOMARD (AC)";"AC";"SENADOR GUIOMARD";351;8;35;394
2019;"TARAUACA (AC)";"AC";"TARAUACA";156;21;23;200
2019;"XAPURI (AC)";"AC";"XAPURI";76;4;6;86
2019;"AGUA BRANCA (AL)";"AL";"AGUA BRANCA";120;91;31;242
2019;"ANADIA (AL)";"AL";"ANADIA";46;36;48;130
2019;"ARAPIRACA (AL)";"AL";"ARAPIRACA";3020;406;503;3929
2019;"ATALAIA (AL)";"AL";"ATALAIA";209;43;162;414
2019;"BARRA DE SANTO ANTONIO (AL)";"AL";"BARRA DE SANTO ANTONIO";31;7;26;64
2019;"BARRA DE SAO MIGUEL (AL)";"AL";"BARRA DE SAO MIGUEL";26;3;13;42
2019;"BATALHA (AL)";"AL";"BATALHA";138;53;21;212
2019;"BELEM (AL)";"AL";"BELEM";9;21;8;38
2019;"BELO MONTE (AL)";"AL";"BELO MONTE";36;23;7;66
2019;"BOCA DA MATA (AL)";"AL";"BOCA DA MATA";207;77;102;386
2019;"BRANQUINHA (AL)";"AL";"BRANQUINHA";32;22;21;75
2019;"CACIMBINHAS (AL)";"AL";"CACIMBINHAS";83;41;13;137
2019;"CAJUEIRO (AL)";"AL";"CAJUEIRO";90;10;51;151
2019;"CAMPESTRE (AL)";"AL";"CAMPESTRE";38;54;8;100
2019;"CAMPO ALEGRE (AL)";"AL";"CAMPO ALEGRE";134;114;158;406
2019;"CAMPO GRANDE (AL)";"AL";"CAMPO GRANDE";47;17;23;87
2019;"CANAPI (AL)";"AL";"CANAPI";70;84;27;181
2019;"CAPELA (AL)";"AL";"CAPELA";69;5;66;140
2019;"CARNEIROS (AL)";"AL";"CARNEIROS";32;19;10;61
2019;"CHA PRETA (AL)";"AL";"CHA PRETA";30;10;6;46
2019;"COITE DO NOIA (AL)";"AL";"COITE DO NOIA";84;11;25;120
2019;"COLONIA LEOPOLDINA (AL)";"AL";"COLONIA LEOPOLDINA";103;33;35;171
2019;"COQUEIRO SECO (AL)";"AL";"COQUEIRO SECO";10;4;9;23
2019;"CORURIPE (AL)";"AL";"CORURIPE";376;78;235;689
2019;"CRAIBAS (AL)";"AL";"CRAIBAS";233;40;37;310
2019;"DELMIRO GOUVEIA (AL)";"AL";"DELMIRO GOUVEIA";789;485;119;1393
2019;"DOIS RIACHOS (AL)";"AL";"DOIS RIACHOS";85;22;13;120
2019;"ESTRELA DE ALAGOAS (AL)";"AL";"ESTRELA DE ALAGOAS";59;90;26;175
2019;"FEIRA GRANDE (AL)";"AL";"FEIRA GRANDE";111;8;50;169
2019;"FELIZ DESERTO (AL)";"AL";"FELIZ DESERTO";14;5;9;28
2019;"FLEXEIRAS (AL)";"AL";"FLEXEIRAS";35;21;49;105
2019;"GIRAU DO PONCIANO (AL)";"AL";"GIRAU DO PONCIANO";220;70;94;384
2019;"IBATEGUARA (AL)";"AL";"IBATEGUARA";49;70;21;140
2019;"IGACI (AL)";"AL";"IGACI";143;128;41;312
2019;"IGREJA NOVA (AL)";"AL";"IGREJA NOVA";79;24;110;213
2019;"INHAPI (AL)";"AL";"INHAPI";82;24;10;116
2019;"JACARE DOS HOMENS (AL)";"AL";"JACARE DOS HOMENS";40;14;17;71
2019;"JACUIPE (AL)";"AL";"JACUIPE";14;19;20;53
2019;"JAPARATINGA (AL)";"AL";"JAPARATINGA";24;22;13;59
2019;"JARAMATAIA (AL)";"AL";"JARAMATAIA";29;14;7;50
2019;"JEQUIA DA PRAIA (AL)";"AL";"JEQUIA DA PRAIA";40;7;48;95
2019;"JOAQUIM GOMES (AL)";"AL";"JOAQUIM GOMES";116;30;86;232
2019;"JUNDIA (AL)";"AL";"JUNDIA";16;6;13;35
2019;"JUNQUEIRO (AL)";"AL";"JUNQUEIRO";187;24;116;327
2019;"LAGOA DA CANOA (AL)";"AL";"LAGOA DA CANOA";100;29;42;171
2019;"LIMOEIRO DE ANADIA (AL)";"AL";"LIMOEIRO DE ANADIA";157;26;68;251
2019;"MACEIO (AL)";"AL";"MACEIO";7648;1242;2287;11177
2019;"MAJOR ISIDORO (AL)";"AL";"MAJOR ISIDORO";109;33;31;173
2019;"MAR VERMELHO (AL)";"AL";"MAR VERMELHO";14;2;9;25
2019;"MARAGOGI (AL)";"AL";"MARAGOGI";93;169;49;311
2019;"MARAVILHA (AL)";"AL";"MARAVILHA";68;53;11;132
2019;"MARECHAL DEODORO (AL)";"AL";"MARECHAL DEODORO";300;77;190;567
2019;"MARIBONDO (AL)";"AL";"MARIBONDO";72;16;19;107
2019;"MATA GRANDE (AL)";"AL";"MATA GRANDE";71;54;20;145
2019;"MATRIZ DE CAMARAGIBE (AL)";"AL";"MATRIZ DE CAMARAGIBE";143;29;139;311
2019;"MESSIAS (AL)";"AL";"MESSIAS";70;43;93;206
2019;"MINADOR DO NEGRAO (AL)";"AL";"MINADOR DO NEGRAO";58;16;9;83
2019;"MONTEIROPOLIS (AL)";"AL";"MONTEIROPOLIS";24;14;6;44
2019;"MURICI (AL)";"AL";"MURICI";144;28;103;275
2019;"NOVO LINO (AL)";"AL";"NOVO LINO";85;51;67;203
2019;"OLHO D AGUA DAS FLORES (AL)";"AL";"OLHO D AGUA DAS FLORES";145;97;35;277
2019;"OLHO D AGUA DO CASADO (AL)";"AL";"OLHO D AGUA DO CASADO";36;16;12;64
2019;"OLHO D AGUA GRANDE (AL)";"AL";"OLHO D AGUA GRANDE";16;3;14;33
2019;"OLIVENCA (AL)";"AL";"OLIVENCA";64;35;14;113
2019;"OURO BRANCO (AL)";"AL";"OURO BRANCO";107;55;33;195
2019;"PALESTINA (AL)";"AL";"PALESTINA";11;23;4;38
2019;"PALMEIRA DOS INDIOS (AL)";"AL";"PALMEIRA DOS INDIOS";658;326;92;1076
2019;"PAO DE ACUCAR (AL)";"AL";"PAO DE ACUCAR";72;92;17;181
2019;"PARICONHA (AL)";"AL";"PARICONHA";54;47;13;114
2019;"PARIPUEIRA (AL)";"AL";"PARIPUEIRA";64;4;18;86
2019;"PASSO DE CAMARAGIBE (AL)";"AL";"PASSO DE CAMARAGIBE";39;11;31;81
2019;"PAULO JACINTO (AL)";"AL";"PAULO JACINTO";15;8;9;32
2019;"PENEDO (AL)";"AL";"PENEDO";293;70;299;662
2019;"PIACABUCU (AL)";"AL";"PIACABUCU";35;15;20;70
2019;"PILAR (AL)";"AL";"PILAR";157;58;91;306
2019;"PINDOBA (AL)";"AL";"PINDOBA";9;2;4;15
2019;"PIRANHAS (AL)";"AL";"PIRANHAS";90;96;20;206
2019;"POCO DAS TRINCHEIRAS (AL)";"AL";"POCO DAS TRINCHEIRAS";78;68;25;171
2019;"PORTO CALVO (AL)";"AL";"PORTO CALVO";209;128;77;414
2019;"PORTO DE PEDRAS (AL)";"AL";"PORTO DE PEDRAS";23;10;10;43
2019;"PORTO REAL DO COLEGIO (AL)";"AL";"PORTO REAL DO COLEGIO";37;37;28;102
2019;"QUEBRANGULO (AL)";"AL";"QUEBRANGULO";36;13;17;66
2019;"RIO LARGO (AL)";"AL";"RIO LARGO";466;207;220;893
2019;"ROTEIRO (AL)";"AL";"ROTEIRO";15;22;11;48
2019;"SANTA LUZIA DO NORTE (AL)";"AL";"SANTA LUZIA DO NORTE";23;4;47;74
2019;"SANTANA DO IPANEMA (AL)";"AL";"SANTANA DO IPANEMA";472;263;61;796
2019;"SANTANA DO MUNDAU (AL)";"AL";"SANTANA DO MUNDAU";74;33;16;123
2019;"SAO BRAS (AL)";"AL";"SAO BRAS";8;3;8;19
2019;"SAO JOSE DA LAJE (AL)";"AL";"SAO JOSE DA LAJE";139;73;74;286
2019;"SAO JOSE DA TAPERA (AL)";"AL";"SAO JOSE DA TAPERA";151;116;46;313
2019;"SAO LUIS DO QUITUNDE (AL)";"AL";"SAO LUIS DO QUITUNDE";242;35;241;518
2019;"SAO MIGUEL DOS CAMPOS (AL)";"AL";"SAO MIGUEL DOS CAMPOS";407;167;221;795
2019;"SAO MIGUEL DOS MILAGRES (AL)";"AL";"SAO MIGUEL DOS MILAGRES";29;3;7;39
2019;"SAO SEBASTIAO (AL)";"AL";"SAO SEBASTIAO";177;39;202;418
2019;"SATUBA (AL)";"AL";"SATUBA";80;29;26;135
2019;"SENADOR RUI PALMEIRA (AL)";"AL";"SENADOR RUI PALMEIRA";45;31;15;91
2019;"TANQUE D ARCA (AL)";"AL";"TANQUE D ARCA";17;16;9;42
2019;"TAQUARANA (AL)";"AL";"TAQUARANA";122;72;47;241
2019;"TEOTONIO VILELA (AL)";"AL";"TEOTONIO VILELA";193;77;228;498
2019;"TRAIPU (AL)";"AL";"TRAIPU";104;17;28;149
2019;"UNIAO DOS PALMARES (AL)";"AL";"UNIAO DOS PALMARES";539;308;254;1101
2019;"VICOSA (AL)";"AL";"VICOSA";139;31;54;224
2019;"ALVARAES (AM)";"AM";"ALVARAES";11;0;3;14
2019;"AMATURA (AM)";"AM";"AMATURA";6;1;1;8
2019;"ANAMA (AM)";"AM";"ANAMA";1;0;6;7
2019;"ANORI (AM)";"AM";"ANORI";15;3;3;21
2019;"APUI (AM)";"AM";"APUI";187;3;37;227
2019;"ATALAIA DO NORTE (AM)";"AM";"ATALAIA DO NORTE";3;1;1;5
2019;"AUTAZES (AM)";"AM";"AUTAZES";48;5;24;77
2019;"BARCELOS (AM)";"AM";"BARCELOS";14;2;0;16
2019;"BARREIRINHA (AM)";"AM";"BARREIRINHA";9;0;6;15
2019;"BENJAMIN CONSTANT (AM)";"AM";"BENJAMIN CONSTANT";21;6;5;32
2019;"BERURI (AM)";"AM";"BERURI";9;0;0;9
2019;"BOA VISTA DO RAMOS (AM)";"AM";"BOA VISTA DO RAMOS";3;0;1;4
2019;"BOCA DO ACRE (AM)";"AM";"BOCA DO ACRE";71;5;8;84
2019;"BORBA (AM)";"AM";"BORBA";23;0;6;29
2019;"CAAPIRANGA (AM)";"AM";"CAAPIRANGA";12;2;8;22
2019;"CANUTAMA (AM)";"AM";"CANUTAMA";6;0;1;7
2019;"CARAUARI (AM)";"AM";"CARAUARI";50;2;1;53
2019;"CAREIRO (AM)";"AM";"CAREIRO";99;54;91;244
2019;"CAREIRO DA VARZEA (AM)";"AM";"CAREIRO DA VARZEA";31;25;47;103
2019;"COARI (AM)";"AM";"COARI";137;8;17;162
2019;"CODAJAS (AM)";"AM";"CODAJAS";9;2;4;15
2019;"EIRUNEPE (AM)";"AM";"EIRUNEPE";41;5;8;54
2019;"ENVIRA (AM)";"AM";"ENVIRA";17;0;5;22
2019;"FONTE BOA (AM)";"AM";"FONTE BOA";21;0;0;21
2019;"GUAJARA (AM)";"AM";"GUAJARA";10;0;10;20
2019;"HUMAITA (AM)";"AM";"HUMAITA";323;12;44;379
2019;"IPIXUNA (AM)";"AM";"IPIXUNA";4;0;3;7
2019;"IRANDUBA (AM)";"AM";"IRANDUBA";351;53;147;551
2019;"ITACOATIARA (AM)";"AM";"ITACOATIARA";393;47;172;612
2019;"ITAMARATI (AM)";"AM";"ITAMARATI";12;0;0;12
2019;"ITAPIRANGA (AM)";"AM";"ITAPIRANGA";28;4;8;40
2019;"JAPURA (AM)";"AM";"JAPURA";6;0;4;10
2019;"JURUA (AM)";"AM";"JURUA";10;0;4;14
2019;"JUTAI (AM)";"AM";"JUTAI";6;0;0;6
2019;"LABREA (AM)";"AM";"LABREA";50;4;9;63
2019;"MANACAPURU (AM)";"AM";"MANACAPURU";385;91;125;601
2019;"MANAQUIRI (AM)";"AM";"MANAQUIRI";14;10;9;33
2019;"MANAUS (AM)";"AM";"MANAUS";16721;3046;8108;27875
2019;"MANICORE (AM)";"AM";"MANICORE";50;1;19;70
2019;"MARAA (AM)";"AM";"MARAA";6;1;0;7
2019;"MAUES (AM)";"AM";"MAUES";59;4;26;89
2019;"NHAMUNDA (AM)";"AM";"NHAMUNDA";9;0;8;17
2019;"NOVA OLINDA DO NORTE (AM)";"AM";"NOVA OLINDA DO NORTE";26;6;9;41
2019;"NOVO AIRAO (AM)";"AM";"NOVO AIRAO";32;10;12;54
2019;"NOVO ARIPUANA (AM)";"AM";"NOVO ARIPUANA";26;2;8;36
2019;"PARINTINS (AM)";"AM";"PARINTINS";169;9;29;207
2019;"PAUINI (AM)";"AM";"PAUINI";4;1;1;6
2019;"PRESIDENTE FIGUEIREDO (AM)";"AM";"PRESIDENTE FIGUEIREDO";344;55;85;484
2019;"RIO PRETO DA EVA (AM)";"AM";"RIO PRETO DA EVA";188;23;78;289
2019;"SANTA ISABEL DO RIO NEGRO (AM)";"AM";"SANTA ISABEL DO RIO NEGRO";11;4;3;18
2019;"SANTO ANTONIO DO ICA (AM)";"AM";"SANTO ANTONIO DO ICA";14;0;1;15
2019;"SAO GABRIEL DA CACHOEIRA (AM)";"AM";"SAO GABRIEL DA CACHOEIRA";110;15;38;163
2019;"SAO PAULO DE OLIVENCA (AM)";"AM";"SAO PAULO DE OLIVENCA";10;0;6;16
2019;"SAO SEBASTIAO DO UATUMA (AM)";"AM";"SAO SEBASTIAO DO UATUMA";6;0;1;7
2019;"SILVES (AM)";"AM";"SILVES";12;10;4;26
2019;"TABATINGA (AM)";"AM";"TABATINGA";85;11;7;103
2019;"TAPAUA (AM)";"AM";"TAPAUA";6;0;2;8
2019;"TEFE (AM)";"AM";"TEFE";79;17;22;118
2019;"TONANTINS (AM)";"AM";"TONANTINS";6;0;1;7
2019;"UARINI (AM)";"AM";"UARINI";11;0;2;13
2019;"URUCARA (AM)";"AM";"URUCARA";23;3;2;28
2019;"URUCURITUBA (AM)";"AM";"URUCURITUBA";9;0;2;11
2019;"AMAPA (AP)";"AP";"AMAPA";11;3;2;16
2019;"CALCOENE (AP)";"AP";"CALCOENE";16;2;4;22
2019;"CUTIAS (AP)";"AP";"CUTIAS";4;1;0;5
2019;"FERREIRA GOMES (AP)";"AP";"FERREIRA GOMES";12;4;5;21
2019;"ITAUBAL (AP)";"AP";"ITAUBAL";9;0;5;14
2019;"LARANJAL DO JARI (AP)";"AP";"LARANJAL DO JARI";106;10;23;139
2019;"MACAPA (AP)";"AP";"MACAPA";3128;352;894;4374
2019;"MAZAGAO (AP)";"AP";"MAZAGAO";43;14;22;79
2019;"OIAPOQUE (AP)";"AP";"OIAPOQUE";75;8;22;105
2019;"PEDRA BRANCA DO AMAPARI (AP)";"AP";"PEDRA BRANCA DO AMAPARI";32;9;27;68
2019;"PORTO GRANDE (AP)";"AP";"PORTO GRANDE";71;7;24;102
2019;"PRACUUBA (AP)";"AP";"PRACUUBA";6;1;2;9
2019;"SANTANA (AP)";"AP";"SANTANA";660;49;199;908
2019;"SERRA DO NAVIO (AP)";"AP";"SERRA DO NAVIO";16;4;5;25
2019;"TARTARUGALZINHO (AP)";"AP";"TARTARUGALZINHO";24;6;7;37
2019;"VITORIA DO JARI (AP)";"AP";"VITORIA DO JARI";14;1;4;19
2019;"ABAIRA (BA)";"BA";"ABAIRA";64;30;18;112
2019;"ABARE (BA)";"BA";"ABARE";52;43;25;120
2019;"ACAJUTIBA (BA)";"BA";"ACAJUTIBA";79;18;23;120
2019;"ADUSTINA (BA)";"BA";"ADUSTINA";17;5;11;33
2019;"AGUA FRIA (BA)";"BA";"AGUA FRIA";42;22;48;112
2019;"AIQUARA (BA)";"BA";"AIQUARA";8;6;6;20
2019;"ALAGOINHAS (BA)";"BA";"ALAGOINHAS";1513;398;684;2595
2019;"ALCOBACA (BA)";"BA";"ALCOBACA";65;12;37;114
2019;"ALMADINA (BA)";"BA";"ALMADINA";17;3;6;26
2019;"AMARGOSA (BA)";"BA";"AMARGOSA";353;91;102;546
2019;"AMELIA RODRIGUES (BA)";"BA";"AMELIA RODRIGUES";294;139;46;479
2019;"AMERICA DOURADA (BA)";"BA";"AMERICA DOURADA";47;21;17;85
2019;"ANAGE (BA)";"BA";"ANAGE";151;96;54;301
2019;"ANDARAI (BA)";"BA";"ANDARAI";53;23;28;104
2019;"ANDORINHA (BA)";"BA";"ANDORINHA";96;19;57;172
2019;"ANGICAL (BA)";"BA";"ANGICAL";52;24;41;117
2019;"ANGUERA (BA)";"BA";"ANGUERA";24;8;15;47
2019;"ANTAS (BA)";"BA";"ANTAS";36;10;13;59
2019;"ANTONIO CARDOSO (BA)";"BA";"ANTONIO CARDOSO";13;32;23;68
2019;"ANTONIO GONCALVES (BA)";"BA";"ANTONIO GONCALVES";27;19;14;60
2019;"APORA (BA)";"BA";"APORA";57;40;46;143
2019;"APUAREMA (BA)";"BA";"APUAREMA";32;7;12;51
2019;"ARACAS (BA)";"BA";"ARACAS";96;31;38;165
2019;"ARACATU (BA)";"BA";"ARACATU";144;41;38;223
2019;"ARACI (BA)";"BA";"ARACI";316;31;82;429
2019;"ARAMARI (BA)";"BA";"ARAMARI";42;7;20;69
2019;"ARATACA (BA)";"BA";"ARATACA";38;2;5;45
2019;"ARATUIPE (BA)";"BA";"ARATUIPE";47;12;20;79
2019;"AURELINO LEAL (BA)";"BA";"AURELINO LEAL";53;10;16;79
2019;"BAIANOPOLIS (BA)";"BA";"BAIANOPOLIS";73;10;46;129
2019;"BAIXA GRANDE (BA)";"BA";"BAIXA GRANDE";123;87;61;271
2019;"BANZAE (BA)";"BA";"BANZAE";28;7;30;65
2019;"BARRA (BA)";"BA";"BARRA";107;42;47;196
2019;"BARRA DA ESTIVA (BA)";"BA";"BARRA DA ESTIVA";322;104;81;507
2019;"BARRA DO CHOCA (BA)";"BA";"BARRA DO CHOCA";164;248;46;458
2019;"BARRA DO MENDES (BA)";"BA";"BARRA DO MENDES";80;33;31;144
2019;"BARRA DO ROCHA (BA)";"BA";"BARRA DO ROCHA";15;7;9;31
2019;"BARREIRAS (BA)";"BA";"BARREIRAS";2567;249;509;3325
2019;"BARRO ALTO (BA)";"BA";"BARRO ALTO";62;21;30;113
2019;"BARRO PRETO (BA)";"BA";"BARRO PRETO";20;2;13;35
2019;"BARROCAS (BA)";"BA";"BARROCAS";125;15;33;173
2019;"BELMONTE (BA)";"BA";"BELMONTE";63;10;42;115
2019;"BELO CAMPO (BA)";"BA";"BELO CAMPO";152;34;49;235
2019;"BIRITINGA (BA)";"BA";"BIRITINGA";39;19;39;97
2019;"BOA NOVA (BA)";"BA";"BOA NOVA";43;66;28;137
2019;"BOA VISTA DO TUPIM (BA)";"BA";"BOA VISTA DO TUPIM";81;23;27;131
2019;"BOM JESUS DA LAPA (BA)";"BA";"BOM JESUS DA LAPA";544;90;161;795
2019;"BOM JESUS DA SERRA (BA)";"BA";"BOM JESUS DA SERRA";47;71;25;143
2019;"BONINAL (BA)";"BA";"BONINAL";112;37;44;193
2019;"BONITO (BA)";"BA";"BONITO";124;21;28;173
2019;"BOQUIRA (BA)";"BA";"BOQUIRA";151;18;77;246
2019;"BOTUPORA (BA)";"BA";"BOTUPORA";73;8;54;135
2019;"BREJOES (BA)";"BA";"BREJOES";109;13;43;165
2019;"BREJOLANDIA (BA)";"BA";"BREJOLANDIA";37;8;21;66
2019;"BROTAS DE MACAUBAS (BA)";"BA";"BROTAS DE MACAUBAS";40;68;27;135
2019;"BRUMADO (BA)";"BA";"BRUMADO";1889;293;373;2555
2019;"BUERAREMA (BA)";"BA";"BUERAREMA";157;13;56;226
2019;"BURITIRAMA (BA)";"BA";"BURITIRAMA";47;18;27;92
2019;"CAATIBA (BA)";"BA";"CAATIBA";20;8;3;31
2019;"CABACEIRAS DO PARAGUACU (BA)";"BA";"CABACEIRAS DO PARAGUACU";108;29;73;210
2019;"CACHOEIRA (BA)";"BA";"CACHOEIRA";135;127;92;354
2019;"CACULE (BA)";"BA";"CACULE";437;40;56;533
2019;"CAEM (BA)";"BA";"CAEM";34;29;22;85
2019;"CAETANOS (BA)";"BA";"CAETANOS";101;15;20;136
2019;"CAETITE (BA)";"BA";"CAETITE";652;176;177;1005
2019;"CAFARNAUM (BA)";"BA";"CAFARNAUM";89;12;55;156
2019;"CAIRU (BA)";"BA";"CAIRU";23;19;13;55
2019;"CALDEIRAO GRANDE (BA)";"BA";"CALDEIRAO GRANDE";38;14;22;74
2019;"CAMACAN (BA)";"BA";"CAMACAN";200;30;52;282
2019;"CAMACARI (BA)";"BA";"CAMACARI";2552;552;1165;4269
2019;"CAMAMU (BA)";"BA";"CAMAMU";200;54;41;295
2019;"CAMPO ALEGRE DE LOURDES (BA)";"BA";"CAMPO ALEGRE DE LOURDES";60;9;18;87
2019;"CAMPO FORMOSO (BA)";"BA";"CAMPO FORMOSO";366;44;131;541
2019;"CANAPOLIS (BA)";"BA";"CANAPOLIS";25;35;14;74
2019;"CANARANA (BA)";"BA";"CANARANA";210;39;51;300
2019;"CANAVIEIRAS (BA)";"BA";"CANAVIEIRAS";115;19;21;155
2019;"CANDEAL (BA)";"BA";"CANDEAL";34;30;25;89
2019;"CANDEIAS (BA)";"BA";"CANDEIAS";882;397;412;1691
2019;"CANDIBA (BA)";"BA";"CANDIBA";86;1;25;112
2019;"CANDIDO SALES (BA)";"BA";"CANDIDO SALES";335;67;55;457
2019;"CANSANCAO (BA)";"BA";"CANSANCAO";227;69;92;388
2019;"CANUDOS (BA)";"BA";"CANUDOS";68;12;51;131
2019;"CAPELA DO ALTO ALEGRE (BA)";"BA";"CAPELA DO ALTO ALEGRE";89;32;30;151
2019;"CAPIM GROSSO (BA)";"BA";"CAPIM GROSSO";703;103;127;933
2019;"CARAIBAS (BA)";"BA";"CARAIBAS";79;46;27;152
2019;"CARAVELAS (BA)";"BA";"CARAVELAS";47;20;39;106
2019;"CARDEAL DA SILVA (BA)";"BA";"CARDEAL DA SILVA";33;13;26;72
2019;"CARINHANHA (BA)";"BA";"CARINHANHA";126;59;55;240
2019;"CASA NOVA (BA)";"BA";"CASA NOVA";389;233;233;855
2019;"CASTRO ALVES (BA)";"BA";"CASTRO ALVES";179;34;88;301
2019;"CATOLANDIA (BA)";"BA";"CATOLANDIA";11;3;12;26
2019;"CATU (BA)";"BA";"CATU";443;146;141;730
2019;"CATURAMA (BA)";"BA";"CATURAMA";55;11;21;87
2019;"CENTRAL (BA)";"BA";"CENTRAL";110;34;17;161
2019;"CHORROCHO (BA)";"BA";"CHORROCHO";51;7;16;74
2019;"CICERO DANTAS (BA)";"BA";"CICERO DANTAS";145;35;71;251
2019;"CIPO (BA)";"BA";"CIPO";55;13;25;93
2019;"COARACI (BA)";"BA";"COARACI";131;10;36;177
2019;"COCOS (BA)";"BA";"COCOS";113;5;47;165
2019;"CONCEICAO DA FEIRA (BA)";"BA";"CONCEICAO DA FEIRA";264;135;21;420
2019;"CONCEICAO DO ALMEIDA (BA)";"BA";"CONCEICAO DO ALMEIDA";139;46;43;228
2019;"CONCEICAO DO COITE (BA)";"BA";"CONCEICAO DO COITE";667;169;165;1001
2019;"CONCEICAO DO JACUIPE (BA)";"BA";"CONCEICAO DO JACUIPE";417;168;37;622
2019;"CONDE (BA)";"BA";"CONDE";62;27;29;118
2019;"CONDEUBA (BA)";"BA";"CONDEUBA";129;58;81;268
2019;"CONTENDAS DO SINCORA (BA)";"BA";"CONTENDAS DO SINCORA";39;11;12;62
2019;"CORACAO DE MARIA (BA)";"BA";"CORACAO DE MARIA";137;61;76;274
2019;"CORDEIROS (BA)";"BA";"CORDEIROS";43;18;23;84
2019;"CORIBE (BA)";"BA";"CORIBE";55;24;32;111
2019;"CORONEL JOAO SA (BA)";"BA";"CORONEL JOAO SA";12;2;26;40
2019;"CORRENTINA (BA)";"BA";"CORRENTINA";172;43;101;316
2019;"COTEGIPE (BA)";"BA";"COTEGIPE";66;24;29;119
2019;"CRAVOLANDIA (BA)";"BA";"CRAVOLANDIA";26;10;11;47
2019;"CRISOPOLIS (BA)";"BA";"CRISOPOLIS";76;40;52;168
2019;"CRISTOPOLIS (BA)";"BA";"CRISTOPOLIS";74;16;39;129
2019;"CRUZ DAS ALMAS (BA)";"BA";"CRUZ DAS ALMAS";1208;403;119;1730
2019;"CURACA (BA)";"BA";"CURACA";110;58;53;221
2019;"DARIO MEIRA (BA)";"BA";"DARIO MEIRA";22;25;5;52
2019;"DIAS D AVILA (BA)";"BA";"DIAS D AVILA";743;167;446;1356
2019;"DOM BASILIO (BA)";"BA";"DOM BASILIO";375;38;42;455
2019;"DOM MACEDO COSTA (BA)";"BA";"DOM MACEDO COSTA";15;27;10;52
2019;"ELISIO MEDRADO (BA)";"BA";"ELISIO MEDRADO";45;32;19;96
2019;"ENCRUZILHADA (BA)";"BA";"ENCRUZILHADA";81;40;20;141
2019;"ENTRE RIOS (BA)";"BA";"ENTRE RIOS";288;111;154;553
2019;"ERICO CARDOSO (BA)";"BA";"ERICO CARDOSO";47;21;30;98
2019;"ESPLANADA (BA)";"BA";"ESPLANADA";150;47;117;314
2019;"EUCLIDES DA CUNHA (BA)";"BA";"EUCLIDES DA CUNHA";339;106;292;737
2019;"EUNAPOLIS (BA)";"BA";"EUNAPOLIS";1520;116;535;2171
2019;"FATIMA (BA)";"BA";"FATIMA";22;11;26;59
2019;"FEIRA DA MATA (BA)";"BA";"FEIRA DA MATA";21;11;14;46
2019;"FEIRA DE SANTANA (BA)";"BA";"FEIRA DE SANTANA";9389;1560;1467;12416
2019;"FILADELFIA (BA)";"BA";"FILADELFIA";169;18;35;222
2019;"FIRMINO ALVES (BA)";"BA";"FIRMINO ALVES";21;2;4;27
2019;"FLORESTA AZUL (BA)";"BA";"FLORESTA AZUL";48;7;3;58
2019;"FORMOSA DO RIO PRETO (BA)";"BA";"FORMOSA DO RIO PRETO";171;8;37;216
2019;"GANDU (BA)";"BA";"GANDU";343;227;39;609
2019;"GAVIAO (BA)";"BA";"GAVIAO";27;18;10;55
2019;"GENTIO DO OURO (BA)";"BA";"GENTIO DO OURO";31;20;11;62
2019;"GLORIA (BA)";"BA";"GLORIA";71;26;52;149
2019;"GONGOGI (BA)";"BA";"GONGOGI";18;8;5;31
2019;"GOVERNADOR MANGABEIRA (BA)";"BA";"GOVERNADOR MANGABEIRA";289;54;55;398
2019;"GUAJERU (BA)";"BA";"GUAJERU";35;34;18;87
2019;"GUANAMBI (BA)";"BA";"GUANAMBI";1416;118;254;1788
2019;"GUARATINGA (BA)";"BA";"GUARATINGA";92;12;42;146
2019;"HELIOPOLIS (BA)";"BA";"HELIOPOLIS";25;10;23;58
2019;"IACU (BA)";"BA";"IACU";173;38;48;259
2019;"IBIASSUCE (BA)";"BA";"IBIASSUCE";100;25;26;151
2019;"IBICARAI (BA)";"BA";"IBICARAI";149;26;38;213
2019;"IBICOARA (BA)";"BA";"IBICOARA";296;117;93;506
2019;"IBICUI (BA)";"BA";"IBICUI";61;29;19;109
2019;"IBIPEBA (BA)";"BA";"IBIPEBA";63;35;23;121
2019;"IBIPITANGA (BA)";"BA";"IBIPITANGA";108;40;50;198
2019;"IBIQUERA (BA)";"BA";"IBIQUERA";10;8;6;24
2019;"IBIRAPITANGA (BA)";"BA";"IBIRAPITANGA";73;70;26;169
2019;"IBIRAPUA (BA)";"BA";"IBIRAPUA";111;7;15;133
2019;"IBIRATAIA (BA)";"BA";"IBIRATAIA";97;59;23;179
2019;"IBITIARA (BA)";"BA";"IBITIARA";131;72;62;265
2019;"IBITITA (BA)";"BA";"IBITITA";64;18;30;112
2019;"IBOTIRAMA (BA)";"BA";"IBOTIRAMA";310;93;43;446
2019;"ICHU (BA)";"BA";"ICHU";45;26;19;90
2019;"IGAPORA (BA)";"BA";"IGAPORA";120;51;50;221
2019;"IGRAPIUNA (BA)";"BA";"IGRAPIUNA";54;39;27;120
2019;"IGUAI (BA)";"BA";"IGUAI";73;54;59;186
2019;"ILHEUS (BA)";"BA";"ILHEUS";899;217;321;1437
2019;"INHAMBUPE (BA)";"BA";"INHAMBUPE";234;112;122;468
2019;"IPECAETA (BA)";"BA";"IPECAETA";32;13;55;100
2019;"IPIAU (BA)";"BA";"IPIAU";452;75;96;623
2019;"IPIRA (BA)";"BA";"IPIRA";499;86;163;748
2019;"IPUPIARA (BA)";"BA";"IPUPIARA";92;34;9;135
2019;"IRAJUBA (BA)";"BA";"IRAJUBA";47;8;23;78
2019;"IRAMAIA (BA)";"BA";"IRAMAIA";51;17;23;91
2019;"IRAQUARA (BA)";"BA";"IRAQUARA";160;47;57;264
2019;"IRARA (BA)";"BA";"IRARA";173;36;90;299
2019;"IRECE (BA)";"BA";"IRECE";1156;152;309;1617
2019;"ITABELA (BA)";"BA";"ITABELA";335;26;136;497
2019;"ITABERABA (BA)";"BA";"ITABERABA";639;129;116;884
2019;"ITABUNA (BA)";"BA";"ITABUNA";2063;111;828;3002
2019;"ITACARE (BA)";"BA";"ITACARE";53;47;12;112
2019;"ITAETE (BA)";"BA";"ITAETE";85;30;30;145
2019;"ITAGI (BA)";"BA";"ITAGI";48;4;9;61
2019;"ITAGIBA (BA)";"BA";"ITAGIBA";42;67;23;132
2019;"ITAGIMIRIM (BA)";"BA";"ITAGIMIRIM";56;6;10;72
2019;"ITAGUACU DA BAHIA (BA)";"BA";"ITAGUACU DA BAHIA";36;16;9;61
2019;"ITAJU DO COLONIA (BA)";"BA";"ITAJU DO COLONIA";27;3;7;37
2019;"ITAJUIPE (BA)";"BA";"ITAJUIPE";86;36;24;146
2019;"ITAMARAJU (BA)";"BA";"ITAMARAJU";511;67;182;760
2019;"ITAMARI (BA)";"BA";"ITAMARI";50;13;2;65
2019;"ITAMBE (BA)";"BA";"ITAMBE";85;76;14;175
2019;"ITANAGRA (BA)";"BA";"ITANAGRA";30;2;12;44
2019;"ITANHEM (BA)";"BA";"ITANHEM";74;12;32;118
2019;"ITAPARICA (BA)";"BA";"ITAPARICA";57;37;37;131
2019;"ITAPE (BA)";"BA";"ITAPE";37;1;5;43
2019;"ITAPEBI (BA)";"BA";"ITAPEBI";66;4;8;78
2019;"ITAPETINGA (BA)";"BA";"ITAPETINGA";531;80;122;733
2019;"ITAPICURU (BA)";"BA";"ITAPICURU";66;19;70;155
2019;"ITAPITANGA (BA)";"BA";"ITAPITANGA";13;6;5;24
2019;"ITAQUARA (BA)";"BA";"ITAQUARA";45;8;16;69
2019;"ITARANTIM (BA)";"BA";"ITARANTIM";116;19;8;143
2019;"ITATIM (BA)";"BA";"ITATIM";261;38;38;337
2019;"ITIRUCU (BA)";"BA";"ITIRUCU";133;22;25;180
2019;"ITIUBA (BA)";"BA";"ITIUBA";161;58;96;315
2019;"ITORORO (BA)";"BA";"ITORORO";105;36;28;169
2019;"ITUACU (BA)";"BA";"ITUACU";205;83;67;355
2019;"ITUBERA (BA)";"BA";"ITUBERA";166;28;46;240
2019;"IUIU (BA)";"BA";"IUIU";55;17;22;94
2019;"JABORANDI (BA)";"BA";"JABORANDI";104;1;34;139
2019;"JACARACI (BA)";"BA";"JACARACI";59;22;39;120
2019;"JACOBINA (BA)";"BA";"JACOBINA";856;172;298;1326
2019;"JAGUAQUARA (BA)";"BA";"JAGUAQUARA";697;58;90;845
2019;"JAGUARARI (BA)";"BA";"JAGUARARI";330;110;102;542
2019;"JAGUARIPE (BA)";"BA";"JAGUARIPE";56;41;42;139
2019;"JANDAIRA (BA)";"BA";"JANDAIRA";26;5;18;49
2019;"JEQUIE (BA)";"BA";"JEQUIE";2022;202;440;2664
2019;"JEREMOABO (BA)";"BA";"JEREMOABO";101;36;66;203
2019;"JIQUIRICA (BA)";"BA";"JIQUIRICA";63;29;26;118
2019;"JITAUNA (BA)";"BA";"JITAUNA";42;16;24;82
2019;"JOAO DOURADO (BA)";"BA";"JOAO DOURADO";184;52;56;292
2019;"JUAZEIRO (BA)";"BA";"JUAZEIRO";2946;1074;1152;5172
2019;"JUCURUCU (BA)";"BA";"JUCURUCU";20;3;8;31
2019;"JUSSARA (BA)";"BA";"JUSSARA";76;26;24;126
2019;"JUSSARI (BA)";"BA";"JUSSARI";17;2;5;24
2019;"JUSSIAPE (BA)";"BA";"JUSSIAPE";68;38;30;136
2019;"LAFAIETE COUTINHO (BA)";"BA";"LAFAIETE COUTINHO";27;4;10;41
2019;"LAGEDO DO TABOCAL (BA)";"BA";"LAGEDO DO TABOCAL";54;10;14;78
2019;"LAGOA REAL (BA)";"BA";"LAGOA REAL";101;33;41;175
2019;"LAJE (BA)";"BA";"LAJE";198;114;57;369
2019;"LAJEDAO (BA)";"BA";"LAJEDAO";9;1;14;24
2019;"LAJEDINHO (BA)";"BA";"LAJEDINHO";12;8;17;37
2019;"LAMARAO (BA)";"BA";"LAMARAO";14;17;10;41
2019;"LAPAO (BA)";"BA";"LAPAO";185;24;59;268
2019;"LAURO DE FREITAS (BA)";"BA";"LAURO DE FREITAS";2515;483;772;3770
2019;"LENCOIS (BA)";"BA";"LENCOIS";50;27;7;84
2019;"LICINIO DE ALMEIDA (BA)";"BA";"LICINIO DE ALMEIDA";132;27;23;182
2019;"LIVRAMENTO DE NOSSA SENHORA (BA)";"BA";"LIVRAMENTO DE NOSSA SENHORA";581;82;160;823
2019;"LUIS EDUARDO MAGALHAES (BA)";"BA";"LUIS EDUARDO MAGALHAES";2066;150;298;2514
2019;"MACAJUBA (BA)";"BA";"MACAJUBA";42;33;40;115
2019;"MACARANI (BA)";"BA";"MACARANI";97;14;21;132
2019;"MACAUBAS (BA)";"BA";"MACAUBAS";295;55;279;629
2019;"MACURURE (BA)";"BA";"MACURURE";28;5;15;48
2019;"MADRE DE DEUS (BA)";"BA";"MADRE DE DEUS";108;55;34;197
2019;"MAETINGA (BA)";"BA";"MAETINGA";57;15;21;93
2019;"MAIQUINIQUE (BA)";"BA";"MAIQUINIQUE";56;12;19;87
2019;"MAIRI (BA)";"BA";"MAIRI";93;34;48;175
2019;"MALHADA (BA)";"BA";"MALHADA";52;29;27;108
2019;"MALHADA DE PEDRAS (BA)";"BA";"MALHADA DE PEDRAS";110;54;42;206
2019;"MANOEL VITORINO (BA)";"BA";"MANOEL VITORINO";78;26;26;130
2019;"MANSIDAO (BA)";"BA";"MANSIDAO";27;0;14;41
2019;"MARACAS (BA)";"BA";"MARACAS";297;44;75;416
2019;"MARAGOGIPE (BA)";"BA";"MARAGOGIPE";183;57;83;323
2019;"MARAU (BA)";"BA";"MARAU";49;8;13;70
2019;"MARCIONILIO SOUZA (BA)";"BA";"MARCIONILIO SOUZA";49;26;19;94
2019;"MASCOTE (BA)";"BA";"MASCOTE";51;9;13;73
2019;"MATA DE SAO JOAO (BA)";"BA";"MATA DE SAO JOAO";316;110;170;596
2019;"MATINA (BA)";"BA";"MATINA";31;18;38;87
2019;"MEDEIROS NETO (BA)";"BA";"MEDEIROS NETO";114;27;58;199
2019;"MIGUEL CALMON (BA)";"BA";"MIGUEL CALMON";99;56;50;205
2019;"MILAGRES (BA)";"BA";"MILAGRES";185;16;21;222
2019;"MIRANGABA (BA)";"BA";"MIRANGABA";77;21;58;156
2019;"MIRANTE (BA)";"BA";"MIRANTE";78;40;23;141
2019;"MONTE SANTO (BA)";"BA";"MONTE SANTO";329;105;217;651
2019;"MORPARA (BA)";"BA";"MORPARA";23;27;10;60
2019;"MORRO DO CHAPEU (BA)";"BA";"MORRO DO CHAPEU";243;74;40;357
2019;"MORTUGABA (BA)";"BA";"MORTUGABA";83;9;24;116
2019;"MUCUGE (BA)";"BA";"MUCUGE";118;32;75;225
2019;"MUCURI (BA)";"BA";"MUCURI";150;43;102;295
2019;"MULUNGU DO MORRO (BA)";"BA";"MULUNGU DO MORRO";101;11;21;133
2019;"MUNDO NOVO (BA)";"BA";"MUNDO NOVO";75;31;34;140
2019;"MUNIZ FERREIRA (BA)";"BA";"MUNIZ FERREIRA";61;45;13;119
2019;"MUQUEM DO SAO FRANCISCO (BA)";"BA";"MUQUEM DO SAO FRANCISCO";46;23;34;103
2019;"MURITIBA (BA)";"BA";"MURITIBA";154;55;45;254
2019;"MUTUIPE (BA)";"BA";"MUTUIPE";175;108;72;355
2019;"NAZARE (BA)";"BA";"NAZARE";277;78;59;414
2019;"NILO PECANHA (BA)";"BA";"NILO PECANHA";48;46;30;124
2019;"NORDESTINA (BA)";"BA";"NORDESTINA";91;19;34;144
2019;"NOVA CANAA (BA)";"BA";"NOVA CANAA";77;29;20;126
2019;"NOVA FATIMA (BA)";"BA";"NOVA FATIMA";91;17;14;122
2019;"NOVA IBIA (BA)";"BA";"NOVA IBIA";23;15;7;45
2019;"NOVA ITARANA (BA)";"BA";"NOVA ITARANA";37;11;9;57
2019;"NOVA REDENCAO (BA)";"BA";"NOVA REDENCAO";24;13;10;47
2019;"NOVA SOURE (BA)";"BA";"NOVA SOURE";83;15;45;143
2019;"NOVA VICOSA (BA)";"BA";"NOVA VICOSA";177;46;76;299
2019;"NOVO HORIZONTE (BA)";"BA";"NOVO HORIZONTE";69;23;26;118
2019;"NOVO TRIUNFO (BA)";"BA";"NOVO TRIUNFO";20;5;4;29
2019;"OLINDINA (BA)";"BA";"OLINDINA";109;51;73;233
2019;"OLIVEIRA DOS BREJINHOS (BA)";"BA";"OLIVEIRA DOS BREJINHOS";150;69;63;282
2019;"OURICANGAS (BA)";"BA";"OURICANGAS";29;8;26;63
2019;"OUROLANDIA (BA)";"BA";"OUROLANDIA";98;36;17;151
2019;"PALMAS DE MONTE ALTO (BA)";"BA";"PALMAS DE MONTE ALTO";86;16;57;159
2019;"PALMEIRAS (BA)";"BA";"PALMEIRAS";54;39;11;104
2019;"PARAMIRIM (BA)";"BA";"PARAMIRIM";241;56;97;394
2019;"PARATINGA (BA)";"BA";"PARATINGA";88;49;63;200
2019;"PARIPIRANGA (BA)";"BA";"PARIPIRANGA";72;8;48;128
2019;"PAU BRASIL (BA)";"BA";"PAU BRASIL";53;16;43;112
2019;"PAULO AFONSO (BA)";"BA";"PAULO AFONSO";845;317;411;1573
2019;"PE DE SERRA (BA)";"BA";"PE DE SERRA";89;23;36;148
2019;"PEDRAO (BA)";"BA";"PEDRAO";12;7;9;28
2019;"PEDRO ALEXANDRE (BA)";"BA";"PEDRO ALEXANDRE";6;6;13;25
2019;"PIATA (BA)";"BA";"PIATA";110;60;42;212
2019;"PILAO ARCADO (BA)";"BA";"PILAO ARCADO";49;47;8;104
2019;"PINDAI (BA)";"BA";"PINDAI";61;32;52;145
2019;"PINDOBACU (BA)";"BA";"PINDOBACU";68;55;36;159
2019;"PINTADAS (BA)";"BA";"PINTADAS";65;29;59;153
2019;"PIRAI DO NORTE (BA)";"BA";"PIRAI DO NORTE";33;13;3;49
2019;"PIRIPA (BA)";"BA";"PIRIPA";101;31;30;162
2019;"PIRITIBA (BA)";"BA";"PIRITIBA";95;33;28;156
2019;"PLANALTINO (BA)";"BA";"PLANALTINO";68;12;34;114
2019;"PLANALTO (BA)";"BA";"PLANALTO";145;74;72;291
2019;"POCOES (BA)";"BA";"POCOES";502;393;107;1002
2019;"POJUCA (BA)";"BA";"POJUCA";426;128;84;638
2019;"PONTO NOVO (BA)";"BA";"PONTO NOVO";98;21;42;161
2019;"PORTO SEGURO (BA)";"BA";"PORTO SEGURO";877;394;415;1686
2019;"POTIRAGUA (BA)";"BA";"POTIRAGUA";50;11;7;68
2019;"PRADO (BA)";"BA";"PRADO";115;24;52;191
2019;"PRESIDENTE DUTRA (BA)";"BA";"PRESIDENTE DUTRA";88;12;14;114
2019;"PRESIDENTE JANIO QUADROS (BA)";"BA";"PRESIDENTE JANIO QUADROS";64;41;30;135
2019;"PRESIDENTE TANCREDO NEVES (BA)";"BA";"PRESIDENTE TANCREDO NEVES";358;247;42;647
2019;"QUEIMADAS (BA)";"BA";"QUEIMADAS";150;41;78;269
2019;"QUIJINGUE (BA)";"BA";"QUIJINGUE";77;30;93;200
2019;"QUIXABEIRA (BA)";"BA";"QUIXABEIRA";71;20;20;111
2019;"RAFAEL JAMBEIRO (BA)";"BA";"RAFAEL JAMBEIRO";88;41;84;213
2019;"REMANSO (BA)";"BA";"REMANSO";175;80;29;284
2019;"RETIROLANDIA (BA)";"BA";"RETIROLANDIA";120;18;26;164
2019;"RIACHAO DAS NEVES (BA)";"BA";"RIACHAO DAS NEVES";79;33;35;147
2019;"RIACHAO DO JACUIPE (BA)";"BA";"RIACHAO DO JACUIPE";396;58;43;497
2019;"RIACHO DE SANTANA (BA)";"BA";"RIACHO DE SANTANA";314;37;123;474
2019;"RIBEIRA DO AMPARO (BA)";"BA";"RIBEIRA DO AMPARO";15;23;48;86
2019;"RIBEIRA DO POMBAL (BA)";"BA";"RIBEIRA DO POMBAL";331;115;151;597
2019;"RIBEIRAO DO LARGO (BA)";"BA";"RIBEIRAO DO LARGO";30;18;9;57
2019;"RIO DE CONTAS (BA)";"BA";"RIO DE CONTAS";82;43;29;154
2019;"RIO DO ANTONIO (BA)";"BA";"RIO DO ANTONIO";224;30;26;280
2019;"RIO DO PIRES (BA)";"BA";"RIO DO PIRES";113;18;24;155
2019;"RIO REAL (BA)";"BA";"RIO REAL";248;32;82;362
2019;"RODELAS (BA)";"BA";"RODELAS";41;11;7;59
2019;"RUY BARBOSA (BA)";"BA";"RUY BARBOSA";168;81;37;286
2019;"SALINAS DA MARGARIDA (BA)";"BA";"SALINAS DA MARGARIDA";27;18;16;61
2019;"SALVADOR (BA)";"BA";"SALVADOR";18206;4212;8948;31366
2019;"SANTA BARBARA (BA)";"BA";"SANTA BARBARA";97;23;38;158
2019;"SANTA BRIGIDA (BA)";"BA";"SANTA BRIGIDA";29;40;28;97
2019;"SANTA CRUZ CABRALIA (BA)";"BA";"SANTA CRUZ CABRALIA";120;56;42;218
2019;"SANTA CRUZ DA VITORIA (BA)";"BA";"SANTA CRUZ DA VITORIA";17;5;5;27
2019;"SANTA INES (BA)";"BA";"SANTA INES";42;21;6;69
2019;"SANTA LUZIA (BA)";"BA";"SANTA LUZIA";42;5;6;53
2019;"SANTA MARIA DA VITORIA (BA)";"BA";"SANTA MARIA DA VITORIA";460;67;100;627
2019;"SANTA RITA DE CASSIA (BA)";"BA";"SANTA RITA DE CASSIA";68;14;20;102
2019;"SANTA TERESINHA (BA)";"BA";"SANTA TERESINHA";44;20;43;107
2019;"SANTALUZ (BA)";"BA";"SANTALUZ";378;51;73;502
2019;"SANTANA (BA)";"BA";"SANTANA";184;26;75;285
2019;"SANTANOPOLIS (BA)";"BA";"SANTANOPOLIS";31;13;17;61
2019;"SANTO AMARO (BA)";"BA";"SANTO AMARO";281;156;158;595
2019;"SANTO ANTONIO DE JESUS (BA)";"BA";"SANTO ANTONIO DE JESUS";2466;310;252;3028
2019;"SANTO ESTEVAO (BA)";"BA";"SANTO ESTEVAO";342;117;97;556
2019;"SAO DESIDERIO (BA)";"BA";"SAO DESIDERIO";369;52;137;558
2019;"SAO DOMINGOS (BA)";"BA";"SAO DOMINGOS";59;4;10;73
2019;"SAO FELIPE (BA)";"BA";"SAO FELIPE";325;55;69;449
2019;"SAO FELIX (BA)";"BA";"SAO FELIX";58;24;19;101
2019;"SAO FELIX DO CORIBE (BA)";"BA";"SAO FELIX DO CORIBE";179;25;37;241
2019;"SAO FRANCISCO DO CONDE (BA)";"BA";"SAO FRANCISCO DO CONDE";162;104;97;363
2019;"SAO GABRIEL (BA)";"BA";"SAO GABRIEL";52;14;38;104
2019;"SAO GONCALO DOS CAMPOS (BA)";"BA";"SAO GONCALO DOS CAMPOS";328;282;69;679
2019;"SAO JOSE DA VITORIA (BA)";"BA";"SAO JOSE DA VITORIA";19;0;8;27
2019;"SAO JOSE DO JACUIPE (BA)";"BA";"SAO JOSE DO JACUIPE";109;28;10;147
2019;"SAO MIGUEL DAS MATAS (BA)";"BA";"SAO MIGUEL DAS MATAS";72;9;25;106
2019;"SAO SEBASTIAO DO PASSE (BA)";"BA";"SAO SEBASTIAO DO PASSE";256;245;166;667
2019;"SAPEACU (BA)";"BA";"SAPEACU";123;77;52;252
2019;"SATIRO DIAS (BA)";"BA";"SATIRO DIAS";27;20;21;68
2019;"SAUBARA (BA)";"BA";"SAUBARA";39;41;3;83
2019;"SAUDE (BA)";"BA";"SAUDE";54;34;24;112
2019;"SEABRA (BA)";"BA";"SEABRA";610;174;204;988
2019;"SEBASTIAO LARANJEIRAS (BA)";"BA";"SEBASTIAO LARANJEIRAS";38;6;31;75
2019;"SENHOR DO BONFIM (BA)";"BA";"SENHOR DO BONFIM";727;173;252;1152
2019;"SENTO SE (BA)";"BA";"SENTO SE";55;12;28;95
2019;"SERRA DO RAMALHO (BA)";"BA";"SERRA DO RAMALHO";130;40;71;241
2019;"SERRA DOURADA (BA)";"BA";"SERRA DOURADA";83;20;40;143
2019;"SERRA PRETA (BA)";"BA";"SERRA PRETA";60;24;74;158
2019;"SERRINHA (BA)";"BA";"SERRINHA";838;170;263;1271
2019;"SERROLANDIA (BA)";"BA";"SERROLANDIA";81;61;26;168
2019;"SIMOES FILHO (BA)";"BA";"SIMOES FILHO";2630;604;867;4101
2019;"SITIO DO MATO (BA)";"BA";"SITIO DO MATO";39;13;29;81
2019;"SITIO DO QUINTO (BA)";"BA";"SITIO DO QUINTO";20;6;13;39
2019;"SOBRADINHO (BA)";"BA";"SOBRADINHO";114;41;32;187
2019;"SOUTO SOARES (BA)";"BA";"SOUTO SOARES";133;20;37;190
2019;"TABOCAS DO BREJO VELHO (BA)";"BA";"TABOCAS DO BREJO VELHO";47;6;15;68
2019;"TANHACU (BA)";"BA";"TANHACU";321;85;65;471
2019;"TANQUE NOVO (BA)";"BA";"TANQUE NOVO";297;24;63;384
2019;"TANQUINHO (BA)";"BA";"TANQUINHO";32;29;16;77
2019;"TAPEROA (BA)";"BA";"TAPEROA";167;38;28;233
2019;"TAPIRAMUTA (BA)";"BA";"TAPIRAMUTA";64;15;23;102
2019;"TEIXEIRA DE FREITAS (BA)";"BA";"TEIXEIRA DE FREITAS";1717;139;416;2272
2019;"TEODORO SAMPAIO (BA)";"BA";"TEODORO SAMPAIO";15;18;16;49
2019;"TEOFILANDIA (BA)";"BA";"TEOFILANDIA";138;60;46;244
2019;"TEOLANDIA (BA)";"BA";"TEOLANDIA";178;54;23;255
2019;"TERRA NOVA (BA)";"BA";"TERRA NOVA";28;20;21;69
2019;"TREMEDAL (BA)";"BA";"TREMEDAL";67;34;58;159
2019;"TUCANO (BA)";"BA";"TUCANO";352;63;130;545
2019;"UAUA (BA)";"BA";"UAUA";263;50;45;358
2019;"UBAIRA (BA)";"BA";"UBAIRA";139;43;55;237
2019;"UBAITABA (BA)";"BA";"UBAITABA";223;26;27;276
2019;"UBATA (BA)";"BA";"UBATA";224;28;24;276
2019;"UIBAI (BA)";"BA";"UIBAI";75;14;24;113
2019;"UMBURANAS (BA)";"BA";"UMBURANAS";74;33;25;132
2019;"UNA (BA)";"BA";"UNA";76;14;197;287
2019;"URANDI (BA)";"BA";"URANDI";154;20;50;224
2019;"URUCUCA (BA)";"BA";"URUCUCA";116;11;19;146
2019;"UTINGA (BA)";"BA";"UTINGA";89;16;26;131
2019;"VALENCA (BA)";"BA";"VALENCA";909;330;175;1414
2019;"VALENTE (BA)";"BA";"VALENTE";212;29;43;284
2019;"VARZEA DA ROCA (BA)";"BA";"VARZEA DA ROCA";70;18;27;115
2019;"VARZEA DO POCO (BA)";"BA";"VARZEA DO POCO";110;24;14;148
2019;"VARZEA NOVA (BA)";"BA";"VARZEA NOVA";78;22;23;123
2019;"VARZEDO (BA)";"BA";"VARZEDO";92;18;36;146
2019;"VERA CRUZ (BA)";"BA";"VERA CRUZ";215;196;76;487
2019;"VEREDA (BA)";"BA";"VEREDA";12;7;3;22
2019;"VITORIA DA CONQUISTA (BA)";"BA";"VITORIA DA CONQUISTA";5074;1240;1812;8126
2019;"WAGNER (BA)";"BA";"WAGNER";49;5;17;71
2019;"WANDERLEY (BA)";"BA";"WANDERLEY";88;11;22;121
2019;"WENCESLAU GUIMARAES (BA)";"BA";"WENCESLAU GUIMARAES";144;35;27;206
2019;"XIQUE XIQUE (BA)";"BA";"XIQUE XIQUE";186;60;41;287
2019;"ABAIARA (CE)";"CE";"ABAIARA";65;31;9;105
2019;"ACARAPE (CE)";"CE";"ACARAPE";109;15;109;233
2019;"ACARAU (CE)";"CE";"ACARAU";281;60;81;422
2019;"ACOPIARA (CE)";"CE";"ACOPIARA";428;95;80;603
2019;"AIUABA (CE)";"CE";"AIUABA";37;8;9;54
2019;"ALCANTARAS (CE)";"CE";"ALCANTARAS";59;18;30;107
2019;"ALTANEIRA (CE)";"CE";"ALTANEIRA";42;20;8;70
2019;"ALTO SANTO (CE)";"CE";"ALTO SANTO";160;13;26;199
2019;"AMONTADA (CE)";"CE";"AMONTADA";217;57;49;323
2019;"ANTONINA DO NORTE (CE)";"CE";"ANTONINA DO NORTE";73;2;8;83
2019;"APUIARES (CE)";"CE";"APUIARES";103;9;22;134
2019;"AQUIRAZ (CE)";"CE";"AQUIRAZ";911;136;144;1191
2019;"ARACATI (CE)";"CE";"ARACATI";633;156;173;962
2019;"ARACOIABA (CE)";"CE";"ARACOIABA";139;25;36;200
2019;"ARARENDA (CE)";"CE";"ARARENDA";40;33;36;109
2019;"ARARIPE (CE)";"CE";"ARARIPE";147;77;75;299
2019;"ARATUBA (CE)";"CE";"ARATUBA";94;1;25;120
2019;"ARNEIROZ (CE)";"CE";"ARNEIROZ";45;14;5;64
2019;"ASSARE (CE)";"CE";"ASSARE";125;63;17;205
2019;"AURORA (CE)";"CE";"AURORA";134;36;20;190
2019;"BAIXIO (CE)";"CE";"BAIXIO";27;27;20;74
2019;"BANABUIU (CE)";"CE";"BANABUIU";214;13;34;261
2019;"BARBALHA (CE)";"CE";"BARBALHA";449;126;110;685
2019;"BARREIRA (CE)";"CE";"BARREIRA";181;13;25;219
2019;"BARRO (CE)";"CE";"BARRO";123;40;21;184
2019;"BARROQUINHA (CE)";"CE";"BARROQUINHA";72;53;9;134
2019;"BATURITE (CE)";"CE";"BATURITE";253;26;44;323
2019;"BEBERIBE (CE)";"CE";"BEBERIBE";350;90;119;559
2019;"BELA CRUZ (CE)";"CE";"BELA CRUZ";149;15;55;219
2019;"BOA VIAGEM (CE)";"CE";"BOA VIAGEM";666;41;98;805
2019;"BREJO SANTO (CE)";"CE";"BREJO SANTO";632;108;73;813
2019;"CAMOCIM (CE)";"CE";"CAMOCIM";267;59;44;370
2019;"CAMPOS SALES (CE)";"CE";"CAMPOS SALES";270;111;72;453
2019;"CANINDE (CE)";"CE";"CANINDE";694;97;275;1066
2019;"CAPISTRANO (CE)";"CE";"CAPISTRANO";84;12;23;119
2019;"CARIDADE (CE)";"CE";"CARIDADE";90;9;21;120
2019;"CARIRE (CE)";"CE";"CARIRE";95;14;35;144
2019;"CARIRIACU (CE)";"CE";"CARIRIACU";107;52;18;177
2019;"CARIUS (CE)";"CE";"CARIUS";60;28;9;97
2019;"CARNAUBAL (CE)";"CE";"CARNAUBAL";86;33;14;133
2019;"CASCAVEL (CE)";"CE";"CASCAVEL";609;94;196;899
2019;"CATARINA (CE)";"CE";"CATARINA";61;6;2;69
2019;"CATUNDA (CE)";"CE";"CATUNDA";55;15;8;78
2019;"CAUCAIA (CE)";"CE";"CAUCAIA";2247;358;504;3109
2019;"CEDRO (CE)";"CE";"CEDRO";129;51;46;226
2019;"CHAVAL (CE)";"CE";"CHAVAL";44;28;11;83
2019;"CHORO (CE)";"CE";"CHORO";83;12;94;189
2019;"CHOROZINHO (CE)";"CE";"CHOROZINHO";168;26;49;243
2019;"COREAU (CE)";"CE";"COREAU";125;20;39;184
2019;"CRATEUS (CE)";"CE";"CRATEUS";452;141;154;747
2019;"CRATO (CE)";"CE";"CRATO";1217;298;175;1690
2019;"CROATA (CE)";"CE";"CROATA";80;34;18;132
2019;"CRUZ (CE)";"CE";"CRUZ";221;36;149;406
2019;"DEPUTADO IRAPUAN PINHEIRO (CE)";"CE";"DEPUTADO IRAPUAN PINHEIRO";28;10;16;54
2019;"ERERE (CE)";"CE";"ERERE";9;6;6;21
2019;"EUSEBIO (CE)";"CE";"EUSEBIO";1845;70;178;2093
2019;"FARIAS BRITO (CE)";"CE";"FARIAS BRITO";145;40;28;213
2019;"FORQUILHA (CE)";"CE";"FORQUILHA";166;29;51;246
2019;"FORTALEZA (CE)";"CE";"FORTALEZA";22560;3404;7001;32965
2019;"FORTIM (CE)";"CE";"FORTIM";60;27;27;114
2019;"FRECHEIRINHA (CE)";"CE";"FRECHEIRINHA";110;20;32;162
2019;"GENERAL SAMPAIO (CE)";"CE";"GENERAL SAMPAIO";33;5;11;49
2019;"GRACA (CE)";"CE";"GRACA";37;18;14;69
2019;"GRANJA (CE)";"CE";"GRANJA";277;181;49;507
2019;"GRANJEIRO (CE)";"CE";"GRANJEIRO";22;4;5;31
2019;"GROAIRAS (CE)";"CE";"GROAIRAS";85;22;32;139
2019;"GUAIUBA (CE)";"CE";"GUAIUBA";110;31;16;157
2019;"GUARACIABA DO NORTE (CE)";"CE";"GUARACIABA DO NORTE";524;79;41;644
2019;"GUARAMIRANGA (CE)";"CE";"GUARAMIRANGA";34;3;13;50
2019;"HIDROLANDIA (CE)";"CE";"HIDROLANDIA";188;31;23;242
2019;"HORIZONTE (CE)";"CE";"HORIZONTE";592;93;107;792
2019;"IBARETAMA (CE)";"CE";"IBARETAMA";147;9;26;182
2019;"IBIAPINA (CE)";"CE";"IBIAPINA";242;29;30;301
2019;"IBICUITINGA (CE)";"CE";"IBICUITINGA";105;10;28;143
2019;"ICAPUI (CE)";"CE";"ICAPUI";133;26;62;221
2019;"ICO (CE)";"CE";"ICO";420;127;104;651
2019;"IGUATU (CE)";"CE";"IGUATU";1158;92;195;1445
2019;"INDEPENDENCIA (CE)";"CE";"INDEPENDENCIA";267;14;30;311
2019;"IPAPORANGA (CE)";"CE";"IPAPORANGA";47;13;13;73
2019;"IPAUMIRIM (CE)";"CE";"IPAUMIRIM";332;74;41;447
2019;"IPU (CE)";"CE";"IPU";359;39;33;431
2019;"IPUEIRAS (CE)";"CE";"IPUEIRAS";125;52;17;194
2019;"IRACEMA (CE)";"CE";"IRACEMA";72;17;33;122
2019;"IRAUCUBA (CE)";"CE";"IRAUCUBA";126;36;46;208
2019;"ITAICABA (CE)";"CE";"ITAICABA";42;7;17;66
2019;"ITAITINGA (CE)";"CE";"ITAITINGA";465;85;103;653
2019;"ITAPAJE (CE)";"CE";"ITAPAJE";383;51;58;492
2019;"ITAPIPOCA (CE)";"CE";"ITAPIPOCA";1064;114;147;1325
2019;"ITAPIUNA (CE)";"CE";"ITAPIUNA";70;15;33;118
2019;"ITAREMA (CE)";"CE";"ITAREMA";195;22;49;266
2019;"ITATIRA (CE)";"CE";"ITATIRA";229;21;61;311
2019;"JAGUARETAMA (CE)";"CE";"JAGUARETAMA";173;17;29;219
2019;"JAGUARIBARA (CE)";"CE";"JAGUARIBARA";125;17;17;159
2019;"JAGUARIBE (CE)";"CE";"JAGUARIBE";439;71;40;550
2019;"JAGUARUANA (CE)";"CE";"JAGUARUANA";297;36;34;367
2019;"JARDIM (CE)";"CE";"JARDIM";212;93;56;361
2019;"JATI (CE)";"CE";"JATI";79;208;27;314
2019;"JIJOCA DE JERICOACOARA (CE)";"CE";"JIJOCA DE JERICOACOARA";117;23;22;162
2019;"JUAZEIRO DO NORTE (CE)";"CE";"JUAZEIRO DO NORTE";2182;225;324;2731
2019;"JUCAS (CE)";"CE";"JUCAS";151;8;40;199
2019;"LAVRAS DA MANGABEIRA (CE)";"CE";"LAVRAS DA MANGABEIRA";144;33;41;218
2019;"LIMOEIRO DO NORTE (CE)";"CE";"LIMOEIRO DO NORTE";898;45;184;1127
2019;"MADALENA (CE)";"CE";"MADALENA";184;19;45;248
2019;"MARACANAU (CE)";"CE";"MARACANAU";2494;267;473;3234
2019;"MARANGUAPE (CE)";"CE";"MARANGUAPE";759;191;313;1263
2019;"MARCO (CE)";"CE";"MARCO";331;17;36;384
2019;"MARTINOPOLE (CE)";"CE";"MARTINOPOLE";42;23;3;68
2019;"MASSAPE (CE)";"CE";"MASSAPE";127;46;117;290
2019;"MAURITI (CE)";"CE";"MAURITI";207;77;82;366
2019;"MERUOCA (CE)";"CE";"MERUOCA";54;25;31;110
2019;"MILAGRES (CE)";"CE";"MILAGRES";134;87;37;258
2019;"MILHA (CE)";"CE";"MILHA";101;15;33;149
2019;"MIRAIMA (CE)";"CE";"MIRAIMA";36;8;13;57
2019;"MISSAO VELHA (CE)";"CE";"MISSAO VELHA";298;73;38;409
2019;"MOMBACA (CE)";"CE";"MOMBACA";297;53;51;401
2019;"MONSENHOR TABOSA (CE)";"CE";"MONSENHOR TABOSA";108;11;9;128
2019;"MORADA NOVA (CE)";"CE";"MORADA NOVA";632;88;145;865
2019;"MORAUJO (CE)";"CE";"MORAUJO";26;7;11;44
2019;"MORRINHOS (CE)";"CE";"MORRINHOS";133;16;28;177
2019;"MUCAMBO (CE)";"CE";"MUCAMBO";53;20;18;91
2019;"MULUNGU (CE)";"CE";"MULUNGU";79;8;16;103
2019;"NOVA OLINDA (CE)";"CE";"NOVA OLINDA";133;30;16;179
2019;"NOVA RUSSAS (CE)";"CE";"NOVA RUSSAS";231;51;30;312
2019;"NOVO ORIENTE (CE)";"CE";"NOVO ORIENTE";88;38;28;154
2019;"OCARA (CE)";"CE";"OCARA";214;12;65;291
2019;"OROS (CE)";"CE";"OROS";159;27;33;219
2019;"PACAJUS (CE)";"CE";"PACAJUS";762;109;171;1042
2019;"PACATUBA (CE)";"CE";"PACATUBA";343;96;59;498
2019;"PACOTI (CE)";"CE";"PACOTI";111;6;18;135
2019;"PACUJA (CE)";"CE";"PACUJA";27;6;9;42
2019;"PALHANO (CE)";"CE";"PALHANO";100;20;14;134
2019;"PALMACIA (CE)";"CE";"PALMACIA";53;13;22;88
2019;"PARACURU (CE)";"CE";"PARACURU";251;28;43;322
2019;"PARAIPABA (CE)";"CE";"PARAIPABA";328;19;42;389
2019;"PARAMBU (CE)";"CE";"PARAMBU";276;16;25;317
2019;"PARAMOTI (CE)";"CE";"PARAMOTI";66;9;25;100
2019;"PEDRA BRANCA (CE)";"CE";"PEDRA BRANCA";606;44;51;701
2019;"PENAFORTE (CE)";"CE";"PENAFORTE";138;58;28;224
2019;"PENTECOSTE (CE)";"CE";"PENTECOSTE";318;32;41;391
2019;"PEREIRO (CE)";"CE";"PEREIRO";130;17;43;190
2019;"PINDORETAMA (CE)";"CE";"PINDORETAMA";192;26;36;254
2019;"PIQUET CARNEIRO (CE)";"CE";"PIQUET CARNEIRO";69;10;16;95
2019;"PIRES FERREIRA (CE)";"CE";"PIRES FERREIRA";27;15;7;49
2019;"PORANGA (CE)";"CE";"PORANGA";32;13;10;55
2019;"PORTEIRAS (CE)";"CE";"PORTEIRAS";104;498;97;699
2019;"POTENGI (CE)";"CE";"POTENGI";79;8;10;97
2019;"POTIRETAMA (CE)";"CE";"POTIRETAMA";60;6;8;74
2019;"QUITERIANOPOLIS (CE)";"CE";"QUITERIANOPOLIS";90;20;8;118
2019;"QUIXADA (CE)";"CE";"QUIXADA";1035;76;167;1278
2019;"QUIXELO (CE)";"CE";"QUIXELO";80;18;44;142
2019;"QUIXERAMOBIM (CE)";"CE";"QUIXERAMOBIM";668;56;184;908
2019;"QUIXERE (CE)";"CE";"QUIXERE";315;13;50;378
2019;"REDENCAO (CE)";"CE";"REDENCAO";267;54;77;398
2019;"RERIUTABA (CE)";"CE";"RERIUTABA";128;47;28;203
2019;"RUSSAS (CE)";"CE";"RUSSAS";1089;74;195;1358
2019;"SABOEIRO (CE)";"CE";"SABOEIRO";55;9;12;76
2019;"SALITRE (CE)";"CE";"SALITRE";190;18;47;255
2019;"SANTA QUITERIA (CE)";"CE";"SANTA QUITERIA";339;66;45;450
2019;"SANTANA DO ACARAU (CE)";"CE";"SANTANA DO ACARAU";183;78;65;326
2019;"SANTANA DO CARIRI (CE)";"CE";"SANTANA DO CARIRI";97;45;27;169
2019;"SAO BENEDITO (CE)";"CE";"SAO BENEDITO";550;136;103;789
2019;"SAO GONCALO DO AMARANTE (CE)";"CE";"SAO GONCALO DO AMARANTE";461;103;154;718
2019;"SAO JOAO DO JAGUARIBE (CE)";"CE";"SAO JOAO DO JAGUARIBE";46;5;10;61
2019;"SAO LUIS DO CURU (CE)";"CE";"SAO LUIS DO CURU";81;3;15;99
2019;"SENADOR POMPEU (CE)";"CE";"SENADOR POMPEU";212;31;82;325
2019;"SENADOR SA (CE)";"CE";"SENADOR SA";35;9;18;62
2019;"SOBRAL (CE)";"CE";"SOBRAL";1817;257;494;2568
2019;"SOLONOPOLE (CE)";"CE";"SOLONOPOLE";111;23;27;161
2019;"TABULEIRO DO NORTE (CE)";"CE";"TABULEIRO DO NORTE";434;42;57;533
2019;"TAMBORIL (CE)";"CE";"TAMBORIL";156;33;34;223
2019;"TARRAFAS (CE)";"CE";"TARRAFAS";32;11;10;53
2019;"TAUA (CE)";"CE";"TAUA";601;144;65;810
2019;"TEJUCUOCA (CE)";"CE";"TEJUCUOCA";116;14;31;161
2019;"TIANGUA (CE)";"CE";"TIANGUA";1548;183;250;1981
2019;"TRAIRI (CE)";"CE";"TRAIRI";308;33;90;431
2019;"TURURU (CE)";"CE";"TURURU";77;14;15;106
2019;"UBAJARA (CE)";"CE";"UBAJARA";317;29;91;437
2019;"UMARI (CE)";"CE";"UMARI";14;6;8;28
2019;"UMIRIM (CE)";"CE";"UMIRIM";61;38;45;144
2019;"URUBURETAMA (CE)";"CE";"URUBURETAMA";107;13;35;155
2019;"URUOCA (CE)";"CE";"URUOCA";98;24;20;142
2019;"VARJOTA (CE)";"CE";"VARJOTA";174;51;14;239
2019;"VARZEA ALEGRE (CE)";"CE";"VARZEA ALEGRE";308;63;68;439
2019;"VICOSA DO CEARA (CE)";"CE";"VICOSA DO CEARA";481;62;99;642
2019;"BRASILIA (DF)";"DF";"BRASILIA";24767;6171;13305;44243
2019;"AFONSO CLAUDIO (ES)";"ES";"AFONSO CLAUDIO";808;117;110;1035
2019;"AGUA DOCE DO NORTE (ES)";"ES";"AGUA DOCE DO NORTE";159;39;47;245
2019;"AGUIA BRANCA (ES)";"ES";"AGUIA BRANCA";200;21;63;284
2019;"ALEGRE (ES)";"ES";"ALEGRE";311;86;48;445
2019;"ALFREDO CHAVES (ES)";"ES";"ALFREDO CHAVES";558;54;49;661
2019;"ALTO RIO NOVO (ES)";"ES";"ALTO RIO NOVO";141;26;24;191
2019;"ANCHIETA (ES)";"ES";"ANCHIETA";425;109;79;613
2019;"APIACA (ES)";"ES";"APIACA";223;35;11;269
2019;"ARACRUZ (ES)";"ES";"ARACRUZ";1586;239;528;2353
2019;"ATILIO VIVACQUA (ES)";"ES";"ATILIO VIVACQUA";230;18;29;277
2019;"BAIXO GUANDU (ES)";"ES";"BAIXO GUANDU";584;49;104;737
2019;"BARRA DE SAO FRANCISCO (ES)";"ES";"BARRA DE SAO FRANCISCO";649;61;158;868
2019;"BOA ESPERANCA (ES)";"ES";"BOA ESPERANCA";280;18;56;354
2019;"BOM JESUS DO NORTE (ES)";"ES";"BOM JESUS DO NORTE";419;51;40;510
2019;"BREJETUBA (ES)";"ES";"BREJETUBA";373;50;66;489
2019;"CACHOEIRO DE ITAPEMIRIM (ES)";"ES";"CACHOEIRO DE ITAPEMIRIM";5399;281;1733;7413
2019;"CARIACICA (ES)";"ES";"CARIACICA";6441;831;1645;8917
2019;"CASTELO (ES)";"ES";"CASTELO";1415;110;113;1638
2019;"COLATINA (ES)";"ES";"COLATINA";2694;221;634;3549
2019;"CONCEICAO DA BARRA (ES)";"ES";"CONCEICAO DA BARRA";296;22;151;469
2019;"CONCEICAO DO CASTELO (ES)";"ES";"CONCEICAO DO CASTELO";338;66;71;475
2019;"DIVINO DE SAO LOURENCO (ES)";"ES";"DIVINO DE SAO LOURENCO";93;12;14;119
2019;"DOMINGOS MARTINS (ES)";"ES";"DOMINGOS MARTINS";1485;142;94;1721
2019;"DORES DO RIO PRETO (ES)";"ES";"DORES DO RIO PRETO";181;27;19;227
2019;"ECOPORANGA (ES)";"ES";"ECOPORANGA";213;58;116;387
2019;"FUNDAO (ES)";"ES";"FUNDAO";364;70;47;481
2019;"GOVERNADOR LINDENBERG (ES)";"ES";"GOVERNADOR LINDENBERG";346;10;7;363
2019;"GUACUI (ES)";"ES";"GUACUI";899;85;75;1059
2019;"GUARAPARI (ES)";"ES";"GUARAPARI";1515;362;304;2181
2019;"IBATIBA (ES)";"ES";"IBATIBA";695;106;91;892
2019;"IBIRACU (ES)";"ES";"IBIRACU";404;36;47;487
2019;"IBITIRAMA (ES)";"ES";"IBITIRAMA";184;47;33;264
2019;"ICONHA (ES)";"ES";"ICONHA";552;32;77;661
2019;"IRUPI (ES)";"ES";"IRUPI";289;56;39;384
2019;"ITAGUACU (ES)";"ES";"ITAGUACU";333;22;75;430
2019;"ITAPEMIRIM (ES)";"ES";"ITAPEMIRIM";672;55;84;811
2019;"ITARANA (ES)";"ES";"ITARANA";493;42;46;581
2019;"IUNA (ES)";"ES";"IUNA";585;118;83;786
2019;"JAGUARE (ES)";"ES";"JAGUARE";536;33;94;663
2019;"JERONIMO MONTEIRO (ES)";"ES";"JERONIMO MONTEIRO";124;27;23;174
2019;"JOAO NEIVA (ES)";"ES";"JOAO NEIVA";332;32;38;402
2019;"LARANJA DA TERRA (ES)";"ES";"LARANJA DA TERRA";370;30;34;434
2019;"LINHARES (ES)";"ES";"LINHARES";3073;226;625;3924
2019;"MANTENOPOLIS (ES)";"ES";"MANTENOPOLIS";232;34;36;302
2019;"MARATAIZES (ES)";"ES";"MARATAIZES";1204;69;111;1384
2019;"MARECHAL FLORIANO (ES)";"ES";"MARECHAL FLORIANO";923;62;57;1042
2019;"MARILANDIA (ES)";"ES";"MARILANDIA";450;23;30;503
2019;"MIMOSO DO SUL (ES)";"ES";"MIMOSO DO SUL";398;86;95;579
2019;"MONTANHA (ES)";"ES";"MONTANHA";309;26;133;468
2019;"MUCURICI (ES)";"ES";"MUCURICI";105;12;28;145
2019;"MUNIZ FREIRE (ES)";"ES";"MUNIZ FREIRE";316;61;53;430
2019;"MUQUI (ES)";"ES";"MUQUI";233;30;43;306
2019;"NOVA VENECIA (ES)";"ES";"NOVA VENECIA";1094;61;195;1350
2019;"PANCAS (ES)";"ES";"PANCAS";345;37;29;411
2019;"PEDRO CANARIO (ES)";"ES";"PEDRO CANARIO";813;66;363;1242
2019;"PINHEIROS (ES)";"ES";"PINHEIROS";343;28;169;540
2019;"PIUMA (ES)";"ES";"PIUMA";326;42;16;384
2019;"PONTO BELO (ES)";"ES";"PONTO BELO";68;15;21;104
2019;"PRESIDENTE KENNEDY (ES)";"ES";"PRESIDENTE KENNEDY";430;28;23;481
2019;"RIO BANANAL (ES)";"ES";"RIO BANANAL";742;25;58;825
2019;"RIO NOVO DO SUL (ES)";"ES";"RIO NOVO DO SUL";372;28;38;438
2019;"SANTA LEOPOLDINA (ES)";"ES";"SANTA LEOPOLDINA";524;55;36;615
2019;"SANTA MARIA DE JETIBA (ES)";"ES";"SANTA MARIA DE JETIBA";3048;105;111;3264
2019;"SANTA TERESA (ES)";"ES";"SANTA TERESA";863;64;129;1056
2019;"SAO DOMINGOS DO NORTE (ES)";"ES";"SAO DOMINGOS DO NORTE";289;18;54;361
2019;"SAO GABRIEL DA PALHA (ES)";"ES";"SAO GABRIEL DA PALHA";812;53;188;1053
2019;"SAO JOSE DO CALCADO (ES)";"ES";"SAO JOSE DO CALCADO";113;32;25;170
2019;"SAO MATEUS (ES)";"ES";"SAO MATEUS";1407;141;452;2000
2019;"SAO ROQUE DO CANAA (ES)";"ES";"SAO ROQUE DO CANAA";370;27;40;437
2019;"SERRA (ES)";"ES";"SERRA";9198;901;2283;12382
2019;"SOORETAMA (ES)";"ES";"SOORETAMA";406;25;70;501
2019;"VARGEM ALTA (ES)";"ES";"VARGEM ALTA";611;50;77;738
2019;"VENDA NOVA DO IMIGRANTE (ES)";"ES";"VENDA NOVA DO IMIGRANTE";903;33;131;1067
2019;"VIANA (ES)";"ES";"VIANA";1475;130;393;1998
2019;"VILA PAVAO (ES)";"ES";"VILA PAVAO";195;10;32;237
2019;"VILA VALERIO (ES)";"ES";"VILA VALERIO";449;34;114;597
2019;"VILA VELHA (ES)";"ES";"VILA VELHA";4545;1012;903;6460
2019;"VITORIA (ES)";"ES";"VITORIA";4305;1052;912;6269
2019;"ABADIA DE GOIAS (GO)";"GO";"ABADIA DE GOIAS";167;10;14;191
2019;"ABADIANIA (GO)";"GO";"ABADIANIA";311;40;36;387
2019;"ACREUNA (GO)";"GO";"ACREUNA";462;21;132;615
2019;"ADELANDIA (GO)";"GO";"ADELANDIA";48;2;7;57
2019;"AGUA FRIA DE GOIAS (GO)";"GO";"AGUA FRIA DE GOIAS";56;11;24;91
2019;"AGUA LIMPA (GO)";"GO";"AGUA LIMPA";22;7;2;31
2019;"AGUAS LINDAS DE GOIAS (GO)";"GO";"AGUAS LINDAS DE GOIAS";1367;229;746;2342
2019;"ALEXANIA (GO)";"GO";"ALEXANIA";557;53;55;665
2019;"ALOANDIA (GO)";"GO";"ALOANDIA";28;2;5;35
2019;"ALTO HORIZONTE (GO)";"GO";"ALTO HORIZONTE";76;10;26;112
2019;"ALTO PARAISO DE GOIAS (GO)";"GO";"ALTO PARAISO DE GOIAS";88;11;18;117
2019;"ALVORADA DO NORTE (GO)";"GO";"ALVORADA DO NORTE";182;12;19;213
2019;"AMARALINA (GO)";"GO";"AMARALINA";15;4;14;33
2019;"AMERICANO DO BRASIL (GO)";"GO";"AMERICANO DO BRASIL";77;10;28;115
2019;"AMORINOPOLIS (GO)";"GO";"AMORINOPOLIS";41;7;12;60
2019;"ANAPOLIS (GO)";"GO";"ANAPOLIS";10042;376;1758;12176
2019;"ANHANGUERA (GO)";"GO";"ANHANGUERA";9;0;2;11
2019;"ANICUNS (GO)";"GO";"ANICUNS";403;28;101;532
2019;"APARECIDA DE GOIANIA (GO)";"GO";"APARECIDA DE GOIANIA";7680;506;732;8918
2019;"APARECIDA DO RIO DOCE (GO)";"GO";"APARECIDA DO RIO DOCE";74;17;11;102
2019;"APORE (GO)";"GO";"APORE";119;13;35;167
2019;"ARACU (GO)";"GO";"ARACU";38;11;14;63
2019;"ARAGARCAS (GO)";"GO";"ARAGARCAS";507;18;33;558
2019;"ARAGOIANIA (GO)";"GO";"ARAGOIANIA";111;5;12;128
2019;"ARAGUAPAZ (GO)";"GO";"ARAGUAPAZ";113;13;19;145
2019;"ARENOPOLIS (GO)";"GO";"ARENOPOLIS";28;16;10;54
2019;"ARUANA (GO)";"GO";"ARUANA";85;4;24;113
2019;"AURILANDIA (GO)";"GO";"AURILANDIA";36;5;3;44
2019;"AVELINOPOLIS (GO)";"GO";"AVELINOPOLIS";67;3;3;73
2019;"BALIZA (GO)";"GO";"BALIZA";10;2;8;20
2019;"BARRO ALTO (GO)";"GO";"BARRO ALTO";192;31;89;312
2019;"BELA VISTA DE GOIAS (GO)";"GO";"BELA VISTA DE GOIAS";561;56;62;679
2019;"BOM JARDIM DE GOIAS (GO)";"GO";"BOM JARDIM DE GOIAS";162;8;38;208
2019;"BOM JESUS (GO)";"GO";"BOM JESUS";519;73;154;746
2019;"BONFINOPOLIS (GO)";"GO";"BONFINOPOLIS";77;9;11;97
2019;"BONOPOLIS (GO)";"GO";"BONOPOLIS";26;3;13;42
2019;"BRAZABRANTES (GO)";"GO";"BRAZABRANTES";69;3;8;80
2019;"BRITANIA (GO)";"GO";"BRITANIA";106;12;14;132
2019;"BURITI ALEGRE (GO)";"GO";"BURITI ALEGRE";250;39;20;309
2019;"BURITI DE GOIAS (GO)";"GO";"BURITI DE GOIAS";29;10;2;41
2019;"BURITINOPOLIS (GO)";"GO";"BURITINOPOLIS";32;2;9;43
2019;"CABECEIRAS (GO)";"GO";"CABECEIRAS";165;14;32;211
2019;"CACHOEIRA ALTA (GO)";"GO";"CACHOEIRA ALTA";183;20;77;280
2019;"CACHOEIRA DE GOIAS (GO)";"GO";"CACHOEIRA DE GOIAS";10;2;2;14
2019;"CACHOEIRA DOURADA (GO)";"GO";"CACHOEIRA DOURADA";130;13;49;192
2019;"CACU (GO)";"GO";"CACU";335;37;49;421
2019;"CAIAPONIA (GO)";"GO";"CAIAPONIA";302;15;16;333
2019;"CALDAS NOVAS (GO)";"GO";"CALDAS NOVAS";904;140;134;1178
2019;"CALDAZINHA (GO)";"GO";"CALDAZINHA";39;7;3;49
2019;"CAMPESTRE DE GOIAS (GO)";"GO";"CAMPESTRE DE GOIAS";49;3;8;60
2019;"CAMPINACU (GO)";"GO";"CAMPINACU";48;2;6;56
2019;"CAMPINORTE (GO)";"GO";"CAMPINORTE";213;22;26;261
2019;"CAMPO ALEGRE DE GOIAS (GO)";"GO";"CAMPO ALEGRE DE GOIAS";190;26;31;247
2019;"CAMPO LIMPO DE GOIAS (GO)";"GO";"CAMPO LIMPO DE GOIAS";212;5;7;224
2019;"CAMPOS BELOS (GO)";"GO";"CAMPOS BELOS";331;20;62;413
2019;"CAMPOS VERDES (GO)";"GO";"CAMPOS VERDES";51;9;3;63
2019;"CARMO DO RIO VERDE (GO)";"GO";"CARMO DO RIO VERDE";131;22;55;208
2019;"CASTELANDIA (GO)";"GO";"CASTELANDIA";71;6;12;89
2019;"CATALAO (GO)";"GO";"CATALAO";2182;246;419;2847
2019;"CATURAI (GO)";"GO";"CATURAI";58;3;10;71
2019;"CAVALCANTE (GO)";"GO";"CAVALCANTE";58;3;6;67
2019;"CERES (GO)";"GO";"CERES";547;21;59;627
2019;"CEZARINA (GO)";"GO";"CEZARINA";163;12;32;207
2019;"CHAPADAO DO CEU (GO)";"GO";"CHAPADAO DO CEU";379;17;33;429
2019;"CIDADE OCIDENTAL (GO)";"GO";"CIDADE OCIDENTAL";227;87;130;444
2019;"COCALZINHO DE GOIAS (GO)";"GO";"COCALZINHO DE GOIAS";245;39;39;323
2019;"COLINAS DO SUL (GO)";"GO";"COLINAS DO SUL";32;4;2;38
2019;"CORREGO DO OURO (GO)";"GO";"CORREGO DO OURO";26;4;3;33
2019;"CORUMBA DE GOIAS (GO)";"GO";"CORUMBA DE GOIAS";126;19;38;183
2019;"CORUMBAIBA (GO)";"GO";"CORUMBAIBA";180;29;11;220
2019;"CRISTALINA (GO)";"GO";"CRISTALINA";1883;111;537;2531
2019;"CRISTIANOPOLIS (GO)";"GO";"CRISTIANOPOLIS";66;9;4;79
2019;"CRIXAS (GO)";"GO";"CRIXAS";201;23;25;249
2019;"CROMINIA (GO)";"GO";"CROMINIA";61;8;5;74
2019;"CUMARI (GO)";"GO";"CUMARI";31;8;5;44
2019;"DAMIANOPOLIS (GO)";"GO";"DAMIANOPOLIS";31;5;16;52
2019;"DAMOLANDIA (GO)";"GO";"DAMOLANDIA";57;6;9;72
2019;"DAVINOPOLIS (GO)";"GO";"DAVINOPOLIS";35;6;6;47
2019;"DIORAMA (GO)";"GO";"DIORAMA";19;5;8;32
2019;"DIVINOPOLIS DE GOIAS (GO)";"GO";"DIVINOPOLIS DE GOIAS";42;6;10;58
2019;"DOVERLANDIA (GO)";"GO";"DOVERLANDIA";152;18;40;210
2019;"EDEALINA (GO)";"GO";"EDEALINA";87;17;14;118
2019;"EDEIA (GO)";"GO";"EDEIA";313;18;27;358
2019;"ESTRELA DO NORTE (GO)";"GO";"ESTRELA DO NORTE";42;2;4;48
2019;"FAINA (GO)";"GO";"FAINA";71;17;11;99
2019;"FAZENDA NOVA (GO)";"GO";"FAZENDA NOVA";53;12;10;75
2019;"FIRMINOPOLIS (GO)";"GO";"FIRMINOPOLIS";125;5;8;138
2019;"FLORES DE GOIAS (GO)";"GO";"FLORES DE GOIAS";61;7;17;85
2019;"FORMOSA (GO)";"GO";"FORMOSA";3437;200;737;4374
2019;"FORMOSO (GO)";"GO";"FORMOSO";63;7;9;79
2019;"GAMELEIRA DE GOIAS (GO)";"GO";"GAMELEIRA DE GOIAS";44;3;19;66
2019;"GOIANAPOLIS (GO)";"GO";"GOIANAPOLIS";255;27;37;319
2019;"GOIANDIRA (GO)";"GO";"GOIANDIRA";60;13;7;80
2019;"GOIANESIA (GO)";"GO";"GOIANESIA";1232;124;317;1673
2019;"GOIANIA (GO)";"GO";"GOIANIA";25347;2176;7118;34641
2019;"GOIANIRA (GO)";"GO";"GOIANIRA";470;44;111;625
2019;"GOIAS (GO)";"GO";"GOIAS";263;22;65;350
2019;"GOIATUBA (GO)";"GO";"GOIATUBA";859;61;154;1074
2019;"GOUVELANDIA (GO)";"GO";"GOUVELANDIA";74;10;13;97
2019;"GUAPO (GO)";"GO";"GUAPO";300;24;63;387
2019;"GUARAITA (GO)";"GO";"GUARAITA";25;3;4;32
2019;"GUARANI DE GOIAS (GO)";"GO";"GUARANI DE GOIAS";18;6;11;35
2019;"GUARINOS (GO)";"GO";"GUARINOS";13;7;3;23
2019;"HEITORAI (GO)";"GO";"HEITORAI";46;3;5;54
2019;"HIDROLANDIA (GO)";"GO";"HIDROLANDIA";932;36;53;1021
2019;"HIDROLINA (GO)";"GO";"HIDROLINA";35;2;4;41
2019;"IACIARA (GO)";"GO";"IACIARA";156;20;27;203
2019;"INACIOLANDIA (GO)";"GO";"INACIOLANDIA";76;8;19;103
2019;"INDIARA (GO)";"GO";"INDIARA";295;20;45;360
2019;"INHUMAS (GO)";"GO";"INHUMAS";1222;92;216;1530
2019;"IPAMERI (GO)";"GO";"IPAMERI";547;89;100;736
2019;"IPIRANGA DE GOIAS (GO)";"GO";"IPIRANGA DE GOIAS";39;7;7;53
2019;"IPORA (GO)";"GO";"IPORA";606;37;53;696
2019;"ISRAELANDIA (GO)";"GO";"ISRAELANDIA";45;6;8;59
2019;"ITABERAI (GO)";"GO";"ITABERAI";1011;63;118;1192
2019;"ITAGUARI (GO)";"GO";"ITAGUARI";65;13;14;92
2019;"ITAGUARU (GO)";"GO";"ITAGUARU";111;10;12;133
2019;"ITAJA (GO)";"GO";"ITAJA";121;15;22;158
2019;"ITAPACI (GO)";"GO";"ITAPACI";261;31;107;399
2019;"ITAPIRAPUA (GO)";"GO";"ITAPIRAPUA";86;14;14;114
2019;"ITAPURANGA (GO)";"GO";"ITAPURANGA";444;36;73;553
2019;"ITARUMA (GO)";"GO";"ITARUMA";104;22;21;147
2019;"ITAUCU (GO)";"GO";"ITAUCU";137;8;14;159
2019;"ITUMBIARA (GO)";"GO";"ITUMBIARA";2085;267;449;2801
2019;"IVOLANDIA (GO)";"GO";"IVOLANDIA";15;3;2;20
2019;"JANDAIA (GO)";"GO";"JANDAIA";127;7;19;153
2019;"JARAGUA (GO)";"GO";"JARAGUA";516;38;53;607
2019;"JATAI (GO)";"GO";"JATAI";2549;183;309;3041
2019;"JAUPACI (GO)";"GO";"JAUPACI";30;6;7;43
2019;"JESUPOLIS (GO)";"GO";"JESUPOLIS";27;4;9;40
2019;"JOVIANIA (GO)";"GO";"JOVIANIA";167;16;29;212
2019;"JUSSARA (GO)";"GO";"JUSSARA";495;23;28;546
2019;"LAGOA SANTA (GO)";"GO";"LAGOA SANTA";23;8;9;40
2019;"LEOPOLDO DE BULHOES (GO)";"GO";"LEOPOLDO DE BULHOES";262;20;16;298
2019;"LUZIANIA (GO)";"GO";"LUZIANIA";2508;320;606;3434
2019;"MAIRIPOTABA (GO)";"GO";"MAIRIPOTABA";36;9;4;49
2019;"MAMBAI (GO)";"GO";"MAMBAI";94;5;34;133
2019;"MARA ROSA (GO)";"GO";"MARA ROSA";162;13;17;192
2019;"MARZAGAO (GO)";"GO";"MARZAGAO";38;4;6;48
2019;"MATRINCHA (GO)";"GO";"MATRINCHA";60;6;12;78
2019;"MAURILANDIA (GO)";"GO";"MAURILANDIA";402;20;128;550
2019;"MIMOSO DE GOIAS (GO)";"GO";"MIMOSO DE GOIAS";11;5;6;22
2019;"MINACU (GO)";"GO";"MINACU";516;48;54;618
2019;"MINEIROS (GO)";"GO";"MINEIROS";1476;96;183;1755
2019;"MOIPORA (GO)";"GO";"MOIPORA";9;0;1;10
2019;"MONTE ALEGRE DE GOIAS (GO)";"GO";"MONTE ALEGRE DE GOIAS";29;7;10;46
2019;"MONTES CLAROS DE GOIAS (GO)";"GO";"MONTES CLAROS DE GOIAS";122;21;37;180
2019;"MONTIVIDIU (GO)";"GO";"MONTIVIDIU";390;45;82;517
2019;"MONTIVIDIU DO NORTE (GO)";"GO";"MONTIVIDIU DO NORTE";30;5;18;53
2019;"MORRINHOS (GO)";"GO";"MORRINHOS";985;88;166;1239
2019;"MORRO AGUDO DE GOIAS (GO)";"GO";"MORRO AGUDO DE GOIAS";68;6;8;82
2019;"MOSSAMEDES (GO)";"GO";"MOSSAMEDES";50;11;7;68
2019;"MOZARLANDIA (GO)";"GO";"MOZARLANDIA";169;26;52;247
2019;"MUNDO NOVO (GO)";"GO";"MUNDO NOVO";62;7;27;96
2019;"MUTUNOPOLIS (GO)";"GO";"MUTUNOPOLIS";47;6;17;70
2019;"NAZARIO (GO)";"GO";"NAZARIO";122;12;18;152
2019;"NEROPOLIS (GO)";"GO";"NEROPOLIS";613;31;43;687
2019;"NIQUELANDIA (GO)";"GO";"NIQUELANDIA";723;96;178;997
2019;"NOVA AMERICA (GO)";"GO";"NOVA AMERICA";40;2;4;46
2019;"NOVA AURORA (GO)";"GO";"NOVA AURORA";42;6;6;54
2019;"NOVA CRIXAS (GO)";"GO";"NOVA CRIXAS";163;14;44;221
2019;"NOVA GLORIA (GO)";"GO";"NOVA GLORIA";135;14;31;180
2019;"NOVA IGUACU DE GOIAS (GO)";"GO";"NOVA IGUACU DE GOIAS";36;7;6;49
2019;"NOVA ROMA (GO)";"GO";"NOVA ROMA";10;5;6;21
2019;"NOVA VENEZA (GO)";"GO";"NOVA VENEZA";178;19;27;224
2019;"NOVO BRASIL (GO)";"GO";"NOVO BRASIL";35;6;5;46
2019;"NOVO GAMA (GO)";"GO";"NOVO GAMA";497;119;198;814
2019;"NOVO PLANALTO (GO)";"GO";"NOVO PLANALTO";53;14;5;72
2019;"ORIZONA (GO)";"GO";"ORIZONA";280;77;49;406
2019;"OURO VERDE DE GOIAS (GO)";"GO";"OURO VERDE DE GOIAS";125;2;16;143
2019;"OUVIDOR (GO)";"GO";"OUVIDOR";77;6;17;100
2019;"PADRE BERNARDO (GO)";"GO";"PADRE BERNARDO";461;36;98;595
2019;"PALESTINA DE GOIAS (GO)";"GO";"PALESTINA DE GOIAS";28;14;13;55
2019;"PALMEIRAS DE GOIAS (GO)";"GO";"PALMEIRAS DE GOIAS";457;29;147;633
2019;"PALMELO (GO)";"GO";"PALMELO";36;5;6;47
2019;"PALMINOPOLIS (GO)";"GO";"PALMINOPOLIS";71;3;6;80
2019;"PANAMA (GO)";"GO";"PANAMA";65;14;10;89
2019;"PARANAIGUARA (GO)";"GO";"PARANAIGUARA";136;19;15;170
2019;"PARAUNA (GO)";"GO";"PARAUNA";225;33;48;306
2019;"PEROLANDIA (GO)";"GO";"PEROLANDIA";62;12;11;85
2019;"PETROLINA DE GOIAS (GO)";"GO";"PETROLINA DE GOIAS";219;8;23;250
2019;"PILAR DE GOIAS (GO)";"GO";"PILAR DE GOIAS";31;5;7;43
2019;"PIRACANJUBA (GO)";"GO";"PIRACANJUBA";534;47;49;630
2019;"PIRANHAS (GO)";"GO";"PIRANHAS";253;21;44;318
2019;"PIRENOPOLIS (GO)";"GO";"PIRENOPOLIS";349;73;43;465
2019;"PIRES DO RIO (GO)";"GO";"PIRES DO RIO";634;34;78;746
2019;"PLANALTINA (GO)";"GO";"PLANALTINA";739;105;422;1266
2019;"PONTALINA (GO)";"GO";"PONTALINA";352;28;42;422
2019;"PORANGATU (GO)";"GO";"PORANGATU";812;71;98;981
2019;"PORTEIRAO (GO)";"GO";"PORTEIRAO";124;18;49;191
2019;"PORTELANDIA (GO)";"GO";"PORTELANDIA";61;25;5;91
2019;"POSSE (GO)";"GO";"POSSE";822;78;136;1036
2019;"PROFESSOR JAMIL (GO)";"GO";"PROFESSOR JAMIL";42;3;7;52
2019;"QUIRINOPOLIS (GO)";"GO";"QUIRINOPOLIS";1098;83;285;1466
2019;"RIALMA (GO)";"GO";"RIALMA";343;31;46;420
2019;"RIANAPOLIS (GO)";"GO";"RIANAPOLIS";101;5;10;116
2019;"RIO QUENTE (GO)";"GO";"RIO QUENTE";55;22;59;136
2019;"RIO VERDE (GO)";"GO";"RIO VERDE";4164;443;633;5240
2019;"RUBIATABA (GO)";"GO";"RUBIATABA";396;40;122;558
2019;"SANCLERLANDIA (GO)";"GO";"SANCLERLANDIA";137;8;8;153
2019;"SANTA BARBARA DE GOIAS (GO)";"GO";"SANTA BARBARA DE GOIAS";136;9;11;156
2019;"SANTA CRUZ DE GOIAS (GO)";"GO";"SANTA CRUZ DE GOIAS";17;5;4;26
2019;"SANTA FE DE GOIAS (GO)";"GO";"SANTA FE DE GOIAS";44;9;6;59
2019;"SANTA HELENA DE GOIAS (GO)";"GO";"SANTA HELENA DE GOIAS";1025;64;301;1390
2019;"SANTA ISABEL (GO)";"GO";"SANTA ISABEL";17;11;6;34
2019;"SANTA RITA DO ARAGUAIA (GO)";"GO";"SANTA RITA DO ARAGUAIA";136;17;15;168
2019;"SANTA RITA DO NOVO DESTINO (GO)";"GO";"SANTA RITA DO NOVO DESTINO";29;14;11;54
2019;"SANTA ROSA DE GOIAS (GO)";"GO";"SANTA ROSA DE GOIAS";46;4;5;55
2019;"SANTA TEREZA DE GOIAS (GO)";"GO";"SANTA TEREZA DE GOIAS";47;4;9;60
2019;"SANTA TEREZINHA DE GOIAS (GO)";"GO";"SANTA TEREZINHA DE GOIAS";138;11;24;173
2019;"SANTO ANTONIO DA BARRA (GO)";"GO";"SANTO ANTONIO DA BARRA";47;18;21;86
2019;"SANTO ANTONIO DE GOIAS (GO)";"GO";"SANTO ANTONIO DE GOIAS";107;6;23;136
2019;"SANTO ANTONIO DO DESCOBERTO (GO)";"GO";"SANTO ANTONIO DO DESCOBERTO";336;81;204;621
2019;"SAO DOMINGOS (GO)";"GO";"SAO DOMINGOS";58;11;42;111
2019;"SAO FRANCISCO DE GOIAS (GO)";"GO";"SAO FRANCISCO DE GOIAS";58;8;14;80
2019;"SAO JOAO D ALIANCA (GO)";"GO";"SAO JOAO D ALIANCA";175;8;26;209
2019;"SAO JOAO DA PARAUNA (GO)";"GO";"SAO JOAO DA PARAUNA";26;2;3;31
2019;"SAO LUIS DE MONTES BELOS (GO)";"GO";"SAO LUIS DE MONTES BELOS";517;46;105;668
2019;"SAO LUIZ DO NORTE (GO)";"GO";"SAO LUIZ DO NORTE";73;7;25;105
2019;"SAO MIGUEL DO ARAGUAIA (GO)";"GO";"SAO MIGUEL DO ARAGUAIA";405;29;82;516
2019;"SAO MIGUEL DO PASSA QUATRO (GO)";"GO";"SAO MIGUEL DO PASSA QUATRO";65;5;6;76
2019;"SAO PATRICIO (GO)";"GO";"SAO PATRICIO";18;2;6;26
2019;"SAO SIMAO (GO)";"GO";"SAO SIMAO";247;45;71;363
2019;"SENADOR CANEDO (GO)";"GO";"SENADOR CANEDO";1145;121;123;1389
2019;"SERRANOPOLIS (GO)";"GO";"SERRANOPOLIS";142;18;25;185
2019;"SILVANIA (GO)";"GO";"SILVANIA";481;47;60;588
2019;"SIMOLANDIA (GO)";"GO";"SIMOLANDIA";168;5;14;187
2019;"SITIO D ABADIA (GO)";"GO";"SITIO D ABADIA";14;3;8;25
2019;"TAQUARAL DE GOIAS (GO)";"GO";"TAQUARAL DE GOIAS";36;5;9;50
2019;"TERESINA DE GOIAS (GO)";"GO";"TERESINA DE GOIAS";20;2;2;24
2019;"TEREZOPOLIS DE GOIAS (GO)";"GO";"TEREZOPOLIS DE GOIAS";120;6;26;152
2019;"TRES RANCHOS (GO)";"GO";"TRES RANCHOS";46;11;5;62
2019;"TRINDADE (GO)";"GO";"TRINDADE";1406;101;186;1693
2019;"TROMBAS (GO)";"GO";"TROMBAS";46;7;14;67
2019;"TURVANIA (GO)";"GO";"TURVANIA";67;7;9;83
2019;"TURVELANDIA (GO)";"GO";"TURVELANDIA";100;14;26;140
2019;"UIRAPURU (GO)";"GO";"UIRAPURU";21;9;7;37
2019;"URUACU (GO)";"GO";"URUACU";734;49;105;888
2019;"URUANA (GO)";"GO";"URUANA";348;11;22;381
2019;"URUTAI (GO)";"GO";"URUTAI";33;3;11;47
2019;"VALPARAISO DE GOIAS (GO)";"GO";"VALPARAISO DE GOIAS";800;251;296;1347
2019;"VARJAO (GO)";"GO";"VARJAO";67;3;9;79
2019;"VIANOPOLIS (GO)";"GO";"VIANOPOLIS";624;48;56;728
2019;"VICENTINOPOLIS (GO)";"GO";"VICENTINOPOLIS";217;10;80;307
2019;"VILA BOA (GO)";"GO";"VILA BOA";41;3;35;79
2019;"VILA PROPICIO (GO)";"GO";"VILA PROPICIO";49;19;30;98
2019;"ACAILANDIA (MA)";"MA";"ACAILANDIA";1835;138;293;2266
2019;"AFONSO CUNHA (MA)";"MA";"AFONSO CUNHA";10;1;7;18
2019;"AGUA DOCE DO MARANHAO (MA)";"MA";"AGUA DOCE DO MARANHAO";5;5;11;21
2019;"ALCANTARA (MA)";"MA";"ALCANTARA";53;30;64;147
2019;"ALDEIAS ALTAS (MA)";"MA";"ALDEIAS ALTAS";51;3;27;81
2019;"ALTAMIRA DO MARANHAO (MA)";"MA";"ALTAMIRA DO MARANHAO";23;3;4;30
2019;"ALTO ALEGRE DO MARANHAO (MA)";"MA";"ALTO ALEGRE DO MARANHAO";75;35;3;113
2019;"ALTO ALEGRE DO PINDARE (MA)";"MA";"ALTO ALEGRE DO PINDARE";50;16;4;70
2019;"ALTO PARNAIBA (MA)";"MA";"ALTO PARNAIBA";93;3;8;104
2019;"AMAPA DO MARANHAO (MA)";"MA";"AMAPA DO MARANHAO";19;3;4;26
2019;"AMARANTE DO MARANHAO (MA)";"MA";"AMARANTE DO MARANHAO";153;12;11;176
2019;"ANAJATUBA (MA)";"MA";"ANAJATUBA";45;6;13;64
2019;"ANAPURUS (MA)";"MA";"ANAPURUS";64;3;25;92
2019;"APICUM ACU (MA)";"MA";"APICUM ACU";19;12;5;36
2019;"ARAGUANA (MA)";"MA";"ARAGUANA";21;1;8;30
2019;"ARAIOSES (MA)";"MA";"ARAIOSES";34;6;29;69
2019;"ARAME (MA)";"MA";"ARAME";124;10;3;137
2019;"ARARI (MA)";"MA";"ARARI";114;13;14;141
2019;"AXIXA (MA)";"MA";"AXIXA";26;6;16;48
2019;"BACABAL (MA)";"MA";"BACABAL";1051;105;95;1251
2019;"BACABEIRA (MA)";"MA";"BACABEIRA";137;14;57;208
2019;"BACURI (MA)";"MA";"BACURI";16;7;8;31
2019;"BACURITUBA (MA)";"MA";"BACURITUBA";5;0;6;11
2019;"BALSAS (MA)";"MA";"BALSAS";2041;88;194;2323
2019;"BARAO DE GRAJAU (MA)";"MA";"BARAO DE GRAJAU";89;5;12;106
2019;"BARRA DO CORDA (MA)";"MA";"BARRA DO CORDA";807;34;28;869
2019;"BARREIRINHAS (MA)";"MA";"BARREIRINHAS";107;14;33;154
2019;"BELA VISTA DO MARANHAO (MA)";"MA";"BELA VISTA DO MARANHAO";53;4;5;62
2019;"BELAGUA (MA)";"MA";"BELAGUA";4;5;3;12
2019;"BENEDITO LEITE (MA)";"MA";"BENEDITO LEITE";8;5;2;15
2019;"BEQUIMAO (MA)";"MA";"BEQUIMAO";103;19;21;143
2019;"BERNARDO DO MEARIM (MA)";"MA";"BERNARDO DO MEARIM";38;1;4;43
2019;"BOA VISTA DO GURUPI (MA)";"MA";"BOA VISTA DO GURUPI";14;6;3;23
2019;"BOM JARDIM (MA)";"MA";"BOM JARDIM";155;11;10;176
2019;"BOM JESUS DAS SELVAS (MA)";"MA";"BOM JESUS DAS SELVAS";158;7;11;176
2019;"BOM LUGAR (MA)";"MA";"BOM LUGAR";38;14;13;65
2019;"BREJO (MA)";"MA";"BREJO";92;19;14;125
2019;"BREJO DE AREIA (MA)";"MA";"BREJO DE AREIA";27;5;6;38
2019;"BURITI (MA)";"MA";"BURITI";34;14;20;68
2019;"BURITI BRAVO (MA)";"MA";"BURITI BRAVO";52;6;9;67
2019;"BURITICUPU (MA)";"MA";"BURITICUPU";506;57;24;587
2019;"BURITIRANA (MA)";"MA";"BURITIRANA";39;7;3;49
2019;"CACHOEIRA GRANDE (MA)";"MA";"CACHOEIRA GRANDE";10;2;11;23
2019;"CAJAPIO (MA)";"MA";"CAJAPIO";10;2;4;16
2019;"CAJARI (MA)";"MA";"CAJARI";12;3;6;21
2019;"CAMPESTRE DO MARANHAO (MA)";"MA";"CAMPESTRE DO MARANHAO";50;19;43;112
2019;"CANDIDO MENDES (MA)";"MA";"CANDIDO MENDES";17;7;3;27
2019;"CANTANHEDE (MA)";"MA";"CANTANHEDE";29;4;9;42
2019;"CAPINZAL DO NORTE (MA)";"MA";"CAPINZAL DO NORTE";40;22;4;66
2019;"CAROLINA (MA)";"MA";"CAROLINA";110;11;14;135
2019;"CARUTAPERA (MA)";"MA";"CARUTAPERA";49;24;14;87
2019;"CAXIAS (MA)";"MA";"CAXIAS";944;90;191;1225
2019;"CEDRAL (MA)";"MA";"CEDRAL";16;0;8;24
2019;"CENTRAL DO MARANHAO (MA)";"MA";"CENTRAL DO MARANHAO";13;5;4;22
2019;"CENTRO DO GUILHERME (MA)";"MA";"CENTRO DO GUILHERME";24;0;6;30
2019;"CENTRO NOVO DO MARANHAO (MA)";"MA";"CENTRO NOVO DO MARANHAO";42;2;11;55
2019;"CHAPADINHA (MA)";"MA";"CHAPADINHA";409;32;27;468
2019;"CIDELANDIA (MA)";"MA";"CIDELANDIA";67;8;16;91
2019;"CODO (MA)";"MA";"CODO";735;30;56;821
2019;"COELHO NETO (MA)";"MA";"COELHO NETO";126;22;50;198
2019;"COLINAS (MA)";"MA";"COLINAS";199;29;26;254
2019;"CONCEICAO DO LAGO ACU (MA)";"MA";"CONCEICAO DO LAGO ACU";32;5;1;38
2019;"COROATA (MA)";"MA";"COROATA";238;64;32;334
2019;"CURURUPU (MA)";"MA";"CURURUPU";46;16;14;76
2019;"DAVINOPOLIS (MA)";"MA";"DAVINOPOLIS";103;3;6;112
2019;"DOM PEDRO (MA)";"MA";"DOM PEDRO";450;10;41;501
2019;"DUQUE BACELAR (MA)";"MA";"DUQUE BACELAR";6;3;9;18
2019;"ESPERANTINOPOLIS (MA)";"MA";"ESPERANTINOPOLIS";90;26;5;121
2019;"ESTREITO (MA)";"MA";"ESTREITO";268;26;35;329
2019;"FEIRA NOVA DO MARANHAO (MA)";"MA";"FEIRA NOVA DO MARANHAO";26;2;8;36
2019;"FERNANDO FALCAO (MA)";"MA";"FERNANDO FALCAO";23;1;10;34
2019;"FORMOSA DA SERRA NEGRA (MA)";"MA";"FORMOSA DA SERRA NEGRA";57;6;8;71
2019;"FORTALEZA DOS NOGUEIRAS (MA)";"MA";"FORTALEZA DOS NOGUEIRAS";108;14;11;133
2019;"FORTUNA (MA)";"MA";"FORTUNA";48;21;4;73
2019;"GODOFREDO VIANA (MA)";"MA";"GODOFREDO VIANA";11;13;11;35
2019;"GONCALVES DIAS (MA)";"MA";"GONCALVES DIAS";74;9;15;98
2019;"GOVERNADOR ARCHER (MA)";"MA";"GOVERNADOR ARCHER";32;12;9;53
2019;"GOVERNADOR EDISON LOBAO (MA)";"MA";"GOVERNADOR EDISON LOBAO";106;0;26;132
2019;"GOVERNADOR EUGENIO BARROS (MA)";"MA";"GOVERNADOR EUGENIO BARROS";53;13;21;87
2019;"GOVERNADOR LUIZ ROCHA (MA)";"MA";"GOVERNADOR LUIZ ROCHA";22;4;5;31
2019;"GOVERNADOR NEWTON BELLO (MA)";"MA";"GOVERNADOR NEWTON BELLO";20;1;2;23
2019;"GOVERNADOR NUNES FREIRE (MA)";"MA";"GOVERNADOR NUNES FREIRE";119;9;7;135
2019;"GRACA ARANHA (MA)";"MA";"GRACA ARANHA";17;6;4;27
2019;"GRAJAU (MA)";"MA";"GRAJAU";577;50;69;696
2019;"GUIMARAES (MA)";"MA";"GUIMARAES";19;4;17;40
2019;"HUMBERTO DE CAMPOS (MA)";"MA";"HUMBERTO DE CAMPOS";24;13;9;46
2019;"ICATU (MA)";"MA";"ICATU";31;4;15;50
2019;"IGARAPE DO MEIO (MA)";"MA";"IGARAPE DO MEIO";44;8;10;62
2019;"IGARAPE GRANDE (MA)";"MA";"IGARAPE GRANDE";70;12;8;90
2019;"IMPERATRIZ (MA)";"MA";"IMPERATRIZ";4572;328;596;5496
2019;"ITAIPAVA DO GRAJAU (MA)";"MA";"ITAIPAVA DO GRAJAU";31;7;9;47
2019;"ITAPECURU MIRIM (MA)";"MA";"ITAPECURU MIRIM";410;40;42;492
2019;"ITINGA DO MARANHAO (MA)";"MA";"ITINGA DO MARANHAO";177;9;19;205
2019;"JATOBA (MA)";"MA";"JATOBA";7;5;20;32
2019;"JENIPAPO DOS VIEIRAS (MA)";"MA";"JENIPAPO DOS VIEIRAS";66;6;12;84
2019;"JOAO LISBOA (MA)";"MA";"JOAO LISBOA";157;12;15;184
2019;"JOSELANDIA (MA)";"MA";"JOSELANDIA";81;18;8;107
2019;"JUNCO DO MARANHAO (MA)";"MA";"JUNCO DO MARANHAO";16;13;6;35
2019;"LAGO DA PEDRA (MA)";"MA";"LAGO DA PEDRA";299;60;23;382
2019;"LAGO DO JUNCO (MA)";"MA";"LAGO DO JUNCO";18;2;13;33
2019;"LAGO DOS RODRIGUES (MA)";"MA";"LAGO DOS RODRIGUES";54;12;8;74
2019;"LAGO VERDE (MA)";"MA";"LAGO VERDE";36;0;11;47
2019;"LAGOA DO MATO (MA)";"MA";"LAGOA DO MATO";29;1;12;42
2019;"LAGOA GRANDE DO MARANHAO (MA)";"MA";"LAGOA GRANDE DO MARANHAO";38;1;3;42
2019;"LAJEADO NOVO (MA)";"MA";"LAJEADO NOVO";26;9;5;40
2019;"LIMA CAMPOS (MA)";"MA";"LIMA CAMPOS";102;38;13;153
2019;"LORETO (MA)";"MA";"LORETO";31;10;11;52
2019;"LUIS DOMINGUES (MA)";"MA";"LUIS DOMINGUES";6;2;4;12
2019;"MAGALHAES DE ALMEIDA (MA)";"MA";"MAGALHAES DE ALMEIDA";19;2;13;34
2019;"MARACACUME (MA)";"MA";"MARACACUME";87;58;9;154
2019;"MARAJA DO SENA (MA)";"MA";"MARAJA DO SENA";14;0;2;16
2019;"MARANHAOZINHO (MA)";"MA";"MARANHAOZINHO";56;2;3;61
2019;"MATA ROMA (MA)";"MA";"MATA ROMA";61;7;24;92
2019;"MATINHA (MA)";"MA";"MATINHA";59;24;12;95
2019;"MATOES (MA)";"MA";"MATOES";48;9;27;84
2019;"MATOES DO NORTE (MA)";"MA";"MATOES DO NORTE";22;5;6;33
2019;"MILAGRES DO MARANHAO (MA)";"MA";"MILAGRES DO MARANHAO";11;3;10;24
2019;"MIRADOR (MA)";"MA";"MIRADOR";52;6;5;63
2019;"MIRANDA DO NORTE (MA)";"MA";"MIRANDA DO NORTE";158;8;15;181
2019;"MIRINZAL (MA)";"MA";"MIRINZAL";52;7;8;67
2019;"MONCAO (MA)";"MA";"MONCAO";37;7;17;61
2019;"MONTES ALTOS (MA)";"MA";"MONTES ALTOS";43;1;3;47
2019;"MORROS (MA)";"MA";"MORROS";28;5;9;42
2019;"NINA RODRIGUES (MA)";"MA";"NINA RODRIGUES";16;3;8;27
2019;"NOVA COLINAS (MA)";"MA";"NOVA COLINAS";24;4;12;40
2019;"NOVA IORQUE (MA)";"MA";"NOVA IORQUE";16;2;2;20
2019;"NOVA OLINDA DO MARANHAO (MA)";"MA";"NOVA OLINDA DO MARANHAO";70;14;8;92
2019;"OLHO D AGUA DAS CUNHAS (MA)";"MA";"OLHO D AGUA DAS CUNHAS";75;14;17;106
2019;"OLINDA NOVA DO MARANHAO (MA)";"MA";"OLINDA NOVA DO MARANHAO";47;5;11;63
2019;"PACO DO LUMIAR (MA)";"MA";"PACO DO LUMIAR";520;132;189;841
2019;"PALMEIRANDIA (MA)";"MA";"PALMEIRANDIA";22;2;11;35
2019;"PARAIBANO (MA)";"MA";"PARAIBANO";99;23;7;129
2019;"PARNARAMA (MA)";"MA";"PARNARAMA";54;4;13;71
2019;"PASSAGEM FRANCA (MA)";"MA";"PASSAGEM FRANCA";56;7;7;70
2019;"PASTOS BONS (MA)";"MA";"PASTOS BONS";153;13;10;176
2019;"PAULINO NEVES (MA)";"MA";"PAULINO NEVES";5;3;12;20
2019;"PAULO RAMOS (MA)";"MA";"PAULO RAMOS";84;11;7;102
2019;"PEDREIRAS (MA)";"MA";"PEDREIRAS";400;86;46;532
2019;"PEDRO DO ROSARIO (MA)";"MA";"PEDRO DO ROSARIO";25;1;10;36
2019;"PENALVA (MA)";"MA";"PENALVA";44;4;4;52
2019;"PERI MIRIM (MA)";"MA";"PERI MIRIM";27;11;12;50
2019;"PERITORO (MA)";"MA";"PERITORO";64;83;14;161
2019;"PINDARE MIRIM (MA)";"MA";"PINDARE MIRIM";98;22;22;142
2019;"PINHEIRO (MA)";"MA";"PINHEIRO";526;52;109;687
2019;"PIO XII (MA)";"MA";"PIO XII";120;9;9;138
2019;"PIRAPEMAS (MA)";"MA";"PIRAPEMAS";26;5;4;35
2019;"POCAO DE PEDRAS (MA)";"MA";"POCAO DE PEDRAS";64;18;7;89
2019;"PORTO FRANCO (MA)";"MA";"PORTO FRANCO";146;20;17;183
2019;"PORTO RICO DO MARANHAO (MA)";"MA";"PORTO RICO DO MARANHAO";5;2;3;10
2019;"PRESIDENTE DUTRA (MA)";"MA";"PRESIDENTE DUTRA";550;42;30;622
2019;"PRESIDENTE JUSCELINO (MA)";"MA";"PRESIDENTE JUSCELINO";12;3;4;19
2019;"PRESIDENTE MEDICI (MA)";"MA";"PRESIDENTE MEDICI";15;6;3;24
2019;"PRESIDENTE SARNEY (MA)";"MA";"PRESIDENTE SARNEY";17;9;11;37
2019;"PRESIDENTE VARGAS (MA)";"MA";"PRESIDENTE VARGAS";24;5;6;35
2019;"PRIMEIRA CRUZ (MA)";"MA";"PRIMEIRA CRUZ";2;2;5;9
2019;"RAPOSA (MA)";"MA";"RAPOSA";139;8;59;206
2019;"RIACHAO (MA)";"MA";"RIACHAO";121;13;25;159
2019;"RIBAMAR FIQUENE (MA)";"MA";"RIBAMAR FIQUENE";35;4;6;45
2019;"ROSARIO (MA)";"MA";"ROSARIO";236;28;53;317
2019;"SAMBAIBA (MA)";"MA";"SAMBAIBA";27;7;10;44
2019;"SANTA FILOMENA DO MARANHAO (MA)";"MA";"SANTA FILOMENA DO MARANHAO";11;5;6;22
2019;"SANTA HELENA (MA)";"MA";"SANTA HELENA";109;15;22;146
2019;"SANTA INES (MA)";"MA";"SANTA INES";890;171;119;1180
2019;"SANTA LUZIA (MA)";"MA";"SANTA LUZIA";312;95;15;422
2019;"SANTA LUZIA DO PARUA (MA)";"MA";"SANTA LUZIA DO PARUA";136;19;13;168
2019;"SANTA QUITERIA DO MARANHAO (MA)";"MA";"SANTA QUITERIA DO MARANHAO";53;6;22;81
2019;"SANTA RITA (MA)";"MA";"SANTA RITA";191;12;22;225
2019;"SANTANA DO MARANHAO (MA)";"MA";"SANTANA DO MARANHAO";13;2;9;24
2019;"SANTO AMARO DO MARANHAO (MA)";"MA";"SANTO AMARO DO MARANHAO";6;4;5;15
2019;"SANTO ANTONIO DOS LOPES (MA)";"MA";"SANTO ANTONIO DOS LOPES";145;15;13;173
2019;"SAO BENEDITO DO RIO PRETO (MA)";"MA";"SAO BENEDITO DO RIO PRETO";25;8;6;39
2019;"SAO BENTO (MA)";"MA";"SAO BENTO";172;47;25;244
2019;"SAO BERNARDO (MA)";"MA";"SAO BERNARDO";87;7;25;119
2019;"SAO DOMINGOS DO AZEITAO (MA)";"MA";"SAO DOMINGOS DO AZEITAO";63;6;4;73
2019;"SAO DOMINGOS DO MARANHAO (MA)";"MA";"SAO DOMINGOS DO MARANHAO";299;9;25;333
2019;"SAO FELIX DE BALSAS (MA)";"MA";"SAO FELIX DE BALSAS";8;3;2;13
2019;"SAO FRANCISCO DO BREJAO (MA)";"MA";"SAO FRANCISCO DO BREJAO";67;4;10;81
2019;"SAO FRANCISCO DO MARANHAO (MA)";"MA";"SAO FRANCISCO DO MARANHAO";10;0;2;12
2019;"SAO JOAO BATISTA (MA)";"MA";"SAO JOAO BATISTA";35;7;12;54
2019;"SAO JOAO DO CARU (MA)";"MA";"SAO JOAO DO CARU";36;2;3;41
2019;"SAO JOAO DO PARAISO (MA)";"MA";"SAO JOAO DO PARAISO";47;4;11;62
2019;"SAO JOAO DO SOTER (MA)";"MA";"SAO JOAO DO SOTER";34;5;14;53
2019;"SAO JOAO DOS PATOS (MA)";"MA";"SAO JOAO DOS PATOS";222;18;10;250
2019;"SAO JOSE DE RIBAMAR (MA)";"MA";"SAO JOSE DE RIBAMAR";920;174;378;1472
2019;"SAO JOSE DOS BASILIOS (MA)";"MA";"SAO JOSE DOS BASILIOS";18;4;6;28
2019;"SAO LUIS (MA)";"MA";"SAO LUIS";10709;1426;4535;16670
2019;"SAO LUIS GONZAGA DO MARANHAO (MA)";"MA";"SAO LUIS GONZAGA DO MARANHAO";41;10;10;61
2019;"SAO MATEUS DO MARANHAO (MA)";"MA";"SAO MATEUS DO MARANHAO";136;48;27;211
2019;"SAO PEDRO DA AGUA BRANCA (MA)";"MA";"SAO PEDRO DA AGUA BRANCA";24;9;9;42
2019;"SAO PEDRO DOS CRENTES (MA)";"MA";"SAO PEDRO DOS CRENTES";59;1;7;67
2019;"SAO RAIMUNDO DAS MANGABEIRAS (MA)";"MA";"SAO RAIMUNDO DAS MANGABEIRAS";179;14;57;250
2019;"SAO RAIMUNDO DO DOCA BEZERRA (MA)";"MA";"SAO RAIMUNDO DO DOCA BEZERRA";20;4;2;26
2019;"SAO ROBERTO (MA)";"MA";"SAO ROBERTO";16;5;4;25
2019;"SAO VICENTE FERRER (MA)";"MA";"SAO VICENTE FERRER";41;2;5;48
2019;"SATUBINHA (MA)";"MA";"SATUBINHA";20;6;2;28
2019;"SENADOR ALEXANDRE COSTA (MA)";"MA";"SENADOR ALEXANDRE COSTA";30;10;9;49
2019;"SENADOR LA ROCQUE (MA)";"MA";"SENADOR LA ROCQUE";95;5;5;105
2019;"SERRANO DO MARANHAO (MA)";"MA";"SERRANO DO MARANHAO";6;3;8;17
2019;"SITIO NOVO (MA)";"MA";"SITIO NOVO";90;5;11;106
2019;"SUCUPIRA DO NORTE (MA)";"MA";"SUCUPIRA DO NORTE";33;3;6;42
2019;"SUCUPIRA DO RIACHAO (MA)";"MA";"SUCUPIRA DO RIACHAO";12;9;6;27
2019;"TASSO FRAGOSO (MA)";"MA";"TASSO FRAGOSO";87;8;7;102
2019;"TIMBIRAS (MA)";"MA";"TIMBIRAS";46;3;10;59
2019;"TIMON (MA)";"MA";"TIMON";741;54;171;966
2019;"TRIZIDELA DO VALE (MA)";"MA";"TRIZIDELA DO VALE";176;37;15;228
2019;"TUFILANDIA (MA)";"MA";"TUFILANDIA";11;4;1;16
2019;"TUNTUM (MA)";"MA";"TUNTUM";157;14;21;192
2019;"TURIACU (MA)";"MA";"TURIACU";49;5;8;62
2019;"TURILANDIA (MA)";"MA";"TURILANDIA";17;5;4;26
2019;"TUTOIA (MA)";"MA";"TUTOIA";96;27;27;150
2019;"URBANO SANTOS (MA)";"MA";"URBANO SANTOS";96;13;27;136
2019;"VARGEM GRANDE (MA)";"MA";"VARGEM GRANDE";156;9;19;184
2019;"VIANA (MA)";"MA";"VIANA";230;12;11;253
2019;"VILA NOVA DOS MARTIRIOS (MA)";"MA";"VILA NOVA DOS MARTIRIOS";55;8;9;72
2019;"VITORIA DO MEARIM (MA)";"MA";"VITORIA DO MEARIM";118;9;12;139
2019;"VITORINO FREIRE (MA)";"MA";"VITORINO FREIRE";138;15;29;182
2019;"ZE DOCA (MA)";"MA";"ZE DOCA";270;27;53;350
2019;"ABADIA DOS DOURADOS (MG)";"MG";"ABADIA DOS DOURADOS";199;38;20;257
2019;"ABAETE (MG)";"MG";"ABAETE";504;51;200;755
2019;"ABRE CAMPO (MG)";"MG";"ABRE CAMPO";255;18;55;328
2019;"ACAIACA (MG)";"MG";"ACAIACA";41;9;14;64
2019;"ACUCENA (MG)";"MG";"ACUCENA";53;18;48;119
2019;"AGUA BOA (MG)";"MG";"AGUA BOA";86;17;45;148
2019;"AGUA COMPRIDA (MG)";"MG";"AGUA COMPRIDA";40;12;13;65
2019;"AGUANIL (MG)";"MG";"AGUANIL";84;9;10;103
2019;"AGUAS FORMOSAS (MG)";"MG";"AGUAS FORMOSAS";125;32;51;208
2019;"AGUAS VERMELHAS (MG)";"MG";"AGUAS VERMELHAS";98;31;37;166
2019;"AIMORES (MG)";"MG";"AIMORES";207;41;48;296
2019;"AIURUOCA (MG)";"MG";"AIURUOCA";123;28;12;163
2019;"ALAGOA (MG)";"MG";"ALAGOA";42;2;20;64
2019;"ALBERTINA (MG)";"MG";"ALBERTINA";61;25;8;94
2019;"ALEM PARAIBA (MG)";"MG";"ALEM PARAIBA";1658;137;77;1872
2019;"ALFENAS (MG)";"MG";"ALFENAS";1396;167;266;1829
2019;"ALFREDO VASCONCELOS (MG)";"MG";"ALFREDO VASCONCELOS";188;18;36;242
2019;"ALMENARA (MG)";"MG";"ALMENARA";326;99;171;596
2019;"ALPERCATA (MG)";"MG";"ALPERCATA";89;5;8;102
2019;"ALPINOPOLIS (MG)";"MG";"ALPINOPOLIS";549;50;109;708
2019;"ALTEROSA (MG)";"MG";"ALTEROSA";323;34;63;420
2019;"ALTO CAPARAO (MG)";"MG";"ALTO CAPARAO";91;23;25;139
2019;"ALTO JEQUITIBA (MG)";"MG";"ALTO JEQUITIBA";115;9;20;144
2019;"ALTO RIO DOCE (MG)";"MG";"ALTO RIO DOCE";148;31;37;216
2019;"ALVARENGA (MG)";"MG";"ALVARENGA";47;7;21;75
2019;"ALVINOPOLIS (MG)";"MG";"ALVINOPOLIS";245;25;28;298
2019;"ALVORADA DE MINAS (MG)";"MG";"ALVORADA DE MINAS";29;22;24;75
2019;"AMPARO DA SERRA (MG)";"MG";"AMPARO DA SERRA";58;5;50;113
2019;"ANDRADAS (MG)";"MG";"ANDRADAS";1178;132;122;1432
2019;"ANDRELANDIA (MG)";"MG";"ANDRELANDIA";168;38;29;235
2019;"ANGELANDIA (MG)";"MG";"ANGELANDIA";98;14;38;150
2019;"ANTONIO CARLOS (MG)";"MG";"ANTONIO CARLOS";200;32;49;281
2019;"ANTONIO DIAS (MG)";"MG";"ANTONIO DIAS";138;22;72;232
2019;"ANTONIO PRADO DE MINAS (MG)";"MG";"ANTONIO PRADO DE MINAS";19;8;5;32
2019;"ARACAI (MG)";"MG";"ARACAI";17;9;9;35
2019;"ARACITABA (MG)";"MG";"ARACITABA";13;4;5;22
2019;"ARACUAI (MG)";"MG";"ARACUAI";299;28;148;475
2019;"ARAGUARI (MG)";"MG";"ARAGUARI";2595;521;269;3385
2019;"ARANTINA (MG)";"MG";"ARANTINA";54;6;3;63
2019;"ARAPONGA (MG)";"MG";"ARAPONGA";81;8;20;109
2019;"ARAPORA (MG)";"MG";"ARAPORA";275;22;70;367
2019;"ARAPUA (MG)";"MG";"ARAPUA";65;5;21;91
2019;"ARAUJOS (MG)";"MG";"ARAUJOS";163;13;13;189
2019;"ARAXA (MG)";"MG";"ARAXA";1884;267;387;2538
2019;"ARCEBURGO (MG)";"MG";"ARCEBURGO";193;27;77;297
2019;"ARCOS (MG)";"MG";"ARCOS";1361;119;305;1785
2019;"AREADO (MG)";"MG";"AREADO";272;30;95;397
2019;"ARGIRITA (MG)";"MG";"ARGIRITA";29;6;10;45
2019;"ARICANDUVA (MG)";"MG";"ARICANDUVA";29;4;18;51
2019;"ARINOS (MG)";"MG";"ARINOS";388;36;144;568
2019;"ASTOLFO DUTRA (MG)";"MG";"ASTOLFO DUTRA";269;8;27;304
2019;"ATALEIA (MG)";"MG";"ATALEIA";103;32;49;184
2019;"AUGUSTO DE LIMA (MG)";"MG";"AUGUSTO DE LIMA";37;5;20;62
2019;"BAEPENDI (MG)";"MG";"BAEPENDI";449;76;35;560
2019;"BALDIM (MG)";"MG";"BALDIM";211;10;26;247
2019;"BAMBUI (MG)";"MG";"BAMBUI";596;68;101;765
2019;"BANDEIRA (MG)";"MG";"BANDEIRA";23;11;17;51
2019;"BANDEIRA DO SUL (MG)";"MG";"BANDEIRA DO SUL";132;20;16;168
2019;"BARAO DE COCAIS (MG)";"MG";"BARAO DE COCAIS";544;103;151;798
2019;"BARAO D0 MONTE ALTO (MG)";"MG";"BARAO D0 MONTE ALTO";61;7;15;83
2019;"BARBACENA (MG)";"MG";"BARBACENA";1897;334;227;2458
2019;"BARRA LONGA (MG)";"MG";"BARRA LONGA";45;5;17;67
2019;"BARROSO (MG)";"MG";"BARROSO";446;37;40;523
2019;"BELA VISTA DE MINAS (MG)";"MG";"BELA VISTA DE MINAS";187;15;19;221
2019;"BELMIRO BRAGA (MG)";"MG";"BELMIRO BRAGA";89;13;11;113
2019;"BELO HORIZONTE (MG)";"MG";"BELO HORIZONTE";36293;6628;9420;52341
2019;"BELO ORIENTE (MG)";"MG";"BELO ORIENTE";275;38;106;419
2019;"BELO VALE (MG)";"MG";"BELO VALE";341;28;32;401
2019;"BERILO (MG)";"MG";"BERILO";91;16;49;156
2019;"BERIZAL (MG)";"MG";"BERIZAL";47;10;14;71
2019;"BERTOPOLIS (MG)";"MG";"BERTOPOLIS";12;7;9;28
2019;"BETIM (MG)";"MG";"BETIM";6029;817;1305;8151
2019;"BIAS FORTES (MG)";"MG";"BIAS FORTES";37;2;7;46
2019;"BICAS (MG)";"MG";"BICAS";252;37;45;334
2019;"BIQUINHAS (MG)";"MG";"BIQUINHAS";66;9;6;81
2019;"BOA ESPERANCA (MG)";"MG";"BOA ESPERANCA";854;139;233;1226
2019;"BOCAINA DE MINAS (MG)";"MG";"BOCAINA DE MINAS";132;19;17;168
2019;"BOCAIUVA (MG)";"MG";"BOCAIUVA";636;88;247;971
2019;"BOM DESPACHO (MG)";"MG";"BOM DESPACHO";1231;95;490;1816
2019;"BOM JARDIM DE MINAS (MG)";"MG";"BOM JARDIM DE MINAS";171;20;24;215
2019;"BOM JESUS DA PENHA (MG)";"MG";"BOM JESUS DA PENHA";178;23;19;220
2019;"BOM JESUS DO AMPARO (MG)";"MG";"BOM JESUS DO AMPARO";100;13;22;135
2019;"BOM JESUS DO GALHO (MG)";"MG";"BOM JESUS DO GALHO";124;10;28;162
2019;"BOM REPOUSO (MG)";"MG";"BOM REPOUSO";209;12;25;246
2019;"BOM SUCESSO (MG)";"MG";"BOM SUCESSO";228;27;69;324
2019;"BONFIM (MG)";"MG";"BONFIM";170;17;25;212
2019;"BONFINOPOLIS DE MINAS (MG)";"MG";"BONFINOPOLIS DE MINAS";111;6;36;153
2019;"BONITO DE MINAS (MG)";"MG";"BONITO DE MINAS";58;10;38;106
2019;"BORDA DA MATA (MG)";"MG";"BORDA DA MATA";300;43;71;414
2019;"BOTELHOS (MG)";"MG";"BOTELHOS";272;95;53;420
2019;"BOTUMIRIM (MG)";"MG";"BOTUMIRIM";43;15;36;94
2019;"BRAS PIRES (MG)";"MG";"BRAS PIRES";79;12;14;105
2019;"BRASILANDIA DE MINAS (MG)";"MG";"BRASILANDIA DE MINAS";263;26;174;463
2019;"BRASILIA DE MINAS (MG)";"MG";"BRASILIA DE MINAS";337;34;109;480
2019;"BRASOPOLIS (MG)";"MG";"BRASOPOLIS";248;46;52;346
2019;"BRAUNAS (MG)";"MG";"BRAUNAS";29;10;24;63
2019;"BRUMADINHO (MG)";"MG";"BRUMADINHO";1079;138;301;1518
2019;"BUENO BRANDAO (MG)";"MG";"BUENO BRANDAO";247;48;28;323
2019;"BUENOPOLIS (MG)";"MG";"BUENOPOLIS";121;19;41;181
2019;"BUGRE (MG)";"MG";"BUGRE";31;3;13;47
2019;"BURITIS (MG)";"MG";"BURITIS";351;20;126;497
2019;"BURITIZEIRO (MG)";"MG";"BURITIZEIRO";301;46;147;494
2019;"CABECEIRA GRANDE (MG)";"MG";"CABECEIRA GRANDE";71;11;15;97
2019;"CABO VERDE (MG)";"MG";"CABO VERDE";208;54;53;315
2019;"CACHOEIRA DA PRATA (MG)";"MG";"CACHOEIRA DA PRATA";64;4;9;77
2019;"CACHOEIRA DE MINAS (MG)";"MG";"CACHOEIRA DE MINAS";152;35;24;211
2019;"CACHOEIRA DE PAJEU (MG)";"MG";"CACHOEIRA DE PAJEU";42;23;21;86
2019;"CACHOEIRA DOURADA (MG)";"MG";"CACHOEIRA DOURADA";18;15;5;38
2019;"CAETANOPOLIS (MG)";"MG";"CAETANOPOLIS";179;22;56;257
2019;"CAETE (MG)";"MG";"CAETE";633;136;77;846
2019;"CAIANA (MG)";"MG";"CAIANA";61;12;12;85
2019;"CAJURI (MG)";"MG";"CAJURI";85;7;14;106
2019;"CALDAS (MG)";"MG";"CALDAS";333;60;36;429
2019;"CAMACHO (MG)";"MG";"CAMACHO";55;9;35;99
2019;"CAMANDUCAIA (MG)";"MG";"CAMANDUCAIA";542;54;72;668
2019;"CAMBUI (MG)";"MG";"CAMBUI";720;90;114;924
2019;"CAMBUQUIRA (MG)";"MG";"CAMBUQUIRA";185;45;44;274
2019;"CAMPANARIO (MG)";"MG";"CAMPANARIO";22;5;6;33
2019;"CAMPANHA (MG)";"MG";"CAMPANHA";321;68;68;457
2019;"CAMPESTRE (MG)";"MG";"CAMPESTRE";611;74;83;768
2019;"CAMPINA VERDE (MG)";"MG";"CAMPINA VERDE";281;55;58;394
2019;"CAMPO AZUL (MG)";"MG";"CAMPO AZUL";14;3;14;31
2019;"CAMPO BELO (MG)";"MG";"CAMPO BELO";1407;99;138;1644
2019;"CAMPO DO MEIO (MG)";"MG";"CAMPO DO MEIO";162;22;85;269
2019;"CAMPO FLORIDO (MG)";"MG";"CAMPO FLORIDO";231;44;84;359
2019;"CAMPOS ALTOS (MG)";"MG";"CAMPOS ALTOS";400;57;119;576
2019;"CAMPOS GERAIS (MG)";"MG";"CAMPOS GERAIS";489;48;166;703
2019;"CANA VERDE (MG)";"MG";"CANA VERDE";94;5;21;120
2019;"CANAA (MG)";"MG";"CANAA";69;5;10;84
2019;"CANAPOLIS (MG)";"MG";"CANAPOLIS";290;19;99;408
2019;"CANDEIAS (MG)";"MG";"CANDEIAS";309;45;62;416
2019;"CANTAGALO (MG)";"MG";"CANTAGALO";37;5;11;53
2019;"CAPARAO (MG)";"MG";"CAPARAO";83;5;17;105
2019;"CAPELA NOVA (MG)";"MG";"CAPELA NOVA";34;17;9;60
2019;"CAPELINHA (MG)";"MG";"CAPELINHA";874;62;219;1155
2019;"CAPETINGA (MG)";"MG";"CAPETINGA";216;32;46;294
2019;"CAPIM BRANCO (MG)";"MG";"CAPIM BRANCO";103;24;13;140
2019;"CAPINOPOLIS (MG)";"MG";"CAPINOPOLIS";315;39;81;435
2019;"CAPITAO ANDRADE (MG)";"MG";"CAPITAO ANDRADE";62;9;11;82
2019;"CAPITAO ENEAS (MG)";"MG";"CAPITAO ENEAS";113;6;36;155
2019;"CAPITOLIO (MG)";"MG";"CAPITOLIO";187;38;40;265
2019;"CAPUTIRA (MG)";"MG";"CAPUTIRA";150;19;61;230
2019;"CARAI (MG)";"MG";"CARAI";100;68;67;235
2019;"CARANAIBA (MG)";"MG";"CARANAIBA";26;15;19;60
2019;"CARANDAI (MG)";"MG";"CARANDAI";681;92;127;900
2019;"CARANGOLA (MG)";"MG";"CARANGOLA";446;68;83;597
2019;"CARATINGA (MG)";"MG";"CARATINGA";1492;132;525;2149
2019;"CARBONITA (MG)";"MG";"CARBONITA";184;20;57;261
2019;"CAREACU (MG)";"MG";"CAREACU";133;10;20;163
2019;"CARLOS CHAGAS (MG)";"MG";"CARLOS CHAGAS";173;47;61;281
2019;"CARMESIA (MG)";"MG";"CARMESIA";82;4;1305;1391
2019;"CARMO DA CACHOEIRA (MG)";"MG";"CARMO DA CACHOEIRA";198;53;62;313
2019;"CARMO DA MATA (MG)";"MG";"CARMO DA MATA";152;31;63;246
2019;"CARMO DE MINAS (MG)";"MG";"CARMO DE MINAS";163;54;40;257
2019;"CARMO DO CAJURU (MG)";"MG";"CARMO DO CAJURU";479;70;117;666
2019;"CARMO DO PARANAIBA (MG)";"MG";"CARMO DO PARANAIBA";792;94;139;1025
2019;"CARMO DO RIO CLARO (MG)";"MG";"CARMO DO RIO CLARO";458;36;107;601
2019;"CARMOPOLIS DE MINAS (MG)";"MG";"CARMOPOLIS DE MINAS";645;87;84;816
2019;"CARNEIRINHO (MG)";"MG";"CARNEIRINHO";200;25;81;306
2019;"CARRANCAS (MG)";"MG";"CARRANCAS";59;16;12;87
2019;"CARVALHOPOLIS (MG)";"MG";"CARVALHOPOLIS";53;15;12;80
2019;"CARVALHOS (MG)";"MG";"CARVALHOS";93;13;12;118
2019;"CASA GRANDE (MG)";"MG";"CASA GRANDE";49;2;8;59
2019;"CASCALHO RICO (MG)";"MG";"CASCALHO RICO";62;28;6;96
2019;"CASSIA (MG)";"MG";"CASSIA";493;72;86;651
2019;"CATAGUASES (MG)";"MG";"CATAGUASES";898;109;183;1190
2019;"CATAS ALTAS (MG)";"MG";"CATAS ALTAS";140;25;10;175
2019;"CATAS ALTAS DA NORUEGA (MG)";"MG";"CATAS ALTAS DA NORUEGA";62;5;14;81
2019;"CATUJI (MG)";"MG";"CATUJI";50;26;30;106
2019;"CATUTI (MG)";"MG";"CATUTI";45;8;33;86
2019;"CAXAMBU (MG)";"MG";"CAXAMBU";243;55;34;332
2019;"CEDRO DO ABAETE (MG)";"MG";"CEDRO DO ABAETE";11;2;4;17
2019;"CENTRAL DE MINAS (MG)";"MG";"CENTRAL DE MINAS";104;8;23;135
2019;"CENTRALINA (MG)";"MG";"CENTRALINA";154;8;23;185
2019;"CHACARA (MG)";"MG";"CHACARA";51;5;21;77
2019;"CHALE (MG)";"MG";"CHALE";95;13;16;124
2019;"CHAPADA DO NORTE (MG)";"MG";"CHAPADA DO NORTE";55;22;31;108
2019;"CHAPADA GAUCHA (MG)";"MG";"CHAPADA GAUCHA";217;13;70;300
2019;"CHIADOR (MG)";"MG";"CHIADOR";276;30;12;318
2019;"CIPOTANEA (MG)";"MG";"CIPOTANEA";73;9;24;106
2019;"CLARAVAL (MG)";"MG";"CLARAVAL";118;14;26;158
2019;"CLARO DOS POCOES (MG)";"MG";"CLARO DOS POCOES";95;15;55;165
2019;"CLAUDIO (MG)";"MG";"CLAUDIO";964;62;67;1093
2019;"COIMBRA (MG)";"MG";"COIMBRA";146;7;20;173
2019;"COLUNA (MG)";"MG";"COLUNA";69;6;20;95
2019;"COMENDADOR GOMES (MG)";"MG";"COMENDADOR GOMES";57;19;23;99
2019;"COMERCINHO (MG)";"MG";"COMERCINHO";32;16;25;73
2019;"CONCEICAO DA APARECIDA (MG)";"MG";"CONCEICAO DA APARECIDA";198;17;39;254
2019;"CONCEICAO DA BARRA DE MINAS (MG)";"MG";"CONCEICAO DA BARRA DE MINAS";50;19;13;82
2019;"CONCEICAO DAS ALAGOAS (MG)";"MG";"CONCEICAO DAS ALAGOAS";567;64;143;774
2019;"CONCEICAO DAS PEDRAS (MG)";"MG";"CONCEICAO DAS PEDRAS";32;9;11;52
2019;"CONCEICAO DE IPANEMA (MG)";"MG";"CONCEICAO DE IPANEMA";61;12;8;81
2019;"CONCEICAO DO MATO DENTRO (MG)";"MG";"CONCEICAO DO MATO DENTRO";225;61;211;497
2019;"CONCEICAO DO PARA (MG)";"MG";"CONCEICAO DO PARA";91;14;21;126
2019;"CONCEICAO DO RIO VERDE (MG)";"MG";"CONCEICAO DO RIO VERDE";222;82;49;353
2019;"CONCEICAO DOS OUROS (MG)";"MG";"CONCEICAO DOS OUROS";275;23;20;318
2019;"CONEGO MARINHO (MG)";"MG";"CONEGO MARINHO";29;8;28;65
2019;"CONFINS (MG)";"MG";"CONFINS";226;31;47;304
2019;"CONGONHAL (MG)";"MG";"CONGONHAL";314;13;16;343
2019;"CONGONHAS (MG)";"MG";"CONGONHAS";1099;193;165;1457
2019;"CONGONHAS DO NORTE (MG)";"MG";"CONGONHAS DO NORTE";68;4;16;88
2019;"CONQUISTA (MG)";"MG";"CONQUISTA";174;26;43;243
2019;"CONSELHEIRO LAFAIETE (MG)";"MG";"CONSELHEIRO LAFAIETE";1629;388;688;2705
2019;"CONSELHEIRO PENA (MG)";"MG";"CONSELHEIRO PENA";260;14;70;344
2019;"CONSOLACAO (MG)";"MG";"CONSOLACAO";17;7;5;29
2019;"CONTAGEM (MG)";"MG";"CONTAGEM";14600;1713;3016;19329
2019;"COQUEIRAL (MG)";"MG";"COQUEIRAL";144;19;28;191
2019;"CORACAO DE JESUS (MG)";"MG";"CORACAO DE JESUS";245;12;129;386
2019;"CORDISBURGO (MG)";"MG";"CORDISBURGO";115;19;28;162
2019;"CORDISLANDIA (MG)";"MG";"CORDISLANDIA";47;21;10;78
2019;"CORINTO (MG)";"MG";"CORINTO";403;32;104;539
2019;"COROACI (MG)";"MG";"COROACI";94;8;24;126
2019;"COROMANDEL (MG)";"MG";"COROMANDEL";772;121;119;1012
2019;"CORONEL FABRICIANO (MG)";"MG";"CORONEL FABRICIANO";1217;233;590;2040
2019;"CORONEL MURTA (MG)";"MG";"CORONEL MURTA";42;11;20;73
2019;"CORONEL PACHECO (MG)";"MG";"CORONEL PACHECO";33;5;8;46
2019;"CORONEL XAVIER CHAVES (MG)";"MG";"CORONEL XAVIER CHAVES";91;7;4;102
2019;"CORREGO DANTA (MG)";"MG";"CORREGO DANTA";60;3;20;83
2019;"CORREGO DO BOM JESUS (MG)";"MG";"CORREGO DO BOM JESUS";54;11;15;80
2019;"CORREGO FUNDO (MG)";"MG";"CORREGO FUNDO";376;29;36;441
2019;"CORREGO NOVO (MG)";"MG";"CORREGO NOVO";18;4;10;32
2019;"COUTO DE MAGALHAES DE MINAS (MG)";"MG";"COUTO DE MAGALHAES DE MINAS";68;4;14;86
2019;"CRISOLITA (MG)";"MG";"CRISOLITA";16;12;12;40
2019;"CRISTAIS (MG)";"MG";"CRISTAIS";198;29;30;257
2019;"CRISTALIA (MG)";"MG";"CRISTALIA";44;5;32;81
2019;"CRISTIANO OTONI (MG)";"MG";"CRISTIANO OTONI";147;16;31;194
2019;"CRISTINA (MG)";"MG";"CRISTINA";108;29;25;162
2019;"CRUCILANDIA (MG)";"MG";"CRUCILANDIA";169;13;20;202
2019;"CRUZEIRO DA FORTALEZA (MG)";"MG";"CRUZEIRO DA FORTALEZA";120;10;18;148
2019;"CRUZILIA (MG)";"MG";"CRUZILIA";421;44;72;537
2019;"CUPARAQUE (MG)";"MG";"CUPARAQUE";70;7;7;84
2019;"CURRAL DE DENTRO (MG)";"MG";"CURRAL DE DENTRO";78;11;23;112
2019;"CURVELO (MG)";"MG";"CURVELO";1389;90;1517;2996
2019;"DATAS (MG)";"MG";"DATAS";56;6;23;85
2019;"DELFIM MOREIRA (MG)";"MG";"DELFIM MOREIRA";90;14;30;134
2019;"DELFINOPOLIS (MG)";"MG";"DELFINOPOLIS";149;21;28;198
2019;"DELTA (MG)";"MG";"DELTA";533;49;191;773
2019;"DESCOBERTO (MG)";"MG";"DESCOBERTO";41;12;4;57
2019;"DESTERRO DE ENTRE RIOS (MG)";"MG";"DESTERRO DE ENTRE RIOS";147;22;30;199
2019;"DESTERRO DO MELO (MG)";"MG";"DESTERRO DO MELO";47;13;21;81
2019;"DIAMANTINA (MG)";"MG";"DIAMANTINA";485;106;338;929
2019;"DIOGO DE VASCONCELOS (MG)";"MG";"DIOGO DE VASCONCELOS";22;8;12;42
2019;"DIONISIO (MG)";"MG";"DIONISIO";46;6;24;76
2019;"DIVINESIA (MG)";"MG";"DIVINESIA";106;7;13;126
2019;"DIVINO (MG)";"MG";"DIVINO";310;28;60;398
2019;"DIVINO DAS LARANJEIRAS (MG)";"MG";"DIVINO DAS LARANJEIRAS";59;1;10;70
2019;"DIVINOLANDIA DE MINAS (MG)";"MG";"DIVINOLANDIA DE MINAS";98;5;20;123
2019;"DIVINOPOLIS (MG)";"MG";"DIVINOPOLIS";3411;300;779;4490
2019;"DIVISA ALEGRE (MG)";"MG";"DIVISA ALEGRE";73;9;12;94
2019;"DIVISA NOVA (MG)";"MG";"DIVISA NOVA";104;42;49;195
2019;"DIVISOPOLIS (MG)";"MG";"DIVISOPOLIS";72;17;14;103
2019;"DOM BOSCO (MG)";"MG";"DOM BOSCO";31;10;16;57
2019;"DOM CAVATI (MG)";"MG";"DOM CAVATI";173;4;18;195
2019;"DOM JOAQUIM (MG)";"MG";"DOM JOAQUIM";33;8;13;54
2019;"DOM SILVERIO (MG)";"MG";"DOM SILVERIO";80;11;14;105
2019;"DOM VICOSO (MG)";"MG";"DOM VICOSO";36;15;16;67
2019;"DONA EUZEBIA (MG)";"MG";"DONA EUZEBIA";343;5;9;357
2019;"DORES DE CAMPOS (MG)";"MG";"DORES DE CAMPOS";143;30;43;216
2019;"DORES DE GUANHAES (MG)";"MG";"DORES DE GUANHAES";55;8;27;90
2019;"DORES DO INDAIA (MG)";"MG";"DORES DO INDAIA";268;52;27;347
2019;"DORES DO TURVO (MG)";"MG";"DORES DO TURVO";88;4;23;115
2019;"DORESOPOLIS (MG)";"MG";"DORESOPOLIS";15;5;7;27
2019;"DOURADOQUARA (MG)";"MG";"DOURADOQUARA";36;6;4;46
2019;"DURANDE (MG)";"MG";"DURANDE";119;11;33;163
2019;"ELOI MENDES (MG)";"MG";"ELOI MENDES";651;91;65;807
2019;"ENGENHEIRO CALDAS (MG)";"MG";"ENGENHEIRO CALDAS";166;9;20;195
2019;"ENGENHEIRO NAVARRO (MG)";"MG";"ENGENHEIRO NAVARRO";76;9;28;113
2019;"ENTRE FOLHAS (MG)";"MG";"ENTRE FOLHAS";77;3;17;97
2019;"ENTRE RIOS DE MINAS (MG)";"MG";"ENTRE RIOS DE MINAS";319;30;70;419
2019;"ERVALIA (MG)";"MG";"ERVALIA";388;23;93;504
2019;"ESMERALDAS (MG)";"MG";"ESMERALDAS";600;71;333;1004
2019;"ESPERA FELIZ (MG)";"MG";"ESPERA FELIZ";435;43;63;541
2019;"ESPINOSA (MG)";"MG";"ESPINOSA";398;52;136;586
2019;"ESPIRITO SANTO DO DOURADO (MG)";"MG";"ESPIRITO SANTO DO DOURADO";123;8;15;146
2019;"ESTIVA (MG)";"MG";"ESTIVA";311;25;30;366
2019;"ESTRELA DALVA (MG)";"MG";"ESTRELA DALVA";34;5;5;44
2019;"ESTRELA DO INDAIA (MG)";"MG";"ESTRELA DO INDAIA";53;8;7;68
2019;"ESTRELA DO SUL (MG)";"MG";"ESTRELA DO SUL";129;22;22;173
2019;"EUGENOPOLIS (MG)";"MG";"EUGENOPOLIS";164;44;39;247
2019;"EWBANK DA CAMARA (MG)";"MG";"EWBANK DA CAMARA";50;4;6;60
2019;"EXTREMA (MG)";"MG";"EXTREMA";592;157;212;961
2019;"FAMA (MG)";"MG";"FAMA";18;6;2;26
2019;"FARIA LEMOS (MG)";"MG";"FARIA LEMOS";28;9;3;40
2019;"FELICIO DOS SANTOS (MG)";"MG";"FELICIO DOS SANTOS";54;21;33;108
2019;"FELISBURGO (MG)";"MG";"FELISBURGO";28;14;18;60
2019;"FELIXLANDIA (MG)";"MG";"FELIXLANDIA";267;22;68;357
2019;"FERNANDES TOURINHO (MG)";"MG";"FERNANDES TOURINHO";23;10;12;45
2019;"FERROS (MG)";"MG";"FERROS";128;23;60;211
2019;"FERVEDOURO (MG)";"MG";"FERVEDOURO";196;12;23;231
2019;"FLORESTAL (MG)";"MG";"FLORESTAL";145;15;37;197
2019;"FORMIGA (MG)";"MG";"FORMIGA";1837;208;247;2292
2019;"FORMOSO (MG)";"MG";"FORMOSO";62;7;42;111
2019;"FORTALEZA DE MINAS (MG)";"MG";"FORTALEZA DE MINAS";76;21;18;115
2019;"FORTUNA DE MINAS (MG)";"MG";"FORTUNA DE MINAS";38;6;13;57
2019;"FRANCISCO BADARO (MG)";"MG";"FRANCISCO BADARO";57;11;39;107
2019;"FRANCISCO DUMONT (MG)";"MG";"FRANCISCO DUMONT";86;8;40;134
2019;"FRANCISCO SA (MG)";"MG";"FRANCISCO SA";295;28;142;465
2019;"FRANCISCOPOLIS (MG)";"MG";"FRANCISCOPOLIS";23;10;21;54
2019;"FREI GASPAR (MG)";"MG";"FREI GASPAR";33;10;19;62
2019;"FREI INOCENCIO (MG)";"MG";"FREI INOCENCIO";99;9;30;138
2019;"FREI LAGONEGRO (MG)";"MG";"FREI LAGONEGRO";13;2;16;31
2019;"FRONTEIRA (MG)";"MG";"FRONTEIRA";266;43;99;408
2019;"FRONTEIRA DOS VALES (MG)";"MG";"FRONTEIRA DOS VALES";15;7;7;29
2019;"FRUTA DE LEITE (MG)";"MG";"FRUTA DE LEITE";24;7;36;67
2019;"FRUTAL (MG)";"MG";"FRUTAL";1696;169;239;2104
2019;"FUNILANDIA (MG)";"MG";"FUNILANDIA";63;2;29;94
2019;"GALILEIA (MG)";"MG";"GALILEIA";71;6;12;89
2019;"GAMELEIRAS (MG)";"MG";"GAMELEIRAS";41;6;21;68
2019;"GLAUCILANDIA (MG)";"MG";"GLAUCILANDIA";8;1;8;17
2019;"GOIABEIRA (MG)";"MG";"GOIABEIRA";42;8;5;55
2019;"GOIANA (MG)";"MG";"GOIANA";37;7;9;53
2019;"GONCALVES (MG)";"MG";"GONCALVES";101;16;12;129
2019;"GONZAGA (MG)";"MG";"GONZAGA";52;8;14;74
2019;"GOUVEA (MG)";"MG";"GOUVEA";144;16;44;204
2019;"GOVERNADOR VALADARES (MG)";"MG";"GOVERNADOR VALADARES";3491;375;400;4266
2019;"GRAO MOGOL (MG)";"MG";"GRAO MOGOL";118;29;93;240
2019;"GRUPIARA (MG)";"MG";"GRUPIARA";16;5;5;26
2019;"GUANHAES (MG)";"MG";"GUANHAES";644;73;142;859
2019;"GUAPE (MG)";"MG";"GUAPE";279;31;78;388
2019;"GUARACIABA (MG)";"MG";"GUARACIABA";96;25;52;173
2019;"GUARACIAMA (MG)";"MG";"GUARACIAMA";65;4;21;90
2019;"GUARANESIA (MG)";"MG";"GUARANESIA";436;87;144;667
2019;"GUARANI (MG)";"MG";"GUARANI";90;20;17;127
2019;"GUARARA (MG)";"MG";"GUARARA";63;12;5;80
2019;"GUARDA MOR (MG)";"MG";"GUARDA MOR";154;24;42;220
2019;"GUAXUPE (MG)";"MG";"GUAXUPE";964;106;153;1223
2019;"GUIDOVAL (MG)";"MG";"GUIDOVAL";176;2;13;191
2019;"GUIMARANIA (MG)";"MG";"GUIMARANIA";200;17;57;274
2019;"GUIRICEMA (MG)";"MG";"GUIRICEMA";272;16;25;313
2019;"GURINHATA (MG)";"MG";"GURINHATA";122;13;37;172
2019;"HELIODORA (MG)";"MG";"HELIODORA";97;18;22;137
2019;"IAPU (MG)";"MG";"IAPU";186;20;31;237
2019;"IBERTIOGA (MG)";"MG";"IBERTIOGA";79;26;11;116
2019;"IBIA (MG)";"MG";"IBIA";504;58;120;682
2019;"IBIAI (MG)";"MG";"IBIAI";64;14;15;93
2019;"IBIRACATU (MG)";"MG";"IBIRACATU";20;4;19;43
2019;"IBIRACI (MG)";"MG";"IBIRACI";440;41;55;536
2019;"IBIRITE (MG)";"MG";"IBIRITE";1564;307;390;2261
2019;"IBITIURA DE MINAS (MG)";"MG";"IBITIURA DE MINAS";121;5;7;133
2019;"IBITURUNA (MG)";"MG";"IBITURUNA";37;6;5;48
2019;"ICARAI DE MINAS (MG)";"MG";"ICARAI DE MINAS";39;5;29;73
2019;"IGARAPE (MG)";"MG";"IGARAPE";1069;88;200;1357
2019;"IGARATINGA (MG)";"MG";"IGARATINGA";572;16;25;613
2019;"IGUATAMA (MG)";"MG";"IGUATAMA";143;22;20;185
2019;"IJACI (MG)";"MG";"IJACI";232;8;28;268
2019;"ILICINEA (MG)";"MG";"ILICINEA";290;23;52;365
2019;"IMBE DE MINAS (MG)";"MG";"IMBE DE MINAS";59;10;22;91
2019;"INCONFIDENTES (MG)";"MG";"INCONFIDENTES";94;24;39;157
2019;"INDAIABIRA (MG)";"MG";"INDAIABIRA";102;18;36;156
2019;"INDIANOPOLIS (MG)";"MG";"INDIANOPOLIS";119;45;22;186
2019;"INGAI (MG)";"MG";"INGAI";20;18;15;53
2019;"INHAPIM (MG)";"MG";"INHAPIM";497;38;89;624
2019;"INHAUMA (MG)";"MG";"INHAUMA";125;5;26;156
2019;"INIMUTABA (MG)";"MG";"INIMUTABA";51;7;15;73
2019;"IPABA (MG)";"MG";"IPABA";99;20;32;151
2019;"IPANEMA (MG)";"MG";"IPANEMA";298;38;57;393
2019;"IPATINGA (MG)";"MG";"IPATINGA";3362;717;766;4845
2019;"IPIACU (MG)";"MG";"IPIACU";86;2;14;102
2019;"IPUIUNA (MG)";"MG";"IPUIUNA";468;50;45;563
2019;"IRAI DE MINAS (MG)";"MG";"IRAI DE MINAS";271;26;41;338
2019;"ITABIRA (MG)";"MG";"ITABIRA";1822;365;545;2732
2019;"ITABIRINHA (MG)";"MG";"ITABIRINHA";184;9;41;234
2019;"ITABIRITO (MG)";"MG";"ITABIRITO";1094;274;406;1774
2019;"ITACAMBIRA (MG)";"MG";"ITACAMBIRA";18;2;10;30
2019;"ITACARAMBI (MG)";"MG";"ITACARAMBI";158;14;66;238
2019;"ITAGUARA (MG)";"MG";"ITAGUARA";509;24;106;639
2019;"ITAIPE (MG)";"MG";"ITAIPE";93;20;31;144
2019;"ITAJUBA (MG)";"MG";"ITAJUBA";945;120;132;1197
2019;"ITAMARANDIBA (MG)";"MG";"ITAMARANDIBA";820;85;196;1101
2019;"ITAMARATI DE MINAS (MG)";"MG";"ITAMARATI DE MINAS";106;14;14;134
2019;"ITAMBACURI (MG)";"MG";"ITAMBACURI";222;39;63;324
2019;"ITAMBE DO MATO DENTRO (MG)";"MG";"ITAMBE DO MATO DENTRO";28;7;8;43
2019;"ITAMOGI (MG)";"MG";"ITAMOGI";350;27;51;428
2019;"ITAMONTE (MG)";"MG";"ITAMONTE";344;28;41;413
2019;"ITANHANDU (MG)";"MG";"ITANHANDU";511;42;35;588
2019;"ITANHOMI (MG)";"MG";"ITANHOMI";137;20;31;188
2019;"ITAOBIM (MG)";"MG";"ITAOBIM";244;41;48;333
2019;"ITAPAGIPE (MG)";"MG";"ITAPAGIPE";307;30;57;394
2019;"ITAPECERICA (MG)";"MG";"ITAPECERICA";422;63;69;554
2019;"ITAPEVA (MG)";"MG";"ITAPEVA";275;40;19;334
2019;"ITATIAIUCU (MG)";"MG";"ITATIAIUCU";367;24;50;441
2019;"ITAU DE MINAS (MG)";"MG";"ITAU DE MINAS";322;44;52;418
2019;"ITAUNA (MG)";"MG";"ITAUNA";1644;263;294;2201
2019;"ITAVERAVA (MG)";"MG";"ITAVERAVA";67;10;26;103
2019;"ITINGA (MG)";"MG";"ITINGA";78;27;49;154
2019;"ITUETA (MG)";"MG";"ITUETA";82;8;23;113
2019;"ITUIUTABA (MG)";"MG";"ITUIUTABA";1520;300;370;2190
2019;"ITUMIRIM (MG)";"MG";"ITUMIRIM";78;29;11;118
2019;"ITURAMA (MG)";"MG";"ITURAMA";965;110;335;1410
2019;"ITUTINGA (MG)";"MG";"ITUTINGA";72;26;9;107
2019;"JABOTICATUBAS (MG)";"MG";"JABOTICATUBAS";331;23;72;426
2019;"JACINTO (MG)";"MG";"JACINTO";45;12;50;107
2019;"JACUI (MG)";"MG";"JACUI";193;22;43;258
2019;"JACUTINGA (MG)";"MG";"JACUTINGA";484;105;99;688
2019;"JAGUARACU (MG)";"MG";"JAGUARACU";78;2;8;88
2019;"JAIBA (MG)";"MG";"JAIBA";480;28;222;730
2019;"JAMPRUCA (MG)";"MG";"JAMPRUCA";21;7;31;59
2019;"JANAUBA (MG)";"MG";"JANAUBA";926;47;199;1172
2019;"JANUARIA (MG)";"MG";"JANUARIA";508;35;191;734
2019;"JAPARAIBA (MG)";"MG";"JAPARAIBA";108;15;22;145
2019;"JAPONVAR (MG)";"MG";"JAPONVAR";71;12;25;108
2019;"JECEABA (MG)";"MG";"JECEABA";123;31;15;169
2019;"JENIPAPO DE MINAS (MG)";"MG";"JENIPAPO DE MINAS";42;11;37;90
2019;"JEQUERI (MG)";"MG";"JEQUERI";158;16;63;237
2019;"JEQUITAI (MG)";"MG";"JEQUITAI";72;3;37;112
2019;"JEQUITIBA (MG)";"MG";"JEQUITIBA";101;15;46;162
2019;"JEQUITINHONHA (MG)";"MG";"JEQUITINHONHA";115;61;51;227
2019;"JESUANIA (MG)";"MG";"JESUANIA";86;24;16;126
2019;"JOAIMA (MG)";"MG";"JOAIMA";80;16;44;140
2019;"JOANESIA (MG)";"MG";"JOANESIA";26;10;17;53
2019;"JOAO MONLEVADE (MG)";"MG";"JOAO MONLEVADE";1422;158;264;1844
2019;"JOAO PINHEIRO (MG)";"MG";"JOAO PINHEIRO";1278;80;379;1737
2019;"JOAQUIM FELICIO (MG)";"MG";"JOAQUIM FELICIO";51;4;19;74
2019;"JORDANIA (MG)";"MG";"JORDANIA";45;20;28;93
2019;"JOSE GONCALVES DE MINAS (MG)";"MG";"JOSE GONCALVES DE MINAS";31;14;22;67
2019;"JOSE RAYDAN (MG)";"MG";"JOSE RAYDAN";42;3;18;63
2019;"JOSENOPOLIS (MG)";"MG";"JOSENOPOLIS";26;7;25;58
2019;"JUATUBA (MG)";"MG";"JUATUBA";373;67;285;725
2019;"JUIZ DE FORA (MG)";"MG";"JUIZ DE FORA";6501;908;1899;9308
2019;"JURAMENTO (MG)";"MG";"JURAMENTO";24;3;18;45
2019;"JURUAIA (MG)";"MG";"JURUAIA";133;24;36;193
2019;"JUVENILIA (MG)";"MG";"JUVENILIA";40;4;18;62
2019;"LADAINHA (MG)";"MG";"LADAINHA";69;24;53;146
2019;"LAGAMAR (MG)";"MG";"LAGAMAR";130;36;25;191
2019;"LAGOA DA PRATA (MG)";"MG";"LAGOA DA PRATA";1321;88;178;1587
2019;"LAGOA DOS PATOS (MG)";"MG";"LAGOA DOS PATOS";40;1;18;59
2019;"LAGOA DOURADA (MG)";"MG";"LAGOA DOURADA";460;48;182;690
2019;"LAGOA FORMOSA (MG)";"MG";"LAGOA FORMOSA";508;25;122;655
2019;"LAGOA GRANDE (MG)";"MG";"LAGOA GRANDE";159;10;77;246
2019;"LAGOA SANTA (MG)";"MG";"LAGOA SANTA";900;144;122;1166
2019;"LAJINHA (MG)";"MG";"LAJINHA";369;63;74;506
2019;"LAMBARI (MG)";"MG";"LAMBARI";464;73;41;578
2019;"LAMIM (MG)";"MG";"LAMIM";47;1;11;59
2019;"LARANJAL (MG)";"MG";"LARANJAL";128;9;9;146
2019;"LASSANCE (MG)";"MG";"LASSANCE";62;21;18;101
2019;"LAVRAS (MG)";"MG";"LAVRAS";1449;225;321;1995
2019;"LEANDRO FERREIRA (MG)";"MG";"LEANDRO FERREIRA";61;8;11;80
2019;"LEME DO PRADO (MG)";"MG";"LEME DO PRADO";37;8;23;68
2019;"LEOPOLDINA (MG)";"MG";"LEOPOLDINA";799;99;110;1008
2019;"LIBERDADE (MG)";"MG";"LIBERDADE";170;25;15;210
2019;"LIMA DUARTE (MG)";"MG";"LIMA DUARTE";269;46;37;352
2019;"LIMEIRA DO OESTE (MG)";"MG";"LIMEIRA DO OESTE";191;34;78;303
2019;"LONTRA (MG)";"MG";"LONTRA";44;7;17;68
2019;"LUISBURGO (MG)";"MG";"LUISBURGO";72;11;28;111
2019;"LUISLANDIA (MG)";"MG";"LUISLANDIA";27;9;24;60
2019;"LUMINARIAS (MG)";"MG";"LUMINARIAS";157;13;44;214
2019;"LUZ (MG)";"MG";"LUZ";403;60;43;506
2019;"MACHACALIS (MG)";"MG";"MACHACALIS";39;4;17;60
2019;"MACHADO (MG)";"MG";"MACHADO";873;180;148;1201
2019;"MADRE DE DEUS DE MINAS (MG)";"MG";"MADRE DE DEUS DE MINAS";128;19;20;167
2019;"MALACACHETA (MG)";"MG";"MALACACHETA";135;19;77;231
2019;"MAMONAS (MG)";"MG";"MAMONAS";118;12;37;167
2019;"MANGA (MG)";"MG";"MANGA";180;18;70;268
2019;"MANHUACU (MG)";"MG";"MANHUACU";1960;182;243;2385
2019;"MANHUMIRIM (MG)";"MG";"MANHUMIRIM";391;55;64;510
2019;"MANTENA (MG)";"MG";"MANTENA";580;48;93;721
2019;"MAR DE ESPANHA (MG)";"MG";"MAR DE ESPANHA";297;35;28;360
2019;"MARAVILHAS (MG)";"MG";"MARAVILHAS";202;22;16;240
2019;"MARIA DA FE (MG)";"MG";"MARIA DA FE";291;25;36;352
2019;"MARIANA (MG)";"MG";"MARIANA";777;325;353;1455
2019;"MARILAC (MG)";"MG";"MARILAC";25;2;20;47
2019;"MARIO CAMPOS (MG)";"MG";"MARIO CAMPOS";300;31;26;357
2019;"MARIPA DE MINAS (MG)";"MG";"MARIPA DE MINAS";76;13;6;95
2019;"MARLIERIA (MG)";"MG";"MARLIERIA";50;6;15;71
2019;"MARMELOPOLIS (MG)";"MG";"MARMELOPOLIS";49;13;12;74
2019;"MARTINHO CAMPOS (MG)";"MG";"MARTINHO CAMPOS";447;35;91;573
2019;"MARTINS SOARES (MG)";"MG";"MARTINS SOARES";195;14;27;236
2019;"MATA VERDE (MG)";"MG";"MATA VERDE";83;56;12;151
2019;"MATERLANDIA (MG)";"MG";"MATERLANDIA";24;8;6;38
2019;"MATEUS LEME (MG)";"MG";"MATEUS LEME";635;108;116;859
2019;"MATHIAS LOBATO (MG)";"MG";"MATHIAS LOBATO";38;3;9;50
2019;"MATIAS BARBOSA (MG)";"MG";"MATIAS BARBOSA";887;48;54;989
2019;"MATIAS CARDOSO (MG)";"MG";"MATIAS CARDOSO";51;7;35;93
2019;"MATIPO (MG)";"MG";"MATIPO";357;33;68;458
2019;"MATO VERDE (MG)";"MG";"MATO VERDE";193;8;50;251
2019;"MATOZINHOS (MG)";"MG";"MATOZINHOS";466;118;129;713
2019;"MATUTINA (MG)";"MG";"MATUTINA";100;27;11;138
2019;"MEDEIROS (MG)";"MG";"MEDEIROS";101;24;11;136
2019;"MEDINA (MG)";"MG";"MEDINA";188;64;49;301
2019;"MENDES PIMENTEL (MG)";"MG";"MENDES PIMENTEL";58;10;18;86
2019;"MERCES (MG)";"MG";"MERCES";213;33;27;273
2019;"MESQUITA (MG)";"MG";"MESQUITA";33;17;17;67
2019;"MINAS NOVAS (MG)";"MG";"MINAS NOVAS";198;40;134;372
2019;"MINDURI (MG)";"MG";"MINDURI";92;11;9;112
2019;"MIRABELA (MG)";"MG";"MIRABELA";230;27;45;302
2019;"MIRADOURO (MG)";"MG";"MIRADOURO";117;14;36;167
2019;"MIRAI (MG)";"MG";"MIRAI";197;13;26;236
2019;"MIRAVANIA (MG)";"MG";"MIRAVANIA";19;4;20;43
2019;"MOEDA (MG)";"MG";"MOEDA";115;19;64;198
2019;"MOEMA (MG)";"MG";"MOEMA";225;22;133;380
2019;"MONJOLOS (MG)";"MG";"MONJOLOS";12;2;10;24
2019;"MONSENHOR PAULO (MG)";"MG";"MONSENHOR PAULO";215;31;16;262
2019;"MONTALVANIA (MG)";"MG";"MONTALVANIA";189;33;128;350
2019;"MONTE ALEGRE DE MINAS (MG)";"MG";"MONTE ALEGRE DE MINAS";738;97;82;917
2019;"MONTE AZUL (MG)";"MG";"MONTE AZUL";204;18;90;312
2019;"MONTE BELO (MG)";"MG";"MONTE BELO";333;47;66;446
2019;"MONTE CARMELO (MG)";"MG";"MONTE CARMELO";1575;154;218;1947
2019;"MONTE FORMOSO (MG)";"MG";"MONTE FORMOSO";36;32;58;126
2019;"MONTE SANTO DE MINAS (MG)";"MG";"MONTE SANTO DE MINAS";589;73;130;792
2019;"MONTE SIAO (MG)";"MG";"MONTE SIAO";371;63;52;486
2019;"MONTES CLAROS (MG)";"MG";"MONTES CLAROS";4827;443;1218;6488
2019;"MONTEZUMA (MG)";"MG";"MONTEZUMA";74;11;48;133
2019;"MORADA NOVA DE MINAS (MG)";"MG";"MORADA NOVA DE MINAS";153;24;32;209
2019;"MORRO DA GARCA (MG)";"MG";"MORRO DA GARCA";44;8;21;73
2019;"MORRO DO PILAR (MG)";"MG";"MORRO DO PILAR";44;11;5;60
2019;"MUNHOZ (MG)";"MG";"MUNHOZ";201;20;15;236
2019;"MURIAE (MG)";"MG";"MURIAE";1578;170;226;1974
2019;"MUTUM (MG)";"MG";"MUTUM";293;36;119;448
2019;"MUZAMBINHO (MG)";"MG";"MUZAMBINHO";579;107;60;746
2019;"NACIP RAYDAN (MG)";"MG";"NACIP RAYDAN";12;2;7;21
2019;"NANUQUE (MG)";"MG";"NANUQUE";577;86;245;908
2019;"NAQUE (MG)";"MG";"NAQUE";47;5;20;72
2019;"NATALANDIA (MG)";"MG";"NATALANDIA";33;2;25;60
2019;"NATERCIA (MG)";"MG";"NATERCIA";108;15;24;147
2019;"NAZARENO (MG)";"MG";"NAZARENO";257;27;48;332
2019;"NEPOMUCENO (MG)";"MG";"NEPOMUCENO";562;60;147;769
2019;"NINHEIRA (MG)";"MG";"NINHEIRA";64;19;54;137
2019;"NOVA BELEM (MG)";"MG";"NOVA BELEM";39;3;17;59
2019;"NOVA ERA (MG)";"MG";"NOVA ERA";284;62;79;425
2019;"NOVA LIMA (MG)";"MG";"NOVA LIMA";1876;405;309;2590
2019;"NOVA MODICA (MG)";"MG";"NOVA MODICA";21;6;16;43
2019;"NOVA PONTE (MG)";"MG";"NOVA PONTE";320;75;90;485
2019;"NOVA PORTEIRINHA (MG)";"MG";"NOVA PORTEIRINHA";44;5;22;71
2019;"NOVA RESENDE (MG)";"MG";"NOVA RESENDE";481;28;107;616
2019;"NOVA SERRANA (MG)";"MG";"NOVA SERRANA";651;89;150;890
2019;"NOVA UNIAO (MG)";"MG";"NOVA UNIAO";210;9;29;248
2019;"NOVO CRUZEIRO (MG)";"MG";"NOVO CRUZEIRO";257;61;220;538
2019;"NOVO ORIENTE DE MINAS (MG)";"MG";"NOVO ORIENTE DE MINAS";44;41;29;114
2019;"NOVORIZONTE (MG)";"MG";"NOVORIZONTE";94;1;29;124
2019;"OLARIA (MG)";"MG";"OLARIA";23;7;14;44
2019;"OLHOS D AGUA (MG)";"MG";"OLHOS D AGUA";125;19;62;206
2019;"OLIMPIO NORONHA (MG)";"MG";"OLIMPIO NORONHA";35;11;11;57
2019;"OLIVEIRA (MG)";"MG";"OLIVEIRA";889;120;134;1143
2019;"OLIVEIRA FORTES (MG)";"MG";"OLIVEIRA FORTES";27;9;11;47
2019;"ONCA DE PITANGUI (MG)";"MG";"ONCA DE PITANGUI";27;11;18;56
2019;"ORATORIOS (MG)";"MG";"ORATORIOS";115;6;26;147
2019;"ORIZANIA (MG)";"MG";"ORIZANIA";104;18;22;144
2019;"OURO BRANCO (MG)";"MG";"OURO BRANCO";511;123;228;862
2019;"OURO FINO (MG)";"MG";"OURO FINO";760;108;150;1018
2019;"OURO PRETO (MG)";"MG";"OURO PRETO";1167;281;347;1795
2019;"OURO VERDE DE MINAS (MG)";"MG";"OURO VERDE DE MINAS";35;5;13;53
2019;"PADRE CARVALHO (MG)";"MG";"PADRE CARVALHO";35;8;35;78
2019;"PADRE PARAISO (MG)";"MG";"PADRE PARAISO";157;96;87;340
2019;"PAI PEDRO (MG)";"MG";"PAI PEDRO";21;3;35;59
2019;"PAINEIRAS (MG)";"MG";"PAINEIRAS";88;18;16;122
2019;"PAINS (MG)";"MG";"PAINS";299;23;37;359
2019;"PAIVA (MG)";"MG";"PAIVA";9;4;2;15
2019;"PALMA (MG)";"MG";"PALMA";126;7;11;144
2019;"PALMOPOLIS (MG)";"MG";"PALMOPOLIS";30;11;22;63
2019;"PAPAGAIOS (MG)";"MG";"PAPAGAIOS";651;22;92;765
2019;"PARA DE MINAS (MG)";"MG";"PARA DE MINAS";2501;211;259;2971
2019;"PARACATU (MG)";"MG";"PARACATU";1759;232;534;2525
2019;"PARAGUACU (MG)";"MG";"PARAGUACU";384;66;53;503
2019;"PARAISOPOLIS (MG)";"MG";"PARAISOPOLIS";420;63;48;531
2019;"PARAOPEBA (MG)";"MG";"PARAOPEBA";514;42;55;611
2019;"PASSA QUATRO (MG)";"MG";"PASSA QUATRO";433;51;42;526
2019;"PASSA TEMPO (MG)";"MG";"PASSA TEMPO";241;37;31;309
2019;"PASSA VINTE (MG)";"MG";"PASSA VINTE";435;45;22;502
2019;"PASSABEM (MG)";"MG";"PASSABEM";17;3;5;25
2019;"PASSOS (MG)";"MG";"PASSOS";2291;238;532;3061
2019;"PATIS (MG)";"MG";"PATIS";35;7;20;62
2019;"PATOS DE MINAS (MG)";"MG";"PATOS DE MINAS";3639;227;439;4305
2019;"PATROCINIO (MG)";"MG";"PATROCINIO";2068;220;645;2933
2019;"PATROCINIO DO MURIAE (MG)";"MG";"PATROCINIO DO MURIAE";122;16;11;149
2019;"PAULA CANDIDO (MG)";"MG";"PAULA CANDIDO";96;13;20;129
2019;"PAULISTAS (MG)";"MG";"PAULISTAS";70;7;12;89
2019;"PAVAO (MG)";"MG";"PAVAO";51;24;15;90
2019;"PECANHA (MG)";"MG";"PECANHA";158;19;74;251
2019;"PEDRA AZUL (MG)";"MG";"PEDRA AZUL";202;29;57;288
2019;"PEDRA BONITA (MG)";"MG";"PEDRA BONITA";101;13;26;140
2019;"PEDRA DO ANTA (MG)";"MG";"PEDRA DO ANTA";39;3;22;64
2019;"PEDRA DO INDAIA (MG)";"MG";"PEDRA DO INDAIA";118;15;11;144
2019;"PEDRA DOURADA (MG)";"MG";"PEDRA DOURADA";22;4;22;48
2019;"PEDRALVA (MG)";"MG";"PEDRALVA";210;38;31;279
2019;"PEDRAS DE MARIA DA CRUZ (MG)";"MG";"PEDRAS DE MARIA DA CRUZ";44;7;42;93
2019;"PEDRINOPOLIS (MG)";"MG";"PEDRINOPOLIS";58;12;13;83
2019;"PEDRO LEOPOLDO (MG)";"MG";"PEDRO LEOPOLDO";1359;214;171;1744
2019;"PEDRO TEIXEIRA (MG)";"MG";"PEDRO TEIXEIRA";18;8;6;32
2019;"PEQUERI (MG)";"MG";"PEQUERI";81;9;6;96
2019;"PEQUI (MG)";"MG";"PEQUI";72;22;7;101
2019;"PERDIGAO (MG)";"MG";"PERDIGAO";176;9;17;202
2019;"PERDIZES (MG)";"MG";"PERDIZES";383;68;86;537
2019;"PERDOES (MG)";"MG";"PERDOES";584;47;101;732
2019;"PERIQUITO (MG)";"MG";"PERIQUITO";59;5;31;95
2019;"PESCADOR (MG)";"MG";"PESCADOR";20;7;12;39
2019;"PIAU (MG)";"MG";"PIAU";68;11;11;90
2019;"PIEDADE DE CARATINGA (MG)";"MG";"PIEDADE DE CARATINGA";241;10;31;282
2019;"PIEDADE DE PONTE NOVA (MG)";"MG";"PIEDADE DE PONTE NOVA";41;5;22;68
2019;"PIEDADE DO RIO GRANDE (MG)";"MG";"PIEDADE DO RIO GRANDE";65;16;8;89
2019;"PIEDADE DOS GERAIS (MG)";"MG";"PIEDADE DOS GERAIS";127;7;21;155
2019;"PIMENTA (MG)";"MG";"PIMENTA";276;18;33;327
2019;"PINGO D AGUA (MG)";"MG";"PINGO D AGUA";36;5;13;54
2019;"PINTOPOLIS (MG)";"MG";"PINTOPOLIS";28;7;21;56
2019;"PIRACEMA (MG)";"MG";"PIRACEMA";148;15;26;189
2019;"PIRAJUBA (MG)";"MG";"PIRAJUBA";209;24;19;252
2019;"PIRANGA (MG)";"MG";"PIRANGA";182;36;99;317
2019;"PIRANGUCU (MG)";"MG";"PIRANGUCU";76;25;33;134
2019;"PIRANGUINHO (MG)";"MG";"PIRANGUINHO";224;26;36;286
2019;"PIRAPETINGA (MG)";"MG";"PIRAPETINGA";641;34;63;738
2019;"PIRAPORA (MG)";"MG";"PIRAPORA";645;72;222;939
2019;"PIRAUBA (MG)";"MG";"PIRAUBA";142;26;19;187
2019;"PITANGUI (MG)";"MG";"PITANGUI";599;116;111;826
2019;"PIUMHI (MG)";"MG";"PIUMHI";953;90;109;1152
2019;"PLANURA (MG)";"MG";"PLANURA";193;19;86;298
2019;"POCO FUNDO (MG)";"MG";"POCO FUNDO";380;65;39;484
2019;"POCOS DE CALDAS (MG)";"MG";"POCOS DE CALDAS";2952;674;517;4143
2019;"POCRANE (MG)";"MG";"POCRANE";100;11;22;133
2019;"POMPEU (MG)";"MG";"POMPEU";516;38;165;719
2019;"PONTE NOVA (MG)";"MG";"PONTE NOVA";1245;101;178;1524
2019;"PONTO CHIQUE (MG)";"MG";"PONTO CHIQUE";12;1;9;22
2019;"PONTO DOS VOLANTES (MG)";"MG";"PONTO DOS VOLANTES";62;22;46;130
2019;"PORTEIRINHA (MG)";"MG";"PORTEIRINHA";500;37;278;815
2019;"PORTO FIRME (MG)";"MG";"PORTO FIRME";85;8;32;125
2019;"POTE (MG)";"MG";"POTE";96;24;45;165
2019;"POUSO ALEGRE (MG)";"MG";"POUSO ALEGRE";3093;368;588;4049
2019;"POUSO ALTO (MG)";"MG";"POUSO ALTO";118;23;19;160
2019;"PRADOS (MG)";"MG";"PRADOS";146;23;22;191
2019;"PRATA (MG)";"MG";"PRATA";517;147;126;790
2019;"PRATAPOLIS (MG)";"MG";"PRATAPOLIS";279;23;36;338
2019;"PRATINHA (MG)";"MG";"PRATINHA";95;18;13;126
2019;"PRESIDENTE BERNARDES (MG)";"MG";"PRESIDENTE BERNARDES";28;9;13;50
2019;"PRESIDENTE JUSCELINO (MG)";"MG";"PRESIDENTE JUSCELINO";60;4;24;88
2019;"PRESIDENTE KUBITSCHEK (MG)";"MG";"PRESIDENTE KUBITSCHEK";31;13;11;55
2019;"PRESIDENTE OLEGARIO (MG)";"MG";"PRESIDENTE OLEGARIO";316;34;139;489
2019;"PRUDENTE DE MORAIS (MG)";"MG";"PRUDENTE DE MORAIS";147;20;17;184
2019;"QUARTEL GERAL (MG)";"MG";"QUARTEL GERAL";54;5;11;70
2019;"QUELUZITA (MG)";"MG";"QUELUZITA";23;9;7;39
2019;"RAPOSOS (MG)";"MG";"RAPOSOS";98;60;33;191
2019;"RAUL SOARES (MG)";"MG";"RAUL SOARES";316;53;91;460
2019;"RECREIO (MG)";"MG";"RECREIO";202;28;30;260
2019;"REDUTO (MG)";"MG";"REDUTO";104;9;15;128
2019;"RESENDE COSTA (MG)";"MG";"RESENDE COSTA";254;28;40;322
2019;"RESPLENDOR (MG)";"MG";"RESPLENDOR";208;50;58;316
2019;"RESSAQUINHA (MG)";"MG";"RESSAQUINHA";187;13;32;232
2019;"RIACHINHO (MG)";"MG";"RIACHINHO";107;7;29;143
2019;"RIACHO DOS MACHADOS (MG)";"MG";"RIACHO DOS MACHADOS";69;9;46;124
2019;"RIBEIRAO DAS NEVES (MG)";"MG";"RIBEIRAO DAS NEVES";2859;708;713;4280
2019;"RIBEIRAO VERMELHO (MG)";"MG";"RIBEIRAO VERMELHO";42;13;5;60
2019;"RIO ACIMA (MG)";"MG";"RIO ACIMA";140;34;19;193
2019;"RIO CASCA (MG)";"MG";"RIO CASCA";221;9;52;282
2019;"RIO DO PRADO (MG)";"MG";"RIO DO PRADO";16;8;17;41
2019;"RIO DOCE (MG)";"MG";"RIO DOCE";26;10;11;47
2019;"RIO ESPERA (MG)";"MG";"RIO ESPERA";51;1;16;68
2019;"RIO MANSO (MG)";"MG";"RIO MANSO";203;7;15;225
2019;"RIO NOVO (MG)";"MG";"RIO NOVO";223;30;45;298
2019;"RIO PARANAIBA (MG)";"MG";"RIO PARANAIBA";374;38;180;592
2019;"RIO PARDO DE MINAS (MG)";"MG";"RIO PARDO DE MINAS";264;65;229;558
2019;"RIO PIRACICABA (MG)";"MG";"RIO PIRACICABA";221;26;35;282
2019;"RIO POMBA (MG)";"MG";"RIO POMBA";304;45;52;401
2019;"RIO PRETO (MG)";"MG";"RIO PRETO";553;42;60;655
2019;"RIO VERMELHO (MG)";"MG";"RIO VERMELHO";90;47;51;188
2019;"RITAPOLIS (MG)";"MG";"RITAPOLIS";40;16;13;69
2019;"ROCHEDO DE MINAS (MG)";"MG";"ROCHEDO DE MINAS";31;7;4;42
2019;"RODEIRO (MG)";"MG";"RODEIRO";310;9;32;351
2019;"ROMARIA (MG)";"MG";"ROMARIA";57;27;15;99
2019;"ROSARIO DA LIMEIRA (MG)";"MG";"ROSARIO DA LIMEIRA";90;6;44;140
2019;"RUBELITA (MG)";"MG";"RUBELITA";22;11;16;49
2019;"RUBIM (MG)";"MG";"RUBIM";27;5;37;69
2019;"SABARA (MG)";"MG";"SABARA";908;236;417;1561
2019;"SABINOPOLIS (MG)";"MG";"SABINOPOLIS";185;42;79;306
2019;"SACRAMENTO (MG)";"MG";"SACRAMENTO";610;107;114;831
2019;"SALINAS (MG)";"MG";"SALINAS";521;62;190;773
2019;"SALTO DA DIVISA (MG)";"MG";"SALTO DA DIVISA";19;10;17;46
2019;"SANTA BARBARA (MG)";"MG";"SANTA BARBARA";442;104;108;654
2019;"SANTA BARBARA DO LESTE (MG)";"MG";"SANTA BARBARA DO LESTE";217;12;16;245
2019;"SANTA BARBARA DO MONTE VERDE (MG)";"MG";"SANTA BARBARA DO MONTE VERDE";606;54;139;799
2019;"SANTA BARBARA DO TUGURIO (MG)";"MG";"SANTA BARBARA DO TUGURIO";90;30;47;167
2019;"SANTA CRUZ DE MINAS (MG)";"MG";"SANTA CRUZ DE MINAS";93;14;11;118
2019;"SANTA CRUZ DE SALINAS (MG)";"MG";"SANTA CRUZ DE SALINAS";33;9;33;75
2019;"SANTA CRUZ DO ESCALVADO (MG)";"MG";"SANTA CRUZ DO ESCALVADO";47;20;24;91
2019;"SANTA EFIGENIA DE MINAS (MG)";"MG";"SANTA EFIGENIA DE MINAS";37;8;10;55
2019;"SANTA FE DE MINAS (MG)";"MG";"SANTA FE DE MINAS";10;1;10;21
2019;"SANTA HELENA DE MINAS (MG)";"MG";"SANTA HELENA DE MINAS";14;5;15;34
2019;"SANTA JULIANA (MG)";"MG";"SANTA JULIANA";550;58;100;708
2019;"SANTA LUZIA (MG)";"MG";"SANTA LUZIA";2060;408;827;3295
2019;"SANTA MARGARIDA (MG)";"MG";"SANTA MARGARIDA";307;27;64;398
2019;"SANTA MARIA DE ITABIRA (MG)";"MG";"SANTA MARIA DE ITABIRA";158;26;62;246
2019;"SANTA MARIA DO SALTO (MG)";"MG";"SANTA MARIA DO SALTO";10;8;13;31
2019;"SANTA MARIA DO SUACUI (MG)";"MG";"SANTA MARIA DO SUACUI";109;11;68;188
2019;"SANTA RITA DE CALDAS (MG)";"MG";"SANTA RITA DE CALDAS";362;33;26;421
2019;"SANTA RITA DE IBITIPOCA (MG)";"MG";"SANTA RITA DE IBITIPOCA";62;18;9;89
2019;"SANTA RITA DE JACUTINGA (MG)";"MG";"SANTA RITA DE JACUTINGA";124;12;9;145
2019;"SANTA RITA DE MINAS (MG)";"MG";"SANTA RITA DE MINAS";136;17;26;179
2019;"SANTA RITA DO ITUETO (MG)";"MG";"SANTA RITA DO ITUETO";130;14;21;165
2019;"SANTA RITA DO SAPUCAI (MG)";"MG";"SANTA RITA DO SAPUCAI";477;126;107;710
2019;"SANTA ROSA DA SERRA (MG)";"MG";"SANTA ROSA DA SERRA";80;13;23;116
2019;"SANTA VITORIA (MG)";"MG";"SANTA VITORIA";497;74;77;648
2019;"SANTANA DA VARGEM (MG)";"MG";"SANTANA DA VARGEM";146;14;31;191
2019;"SANTANA DE CATAGUASES (MG)";"MG";"SANTANA DE CATAGUASES";39;11;8;58
2019;"SANTANA DE PIRAPAMA (MG)";"MG";"SANTANA DE PIRAPAMA";96;10;36;142
2019;"SANTANA DO DESERTO (MG)";"MG";"SANTANA DO DESERTO";79;23;15;117
2019;"SANTANA DO GARAMBEU (MG)";"MG";"SANTANA DO GARAMBEU";24;11;11;46
2019;"SANTANA DO JACARE (MG)";"MG";"SANTANA DO JACARE";68;9;21;98
2019;"SANTANA DO MANHUACU (MG)";"MG";"SANTANA DO MANHUACU";304;12;26;342
2019;"SANTANA DO PARAISO (MG)";"MG";"SANTANA DO PARAISO";267;34;49;350
2019;"SANTANA DO RIACHO (MG)";"MG";"SANTANA DO RIACHO";63;16;11;90
2019;"SANTANA DOS MONTES (MG)";"MG";"SANTANA DOS MONTES";49;7;11;67
2019;"SANTO ANTONIO DO AMPARO (MG)";"MG";"SANTO ANTONIO DO AMPARO";380;57;116;553
2019;"SANTO ANTONIO DO AVENTUREIRO (MG)";"MG";"SANTO ANTONIO DO AVENTUREIRO";76;3;11;90
2019;"SANTO ANTONIO DO GRAMA (MG)";"MG";"SANTO ANTONIO DO GRAMA";60;11;12;83
2019;"SANTO ANTONIO DO ITAMBE (MG)";"MG";"SANTO ANTONIO DO ITAMBE";20;7;18;45
2019;"SANTO ANTONIO DO JACINTO (MG)";"MG";"SANTO ANTONIO DO JACINTO";54;7;46;107
2019;"SANTO ANTONIO DO MONTE (MG)";"MG";"SANTO ANTONIO DO MONTE";592;68;120;780
2019;"SANTO ANTONIO DO RETIRO (MG)";"MG";"SANTO ANTONIO DO RETIRO";77;5;52;134
2019;"SANTO ANTONIO DO RIO ABAIXO (MG)";"MG";"SANTO ANTONIO DO RIO ABAIXO";16;6;12;34
2019;"SANTO HIPOLITO (MG)";"MG";"SANTO HIPOLITO";29;8;7;44
2019;"SANTOS DUMONT (MG)";"MG";"SANTOS DUMONT";479;115;166;760
2019;"SAO BENTO ABADE (MG)";"MG";"SAO BENTO ABADE";49;24;32;105
2019;"SAO BRAS DO SUACUI (MG)";"MG";"SAO BRAS DO SUACUI";58;6;13;77
2019;"SAO DOMINGOS DAS DORES (MG)";"MG";"SAO DOMINGOS DAS DORES";155;15;20;190
2019;"SAO DOMINGOS DO PRATA (MG)";"MG";"SAO DOMINGOS DO PRATA";371;22;92;485
2019;"SAO FELIX DE MINAS (MG)";"MG";"SAO FELIX DE MINAS";30;3;17;50
2019;"SAO FRANCISCO (MG)";"MG";"SAO FRANCISCO";349;40;234;623
2019;"SAO FRANCISCO DE PAULA (MG)";"MG";"SAO FRANCISCO DE PAULA";94;32;26;152
2019;"SAO FRANCISCO DE SALES (MG)";"MG";"SAO FRANCISCO DE SALES";96;13;29;138
2019;"SAO FRANCISCO DO GLORIA (MG)";"MG";"SAO FRANCISCO DO GLORIA";76;14;10;100
2019;"SAO GERALDO (MG)";"MG";"SAO GERALDO";193;14;23;230
2019;"SAO GERALDO DA PIEDADE (MG)";"MG";"SAO GERALDO DA PIEDADE";31;8;15;54
2019;"SAO GERALDO DO BAIXIO (MG)";"MG";"SAO GERALDO DO BAIXIO";21;6;12;39
2019;"SAO GONCALO DO ABAETE (MG)";"MG";"SAO GONCALO DO ABAETE";114;26;26;166
2019;"SAO GONCALO DO PARA (MG)";"MG";"SAO GONCALO DO PARA";314;32;45;391
2019;"SAO GONCALO DO RIO ABAIXO (MG)";"MG";"SAO GONCALO DO RIO ABAIXO";234;61;47;342
2019;"SAO GONCALO DO RIO PRETO (MG)";"MG";"SAO GONCALO DO RIO PRETO";35;10;9;54
2019;"SAO GONCALO DO SAPUCAI (MG)";"MG";"SAO GONCALO DO SAPUCAI";525;58;93;676
2019;"SAO GOTARDO (MG)";"MG";"SAO GOTARDO";1118;121;309;1548
2019;"SAO JOAO BATISTA DO GLORIA (MG)";"MG";"SAO JOAO BATISTA DO GLORIA";167;14;22;203
2019;"SAO JOAO DA LAGOA (MG)";"MG";"SAO JOAO DA LAGOA";49;22;16;87
2019;"SAO JOAO DA MATA (MG)";"MG";"SAO JOAO DA MATA";65;26;5;96
2019;"SAO JOAO DA PONTE (MG)";"MG";"SAO JOAO DA PONTE";88;13;79;180
2019;"SAO JOAO DAS MISSOES (MG)";"MG";"SAO JOAO DAS MISSOES";46;8;31;85
2019;"SAO JOAO DEL REI (MG)";"MG";"SAO JOAO DEL REI";1292;274;243;1809
2019;"SAO JOAO DO MANHUACU (MG)";"MG";"SAO JOAO DO MANHUACU";200;16;51;267
2019;"SAO JOAO DO MANTENINHA (MG)";"MG";"SAO JOAO DO MANTENINHA";93;13;10;116
2019;"SAO JOAO DO ORIENTE (MG)";"MG";"SAO JOAO DO ORIENTE";128;8;15;151
2019;"SAO JOAO DO PACUI (MG)";"MG";"SAO JOAO DO PACUI";23;8;12;43
2019;"SAO JOAO DO PARAISO (MG)";"MG";"SAO JOAO DO PARAISO";252;60;133;445
2019;"SAO JOAO EVANGELISTA (MG)";"MG";"SAO JOAO EVANGELISTA";150;23;50;223
2019;"SAO JOAO NEPOMUCENO (MG)";"MG";"SAO JOAO NEPOMUCENO";311;51;29;391
2019;"SAO JOAQUIM DE BICAS (MG)";"MG";"SAO JOAQUIM DE BICAS";636;71;69;776
2019;"SAO JOSE DA BARRA (MG)";"MG";"SAO JOSE DA BARRA";130;18;36;184
2019;"SAO JOSE DA LAPA (MG)";"MG";"SAO JOSE DA LAPA";1250;186;482;1918
2019;"SAO JOSE DA SAFIRA (MG)";"MG";"SAO JOSE DA SAFIRA";9;1;9;19
2019;"SAO JOSE DA VARGINHA (MG)";"MG";"SAO JOSE DA VARGINHA";67;2;20;89
2019;"SAO JOSE DO ALEGRE (MG)";"MG";"SAO JOSE DO ALEGRE";49;9;8;66
2019;"SAO JOSE DO DIVINO (MG)";"MG";"SAO JOSE DO DIVINO";20;7;17;44
2019;"SAO JOSE DO GOIABAL (MG)";"MG";"SAO JOSE DO GOIABAL";73;8;41;122
2019;"SAO JOSE DO JACURI (MG)";"MG";"SAO JOSE DO JACURI";51;7;9;67
2019;"SAO JOSE DO MANTIMENTO (MG)";"MG";"SAO JOSE DO MANTIMENTO";44;2;5;51
2019;"SAO LOURENCO (MG)";"MG";"SAO LOURENCO";612;83;65;760
2019;"SAO MIGUEL DO ANTA (MG)";"MG";"SAO MIGUEL DO ANTA";96;16;15;127
2019;"SAO PEDRO DA UNIAO (MG)";"MG";"SAO PEDRO DA UNIAO";143;18;22;183
2019;"SAO PEDRO DO SUACUI (MG)";"MG";"SAO PEDRO DO SUACUI";48;5;12;65
2019;"SAO PEDRO DOS FERROS (MG)";"MG";"SAO PEDRO DOS FERROS";106;10;45;161
2019;"SAO ROMAO (MG)";"MG";"SAO ROMAO";56;3;20;79
2019;"SAO ROQUE DE MINAS (MG)";"MG";"SAO ROQUE DE MINAS";238;21;38;297
2019;"SAO SEBASTIAO DA BELA VISTA (MG)";"MG";"SAO SEBASTIAO DA BELA VISTA";138;17;19;174
2019;"SAO SEBASTIAO DA VARGEM ALEGRE (MG)";"MG";"SAO SEBASTIAO DA VARGEM ALEGRE";50;6;10;66
2019;"SAO SEBASTIAO DO ANTA (MG)";"MG";"SAO SEBASTIAO DO ANTA";82;10;11;103
2019;"SAO SEBASTIAO DO MARANHAO (MG)";"MG";"SAO SEBASTIAO DO MARANHAO";33;16;31;80
2019;"SAO SEBASTIAO DO OESTE (MG)";"MG";"SAO SEBASTIAO DO OESTE";192;14;65;271
2019;"SAO SEBASTIAO DO PARAISO (MG)";"MG";"SAO SEBASTIAO DO PARAISO";1733;151;261;2145
2019;"SAO SEBASTIAO DO RIO PRETO (MG)";"MG";"SAO SEBASTIAO DO RIO PRETO";10;6;6;22
2019;"SAO SEBASTIAO DO RIO VERDE (MG)";"MG";"SAO SEBASTIAO DO RIO VERDE";24;5;10;39
2019;"SAO TIAGO (MG)";"MG";"SAO TIAGO";308;27;37;372
2019;"SAO TOMAS DE AQUINO (MG)";"MG";"SAO TOMAS DE AQUINO";121;25;18;164
2019;"SAO TOME DAS LETRAS (MG)";"MG";"SAO TOME DAS LETRAS";104;19;41;164
2019;"SAO VICENTE DE MINAS (MG)";"MG";"SAO VICENTE DE MINAS";144;30;12;186
2019;"SAPUCAI MIRIM (MG)";"MG";"SAPUCAI MIRIM";240;35;13;288
2019;"SARDOA (MG)";"MG";"SARDOA";75;11;17;103
2019;"SARZEDO (MG)";"MG";"SARZEDO";984;72;129;1185
2019;"SEM PEIXE (MG)";"MG";"SEM PEIXE";20;3;15;38
2019;"SENADOR AMARAL (MG)";"MG";"SENADOR AMARAL";147;8;20;175
2019;"SENADOR CORTES (MG)";"MG";"SENADOR CORTES";33;5;5;43
2019;"SENADOR FIRMINO (MG)";"MG";"SENADOR FIRMINO";140;16;40;196
2019;"SENADOR JOSE BENTO (MG)";"MG";"SENADOR JOSE BENTO";15;0;9;24
2019;"SENADOR MODESTINO GONCALVES (MG)";"MG";"SENADOR MODESTINO GONCALVES";36;5;15;56
2019;"SENHORA DE OLIVEIRA (MG)";"MG";"SENHORA DE OLIVEIRA";100;4;13;117
2019;"SENHORA DO PORTO (MG)";"MG";"SENHORA DO PORTO";33;7;16;56
2019;"SENHORA DOS REMEDIOS (MG)";"MG";"SENHORA DOS REMEDIOS";163;46;32;241
2019;"SERICITA (MG)";"MG";"SERICITA";111;4;11;126
2019;"SERITINGA (MG)";"MG";"SERITINGA";30;5;4;39
2019;"SERRA AZUL DE MINAS (MG)";"MG";"SERRA AZUL DE MINAS";21;5;13;39
2019;"SERRA DA SAUDADE (MG)";"MG";"SERRA DA SAUDADE";10;5;2;17
2019;"SERRA DO SALITRE (MG)";"MG";"SERRA DO SALITRE";320;27;122;469
2019;"SERRA DOS AIMORES (MG)";"MG";"SERRA DOS AIMORES";91;6;37;134
2019;"SERRANIA (MG)";"MG";"SERRANIA";136;23;28;187
2019;"SERRANOPOLIS DE MINAS (MG)";"MG";"SERRANOPOLIS DE MINAS";26;1;28;55
2019;"SERRANOS (MG)";"MG";"SERRANOS";31;9;5;45
2019;"SERRO (MG)";"MG";"SERRO";225;28;90;343
2019;"SETE LAGOAS (MG)";"MG";"SETE LAGOAS";3842;462;824;5128
2019;"SETUBINHA (MG)";"MG";"SETUBINHA";44;12;46;102
2019;"SILVEIRANIA (MG)";"MG";"SILVEIRANIA";30;4;9;43
2019;"SILVIANOPOLIS (MG)";"MG";"SILVIANOPOLIS";105;17;20;142
2019;"SIMAO PEREIRA (MG)";"MG";"SIMAO PEREIRA";73;19;10;102
2019;"SIMONESIA (MG)";"MG";"SIMONESIA";371;21;57;449
2019;"SOBRALIA (MG)";"MG";"SOBRALIA";41;3;11;55
2019;"SOLEDADE DE MINAS (MG)";"MG";"SOLEDADE DE MINAS";61;27;5;93
2019;"TABULEIRO (MG)";"MG";"TABULEIRO";78;11;15;104
2019;"TAIOBEIRAS (MG)";"MG";"TAIOBEIRAS";948;66;257;1271
2019;"TAPARUBA (MG)";"MG";"TAPARUBA";32;3;13;48
2019;"TAPIRA (MG)";"MG";"TAPIRA";163;21;33;217
2019;"TAPIRAI (MG)";"MG";"TAPIRAI";21;10;10;41
2019;"TAQUARACU DE MINAS (MG)";"MG";"TAQUARACU DE MINAS";119;9;20;148
2019;"TARUMIRIM (MG)";"MG";"TARUMIRIM";166;21;37;224
2019;"TEIXEIRAS (MG)";"MG";"TEIXEIRAS";189;20;19;228
2019;"TEOFILO OTONI (MG)";"MG";"TEOFILO OTONI";1661;258;220;2139
2019;"TIMOTEO (MG)";"MG";"TIMOTEO";936;206;156;1298
2019;"TIRADENTES (MG)";"MG";"TIRADENTES";135;30;13;178
2019;"TIROS (MG)";"MG";"TIROS";223;18;21;262
2019;"TOCANTINS (MG)";"MG";"TOCANTINS";292;20;30;342
2019;"TOCOS DO MOJI (MG)";"MG";"TOCOS DO MOJI";64;13;15;92
2019;"TOLEDO (MG)";"MG";"TOLEDO";172;9;27;208
2019;"TOMBOS (MG)";"MG";"TOMBOS";155;42;46;243
2019;"TRES CORACOES (MG)";"MG";"TRES CORACOES";1188;126;237;1551
2019;"TRES MARIAS (MG)";"MG";"TRES MARIAS";450;61;144;655
2019;"TRES PONTAS (MG)";"MG";"TRES PONTAS";1122;149;242;1513
2019;"TUMIRITINGA (MG)";"MG";"TUMIRITINGA";40;6;13;59
2019;"TUPACIGUARA (MG)";"MG";"TUPACIGUARA";706;106;105;917
2019;"TURMALINA (MG)";"MG";"TURMALINA";417;47;106;570
2019;"TURVOLANDIA (MG)";"MG";"TURVOLANDIA";147;44;16;207
2019;"UBA (MG)";"MG";"UBA";2125;132;210;2467
2019;"UBAI (MG)";"MG";"UBAI";55;14;57;126
2019;"UBAPORANGA (MG)";"MG";"UBAPORANGA";222;10;42;274
2019;"UBERABA (MG)";"MG";"UBERABA";5458;1171;1130;7759
2019;"UBERLANDIA (MG)";"MG";"UBERLANDIA";12250;1415;1733;15398
2019;"UMBURATIBA (MG)";"MG";"UMBURATIBA";13;4;8;25
2019;"UNAI (MG)";"MG";"UNAI";1873;117;577;2567
2019;"UNIAO DE MINAS (MG)";"MG";"UNIAO DE MINAS";63;9;43;115
2019;"URUANA DE MINAS (MG)";"MG";"URUANA DE MINAS";28;5;19;52
2019;"URUCANIA (MG)";"MG";"URUCANIA";219;15;71;305
2019;"URUCUIA (MG)";"MG";"URUCUIA";106;7;52;165
2019;"VARGEM ALEGRE (MG)";"MG";"VARGEM ALEGRE";90;6;21;117
2019;"VARGEM BONITA (MG)";"MG";"VARGEM BONITA";46;5;11;62
2019;"VARGEM GRANDE DO RIO PARDO (MG)";"MG";"VARGEM GRANDE DO RIO PARDO";69;8;23;100
2019;"VARGINHA (MG)";"MG";"VARGINHA";2342;243;320;2905
2019;"VARJAO DE MINAS (MG)";"MG";"VARJAO DE MINAS";107;22;68;197
2019;"VARZEA DA PALMA (MG)";"MG";"VARZEA DA PALMA";544;23;129;696
2019;"VARZELANDIA (MG)";"MG";"VARZELANDIA";75;14;72;161
2019;"VAZANTE (MG)";"MG";"VAZANTE";409;57;83;549
2019;"VERDELANDIA (MG)";"MG";"VERDELANDIA";20;3;15;38
2019;"VEREDINHA (MG)";"MG";"VEREDINHA";81;14;26;121
2019;"VERISSIMO (MG)";"MG";"VERISSIMO";39;33;10;82
2019;"VERMELHO NOVO (MG)";"MG";"VERMELHO NOVO";128;14;33;175
2019;"VESPASIANO (MG)";"MG";"VESPASIANO";1424;311;313;2048
2019;"VICOSA (MG)";"MG";"VICOSA";812;197;238;1247
2019;"VIEIRAS (MG)";"MG";"VIEIRAS";48;14;10;72
2019;"VIRGEM DA LAPA (MG)";"MG";"VIRGEM DA LAPA";78;14;38;130
2019;"VIRGINIA (MG)";"MG";"VIRGINIA";216;22;18;256
2019;"VIRGINOPOLIS (MG)";"MG";"VIRGINOPOLIS";151;15;40;206
2019;"VIRGOLANDIA (MG)";"MG";"VIRGOLANDIA";27;7;16;50
2019;"VISCONDE DO RIO BRANCO (MG)";"MG";"VISCONDE DO RIO BRANCO";1220;62;96;1378
2019;"VOLTA GRANDE (MG)";"MG";"VOLTA GRANDE";83;14;13;110
2019;"WENCESLAU BRAZ (MG)";"MG";"WENCESLAU BRAZ";43;7;12;62
2019;"AGUA CLARA (MS)";"MS";"AGUA CLARA";460;41;128;629
2019;"ALCINOPOLIS (MS)";"MS";"ALCINOPOLIS";134;20;24;178
2019;"AMAMBAI (MS)";"MS";"AMAMBAI";889;38;94;1021
2019;"ANASTACIO (MS)";"MS";"ANASTACIO";512;30;51;593
2019;"ANAURILANDIA (MS)";"MS";"ANAURILANDIA";142;28;72;242
2019;"ANGELICA (MS)";"MS";"ANGELICA";325;57;85;467
2019;"ANTONIO JOAO (MS)";"MS";"ANTONIO JOAO";152;11;33;196
2019;"APARECIDA DO TABOADO (MS)";"MS";"APARECIDA DO TABOADO";510;58;79;647
2019;"AQUIDAUANA (MS)";"MS";"AQUIDAUANA";447;27;94;568
2019;"ARAL MOREIRA (MS)";"MS";"ARAL MOREIRA";254;15;37;306
2019;"BANDEIRANTES (MS)";"MS";"BANDEIRANTES";247;15;56;318
2019;"BATAGUASSU (MS)";"MS";"BATAGUASSU";522;50;251;823
2019;"BATAYPORA (MS)";"MS";"BATAYPORA";211;18;42;271
2019;"BELA VISTA (MS)";"MS";"BELA VISTA";364;55;85;504
2019;"BODOQUENA (MS)";"MS";"BODOQUENA";118;28;47;193
2019;"BONITO (MS)";"MS";"BONITO";385;79;96;560
2019;"BRASILANDIA (MS)";"MS";"BRASILANDIA";307;37;111;455
2019;"CAARAPO (MS)";"MS";"CAARAPO";721;21;210;952
2019;"CAMAPUA (MS)";"MS";"CAMAPUA";424;55;52;531
2019;"CAMPO GRANDE (MS)";"MS";"CAMPO GRANDE";16255;1094;2266;19615
2019;"CARACOL (MS)";"MS";"CARACOL";85;18;20;123
2019;"CASSILANDIA (MS)";"MS";"CASSILANDIA";524;33;63;620
2019;"CHAPADAO DO SUL (MS)";"MS";"CHAPADAO DO SUL";1045;39;139;1223
2019;"CORGUINHO (MS)";"MS";"CORGUINHO";71;19;32;122
2019;"CORONEL SAPUCAIA (MS)";"MS";"CORONEL SAPUCAIA";384;12;41;437
2019;"CORUMBA (MS)";"MS";"CORUMBA";1059;92;282;1433
2019;"COSTA RICA (MS)";"MS";"COSTA RICA";600;32;180;812
2019;"COXIM (MS)";"MS";"COXIM";721;29;98;848
2019;"DEODAPOLIS (MS)";"MS";"DEODAPOLIS";324;33;119;476
2019;"DOIS IRMAOS DO BURITI (MS)";"MS";"DOIS IRMAOS DO BURITI";187;37;40;264
2019;"DOURADINA (MS)";"MS";"DOURADINA";318;13;31;362
2019;"DOURADOS (MS)";"MS";"DOURADOS";4647;290;524;5461
2019;"ELDORADO (MS)";"MS";"ELDORADO";287;22;46;355
2019;"FATIMA DO SUL (MS)";"MS";"FATIMA DO SUL";510;16;50;576
2019;"FIGUEIRAO (MS)";"MS";"FIGUEIRAO";66;25;9;100
2019;"GLORIA DE DOURADOS (MS)";"MS";"GLORIA DE DOURADOS";224;11;34;269
2019;"GUIA LOPES DA LAGUNA (MS)";"MS";"GUIA LOPES DA LAGUNA";229;24;33;286
2019;"IGUATEMI (MS)";"MS";"IGUATEMI";310;10;86;406
2019;"INOCENCIA (MS)";"MS";"INOCENCIA";237;12;52;301
2019;"ITAPORA (MS)";"MS";"ITAPORA";530;30;53;613
2019;"ITAQUIRAI (MS)";"MS";"ITAQUIRAI";301;13;136;450
2019;"IVINHEMA (MS)";"MS";"IVINHEMA";791;88;303;1182
2019;"JAPORA (MS)";"MS";"JAPORA";56;4;29;89
2019;"JARAGUARI (MS)";"MS";"JARAGUARI";106;11;21;138
2019;"JARDIM (MS)";"MS";"JARDIM";577;26;77;680
2019;"JATEI (MS)";"MS";"JATEI";68;8;50;126
2019;"JUTI (MS)";"MS";"JUTI";120;15;37;172
2019;"LADARIO (MS)";"MS";"LADARIO";194;29;69;292
2019;"LAGUNA CARAPA (MS)";"MS";"LAGUNA CARAPA";247;8;37;292
2019;"MARACAJU (MS)";"MS";"MARACAJU";1313;55;179;1547
2019;"MIRANDA (MS)";"MS";"MIRANDA";415;38;141;594
2019;"MUNDO NOVO (MS)";"MS";"MUNDO NOVO";338;48;33;419
2019;"NAVIRAI (MS)";"MS";"NAVIRAI";1129;51;203;1383
2019;"NIOAQUE (MS)";"MS";"NIOAQUE";231;26;74;331
2019;"NOVA ALVORADA DO SUL (MS)";"MS";"NOVA ALVORADA DO SUL";445;41;85;571
2019;"NOVA ANDRADINA (MS)";"MS";"NOVA ANDRADINA";1215;53;300;1568
2019;"NOVO HORIZONTE DO SUL (MS)";"MS";"NOVO HORIZONTE DO SUL";95;10;27;132
2019;"PARAISO DAS AGUAS (MS)";"MS";"PARAISO DAS AGUAS";110;23;27;160
2019;"PARANAIBA (MS)";"MS";"PARANAIBA";940;49;131;1120
2019;"PARANHOS (MS)";"MS";"PARANHOS";126;10;41;177
2019;"PEDRO GOMES (MS)";"MS";"PEDRO GOMES";136;12;21;169
2019;"PONTA PORA (MS)";"MS";"PONTA PORA";2306;140;396;2842
2019;"PORTO MURTINHO (MS)";"MS";"PORTO MURTINHO";99;21;34;154
2019;"RIBAS DO RIO PARDO (MS)";"MS";"RIBAS DO RIO PARDO";683;81;108;872
2019;"RIO BRILHANTE (MS)";"MS";"RIO BRILHANTE";785;55;163;1003
2019;"RIO NEGRO (MS)";"MS";"RIO NEGRO";104;12;11;127
2019;"RIO VERDE DE MATO GROSSO (MS)";"MS";"RIO VERDE DE MATO GROSSO";447;30;43;520
2019;"ROCHEDO (MS)";"MS";"ROCHEDO";82;5;15;102
2019;"SANTA RITA DO PARDO (MS)";"MS";"SANTA RITA DO PARDO";169;19;50;238
2019;"SAO GABRIEL DO OESTE (MS)";"MS";"SAO GABRIEL DO OESTE";1147;36;117;1300
2019;"SELVIRIA (MS)";"MS";"SELVIRIA";125;20;37;182
2019;"SETE QUEDAS (MS)";"MS";"SETE QUEDAS";291;11;28;330
2019;"SIDROLANDIA (MS)";"MS";"SIDROLANDIA";801;198;351;1350
2019;"SONORA (MS)";"MS";"SONORA";290;36;120;446
2019;"TACURU (MS)";"MS";"TACURU";144;10;29;183
2019;"TAQUARUSSU (MS)";"MS";"TAQUARUSSU";68;7;21;96
2019;"TERENOS (MS)";"MS";"TERENOS";408;18;77;503
2019;"TRES LAGOAS (MS)";"MS";"TRES LAGOAS";2146;248;429;2823
2019;"VICENTINA (MS)";"MS";"VICENTINA";177;10;117;304
2019;"ACORIZAL (MT)";"MT";"ACORIZAL";28;7;3;38
2019;"AGUA BOA (MT)";"MT";"AGUA BOA";769;28;63;860
2019;"ALTA FLORESTA (MT)";"MT";"ALTA FLORESTA";1614;43;164;1821
2019;"ALTO ARAGUAIA (MT)";"MT";"ALTO ARAGUAIA";273;31;43;347
2019;"ALTO BOA VISTA (MT)";"MT";"ALTO BOA VISTA";78;0;8;86
2019;"ALTO GARCAS (MT)";"MT";"ALTO GARCAS";332;20;65;417
2019;"ALTO PARAGUAI (MT)";"MT";"ALTO PARAGUAI";51;9;8;68
2019;"ALTO TAQUARI (MT)";"MT";"ALTO TAQUARI";298;25;32;355
2019;"APIACAS (MT)";"MT";"APIACAS";176;9;14;199
2019;"ARAGUAIANA (MT)";"MT";"ARAGUAIANA";27;3;6;36
2019;"ARAGUAINHA (MT)";"MT";"ARAGUAINHA";12;2;1;15
2019;"ARAPUTANGA (MT)";"MT";"ARAPUTANGA";315;14;35;364
2019;"ARENAPOLIS (MT)";"MT";"ARENAPOLIS";260;14;73;347
2019;"ARIPUANA (MT)";"MT";"ARIPUANA";532;14;67;613
2019;"BARAO DE MELGACO (MT)";"MT";"BARAO DE MELGACO";28;5;7;40
2019;"BARRA DO BUGRES (MT)";"MT";"BARRA DO BUGRES";679;24;184;887
2019;"BARRA DO GARCAS (MT)";"MT";"BARRA DO GARCAS";1090;36;270;1396
2019;"BOM JESUS DO ARAGUAIA (MT)";"MT";"BOM JESUS DO ARAGUAIA";116;5;25;146
2019;"BRASNORTE (MT)";"MT";"BRASNORTE";439;12;74;525
2019;"CACERES (MT)";"MT";"CACERES";1198;68;401;1667
2019;"CAMPINAPOLIS (MT)";"MT";"CAMPINAPOLIS";165;6;29;200
2019;"CAMPO NOVO DO PARECIS (MT)";"MT";"CAMPO NOVO DO PARECIS";1053;82;220;1355
2019;"CAMPO VERDE (MT)";"MT";"CAMPO VERDE";1182;68;190;1440
2019;"CAMPOS DE JULIO (MT)";"MT";"CAMPOS DE JULIO";411;13;53;477
2019;"CANABRAVA DO NORTE (MT)";"MT";"CANABRAVA DO NORTE";57;0;12;69
2019;"CANARANA (MT)";"MT";"CANARANA";700;20;47;767
2019;"CARLINDA (MT)";"MT";"CARLINDA";187;2;30;219
2019;"CASTANHEIRA (MT)";"MT";"CASTANHEIRA";196;2;38;236
2019;"CHAPADA DOS GUIMARAES (MT)";"MT";"CHAPADA DOS GUIMARAES";268;44;63;375
2019;"CLAUDIA (MT)";"MT";"CLAUDIA";476;8;34;518
2019;"COCALINHO (MT)";"MT";"COCALINHO";73;3;11;87
2019;"COLIDER (MT)";"MT";"COLIDER";985;27;148;1160
2019;"COLNIZA (MT)";"MT";"COLNIZA";546;2;36;584
2019;"COMODORO (MT)";"MT";"COMODORO";747;15;111;873
2019;"CONFRESA (MT)";"MT";"CONFRESA";452;8;78;538
2019;"CONQUISTA D OESTE (MT)";"MT";"CONQUISTA D OESTE";78;5;16;99
2019;"COTRIGUACU (MT)";"MT";"COTRIGUACU";193;7;45;245
2019;"CUIABA (MT)";"MT";"CUIABA";10975;940;3331;15246
2019;"CURVELANDIA (MT)";"MT";"CURVELANDIA";128;2;24;154
2019;"DENISE (MT)";"MT";"DENISE";106;7;37;150
2019;"DIAMANTINO (MT)";"MT";"DIAMANTINO";672;22;110;804
2019;"DOM AQUINO (MT)";"MT";"DOM AQUINO";143;12;34;189
2019;"FELIZ NATAL (MT)";"MT";"FELIZ NATAL";327;4;29;360
2019;"FIGUEIROPOLIS D OESTE (MT)";"MT";"FIGUEIROPOLIS D OESTE";79;3;11;93
2019;"GAUCHA DO NORTE (MT)";"MT";"GAUCHA DO NORTE";190;6;33;229
2019;"GENERAL CARNEIRO (MT)";"MT";"GENERAL CARNEIRO";35;7;10;52
2019;"GLORIA D OESTE (MT)";"MT";"GLORIA D OESTE";79;4;19;102
2019;"GUARANTA DO NORTE (MT)";"MT";"GUARANTA DO NORTE";1086;21;111;1218
2019;"GUIRATINGA (MT)";"MT";"GUIRATINGA";227;18;19;264
2019;"INDIAVAI (MT)";"MT";"INDIAVAI";29;3;8;40
2019;"IPIRANGA DO NORTE (MT)";"MT";"IPIRANGA DO NORTE";210;9;19;238
2019;"ITANHANGA (MT)";"MT";"ITANHANGA";228;8;17;253
2019;"ITAUBA (MT)";"MT";"ITAUBA";148;13;17;178
2019;"ITIQUIRA (MT)";"MT";"ITIQUIRA";205;30;87;322
2019;"JACIARA (MT)";"MT";"JACIARA";735;52;171;958
2019;"JANGADA (MT)";"MT";"JANGADA";81;10;22;113
2019;"JAURU (MT)";"MT";"JAURU";177;13;48;238
2019;"JUARA (MT)";"MT";"JUARA";1041;27;97;1165
2019;"JUINA (MT)";"MT";"JUINA";1209;24;104;1337
2019;"JURUENA (MT)";"MT";"JURUENA";234;3;22;259
2019;"JUSCIMEIRA (MT)";"MT";"JUSCIMEIRA";178;10;79;267
2019;"LAMBARI D OESTE (MT)";"MT";"LAMBARI D OESTE";108;3;35;146
2019;"LUCAS DO RIO VERDE (MT)";"MT";"LUCAS DO RIO VERDE";2099;81;201;2381
2019;"LUCIARA (MT)";"MT";"LUCIARA";14;1;3;18
2019;"MARCELANDIA (MT)";"MT";"MARCELANDIA";476;11;29;516
2019;"MATUPA (MT)";"MT";"MATUPA";508;14;59;581
2019;"MIRASSOL D OESTE (MT)";"MT";"MIRASSOL D OESTE";989;17;109;1115
2019;"NOBRES (MT)";"MT";"NOBRES";380;44;60;484
2019;"NORTELANDIA (MT)";"MT";"NORTELANDIA";93;7;26;126
2019;"NOSSA SENHORA DO LIVRAMENTO (MT)";"MT";"NOSSA SENHORA DO LIVRAMENTO";161;15;41;217
2019;"NOVA BANDEIRANTES (MT)";"MT";"NOVA BANDEIRANTES";273;6;45;324
2019;"NOVA BRASILANDIA (MT)";"MT";"NOVA BRASILANDIA";97;3;14;114
2019;"NOVA CANAA DO NORTE (MT)";"MT";"NOVA CANAA DO NORTE";293;9;69;371
2019;"NOVA GUARITA (MT)";"MT";"NOVA GUARITA";135;3;20;158
2019;"NOVA LACERDA (MT)";"MT";"NOVA LACERDA";192;6;38;236
2019;"NOVA MARILANDIA (MT)";"MT";"NOVA MARILANDIA";56;7;8;71
2019;"NOVA MARINGA (MT)";"MT";"NOVA MARINGA";142;9;16;167
2019;"NOVA MONTE VERDE (MT)";"MT";"NOVA MONTE VERDE";228;4;15;247
2019;"NOVA MUTUM (MT)";"MT";"NOVA MUTUM";1293;31;165;1489
2019;"NOVA NAZARE (MT)";"MT";"NOVA NAZARE";13;8;8;29
2019;"NOVA OLIMPIA (MT)";"MT";"NOVA OLIMPIA";458;15;153;626
2019;"NOVA SANTA HELENA (MT)";"MT";"NOVA SANTA HELENA";85;8;19;112
2019;"NOVA UBIRATA (MT)";"MT";"NOVA UBIRATA";303;27;43;373
2019;"NOVA XAVANTINA (MT)";"MT";"NOVA XAVANTINA";545;36;48;629
2019;"NOVO HORIZONTE DO NORTE (MT)";"MT";"NOVO HORIZONTE DO NORTE";68;2;11;81
2019;"NOVO MUNDO (MT)";"MT";"NOVO MUNDO";153;5;26;184
2019;"NOVO SANTO ANTONIO (MT)";"MT";"NOVO SANTO ANTONIO";5;2;3;10
2019;"NOVO SAO JOAQUIM (MT)";"MT";"NOVO SAO JOAQUIM";134;10;22;166
2019;"PARANAITA (MT)";"MT";"PARANAITA";294;15;80;389
2019;"PARANATINGA (MT)";"MT";"PARANATINGA";607;29;98;734
2019;"PEDRA PRETA (MT)";"MT";"PEDRA PRETA";398;11;64;473
2019;"PEIXOTO DE AZEVEDO (MT)";"MT";"PEIXOTO DE AZEVEDO";539;16;96;651
2019;"PLANALTO DA SERRA (MT)";"MT";"PLANALTO DA SERRA";42;2;12;56
2019;"POCONE (MT)";"MT";"POCONE";628;33;48;709
2019;"PONTAL DO ARAGUAIA (MT)";"MT";"PONTAL DO ARAGUAIA";41;5;3;49
2019;"PONTE BRANCA (MT)";"MT";"PONTE BRANCA";11;1;1;13
2019;"PONTES E LACERDA (MT)";"MT";"PONTES E LACERDA";1139;29;153;1321
2019;"PORTO ALEGRE DO NORTE (MT)";"MT";"PORTO ALEGRE DO NORTE";138;7;39;184
2019;"PORTO DOS GAUCHOS (MT)";"MT";"PORTO DOS GAUCHOS";183;16;10;209
2019;"PORTO ESPERIDIAO (MT)";"MT";"PORTO ESPERIDIAO";174;13;66;253
2019;"PORTO ESTRELA (MT)";"MT";"PORTO ESTRELA";42;4;12;58
2019;"POXOREO (MT)";"MT";"POXOREO";211;26;47;284
2019;"PRIMAVERA DO LESTE (MT)";"MT";"PRIMAVERA DO LESTE";2446;112;248;2806
2019;"QUERENCIA (MT)";"MT";"QUERENCIA";559;53;97;709
2019;"RESERVA DO CABACAL (MT)";"MT";"RESERVA DO CABACAL";22;1;7;30
2019;"RIBEIRAO CASCALHEIRA (MT)";"MT";"RIBEIRAO CASCALHEIRA";182;17;23;222
2019;"RIBEIRAOZINHO (MT)";"MT";"RIBEIRAOZINHO";31;2;9;42
2019;"RIO BRANCO (MT)";"MT";"RIO BRANCO";96;4;34;134
2019;"RONDOLANDIA (MT)";"MT";"RONDOLANDIA";196;5;29;230
2019;"RONDONOPOLIS (MT)";"MT";"RONDONOPOLIS";4985;213;556;5754
2019;"ROSARIO OESTE (MT)";"MT";"ROSARIO OESTE";209;19;55;283
2019;"SALTO DO CEU (MT)";"MT";"SALTO DO CEU";69;12;25;106
2019;"SANTA CARMEM (MT)";"MT";"SANTA CARMEM";193;10;24;227
2019;"SANTA CRUZ DO XINGU (MT)";"MT";"SANTA CRUZ DO XINGU";17;4;9;30
2019;"SANTA RITA DO TRIVELATO (MT)";"MT";"SANTA RITA DO TRIVELATO";114;3;16;133
2019;"SANTA TEREZINHA (MT)";"MT";"SANTA TEREZINHA";16;3;20;39
2019;"SANTO AFONSO (MT)";"MT";"SANTO AFONSO";38;4;13;55
2019;"SANTO ANTONIO DO LESTE (MT)";"MT";"SANTO ANTONIO DO LESTE";76;8;26;110
2019;"SANTO ANTONIO DO LEVERGER (MT)";"MT";"SANTO ANTONIO DO LEVERGER";166;17;15;198
2019;"SAO FELIX DO ARAGUAIA (MT)";"MT";"SAO FELIX DO ARAGUAIA";81;29;40;150
2019;"SAO JOSE DO POVO (MT)";"MT";"SAO JOSE DO POVO";26;5;7;38
2019;"SAO JOSE DO RIO CLARO (MT)";"MT";"SAO JOSE DO RIO CLARO";410;17;61;488
2019;"SAO JOSE DO XINGU (MT)";"MT";"SAO JOSE DO XINGU";44;3;16;63
2019;"SAO JOSE DOS QUATRO MARCOS (MT)";"MT";"SAO JOSE DOS QUATRO MARCOS";543;17;85;645
2019;"SAO PEDRO DA CIPA (MT)";"MT";"SAO PEDRO DA CIPA";27;8;27;62
2019;"SAPEZAL (MT)";"MT";"SAPEZAL";760;65;148;973
2019;"SERRA NOVA DOURADA (MT)";"MT";"SERRA NOVA DOURADA";8;2;5;15
2019;"SINOP (MT)";"MT";"SINOP";4123;155;247;4525
2019;"SORRISO (MT)";"MT";"SORRISO";2934;118;278;3330
2019;"TABAPORA (MT)";"MT";"TABAPORA";225;5;32;262
2019;"TANGARA DA SERRA (MT)";"MT";"TANGARA DA SERRA";2332;95;267;2694
2019;"TAPURAH (MT)";"MT";"TAPURAH";421;7;50;478
2019;"TERRA NOVA DO NORTE (MT)";"MT";"TERRA NOVA DO NORTE";332;14;47;393
2019;"TESOURO (MT)";"MT";"TESOURO";26;7;5;38
2019;"TORIXOREU (MT)";"MT";"TORIXOREU";62;6;6;74
2019;"UNIAO DO SUL (MT)";"MT";"UNIAO DO SUL";121;3;11;135
2019;"VALE DE SAO DOMINGOS (MT)";"MT";"VALE DE SAO DOMINGOS";27;1;15;43
2019;"VARZEA GRANDE (MT)";"MT";"VARZEA GRANDE";5553;375;713;6641
2019;"VERA (MT)";"MT";"VERA";316;3;32;351
2019;"VILA BELA DA SANTISSIMA TRINDA (MT)";"MT";"VILA BELA DA SANTISSIMA TRINDA";190;8;58;256
2019;"VILA RICA (MT)";"MT";"VILA RICA";425;3;48;476
2019;"ABAETETUBA (PA)";"PA";"ABAETETUBA";466;32;309;807
2019;"ABEL FIGUEIREDO (PA)";"PA";"ABEL FIGUEIREDO";75;6;7;88
2019;"ACARA (PA)";"PA";"ACARA";109;15;103;227
2019;"AFUA (PA)";"PA";"AFUA";1;0;0;1
2019;"AGUA AZUL DO NORTE (PA)";"PA";"AGUA AZUL DO NORTE";115;12;39;166
2019;"ALENQUER (PA)";"PA";"ALENQUER";215;6;91;312
2019;"ALMEIRIM (PA)";"PA";"ALMEIRIM";294;24;104;422
2019;"ALTAMIRA (PA)";"PA";"ALTAMIRA";1936;193;395;2524
2019;"ANAJAS (PA)";"PA";"ANAJAS";0;1;1;2
2019;"ANANINDEUA (PA)";"PA";"ANANINDEUA";4474;394;1681;6549
2019;"ANAPU (PA)";"PA";"ANAPU";200;19;26;245
2019;"AUGUSTO CORREA (PA)";"PA";"AUGUSTO CORREA";90;4;88;182
2019;"AURORA DO PARA (PA)";"PA";"AURORA DO PARA";107;17;85;209
2019;"AVEIRO (PA)";"PA";"AVEIRO";7;0;6;13
2019;"BAGRE (PA)";"PA";"BAGRE";2;0;2;4
2019;"BAIAO (PA)";"PA";"BAIAO";70;6;28;104
2019;"BANNACH (PA)";"PA";"BANNACH";28;1;6;35
2019;"BARCARENA (PA)";"PA";"BARCARENA";1159;173;855;2187
2019;"BELEM (PA)";"PA";"BELEM";8908;2137;3867;14912
2019;"BELTERRA (PA)";"PA";"BELTERRA";72;12;81;165
2019;"BENEVIDES (PA)";"PA";"BENEVIDES";1099;69;181;1349
2019;"BOM JESUS DO TOCANTINS (PA)";"PA";"BOM JESUS DO TOCANTINS";83;10;10;103
2019;"BONITO (PA)";"PA";"BONITO";68;5;106;179
2019;"BRAGANCA (PA)";"PA";"BRAGANCA";502;44;237;783
2019;"BRASIL NOVO (PA)";"PA";"BRASIL NOVO";208;12;13;233
2019;"BREJO GRANDE DO ARAGUAIA (PA)";"PA";"BREJO GRANDE DO ARAGUAIA";32;3;11;46
2019;"BREU BRANCO (PA)";"PA";"BREU BRANCO";357;16;132;505
2019;"BREVES (PA)";"PA";"BREVES";65;1;11;77
2019;"BUJARU (PA)";"PA";"BUJARU";49;11;43;103
2019;"CACHOEIRA DO ARARI (PA)";"PA";"CACHOEIRA DO ARARI";19;2;20;41
2019;"CACHOEIRA DO PIRIA (PA)";"PA";"CACHOEIRA DO PIRIA";54;6;33;93
2019;"CAMETA (PA)";"PA";"CAMETA";177;10;90;277
2019;"CANAA DOS CARAJAS (PA)";"PA";"CANAA DOS CARAJAS";483;106;244;833
2019;"CAPANEMA (PA)";"PA";"CAPANEMA";862;37;125;1024
2019;"CAPITAO POCO (PA)";"PA";"CAPITAO POCO";517;24;132;673
2019;"CASTANHAL (PA)";"PA";"CASTANHAL";2982;182;481;3645
2019;"CHAVES (PA)";"PA";"CHAVES";1;0;0;1
2019;"COLARES (PA)";"PA";"COLARES";12;0;5;17
2019;"CONCEICAO DO ARAGUAIA (PA)";"PA";"CONCEICAO DO ARAGUAIA";478;45;127;650
2019;"CONCORDIA DO PARA (PA)";"PA";"CONCORDIA DO PARA";174;13;84;271
2019;"CUMARU DO NORTE (PA)";"PA";"CUMARU DO NORTE";35;2;10;47
2019;"CURIONOPOLIS (PA)";"PA";"CURIONOPOLIS";310;120;36;466
2019;"CURRALINHO (PA)";"PA";"CURRALINHO";4;0;2;6
2019;"CURUA (PA)";"PA";"CURUA";11;1;5;17
2019;"CURUCA (PA)";"PA";"CURUCA";68;14;29;111
2019;"DOM ELISEU (PA)";"PA";"DOM ELISEU";627;72;58;757
2019;"ELDORADO DOS CARAJAS (PA)";"PA";"ELDORADO DOS CARAJAS";229;55;28;312
2019;"FARO (PA)";"PA";"FARO";4;1;1;6
2019;"FLORESTA DO ARAGUAIA (PA)";"PA";"FLORESTA DO ARAGUAIA";248;4;22;274
2019;"GARRAFAO DO NORTE (PA)";"PA";"GARRAFAO DO NORTE";153;11;28;192
2019;"GOIANESIA DO PARA (PA)";"PA";"GOIANESIA DO PARA";325;30;50;405
2019;"GURUPA (PA)";"PA";"GURUPA";14;0;3;17
2019;"IGARAPE ACU (PA)";"PA";"IGARAPE ACU";271;90;147;508
2019;"IGARAPE MIRI (PA)";"PA";"IGARAPE MIRI";134;29;53;216
2019;"INHANGAPI (PA)";"PA";"INHANGAPI";46;4;35;85
2019;"IPIXUNA DO PARA (PA)";"PA";"IPIXUNA DO PARA";119;17;66;202
2019;"IRITUIA (PA)";"PA";"IRITUIA";115;9;63;187
2019;"ITAITUBA (PA)";"PA";"ITAITUBA";1482;45;194;1721
2019;"ITUPIRANGA (PA)";"PA";"ITUPIRANGA";329;111;51;491
2019;"JACAREACANGA (PA)";"PA";"JACAREACANGA";58;2;5;65
2019;"JACUNDA (PA)";"PA";"JACUNDA";638;23;61;722
2019;"JURUTI (PA)";"PA";"JURUTI";111;12;44;167
2019;"LIMOEIRO DO AJURU (PA)";"PA";"LIMOEIRO DO AJURU";3;0;5;8
2019;"MAE DO RIO (PA)";"PA";"MAE DO RIO";373;30;89;492
2019;"MAGALHAES BARATA (PA)";"PA";"MAGALHAES BARATA";14;8;13;35
2019;"MARABA (PA)";"PA";"MARABA";3892;304;775;4971
2019;"MARACANA (PA)";"PA";"MARACANA";31;16;41;88
2019;"MARAPANIM (PA)";"PA";"MARAPANIM";38;15;39;92
2019;"MARITUBA (PA)";"PA";"MARITUBA";1182;105;553;1840
2019;"MEDICILANDIA (PA)";"PA";"MEDICILANDIA";217;11;47;275
2019;"MELGACO (PA)";"PA";"MELGACO";7;0;4;11
2019;"MOCAJUBA (PA)";"PA";"MOCAJUBA";24;4;16;44
2019;"MOJU (PA)";"PA";"MOJU";263;20;279;562
2019;"MOJUI DOS CAMPOS (PA)";"PA";"MOJUI DOS CAMPOS";71;1;61;133
2019;"MONTE ALEGRE (PA)";"PA";"MONTE ALEGRE";365;20;236;621
2019;"MUANA (PA)";"PA";"MUANA";6;3;12;21
2019;"NOVA ESPERANCA DO PIRIA (PA)";"PA";"NOVA ESPERANCA DO PIRIA";106;8;29;143
2019;"NOVA IPIXUNA (PA)";"PA";"NOVA IPIXUNA";172;3;32;207
2019;"NOVA TIMBOTEUA (PA)";"PA";"NOVA TIMBOTEUA";84;8;23;115
2019;"NOVO PROGRESSO (PA)";"PA";"NOVO PROGRESSO";991;11;55;1057
2019;"NOVO REPARTIMENTO (PA)";"PA";"NOVO REPARTIMENTO";566;43;81;690
2019;"OBIDOS (PA)";"PA";"OBIDOS";232;9;80;321
2019;"OEIRAS DO PARA (PA)";"PA";"OEIRAS DO PARA";9;1;12;22
2019;"ORIXIMINA (PA)";"PA";"ORIXIMINA";362;14;50;426
2019;"OUREM (PA)";"PA";"OUREM";158;3;22;183
2019;"OURILANDIA DO NORTE (PA)";"PA";"OURILANDIA DO NORTE";357;12;31;400
2019;"PACAJA (PA)";"PA";"PACAJA";187;35;17;239
2019;"PALESTINA DO PARA (PA)";"PA";"PALESTINA DO PARA";26;6;5;37
2019;"PARAGOMINAS (PA)";"PA";"PARAGOMINAS";1912;101;259;2272
2019;"PARAUAPEBAS (PA)";"PA";"PARAUAPEBAS";2897;625;1409;4931
2019;"PAU D ARCO (PA)";"PA";"PAU D ARCO";35;13;11;59
2019;"PEIXE BOI (PA)";"PA";"PEIXE BOI";39;9;22;70
2019;"PICARRA (PA)";"PA";"PICARRA";35;1;8;44
2019;"PLACAS (PA)";"PA";"PLACAS";124;7;10;141
2019;"PONTA DE PEDRAS (PA)";"PA";"PONTA DE PEDRAS";22;2;5;29
2019;"PORTEL (PA)";"PA";"PORTEL";25;2;11;38
2019;"PORTO DE MOZ (PA)";"PA";"PORTO DE MOZ";27;1;7;35
2019;"PRAINHA (PA)";"PA";"PRAINHA";42;1;8;51
2019;"PRIMAVERA (PA)";"PA";"PRIMAVERA";36;7;26;69
2019;"QUATIPURU (PA)";"PA";"QUATIPURU";14;8;20;42
2019;"REDENCAO (PA)";"PA";"REDENCAO";2092;109;234;2435
2019;"RIO MARIA (PA)";"PA";"RIO MARIA";366;31;59;456
2019;"RONDON DO PARA (PA)";"PA";"RONDON DO PARA";560;49;31;640
2019;"RUROPOLIS (PA)";"PA";"RUROPOLIS";294;11;29;334
2019;"SALINOPOLIS (PA)";"PA";"SALINOPOLIS";274;44;122;440
2019;"SALVATERRA (PA)";"PA";"SALVATERRA";62;36;32;130
2019;"SANTA BARBARA DO PARA (PA)";"PA";"SANTA BARBARA DO PARA";85;24;113;222
2019;"SANTA CRUZ DO ARARI (PA)";"PA";"SANTA CRUZ DO ARARI";5;1;1;7
2019;"SANTA ISABEL DO PARA (PA)";"PA";"SANTA ISABEL DO PARA";856;64;213;1133
2019;"SANTA LUZIA DO PARA (PA)";"PA";"SANTA LUZIA DO PARA";132;14;41;187
2019;"SANTA MARIA DAS BARREIRAS (PA)";"PA";"SANTA MARIA DAS BARREIRAS";154;7;51;212
2019;"SANTA MARIA DO PARA (PA)";"PA";"SANTA MARIA DO PARA";404;26;81;511
2019;"SANTANA DO ARAGUAIA (PA)";"PA";"SANTANA DO ARAGUAIA";403;19;57;479
2019;"SANTAREM (PA)";"PA";"SANTAREM";3405;158;939;4502
2019;"SANTAREM NOVO (PA)";"PA";"SANTAREM NOVO";11;5;20;36
2019;"SANTO ANTONIO DO TAUA (PA)";"PA";"SANTO ANTONIO DO TAUA";172;24;110;306
2019;"SAO CAETANO DE ODIVELAS (PA)";"PA";"SAO CAETANO DE ODIVELAS";30;2;22;54
2019;"SAO DOMINGOS DO ARAGUAIA (PA)";"PA";"SAO DOMINGOS DO ARAGUAIA";199;25;32;256
2019;"SAO DOMINGOS DO CAPIM (PA)";"PA";"SAO DOMINGOS DO CAPIM";47;0;37;84
2019;"SAO FELIX DO XINGU (PA)";"PA";"SAO FELIX DO XINGU";441;11;56;508
2019;"SAO FRANCISCO DO PARA (PA)";"PA";"SAO FRANCISCO DO PARA";78;40;29;147
2019;"SAO GERALDO DO ARAGUAIA (PA)";"PA";"SAO GERALDO DO ARAGUAIA";152;12;23;187
2019;"SAO JOAO DA PONTA (PA)";"PA";"SAO JOAO DA PONTA";5;3;9;17
2019;"SAO JOAO DE PIRABAS (PA)";"PA";"SAO JOAO DE PIRABAS";38;10;33;81
2019;"SAO JOAO DO ARAGUAIA (PA)";"PA";"SAO JOAO DO ARAGUAIA";44;15;13;72
2019;"SAO MIGUEL DO GUAMA (PA)";"PA";"SAO MIGUEL DO GUAMA";515;29;141;685
2019;"SAO SEBASTIAO DA BOA VISTA (PA)";"PA";"SAO SEBASTIAO DA BOA VISTA";5;0;1;6
2019;"SAPUCAIA (PA)";"PA";"SAPUCAIA";52;4;14;70
2019;"SENADOR JOSE PORFIRIO (PA)";"PA";"SENADOR JOSE PORFIRIO";48;3;12;63
2019;"SOURE (PA)";"PA";"SOURE";39;5;16;60
2019;"TAILANDIA (PA)";"PA";"TAILANDIA";888;41;247;1176
2019;"TERRA ALTA (PA)";"PA";"TERRA ALTA";21;16;18;55
2019;"TERRA SANTA (PA)";"PA";"TERRA SANTA";35;0;3;38
2019;"TOME ACU (PA)";"PA";"TOME ACU";607;22;183;812
2019;"TRACUATEUA (PA)";"PA";"TRACUATEUA";55;5;93;153
2019;"TRAIRAO (PA)";"PA";"TRAIRAO";197;4;18;219
2019;"TUCUMA (PA)";"PA";"TUCUMA";771;20;103;894
2019;"TUCURUI (PA)";"PA";"TUCURUI";979;86;247;1312
2019;"ULIANOPOLIS (PA)";"PA";"ULIANOPOLIS";273;32;60;365
2019;"URUARA (PA)";"PA";"URUARA";590;24;42;656
2019;"VIGIA (PA)";"PA";"VIGIA";156;23;92;271
2019;"VISEU (PA)";"PA";"VISEU";93;7;60;160
2019;"VITORIA DO XINGU (PA)";"PA";"VITORIA DO XINGU";70;24;30;124
2019;"XINGUARA (PA)";"PA";"XINGUARA";1253;29;145;1427
2019;"AGUA BRANCA (PB)";"PB";"AGUA BRANCA";17;17;6;40
2019;"AGUIAR (PB)";"PB";"AGUIAR";17;8;3;28
2019;"ALAGOA GRANDE (PB)";"PB";"ALAGOA GRANDE";133;39;49;221
2019;"ALAGOA NOVA (PB)";"PB";"ALAGOA NOVA";169;36;12;217
2019;"ALAGOINHA (PB)";"PB";"ALAGOINHA";47;18;43;108
2019;"ALCANTIL (PB)";"PB";"ALCANTIL";68;16;17;101
2019;"ALGODAO DE JANDAIRA (PB)";"PB";"ALGODAO DE JANDAIRA";37;1;7;45
2019;"ALHANDRA (PB)";"PB";"ALHANDRA";208;27;56;291
2019;"AMPARO (PB)";"PB";"AMPARO";15;12;6;33
2019;"APARECIDA (PB)";"PB";"APARECIDA";44;5;19;68
2019;"ARACAGI (PB)";"PB";"ARACAGI";95;5;64;164
2019;"ARARA (PB)";"PB";"ARARA";100;10;20;130
2019;"ARARUNA (PB)";"PB";"ARARUNA";102;46;18;166
2019;"AREIA (PB)";"PB";"AREIA";133;45;30;208
2019;"AREIA DE BARAUNAS (PB)";"PB";"AREIA DE BARAUNAS";7;4;2;13
2019;"AREIAL (PB)";"PB";"AREIAL";56;14;12;82
2019;"AROEIRAS (PB)";"PB";"AROEIRAS";109;80;24;213
2019;"ASSUNCAO (PB)";"PB";"ASSUNCAO";31;6;6;43
2019;"BAIA DA TRAICAO (PB)";"PB";"BAIA DA TRAICAO";16;10;17;43
2019;"BANANEIRAS (PB)";"PB";"BANANEIRAS";135;34;36;205
2019;"BARAUNA (PB)";"PB";"BARAUNA";23;3;8;34
2019;"BARRA DE SANTA ROSA (PB)";"PB";"BARRA DE SANTA ROSA";91;9;23;123
2019;"BARRA DE SANTANA (PB)";"PB";"BARRA DE SANTANA";103;10;20;133
2019;"BARRA DE SAO MIGUEL (PB)";"PB";"BARRA DE SAO MIGUEL";18;5;6;29
2019;"BAYEUX (PB)";"PB";"BAYEUX";716;63;203;982
2019;"BELEM (PB)";"PB";"BELEM";150;13;16;179
2019;"BELEM DO BREJO DO CRUZ (PB)";"PB";"BELEM DO BREJO DO CRUZ";17;10;4;31
2019;"BERNARDINO BATISTA (PB)";"PB";"BERNARDINO BATISTA";8;2;5;15
2019;"BOA VENTURA (PB)";"PB";"BOA VENTURA";16;5;4;25
2019;"BOA VISTA (PB)";"PB";"BOA VISTA";103;8;24;135
2019;"BOM JESUS (PB)";"PB";"BOM JESUS";11;1;3;15
2019;"BOM SUCESSO (PB)";"PB";"BOM SUCESSO";11;5;9;25
2019;"BONITO DE SANTA FE (PB)";"PB";"BONITO DE SANTA FE";41;17;4;62
2019;"BOQUEIRAO (PB)";"PB";"BOQUEIRAO";240;19;27;286
2019;"BORBOREMA (PB)";"PB";"BORBOREMA";40;8;3;51
2019;"BREJO DO CRUZ (PB)";"PB";"BREJO DO CRUZ";60;13;10;83
2019;"BREJO DOS SANTOS (PB)";"PB";"BREJO DOS SANTOS";25;4;4;33
2019;"CAAPORA (PB)";"PB";"CAAPORA";69;12;21;102
2019;"CABACEIRAS (PB)";"PB";"CABACEIRAS";39;8;19;66
2019;"CABEDELO (PB)";"PB";"CABEDELO";507;45;46;598
2019;"CACHOEIRA DOS INDIOS (PB)";"PB";"CACHOEIRA DOS INDIOS";20;9;9;38
2019;"CACIMBA DE AREIA (PB)";"PB";"CACIMBA DE AREIA";5;7;5;17
2019;"CACIMBA DE DENTRO (PB)";"PB";"CACIMBA DE DENTRO";87;19;35;141
2019;"CACIMBAS (PB)";"PB";"CACIMBAS";6;13;5;24
2019;"CAICARA (PB)";"PB";"CAICARA";17;4;5;26
2019;"CAJAZEIRAS (PB)";"PB";"CAJAZEIRAS";424;56;74;554
2019;"CAJAZEIRINHAS (PB)";"PB";"CAJAZEIRINHAS";4;0;3;7
2019;"CALDAS BRANDAO (PB)";"PB";"CALDAS BRANDAO";43;5;9;57
2019;"CAMALAU (PB)";"PB";"CAMALAU";39;13;17;69
2019;"CAMPINA GRANDE (PB)";"PB";"CAMPINA GRANDE";4256;381;878;5515
2019;"CAPIM (PB)";"PB";"CAPIM";34;12;22;68
2019;"CARAUBAS (PB)";"PB";"CARAUBAS";15;13;4;32
2019;"CARRAPATEIRA (PB)";"PB";"CARRAPATEIRA";6;1;3;10
2019;"CASSERENGUE (PB)";"PB";"CASSERENGUE";48;10;18;76
2019;"CATINGUEIRA (PB)";"PB";"CATINGUEIRA";20;5;2;27
2019;"CATOLE DO ROCHA (PB)";"PB";"CATOLE DO ROCHA";240;55;17;312
2019;"CATURITE (PB)";"PB";"CATURITE";107;20;15;142
2019;"CONCEICAO (PB)";"PB";"CONCEICAO";109;36;9;154
2019;"CONDADO (PB)";"PB";"CONDADO";37;8;9;54
2019;"CONDE (PB)";"PB";"CONDE";157;31;27;215
2019;"CONGO (PB)";"PB";"CONGO";26;10;6;42
2019;"COREMAS (PB)";"PB";"COREMAS";80;29;11;120
2019;"COXIXOLA (PB)";"PB";"COXIXOLA";7;10;4;21
2019;"CRUZ DO ESPIRITO SANTO (PB)";"PB";"CRUZ DO ESPIRITO SANTO";35;9;32;76
2019;"CUBATI (PB)";"PB";"CUBATI";43;10;6;59
2019;"CUITE (PB)";"PB";"CUITE";85;12;20;117
2019;"CUITE DE MAMANGUAPE (PB)";"PB";"CUITE DE MAMANGUAPE";22;11;42;75
2019;"CUITEGI (PB)";"PB";"CUITEGI";23;4;3;30
2019;"CURRAL DE CIMA (PB)";"PB";"CURRAL DE CIMA";18;5;19;42
2019;"CURRAL VELHO (PB)";"PB";"CURRAL VELHO";8;3;3;14
2019;"DAMIAO (PB)";"PB";"DAMIAO";37;9;8;54
2019;"DESTERRO (PB)";"PB";"DESTERRO";26;14;6;46
2019;"DIAMANTE (PB)";"PB";"DIAMANTE";19;5;5;29
2019;"DONA INES (PB)";"PB";"DONA INES";53;16;24;93
2019;"DUAS ESTRADAS (PB)";"PB";"DUAS ESTRADAS";13;6;5;24
2019;"EMAS (PB)";"PB";"EMAS";10;6;5;21
2019;"ESPERANCA (PB)";"PB";"ESPERANCA";557;32;91;680
2019;"FAGUNDES (PB)";"PB";"FAGUNDES";47;15;35;97
2019;"FREI MARTINHO (PB)";"PB";"FREI MARTINHO";10;2;6;18
2019;"GADO BRAVO (PB)";"PB";"GADO BRAVO";59;36;20;115
2019;"GUARABIRA (PB)";"PB";"GUARABIRA";576;79;246;901
2019;"GURINHEM (PB)";"PB";"GURINHEM";63;11;32;106
2019;"GURJAO (PB)";"PB";"GURJAO";24;3;6;33
2019;"IBIARA (PB)";"PB";"IBIARA";10;4;5;19
2019;"IGARACY (PB)";"PB";"IGARACY";19;6;5;30
2019;"IMACULADA (PB)";"PB";"IMACULADA";16;14;6;36
2019;"INGA (PB)";"PB";"INGA";129;17;40;186
2019;"ITABAIANA (PB)";"PB";"ITABAIANA";159;18;41;218
2019;"ITAPORANGA (PB)";"PB";"ITAPORANGA";160;44;28;232
2019;"ITAPOROROCA (PB)";"PB";"ITAPOROROCA";140;5;39;184
2019;"ITATUBA (PB)";"PB";"ITATUBA";41;5;16;62
2019;"JACARAU (PB)";"PB";"JACARAU";68;10;24;102
2019;"JERICO (PB)";"PB";"JERICO";27;7;3;37
2019;"JOAO PESSOA (PB)";"PB";"JOAO PESSOA";6382;1154;2382;9918
2019;"JUAREZ TAVORA (PB)";"PB";"JUAREZ TAVORA";37;6;15;58
2019;"JUAZEIRINHO (PB)";"PB";"JUAZEIRINHO";86;21;18;125
2019;"JUNCO DO SERIDO (PB)";"PB";"JUNCO DO SERIDO";58;4;6;68
2019;"JURIPIRANGA (PB)";"PB";"JURIPIRANGA";58;6;23;87
2019;"JURU (PB)";"PB";"JURU";19;3;5;27
2019;"LAGOA (PB)";"PB";"LAGOA";19;3;6;28
2019;"LAGOA DE DENTRO (PB)";"PB";"LAGOA DE DENTRO";55;9;16;80
2019;"LAGOA SECA (PB)";"PB";"LAGOA SECA";269;44;20;333
2019;"LASTRO (PB)";"PB";"LASTRO";9;5;4;18
2019;"LIVRAMENTO (PB)";"PB";"LIVRAMENTO";40;9;7;56
2019;"LOGRADOURO (PB)";"PB";"LOGRADOURO";5;3;10;18
2019;"LUCENA (PB)";"PB";"LUCENA";35;6;26;67
2019;"MAE D AGUA (PB)";"PB";"MAE D AGUA";5;2;4;11
2019;"MALTA (PB)";"PB";"MALTA";12;8;4;24
2019;"MAMANGUAPE (PB)";"PB";"MAMANGUAPE";496;21;104;621
2019;"MANAIRA (PB)";"PB";"MANAIRA";29;18;6;53
2019;"MARCACAO (PB)";"PB";"MARCACAO";6;4;17;27
2019;"MARI (PB)";"PB";"MARI";118;12;60;190
2019;"MARIZOPOLIS (PB)";"PB";"MARIZOPOLIS";38;5;5;48
2019;"MASSARANDUBA (PB)";"PB";"MASSARANDUBA";49;35;13;97
2019;"MATARACA (PB)";"PB";"MATARACA";50;5;19;74
2019;"MATINHAS (PB)";"PB";"MATINHAS";15;1;4;20
2019;"MATO GROSSO (PB)";"PB";"MATO GROSSO";13;2;3;18
2019;"MATUREIA (PB)";"PB";"MATUREIA";19;35;11;65
2019;"MOGEIRO (PB)";"PB";"MOGEIRO";39;8;10;57
2019;"MONTADAS (PB)";"PB";"MONTADAS";62;11;8;81
2019;"MONTE HOREBE (PB)";"PB";"MONTE HOREBE";8;4;5;17
2019;"MONTEIRO (PB)";"PB";"MONTEIRO";319;89;69;477
2019;"MULUNGU (PB)";"PB";"MULUNGU";65;11;21;97
2019;"NATUBA (PB)";"PB";"NATUBA";40;10;7;57
2019;"NAZAREZINHO (PB)";"PB";"NAZAREZINHO";29;6;5;40
2019;"NOVA FLORESTA (PB)";"PB";"NOVA FLORESTA";37;9;9;55
2019;"NOVA OLINDA (PB)";"PB";"NOVA OLINDA";26;6;5;37
2019;"NOVA PALMEIRA (PB)";"PB";"NOVA PALMEIRA";33;2;4;39
2019;"OLHO D AGUA (PB)";"PB";"OLHO D AGUA";14;5;6;25
2019;"OLIVEDOS (PB)";"PB";"OLIVEDOS";45;3;12;60
2019;"OURO VELHO (PB)";"PB";"OURO VELHO";14;11;7;32
2019;"PARARI (PB)";"PB";"PARARI";6;1;2;9
2019;"PASSAGEM (PB)";"PB";"PASSAGEM";19;3;3;25
2019;"PATOS (PB)";"PB";"PATOS";695;162;61;918
2019;"PAULISTA (PB)";"PB";"PAULISTA";70;13;14;97
2019;"PEDRA BRANCA (PB)";"PB";"PEDRA BRANCA";11;6;5;22
2019;"PEDRA LAVRADA (PB)";"PB";"PEDRA LAVRADA";48;4;12;64
2019;"PEDRAS DE FOGO (PB)";"PB";"PEDRAS DE FOGO";326;39;108;473
2019;"PEDRO REGIS (PB)";"PB";"PEDRO REGIS";21;1;5;27
2019;"PIANCO (PB)";"PB";"PIANCO";98;27;8;133
2019;"PICUI (PB)";"PB";"PICUI";129;16;57;202
2019;"PILAR (PB)";"PB";"PILAR";36;4;16;56
2019;"PILOES (PB)";"PB";"PILOES";37;2;13;52
2019;"PILOEZINHOS (PB)";"PB";"PILOEZINHOS";11;3;6;20
2019;"PIRPIRITUBA (PB)";"PB";"PIRPIRITUBA";46;0;14;60
2019;"PITIMBU (PB)";"PB";"PITIMBU";42;37;10;89
2019;"POCINHOS (PB)";"PB";"POCINHOS";163;30;31;224
2019;"POCO DANTAS (PB)";"PB";"POCO DANTAS";10;1;5;16
2019;"POCO DE JOSE DE MOURA (PB)";"PB";"POCO DE JOSE DE MOURA";8;4;6;18
2019;"POMBAL (PB)";"PB";"POMBAL";326;61;24;411
2019;"PRATA (PB)";"PB";"PRATA";29;13;6;48
2019;"PRINCESA ISABEL (PB)";"PB";"PRINCESA ISABEL";143;103;31;277
2019;"PUXINANA (PB)";"PB";"PUXINANA";82;37;19;138
2019;"QUEIMADAS (PB)";"PB";"QUEIMADAS";526;126;100;752
2019;"QUIXABA (PB)";"PB";"QUIXABA";9;1;4;14
2019;"REMIGIO (PB)";"PB";"REMIGIO";263;10;37;310
2019;"RIACHAO (PB)";"PB";"RIACHAO";7;2;8;17
2019;"RIACHAO DO BACAMARTE (PB)";"PB";"RIACHAO DO BACAMARTE";29;4;5;38
2019;"RIACHAO DO POCO (PB)";"PB";"RIACHAO DO POCO";31;1;18;50
2019;"RIACHO DE SANTO ANTONIO (PB)";"PB";"RIACHO DE SANTO ANTONIO";18;8;3;29
2019;"RIACHO DOS CAVALOS (PB)";"PB";"RIACHO DOS CAVALOS";32;3;5;40
2019;"RIO TINTO (PB)";"PB";"RIO TINTO";113;20;52;185
2019;"SALGADINHO (PB)";"PB";"SALGADINHO";5;4;5;14
2019;"SALGADO DE SAO FELIX (PB)";"PB";"SALGADO DE SAO FELIX";23;11;15;49
2019;"SANTA CECILIA (PB)";"PB";"SANTA CECILIA";63;11;14;88
2019;"SANTA CRUZ (PB)";"PB";"SANTA CRUZ";19;2;18;39
2019;"SANTA HELENA (PB)";"PB";"SANTA HELENA";11;5;13;29
2019;"SANTA INES (PB)";"PB";"SANTA INES";13;3;3;19
2019;"SANTA LUZIA (PB)";"PB";"SANTA LUZIA";147;17;18;182
2019;"SANTA RITA (PB)";"PB";"SANTA RITA";980;107;299;1386
2019;"SANTA TERESINHA (PB)";"PB";"SANTA TERESINHA";24;3;5;32
2019;"SANTANA DE MANGUEIRA (PB)";"PB";"SANTANA DE MANGUEIRA";3;2;3;8
2019;"SANTANA DOS GARROTES (PB)";"PB";"SANTANA DOS GARROTES";18;14;4;36
2019;"SANTAREM (PB)";"PB";"SANTAREM";7;5;4;16
2019;"SANTO ANDRE (PB)";"PB";"SANTO ANDRE";19;4;27;50
2019;"SAO BENTINHO (PB)";"PB";"SAO BENTINHO";19;7;4;30
2019;"SAO BENTO (PB)";"PB";"SAO BENTO";216;32;33;281
2019;"SAO DOMINGOS DE POMBAL (PB)";"PB";"SAO DOMINGOS DE POMBAL";8;7;6;21
2019;"SAO DOMINGOS DO CARIRI (PB)";"PB";"SAO DOMINGOS DO CARIRI";9;7;5;21
2019;"SAO FRANCISCO (PB)";"PB";"SAO FRANCISCO";11;2;5;18
2019;"SAO JOAO DO CARIRI (PB)";"PB";"SAO JOAO DO CARIRI";35;7;10;52
2019;"SAO JOAO DO RIO DO PEIXE (PB)";"PB";"SAO JOAO DO RIO DO PEIXE";70;13;22;105
2019;"SAO JOAO DO TIGRE (PB)";"PB";"SAO JOAO DO TIGRE";16;2;5;23
2019;"SAO JOSE DA LAGOA TAPADA (PB)";"PB";"SAO JOSE DA LAGOA TAPADA";33;8;7;48
2019;"SAO JOSE DE CAIANA (PB)";"PB";"SAO JOSE DE CAIANA";11;10;8;29
2019;"SAO JOSE DE ESPINHARAS (PB)";"PB";"SAO JOSE DE ESPINHARAS";18;5;6;29
2019;"SAO JOSE DE PIRANHAS (PB)";"PB";"SAO JOSE DE PIRANHAS";54;19;13;86
2019;"SAO JOSE DE PRINCESA (PB)";"PB";"SAO JOSE DE PRINCESA";6;25;3;34
2019;"SAO JOSE DO BONFIM (PB)";"PB";"SAO JOSE DO BONFIM";11;2;4;17
2019;"SAO JOSE DO BREJO DO CRUZ (PB)";"PB";"SAO JOSE DO BREJO DO CRUZ";3;3;2;8
2019;"SAO JOSE DO SABUGI (PB)";"PB";"SAO JOSE DO SABUGI";24;2;8;34
2019;"SAO JOSE DOS CORDEIROS (PB)";"PB";"SAO JOSE DOS CORDEIROS";19;8;7;34
2019;"SAO JOSE DOS RAMOS (PB)";"PB";"SAO JOSE DOS RAMOS";25;0;13;38
2019;"SAO MAMEDE (PB)";"PB";"SAO MAMEDE";33;3;7;43
2019;"SAO MIGUEL DE TAIPU (PB)";"PB";"SAO MIGUEL DE TAIPU";24;1;8;33
2019;"SAO SEBASTIAO DE LAGOA DE ROCA (PB)";"PB";"SAO SEBASTIAO DE LAGOA DE ROCA";121;19;16;156
2019;"SAO SEBASTIAO DO UMBUZEIRO (PB)";"PB";"SAO SEBASTIAO DO UMBUZEIRO";12;5;6;23
2019;"SAO VICENTE DO SERIDO (PB)";"PB";"SAO VICENTE DO SERIDO";39;6;14;59
2019;"SAPE (PB)";"PB";"SAPE";419;33;129;581
2019;"SERRA BRANCA (PB)";"PB";"SERRA BRANCA";111;24;11;146
2019;"SERRA DA RAIZ (PB)";"PB";"SERRA DA RAIZ";9;1;7;17
2019;"SERRA GRANDE (PB)";"PB";"SERRA GRANDE";7;3;5;15
2019;"SERRA REDONDA (PB)";"PB";"SERRA REDONDA";30;11;5;46
2019;"SERRARIA (PB)";"PB";"SERRARIA";22;9;12;43
2019;"SERTAOZINHO (PB)";"PB";"SERTAOZINHO";12;3;17;32
2019;"SOBRADO (PB)";"PB";"SOBRADO";89;3;8;100
2019;"SOLANEA (PB)";"PB";"SOLANEA";256;38;44;338
2019;"SOLEDADE (PB)";"PB";"SOLEDADE";187;28;30;245
2019;"SOSSEGO (PB)";"PB";"SOSSEGO";24;5;6;35
2019;"SOUSA (PB)";"PB";"SOUSA";988;57;85;1130
2019;"SUME (PB)";"PB";"SUME";137;31;24;192
2019;"TACIMA (PB)";"PB";"TACIMA";38;6;18;62
2019;"TAPEROA (PB)";"PB";"TAPEROA";90;24;12;126
2019;"TAVARES (PB)";"PB";"TAVARES";28;16;12;56
2019;"TEIXEIRA (PB)";"PB";"TEIXEIRA";106;27;20;153
2019;"TENORIO (PB)";"PB";"TENORIO";12;0;5;17
2019;"TRIUNFO (PB)";"PB";"TRIUNFO";26;7;6;39
2019;"UIRAUNA (PB)";"PB";"UIRAUNA";79;13;5;97
2019;"UMBUZEIRO (PB)";"PB";"UMBUZEIRO";70;29;34;133
2019;"VARZEA (PB)";"PB";"VARZEA";16;7;5;28
2019;"VIEIROPOLIS (PB)";"PB";"VIEIROPOLIS";9;5;11;25
2019;"VISTA SERRANA (PB)";"PB";"VISTA SERRANA";16;3;5;24
2019;"ZABELE (PB)";"PB";"ZABELE";21;13;9;43
2019;"ABREU E LIMA (PE)";"PE";"ABREU E LIMA";697;87;373;1157
2019;"AFOGADOS DA INGAZEIRA (PE)";"PE";"AFOGADOS DA INGAZEIRA";502;110;98;710
2019;"AFRANIO (PE)";"PE";"AFRANIO";226;22;26;274
2019;"AGRESTINA (PE)";"PE";"AGRESTINA";214;51;36;301
2019;"AGUA PRETA (PE)";"PE";"AGUA PRETA";172;79;83;334
2019;"AGUAS BELAS (PE)";"PE";"AGUAS BELAS";389;99;73;561
2019;"ALAGOINHA (PE)";"PE";"ALAGOINHA";154;60;20;234
2019;"ALIANCA (PE)";"PE";"ALIANCA";178;27;141;346
2019;"ALTINHO (PE)";"PE";"ALTINHO";112;80;40;232
2019;"AMARAJI (PE)";"PE";"AMARAJI";135;29;55;219
2019;"ANGELIM (PE)";"PE";"ANGELIM";55;40;10;105
2019;"ARACOIABA (PE)";"PE";"ARACOIABA";99;37;97;233
2019;"ARARIPINA (PE)";"PE";"ARARIPINA";1085;90;89;1264
2019;"ARCOVERDE (PE)";"PE";"ARCOVERDE";1242;210;147;1599
2019;"BARRA DE GUABIRABA (PE)";"PE";"BARRA DE GUABIRABA";72;23;16;111
2019;"BARREIROS (PE)";"PE";"BARREIROS";286;43;83;412
2019;"BELEM DE MARIA (PE)";"PE";"BELEM DE MARIA";93;41;19;153
2019;"BELEM DE SAO FRANCISCO (PE)";"PE";"BELEM DE SAO FRANCISCO";119;39;26;184
2019;"BELO JARDIM (PE)";"PE";"BELO JARDIM";930;439;113;1482
2019;"BETANIA (PE)";"PE";"BETANIA";53;19;16;88
2019;"BEZERROS (PE)";"PE";"BEZERROS";905;174;120;1199
2019;"BODOCO (PE)";"PE";"BODOCO";246;13;29;288
2019;"BOM CONSELHO (PE)";"PE";"BOM CONSELHO";337;68;49;454
2019;"BOM JARDIM (PE)";"PE";"BOM JARDIM";308;319;78;705
2019;"BONITO (PE)";"PE";"BONITO";421;105;55;581
2019;"BREJAO (PE)";"PE";"BREJAO";72;30;16;118
2019;"BREJINHO (PE)";"PE";"BREJINHO";61;19;8;88
2019;"BREJO DA MADRE DE DEUS (PE)";"PE";"BREJO DA MADRE DE DEUS";452;468;23;943
2019;"BUENOS AIRES (PE)";"PE";"BUENOS AIRES";66;13;24;103
2019;"BUIQUE (PE)";"PE";"BUIQUE";292;132;63;487
2019;"CABO DE SANTO AGOSTINHO (PE)";"PE";"CABO DE SANTO AGOSTINHO";1532;282;538;2352
2019;"CABROBO (PE)";"PE";"CABROBO";289;26;30;345
2019;"CACHOEIRINHA (PE)";"PE";"CACHOEIRINHA";233;80;17;330
2019;"CAETES (PE)";"PE";"CAETES";324;83;54;461
2019;"CALCADO (PE)";"PE";"CALCADO";86;17;29;132
2019;"CALUMBI (PE)";"PE";"CALUMBI";56;7;9;72
2019;"CAMARAGIBE (PE)";"PE";"CAMARAGIBE";794;213;163;1170
2019;"CAMOCIM DE SAO FELIX (PE)";"PE";"CAMOCIM DE SAO FELIX";171;53;15;239
2019;"CAMUTANGA (PE)";"PE";"CAMUTANGA";103;2;24;129
2019;"CANHOTINHO (PE)";"PE";"CANHOTINHO";233;103;31;367
2019;"CAPOEIRAS (PE)";"PE";"CAPOEIRAS";285;69;28;382
2019;"CARNAIBA (PE)";"PE";"CARNAIBA";150;66;29;245
2019;"CARNAUBEIRA DA PENHA (PE)";"PE";"CARNAUBEIRA DA PENHA";44;19;7;70
2019;"CARPINA (PE)";"PE";"CARPINA";1010;147;184;1341
2019;"CARUARU (PE)";"PE";"CARUARU";5073;941;789;6803
2019;"CASINHAS (PE)";"PE";"CASINHAS";97;147;23;267
2019;"CATENDE (PE)";"PE";"CATENDE";200;85;85;370
2019;"CEDRO (PE)";"PE";"CEDRO";40;6;15;61
2019;"CHA DE ALEGRIA (PE)";"PE";"CHA DE ALEGRIA";51;36;41;128
2019;"CHA GRANDE (PE)";"PE";"CHA GRANDE";356;72;38;466
2019;"CONDADO (PE)";"PE";"CONDADO";148;32;67;247
2019;"CORRENTES (PE)";"PE";"CORRENTES";90;57;16;163
2019;"CORTES (PE)";"PE";"CORTES";192;52;40;284
2019;"CUMARU (PE)";"PE";"CUMARU";194;115;18;327
2019;"CUPIRA (PE)";"PE";"CUPIRA";303;103;24;430
2019;"CUSTODIA (PE)";"PE";"CUSTODIA";406;115;49;570
2019;"DORMENTES (PE)";"PE";"DORMENTES";330;26;44;400
2019;"ESCADA (PE)";"PE";"ESCADA";389;89;171;649
2019;"EXU (PE)";"PE";"EXU";322;11;39;372
2019;"FEIRA NOVA (PE)";"PE";"FEIRA NOVA";289;65;26;380
2019;"FERNANDO DE NORONHA (PE)";"PE";"FERNANDO DE NORONHA";12;21;11;44
2019;"FERREIROS (PE)";"PE";"FERREIROS";91;1;52;144
2019;"FLORES (PE)";"PE";"FLORES";128;63;23;214
2019;"FLORESTA (PE)";"PE";"FLORESTA";517;42;36;595
2019;"FREI MIGUELINHO (PE)";"PE";"FREI MIGUELINHO";259;143;26;428
2019;"GAMELEIRA (PE)";"PE";"GAMELEIRA";84;15;65;164
2019;"GARANHUNS (PE)";"PE";"GARANHUNS";1791;329;156;2276
2019;"GLORIA DO GOITA (PE)";"PE";"GLORIA DO GOITA";223;72;66;361
2019;"GOIANA (PE)";"PE";"GOIANA";821;246;183;1250
2019;"GRANITO (PE)";"PE";"GRANITO";36;2;14;52
2019;"GRAVATA (PE)";"PE";"GRAVATA";1050;156;103;1309
2019;"IATI (PE)";"PE";"IATI";103;52;30;185
2019;"IBIMIRIM (PE)";"PE";"IBIMIRIM";212;65;25;302
2019;"IBIRAJUBA (PE)";"PE";"IBIRAJUBA";50;16;11;77
2019;"IGARASSU (PE)";"PE";"IGARASSU";1006;134;557;1697
2019;"IGUARACI (PE)";"PE";"IGUARACI";147;32;34;213
2019;"ILHA DE ITAMARACA (PE)";"PE";"ILHA DE ITAMARACA";85;18;22;125
2019;"INAJA (PE)";"PE";"INAJA";80;20;18;118
2019;"INGAZEIRA (PE)";"PE";"INGAZEIRA";39;17;8;64
2019;"IPOJUCA (PE)";"PE";"IPOJUCA";743;344;464;1551
2019;"IPUBI (PE)";"PE";"IPUBI";292;17;39;348
2019;"ITACURUBA (PE)";"PE";"ITACURUBA";26;5;6;37
2019;"ITAIBA (PE)";"PE";"ITAIBA";177;55;26;258
2019;"ITAMBE (PE)";"PE";"ITAMBE";417;49;152;618
2019;"ITAPETIM (PE)";"PE";"ITAPETIM";88;8;12;108
2019;"ITAPISSUMA (PE)";"PE";"ITAPISSUMA";127;39;23;189
2019;"ITAQUITINGA (PE)";"PE";"ITAQUITINGA";46;26;46;118
2019;"JABOATAO DOS GUARARAPES (PE)";"PE";"JABOATAO DOS GUARARAPES";5689;736;2155;8580
2019;"JAQUEIRA (PE)";"PE";"JAQUEIRA";62;12;31;105
2019;"JATAUBA (PE)";"PE";"JATAUBA";229;234;16;479
2019;"JATOBA (PE)";"PE";"JATOBA";60;32;17;109
2019;"JOAO ALFREDO (PE)";"PE";"JOAO ALFREDO";275;632;32;939
2019;"JOAQUIM NABUCO (PE)";"PE";"JOAQUIM NABUCO";85;20;66;171
2019;"JUCATI (PE)";"PE";"JUCATI";121;30;31;182
2019;"JUPI (PE)";"PE";"JUPI";242;53;67;362
2019;"JUREMA (PE)";"PE";"JUREMA";94;51;17;162
2019;"LAGOA DO CARRO (PE)";"PE";"LAGOA DO CARRO";111;11;24;146
2019;"LAGOA DO ITAENGA (PE)";"PE";"LAGOA DO ITAENGA";421;55;68;544
2019;"LAGOA DO OURO (PE)";"PE";"LAGOA DO OURO";52;31;18;101
2019;"LAGOA DOS GATOS (PE)";"PE";"LAGOA DOS GATOS";108;41;7;156
2019;"LAGOA GRANDE (PE)";"PE";"LAGOA GRANDE";183;9;19;211
2019;"LAJEDO (PE)";"PE";"LAJEDO";644;115;67;826
2019;"LIMOEIRO (PE)";"PE";"LIMOEIRO";569;159;87;815
2019;"MACAPARANA (PE)";"PE";"MACAPARANA";212;16;54;282
2019;"MACHADOS (PE)";"PE";"MACHADOS";185;54;22;261
2019;"MANARI (PE)";"PE";"MANARI";65;21;12;98
2019;"MARAIAL (PE)";"PE";"MARAIAL";120;22;32;174
2019;"MIRANDIBA (PE)";"PE";"MIRANDIBA";130;6;12;148
2019;"MOREILANDIA (PE)";"PE";"MOREILANDIA";68;6;10;84
2019;"MORENO (PE)";"PE";"MORENO";783;188;159;1130
2019;"NAZARE DA MATA (PE)";"PE";"NAZARE DA MATA";229;27;61;317
2019;"OLINDA (PE)";"PE";"OLINDA";3050;424;1325;4799
2019;"OROBO (PE)";"PE";"OROBO";230;227;87;544
2019;"OROCO (PE)";"PE";"OROCO";97;4;14;115
2019;"OURICURI (PE)";"PE";"OURICURI";698;42;118;858
2019;"PALMARES (PE)";"PE";"PALMARES";527;137;224;888
2019;"PALMEIRINA (PE)";"PE";"PALMEIRINA";22;19;7;48
2019;"PANELAS (PE)";"PE";"PANELAS";120;83;24;227
2019;"PARANATAMA (PE)";"PE";"PARANATAMA";156;39;34;229
2019;"PARNAMIRIM (PE)";"PE";"PARNAMIRIM";289;10;31;330
2019;"PASSIRA (PE)";"PE";"PASSIRA";312;161;37;510
2019;"PAUDALHO (PE)";"PE";"PAUDALHO";576;51;91;718
2019;"PAULISTA (PE)";"PE";"PAULISTA";1743;407;358;2508
2019;"PEDRA (PE)";"PE";"PEDRA";184;76;27;287
2019;"PESQUEIRA (PE)";"PE";"PESQUEIRA";820;188;158;1166
2019;"PETROLANDIA (PE)";"PE";"PETROLANDIA";375;27;75;477
2019;"PETROLINA (PE)";"PE";"PETROLINA";4552;279;654;5485
2019;"POCAO (PE)";"PE";"POCAO";71;53;14;138
2019;"POMBOS (PE)";"PE";"POMBOS";480;74;60;614
2019;"PRIMAVERA (PE)";"PE";"PRIMAVERA";98;16;49;163
2019;"QUIPAPA (PE)";"PE";"QUIPAPA";103;39;47;189
2019;"QUIXABA (PE)";"PE";"QUIXABA";53;27;13;93
2019;"RECIFE (PE)";"PE";"RECIFE";19530;2465;4023;26018
2019;"RIACHO DAS ALMAS (PE)";"PE";"RIACHO DAS ALMAS";404;128;30;562
2019;"RIBEIRAO (PE)";"PE";"RIBEIRAO";270;53;108;431
2019;"RIO FORMOSO (PE)";"PE";"RIO FORMOSO";121;55;86;262
2019;"SAIRE (PE)";"PE";"SAIRE";105;15;21;141
2019;"SALGADINHO (PE)";"PE";"SALGADINHO";19;61;6;86
2019;"SALGUEIRO (PE)";"PE";"SALGUEIRO";562;57;93;712
2019;"SALOA (PE)";"PE";"SALOA";83;51;14;148
2019;"SANHARO (PE)";"PE";"SANHARO";164;44;45;253
2019;"SANTA CRUZ (PE)";"PE";"SANTA CRUZ";185;9;30;224
2019;"SANTA CRUZ DA BAIXA VERDE (PE)";"PE";"SANTA CRUZ DA BAIXA VERDE";230;19;12;261
2019;"SANTA CRUZ DO CAPIBARIBE (PE)";"PE";"SANTA CRUZ DO CAPIBARIBE";1070;426;72;1568
2019;"SANTA FILOMENA (PE)";"PE";"SANTA FILOMENA";142;11;34;187
2019;"SANTA MARIA DA BOA VISTA (PE)";"PE";"SANTA MARIA DA BOA VISTA";304;21;85;410
2019;"SANTA MARIA DO CAMBUCA (PE)";"PE";"SANTA MARIA DO CAMBUCA";234;125;35;394
2019;"SANTA TEREZINHA (PE)";"PE";"SANTA TEREZINHA";88;15;8;111
2019;"SAO BENEDITO DO SUL (PE)";"PE";"SAO BENEDITO DO SUL";32;17;17;66
2019;"SAO BENTO DO UNA (PE)";"PE";"SAO BENTO DO UNA";1094;91;132;1317
2019;"SAO CAITANO (PE)";"PE";"SAO CAITANO";439;274;45;758
2019;"SAO JOAO (PE)";"PE";"SAO JOAO";150;68;40;258
2019;"SAO JOAQUIM DO MONTE (PE)";"PE";"SAO JOAQUIM DO MONTE";91;51;29;171
2019;"SAO JOSE DA COROA GRANDE (PE)";"PE";"SAO JOSE DA COROA GRANDE";78;21;40;139
2019;"SAO JOSE DO BELMONTE (PE)";"PE";"SAO JOSE DO BELMONTE";345;38;81;464
2019;"SAO JOSE DO EGITO (PE)";"PE";"SAO JOSE DO EGITO";526;59;78;663
2019;"SAO LOURENCO DA MATA (PE)";"PE";"SAO LOURENCO DA MATA";449;107;562;1118
2019;"SAO VICENTE FERRER (PE)";"PE";"SAO VICENTE FERRER";197;16;29;242
2019;"SERRA TALHADA (PE)";"PE";"SERRA TALHADA";1621;143;105;1869
2019;"SERRITA (PE)";"PE";"SERRITA";103;8;15;126
2019;"SERTANIA (PE)";"PE";"SERTANIA";497;92;64;653
2019;"SIRINHAEM (PE)";"PE";"SIRINHAEM";240;52;100;392
2019;"SOLIDAO (PE)";"PE";"SOLIDAO";25;6;9;40
2019;"SURUBIM (PE)";"PE";"SURUBIM";927;707;137;1771
2019;"TABIRA (PE)";"PE";"TABIRA";293;54;51;398
2019;"TACAIMBO (PE)";"PE";"TACAIMBO";126;48;22;196
2019;"TACARATU (PE)";"PE";"TACARATU";72;45;11;128
2019;"TAMANDARE (PE)";"PE";"TAMANDARE";77;37;36;150
2019;"TAQUARITINGA DO NORTE (PE)";"PE";"TAQUARITINGA DO NORTE";346;106;49;501
2019;"TEREZINHA (PE)";"PE";"TEREZINHA";30;16;22;68
2019;"TERRA NOVA (PE)";"PE";"TERRA NOVA";84;2;11;97
2019;"TIMBAUBA (PE)";"PE";"TIMBAUBA";646;42;128;816
2019;"TORITAMA (PE)";"PE";"TORITAMA";343;80;44;467
2019;"TRACUNHAEM (PE)";"PE";"TRACUNHAEM";58;27;20;105
2019;"TRINDADE (PE)";"PE";"TRINDADE";410;49;23;482
2019;"TRIUNFO (PE)";"PE";"TRIUNFO";250;36;16;302
2019;"TUPANATINGA (PE)";"PE";"TUPANATINGA";158;53;32;243
2019;"TUPARETAMA (PE)";"PE";"TUPARETAMA";121;44;21;186
2019;"VENTUROSA (PE)";"PE";"VENTUROSA";205;54;16;275
2019;"VERDEJANTE (PE)";"PE";"VERDEJANTE";70;9;18;97
2019;"VERTENTE DO LERIO (PE)";"PE";"VERTENTE DO LERIO";92;123;19;234
2019;"VERTENTES (PE)";"PE";"VERTENTES";233;91;28;352
2019;"VICENCIA (PE)";"PE";"VICENCIA";318;25;88;431
2019;"VITORIA DE SANTO ANTAO (PE)";"PE";"VITORIA DE SANTO ANTAO";2462;176;388;3026
2019;"XEXEU (PE)";"PE";"XEXEU";77;18;42;137
2019;"ACAUA (PI)";"PI";"ACAUA";140;32;33;205
2019;"AGRICOLANDIA (PI)";"PI";"AGRICOLANDIA";23;3;8;34
2019;"AGUA BRANCA (PI)";"PI";"AGUA BRANCA";215;20;24;259
2019;"ALAGOINHA DO PIAUI (PI)";"PI";"ALAGOINHA DO PIAUI";67;6;5;78
2019;"ALEGRETE DO PIAUI (PI)";"PI";"ALEGRETE DO PIAUI";46;4;4;54
2019;"ALTO LONGA (PI)";"PI";"ALTO LONGA";60;14;37;111
2019;"ALTOS (PI)";"PI";"ALTOS";332;19;80;431
2019;"ALVORADA DO GURGUEIA (PI)";"PI";"ALVORADA DO GURGUEIA";26;4;10;40
2019;"AMARANTE (PI)";"PI";"AMARANTE";91;18;28;137
2019;"ANGICAL DO PIAUI (PI)";"PI";"ANGICAL DO PIAUI";30;4;11;45
2019;"ANISIO DE ABREU (PI)";"PI";"ANISIO DE ABREU";54;18;17;89
2019;"ANTONIO ALMEIDA (PI)";"PI";"ANTONIO ALMEIDA";29;4;6;39
2019;"AROAZES (PI)";"PI";"AROAZES";22;11;11;44
2019;"AROEIRAS DO ITAIM (PI)";"PI";"AROEIRAS DO ITAIM";19;0;13;32
2019;"ARRAIAL (PI)";"PI";"ARRAIAL";13;2;4;19
2019;"ASSUNCAO DO PIAUI (PI)";"PI";"ASSUNCAO DO PIAUI";12;0;4;16
2019;"AVELINO LOPES (PI)";"PI";"AVELINO LOPES";36;11;8;55
2019;"BAIXA GRANDE DO RIBEIRO (PI)";"PI";"BAIXA GRANDE DO RIBEIRO";140;4;26;170
2019;"BARRA D ALCANTARA (PI)";"PI";"BARRA D ALCANTARA";22;3;5;30
2019;"BARRAS (PI)";"PI";"BARRAS";175;27;114;316
2019;"BARREIRAS DO PIAUI (PI)";"PI";"BARREIRAS DO PIAUI";7;1;2;10
2019;"BARRO DURO (PI)";"PI";"BARRO DURO";54;6;6;66
2019;"BATALHA (PI)";"PI";"BATALHA";101;18;23;142
2019;"BELA VISTA DO PIAUI (PI)";"PI";"BELA VISTA DO PIAUI";20;2;7;29
2019;"BELEM DO PIAUI (PI)";"PI";"BELEM DO PIAUI";43;3;3;49
2019;"BENEDITINOS (PI)";"PI";"BENEDITINOS";44;4;15;63
2019;"BERTOLINIA (PI)";"PI";"BERTOLINIA";27;11;13;51
2019;"BETANIA DO PIAUI (PI)";"PI";"BETANIA DO PIAUI";107;30;24;161
2019;"BOA HORA (PI)";"PI";"BOA HORA";26;2;12;40
2019;"BOCAINA (PI)";"PI";"BOCAINA";12;7;4;23
2019;"BOM JESUS (PI)";"PI";"BOM JESUS";384;19;33;436
2019;"BOM PRINCIPIO DO PIAUI (PI)";"PI";"BOM PRINCIPIO DO PIAUI";15;3;12;30
2019;"BONFIM DO PIAUI (PI)";"PI";"BONFIM DO PIAUI";47;6;10;63
2019;"BOQUEIRAO DO PIAUI (PI)";"PI";"BOQUEIRAO DO PIAUI";20;3;5;28
2019;"BRASILEIRA (PI)";"PI";"BRASILEIRA";31;7;10;48
2019;"BREJO DO PIAUI (PI)";"PI";"BREJO DO PIAUI";11;8;3;22
2019;"BURITI DOS LOPES (PI)";"PI";"BURITI DOS LOPES";65;15;24;104
2019;"BURITI DOS MONTES (PI)";"PI";"BURITI DOS MONTES";19;13;5;37
2019;"CABECEIRAS DO PIAUI (PI)";"PI";"CABECEIRAS DO PIAUI";34;3;27;64
2019;"CAJAZEIRAS DO PIAUI (PI)";"PI";"CAJAZEIRAS DO PIAUI";6;0;3;9
2019;"CAJUEIRO DA PRAIA (PI)";"PI";"CAJUEIRO DA PRAIA";18;4;16;38
2019;"CALDEIRAO GRANDE DO PIAUI (PI)";"PI";"CALDEIRAO GRANDE DO PIAUI";52;19;15;86
2019;"CAMPINAS DO PIAUI (PI)";"PI";"CAMPINAS DO PIAUI";11;5;2;18
2019;"CAMPO ALEGRE DO FIDALGO (PI)";"PI";"CAMPO ALEGRE DO FIDALGO";41;5;4;50
2019;"CAMPO GRANDE DO PIAUI (PI)";"PI";"CAMPO GRANDE DO PIAUI";58;14;5;77
2019;"CAMPO LARGO DO PIAUI (PI)";"PI";"CAMPO LARGO DO PIAUI";11;3;6;20
2019;"CAMPO MAIOR (PI)";"PI";"CAMPO MAIOR";504;40;99;643
2019;"CANAVIEIRA (PI)";"PI";"CANAVIEIRA";5;4;1;10
2019;"CANTO DO BURITI (PI)";"PI";"CANTO DO BURITI";125;42;25;192
2019;"CAPITAO DE CAMPOS (PI)";"PI";"CAPITAO DE CAMPOS";43;5;15;63
2019;"CAPITAO GERVASIO OLIVEIRA (PI)";"PI";"CAPITAO GERVASIO OLIVEIRA";31;3;8;42
2019;"CARACOL (PI)";"PI";"CARACOL";77;7;7;91
2019;"CARAUBAS DO PIAUI (PI)";"PI";"CARAUBAS DO PIAUI";31;4;9;44
2019;"CARIDADE DO PIAUI (PI)";"PI";"CARIDADE DO PIAUI";30;1;9;40
2019;"CASTELO DO PIAUI (PI)";"PI";"CASTELO DO PIAUI";80;19;24;123
2019;"CAXINGO (PI)";"PI";"CAXINGO";19;5;10;34
2019;"COCAL (PI)";"PI";"COCAL";207;27;43;277
2019;"COCAL DE TELHA (PI)";"PI";"COCAL DE TELHA";10;5;7;22
2019;"COCAL DOS ALVES (PI)";"PI";"COCAL DOS ALVES";10;18;4;32
2019;"COIVARAS (PI)";"PI";"COIVARAS";14;2;8;24
2019;"COLONIA DO GURGUEIA (PI)";"PI";"COLONIA DO GURGUEIA";22;15;3;40
2019;"COLONIA DO PIAUI (PI)";"PI";"COLONIA DO PIAUI";18;7;10;35
2019;"CONCEICAO DO CANINDE (PI)";"PI";"CONCEICAO DO CANINDE";19;4;5;28
2019;"CORONEL JOSE DIAS (PI)";"PI";"CORONEL JOSE DIAS";23;13;8;44
2019;"CORRENTE (PI)";"PI";"CORRENTE";580;48;86;714
2019;"CRISTALANDIA DO PIAUI (PI)";"PI";"CRISTALANDIA DO PIAUI";26;6;4;36
2019;"CRISTINO CASTRO (PI)";"PI";"CRISTINO CASTRO";56;6;18;80
2019;"CURIMATA (PI)";"PI";"CURIMATA";80;7;9;96
2019;"CURRAIS (PI)";"PI";"CURRAIS";7;2;2;11
2019;"CURRAL NOVO DO PIAUI (PI)";"PI";"CURRAL NOVO DO PIAUI";23;4;4;31
2019;"CURRALINHOS (PI)";"PI";"CURRALINHOS";6;0;2;8
2019;"DEMERVAL LOBAO (PI)";"PI";"DEMERVAL LOBAO";94;7;43;144
2019;"DIRCEU ARCOVERDE (PI)";"PI";"DIRCEU ARCOVERDE";91;13;11;115
2019;"DOM EXPEDITO LOPES (PI)";"PI";"DOM EXPEDITO LOPES";79;15;8;102
2019;"DOM INOCENCIO (PI)";"PI";"DOM INOCENCIO";109;31;20;160
2019;"DOMINGOS MOURAO (PI)";"PI";"DOMINGOS MOURAO";5;1;5;11
2019;"ELESBAO VELOSO (PI)";"PI";"ELESBAO VELOSO";83;13;11;107
2019;"ELISEU MARTINS (PI)";"PI";"ELISEU MARTINS";15;4;3;22
2019;"ESPERANTINA (PI)";"PI";"ESPERANTINA";267;37;74;378
2019;"FARTURA DO PIAUI (PI)";"PI";"FARTURA DO PIAUI";33;13;5;51
2019;"FLORES DO PIAUI (PI)";"PI";"FLORES DO PIAUI";16;8;3;27
2019;"FLORESTA DO PIAUI (PI)";"PI";"FLORESTA DO PIAUI";13;8;4;25
2019;"FLORIANO (PI)";"PI";"FLORIANO";1233;122;85;1440
2019;"FRANCINOPOLIS (PI)";"PI";"FRANCINOPOLIS";20;13;2;35
2019;"FRANCISCO AYRES (PI)";"PI";"FRANCISCO AYRES";11;10;7;28
2019;"FRANCISCO MACEDO (PI)";"PI";"FRANCISCO MACEDO";41;11;9;61
2019;"FRANCISCO SANTOS (PI)";"PI";"FRANCISCO SANTOS";90;11;8;109
2019;"FRONTEIRAS (PI)";"PI";"FRONTEIRAS";189;37;19;245
2019;"GEMINIANO (PI)";"PI";"GEMINIANO";42;16;11;69
2019;"GILBUES (PI)";"PI";"GILBUES";23;9;16;48
2019;"GUADALUPE (PI)";"PI";"GUADALUPE";105;14;9;128
2019;"GUARIBAS (PI)";"PI";"GUARIBAS";15;1;5;21
2019;"HUGO NAPOLEAO (PI)";"PI";"HUGO NAPOLEAO";10;0;2;12
2019;"ILHA GRANDE (PI)";"PI";"ILHA GRANDE";17;9;12;38
2019;"INHUMA (PI)";"PI";"INHUMA";129;8;20;157
2019;"IPIRANGA DO PIAUI (PI)";"PI";"IPIRANGA DO PIAUI";74;17;10;101
2019;"ISAIAS COELHO (PI)";"PI";"ISAIAS COELHO";18;3;8;29
2019;"ITAINOPOLIS (PI)";"PI";"ITAINOPOLIS";66;29;28;123
2019;"ITAUEIRA (PI)";"PI";"ITAUEIRA";83;10;8;101
2019;"JACOBINA DO PIAUI (PI)";"PI";"JACOBINA DO PIAUI";87;4;1;92
2019;"JAICOS (PI)";"PI";"JAICOS";168;33;15;216
2019;"JARDIM DO MULATO (PI)";"PI";"JARDIM DO MULATO";11;1;3;15
2019;"JATOBA DO PIAUI (PI)";"PI";"JATOBA DO PIAUI";39;2;14;55
2019;"JERUMENHA (PI)";"PI";"JERUMENHA";23;3;1;27
2019;"JOAO COSTA (PI)";"PI";"JOAO COSTA";6;0;3;9
2019;"JOAQUIM PIRES (PI)";"PI";"JOAQUIM PIRES";54;6;16;76
2019;"JOCA MARQUES (PI)";"PI";"JOCA MARQUES";9;2;6;17
2019;"JOSE DE FREITAS (PI)";"PI";"JOSE DE FREITAS";172;21;115;308
2019;"JUAZEIRO DO PIAUI (PI)";"PI";"JUAZEIRO DO PIAUI";28;3;6;37
2019;"JULIO BORGES (PI)";"PI";"JULIO BORGES";18;7;5;30
2019;"JUREMA (PI)";"PI";"JUREMA";25;2;28;55
2019;"LAGOA ALEGRE (PI)";"PI";"LAGOA ALEGRE";19;2;33;54
2019;"LAGOA DE SAO FRANCISCO (PI)";"PI";"LAGOA DE SAO FRANCISCO";11;6;5;22
2019;"LAGOA DO BARRO DO PIAUI (PI)";"PI";"LAGOA DO BARRO DO PIAUI";38;13;13;64
2019;"LAGOA DO PIAUI (PI)";"PI";"LAGOA DO PIAUI";18;1;9;28
2019;"LAGOA DO SITIO (PI)";"PI";"LAGOA DO SITIO";19;4;4;27
2019;"LAGOINHA DO PIAUI (PI)";"PI";"LAGOINHA DO PIAUI";6;0;4;10
2019;"LANDRI SALES (PI)";"PI";"LANDRI SALES";25;6;1;32
2019;"LUIS CORREIA (PI)";"PI";"LUIS CORREIA";102;30;60;192
2019;"LUZILANDIA (PI)";"PI";"LUZILANDIA";145;35;54;234
2019;"MADEIRO (PI)";"PI";"MADEIRO";12;4;4;20
2019;"MANOEL EMIDIO (PI)";"PI";"MANOEL EMIDIO";19;4;6;29
2019;"MARCOLANDIA (PI)";"PI";"MARCOLANDIA";656;71;25;752
2019;"MARCOS PARENTE (PI)";"PI";"MARCOS PARENTE";13;10;3;26
2019;"MASSAPE DO PIAUI (PI)";"PI";"MASSAPE DO PIAUI";28;12;11;51
2019;"MATIAS OLIMPIO (PI)";"PI";"MATIAS OLIMPIO";34;7;9;50
2019;"MIGUEL ALVES (PI)";"PI";"MIGUEL ALVES";69;6;58;133
2019;"MIGUEL LEAO (PI)";"PI";"MIGUEL LEAO";6;0;1;7
2019;"MILTON BRANDAO (PI)";"PI";"MILTON BRANDAO";17;4;6;27
2019;"MONSENHOR GIL (PI)";"PI";"MONSENHOR GIL";41;6;9;56
2019;"MONSENHOR HIPOLITO (PI)";"PI";"MONSENHOR HIPOLITO";53;12;7;72
2019;"MONTE ALEGRE DO PIAUI (PI)";"PI";"MONTE ALEGRE DO PIAUI";31;6;13;50
2019;"MORRO CABECA NO TEMPO (PI)";"PI";"MORRO CABECA NO TEMPO";8;1;4;13
2019;"MORRO DO CHAPEU DO PIAUI (PI)";"PI";"MORRO DO CHAPEU DO PIAUI";7;8;12;27
2019;"MURICI DOS PORTELAS (PI)";"PI";"MURICI DOS PORTELAS";13;2;10;25
2019;"NAZARE DO PIAUI (PI)";"PI";"NAZARE DO PIAUI";30;12;11;53
2019;"NAZARIA (PI)";"PI";"NAZARIA";26;0;11;37
2019;"NOSSA SENHORA DE NAZARE (PI)";"PI";"NOSSA SENHORA DE NAZARE";19;6;15;40
2019;"NOSSA SENHORA DOS REMEDIOS (PI)";"PI";"NOSSA SENHORA DOS REMEDIOS";16;5;6;27
2019;"NOVA SANTA RITA (PI)";"PI";"NOVA SANTA RITA";3;5;6;14
2019;"NOVO ORIENTE DO PIAUI (PI)";"PI";"NOVO ORIENTE DO PIAUI";21;6;13;40
2019;"NOVO SANTO ANTONIO (PI)";"PI";"NOVO SANTO ANTONIO";14;1;4;19
2019;"OEIRAS (PI)";"PI";"OEIRAS";390;99;62;551
2019;"OLHO D AGUA DO PIAUI (PI)";"PI";"OLHO D AGUA DO PIAUI";7;2;3;12
2019;"PADRE MARCOS (PI)";"PI";"PADRE MARCOS";112;18;6;136
2019;"PAES LANDIM (PI)";"PI";"PAES LANDIM";10;12;3;25
2019;"PAJEU DO PIAUI (PI)";"PI";"PAJEU DO PIAUI";14;8;3;25
2019;"PALMEIRA DO PIAUI (PI)";"PI";"PALMEIRA DO PIAUI";45;4;6;55
2019;"PALMEIRAIS (PI)";"PI";"PALMEIRAIS";24;3;14;41
2019;"PAQUETA (PI)";"PI";"PAQUETA";23;5;7;35
2019;"PARNAGUA (PI)";"PI";"PARNAGUA";26;5;5;36
2019;"PARNAIBA (PI)";"PI";"PARNAIBA";1436;125;354;1915
2019;"PASSAGEM FRANCA DO PIAUI (PI)";"PI";"PASSAGEM FRANCA DO PIAUI";10;2;6;18
2019;"PATOS DO PIAUI (PI)";"PI";"PATOS DO PIAUI";27;4;9;40
2019;"PAU D ARCO DO PIAUI (PI)";"PI";"PAU D ARCO DO PIAUI";10;0;7;17
2019;"PAULISTANA (PI)";"PI";"PAULISTANA";563;126;174;863
2019;"PAVUSSU (PI)";"PI";"PAVUSSU";16;2;2;20
2019;"PEDRO II (PI)";"PI";"PEDRO II";153;49;28;230
2019;"PEDRO LAURENTINO (PI)";"PI";"PEDRO LAURENTINO";5;3;2;10
2019;"PICOS (PI)";"PI";"PICOS";1924;168;117;2209
2019;"PIMENTEIRAS (PI)";"PI";"PIMENTEIRAS";52;11;7;70
2019;"PIO IX (PI)";"PI";"PIO IX";163;20;21;204
2019;"PIRACURUCA (PI)";"PI";"PIRACURUCA";326;24;90;440
2019;"PIRIPIRI (PI)";"PI";"PIRIPIRI";445;83;191;719
2019;"PORTO (PI)";"PI";"PORTO";18;6;5;29
2019;"PORTO ALEGRE DO PIAUI (PI)";"PI";"PORTO ALEGRE DO PIAUI";12;5;2;19
2019;"PRATA DO PIAUI (PI)";"PI";"PRATA DO PIAUI";12;1;2;15
2019;"QUEIMADA NOVA (PI)";"PI";"QUEIMADA NOVA";116;12;31;159
2019;"REDENCAO DO GURGUEIA (PI)";"PI";"REDENCAO DO GURGUEIA";25;6;14;45
2019;"REGENERACAO (PI)";"PI";"REGENERACAO";110;9;18;137
2019;"RIACHO FRIO (PI)";"PI";"RIACHO FRIO";8;3;5;16
2019;"RIBEIRA DO PIAUI (PI)";"PI";"RIBEIRA DO PIAUI";12;4;3;19
2019;"RIBEIRO GONCALVES (PI)";"PI";"RIBEIRO GONCALVES";32;1;4;37
2019;"RIO GRANDE DO PIAUI (PI)";"PI";"RIO GRANDE DO PIAUI";32;11;7;50
2019;"SANTA CRUZ DO PIAUI (PI)";"PI";"SANTA CRUZ DO PIAUI";29;27;5;61
2019;"SANTA CRUZ DOS MILAGRES (PI)";"PI";"SANTA CRUZ DOS MILAGRES";7;0;4;11
2019;"SANTA FILOMENA (PI)";"PI";"SANTA FILOMENA";39;0;8;47
2019;"SANTA LUZ (PI)";"PI";"SANTA LUZ";16;4;6;26
2019;"SANTA ROSA DO PIAUI (PI)";"PI";"SANTA ROSA DO PIAUI";20;13;13;46
2019;"SANTANA DO PIAUI (PI)";"PI";"SANTANA DO PIAUI";32;12;16;60
2019;"SANTO ANTONIO DE LISBOA (PI)";"PI";"SANTO ANTONIO DE LISBOA";59;16;6;81
2019;"SANTO ANTONIO DOS MILAGRES (PI)";"PI";"SANTO ANTONIO DOS MILAGRES";3;3;2;8
2019;"SANTO INACIO DO PIAUI (PI)";"PI";"SANTO INACIO DO PIAUI";15;8;2;25
2019;"SAO BRAZ DO PIAUI (PI)";"PI";"SAO BRAZ DO PIAUI";38;4;7;49
2019;"SAO FELIX DO PIAUI (PI)";"PI";"SAO FELIX DO PIAUI";8;2;3;13
2019;"SAO FRANCISCO DE ASSIS DO PIAU (PI)";"PI";"SAO FRANCISCO DE ASSIS DO PIAU";26;12;8;46
2019;"SAO FRANCISCO DO PIAUI (PI)";"PI";"SAO FRANCISCO DO PIAUI";15;13;8;36
2019;"SAO GONCALO DO GURGUEIA (PI)";"PI";"SAO GONCALO DO GURGUEIA";5;1;1;7
2019;"SAO GONCALO DO PIAUI (PI)";"PI";"SAO GONCALO DO PIAUI";20;5;4;29
2019;"SAO JOAO DA CANABRAVA (PI)";"PI";"SAO JOAO DA CANABRAVA";23;14;7;44
2019;"SAO JOAO DA FRONTEIRA (PI)";"PI";"SAO JOAO DA FRONTEIRA";9;3;10;22
2019;"SAO JOAO DA SERRA (PI)";"PI";"SAO JOAO DA SERRA";23;1;4;28
2019;"SAO JOAO DA VARJOTA (PI)";"PI";"SAO JOAO DA VARJOTA";7;8;4;19
2019;"SAO JOAO DO ARRAIAL (PI)";"PI";"SAO JOAO DO ARRAIAL";18;4;10;32
2019;"SAO JOAO DO PIAUI (PI)";"PI";"SAO JOAO DO PIAUI";149;48;25;222
2019;"SAO JOSE DO DIVINO (PI)";"PI";"SAO JOSE DO DIVINO";31;5;5;41
2019;"SAO JOSE DO PEIXE (PI)";"PI";"SAO JOSE DO PEIXE";11;1;5;17
2019;"SAO JOSE DO PIAUI (PI)";"PI";"SAO JOSE DO PIAUI";39;12;14;65
2019;"SAO JULIAO (PI)";"PI";"SAO JULIAO";51;13;5;69
2019;"SAO LOURENCO DO PIAUI (PI)";"PI";"SAO LOURENCO DO PIAUI";11;5;6;22
2019;"SAO LUIS DO PIAUI (PI)";"PI";"SAO LUIS DO PIAUI";14;3;3;20
2019;"SAO MIGUEL DA BAIXA GRANDE (PI)";"PI";"SAO MIGUEL DA BAIXA GRANDE";13;3;4;20
2019;"SAO MIGUEL DO FIDALGO (PI)";"PI";"SAO MIGUEL DO FIDALGO";7;4;4;15
2019;"SAO MIGUEL DO TAPUIO (PI)";"PI";"SAO MIGUEL DO TAPUIO";56;7;24;87
2019;"SAO PEDRO DO PIAUI (PI)";"PI";"SAO PEDRO DO PIAUI";59;4;10;73
2019;"SAO RAIMUNDO NONATO (PI)";"PI";"SAO RAIMUNDO NONATO";1077;242;184;1503
2019;"SEBASTIAO BARROS (PI)";"PI";"SEBASTIAO BARROS";11;2;3;16
2019;"SEBASTIAO LEAL (PI)";"PI";"SEBASTIAO LEAL";52;2;3;57
2019;"SIGEFREDO PACHECO (PI)";"PI";"SIGEFREDO PACHECO";50;14;14;78
2019;"SIMOES (PI)";"PI";"SIMOES";151;30;21;202
2019;"SIMPLICIO MENDES (PI)";"PI";"SIMPLICIO MENDES";89;19;13;121
2019;"SOCORRO DO PIAUI (PI)";"PI";"SOCORRO DO PIAUI";11;7;3;21
2019;"SUSSUAPARA (PI)";"PI";"SUSSUAPARA";56;24;10;90
2019;"TAMBORIL DO PIAUI (PI)";"PI";"TAMBORIL DO PIAUI";7;8;1;16
2019;"TANQUE DO PIAUI (PI)";"PI";"TANQUE DO PIAUI";12;7;4;23
2019;"TERESINA (PI)";"PI";"TERESINA";12047;1207;4133;17387
2019;"UNIAO (PI)";"PI";"UNIAO";195;58;101;354
2019;"URUCUI (PI)";"PI";"URUCUI";241;16;32;289
2019;"VALENCA DO PIAUI (PI)";"PI";"VALENCA DO PIAUI";212;43;34;289
2019;"VARZEA BRANCA (PI)";"PI";"VARZEA BRANCA";41;15;33;89
2019;"VARZEA GRANDE (PI)";"PI";"VARZEA GRANDE";18;5;4;27
2019;"VERA MENDES (PI)";"PI";"VERA MENDES";20;4;4;28
2019;"VILA NOVA DO PIAUI (PI)";"PI";"VILA NOVA DO PIAUI";27;10;5;42
2019;"WALL FERRAZ (PI)";"PI";"WALL FERRAZ";17;18;9;44
2019;"ABATIA (PR)";"PR";"ABATIA";171;10;50;231
2019;"ADRIANOPOLIS (PR)";"PR";"ADRIANOPOLIS";143;8;31;182
2019;"AGUDOS DO SUL (PR)";"PR";"AGUDOS DO SUL";576;26;47;649
2019;"ALMIRANTE TAMANDARE (PR)";"PR";"ALMIRANTE TAMANDARE";1756;129;272;2157
2019;"ALTAMIRA DO PARANA (PR)";"PR";"ALTAMIRA DO PARANA";62;6;16;84
2019;"ALTO PARAISO (PR)";"PR";"ALTO PARAISO";68;16;15;99
2019;"ALTO PARANA (PR)";"PR";"ALTO PARANA";347;25;107;479
2019;"ALTO PIQUIRI (PR)";"PR";"ALTO PIQUIRI";236;15;56;307
2019;"ALTONIA (PR)";"PR";"ALTONIA";549;37;66;652
2019;"ALVORADA DO SUL (PR)";"PR";"ALVORADA DO SUL";355;9;67;431
2019;"AMAPORA (PR)";"PR";"AMAPORA";84;5;61;150
2019;"AMPERE (PR)";"PR";"AMPERE";550;25;65;640
2019;"ANAHY (PR)";"PR";"ANAHY";111;5;10;126
2019;"ANDIRA (PR)";"PR";"ANDIRA";585;24;103;712
2019;"ANGULO (PR)";"PR";"ANGULO";94;5;12;111
2019;"ANTONINA (PR)";"PR";"ANTONINA";136;23;45;204
2019;"ANTONIO OLINTO (PR)";"PR";"ANTONIO OLINTO";242;10;46;298
2019;"APUCARANA (PR)";"PR";"APUCARANA";2724;413;375;3512
2019;"ARAPONGAS (PR)";"PR";"ARAPONGAS";3472;295;194;3961
2019;"ARAPOTI (PR)";"PR";"ARAPOTI";834;41;88;963
2019;"ARAPUA (PR)";"PR";"ARAPUA";142;6;31;179
2019;"ARARUNA (PR)";"PR";"ARARUNA";474;24;51;549
2019;"ARAUCARIA (PR)";"PR";"ARAUCARIA";3073;371;628;4072
2019;"ARIRANHA DO IVAI (PR)";"PR";"ARIRANHA DO IVAI";67;4;24;95
2019;"ASSAI (PR)";"PR";"ASSAI";522;32;53;607
2019;"ASSIS CHATEAUBRIAND (PR)";"PR";"ASSIS CHATEAUBRIAND";1359;66;98;1523
2019;"ASTORGA (PR)";"PR";"ASTORGA";793;60;117;970
2019;"ATALAIA (PR)";"PR";"ATALAIA";138;12;37;187
2019;"BALSA NOVA (PR)";"PR";"BALSA NOVA";437;51;174;662
2019;"BANDEIRANTES (PR)";"PR";"BANDEIRANTES";966;67;120;1153
2019;"BARBOSA FERRAZ (PR)";"PR";"BARBOSA FERRAZ";262;11;42;315
2019;"BARRA DO JACARE (PR)";"PR";"BARRA DO JACARE";71;7;20;98
2019;"BARRACAO (PR)";"PR";"BARRACAO";333;40;56;429
2019;"BELA VISTA DO CAROBA (PR)";"PR";"BELA VISTA DO CAROBA";86;8;29;123
2019;"BELA VISTA DO PARAISO (PR)";"PR";"BELA VISTA DO PARAISO";481;37;77;595
2019;"BITURUNA (PR)";"PR";"BITURUNA";561;34;228;823
2019;"BOA ESPERANCA (PR)";"PR";"BOA ESPERANCA";216;10;19;245
2019;"BOA ESPERANCA DO IGUACU (PR)";"PR";"BOA ESPERANCA DO IGUACU";76;8;16;100
2019;"BOA VENTURA DE SAO ROQUE (PR)";"PR";"BOA VENTURA DE SAO ROQUE";256;26;52;334
2019;"BOA VISTA DA APARECIDA (PR)";"PR";"BOA VISTA DA APARECIDA";213;20;35;268
2019;"BOCAIUVA DO SUL (PR)";"PR";"BOCAIUVA DO SUL";406;22;34;462
2019;"BOM JESUS DO SUL (PR)";"PR";"BOM JESUS DO SUL";50;11;13;74
2019;"BOM SUCESSO (PR)";"PR";"BOM SUCESSO";150;11;61;222
2019;"BOM SUCESSO DO SUL (PR)";"PR";"BOM SUCESSO DO SUL";152;10;17;179
2019;"BORRAZOPOLIS (PR)";"PR";"BORRAZOPOLIS";341;6;24;371
2019;"BRAGANEY (PR)";"PR";"BRAGANEY";214;5;31;250
2019;"BRASILANDIA DO SUL (PR)";"PR";"BRASILANDIA DO SUL";94;6;13;113
2019;"CAFEARA (PR)";"PR";"CAFEARA";57;10;19;86
2019;"CAFELANDIA (PR)";"PR";"CAFELANDIA";784;79;133;996
2019;"CAFEZAL DO SUL (PR)";"PR";"CAFEZAL DO SUL";114;5;35;154
2019;"CALIFORNIA (PR)";"PR";"CALIFORNIA";328;21;32;381
2019;"CAMBARA (PR)";"PR";"CAMBARA";886;61;113;1060
2019;"CAMBE (PR)";"PR";"CAMBE";2243;317;155;2715
2019;"CAMBIRA (PR)";"PR";"CAMBIRA";318;7;34;359
2019;"CAMPINA DA LAGOA (PR)";"PR";"CAMPINA DA LAGOA";539;33;62;634
2019;"CAMPINA DO SIMAO (PR)";"PR";"CAMPINA DO SIMAO";152;4;41;197
2019;"CAMPINA GRANDE DO SUL (PR)";"PR";"CAMPINA GRANDE DO SUL";903;93;100;1096
2019;"CAMPO BONITO (PR)";"PR";"CAMPO BONITO";130;16;24;170
2019;"CAMPO DO TENENTE (PR)";"PR";"CAMPO DO TENENTE";187;14;61;262
2019;"CAMPO LARGO (PR)";"PR";"CAMPO LARGO";2707;358;529;3594
2019;"CAMPO MAGRO (PR)";"PR";"CAMPO MAGRO";657;88;53;798
2019;"CAMPO MOURAO (PR)";"PR";"CAMPO MOURAO";2746;133;633;3512
2019;"CANDIDO DE ABREU (PR)";"PR";"CANDIDO DE ABREU";346;15;61;422
2019;"CANDOI (PR)";"PR";"CANDOI";518;24;127;669
2019;"CANTAGALO (PR)";"PR";"CANTAGALO";319;19;69;407
2019;"CAPANEMA (PR)";"PR";"CAPANEMA";579;27;88;694
2019;"CAPITAO LEONIDAS MARQUES (PR)";"PR";"CAPITAO LEONIDAS MARQUES";697;33;85;815
2019;"CARAMBEI (PR)";"PR";"CARAMBEI";777;96;90;963
2019;"CARLOPOLIS (PR)";"PR";"CARLOPOLIS";367;40;95;502
2019;"CASCAVEL (PR)";"PR";"CASCAVEL";8547;558;1136;10241
2019;"CASTRO (PR)";"PR";"CASTRO";2319;283;434;3036
2019;"CATANDUVAS (PR)";"PR";"CATANDUVAS";275;18;57;350
2019;"CENTENARIO DO SUL (PR)";"PR";"CENTENARIO DO SUL";186;33;93;312
2019;"CERRO AZUL (PR)";"PR";"CERRO AZUL";617;34;76;727
2019;"CEU AZUL (PR)";"PR";"CEU AZUL";421;18;67;506
2019;"CHOPINZINHO (PR)";"PR";"CHOPINZINHO";735;43;115;893
2019;"CIANORTE (PR)";"PR";"CIANORTE";1774;96;280;2150
2019;"CIDADE GAUCHA (PR)";"PR";"CIDADE GAUCHA";327;26;104;457
2019;"CLEVELANDIA (PR)";"PR";"CLEVELANDIA";689;55;62;806
2019;"COLOMBO (PR)";"PR";"COLOMBO";4557;433;625;5615
2019;"COLORADO (PR)";"PR";"COLORADO";632;60;189;881
2019;"CONGONHINHAS (PR)";"PR";"CONGONHINHAS";152;9;49;210
2019;"CONSELHEIRO MAIRINCK (PR)";"PR";"CONSELHEIRO MAIRINCK";67;7;19;93
2019;"CONTENDA (PR)";"PR";"CONTENDA";875;27;68;970
2019;"CORBELIA (PR)";"PR";"CORBELIA";869;32;71;972
2019;"CORNELIO PROCOPIO (PR)";"PR";"CORNELIO PROCOPIO";1165;131;154;1450
2019;"CORONEL DOMINGOS SOARES (PR)";"PR";"CORONEL DOMINGOS SOARES";190;12;42;244
2019;"CORONEL VIVIDA (PR)";"PR";"CORONEL VIVIDA";857;47;131;1035
2019;"CORUMBATAI DO SUL (PR)";"PR";"CORUMBATAI DO SUL";76;2;31;109
2019;"CRUZ MACHADO (PR)";"PR";"CRUZ MACHADO";786;20;113;919
2019;"CRUZEIRO DO IGUACU (PR)";"PR";"CRUZEIRO DO IGUACU";102;9;30;141
2019;"CRUZEIRO DO OESTE (PR)";"PR";"CRUZEIRO DO OESTE";597;28;99;724
2019;"CRUZEIRO DO SUL (PR)";"PR";"CRUZEIRO DO SUL";102;11;25;138
2019;"CRUZMALTINA (PR)";"PR";"CRUZMALTINA";117;7;15;139
2019;"CURITIBA (PR)";"PR";"CURITIBA";38459;3970;6893;49322
2019;"CURIUVA (PR)";"PR";"CURIUVA";329;29;96;454
2019;"DIAMANTE D OESTE (PR)";"PR";"DIAMANTE D OESTE";89;14;48;151
2019;"DIAMANTE DO NORTE (PR)";"PR";"DIAMANTE DO NORTE";84;8;37;129
2019;"DIAMANTE DO SUL (PR)";"PR";"DIAMANTE DO SUL";44;6;17;67
2019;"DOIS VIZINHOS (PR)";"PR";"DOIS VIZINHOS";1390;118;178;1686
2019;"DOURADINA (PR)";"PR";"DOURADINA";386;16;30;432
2019;"DOUTOR CAMARGO (PR)";"PR";"DOUTOR CAMARGO";214;9;66;289
2019;"DOUTOR ULYSSES (PR)";"PR";"DOUTOR ULYSSES";101;9;34;144
2019;"ENEAS MARQUES (PR)";"PR";"ENEAS MARQUES";253;8;34;295
2019;"ENGENHEIRO BELTRAO (PR)";"PR";"ENGENHEIRO BELTRAO";573;25;114;712
2019;"ENTRE RIOS DO OESTE (PR)";"PR";"ENTRE RIOS DO OESTE";175;9;14;198
2019;"ESPERANCA NOVA (PR)";"PR";"ESPERANCA NOVA";38;12;9;59
2019;"ESPIGAO ALTO DO IGUACU (PR)";"PR";"ESPIGAO ALTO DO IGUACU";101;10;17;128
2019;"FAROL (PR)";"PR";"FAROL";115;4;21;140
2019;"FAXINAL (PR)";"PR";"FAXINAL";543;28;63;634
2019;"FAZENDA RIO GRANDE (PR)";"PR";"FAZENDA RIO GRANDE";1576;96;348;2020
2019;"FENIX (PR)";"PR";"FENIX";148;5;21;174
2019;"FERNANDES PINHEIRO (PR)";"PR";"FERNANDES PINHEIRO";135;10;33;178
2019;"FIGUEIRA (PR)";"PR";"FIGUEIRA";165;9;49;223
2019;"FLOR DA SERRA DO SUL (PR)";"PR";"FLOR DA SERRA DO SUL";123;5;36;164
2019;"FLORAI (PR)";"PR";"FLORAI";180;11;26;217
2019;"FLORESTA (PR)";"PR";"FLORESTA";314;21;42;377
2019;"FLORESTOPOLIS (PR)";"PR";"FLORESTOPOLIS";221;45;137;403
2019;"FLORIDA (PR)";"PR";"FLORIDA";77;10;31;118
2019;"FORMOSA DO OESTE (PR)";"PR";"FORMOSA DO OESTE";336;13;30;379
2019;"FOZ DO IGUACU (PR)";"PR";"FOZ DO IGUACU";3986;1252;1609;6847
2019;"FOZ DO JORDAO (PR)";"PR";"FOZ DO JORDAO";90;13;26;129
2019;"FRANCISCO ALVES (PR)";"PR";"FRANCISCO ALVES";204;9;40;253
2019;"FRANCISCO BELTRAO (PR)";"PR";"FRANCISCO BELTRAO";2454;212;278;2944
2019;"GENERAL CARNEIRO (PR)";"PR";"GENERAL CARNEIRO";525;53;108;686
2019;"GODOY MOREIRA (PR)";"PR";"GODOY MOREIRA";78;5;17;100
2019;"GOIOERE (PR)";"PR";"GOIOERE";692;63;67;822
2019;"GOIOXIM (PR)";"PR";"GOIOXIM";154;20;49;223
2019;"GRANDES RIOS (PR)";"PR";"GRANDES RIOS";129;9;24;162
2019;"GUAIRA (PR)";"PR";"GUAIRA";1193;50;669;1912
2019;"GUAIRACA (PR)";"PR";"GUAIRACA";140;17;35;192
2019;"GUAMIRANGA (PR)";"PR";"GUAMIRANGA";200;18;42;260
2019;"GUAPIRAMA (PR)";"PR";"GUAPIRAMA";139;4;28;171
2019;"GUAPOREMA (PR)";"PR";"GUAPOREMA";62;3;15;80
2019;"GUARACI (PR)";"PR";"GUARACI";124;7;47;178
2019;"GUARANIACU (PR)";"PR";"GUARANIACU";501;49;66;616
2019;"GUARAPUAVA (PR)";"PR";"GUARAPUAVA";5154;604;566;6324
2019;"GUARAQUECABA (PR)";"PR";"GUARAQUECABA";35;6;19;60
2019;"GUARATUBA (PR)";"PR";"GUARATUBA";542;63;73;678
2019;"HONORIO SERPA (PR)";"PR";"HONORIO SERPA";136;7;42;185
2019;"IBAITI (PR)";"PR";"IBAITI";678;68;184;930
2019;"IBEMA (PR)";"PR";"IBEMA";179;18;21;218
2019;"IBIPORA (PR)";"PR";"IBIPORA";1315;103;203;1621
2019;"ICARAIMA (PR)";"PR";"ICARAIMA";210;16;51;277
2019;"IGUARACU (PR)";"PR";"IGUARACU";129;14;18;161
2019;"IGUATU (PR)";"PR";"IGUATU";62;2;10;74
2019;"IMBAU (PR)";"PR";"IMBAU";282;28;44;354
2019;"IMBITUVA (PR)";"PR";"IMBITUVA";893;59;82;1034
2019;"INACIO MARTINS (PR)";"PR";"INACIO MARTINS";320;43;54;417
2019;"INAJA (PR)";"PR";"INAJA";33;8;19;60
2019;"INDIANOPOLIS (PR)";"PR";"INDIANOPOLIS";198;8;20;226
2019;"IPIRANGA (PR)";"PR";"IPIRANGA";405;42;111;558
2019;"IPORA (PR)";"PR";"IPORA";463;18;50;531
2019;"IRACEMA DO OESTE (PR)";"PR";"IRACEMA DO OESTE";87;6;8;101
2019;"IRATI (PR)";"PR";"IRATI";1867;146;184;2197
2019;"IRETAMA (PR)";"PR";"IRETAMA";253;6;55;314
2019;"ITAGUAJE (PR)";"PR";"ITAGUAJE";81;12;31;124
2019;"ITAIPULANDIA (PR)";"PR";"ITAIPULANDIA";288;37;57;382
2019;"ITAMBARACA (PR)";"PR";"ITAMBARACA";214;17;38;269
2019;"ITAMBE (PR)";"PR";"ITAMBE";216;6;39;261
2019;"ITAPEJARA D OESTE (PR)";"PR";"ITAPEJARA D OESTE";423;19;56;498
2019;"ITAPERUCU (PR)";"PR";"ITAPERUCU";756;99;118;973
2019;"ITAUNA DO SUL (PR)";"PR";"ITAUNA DO SUL";54;9;16;79
2019;"IVAI (PR)";"PR";"IVAI";428;14;54;496
2019;"IVAIPORA (PR)";"PR";"IVAIPORA";1072;50;129;1251
2019;"IVATE (PR)";"PR";"IVATE";253;11;86;350
2019;"IVATUBA (PR)";"PR";"IVATUBA";65;6;10;81
2019;"JABOTI (PR)";"PR";"JABOTI";73;12;30;115
2019;"JACAREZINHO (PR)";"PR";"JACAREZINHO";646;150;171;967
2019;"JAGUAPITA (PR)";"PR";"JAGUAPITA";425;41;96;562
2019;"JAGUARIAIVA (PR)";"PR";"JAGUARIAIVA";813;91;153;1057
2019;"JANDAIA DO SUL (PR)";"PR";"JANDAIA DO SUL";717;49;73;839
2019;"JANIOPOLIS (PR)";"PR";"JANIOPOLIS";168;12;34;214
2019;"JAPIRA (PR)";"PR";"JAPIRA";67;7;22;96
2019;"JAPURA (PR)";"PR";"JAPURA";365;15;32;412
2019;"JARDIM ALEGRE (PR)";"PR";"JARDIM ALEGRE";327;18;54;399
2019;"JARDIM OLINDA (PR)";"PR";"JARDIM OLINDA";48;5;10;63
2019;"JATAIZINHO (PR)";"PR";"JATAIZINHO";395;33;35;463
2019;"JESUITAS (PR)";"PR";"JESUITAS";379;22;47;448
2019;"JOAQUIM TAVORA (PR)";"PR";"JOAQUIM TAVORA";309;20;45;374
2019;"JUNDIAI DO SUL (PR)";"PR";"JUNDIAI DO SUL";40;3;36;79
2019;"JURANDA (PR)";"PR";"JURANDA";350;9;19;378
2019;"JUSSARA (PR)";"PR";"JUSSARA";194;8;53;255
2019;"KALORE (PR)";"PR";"KALORE";172;21;26;219
2019;"LAPA (PR)";"PR";"LAPA";1422;142;246;1810
2019;"LARANJAL (PR)";"PR";"LARANJAL";81;11;32;124
2019;"LARANJEIRAS DO SUL (PR)";"PR";"LARANJEIRAS DO SUL";996;60;125;1181
2019;"LEOPOLIS (PR)";"PR";"LEOPOLIS";103;9;13;125
2019;"LIDIANOPOLIS (PR)";"PR";"LIDIANOPOLIS";116;10;31;157
2019;"LINDOESTE (PR)";"PR";"LINDOESTE";130;15;38;183
2019;"LOANDA (PR)";"PR";"LOANDA";497;33;76;606
2019;"LOBATO (PR)";"PR";"LOBATO";183;9;42;234
2019;"LONDRINA (PR)";"PR";"LONDRINA";9508;831;1985;12324
2019;"LUIZIANA (PR)";"PR";"LUIZIANA";223;9;30;262
2019;"LUNARDELLI (PR)";"PR";"LUNARDELLI";120;11;16;147
2019;"LUPIONOPOLIS (PR)";"PR";"LUPIONOPOLIS";111;17;64;192
2019;"MALLET (PR)";"PR";"MALLET";551;20;93;664
2019;"MAMBORE (PR)";"PR";"MAMBORE";690;10;52;752
2019;"MANDAGUACU (PR)";"PR";"MANDAGUACU";556;32;69;657
2019;"MANDAGUARI (PR)";"PR";"MANDAGUARI";972;74;90;1136
2019;"MANDIRITUBA (PR)";"PR";"MANDIRITUBA";1209;53;99;1361
2019;"MANFRINOPOLIS (PR)";"PR";"MANFRINOPOLIS";48;9;23;80
2019;"MANGUEIRINHA (PR)";"PR";"MANGUEIRINHA";631;40;111;782
2019;"MANOEL RIBAS (PR)";"PR";"MANOEL RIBAS";466;23;44;533
2019;"MARECHAL CANDIDO RONDON (PR)";"PR";"MARECHAL CANDIDO RONDON";1744;117;243;2104
2019;"MARIA HELENA (PR)";"PR";"MARIA HELENA";144;13;40;197
2019;"MARIALVA (PR)";"PR";"MARIALVA";1105;69;116;1290
2019;"MARILANDIA DO SUL (PR)";"PR";"MARILANDIA DO SUL";287;23;41;351
2019;"MARILENA (PR)";"PR";"MARILENA";135;6;39;180
2019;"MARILUZ (PR)";"PR";"MARILUZ";218;17;83;318
2019;"MARINGA (PR)";"PR";"MARINGA";10317;562;1011;11890
2019;"MARIOPOLIS (PR)";"PR";"MARIOPOLIS";280;20;44;344
2019;"MARIPA (PR)";"PR";"MARIPA";401;15;16;432
2019;"MARMELEIRO (PR)";"PR";"MARMELEIRO";484;34;65;583
2019;"MARQUINHO (PR)";"PR";"MARQUINHO";91;5;26;122
2019;"MARUMBI (PR)";"PR";"MARUMBI";120;7;32;159
2019;"MATELANDIA (PR)";"PR";"MATELANDIA";773;29;101;903
2019;"MATINHOS (PR)";"PR";"MATINHOS";407;66;62;535
2019;"MATO RICO (PR)";"PR";"MATO RICO";112;8;18;138
2019;"MAUA DA SERRA (PR)";"PR";"MAUA DA SERRA";278;15;33;326
2019;"MEDIANEIRA (PR)";"PR";"MEDIANEIRA";1428;96;144;1668
2019;"MERCEDES (PR)";"PR";"MERCEDES";320;9;32;361
2019;"MIRADOR (PR)";"PR";"MIRADOR";21;6;11;38
2019;"MIRASELVA (PR)";"PR";"MIRASELVA";42;16;34;92
2019;"MISSAL (PR)";"PR";"MISSAL";443;31;54;528
2019;"MOREIRA SALES (PR)";"PR";"MOREIRA SALES";324;15;110;449
2019;"MORRETES (PR)";"PR";"MORRETES";262;24;48;334
2019;"MUNHOZ DE MELLO (PR)";"PR";"MUNHOZ DE MELLO";91;8;14;113
2019;"NOSSA SENHORA DAS GRACAS (PR)";"PR";"NOSSA SENHORA DAS GRACAS";54;11;44;109
2019;"NOVA ALIANCA DO IVAI (PR)";"PR";"NOVA ALIANCA DO IVAI";27;6;11;44
2019;"NOVA AMERICA DA COLINA (PR)";"PR";"NOVA AMERICA DA COLINA";119;9;31;159
2019;"NOVA AURORA (PR)";"PR";"NOVA AURORA";522;15;56;593
2019;"NOVA CANTU (PR)";"PR";"NOVA CANTU";175;4;33;212
2019;"NOVA ESPERANCA (PR)";"PR";"NOVA ESPERANCA";849;61;101;1011
2019;"NOVA ESPERANCA DO SUDOESTE (PR)";"PR";"NOVA ESPERANCA DO SUDOESTE";205;17;30;252
2019;"NOVA FATIMA (PR)";"PR";"NOVA FATIMA";318;11;56;385
2019;"NOVA LARANJEIRAS (PR)";"PR";"NOVA LARANJEIRAS";208;10;42;260
2019;"NOVA LONDRINA (PR)";"PR";"NOVA LONDRINA";399;30;77;506
2019;"NOVA OLIMPIA (PR)";"PR";"NOVA OLIMPIA";128;19;37;184
2019;"NOVA PRATA DO IGUACU (PR)";"PR";"NOVA PRATA DO IGUACU";334;20;49;403
2019;"NOVA SANTA BARBARA (PR)";"PR";"NOVA SANTA BARBARA";164;13;13;190
2019;"NOVA SANTA ROSA (PR)";"PR";"NOVA SANTA ROSA";481;23;24;528
2019;"NOVA TEBAS (PR)";"PR";"NOVA TEBAS";156;10;34;200
2019;"NOVO ITACOLOMI (PR)";"PR";"NOVO ITACOLOMI";118;4;17;139
2019;"ORTIGUEIRA (PR)";"PR";"ORTIGUEIRA";569;53;108;730
2019;"OURIZONA (PR)";"PR";"OURIZONA";110;4;21;135
2019;"OURO VERDE DO OESTE (PR)";"PR";"OURO VERDE DO OESTE";198;10;23;231
2019;"PAICANDU (PR)";"PR";"PAICANDU";687;53;68;808
2019;"PALMAS (PR)";"PR";"PALMAS";1227;103;137;1467
2019;"PALMEIRA (PR)";"PR";"PALMEIRA";1161;73;123;1357
2019;"PALMITAL (PR)";"PR";"PALMITAL";350;18;81;449
2019;"PALOTINA (PR)";"PR";"PALOTINA";1440;73;296;1809
2019;"PARAISO DO NORTE (PR)";"PR";"PARAISO DO NORTE";317;24;90;431
2019;"PARANACITY (PR)";"PR";"PARANACITY";305;22;63;390
2019;"PARANAGUA (PR)";"PR";"PARANAGUA";2119;189;240;2548
2019;"PARANAPOEMA (PR)";"PR";"PARANAPOEMA";80;7;25;112
2019;"PARANAVAI (PR)";"PR";"PARANAVAI";2296;168;273;2737
2019;"PATO BRAGADO (PR)";"PR";"PATO BRAGADO";213;10;28;251
2019;"PATO BRANCO (PR)";"PR";"PATO BRANCO";2501;197;429;3127
2019;"PAULA FREITAS (PR)";"PR";"PAULA FREITAS";228;7;34;269
2019;"PAULO FRONTIN (PR)";"PR";"PAULO FRONTIN";324;6;32;362
2019;"PEABIRU (PR)";"PR";"PEABIRU";409;22;40;471
2019;"PEROBAL (PR)";"PR";"PEROBAL";160;13;35;208
2019;"PEROLA (PR)";"PR";"PEROLA";267;20;24;311
2019;"PEROLA D OESTE (PR)";"PR";"PEROLA D OESTE";237;5;28;270
2019;"PIEN (PR)";"PR";"PIEN";489;34;35;558
2019;"PINHAIS (PR)";"PR";"PINHAIS";2314;269;535;3118
2019;"PINHAL DO SAO BENTO (PR)";"PR";"PINHAL DO SAO BENTO";47;5;20;72
2019;"PINHALAO (PR)";"PR";"PINHALAO";149;12;28;189
2019;"PINHAO (PR)";"PR";"PINHAO";707;107;166;980
2019;"PIRAI DO SUL (PR)";"PR";"PIRAI DO SUL";537;67;140;744
2019;"PIRAQUARA (PR)";"PR";"PIRAQUARA";706;132;255;1093
2019;"PITANGA (PR)";"PR";"PITANGA";1146;49;157;1352
2019;"PITANGUEIRAS (PR)";"PR";"PITANGUEIRAS";66;14;38;118
2019;"PLANALTINA DO PARANA (PR)";"PR";"PLANALTINA DO PARANA";123;7;28;158
2019;"PLANALTO (PR)";"PR";"PLANALTO";471;19;57;547
2019;"PONTA GROSSA (PR)";"PR";"PONTA GROSSA";6822;872;1285;8979
2019;"PONTAL DO PARANA (PR)";"PR";"PONTAL DO PARANA";360;47;80;487
2019;"PORECATU (PR)";"PR";"PORECATU";299;38;197;534
2019;"PORTO AMAZONAS (PR)";"PR";"PORTO AMAZONAS";100;14;25;139
2019;"PORTO BARREIRO (PR)";"PR";"PORTO BARREIRO";106;10;33;149
2019;"PORTO RICO (PR)";"PR";"PORTO RICO";34;4;13;51
2019;"PORTO VITORIA (PR)";"PR";"PORTO VITORIA";182;5;20;207
2019;"PRADO FERREIRA (PR)";"PR";"PRADO FERREIRA";122;10;20;152
2019;"PRANCHITA (PR)";"PR";"PRANCHITA";329;14;24;367
2019;"PRESIDENTE CASTELO BRANCO (PR)";"PR";"PRESIDENTE CASTELO BRANCO";141;8;34;183
2019;"PRIMEIRO DE MAIO (PR)";"PR";"PRIMEIRO DE MAIO";364;20;40;424
2019;"PRUDENTOPOLIS (PR)";"PR";"PRUDENTOPOLIS";1648;80;213;1941
2019;"QUARTO CENTENARIO (PR)";"PR";"QUARTO CENTENARIO";141;5;12;158
2019;"QUATIGUA (PR)";"PR";"QUATIGUA";399;17;26;442
2019;"QUATRO BARRAS (PR)";"PR";"QUATRO BARRAS";788;59;128;975
2019;"QUATRO PONTES (PR)";"PR";"QUATRO PONTES";216;7;9;232
2019;"QUEDAS DO IGUACU (PR)";"PR";"QUEDAS DO IGUACU";852;45;206;1103
2019;"QUERENCIA DO NORTE (PR)";"PR";"QUERENCIA DO NORTE";270;10;45;325
2019;"QUINTA DO SOL (PR)";"PR";"QUINTA DO SOL";171;8;31;210
2019;"QUITANDINHA (PR)";"PR";"QUITANDINHA";620;16;112;748
2019;"RAMILANDIA (PR)";"PR";"RAMILANDIA";67;10;26;103
2019;"RANCHO ALEGRE (PR)";"PR";"RANCHO ALEGRE";118;10;22;150
2019;"RANCHO ALEGRE D OESTE (PR)";"PR";"RANCHO ALEGRE D OESTE";89;6;16;111
2019;"REALEZA (PR)";"PR";"REALEZA";715;42;57;814
2019;"REBOUCAS (PR)";"PR";"REBOUCAS";337;22;68;427
2019;"RENASCENCA (PR)";"PR";"RENASCENCA";292;13;46;351
2019;"RESERVA (PR)";"PR";"RESERVA";801;42;130;973
2019;"RESERVA DO IGUACU (PR)";"PR";"RESERVA DO IGUACU";91;15;30;136
2019;"RIBEIRAO CLARO (PR)";"PR";"RIBEIRAO CLARO";250;51;45;346
2019;"RIBEIRAO DO PINHAL (PR)";"PR";"RIBEIRAO DO PINHAL";258;41;92;391
2019;"RIO AZUL (PR)";"PR";"RIO AZUL";378;19;56;453
2019;"RIO BOM (PR)";"PR";"RIO BOM";103;8;16;127
2019;"RIO BONITO DO IGUACU (PR)";"PR";"RIO BONITO DO IGUACU";376;14;113;503
2019;"RIO BRANCO DO IVAI (PR)";"PR";"RIO BRANCO DO IVAI";44;8;17;69
2019;"RIO BRANCO DO SUL (PR)";"PR";"RIO BRANCO DO SUL";752;136;208;1096
2019;"RIO NEGRO (PR)";"PR";"RIO NEGRO";1178;103;89;1370
2019;"ROLANDIA (PR)";"PR";"ROLANDIA";1685;168;146;1999
2019;"RONCADOR (PR)";"PR";"RONCADOR";428;8;50;486
2019;"RONDON (PR)";"PR";"RONDON";318;17;88;423
2019;"ROSARIO DO IVAI (PR)";"PR";"ROSARIO DO IVAI";121;15;31;167
2019;"SABAUDIA (PR)";"PR";"SABAUDIA";275;14;35;324
2019;"SALGADO FILHO (PR)";"PR";"SALGADO FILHO";111;5;42;158
2019;"SALTO DO ITARARE (PR)";"PR";"SALTO DO ITARARE";143;12;32;187
2019;"SALTO DO LONTRA (PR)";"PR";"SALTO DO LONTRA";368;14;48;430
2019;"SANTA AMELIA (PR)";"PR";"SANTA AMELIA";76;11;23;110
2019;"SANTA CECILIA DO PAVAO (PR)";"PR";"SANTA CECILIA DO PAVAO";117;9;18;144
2019;"SANTA CRUZ DO MONTE CASTELO (PR)";"PR";"SANTA CRUZ DO MONTE CASTELO";236;10;60;306
2019;"SANTA FE (PR)";"PR";"SANTA FE";325;18;47;390
2019;"SANTA HELENA (PR)";"PR";"SANTA HELENA";791;76;168;1035
2019;"SANTA INES (PR)";"PR";"SANTA INES";20;13;9;42
2019;"SANTA ISABEL DO IVAI (PR)";"PR";"SANTA ISABEL DO IVAI";200;19;39;258
2019;"SANTA IZABEL DO OESTE (PR)";"PR";"SANTA IZABEL DO OESTE";276;27;46;349
2019;"SANTA LUCIA (PR)";"PR";"SANTA LUCIA";145;6;18;169
2019;"SANTA MARIA DO OESTE (PR)";"PR";"SANTA MARIA DO OESTE";301;21;36;358
2019;"SANTA MARIANA (PR)";"PR";"SANTA MARIANA";341;32;55;428
2019;"SANTA MONICA (PR)";"PR";"SANTA MONICA";52;8;21;81
2019;"SANTA TEREZA DO OESTE (PR)";"PR";"SANTA TEREZA DO OESTE";319;21;26;366
2019;"SANTA TEREZINHA DE ITAIPU (PR)";"PR";"SANTA TEREZINHA DE ITAIPU";526;57;72;655
2019;"SANTANA DO ITARARE (PR)";"PR";"SANTANA DO ITARARE";125;12;30;167
2019;"SANTO ANTONIO DA PLATINA (PR)";"PR";"SANTO ANTONIO DA PLATINA";798;103;264;1165
2019;"SANTO ANTONIO DO CAIUA (PR)";"PR";"SANTO ANTONIO DO CAIUA";27;6;19;52
2019;"SANTO ANTONIO DO PARAISO (PR)";"PR";"SANTO ANTONIO DO PARAISO";82;7;18;107
2019;"SANTO ANTONIO DO SUDOESTE (PR)";"PR";"SANTO ANTONIO DO SUDOESTE";516;22;49;587
2019;"SANTO INACIO (PR)";"PR";"SANTO INACIO";167;14;29;210
2019;"SAO CARLOS DO IVAI (PR)";"PR";"SAO CARLOS DO IVAI";239;8;39;286
2019;"SAO JERONIMO DA SERRA (PR)";"PR";"SAO JERONIMO DA SERRA";249;19;36;304
2019;"SAO JOAO (PR)";"PR";"SAO JOAO";474;26;68;568
2019;"SAO JOAO DO CAIUA (PR)";"PR";"SAO JOAO DO CAIUA";96;15;53;164
2019;"SAO JOAO DO IVAI (PR)";"PR";"SAO JOAO DO IVAI";399;13;44;456
2019;"SAO JOAO DO TRIUNFO (PR)";"PR";"SAO JOAO DO TRIUNFO";314;14;66;394
2019;"SAO JORGE D OESTE (PR)";"PR";"SAO JORGE D OESTE";302;14;59;375
2019;"SAO JORGE DO IVAI (PR)";"PR";"SAO JORGE DO IVAI";296;11;26;333
2019;"SAO JORGE DO PATROCINIO (PR)";"PR";"SAO JORGE DO PATROCINIO";154;10;29;193
2019;"SAO JOSE DA BOA VISTA (PR)";"PR";"SAO JOSE DA BOA VISTA";138;9;32;179
2019;"SAO JOSE DAS PALMEIRAS (PR)";"PR";"SAO JOSE DAS PALMEIRAS";103;11;44;158
2019;"SAO JOSE DOS PINHAIS (PR)";"PR";"SAO JOSE DOS PINHAIS";8122;685;938;9745
2019;"SAO MANOEL DO PARANA (PR)";"PR";"SAO MANOEL DO PARANA";63;4;10;77
2019;"SAO MATEUS DO SUL (PR)";"PR";"SAO MATEUS DO SUL";1254;112;218;1584
2019;"SAO MIGUEL DO IGUACU (PR)";"PR";"SAO MIGUEL DO IGUACU";986;76;112;1174
2019;"SAO PEDRO DO IGUACU (PR)";"PR";"SAO PEDRO DO IGUACU";211;11;47;269
2019;"SAO PEDRO DO IVAI (PR)";"PR";"SAO PEDRO DO IVAI";382;16;58;456
2019;"SAO PEDRO DO PARANA (PR)";"PR";"SAO PEDRO DO PARANA";56;11;10;77
2019;"SAO SEBASTIAO DA AMOREIRA (PR)";"PR";"SAO SEBASTIAO DA AMOREIRA";218;15;59;292
2019;"SAO TOME (PR)";"PR";"SAO TOME";174;11;37;222
2019;"SAPOPEMA (PR)";"PR";"SAPOPEMA";132;8;24;164
2019;"SARANDI (PR)";"PR";"SARANDI";1238;130;232;1600
2019;"SAUDADE DO IGUACU (PR)";"PR";"SAUDADE DO IGUACU";120;20;35;175
2019;"SENGES (PR)";"PR";"SENGES";603;32;85;720
2019;"SERRANOPOLIS DO IGUACU (PR)";"PR";"SERRANOPOLIS DO IGUACU";167;16;13;196
2019;"SERTANEJA (PR)";"PR";"SERTANEJA";234;18;43;295
2019;"SERTANOPOLIS (PR)";"PR";"SERTANOPOLIS";683;28;80;791
2019;"SIQUEIRA CAMPOS (PR)";"PR";"SIQUEIRA CAMPOS";482;22;76;580
2019;"SULINA (PR)";"PR";"SULINA";98;6;18;122
2019;"TAMARANA (PR)";"PR";"TAMARANA";373;20;64;457
2019;"TAMBOARA (PR)";"PR";"TAMBOARA";110;16;21;147
2019;"TAPEJARA (PR)";"PR";"TAPEJARA";470;16;128;614
2019;"TAPIRA (PR)";"PR";"TAPIRA";176;8;37;221
2019;"TEIXEIRA SOARES (PR)";"PR";"TEIXEIRA SOARES";253;21;142;416
2019;"TELEMACO BORBA (PR)";"PR";"TELEMACO BORBA";1228;250;261;1739
2019;"TERRA BOA (PR)";"PR";"TERRA BOA";427;22;137;586
2019;"TERRA RICA (PR)";"PR";"TERRA RICA";436;26;125;587
2019;"TERRA ROXA (PR)";"PR";"TERRA ROXA";652;23;76;751
2019;"TIBAGI (PR)";"PR";"TIBAGI";424;54;87;565
2019;"TIJUCAS DO SUL (PR)";"PR";"TIJUCAS DO SUL";588;23;51;662
2019;"TOLEDO (PR)";"PR";"TOLEDO";3826;311;275;4412
2019;"TOMAZINA (PR)";"PR";"TOMAZINA";135;13;33;181
2019;"TRES BARRAS DO PARANA (PR)";"PR";"TRES BARRAS DO PARANA";403;12;46;461
2019;"TUNAS DO PARANA (PR)";"PR";"TUNAS DO PARANA";157;18;58;233
2019;"TUNEIRAS DO OESTE (PR)";"PR";"TUNEIRAS DO OESTE";171;25;83;279
2019;"TUPASSI (PR)";"PR";"TUPASSI";402;17;45;464
2019;"TURVO (PR)";"PR";"TURVO";482;42;99;623
2019;"UBIRATA (PR)";"PR";"UBIRATA";827;37;92;956
2019;"UMUARAMA (PR)";"PR";"UMUARAMA";3045;105;309;3459
2019;"UNIAO DA VITORIA (PR)";"PR";"UNIAO DA VITORIA";1698;82;102;1882
2019;"UNIFLOR (PR)";"PR";"UNIFLOR";64;4;14;82
2019;"URAI (PR)";"PR";"URAI";382;24;29;435
2019;"VENTANIA (PR)";"PR";"VENTANIA";212;27;36;275
2019;"VERA CRUZ DO OESTE (PR)";"PR";"VERA CRUZ DO OESTE";331;15;29;375
2019;"VERE (PR)";"PR";"VERE";311;11;27;349
2019;"VIRMOND (PR)";"PR";"VIRMOND";142;3;29;174
2019;"VITORINO (PR)";"PR";"VITORINO";332;15;42;389
2019;"WENCESLAU BRAZ (PR)";"PR";"WENCESLAU BRAZ";587;29;100;716
2019;"XAMBRE (PR)";"PR";"XAMBRE";158;15;22;195
2019;"ANGRA DOS REIS (RJ)";"RJ";"ANGRA DOS REIS";1265;220;388;1873
2019;"APERIBE (RJ)";"RJ";"APERIBE";149;24;17;190
2019;"ARARUAMA (RJ)";"RJ";"ARARUAMA";1930;319;186;2435
2019;"AREAL (RJ)";"RJ";"AREAL";202;43;55;300
2019;"ARMACAO DE BUZIOS (RJ)";"RJ";"ARMACAO DE BUZIOS";388;362;73;823
2019;"ARRAIAL DO CABO (RJ)";"RJ";"ARRAIAL DO CABO";208;71;17;296
2019;"BARRA DO PIRAI (RJ)";"RJ";"BARRA DO PIRAI";1409;242;332;1983
2019;"BARRA MANSA (RJ)";"RJ";"BARRA MANSA";1990;281;649;2920
2019;"BELFORD ROXO (RJ)";"RJ";"BELFORD ROXO";2166;553;720;3439
2019;"BOM JARDIM (RJ)";"RJ";"BOM JARDIM";692;75;58;825
2019;"BOM JESUS DO ITABAPOANA (RJ)";"RJ";"BOM JESUS DO ITABAPOANA";306;71;65;442
2019;"CABO FRIO (RJ)";"RJ";"CABO FRIO";3089;379;454;3922
2019;"CACHOEIRAS DE MACACU (RJ)";"RJ";"CACHOEIRAS DE MACACU";1005;222;59;1286
2019;"CAMBUCI (RJ)";"RJ";"CAMBUCI";127;31;35;193
2019;"CAMPOS DOS GOYTACAZES (RJ)";"RJ";"CAMPOS DOS GOYTACAZES";6849;1145;1478;9472
2019;"CANTAGALO (RJ)";"RJ";"CANTAGALO";222;52;49;323
2019;"CARAPEBUS (RJ)";"RJ";"CARAPEBUS";151;36;26;213
2019;"CARDOSO MOREIRA (RJ)";"RJ";"CARDOSO MOREIRA";169;35;72;276
2019;"CARMO (RJ)";"RJ";"CARMO";164;42;19;225
2019;"CASIMIRO DE ABREU (RJ)";"RJ";"CASIMIRO DE ABREU";668;118;34;820
2019;"COMENDADOR LEVY GASPARIAN (RJ)";"RJ";"COMENDADOR LEVY GASPARIAN";185;36;21;242
2019;"CONCEICAO DE MACABU (RJ)";"RJ";"CONCEICAO DE MACABU";196;45;54;295
2019;"CORDEIRO (RJ)";"RJ";"CORDEIRO";291;54;59;404
2019;"DUAS BARRAS (RJ)";"RJ";"DUAS BARRAS";161;53;13;227
2019;"DUQUE DE CAXIAS (RJ)";"RJ";"DUQUE DE CAXIAS";9848;1138;3861;14847
2019;"ENGENHEIRO PAULO DE FRONTIN (RJ)";"RJ";"ENGENHEIRO PAULO DE FRONTIN";131;32;21;184
2019;"GUAPIMIRIM (RJ)";"RJ";"GUAPIMIRIM";477;88;55;620
2019;"IGUABA GRANDE (RJ)";"RJ";"IGUABA GRANDE";215;87;44;346
2019;"ITABORAI (RJ)";"RJ";"ITABORAI";3170;767;524;4461
2019;"ITAGUAI (RJ)";"RJ";"ITAGUAI";1725;339;359;2423
2019;"ITALVA (RJ)";"RJ";"ITALVA";210;36;33;279
2019;"ITAOCARA (RJ)";"RJ";"ITAOCARA";389;56;46;491
2019;"ITAPERUNA (RJ)";"RJ";"ITAPERUNA";1005;144;120;1269
2019;"ITATIAIA (RJ)";"RJ";"ITATIAIA";158;87;50;295
2019;"JAPERI (RJ)";"RJ";"JAPERI";531;82;43;656
2019;"LAJE DO MURIAE (RJ)";"RJ";"LAJE DO MURIAE";43;6;18;67
2019;"MACAE (RJ)";"RJ";"MACAE";3118;1170;884;5172
2019;"MACUCO (RJ)";"RJ";"MACUCO";205;15;14;234
2019;"MAGE (RJ)";"RJ";"MAGE";2080;501;202;2783
2019;"MANGARATIBA (RJ)";"RJ";"MANGARATIBA";201;163;137;501
2019;"MARICA (RJ)";"RJ";"MARICA";1331;476;444;2251
2019;"MENDES (RJ)";"RJ";"MENDES";208;62;56;326
2019;"MESQUITA (RJ)";"RJ";"MESQUITA";844;147;660;1651
2019;"MIGUEL PEREIRA (RJ)";"RJ";"MIGUEL PEREIRA";399;81;61;541
2019;"MIRACEMA (RJ)";"RJ";"MIRACEMA";265;44;39;348
2019;"MUNICIPIO NAO INFORMADO (RJ)";"RJ";"MUNICIPIO NAO INFORMADO";1;0;0;1
2019;"NATIVIDADE (RJ)";"RJ";"NATIVIDADE";92;26;50;168
2019;"NILOPOLIS (RJ)";"RJ";"NILOPOLIS";641;162;318;1121
2019;"NITEROI (RJ)";"RJ";"NITEROI";2827;1255;2438;6520
2019;"NOVA FRIBURGO (RJ)";"RJ";"NOVA FRIBURGO";3731;321;376;4428
2019;"NOVA IGUACU (RJ)";"RJ";"NOVA IGUACU";6868;1726;1740;10334
2019;"PARACAMBI (RJ)";"RJ";"PARACAMBI";722;107;114;943
2019;"PARAIBA DO SUL (RJ)";"RJ";"PARAIBA DO SUL";621;126;108;855
2019;"PARATI (RJ)";"RJ";"PARATI";217;117;57;391
2019;"PATY DO ALFERES (RJ)";"RJ";"PATY DO ALFERES";529;59;85;673
2019;"PETROPOLIS (RJ)";"RJ";"PETROPOLIS";3779;731;1013;5523
2019;"PINHEIRAL (RJ)";"RJ";"PINHEIRAL";230;64;136;430
2019;"PIRAI (RJ)";"RJ";"PIRAI";411;96;78;585
2019;"PORCIUNCULA (RJ)";"RJ";"PORCIUNCULA";68;22;30;120
2019;"PORTO REAL (RJ)";"RJ";"PORTO REAL";216;40;17;273
2019;"QUATIS (RJ)";"RJ";"QUATIS";154;76;32;262
2019;"QUEIMADOS (RJ)";"RJ";"QUEIMADOS";696;234;311;1241
2019;"QUISSAMA (RJ)";"RJ";"QUISSAMA";243;45;128;416
2019;"RESENDE (RJ)";"RJ";"RESENDE";1596;284;515;2395
2019;"RIO BONITO (RJ)";"RJ";"RIO BONITO";3283;347;140;3770
2019;"RIO CLARO (RJ)";"RJ";"RIO CLARO";145;37;24;206
2019;"RIO DAS FLORES (RJ)";"RJ";"RIO DAS FLORES";63;31;26;120
2019;"RIO DAS OSTRAS (RJ)";"RJ";"RIO DAS OSTRAS";1210;802;156;2168
2019;"RIO DE JANEIRO (RJ)";"RJ";"RIO DE JANEIRO";43227;18127;17278;78632
2019;"SANTA MARIA MADALENA (RJ)";"RJ";"SANTA MARIA MADALENA";86;29;28;143
2019;"SANTO ANTONIO DE PADUA (RJ)";"RJ";"SANTO ANTONIO DE PADUA";601;118;42;761
2019;"SAO FIDELIS (RJ)";"RJ";"SAO FIDELIS";410;58;79;547
2019;"SAO FRANCISCO DE ITABAPOANA (RJ)";"RJ";"SAO FRANCISCO DE ITABAPOANA";449;146;107;702
2019;"SAO GONCALO (RJ)";"RJ";"SAO GONCALO";5452;1965;2940;10357
2019;"SAO JOAO DA BARRA (RJ)";"RJ";"SAO JOAO DA BARRA";664;93;88;845
2019;"SAO JOAO DE MERITI (RJ)";"RJ";"SAO JOAO DE MERITI";3725;573;1233;5531
2019;"SAO JOSE DE UBA (RJ)";"RJ";"SAO JOSE DE UBA";52;13;11;76
2019;"SAO JOSE DO VALE DO RIO PRETO (RJ)";"RJ";"SAO JOSE DO VALE DO RIO PRETO";766;41;53;860
2019;"SAO PEDRO DA ALDEIA (RJ)";"RJ";"SAO PEDRO DA ALDEIA";1022;127;139;1288
2019;"SAO SEBASTIAO DO ALTO (RJ)";"RJ";"SAO SEBASTIAO DO ALTO";137;30;8;175
2019;"SAPUCAIA (RJ)";"RJ";"SAPUCAIA";139;25;18;182
2019;"SAQUAREMA (RJ)";"RJ";"SAQUAREMA";908;189;161;1258
2019;"SEROPEDICA (RJ)";"RJ";"SEROPEDICA";1378;96;254;1728
2019;"SILVA JARDIM (RJ)";"RJ";"SILVA JARDIM";323;64;51;438
2019;"SUMIDOURO (RJ)";"RJ";"SUMIDOURO";422;32;25;479
2019;"TANGUA (RJ)";"RJ";"TANGUA";411;55;68;534
2019;"TERESOPOLIS (RJ)";"RJ";"TERESOPOLIS";2581;355;300;3236
2019;"TRAJANO DE MORAIS (RJ)";"RJ";"TRAJANO DE MORAIS";117;34;26;177
2019;"TRES RIOS (RJ)";"RJ";"TRES RIOS";1021;138;234;1393
2019;"VALENCA (RJ)";"RJ";"VALENCA";405;167;108;680
2019;"VARRE SAI (RJ)";"RJ";"VARRE SAI";64;26;12;102
2019;"VASSOURAS (RJ)";"RJ";"VASSOURAS";601;102;123;826
2019;"VOLTA REDONDA (RJ)";"RJ";"VOLTA REDONDA";2332;456;690;3478
2019;"ACARI (RN)";"RN";"ACARI";120;11;16;147
2019;"AFONSO BEZERRA (RN)";"RN";"AFONSO BEZERRA";36;6;17;59
2019;"AGUA NOVA (RN)";"RN";"AGUA NOVA";11;10;2;23
2019;"ALEXANDRIA (RN)";"RN";"ALEXANDRIA";151;46;17;214
2019;"ALMINO AFONSO (RN)";"RN";"ALMINO AFONSO";25;7;2;34
2019;"ALTO DO RODRIGUES (RN)";"RN";"ALTO DO RODRIGUES";190;19;29;238
2019;"ANGICOS (RN)";"RN";"ANGICOS";131;23;13;167
2019;"ANTONIO MARTINS (RN)";"RN";"ANTONIO MARTINS";46;12;5;63
2019;"APODI (RN)";"RN";"APODI";381;45;60;486
2019;"AREIA BRANCA (RN)";"RN";"AREIA BRANCA";165;44;74;283
2019;"ARES (RN)";"RN";"ARES";67;8;49;124
2019;"ASSU (RN)";"RN";"ASSU";743;68;116;927
2019;"BAIA FORMOSA (RN)";"RN";"BAIA FORMOSA";54;5;28;87
2019;"BARAUNA (RN)";"RN";"BARAUNA";796;35;54;885
2019;"BARCELONA (RN)";"RN";"BARCELONA";26;4;4;34
2019;"BENTO FERNANDES (RN)";"RN";"BENTO FERNANDES";15;9;16;40
2019;"BOA SAUDE (RN)";"RN";"BOA SAUDE";101;7;13;121
2019;"BODO (RN)";"RN";"BODO";10;11;5;26
2019;"BOM JESUS (RN)";"RN";"BOM JESUS";66;8;14;88
2019;"BREJINHO (RN)";"RN";"BREJINHO";126;11;22;159
2019;"CAICARA DO NORTE (RN)";"RN";"CAICARA DO NORTE";20;2;6;28
2019;"CAICARA DO RIO DO VENTO (RN)";"RN";"CAICARA DO RIO DO VENTO";26;4;4;34
2019;"CAICO (RN)";"RN";"CAICO";2581;162;84;2827
2019;"CAMPO GRANDE (RN)";"RN";"CAMPO GRANDE";64;10;12;86
2019;"CAMPO REDONDO (RN)";"RN";"CAMPO REDONDO";78;17;16;111
2019;"CANGUARETAMA (RN)";"RN";"CANGUARETAMA";217;38;94;349
2019;"CARAUBAS (RN)";"RN";"CARAUBAS";177;49;22;248
2019;"CARNAUBA DOS DANTAS (RN)";"RN";"CARNAUBA DOS DANTAS";242;12;9;263
2019;"CARNAUBAIS (RN)";"RN";"CARNAUBAIS";53;19;15;87
2019;"CEARA MIRIM (RN)";"RN";"CEARA MIRIM";416;71;182;669
2019;"CERRO CORA (RN)";"RN";"CERRO CORA";123;15;18;156
2019;"CORONEL EZEQUIEL (RN)";"RN";"CORONEL EZEQUIEL";77;8;5;90
2019;"CORONEL JOAO PESSOA (RN)";"RN";"CORONEL JOAO PESSOA";13;5;3;21
2019;"CRUZETA (RN)";"RN";"CRUZETA";101;19;16;136
2019;"CURRAIS NOVOS (RN)";"RN";"CURRAIS NOVOS";829;70;71;970
2019;"DOUTOR SEVERIANO (RN)";"RN";"DOUTOR SEVERIANO";39;10;14;63
2019;"ENCANTO (RN)";"RN";"ENCANTO";19;7;8;34
2019;"EQUADOR (RN)";"RN";"EQUADOR";202;7;5;214
2019;"ESPIRITO SANTO (RN)";"RN";"ESPIRITO SANTO";25;5;24;54
2019;"EXTREMOZ (RN)";"RN";"EXTREMOZ";114;49;57;220
2019;"FELIPE GUERRA (RN)";"RN";"FELIPE GUERRA";54;9;11;74
2019;"FERNANDO PEDROZA (RN)";"RN";"FERNANDO PEDROZA";30;6;2;38
2019;"FLORANIA (RN)";"RN";"FLORANIA";83;16;12;111
2019;"FRANCISCO DANTAS (RN)";"RN";"FRANCISCO DANTAS";23;4;4;31
2019;"FRUTUOSO GOMES (RN)";"RN";"FRUTUOSO GOMES";30;14;4;48
2019;"GALINHOS (RN)";"RN";"GALINHOS";17;4;4;25
2019;"GOIANINHA (RN)";"RN";"GOIANINHA";220;60;129;409
2019;"GOVERNADOR DIX SEPT ROSADO (RN)";"RN";"GOVERNADOR DIX SEPT ROSADO";212;27;23;262
2019;"GROSSOS (RN)";"RN";"GROSSOS";77;4;22;103
2019;"GUAMARE (RN)";"RN";"GUAMARE";142;24;47;213
2019;"IELMO MARINHO (RN)";"RN";"IELMO MARINHO";74;7;27;108
2019;"IPANGUACU (RN)";"RN";"IPANGUACU";124;29;49;202
2019;"IPUEIRA (RN)";"RN";"IPUEIRA";21;6;6;33
2019;"ITAJA (RN)";"RN";"ITAJA";114;5;7;126
2019;"ITAU (RN)";"RN";"ITAU";44;13;1;58
2019;"JACANA (RN)";"RN";"JACANA";658;70;35;763
2019;"JANDAIRA (RN)";"RN";"JANDAIRA";55;1;16;72
2019;"JANDUIS (RN)";"RN";"JANDUIS";30;9;4;43
2019;"JAPI (RN)";"RN";"JAPI";78;18;13;109
2019;"JARDIM DE ANGICOS (RN)";"RN";"JARDIM DE ANGICOS";9;1;4;14
2019;"JARDIM DE PIRANHAS (RN)";"RN";"JARDIM DE PIRANHAS";139;43;12;194
2019;"JARDIM DO SERIDO (RN)";"RN";"JARDIM DO SERIDO";183;20;54;257
2019;"JOAO CAMARA (RN)";"RN";"JOAO CAMARA";417;33;57;507
2019;"JOAO DIAS (RN)";"RN";"JOAO DIAS";8;3;1;12
2019;"JOSE DA PENHA (RN)";"RN";"JOSE DA PENHA";39;21;7;67
2019;"JUCURUTU (RN)";"RN";"JUCURUTU";191;58;10;259
2019;"JUNDIA (RN)";"RN";"JUNDIA";17;5;10;32
2019;"LAGOA DANTA (RN)";"RN";"LAGOA DANTA";59;11;17;87
2019;"LAGOA DE PEDRAS (RN)";"RN";"LAGOA DE PEDRAS";41;5;19;65
2019;"LAGOA DE VELHOS (RN)";"RN";"LAGOA DE VELHOS";29;0;4;33
2019;"LAGOA NOVA (RN)";"RN";"LAGOA NOVA";125;33;24;182
2019;"LAGOA SALGADA (RN)";"RN";"LAGOA SALGADA";137;5;13;155
2019;"LAJES (RN)";"RN";"LAJES";73;6;12;91
2019;"LAJES PINTADAS (RN)";"RN";"LAJES PINTADAS";25;9;5;39
2019;"LUCRECIA (RN)";"RN";"LUCRECIA";33;9;4;46
2019;"LUIS GOMES (RN)";"RN";"LUIS GOMES";154;46;12;212
2019;"MACAIBA (RN)";"RN";"MACAIBA";935;163;90;1188
2019;"MACAU (RN)";"RN";"MACAU";198;41;65;304
2019;"MAJOR SALES (RN)";"RN";"MAJOR SALES";23;10;3;36
2019;"MARCELINO VIEIRA (RN)";"RN";"MARCELINO VIEIRA";36;23;5;64
2019;"MARTINS (RN)";"RN";"MARTINS";64;12;11;87
2019;"MAXARANGUAPE (RN)";"RN";"MAXARANGUAPE";33;10;12;55
2019;"MESSIAS TARGINO (RN)";"RN";"MESSIAS TARGINO";46;13;4;63
2019;"MONTANHAS (RN)";"RN";"MONTANHAS";67;9;23;99
2019;"MONTE ALEGRE (RN)";"RN";"MONTE ALEGRE";151;20;43;214
2019;"MONTE DAS GAMELEIRAS (RN)";"RN";"MONTE DAS GAMELEIRAS";18;2;12;32
2019;"MOSSORO (RN)";"RN";"MOSSORO";4519;312;421;5252
2019;"NATAL (RN)";"RN";"NATAL";7538;1309;2851;11698
2019;"NISIA FLORESTA (RN)";"RN";"NISIA FLORESTA";104;44;67;215
2019;"NOVA CRUZ (RN)";"RN";"NOVA CRUZ";498;56;112;666
2019;"OLHO D AGUA DO BORGES (RN)";"RN";"OLHO D AGUA DO BORGES";28;5;2;35
2019;"OURO BRANCO (RN)";"RN";"OURO BRANCO";67;15;7;89
2019;"PARANA (RN)";"RN";"PARANA";24;16;6;46
2019;"PARAU (RN)";"RN";"PARAU";16;15;2;33
2019;"PARAZINHO (RN)";"RN";"PARAZINHO";31;5;18;54
2019;"PARELHAS (RN)";"RN";"PARELHAS";624;40;48;712
2019;"PARNAMIRIM (RN)";"RN";"PARNAMIRIM";2270;415;531;3216
2019;"PASSA E FICA (RN)";"RN";"PASSA E FICA";206;56;49;311
2019;"PASSAGEM (RN)";"RN";"PASSAGEM";15;10;5;30
2019;"PATU (RN)";"RN";"PATU";184;27;9;220
2019;"PAU DOS FERROS (RN)";"RN";"PAU DOS FERROS";791;64;34;889
2019;"PEDRA GRANDE (RN)";"RN";"PEDRA GRANDE";16;2;10;28
2019;"PEDRA PRETA (RN)";"RN";"PEDRA PRETA";34;3;9;46
2019;"PEDRO AVELINO (RN)";"RN";"PEDRO AVELINO";35;3;7;45
2019;"PEDRO VELHO (RN)";"RN";"PEDRO VELHO";55;8;17;80
2019;"PENDENCIAS (RN)";"RN";"PENDENCIAS";74;15;15;104
2019;"PILOES (RN)";"RN";"PILOES";24;5;2;31
2019;"POCO BRANCO (RN)";"RN";"POCO BRANCO";36;11;11;58
2019;"PORTALEGRE (RN)";"RN";"PORTALEGRE";48;22;6;76
2019;"PORTO DO MANGUE (RN)";"RN";"PORTO DO MANGUE";36;15;7;58
2019;"PUREZA (RN)";"RN";"PUREZA";93;6;30;129
2019;"RAFAEL FERNANDES (RN)";"RN";"RAFAEL FERNANDES";63;9;1;73
2019;"RAFAEL GODEIRO (RN)";"RN";"RAFAEL GODEIRO";12;2;4;18
2019;"RIACHO DA CRUZ (RN)";"RN";"RIACHO DA CRUZ";8;5;1;14
2019;"RIACHO DE SANTANA (RN)";"RN";"RIACHO DE SANTANA";12;11;5;28
2019;"RIACHUELO (RN)";"RN";"RIACHUELO";35;3;7;45
2019;"RIO DO FOGO (RN)";"RN";"RIO DO FOGO";48;7;11;66
2019;"RODOLFO FERNANDES (RN)";"RN";"RODOLFO FERNANDES";63;14;4;81
2019;"RUY BARBOSA (RN)";"RN";"RUY BARBOSA";14;2;6;22
2019;"SANTA CRUZ (RN)";"RN";"SANTA CRUZ";627;35;50;712
2019;"SANTA MARIA (RN)";"RN";"SANTA MARIA";71;7;8;86
2019;"SANTANA DO MATOS (RN)";"RN";"SANTANA DO MATOS";87;13;13;113
2019;"SANTANA DO SERIDO (RN)";"RN";"SANTANA DO SERIDO";29;4;2;35
2019;"SANTO ANTONIO (RN)";"RN";"SANTO ANTONIO";143;60;39;242
2019;"SAO BENTO DO NORTE (RN)";"RN";"SAO BENTO DO NORTE";9;0;9;18
2019;"SAO BENTO DO TRAIRI (RN)";"RN";"SAO BENTO DO TRAIRI";15;4;13;32
2019;"SAO FERNANDO (RN)";"RN";"SAO FERNANDO";19;14;4;37
2019;"SAO FRANCISCO DO OESTE (RN)";"RN";"SAO FRANCISCO DO OESTE";38;4;5;47
2019;"SAO GONCALO DO AMARANTE (RN)";"RN";"SAO GONCALO DO AMARANTE";537;168;314;1019
2019;"SAO JOAO DO SABUGI (RN)";"RN";"SAO JOAO DO SABUGI";46;22;6;74
2019;"SAO JOSE DE MIPIBU (RN)";"RN";"SAO JOSE DE MIPIBU";472;58;77;607
2019;"SAO JOSE DO CAMPESTRE (RN)";"RN";"SAO JOSE DO CAMPESTRE";89;7;22;118
2019;"SAO JOSE DO SERIDO (RN)";"RN";"SAO JOSE DO SERIDO";43;14;2;59
2019;"SAO MIGUEL (RN)";"RN";"SAO MIGUEL";288;72;40;400
2019;"SAO MIGUEL DO GOSTOSO (RN)";"RN";"SAO MIGUEL DO GOSTOSO";32;13;20;65
2019;"SAO PAULO DO POTENGI (RN)";"RN";"SAO PAULO DO POTENGI";134;14;31;179
2019;"SAO PEDRO (RN)";"RN";"SAO PEDRO";34;4;9;47
2019;"SAO RAFAEL (RN)";"RN";"SAO RAFAEL";49;16;6;71
2019;"SAO TOME (RN)";"RN";"SAO TOME";75;5;27;107
2019;"SAO VICENTE (RN)";"RN";"SAO VICENTE";56;5;7;68
2019;"SENADOR ELOI DE SOUZA (RN)";"RN";"SENADOR ELOI DE SOUZA";30;6;15;51
2019;"SENADOR GEORGINO AVELINO (RN)";"RN";"SENADOR GEORGINO AVELINO";17;5;2;24
2019;"SERRA CAIADA (RN)";"RN";"SERRA CAIADA";64;10;16;90
2019;"SERRA DE SAO BENTO (RN)";"RN";"SERRA DE SAO BENTO";57;6;5;68
2019;"SERRA DO MEL (RN)";"RN";"SERRA DO MEL";142;13;19;174
2019;"SERRA NEGRA DO NORTE (RN)";"RN";"SERRA NEGRA DO NORTE";67;22;10;99
2019;"SERRINHA (RN)";"RN";"SERRINHA";44;17;11;72
2019;"SERRINHA DOS PINTOS (RN)";"RN";"SERRINHA DOS PINTOS";48;9;4;61
2019;"SEVERIANO MELO (RN)";"RN";"SEVERIANO MELO";46;12;9;67
2019;"SITIO NOVO (RN)";"RN";"SITIO NOVO";23;13;3;39
2019;"TABOLEIRO GRANDE (RN)";"RN";"TABOLEIRO GRANDE";6;10;3;19
2019;"TAIPU (RN)";"RN";"TAIPU";60;7;35;102
2019;"TANGARA (RN)";"RN";"TANGARA";152;12;41;205
2019;"TENENTE ANANIAS (RN)";"RN";"TENENTE ANANIAS";82;21;7;110
2019;"TENENTE LAURENTINO CRUZ (RN)";"RN";"TENENTE LAURENTINO CRUZ";54;10;6;70
2019;"TIBAU (RN)";"RN";"TIBAU";48;12;33;93
2019;"TIBAU DO SUL (RN)";"RN";"TIBAU DO SUL";66;54;27;147
2019;"TIMBAUBA DOS BATISTAS (RN)";"RN";"TIMBAUBA DOS BATISTAS";12;8;7;27
2019;"TOUROS (RN)";"RN";"TOUROS";189;40;61;290
2019;"TRIUNFO POTIGUAR (RN)";"RN";"TRIUNFO POTIGUAR";18;7;3;28
2019;"UMARIZAL (RN)";"RN";"UMARIZAL";78;31;8;117
2019;"UPANEMA (RN)";"RN";"UPANEMA";109;12;16;137
2019;"VARZEA (RN)";"RN";"VARZEA";21;5;7;33
2019;"VENHA VER (RN)";"RN";"VENHA VER";19;9;7;35
2019;"VERA CRUZ (RN)";"RN";"VERA CRUZ";195;11;27;233
2019;"VICOSA (RN)";"RN";"VICOSA";7;1;1;9
2019;"VILA FLOR (RN)";"RN";"VILA FLOR";15;2;2;19
2019;"ALTA FLORESTA D OESTE (RO)";"RO";"ALTA FLORESTA D OESTE";515;20;93;628
2019;"ALTO ALEGRE DOS PARECIS (RO)";"RO";"ALTO ALEGRE DOS PARECIS";161;23;47;231
2019;"ALTO PARAISO (RO)";"RO";"ALTO PARAISO";328;13;79;420
2019;"ALVORADA D OESTE (RO)";"RO";"ALVORADA D OESTE";290;11;76;377
2019;"ARIQUEMES (RO)";"RO";"ARIQUEMES";2155;49;243;2447
2019;"BURITIS (RO)";"RO";"BURITIS";560;9;57;626
2019;"CABIXI (RO)";"RO";"CABIXI";127;5;29;161
2019;"CACAULANDIA (RO)";"RO";"CACAULANDIA";71;6;30;107
2019;"CACOAL (RO)";"RO";"CACOAL";1862;87;349;2298
2019;"CAMPO NOVO DE RONDONIA (RO)";"RO";"CAMPO NOVO DE RONDONIA";103;9;66;178
2019;"CANDEIAS DO JAMARI (RO)";"RO";"CANDEIAS DO JAMARI";278;12;42;332
2019;"CASTANHEIRAS (RO)";"RO";"CASTANHEIRAS";40;2;18;60
2019;"CEREJEIRAS (RO)";"RO";"CEREJEIRAS";374;10;48;432
2019;"CHUPINGUAIA (RO)";"RO";"CHUPINGUAIA";124;7;87;218
2019;"COLORADO DO OESTE (RO)";"RO";"COLORADO DO OESTE";414;21;72;507
2019;"CORUMBIARA (RO)";"RO";"CORUMBIARA";152;9;25;186
2019;"COSTA MARQUES (RO)";"RO";"COSTA MARQUES";239;7;30;276
2019;"CUJUBIM (RO)";"RO";"CUJUBIM";277;8;29;314
2019;"ESPIGAO D OESTE (RO)";"RO";"ESPIGAO D OESTE";733;6;150;889
2019;"GOVERNADOR JORGE TEIXEIRA (RO)";"RO";"GOVERNADOR JORGE TEIXEIRA";83;5;33;121
2019;"GUAJARA MIRIM (RO)";"RO";"GUAJARA MIRIM";758;15;32;805
2019;"ITAPUA DO OESTE (RO)";"RO";"ITAPUA DO OESTE";206;7;72;285
2019;"JARU (RO)";"RO";"JARU";1100;25;232;1357
2019;"JI PARANA (RO)";"RO";"JI PARANA";3213;99;711;4023
2019;"MACHADINHO D OESTE (RO)";"RO";"MACHADINHO D OESTE";424;13;65;502
2019;"MINISTRO ANDREAZZA (RO)";"RO";"MINISTRO ANDREAZZA";231;3;22;256
2019;"MIRANTE DA SERRA (RO)";"RO";"MIRANTE DA SERRA";183;8;33;224
2019;"MONTE NEGRO (RO)";"RO";"MONTE NEGRO";338;15;98;451
2019;"NOVA BRASILANDIA D OESTE (RO)";"RO";"NOVA BRASILANDIA D OESTE";254;13;120;387
2019;"NOVA DO MAMORE (RO)";"RO";"NOVA DO MAMORE";340;4;42;386
2019;"NOVA UNIAO (RO)";"RO";"NOVA UNIAO";125;1;42;168
2019;"NOVO HORIZONTE DO OESTE (RO)";"RO";"NOVO HORIZONTE DO OESTE";116;1;25;142
2019;"OURO PRETO DO OESTE (RO)";"RO";"OURO PRETO DO OESTE";800;30;139;969
2019;"PARECIS (RO)";"RO";"PARECIS";98;2;31;131
2019;"PIMENTA BUENO (RO)";"RO";"PIMENTA BUENO";1139;48;120;1307
2019;"PIMENTEIRAS DO OESTE (RO)";"RO";"PIMENTEIRAS DO OESTE";33;0;28;61
2019;"PORTO VELHO (RO)";"RO";"PORTO VELHO";7789;554;1881;10224
2019;"PRESIDENTE MEDICI (RO)";"RO";"PRESIDENTE MEDICI";432;14;102;548
2019;"PRIMAVERA DE RONDONIA (RO)";"RO";"PRIMAVERA DE RONDONIA";64;7;16;87
2019;"RIO CRESPO (RO)";"RO";"RIO CRESPO";58;3;19;80
2019;"ROLIM DE MOURA (RO)";"RO";"ROLIM DE MOURA";1306;41;167;1514
2019;"SANTA LUZIA D OESTE (RO)";"RO";"SANTA LUZIA D OESTE";222;5;63;290
2019;"SAO FELIPE D OESTE (RO)";"RO";"SAO FELIPE D OESTE";103;7;32;142
2019;"SAO FRANCISCO DO GUAPORE (RO)";"RO";"SAO FRANCISCO DO GUAPORE";477;9;91;577
2019;"SAO MIGUEL DO GUAPORE (RO)";"RO";"SAO MIGUEL DO GUAPORE";336;16;77;429
2019;"SERINGUEIRAS (RO)";"RO";"SERINGUEIRAS";228;4;59;291
2019;"TEIXEIROPOLIS (RO)";"RO";"TEIXEIROPOLIS";70;2;20;92
2019;"THEOBROMA (RO)";"RO";"THEOBROMA";125;4;27;156
2019;"URUPA (RO)";"RO";"URUPA";155;4;133;292
2019;"VALE DO ANARI (RO)";"RO";"VALE DO ANARI";106;7;33;146
2019;"VALE DO PARAISO (RO)";"RO";"VALE DO PARAISO";154;2;25;181
2019;"VILHENA (RO)";"RO";"VILHENA";1610;74;194;1878
2019;"ALTO ALEGRE (RR)";"RR";"ALTO ALEGRE";81;14;16;111
2019;"AMAJARI (RR)";"RR";"AMAJARI";34;10;4;48
2019;"BOA VISTA (RR)";"RR";"BOA VISTA";4213;538;997;5748
2019;"BONFIM (RR)";"RR";"BONFIM";23;3;12;38
2019;"CANTA (RR)";"RR";"CANTA";71;13;16;100
2019;"CARACARAI (RR)";"RR";"CARACARAI";130;16;12;158
2019;"CAROEBE (RR)";"RR";"CAROEBE";78;13;32;123
2019;"IRACEMA (RR)";"RR";"IRACEMA";30;19;1;50
2019;"MUCAJAI (RR)";"RR";"MUCAJAI";138;46;48;232
2019;"NORMANDIA (RR)";"RR";"NORMANDIA";14;4;2;20
2019;"PACARAIMA (RR)";"RR";"PACARAIMA";189;6;11;206
2019;"RORAINOPOLIS (RR)";"RR";"RORAINOPOLIS";282;31;43;356
2019;"SAO JOAO DA BALIZA (RR)";"RR";"SAO JOAO DA BALIZA";49;9;16;74
2019;"SAO LUIZ (RR)";"RR";"SAO LUIZ";56;4;7;67
2019;"UIRAMUTA (RR)";"RR";"UIRAMUTA";4;1;0;5
2019;"ACEGUA (RS)";"RS";"ACEGUA";103;17;30;150
2019;"AGUA SANTA (RS)";"RS";"AGUA SANTA";226;15;23;264
2019;"AGUDO (RS)";"RS";"AGUDO";343;18;74;435
2019;"AJURICABA (RS)";"RS";"AJURICABA";500;27;34;561
2019;"ALECRIM (RS)";"RS";"ALECRIM";112;8;37;157
2019;"ALEGRETE (RS)";"RS";"ALEGRETE";1097;61;283;1441
2019;"ALEGRIA (RS)";"RS";"ALEGRIA";118;5;30;153
2019;"ALMIRANTE TAMANDARE DO SUL (RS)";"RS";"ALMIRANTE TAMANDARE DO SUL";144;13;5;162
2019;"ALPESTRE (RS)";"RS";"ALPESTRE";185;19;62;266
2019;"ALTO ALEGRE (RS)";"RS";"ALTO ALEGRE";124;5;6;135
2019;"ALTO FELIZ (RS)";"RS";"ALTO FELIZ";131;19;16;166
2019;"ALVORADA (RS)";"RS";"ALVORADA";1755;229;644;2628
2019;"AMARAL FERRADOR (RS)";"RS";"AMARAL FERRADOR";161;19;27;207
2019;"AMETISTA DO SUL (RS)";"RS";"AMETISTA DO SUL";114;9;48;171
2019;"ANDRE DA ROCHA (RS)";"RS";"ANDRE DA ROCHA";67;15;9;91
2019;"ANTA GORDA (RS)";"RS";"ANTA GORDA";295;27;22;344
2019;"ANTONIO PRADO (RS)";"RS";"ANTONIO PRADO";729;18;45;792
2019;"ARAMBARE (RS)";"RS";"ARAMBARE";90;5;13;108
2019;"ARARICA (RS)";"RS";"ARARICA";118;16;24;158
2019;"ARATIBA (RS)";"RS";"ARATIBA";211;37;46;294
2019;"ARROIO DO MEIO (RS)";"RS";"ARROIO DO MEIO";674;54;63;791
2019;"ARROIO DO PADRE (RS)";"RS";"ARROIO DO PADRE";145;3;17;165
2019;"ARROIO DO SAL (RS)";"RS";"ARROIO DO SAL";130;12;20;162
2019;"ARROIO DO TIGRE (RS)";"RS";"ARROIO DO TIGRE";344;29;49;422
2019;"ARROIO DOS RATOS (RS)";"RS";"ARROIO DOS RATOS";261;29;90;380
2019;"ARROIO GRANDE (RS)";"RS";"ARROIO GRANDE";308;26;76;410
2019;"ARVOREZINHA (RS)";"RS";"ARVOREZINHA";567;41;60;668
2019;"AUGUSTO PESTANA (RS)";"RS";"AUGUSTO PESTANA";583;17;44;644
2019;"AUREA (RS)";"RS";"AUREA";208;3;10;221
2019;"BAGE (RS)";"RS";"BAGE";1559;258;406;2223
2019;"BALNEARIO PINHAL (RS)";"RS";"BALNEARIO PINHAL";153;15;40;208
2019;"BARAO (RS)";"RS";"BARAO";216;24;52;292
2019;"BARAO DE COTEGIPE (RS)";"RS";"BARAO DE COTEGIPE";304;11;22;337
2019;"BARAO DO TRIUNFO (RS)";"RS";"BARAO DO TRIUNFO";151;21;76;248
2019;"BARRA DO GUARITA (RS)";"RS";"BARRA DO GUARITA";38;5;8;51
2019;"BARRA DO QUARAI (RS)";"RS";"BARRA DO QUARAI";38;5;15;58
2019;"BARRA DO RIBEIRO (RS)";"RS";"BARRA DO RIBEIRO";262;18;63;343
2019;"BARRA DO RIO AZUL (RS)";"RS";"BARRA DO RIO AZUL";44;10;11;65
2019;"BARRA FUNDA (RS)";"RS";"BARRA FUNDA";198;3;26;227
2019;"BARRACAO (RS)";"RS";"BARRACAO";183;12;23;218
2019;"BARROS CASSAL (RS)";"RS";"BARROS CASSAL";221;34;89;344
2019;"BENJAMIN CONSTANT DO SUL (RS)";"RS";"BENJAMIN CONSTANT DO SUL";35;5;16;56
2019;"BENTO GONCALVES (RS)";"RS";"BENTO GONCALVES";3281;316;371;3968
2019;"BOA VISTA DAS MISSOES (RS)";"RS";"BOA VISTA DAS MISSOES";117;4;14;135
2019;"BOA VISTA DO BURICA (RS)";"RS";"BOA VISTA DO BURICA";280;13;33;326
2019;"BOA VISTA DO CADEADO (RS)";"RS";"BOA VISTA DO CADEADO";161;3;26;190
2019;"BOA VISTA DO INCRA (RS)";"RS";"BOA VISTA DO INCRA";110;3;12;125
2019;"BOA VISTA DO SUL (RS)";"RS";"BOA VISTA DO SUL";369;11;15;395
2019;"BOM JESUS (RS)";"RS";"BOM JESUS";334;59;74;467
2019;"BOM PRINCIPIO (RS)";"RS";"BOM PRINCIPIO";511;40;40;591
2019;"BOM PROGRESSO (RS)";"RS";"BOM PROGRESSO";59;8;9;76
2019;"BOM RETIRO DO SUL (RS)";"RS";"BOM RETIRO DO SUL";244;16;51;311
2019;"BOQUEIRAO DO LEAO (RS)";"RS";"BOQUEIRAO DO LEAO";193;21;28;242
2019;"BOSSOROCA (RS)";"RS";"BOSSOROCA";247;7;24;278
2019;"BOZANO (RS)";"RS";"BOZANO";196;4;8;208
2019;"BRAGA (RS)";"RS";"BRAGA";117;5;24;146
2019;"BROCHIER (RS)";"RS";"BROCHIER";329;16;31;376
2019;"BUTIA (RS)";"RS";"BUTIA";536;51;164;751
2019;"CACAPAVA DO SUL (RS)";"RS";"CACAPAVA DO SUL";844;84;195;1123
2019;"CACEQUI (RS)";"RS";"CACEQUI";188;24;32;244
2019;"CACHOEIRA DO SUL (RS)";"RS";"CACHOEIRA DO SUL";1446;148;250;1844
2019;"CACHOEIRINHA (RS)";"RS";"CACHOEIRINHA";2426;251;538;3215
2019;"CACIQUE DOBLE (RS)";"RS";"CACIQUE DOBLE";133;6;17;156
2019;"CAIBATE (RS)";"RS";"CAIBATE";184;7;9;200
2019;"CAICARA (RS)";"RS";"CAICARA";108;7;21;136
2019;"CAMAQUA (RS)";"RS";"CAMAQUA";1529;72;285;1886
2019;"CAMARGO (RS)";"RS";"CAMARGO";256;4;21;281
2019;"CAMBARA DO SUL (RS)";"RS";"CAMBARA DO SUL";267;22;47;336
2019;"CAMPESTRE DA SERRA (RS)";"RS";"CAMPESTRE DA SERRA";215;5;15;235
2019;"CAMPINA DAS MISSOES (RS)";"RS";"CAMPINA DAS MISSOES";198;11;40;249
2019;"CAMPINAS DO SUL (RS)";"RS";"CAMPINAS DO SUL";241;15;24;280
2019;"CAMPO BOM (RS)";"RS";"CAMPO BOM";892;107;93;1092
2019;"CAMPO NOVO (RS)";"RS";"CAMPO NOVO";209;17;35;261
2019;"CAMPOS BORGES (RS)";"RS";"CAMPOS BORGES";198;13;21;232
2019;"CANDELARIA (RS)";"RS";"CANDELARIA";528;42;128;698
2019;"CANDIDO GODOI (RS)";"RS";"CANDIDO GODOI";350;13;21;384
2019;"CANDIOTA (RS)";"RS";"CANDIOTA";210;56;75;341
2019;"CANELA (RS)";"RS";"CANELA";640;120;135;895
2019;"CANGUCU (RS)";"RS";"CANGUCU";1446;140;267;1853
2019;"CANOAS (RS)";"RS";"CANOAS";4730;562;1126;6418
2019;"CANUDOS DO VALE (RS)";"RS";"CANUDOS DO VALE";35;14;8;57
2019;"CAPAO BONITO DO SUL (RS)";"RS";"CAPAO BONITO DO SUL";72;6;7;85
2019;"CAPAO DA CANOA (RS)";"RS";"CAPAO DA CANOA";627;81;132;840
2019;"CAPAO DO CIPO (RS)";"RS";"CAPAO DO CIPO";156;6;11;173
2019;"CAPAO DO LEAO (RS)";"RS";"CAPAO DO LEAO";550;31;41;622
2019;"CAPELA DE SANTANA (RS)";"RS";"CAPELA DE SANTANA";236;13;27;276
2019;"CAPITAO (RS)";"RS";"CAPITAO";89;8;11;108
2019;"CAPIVARI DO SUL (RS)";"RS";"CAPIVARI DO SUL";186;15;13;214
2019;"CARAA (RS)";"RS";"CARAA";127;14;36;177
2019;"CARAZINHO (RS)";"RS";"CARAZINHO";1484;108;230;1822
2019;"CARLOS BARBOSA (RS)";"RS";"CARLOS BARBOSA";923;55;156;1134
2019;"CARLOS GOMES (RS)";"RS";"CARLOS GOMES";52;7;9;68
2019;"CASCA (RS)";"RS";"CASCA";497;20;36;553
2019;"CASEIROS (RS)";"RS";"CASEIROS";198;8;18;224
2019;"CATUIPE (RS)";"RS";"CATUIPE";510;18;46;574
2019;"CAXIAS DO SUL (RS)";"RS";"CAXIAS DO SUL";9297;1538;1771;12606
2019;"CENTENARIO (RS)";"RS";"CENTENARIO";145;8;11;164
2019;"CERRITO (RS)";"RS";"CERRITO";241;17;25;283
2019;"CERRO BRANCO (RS)";"RS";"CERRO BRANCO";79;13;22;114
2019;"CERRO GRANDE (RS)";"RS";"CERRO GRANDE";57;1;12;70
2019;"CERRO GRANDE DO SUL (RS)";"RS";"CERRO GRANDE DO SUL";324;18;34;376
2019;"CERRO LARGO (RS)";"RS";"CERRO LARGO";417;13;47;477
2019;"CHAPADA (RS)";"RS";"CHAPADA";479;52;40;571
2019;"CHARQUEADAS (RS)";"RS";"CHARQUEADAS";443;93;134;670
2019;"CHARRUA (RS)";"RS";"CHARRUA";117;6;11;134
2019;"CHIAPETTA (RS)";"RS";"CHIAPETTA";180;11;16;207
2019;"CHUI (RS)";"RS";"CHUI";133;19;6;158
2019;"CHUVISCA (RS)";"RS";"CHUVISCA";152;7;40;199
2019;"CIDREIRA (RS)";"RS";"CIDREIRA";121;16;39;176
2019;"CIRIACO (RS)";"RS";"CIRIACO";193;14;25;232
2019;"COLINAS (RS)";"RS";"COLINAS";76;10;12;98
2019;"COLORADO (RS)";"RS";"COLORADO";289;18;14;321
2019;"CONDOR (RS)";"RS";"CONDOR";342;27;40;409
2019;"CONSTANTINA (RS)";"RS";"CONSTANTINA";490;21;87;598
2019;"COQUEIRO BAIXO (RS)";"RS";"COQUEIRO BAIXO";28;6;3;37
2019;"COQUEIROS DO SUL (RS)";"RS";"COQUEIROS DO SUL";163;8;10;181
2019;"CORONEL BARROS (RS)";"RS";"CORONEL BARROS";164;1;9;174
2019;"CORONEL BICACO (RS)";"RS";"CORONEL BICACO";290;18;30;338
2019;"CORONEL PILAR (RS)";"RS";"CORONEL PILAR";237;9;8;254
2019;"COTIPORA (RS)";"RS";"COTIPORA";298;8;18;324
2019;"COXILHA (RS)";"RS";"COXILHA";164;5;16;185
2019;"CRISSIUMAL (RS)";"RS";"CRISSIUMAL";359;21;52;432
2019;"CRISTAL (RS)";"RS";"CRISTAL";262;11;68;341
2019;"CRISTAL DO SUL (RS)";"RS";"CRISTAL DO SUL";64;9;20;93
2019;"CRUZ ALTA (RS)";"RS";"CRUZ ALTA";1339;127;162;1628
2019;"CRUZALTENSE (RS)";"RS";"CRUZALTENSE";86;6;11;103
2019;"CRUZEIRO DO SUL (RS)";"RS";"CRUZEIRO DO SUL";584;10;21;615
2019;"DAVID CANABARRO (RS)";"RS";"DAVID CANABARRO";198;11;27;236
2019;"DERRUBADAS (RS)";"RS";"DERRUBADAS";141;6;18;165
2019;"DEZESSEIS DE NOVEMBRO (RS)";"RS";"DEZESSEIS DE NOVEMBRO";67;6;9;82
2019;"DILERMANDO DE AGUIAR (RS)";"RS";"DILERMANDO DE AGUIAR";53;2;33;88
2019;"DOIS IRMAOS (RS)";"RS";"DOIS IRMAOS";513;28;109;650
2019;"DOIS IRMAOS DAS MISSOES (RS)";"RS";"DOIS IRMAOS DAS MISSOES";94;6;7;107
2019;"DOIS LAJEADOS (RS)";"RS";"DOIS LAJEADOS";157;6;19;182
2019;"DOM FELICIANO (RS)";"RS";"DOM FELICIANO";261;18;101;380
2019;"DOM PEDRITO (RS)";"RS";"DOM PEDRITO";736;52;65;853
2019;"DOM PEDRO DE ALCANTARA (RS)";"RS";"DOM PEDRO DE ALCANTARA";127;4;7;138
2019;"DONA FRANCISCA (RS)";"RS";"DONA FRANCISCA";62;3;8;73
2019;"DOUTOR MAURICIO CARDOSO (RS)";"RS";"DOUTOR MAURICIO CARDOSO";246;16;18;280
2019;"DOUTOR RICARDO (RS)";"RS";"DOUTOR RICARDO";76;7;8;91
2019;"ELDORADO DO SUL (RS)";"RS";"ELDORADO DO SUL";987;50;77;1114
2019;"ENCANTADO (RS)";"RS";"ENCANTADO";749;71;144;964
2019;"ENCRUZILHADA DO SUL (RS)";"RS";"ENCRUZILHADA DO SUL";517;36;234;787
2019;"ENGENHO VELHO (RS)";"RS";"ENGENHO VELHO";49;3;14;66
2019;"ENTRE IJUIS (RS)";"RS";"ENTRE IJUIS";485;10;29;524
2019;"ENTRE RIOS DO SUL (RS)";"RS";"ENTRE RIOS DO SUL";73;15;18;106
2019;"EREBANGO (RS)";"RS";"EREBANGO";142;3;5;150
2019;"ERECHIM (RS)";"RS";"ERECHIM";2259;360;568;3187
2019;"ERNESTINA (RS)";"RS";"ERNESTINA";189;20;19;228
2019;"ERVAL GRANDE (RS)";"RS";"ERVAL GRANDE";165;31;35;231
2019;"ERVAL SECO (RS)";"RS";"ERVAL SECO";198;8;41;247
2019;"ESMERALDA (RS)";"RS";"ESMERALDA";117;2;17;136
2019;"ESPERANCA DO SUL (RS)";"RS";"ESPERANCA DO SUL";70;3;19;92
2019;"ESPUMOSO (RS)";"RS";"ESPUMOSO";872;52;93;1017
2019;"ESTACAO (RS)";"RS";"ESTACAO";254;10;31;295
2019;"ESTANCIA VELHA (RS)";"RS";"ESTANCIA VELHA";925;88;127;1140
2019;"ESTEIO (RS)";"RS";"ESTEIO";1091;125;270;1486
2019;"ESTRELA (RS)";"RS";"ESTRELA";1173;61;73;1307
2019;"ESTRELA VELHA (RS)";"RS";"ESTRELA VELHA";163;8;27;198
2019;"EUGENIO DE CASTRO (RS)";"RS";"EUGENIO DE CASTRO";127;9;18;154
2019;"FAGUNDES VARELA (RS)";"RS";"FAGUNDES VARELA";131;4;18;153
2019;"FARROUPILHA (RS)";"RS";"FARROUPILHA";2444;262;257;2963
2019;"FAXINAL DO SOTURNO (RS)";"RS";"FAXINAL DO SOTURNO";185;3;17;205
2019;"FAXINALZINHO (RS)";"RS";"FAXINALZINHO";65;4;13;82
2019;"FAZENDA VILANOVA (RS)";"RS";"FAZENDA VILANOVA";152;11;30;193
2019;"FELIZ (RS)";"RS";"FELIZ";488;37;95;620
2019;"FLORES DA CUNHA (RS)";"RS";"FLORES DA CUNHA";1698;81;152;1931
2019;"FLORIANO PEIXOTO (RS)";"RS";"FLORIANO PEIXOTO";85;4;22;111
2019;"FONTOURA XAVIER (RS)";"RS";"FONTOURA XAVIER";254;26;59;339
2019;"FORMIGUEIRO (RS)";"RS";"FORMIGUEIRO";207;3;25;235
2019;"FORQUETINHA (RS)";"RS";"FORQUETINHA";72;6;6;84
2019;"FORTALEZA DOS VALOS (RS)";"RS";"FORTALEZA DOS VALOS";307;6;26;339
2019;"FREDERICO WESTPHALEN (RS)";"RS";"FREDERICO WESTPHALEN";919;51;105;1075
2019;"GARIBALDI (RS)";"RS";"GARIBALDI";1630;94;149;1873
2019;"GARRUCHOS (RS)";"RS";"GARRUCHOS";61;9;18;88
2019;"GAURAMA (RS)";"RS";"GAURAMA";251;26;20;297
2019;"GENERAL CAMARA (RS)";"RS";"GENERAL CAMARA";129;15;35;179
2019;"GENTIL (RS)";"RS";"GENTIL";123;8;21;152
2019;"GETULIO VARGAS (RS)";"RS";"GETULIO VARGAS";546;43;56;645
2019;"GIRUA (RS)";"RS";"GIRUA";653;62;55;770
2019;"GLORINHA (RS)";"RS";"GLORINHA";303;19;16;338
2019;"GRAMADO (RS)";"RS";"GRAMADO";730;155;164;1049
2019;"GRAMADO DOS LOUREIROS (RS)";"RS";"GRAMADO DOS LOUREIROS";48;3;14;65
2019;"GRAMADO XAVIER (RS)";"RS";"GRAMADO XAVIER";84;6;10;100
2019;"GRAVATAI (RS)";"RS";"GRAVATAI";3759;563;751;5073
2019;"GUABIJU (RS)";"RS";"GUABIJU";59;3;12;74
2019;"GUAIBA (RS)";"RS";"GUAIBA";1248;241;431;1920
2019;"GUAPORE (RS)";"RS";"GUAPORE";552;48;88;688
2019;"GUARANI DAS MISSOES (RS)";"RS";"GUARANI DAS MISSOES";335;6;39;380
2019;"HARMONIA (RS)";"RS";"HARMONIA";271;8;9;288
2019;"HERVAL (RS)";"RS";"HERVAL";134;19;19;172
2019;"HERVEIRAS (RS)";"RS";"HERVEIRAS";69;2;3;74
2019;"HORIZONTINA (RS)";"RS";"HORIZONTINA";447;39;67;553
2019;"HULHA NEGRA (RS)";"RS";"HULHA NEGRA";105;11;27;143
2019;"HUMAITA (RS)";"RS";"HUMAITA";188;11;15;214
2019;"IBARAMA (RS)";"RS";"IBARAMA";111;6;20;137
2019;"IBIACA (RS)";"RS";"IBIACA";313;13;34;360
2019;"IBIRAIARAS (RS)";"RS";"IBIRAIARAS";548;13;36;597
2019;"IBIRAPUITA (RS)";"RS";"IBIRAPUITA";160;12;56;228
2019;"IBIRUBA (RS)";"RS";"IBIRUBA";1132;71;109;1312
2019;"IGREJINHA (RS)";"RS";"IGREJINHA";591;49;71;711
2019;"IJUI (RS)";"RS";"IJUI";2018;173;138;2329
2019;"ILOPOLIS (RS)";"RS";"ILOPOLIS";256;13;17;286
2019;"IMBE (RS)";"RS";"IMBE";338;28;81;447
2019;"IMIGRANTE (RS)";"RS";"IMIGRANTE";111;18;20;149
2019;"INDEPENDENCIA (RS)";"RS";"INDEPENDENCIA";331;13;56;400
2019;"INHACORA (RS)";"RS";"INHACORA";87;8;9;104
2019;"IPE (RS)";"RS";"IPE";352;31;34;417
2019;"IPIRANGA DO SUL (RS)";"RS";"IPIRANGA DO SUL";152;9;12;173
2019;"IRAI (RS)";"RS";"IRAI";172;11;22;205
2019;"ITAARA (RS)";"RS";"ITAARA";145;7;21;173
2019;"ITACURUBI (RS)";"RS";"ITACURUBI";73;8;12;93
2019;"ITAPUCA (RS)";"RS";"ITAPUCA";81;6;13;100
2019;"ITAQUI (RS)";"RS";"ITAQUI";740;38;111;889
2019;"ITATI (RS)";"RS";"ITATI";77;4;10;91
2019;"ITATIBA DO SUL (RS)";"RS";"ITATIBA DO SUL";87;12;13;112
2019;"IVORA (RS)";"RS";"IVORA";86;5;8;99
2019;"IVOTI (RS)";"RS";"IVOTI";606;51;119;776
2019;"JABOTICABA (RS)";"RS";"JABOTICABA";106;6;32;144
2019;"JACUIZINHO (RS)";"RS";"JACUIZINHO";81;3;19;103
2019;"JACUTINGA (RS)";"RS";"JACUTINGA";148;9;9;166
2019;"JAGUARAO (RS)";"RS";"JAGUARAO";371;28;73;472
2019;"JAGUARI (RS)";"RS";"JAGUARI";355;33;61;449
2019;"JAQUIRANA (RS)";"RS";"JAQUIRANA";177;10;18;205
2019;"JARI (RS)";"RS";"JARI";118;7;18;143
2019;"JOIA (RS)";"RS";"JOIA";411;21;55;487
2019;"JULIO DE CASTILHOS (RS)";"RS";"JULIO DE CASTILHOS";767;34;84;885
2019;"LAGOA BONITA DO SUL (RS)";"RS";"LAGOA BONITA DO SUL";75;11;16;102
2019;"LAGOA DOS TRES CANTOS (RS)";"RS";"LAGOA DOS TRES CANTOS";118;5;7;130
2019;"LAGOA VERMELHA (RS)";"RS";"LAGOA VERMELHA";752;76;88;916
2019;"LAGOAO (RS)";"RS";"LAGOAO";113;9;50;172
2019;"LAJEADO (RS)";"RS";"LAJEADO";2386;176;285;2847
2019;"LAJEADO DO BUGRE (RS)";"RS";"LAJEADO DO BUGRE";38;7;14;59
2019;"LAVRAS DO SUL (RS)";"RS";"LAVRAS DO SUL";127;12;33;172
2019;"LIBERATO SALZANO (RS)";"RS";"LIBERATO SALZANO";167;6;34;207
2019;"LINDOLFO COLLOR (RS)";"RS";"LINDOLFO COLLOR";149;14;21;184
2019;"LINHA NOVA (RS)";"RS";"LINHA NOVA";92;8;4;104
2019;"MACAMBARA (RS)";"RS";"MACAMBARA";56;4;43;103
2019;"MACHADINHO (RS)";"RS";"MACHADINHO";162;10;30;202
2019;"MAMPITUBA (RS)";"RS";"MAMPITUBA";30;4;12;46
2019;"MANOEL VIANA (RS)";"RS";"MANOEL VIANA";206;9;15;230
2019;"MAQUINE (RS)";"RS";"MAQUINE";286;17;20;323
2019;"MARATA (RS)";"RS";"MARATA";143;10;22;175
2019;"MARAU (RS)";"RS";"MARAU";1240;116;216;1572
2019;"MARCELINO RAMOS (RS)";"RS";"MARCELINO RAMOS";144;25;35;204
2019;"MARIANA PIMENTEL (RS)";"RS";"MARIANA PIMENTEL";174;13;34;221
2019;"MARIANO MORO (RS)";"RS";"MARIANO MORO";82;12;20;114
2019;"MARQUES DE SOUZA (RS)";"RS";"MARQUES DE SOUZA";134;13;18;165
2019;"MATA (RS)";"RS";"MATA";133;8;30;171
2019;"MATO CASTELHANO (RS)";"RS";"MATO CASTELHANO";165;22;20;207
2019;"MATO LEITAO (RS)";"RS";"MATO LEITAO";168;12;14;194
2019;"MATO QUEIMADO (RS)";"RS";"MATO QUEIMADO";113;8;8;129
2019;"MAXIMILIANO DE ALMEIDA (RS)";"RS";"MAXIMILIANO DE ALMEIDA";185;21;56;262
2019;"MINAS DO LEAO (RS)";"RS";"MINAS DO LEAO";127;15;38;180
2019;"MIRAGUAI (RS)";"RS";"MIRAGUAI";130;6;37;173
2019;"MONTAURI (RS)";"RS";"MONTAURI";87;4;5;96
2019;"MONTE ALEGRE DOS CAMPOS (RS)";"RS";"MONTE ALEGRE DOS CAMPOS";131;6;28;165
2019;"MONTE BELO DO SUL (RS)";"RS";"MONTE BELO DO SUL";315;6;25;346
2019;"MONTENEGRO (RS)";"RS";"MONTENEGRO";1550;157;193;1900
2019;"MORMACO (RS)";"RS";"MORMACO";109;6;14;129
2019;"MORRINHOS DO SUL (RS)";"RS";"MORRINHOS DO SUL";183;1;6;190
2019;"MORRO REDONDO (RS)";"RS";"MORRO REDONDO";266;5;27;298
2019;"MORRO REUTER (RS)";"RS";"MORRO REUTER";225;13;29;267
2019;"MOSTARDAS (RS)";"RS";"MOSTARDAS";369;26;80;475
2019;"MUCUM (RS)";"RS";"MUCUM";103;11;21;135
2019;"MUITOS CAPOES (RS)";"RS";"MUITOS CAPOES";123;7;9;139
2019;"MULITERNO (RS)";"RS";"MULITERNO";124;3;12;139
2019;"NAO ME TOQUE (RS)";"RS";"NAO ME TOQUE";616;51;83;750
2019;"NICOLAU VERGUEIRO (RS)";"RS";"NICOLAU VERGUEIRO";119;7;19;145
2019;"NONOAI (RS)";"RS";"NONOAI";269;19;58;346
2019;"NOVA ALVORADA (RS)";"RS";"NOVA ALVORADA";223;7;18;248
2019;"NOVA ARACA (RS)";"RS";"NOVA ARACA";160;18;42;220
2019;"NOVA BASSANO (RS)";"RS";"NOVA BASSANO";532;27;59;618
2019;"NOVA BOA VISTA (RS)";"RS";"NOVA BOA VISTA";113;11;12;136
2019;"NOVA BRESCIA (RS)";"RS";"NOVA BRESCIA";161;11;19;191
2019;"NOVA CANDELARIA (RS)";"RS";"NOVA CANDELARIA";103;10;11;124
2019;"NOVA ESPERANCA DO SUL (RS)";"RS";"NOVA ESPERANCA DO SUL";115;17;47;179
2019;"NOVA HARTZ (RS)";"RS";"NOVA HARTZ";204;29;137;370
2019;"NOVA PADUA (RS)";"RS";"NOVA PADUA";366;5;5;376
2019;"NOVA PALMA (RS)";"RS";"NOVA PALMA";345;17;42;404
2019;"NOVA PETROPOLIS (RS)";"RS";"NOVA PETROPOLIS";589;33;73;695
2019;"NOVA PRATA (RS)";"RS";"NOVA PRATA";733;31;84;848
2019;"NOVA RAMADA (RS)";"RS";"NOVA RAMADA";160;13;12;185
2019;"NOVA ROMA DO SUL (RS)";"RS";"NOVA ROMA DO SUL";363;6;26;395
2019;"NOVA SANTA RITA (RS)";"RS";"NOVA SANTA RITA";1057;65;65;1187
2019;"NOVO BARREIRO (RS)";"RS";"NOVO BARREIRO";194;6;17;217
2019;"NOVO CABRAIS (RS)";"RS";"NOVO CABRAIS";125;4;10;139
2019;"NOVO HAMBURGO (RS)";"RS";"NOVO HAMBURGO";3392;356;490;4238
2019;"NOVO MACHADO (RS)";"RS";"NOVO MACHADO";213;20;19;252
2019;"NOVO TIRADENTES (RS)";"RS";"NOVO TIRADENTES";57;4;10;71
2019;"NOVO XINGU (RS)";"RS";"NOVO XINGU";65;10;10;85
2019;"OSORIO (RS)";"RS";"OSORIO";989;75;117;1181
2019;"PAIM FILHO (RS)";"RS";"PAIM FILHO";160;3;32;195
2019;"PALMARES DO SUL (RS)";"RS";"PALMARES DO SUL";209;16;53;278
2019;"PALMEIRA DAS MISSOES (RS)";"RS";"PALMEIRA DAS MISSOES";1167;40;116;1323
2019;"PALMITINHO (RS)";"RS";"PALMITINHO";244;21;51;316
2019;"PANAMBI (RS)";"RS";"PANAMBI";1178;78;150;1406
2019;"PANTANO GRANDE (RS)";"RS";"PANTANO GRANDE";355;18;36;409
2019;"PARAI (RS)";"RS";"PARAI";575;15;17;607
2019;"PARAISO DO SUL (RS)";"RS";"PARAISO DO SUL";117;5;26;148
2019;"PARECI NOVO (RS)";"RS";"PARECI NOVO";461;9;19;489
2019;"PAROBE (RS)";"RS";"PAROBE";707;99;209;1015
2019;"PASSA SETE (RS)";"RS";"PASSA SETE";119;5;34;158
2019;"PASSO DO SOBRADO (RS)";"RS";"PASSO DO SOBRADO";168;7;60;235
2019;"PASSO FUNDO (RS)";"RS";"PASSO FUNDO";3894;291;410;4595
2019;"PAULO BENTO (RS)";"RS";"PAULO BENTO";110;16;10;136
2019;"PAVERAMA (RS)";"RS";"PAVERAMA";242;47;54;343
2019;"PEDRAS ALTAS (RS)";"RS";"PEDRAS ALTAS";30;14;8;52
2019;"PEDRO OSORIO (RS)";"RS";"PEDRO OSORIO";146;16;37;199
2019;"PEJUCARA (RS)";"RS";"PEJUCARA";270;5;24;299
2019;"PELOTAS (RS)";"RS";"PELOTAS";6004;517;1291;7812
2019;"PICADA CAFE (RS)";"RS";"PICADA CAFE";113;21;60;194
2019;"PINHAL (RS)";"RS";"PINHAL";132;4;11;147
2019;"PINHAL DA SERRA (RS)";"RS";"PINHAL DA SERRA";81;9;21;111
2019;"PINHAL GRANDE (RS)";"RS";"PINHAL GRANDE";168;12;31;211
2019;"PINHEIRINHO DO VALE (RS)";"RS";"PINHEIRINHO DO VALE";71;9;25;105
2019;"PINHEIRO MACHADO (RS)";"RS";"PINHEIRO MACHADO";187;13;63;263
2019;"PINTO BANDEIRA (RS)";"RS";"PINTO BANDEIRA";203;11;7;221
2019;"PIRAPO (RS)";"RS";"PIRAPO";64;9;16;89
2019;"PIRATINI (RS)";"RS";"PIRATINI";336;68;157;561
2019;"PLANALTO (RS)";"RS";"PLANALTO";264;12;36;312
2019;"POCO DAS ANTAS (RS)";"RS";"POCO DAS ANTAS";123;10;16;149
2019;"PONTAO (RS)";"RS";"PONTAO";196;11;29;236
2019;"PONTE PRETA (RS)";"RS";"PONTE PRETA";84;10;9;103
2019;"PORTAO (RS)";"RS";"PORTAO";1864;114;131;2109
2019;"PORTO ALEGRE (RS)";"RS";"PORTO ALEGRE";15969;2294;5209;23472
2019;"PORTO LUCENA (RS)";"RS";"PORTO LUCENA";117;16;18;151
2019;"PORTO MAUA (RS)";"RS";"PORTO MAUA";74;6;12;92
2019;"PORTO VERA CRUZ (RS)";"RS";"PORTO VERA CRUZ";22;4;10;36
2019;"PORTO XAVIER (RS)";"RS";"PORTO XAVIER";229;30;58;317
2019;"POUSO NOVO (RS)";"RS";"POUSO NOVO";52;10;12;74
2019;"PRESIDENTE LUCENA (RS)";"RS";"PRESIDENTE LUCENA";213;6;22;241
2019;"PROGRESSO (RS)";"RS";"PROGRESSO";141;16;41;198
2019;"PROTASIO ALVES (RS)";"RS";"PROTASIO ALVES";54;4;9;67
2019;"PUTINGA (RS)";"RS";"PUTINGA";145;12;9;166
2019;"QUARAI (RS)";"RS";"QUARAI";246;38;65;349
2019;"QUATRO IRMAOS (RS)";"RS";"QUATRO IRMAOS";70;11;9;90
2019;"QUEVEDOS (RS)";"RS";"QUEVEDOS";63;11;16;90
2019;"QUINZE DE NOVEMBRO (RS)";"RS";"QUINZE DE NOVEMBRO";267;31;34;332
2019;"REDENTORA (RS)";"RS";"REDENTORA";150;23;22;195
2019;"RELVADO (RS)";"RS";"RELVADO";61;7;6;74
2019;"RESTINGA SECA (RS)";"RS";"RESTINGA SECA";387;18;74;479
2019;"RIO DOS INDIOS (RS)";"RS";"RIO DOS INDIOS";106;8;33;147
2019;"RIO GRANDE (RS)";"RS";"RIO GRANDE";2549;283;764;3596
2019;"RIO PARDO (RS)";"RS";"RIO PARDO";559;86;128;773
2019;"RIOZINHO (RS)";"RS";"RIOZINHO";60;15;36;111
2019;"ROCA SALES (RS)";"RS";"ROCA SALES";185;22;45;252
2019;"RODEIO BONITO (RS)";"RS";"RODEIO BONITO";213;10;41;264
2019;"ROLADOR (RS)";"RS";"ROLADOR";74;5;6;85
2019;"ROLANTE (RS)";"RS";"ROLANTE";327;34;107;468
2019;"RONDA ALTA (RS)";"RS";"RONDA ALTA";383;13;37;433
2019;"RONDINHA (RS)";"RS";"RONDINHA";209;12;22;243
2019;"ROQUE GONZALES (RS)";"RS";"ROQUE GONZALES";176;6;31;213
2019;"ROSARIO DO SUL (RS)";"RS";"ROSARIO DO SUL";629;66;119;814
2019;"SAGRADA FAMILIA (RS)";"RS";"SAGRADA FAMILIA";43;4;10;57
2019;"SALDANHA MARINHO (RS)";"RS";"SALDANHA MARINHO";192;8;9;209
2019;"SALTO DO JACUI (RS)";"RS";"SALTO DO JACUI";245;30;33;308
2019;"SALVADOR DAS MISSOES (RS)";"RS";"SALVADOR DAS MISSOES";144;5;10;159
2019;"SALVADOR DO SUL (RS)";"RS";"SALVADOR DO SUL";334;21;32;387
2019;"SANANDUVA (RS)";"RS";"SANANDUVA";753;29;87;869
2019;"SANTA BARBARA DO SUL (RS)";"RS";"SANTA BARBARA DO SUL";425;21;34;480
2019;"SANTA CECILIA DO SUL (RS)";"RS";"SANTA CECILIA DO SUL";94;4;16;114
2019;"SANTA CLARA DO SUL (RS)";"RS";"SANTA CLARA DO SUL";140;30;17;187
2019;"SANTA CRUZ DO SUL (RS)";"RS";"SANTA CRUZ DO SUL";2376;194;692;3262
2019;"SANTA MARGARIDA DO SUL (RS)";"RS";"SANTA MARGARIDA DO SUL";76;8;17;101
2019;"SANTA MARIA (RS)";"RS";"SANTA MARIA";4013;460;1096;5569
2019;"SANTA MARIA DO HERVAL (RS)";"RS";"SANTA MARIA DO HERVAL";282;26;62;370
2019;"SANTA ROSA (RS)";"RS";"SANTA ROSA";1854;117;228;2199
2019;"SANTA TEREZA (RS)";"RS";"SANTA TEREZA";119;7;5;131
2019;"SANTA VITORIA DO PALMAR (RS)";"RS";"SANTA VITORIA DO PALMAR";736;30;87;853
2019;"SANTANA DA BOA VISTA (RS)";"RS";"SANTANA DA BOA VISTA";138;27;63;228
2019;"SANTANA DO LIVRAMENTO (RS)";"RS";"SANTANA DO LIVRAMENTO";981;145;260;1386
2019;"SANTIAGO (RS)";"RS";"SANTIAGO";1103;148;114;1365
2019;"SANTO ANGELO (RS)";"RS";"SANTO ANGELO";1419;115;135;1669
2019;"SANTO ANTONIO DA PATRULHA (RS)";"RS";"SANTO ANTONIO DA PATRULHA";1055;75;220;1350
2019;"SANTO ANTONIO DAS MISSOES (RS)";"RS";"SANTO ANTONIO DAS MISSOES";284;69;58;411
2019;"SANTO ANTONIO DO PALMA (RS)";"RS";"SANTO ANTONIO DO PALMA";76;5;14;95
2019;"SANTO ANTONIO DO PLANALTO (RS)";"RS";"SANTO ANTONIO DO PLANALTO";113;4;11;128
2019;"SANTO AUGUSTO (RS)";"RS";"SANTO AUGUSTO";610;54;39;703
2019;"SANTO CRISTO (RS)";"RS";"SANTO CRISTO";640;22;56;718
2019;"SANTO EXPEDITO DO SUL (RS)";"RS";"SANTO EXPEDITO DO SUL";122;2;13;137
2019;"SAO BORJA (RS)";"RS";"SAO BORJA";1337;82;124;1543
2019;"SAO DOMINGOS DO SUL (RS)";"RS";"SAO DOMINGOS DO SUL";128;5;14;147
2019;"SAO FRANCISCO DE ASSIS (RS)";"RS";"SAO FRANCISCO DE ASSIS";428;46;132;606
2019;"SAO FRANCISCO DE PAULA (RS)";"RS";"SAO FRANCISCO DE PAULA";675;66;104;845
2019;"SAO GABRIEL (RS)";"RS";"SAO GABRIEL";994;61;161;1216
2019;"SAO JERONIMO (RS)";"RS";"SAO JERONIMO";355;44;132;531
2019;"SAO JOAO DA URTIGA (RS)";"RS";"SAO JOAO DA URTIGA";189;8;24;221
2019;"SAO JOAO DO POLESINE (RS)";"RS";"SAO JOAO DO POLESINE";110;4;6;120
2019;"SAO JORGE (RS)";"RS";"SAO JORGE";160;7;21;188
2019;"SAO JOSE DAS MISSOES (RS)";"RS";"SAO JOSE DAS MISSOES";52;4;9;65
2019;"SAO JOSE DO HERVAL (RS)";"RS";"SAO JOSE DO HERVAL";75;4;14;93
2019;"SAO JOSE DO HORTENCIO (RS)";"RS";"SAO JOSE DO HORTENCIO";222;12;34;268
2019;"SAO JOSE DO INHACORA (RS)";"RS";"SAO JOSE DO INHACORA";74;6;10;90
2019;"SAO JOSE DO NORTE (RS)";"RS";"SAO JOSE DO NORTE";480;24;159;663
2019;"SAO JOSE DO OURO (RS)";"RS";"SAO JOSE DO OURO";406;9;47;462
2019;"SAO JOSE DO SUL (RS)";"RS";"SAO JOSE DO SUL";163;10;18;191
2019;"SAO JOSE DOS AUSENTES (RS)";"RS";"SAO JOSE DOS AUSENTES";145;13;26;184
2019;"SAO LEOPOLDO (RS)";"RS";"SAO LEOPOLDO";2776;308;432;3516
2019;"SAO LOURENCO DO SUL (RS)";"RS";"SAO LOURENCO DO SUL";1151;71;187;1409
2019;"SAO LUIZ GONZAGA (RS)";"RS";"SAO LUIZ GONZAGA";751;90;108;949
2019;"SAO MARCOS (RS)";"RS";"SAO MARCOS";861;41;143;1045
2019;"SAO MARTINHO (RS)";"RS";"SAO MARTINHO";276;8;23;307
2019;"SAO MARTINHO DA SERRA (RS)";"RS";"SAO MARTINHO DA SERRA";75;8;7;90
2019;"SAO MIGUEL DAS MISSOES (RS)";"RS";"SAO MIGUEL DAS MISSOES";328;30;50;408
2019;"SAO NICOLAU (RS)";"RS";"SAO NICOLAU";87;14;19;120
2019;"SAO PAULO DAS MISSOES (RS)";"RS";"SAO PAULO DAS MISSOES";148;9;37;194
2019;"SAO PEDRO DA SERRA (RS)";"RS";"SAO PEDRO DA SERRA";117;13;17;147
2019;"SAO PEDRO DAS MISSOES (RS)";"RS";"SAO PEDRO DAS MISSOES";48;4;9;61
2019;"SAO PEDRO DO BUTIA (RS)";"RS";"SAO PEDRO DO BUTIA";162;3;19;184
2019;"SAO PEDRO DO SUL (RS)";"RS";"SAO PEDRO DO SUL";380;57;59;496
2019;"SAO SEBASTIAO DO CAI (RS)";"RS";"SAO SEBASTIAO DO CAI";793;45;64;902
2019;"SAO SEPE (RS)";"RS";"SAO SEPE";547;65;132;744
2019;"SAO VALENTIM (RS)";"RS";"SAO VALENTIM";86;11;15;112
2019;"SAO VALENTIM DO SUL (RS)";"RS";"SAO VALENTIM DO SUL";92;9;13;114
2019;"SAO VALERIO DO SUL (RS)";"RS";"SAO VALERIO DO SUL";53;2;9;64
2019;"SAO VENDELINO (RS)";"RS";"SAO VENDELINO";83;16;16;115
2019;"SAO VICENTE DO SUL (RS)";"RS";"SAO VICENTE DO SUL";168;10;59;237
2019;"SAPIRANGA (RS)";"RS";"SAPIRANGA";1014;105;201;1320
2019;"SAPUCAIA DO SUL (RS)";"RS";"SAPUCAIA DO SUL";1792;151;155;2098
2019;"SARANDI (RS)";"RS";"SARANDI";675;37;89;801
2019;"SEBERI (RS)";"RS";"SEBERI";368;13;67;448
2019;"SEDE NOVA (RS)";"RS";"SEDE NOVA";129;12;13;154
2019;"SEGREDO (RS)";"RS";"SEGREDO";231;6;54;291
2019;"SELBACH (RS)";"RS";"SELBACH";373;15;28;416
2019;"SENADOR SALGADO FILHO (RS)";"RS";"SENADOR SALGADO FILHO";180;9;14;203
2019;"SENTINELA DO SUL (RS)";"RS";"SENTINELA DO SUL";202;7;20;229
2019;"SERAFINA CORREA (RS)";"RS";"SERAFINA CORREA";445;46;87;578
2019;"SERIO (RS)";"RS";"SERIO";69;3;6;78
2019;"SERTAO (RS)";"RS";"SERTAO";323;23;43;389
2019;"SERTAO SANTANA (RS)";"RS";"SERTAO SANTANA";188;5;28;221
2019;"SETE DE SETEMBRO (RS)";"RS";"SETE DE SETEMBRO";116;4;12;132
2019;"SEVERIANO DE ALMEIDA (RS)";"RS";"SEVERIANO DE ALMEIDA";124;15;16;155
2019;"SILVEIRA MARTINS (RS)";"RS";"SILVEIRA MARTINS";140;2;9;151
2019;"SINIMBU (RS)";"RS";"SINIMBU";149;5;7;161
2019;"SOBRADINHO (RS)";"RS";"SOBRADINHO";352;15;68;435
2019;"SOLEDADE (RS)";"RS";"SOLEDADE";715;51;156;922
2019;"TABAI (RS)";"RS";"TABAI";220;17;22;259
2019;"TAPEJARA (RS)";"RS";"TAPEJARA";954;41;136;1131
2019;"TAPERA (RS)";"RS";"TAPERA";450;25;39;514
2019;"TAPES (RS)";"RS";"TAPES";311;28;39;378
2019;"TAQUARA (RS)";"RS";"TAQUARA";944;72;288;1304
2019;"TAQUARI (RS)";"RS";"TAQUARI";491;49;165;705
2019;"TAQUARUCU DO SUL (RS)";"RS";"TAQUARUCU DO SUL";90;4;15;109
2019;"TAVARES (RS)";"RS";"TAVARES";172;23;30;225
2019;"TENENTE PORTELA (RS)";"RS";"TENENTE PORTELA";367;19;80;466
2019;"TERRA DE AREIA (RS)";"RS";"TERRA DE AREIA";363;11;46;420
2019;"TEUTONIA (RS)";"RS";"TEUTONIA";810;45;116;971
2019;"TIO HUGO (RS)";"RS";"TIO HUGO";156;9;19;184
2019;"TIRADENTES DO SUL (RS)";"RS";"TIRADENTES DO SUL";143;5;13;161
2019;"TOROPI (RS)";"RS";"TOROPI";78;9;21;108
2019;"TORRES (RS)";"RS";"TORRES";528;37;118;683
2019;"TRAMANDAI (RS)";"RS";"TRAMANDAI";743;109;191;1043
2019;"TRAVESSEIRO (RS)";"RS";"TRAVESSEIRO";48;11;13;72
2019;"TRES ARROIOS (RS)";"RS";"TRES ARROIOS";135;14;5;154
2019;"TRES CACHOEIRAS (RS)";"RS";"TRES CACHOEIRAS";687;11;32;730
2019;"TRES COROAS (RS)";"RS";"TRES COROAS";308;46;87;441
2019;"TRES DE MAIO (RS)";"RS";"TRES DE MAIO";846;54;90;990
2019;"TRES FORQUILHAS (RS)";"RS";"TRES FORQUILHAS";106;4;7;117
2019;"TRES PALMEIRAS (RS)";"RS";"TRES PALMEIRAS";100;7;28;135
2019;"TRES PASSOS (RS)";"RS";"TRES PASSOS";606;32;142;780
2019;"TRINDADE DO SUL (RS)";"RS";"TRINDADE DO SUL";168;18;29;215
2019;"TRIUNFO (RS)";"RS";"TRIUNFO";676;122;271;1069
2019;"TUCUNDUVA (RS)";"RS";"TUCUNDUVA";306;18;17;341
2019;"TUNAS (RS)";"RS";"TUNAS";86;6;27;119
2019;"TUPANCI DO SUL (RS)";"RS";"TUPANCI DO SUL";83;3;19;105
2019;"TUPANCIRETA (RS)";"RS";"TUPANCIRETA";777;94;88;959
2019;"TUPANDI (RS)";"RS";"TUPANDI";125;41;48;214
2019;"TUPARENDI (RS)";"RS";"TUPARENDI";373;19;35;427
2019;"TURUCU (RS)";"RS";"TURUCU";130;8;15;153
2019;"UBIRETAMA (RS)";"RS";"UBIRETAMA";123;10;5;138
2019;"UNIAO DA SERRA (RS)";"RS";"UNIAO DA SERRA";69;6;8;83
2019;"UNISTALDA (RS)";"RS";"UNISTALDA";70;12;19;101
2019;"URUGUAIANA (RS)";"RS";"URUGUAIANA";2075;126;192;2393
2019;"VACARIA (RS)";"RS";"VACARIA";1966;228;644;2838
2019;"VALE DO SOL (RS)";"RS";"VALE DO SOL";208;9;55;272
2019;"VALE REAL (RS)";"RS";"VALE REAL";226;17;12;255
2019;"VALE VERDE (RS)";"RS";"VALE VERDE";76;4;14;94
2019;"VANINI (RS)";"RS";"VANINI";102;12;18;132
2019;"VENANCIO AIRES (RS)";"RS";"VENANCIO AIRES";1317;133;239;1689
2019;"VERA CRUZ (RS)";"RS";"VERA CRUZ";532;45;155;732
2019;"VERANOPOLIS (RS)";"RS";"VERANOPOLIS";973;42;73;1088
2019;"VESPASIANO CORREA (RS)";"RS";"VESPASIANO CORREA";136;9;13;158
2019;"VIADUTOS (RS)";"RS";"VIADUTOS";176;13;24;213
2019;"VIAMAO (RS)";"RS";"VIAMAO";2432;401;728;3561
2019;"VICENTE DUTRA (RS)";"RS";"VICENTE DUTRA";77;2;21;100
2019;"VICTOR GRAEFF (RS)";"RS";"VICTOR GRAEFF";196;15;9;220
2019;"VILA FLORES (RS)";"RS";"VILA FLORES";203;15;22;240
2019;"VILA LANGARO (RS)";"RS";"VILA LANGARO";140;7;17;164
2019;"VILA MARIA (RS)";"RS";"VILA MARIA";355;8;47;410
2019;"VILA NOVA DO SUL (RS)";"RS";"VILA NOVA DO SUL";152;9;17;178
2019;"VISTA ALEGRE (RS)";"RS";"VISTA ALEGRE";92;6;12;110
2019;"VISTA ALEGRE DO PRATA (RS)";"RS";"VISTA ALEGRE DO PRATA";48;12;5;65
2019;"VISTA GAUCHA (RS)";"RS";"VISTA GAUCHA";94;1;14;109
2019;"VITORIA DAS MISSOES (RS)";"RS";"VITORIA DAS MISSOES";156;4;19;179
2019;"WESTFALIA (RS)";"RS";"WESTFALIA";167;15;19;201
2019;"XANGRI LA (RS)";"RS";"XANGRI LA";237;16;21;274
2019;"ABDON BATISTA (SC)";"SC";"ABDON BATISTA";84;3;14;101
2019;"ABELARDO LUZ (SC)";"SC";"ABELARDO LUZ";434;25;137;596
2019;"AGROLANDIA (SC)";"SC";"AGROLANDIA";288;20;22;330
2019;"AGRONOMICA (SC)";"SC";"AGRONOMICA";167;6;11;184
2019;"AGUA DOCE (SC)";"SC";"AGUA DOCE";270;37;38;345
2019;"AGUAS DE CHAPECO (SC)";"SC";"AGUAS DE CHAPECO";78;8;32;118
2019;"AGUAS FRIAS (SC)";"SC";"AGUAS FRIAS";75;7;7;89
2019;"AGUAS MORNAS (SC)";"SC";"AGUAS MORNAS";330;7;17;354
2019;"ALFREDO WAGNER (SC)";"SC";"ALFREDO WAGNER";348;24;22;394
2019;"ALTO BELA VISTA (SC)";"SC";"ALTO BELA VISTA";68;10;10;88
2019;"ANCHIETA (SC)";"SC";"ANCHIETA";210;17;25;252
2019;"ANGELINA (SC)";"SC";"ANGELINA";254;23;24;301
2019;"ANITA GARIBALDI (SC)";"SC";"ANITA GARIBALDI";156;17;36;209
2019;"ANITAPOLIS (SC)";"SC";"ANITAPOLIS";164;8;17;189
2019;"ANTONIO CARLOS (SC)";"SC";"ANTONIO CARLOS";729;8;20;757
2019;"APIUNA (SC)";"SC";"APIUNA";216;34;25;275
2019;"ARABUTA (SC)";"SC";"ARABUTA";158;14;34;206
2019;"ARAQUARI (SC)";"SC";"ARAQUARI";974;83;82;1139
2019;"ARARANGUA (SC)";"SC";"ARARANGUA";1438;97;171;1706
2019;"ARMAZEM (SC)";"SC";"ARMAZEM";302;15;19;336
2019;"ARROIO TRINTA (SC)";"SC";"ARROIO TRINTA";200;14;27;241
2019;"ARVOREDO (SC)";"SC";"ARVOREDO";72;42;12;126
2019;"ASCURRA (SC)";"SC";"ASCURRA";267;20;45;332
2019;"ATALANTA (SC)";"SC";"ATALANTA";103;1;9;113
2019;"AURORA (SC)";"SC";"AURORA";224;5;21;250
2019;"BALNEARIO ARROIO DO SILVA (SC)";"SC";"BALNEARIO ARROIO DO SILVA";145;13;16;174
2019;"BALNEARIO BARRA DO SUL (SC)";"SC";"BALNEARIO BARRA DO SUL";192;15;14;221
2019;"BALNEARIO CAMBORIU (SC)";"SC";"BALNEARIO CAMBORIU";916;313;278;1507
2019;"BALNEARIO DE PICARRAS (SC)";"SC";"BALNEARIO DE PICARRAS";337;42;66;445
2019;"BALNEARIO GAIVOTA (SC)";"SC";"BALNEARIO GAIVOTA";246;8;34;288
2019;"BALNEARIO RINCAO (SC)";"SC";"BALNEARIO RINCAO";112;13;12;137
2019;"BANDEIRANTE (SC)";"SC";"BANDEIRANTE";65;9;18;92
2019;"BARRA BONITA (SC)";"SC";"BARRA BONITA";43;6;10;59
2019;"BARRA VELHA (SC)";"SC";"BARRA VELHA";656;51;66;773
2019;"BELA VISTA DO TOLDO (SC)";"SC";"BELA VISTA DO TOLDO";113;11;42;166
2019;"BELMONTE (SC)";"SC";"BELMONTE";84;7;6;97
2019;"BENEDITO NOVO (SC)";"SC";"BENEDITO NOVO";344;46;33;423
2019;"BIGUACU (SC)";"SC";"BIGUACU";1536;91;143;1770
2019;"BLUMENAU (SC)";"SC";"BLUMENAU";5768;483;946;7197
2019;"BOCAINA DO SUL (SC)";"SC";"BOCAINA DO SUL";82;5;18;105
2019;"BOM JARDIM DA SERRA (SC)";"SC";"BOM JARDIM DA SERRA";181;16;25;222
2019;"BOM JESUS (SC)";"SC";"BOM JESUS";87;3;11;101
2019;"BOM JESUS DO OESTE (SC)";"SC";"BOM JESUS DO OESTE";77;4;10;91
2019;"BOM RETIRO (SC)";"SC";"BOM RETIRO";238;21;39;298
2019;"BOMBINHAS (SC)";"SC";"BOMBINHAS";227;62;42;331
2019;"BOTUVERA (SC)";"SC";"BOTUVERA";233;8;15;256
2019;"BRACO DO NORTE (SC)";"SC";"BRACO DO NORTE";1250;53;89;1392
2019;"BRACO DO TROMBUDO (SC)";"SC";"BRACO DO TROMBUDO";144;7;10;161
2019;"BRUNOPOLIS (SC)";"SC";"BRUNOPOLIS";127;4;12;143
2019;"BRUSQUE (SC)";"SC";"BRUSQUE";2819;170;221;3210
2019;"CACADOR (SC)";"SC";"CACADOR";2204;168;712;3084
2019;"CAIBI (SC)";"SC";"CAIBI";185;7;20;212
2019;"CALMON (SC)";"SC";"CALMON";46;11;27;84
2019;"CAMBORIU (SC)";"SC";"CAMBORIU";1269;70;48;1387
2019;"CAMPO ALEGRE (SC)";"SC";"CAMPO ALEGRE";458;21;19;498
2019;"CAMPO BELO DO SUL (SC)";"SC";"CAMPO BELO DO SUL";244;16;53;313
2019;"CAMPO ERE (SC)";"SC";"CAMPO ERE";364;18;37;419
2019;"CAMPOS NOVOS (SC)";"SC";"CAMPOS NOVOS";1181;124;122;1427
2019;"CANELINHA (SC)";"SC";"CANELINHA";542;15;11;568
2019;"CANOINHAS (SC)";"SC";"CANOINHAS";1368;75;195;1638
2019;"CAPAO ALTO (SC)";"SC";"CAPAO ALTO";85;9;21;115
2019;"CAPINZAL (SC)";"SC";"CAPINZAL";544;62;66;672
2019;"CAPIVARI DE BAIXO (SC)";"SC";"CAPIVARI DE BAIXO";392;25;28;445
2019;"CATANDUVAS (SC)";"SC";"CATANDUVAS";443;43;46;532
2019;"CAXAMBU DO SUL (SC)";"SC";"CAXAMBU DO SUL";137;4;14;155
2019;"CELSO RAMOS (SC)";"SC";"CELSO RAMOS";87;9;8;104
2019;"CERRO NEGRO (SC)";"SC";"CERRO NEGRO";71;6;21;98
2019;"CHAPADAO DO LAGEADO (SC)";"SC";"CHAPADAO DO LAGEADO";65;8;12;85
2019;"CHAPECO (SC)";"SC";"CHAPECO";4804;363;470;5637
2019;"COCAL DO SUL (SC)";"SC";"COCAL DO SUL";349;20;31;400
2019;"CONCORDIA (SC)";"SC";"CONCORDIA";2966;188;269;3423
2019;"CORDILHEIRA ALTA (SC)";"SC";"CORDILHEIRA ALTA";350;28;25;403
2019;"CORONEL FREITAS (SC)";"SC";"CORONEL FREITAS";323;12;31;366
2019;"CORONEL MARTINS (SC)";"SC";"CORONEL MARTINS";53;7;9;69
2019;"CORREIA PINTO (SC)";"SC";"CORREIA PINTO";465;54;83;602
2019;"CORUPA (SC)";"SC";"CORUPA";480;4;36;520
2019;"CRICIUMA (SC)";"SC";"CRICIUMA";3576;350;440;4366
2019;"CUNHA PORA (SC)";"SC";"CUNHA PORA";443;22;73;538
2019;"CUNHATAI (SC)";"SC";"CUNHATAI";57;4;10;71
2019;"CURITIBANOS (SC)";"SC";"CURITIBANOS";1119;102;163;1384
2019;"DESCANSO (SC)";"SC";"DESCANSO";246;18;36;300
2019;"DIONISIO CERQUEIRA (SC)";"SC";"DIONISIO CERQUEIRA";198;26;16;240
2019;"DONA EMMA (SC)";"SC";"DONA EMMA";142;16;13;171
2019;"DOUTOR PEDRINHO (SC)";"SC";"DOUTOR PEDRINHO";150;7;8;165
2019;"ENTRE RIOS (SC)";"SC";"ENTRE RIOS";33;4;30;67
2019;"ERMO (SC)";"SC";"ERMO";103;3;10;116
2019;"ERVAL VELHO (SC)";"SC";"ERVAL VELHO";136;11;27;174
2019;"FAXINAL DOS GUEDES (SC)";"SC";"FAXINAL DOS GUEDES";436;20;46;502
2019;"FLOR DO SERTAO (SC)";"SC";"FLOR DO SERTAO";26;10;16;52
2019;"FLORIANOPOLIS (SC)";"SC";"FLORIANOPOLIS";3872;915;1977;6764
2019;"FORMOSA DO SUL (SC)";"SC";"FORMOSA DO SUL";67;7;19;93
2019;"FORQUILHINHA (SC)";"SC";"FORQUILHINHA";626;30;41;697
2019;"FRAIBURGO (SC)";"SC";"FRAIBURGO";968;61;242;1271
2019;"FREI ROGERIO (SC)";"SC";"FREI ROGERIO";100;10;20;130
2019;"GALVAO (SC)";"SC";"GALVAO";121;9;14;144
2019;"GAROPABA (SC)";"SC";"GAROPABA";328;33;61;422
2019;"GARUVA (SC)";"SC";"GARUVA";629;31;55;715
2019;"GASPAR (SC)";"SC";"GASPAR";1489;73;82;1644
2019;"GOVERNADOR CELSO RAMOS (SC)";"SC";"GOVERNADOR CELSO RAMOS";214;30;19;263
2019;"GRAO PARA (SC)";"SC";"GRAO PARA";288;5;21;314
2019;"GRAVATAL (SC)";"SC";"GRAVATAL";347;20;21;388
2019;"GUABIRUBA (SC)";"SC";"GUABIRUBA";358;25;27;410
2019;"GUARACIABA (SC)";"SC";"GUARACIABA";281;15;41;337
2019;"GUARAMIRIM (SC)";"SC";"GUARAMIRIM";1152;37;27;1216
2019;"GUARUJA DO SUL (SC)";"SC";"GUARUJA DO SUL";177;13;26;216
2019;"GUATAMBU (SC)";"SC";"GUATAMBU";176;19;27;222
2019;"HERVAL D OESTE (SC)";"SC";"HERVAL D OESTE";410;46;69;525
2019;"IBIAM (SC)";"SC";"IBIAM";78;6;14;98
2019;"IBICARE (SC)";"SC";"IBICARE";173;12;10;195
2019;"IBIRAMA (SC)";"SC";"IBIRAMA";499;70;98;667
2019;"ICARA (SC)";"SC";"ICARA";1979;107;164;2250
2019;"ILHOTA (SC)";"SC";"ILHOTA";420;29;32;481
2019;"IMARUI (SC)";"SC";"IMARUI";180;31;34;245
2019;"IMBITUBA (SC)";"SC";"IMBITUBA";791;87;105;983
2019;"IMBUIA (SC)";"SC";"IMBUIA";204;8;21;233
2019;"INDAIAL (SC)";"SC";"INDAIAL";1685;106;140;1931
2019;"IOMERE (SC)";"SC";"IOMERE";178;6;9;193
2019;"IPIRA (SC)";"SC";"IPIRA";138;7;21;166
2019;"IPORA DO OESTE (SC)";"SC";"IPORA DO OESTE";306;35;49;390
2019;"IPUACU (SC)";"SC";"IPUACU";134;10;45;189
2019;"IPUMIRIM (SC)";"SC";"IPUMIRIM";304;52;32;388
2019;"IRACEMINHA (SC)";"SC";"IRACEMINHA";132;8;24;164
2019;"IRANI (SC)";"SC";"IRANI";418;29;70;517
2019;"IRATI (SC)";"SC";"IRATI";51;7;8;66
2019;"IRINEOPOLIS (SC)";"SC";"IRINEOPOLIS";311;15;19;345
2019;"ITA (SC)";"SC";"ITA";121;17;45;183
2019;"ITAIOPOLIS (SC)";"SC";"ITAIOPOLIS";717;35;109;861
2019;"ITAJAI (SC)";"SC";"ITAJAI";4846;306;421;5573
2019;"ITAPEMA (SC)";"SC";"ITAPEMA";701;74;60;835
2019;"ITAPIRANGA (SC)";"SC";"ITAPIRANGA";410;29;87;526
2019;"ITAPOA (SC)";"SC";"ITAPOA";327;31;30;388
2019;"ITUPORANGA (SC)";"SC";"ITUPORANGA";782;34;77;893
2019;"JABORA (SC)";"SC";"JABORA";157;15;27;199
2019;"JACINTO MACHADO (SC)";"SC";"JACINTO MACHADO";471;13;44;528
2019;"JAGUARUNA (SC)";"SC";"JAGUARUNA";518;23;84;625
2019;"JARAGUA DO SUL (SC)";"SC";"JARAGUA DO SUL";2765;245;461;3471
2019;"JARDINOPOLIS (SC)";"SC";"JARDINOPOLIS";29;8;8;45
2019;"JOACABA (SC)";"SC";"JOACABA";870;62;51;983
2019;"JOINVILLE (SC)";"SC";"JOINVILLE";8460;826;908;10194
2019;"JOSE BOITEUX (SC)";"SC";"JOSE BOITEUX";129;25;12;166
2019;"JUPIA (SC)";"SC";"JUPIA";59;5;11;75
2019;"LACERDOPOLIS (SC)";"SC";"LACERDOPOLIS";135;5;8;148
2019;"LAGEADO GRANDE (SC)";"SC";"LAGEADO GRANDE";45;1;4;50
2019;"LAGES (SC)";"SC";"LAGES";3651;296;407;4354
2019;"LAGUNA (SC)";"SC";"LAGUNA";568;130;97;795
2019;"LAURENTINO (SC)";"SC";"LAURENTINO";338;7;9;354
2019;"LAURO MULLER (SC)";"SC";"LAURO MULLER";480;30;53;563
2019;"LEBON REGIS (SC)";"SC";"LEBON REGIS";296;27;72;395
2019;"LEOBERTO LEAL (SC)";"SC";"LEOBERTO LEAL";131;13;5;149
2019;"LINDOIA DO SUL (SC)";"SC";"LINDOIA DO SUL";145;15;44;204
2019;"LONTRAS (SC)";"SC";"LONTRAS";383;23;42;448
2019;"LUIZ ALVES (SC)";"SC";"LUIZ ALVES";508;20;29;557
2019;"LUZERNA (SC)";"SC";"LUZERNA";162;15;24;201
2019;"MACIEIRA (SC)";"SC";"MACIEIRA";109;8;14;131
2019;"MAFRA (SC)";"SC";"MAFRA";1513;109;162;1784
2019;"MAJOR GERCINO (SC)";"SC";"MAJOR GERCINO";139;7;10;156
2019;"MAJOR VIEIRA (SC)";"SC";"MAJOR VIEIRA";226;3;18;247
2019;"MARACAJA (SC)";"SC";"MARACAJA";263;5;17;285
2019;"MARAVILHA (SC)";"SC";"MARAVILHA";904;34;90;1028
2019;"MAREMA (SC)";"SC";"MAREMA";68;7;9;84
2019;"MASSARANDUBA (SC)";"SC";"MASSARANDUBA";618;33;41;692
2019;"MATOS COSTA (SC)";"SC";"MATOS COSTA";76;7;21;104
2019;"MELEIRO (SC)";"SC";"MELEIRO";271;11;24;306
2019;"MIRIM DOCE (SC)";"SC";"MIRIM DOCE";85;5;13;103
2019;"MODELO (SC)";"SC";"MODELO";140;12;10;162
2019;"MONDAI (SC)";"SC";"MONDAI";199;15;63;277
2019;"MONTE CARLO (SC)";"SC";"MONTE CARLO";189;22;105;316
2019;"MONTE CASTELO (SC)";"SC";"MONTE CASTELO";201;18;29;248
2019;"MORRO DA FUMACA (SC)";"SC";"MORRO DA FUMACA";879;31;47;957
2019;"MORRO GRANDE (SC)";"SC";"MORRO GRANDE";151;4;12;167
2019;"NAVEGANTES (SC)";"SC";"NAVEGANTES";986;134;77;1197
2019;"NOVA ERECHIM (SC)";"SC";"NOVA ERECHIM";151;6;13;170
2019;"NOVA ITABERABA (SC)";"SC";"NOVA ITABERABA";121;5;15;141
2019;"NOVA TRENTO (SC)";"SC";"NOVA TRENTO";315;56;43;414
2019;"NOVA VENEZA (SC)";"SC";"NOVA VENEZA";464;37;45;546
2019;"NOVO HORIZONTE (SC)";"SC";"NOVO HORIZONTE";72;13;18;103
2019;"ORLEANS (SC)";"SC";"ORLEANS";955;47;56;1058
2019;"OTACILIO COSTA (SC)";"SC";"OTACILIO COSTA";546;52;70;668
2019;"OURO (SC)";"SC";"OURO";261;32;32;325
2019;"OURO VERDE (SC)";"SC";"OURO VERDE";96;3;7;106
2019;"PAIAL (SC)";"SC";"PAIAL";26;3;10;39
2019;"PAINEL (SC)";"SC";"PAINEL";47;5;10;62
2019;"PALHOCA (SC)";"SC";"PALHOCA";2781;215;411;3407
2019;"PALMA SOLA (SC)";"SC";"PALMA SOLA";228;11;37;276
2019;"PALMEIRA (SC)";"SC";"PALMEIRA";131;7;6;144
2019;"PALMITOS (SC)";"SC";"PALMITOS";449;58;71;578
2019;"PAPANDUVA (SC)";"SC";"PAPANDUVA";578;15;103;696
2019;"PARAISO (SC)";"SC";"PARAISO";114;7;14;135
2019;"PASSO DE TORRES (SC)";"SC";"PASSO DE TORRES";192;15;30;237
2019;"PASSOS MAIA (SC)";"SC";"PASSOS MAIA";136;9;61;206
2019;"PAULO LOPES (SC)";"SC";"PAULO LOPES";270;20;56;346
2019;"PEDRAS GRANDES (SC)";"SC";"PEDRAS GRANDES";258;27;18;303
2019;"PENHA (SC)";"SC";"PENHA";439;60;63;562
2019;"PERITIBA (SC)";"SC";"PERITIBA";115;6;16;137
2019;"PESCARIA BRAVA (SC)";"SC";"PESCARIA BRAVA";152;6;8;166
2019;"PETROLANDIA (SC)";"SC";"PETROLANDIA";205;9;25;239
2019;"PINHALZINHO (SC)";"SC";"PINHALZINHO";568;24;68;660
2019;"PINHEIRO PRETO (SC)";"SC";"PINHEIRO PRETO";331;12;15;358
2019;"PIRATUBA (SC)";"SC";"PIRATUBA";126;11;34;171
2019;"PLANALTO ALEGRE (SC)";"SC";"PLANALTO ALEGRE";82;7;8;97
2019;"POMERODE (SC)";"SC";"POMERODE";682;39;92;813
2019;"PONTE ALTA (SC)";"SC";"PONTE ALTA";162;15;17;194
2019;"PONTE ALTA DO NORTE (SC)";"SC";"PONTE ALTA DO NORTE";111;8;11;130
2019;"PONTE SERRADA (SC)";"SC";"PONTE SERRADA";368;49;126;543
2019;"PORTO BELO (SC)";"SC";"PORTO BELO";331;47;39;417
2019;"PORTO UNIAO (SC)";"SC";"PORTO UNIAO";785;44;47;876
2019;"POUSO REDONDO (SC)";"SC";"POUSO REDONDO";537;25;49;611
2019;"PRAIA GRANDE (SC)";"SC";"PRAIA GRANDE";286;15;30;331
2019;"PRESIDENTE CASTELO BRANCO (SC)";"SC";"PRESIDENTE CASTELO BRANCO";84;5;8;97
2019;"PRESIDENTE GETULIO (SC)";"SC";"PRESIDENTE GETULIO";397;54;61;512
2019;"PRESIDENTE NEREU (SC)";"SC";"PRESIDENTE NEREU";48;7;8;63
2019;"PRINCESA (SC)";"SC";"PRINCESA";71;2;13;86
2019;"QUILOMBO (SC)";"SC";"QUILOMBO";252;35;55;342
2019;"RANCHO QUEIMADO (SC)";"SC";"RANCHO QUEIMADO";171;6;8;185
2019;"RIO DAS ANTAS (SC)";"SC";"RIO DAS ANTAS";211;9;37;257
2019;"RIO DO CAMPO (SC)";"SC";"RIO DO CAMPO";204;17;20;241
2019;"RIO DO OESTE (SC)";"SC";"RIO DO OESTE";231;16;23;270
2019;"RIO DO SUL (SC)";"SC";"RIO DO SUL";1465;85;122;1672
2019;"RIO DOS CEDROS (SC)";"SC";"RIO DOS CEDROS";306;29;38;373
2019;"RIO FORTUNA (SC)";"SC";"RIO FORTUNA";293;11;19;323
2019;"RIO NEGRINHO (SC)";"SC";"RIO NEGRINHO";1150;77;115;1342
2019;"RIO RUFINO (SC)";"SC";"RIO RUFINO";63;8;22;93
2019;"RIQUEZA (SC)";"SC";"RIQUEZA";153;6;31;190
2019;"RODEIO (SC)";"SC";"RODEIO";307;21;30;358
2019;"ROMELANDIA (SC)";"SC";"ROMELANDIA";106;5;31;142
2019;"SALETE (SC)";"SC";"SALETE";205;9;26;240
2019;"SALTINHO (SC)";"SC";"SALTINHO";72;6;27;105
2019;"SALTO VELOSO (SC)";"SC";"SALTO VELOSO";177;12;10;199
2019;"SANGAO (SC)";"SC";"SANGAO";505;19;19;543
2019;"SANTA CECILIA (SC)";"SC";"SANTA CECILIA";544;46;76;666
2019;"SANTA HELENA (SC)";"SC";"SANTA HELENA";72;18;15;105
2019;"SANTA ROSA DE LIMA (SC)";"SC";"SANTA ROSA DE LIMA";139;5;12;156
2019;"SANTA ROSA DO SUL (SC)";"SC";"SANTA ROSA DO SUL";311;14;32;357
2019;"SANTA TEREZINHA (SC)";"SC";"SANTA TEREZINHA";218;15;32;265
2019;"SANTA TEREZINHA DO PROGRESSO (SC)";"SC";"SANTA TEREZINHA DO PROGRESSO";54;5;19;78
2019;"SANTIAGO DO SUL (SC)";"SC";"SANTIAGO DO SUL";74;8;5;87
2019;"SANTO AMARO DA IMPERATRIZ (SC)";"SC";"SANTO AMARO DA IMPERATRIZ";723;30;79;832
2019;"SAO BENTO DO SUL (SC)";"SC";"SAO BENTO DO SUL";1768;168;205;2141
2019;"SAO BERNARDINO (SC)";"SC";"SAO BERNARDINO";62;6;24;92
2019;"SAO BONIFACIO (SC)";"SC";"SAO BONIFACIO";154;10;11;175
2019;"SAO CARLOS (SC)";"SC";"SAO CARLOS";242;20;55;317
2019;"SAO CRISTOVAO DO SUL (SC)";"SC";"SAO CRISTOVAO DO SUL";310;6;17;333
2019;"SAO DOMINGOS (SC)";"SC";"SAO DOMINGOS";388;28;69;485
2019;"SAO FRANCISCO DO SUL (SC)";"SC";"SAO FRANCISCO DO SUL";799;73;94;966
2019;"SAO JOAO BATISTA (SC)";"SC";"SAO JOAO BATISTA";647;40;63;750
2019;"SAO JOAO DO ITAPERIU (SC)";"SC";"SAO JOAO DO ITAPERIU";276;8;13;297
2019;"SAO JOAO DO OESTE (SC)";"SC";"SAO JOAO DO OESTE";201;15;25;241
2019;"SAO JOAO DO SUL (SC)";"SC";"SAO JOAO DO SUL";247;7;22;276
2019;"SAO JOAQUIM (SC)";"SC";"SAO JOAQUIM";1210;126;263;1599
2019;"SAO JOSE (SC)";"SC";"SAO JOSE";3584;274;239;4097
2019;"SAO JOSE DO CEDRO (SC)";"SC";"SAO JOSE DO CEDRO";441;22;71;534
2019;"SAO JOSE DO CERRITO (SC)";"SC";"SAO JOSE DO CERRITO";255;17;67;339
2019;"SAO LOURENCO D OESTE (SC)";"SC";"SAO LOURENCO D OESTE";903;53;104;1060
2019;"SAO LUDGERO (SC)";"SC";"SAO LUDGERO";683;17;29;729
2019;"SAO MARTINHO (SC)";"SC";"SAO MARTINHO";165;7;6;178
2019;"SAO MIGUEL D OESTE (SC)";"SC";"SAO MIGUEL D OESTE";1140;78;128;1346
2019;"SAO MIGUEL DA BOA VISTA (SC)";"SC";"SAO MIGUEL DA BOA VISTA";33;3;9;45
2019;"SAO PEDRO DE ALCANTARA (SC)";"SC";"SAO PEDRO DE ALCANTARA";158;7;6;171
2019;"SAUDADES (SC)";"SC";"SAUDADES";285;15;46;346
2019;"SCHROEDER (SC)";"SC";"SCHROEDER";270;21;31;322
2019;"SEARA (SC)";"SC";"SEARA";422;65;122;609
2019;"SERRA ALTA (SC)";"SC";"SERRA ALTA";72;9;16;97
2019;"SIDEROPOLIS (SC)";"SC";"SIDEROPOLIS";444;26;74;544
2019;"SOMBRIO (SC)";"SC";"SOMBRIO";860;81;99;1040
2019;"SUL BRASIL (SC)";"SC";"SUL BRASIL";66;5;15;86
2019;"TAIO (SC)";"SC";"TAIO";641;24;74;739
2019;"TANGARA (SC)";"SC";"TANGARA";446;18;59;523
2019;"TIGRINHOS (SC)";"SC";"TIGRINHOS";34;3;13;50
2019;"TIJUCAS (SC)";"SC";"TIJUCAS";1134;69;71;1274
2019;"TIMBE DO SUL (SC)";"SC";"TIMBE DO SUL";178;12;23;213
2019;"TIMBO (SC)";"SC";"TIMBO";781;68;56;905
2019;"TIMBO GRANDE (SC)";"SC";"TIMBO GRANDE";207;13;37;257
2019;"TRES BARRAS (SC)";"SC";"TRES BARRAS";335;39;78;452
2019;"TREVISO (SC)";"SC";"TREVISO";122;12;8;142
2019;"TREZE DE MAIO (SC)";"SC";"TREZE DE MAIO";426;17;26;469
2019;"TREZE TILIAS (SC)";"SC";"TREZE TILIAS";374;22;55;451
2019;"TROMBUDO CENTRAL (SC)";"SC";"TROMBUDO CENTRAL";250;18;28;296
2019;"TUBARAO (SC)";"SC";"TUBARAO";2506;122;318;2946
2019;"TUNAPOLIS (SC)";"SC";"TUNAPOLIS";110;14;25;149
2019;"TURVO (SC)";"SC";"TURVO";532;27;46;605
2019;"UNIAO DO OESTE (SC)";"SC";"UNIAO DO OESTE";65;7;19;91
2019;"URUBICI (SC)";"SC";"URUBICI";298;31;54;383
2019;"URUPEMA (SC)";"SC";"URUPEMA";88;17;10;115
2019;"URUSSANGA (SC)";"SC";"URUSSANGA";541;43;87;671
2019;"VARGEAO (SC)";"SC";"VARGEAO";174;4;15;193
2019;"VARGEM (SC)";"SC";"VARGEM";72;1;17;90
2019;"VARGEM BONITA (SC)";"SC";"VARGEM BONITA";205;14;23;242
2019;"VIDAL RAMOS (SC)";"SC";"VIDAL RAMOS";198;16;18;232
2019;"VIDEIRA (SC)";"SC";"VIDEIRA";1868;136;176;2180
2019;"VITOR MEIRELES (SC)";"SC";"VITOR MEIRELES";107;16;24;147
2019;"WITMARSUM (SC)";"SC";"WITMARSUM";136;10;15;161
2019;"XANXERE (SC)";"SC";"XANXERE";1378;140;135;1653
2019;"XAVANTINA (SC)";"SC";"XAVANTINA";134;19;11;164
2019;"XAXIM (SC)";"SC";"XAXIM";818;79;163;1060
2019;"ZORTEA (SC)";"SC";"ZORTEA";50;16;8;74
2019;"AMPARO DE SAO FRANCISCO (SE)";"SE";"AMPARO DE SAO FRANCISCO";9;12;3;24
2019;"AQUIDABA (SE)";"SE";"AQUIDABA";135;20;56;211
2019;"ARACAJU (SE)";"SE";"ARACAJU";5973;1069;2552;9594
2019;"ARAUA (SE)";"SE";"ARAUA";52;20;26;98
2019;"AREIA BRANCA (SE)";"SE";"AREIA BRANCA";170;26;23;219
2019;"BARRA DOS COQUEIROS (SE)";"SE";"BARRA DOS COQUEIROS";90;54;50;194
2019;"BOQUIM (SE)";"SE";"BOQUIM";220;26;59;305
2019;"BREJO GRANDE (SE)";"SE";"BREJO GRANDE";8;7;15;30
2019;"CAMPO DO BRITO (SE)";"SE";"CAMPO DO BRITO";551;13;83;647
2019;"CANHOBA (SE)";"SE";"CANHOBA";8;4;7;19
2019;"CANINDE DE SAO FRANCISCO (SE)";"SE";"CANINDE DE SAO FRANCISCO";208;99;32;339
2019;"CAPELA (SE)";"SE";"CAPELA";149;37;72;258
2019;"CARIRA (SE)";"SE";"CARIRA";310;32;117;459
2019;"CARMOPOLIS (SE)";"SE";"CARMOPOLIS";110;37;30;177
2019;"CEDRO DE SAO JOAO (SE)";"SE";"CEDRO DE SAO JOAO";22;5;5;32
2019;"CRISTINAPOLIS (SE)";"SE";"CRISTINAPOLIS";114;23;45;182
2019;"CUMBE (SE)";"SE";"CUMBE";31;11;15;57
2019;"DIVINA PASTORA (SE)";"SE";"DIVINA PASTORA";9;8;10;27
2019;"ESTANCIA (SE)";"SE";"ESTANCIA";590;209;326;1125
2019;"FEIRA NOVA (SE)";"SE";"FEIRA NOVA";21;13;8;42
2019;"FREI PAULO (SE)";"SE";"FREI PAULO";155;17;41;213
2019;"GARARU (SE)";"SE";"GARARU";53;14;32;99
2019;"GENERAL MAYNARD (SE)";"SE";"GENERAL MAYNARD";13;11;11;35
2019;"GRACCHO CARDOSO (SE)";"SE";"GRACCHO CARDOSO";22;9;10;41
2019;"ILHA DAS FLORES (SE)";"SE";"ILHA DAS FLORES";18;12;15;45
2019;"INDIAROBA (SE)";"SE";"INDIAROBA";40;22;24;86
2019;"ITABAIANA (SE)";"SE";"ITABAIANA";3439;141;214;3794
2019;"ITABAIANINHA (SE)";"SE";"ITABAIANINHA";592;77;82;751
2019;"ITABI (SE)";"SE";"ITABI";26;4;9;39
2019;"ITAPORANGA D AJUDA (SE)";"SE";"ITAPORANGA D AJUDA";335;40;85;460
2019;"JAPARATUBA (SE)";"SE";"JAPARATUBA";67;28;81;176
2019;"JAPOATA (SE)";"SE";"JAPOATA";62;15;49;126
2019;"LAGARTO (SE)";"SE";"LAGARTO";1188;149;268;1605
2019;"LARANJEIRAS (SE)";"SE";"LARANJEIRAS";137;55;41;233
2019;"MACAMBIRA (SE)";"SE";"MACAMBIRA";58;6;22;86
2019;"MALHADA DOS BOIS (SE)";"SE";"MALHADA DOS BOIS";24;4;13;41
2019;"MALHADOR (SE)";"SE";"MALHADOR";222;25;61;308
2019;"MARUIM (SE)";"SE";"MARUIM";46;32;41;119
2019;"MOITA BONITA (SE)";"SE";"MOITA BONITA";512;18;21;551
2019;"MONTE ALEGRE DE SERGIPE (SE)";"SE";"MONTE ALEGRE DE SERGIPE";170;44;50;264
2019;"MURIBECA (SE)";"SE";"MURIBECA";39;7;40;86
2019;"NEOPOLIS (SE)";"SE";"NEOPOLIS";54;21;36;111
2019;"NOSSA SENHORA APARECIDA (SE)";"SE";"NOSSA SENHORA APARECIDA";152;23;22;197
2019;"NOSSA SENHORA DA GLORIA (SE)";"SE";"NOSSA SENHORA DA GLORIA";549;69;246;864
2019;"NOSSA SENHORA DAS DORES (SE)";"SE";"NOSSA SENHORA DAS DORES";254;42;159;455
2019;"NOSSA SENHORA DE LOURDES (SE)";"SE";"NOSSA SENHORA DE LOURDES";29;5;13;47
2019;"NOSSA SENHORA DO SOCORRO (SE)";"SE";"NOSSA SENHORA DO SOCORRO";1114;131;244;1489
2019;"PACATUBA (SE)";"SE";"PACATUBA";419;12;62;493
2019;"PEDRA MOLE (SE)";"SE";"PEDRA MOLE";9;3;7;19
2019;"PEDRINHAS (SE)";"SE";"PEDRINHAS";68;6;13;87
2019;"PINHAO (SE)";"SE";"PINHAO";22;16;11;49
2019;"PIRAMBU (SE)";"SE";"PIRAMBU";33;8;27;68
2019;"POCO REDONDO (SE)";"SE";"POCO REDONDO";182;64;74;320
2019;"POCO VERDE (SE)";"SE";"POCO VERDE";138;51;129;318
2019;"PORTO DA FOLHA (SE)";"SE";"PORTO DA FOLHA";140;42;40;222
2019;"PROPRIA (SE)";"SE";"PROPRIA";258;26;67;351
2019;"RIACHAO DO DANTAS (SE)";"SE";"RIACHAO DO DANTAS";34;5;21;60
2019;"RIACHUELO (SE)";"SE";"RIACHUELO";43;14;10;67
2019;"RIBEIROPOLIS (SE)";"SE";"RIBEIROPOLIS";284;45;77;406
2019;"ROSARIO DO CATETE (SE)";"SE";"ROSARIO DO CATETE";46;22;18;86
2019;"SALGADO (SE)";"SE";"SALGADO";145;20;157;322
2019;"SANTA LUZIA DO ITANHY (SE)";"SE";"SANTA LUZIA DO ITANHY";30;18;32;80
2019;"SANTA ROSA DE LIMA (SE)";"SE";"SANTA ROSA DE LIMA";25;6;10;41
2019;"SANTANA DO SAO FRANCISCO (SE)";"SE";"SANTANA DO SAO FRANCISCO";13;6;11;30
2019;"SANTO AMARO DAS BROTAS (SE)";"SE";"SANTO AMARO DAS BROTAS";24;6;20;50
2019;"SAO CRISTOVAO (SE)";"SE";"SAO CRISTOVAO";462;147;324;933
2019;"SAO DOMINGOS (SE)";"SE";"SAO DOMINGOS";159;11;27;197
2019;"SAO FRANCISCO (SE)";"SE";"SAO FRANCISCO";25;3;29;57
2019;"SAO MIGUEL DO ALEIXO (SE)";"SE";"SAO MIGUEL DO ALEIXO";45;3;7;55
2019;"SIMAO DIAS (SE)";"SE";"SIMAO DIAS";283;51;334;668
2019;"SIRIRI (SE)";"SE";"SIRIRI";36;10;138;184
2019;"TELHA (SE)";"SE";"TELHA";20;11;7;38
2019;"TOBIAS BARRETO (SE)";"SE";"TOBIAS BARRETO";373;101;280;754
2019;"TOMAR DO GERU (SE)";"SE";"TOMAR DO GERU";61;9;19;89
2019;"UMBAUBA (SE)";"SE";"UMBAUBA";321;48;49;418
2019;"ADAMANTINA (SP)";"SP";"ADAMANTINA";754;69;88;911
2019;"ADOLFO (SP)";"SP";"ADOLFO";65;4;28;97
2019;"AGUAI (SP)";"SP";"AGUAI";966;83;220;1269
2019;"AGUAS DA PRATA (SP)";"SP";"AGUAS DA PRATA";132;25;15;172
2019;"AGUAS DE LINDOIA (SP)";"SP";"AGUAS DE LINDOIA";201;85;104;390
2019;"AGUAS DE SANTA BARBARA (SP)";"SP";"AGUAS DE SANTA BARBARA";143;39;36;218
2019;"AGUAS DE SAO PEDRO (SP)";"SP";"AGUAS DE SAO PEDRO";43;9;6;58
2019;"AGUDOS (SP)";"SP";"AGUDOS";589;138;120;847
2019;"ALAMBARI (SP)";"SP";"ALAMBARI";102;18;9;129
2019;"ALFREDO MARCONDES (SP)";"SP";"ALFREDO MARCONDES";76;14;8;98
2019;"ALTAIR (SP)";"SP";"ALTAIR";72;7;37;116
2019;"ALTINOPOLIS (SP)";"SP";"ALTINOPOLIS";420;58;126;604
2019;"ALTO ALEGRE (SP)";"SP";"ALTO ALEGRE";104;5;44;153
2019;"ALUMINIO (SP)";"SP";"ALUMINIO";258;59;56;373
2019;"ALVARES FLORENCE (SP)";"SP";"ALVARES FLORENCE";58;6;18;82
2019;"ALVARES MACHADO (SP)";"SP";"ALVARES MACHADO";522;39;35;596
2019;"ALVARO DE CARVALHO (SP)";"SP";"ALVARO DE CARVALHO";37;8;28;73
2019;"ALVINLANDIA (SP)";"SP";"ALVINLANDIA";50;7;16;73
2019;"AMERICANA (SP)";"SP";"AMERICANA";3479;561;577;4617
2019;"AMERICO BRASILIENSE (SP)";"SP";"AMERICO BRASILIENSE";715;78;220;1013
2019;"AMERICO DE CAMPOS (SP)";"SP";"AMERICO DE CAMPOS";134;17;36;187
2019;"AMPARO (SP)";"SP";"AMPARO";1460;245;154;1859
2019;"ANALANDIA (SP)";"SP";"ANALANDIA";96;20;18;134
2019;"ANDRADINA (SP)";"SP";"ANDRADINA";1217;120;179;1516
2019;"ANGATUBA (SP)";"SP";"ANGATUBA";433;76;126;635
2019;"ANHEMBI (SP)";"SP";"ANHEMBI";108;31;31;170
2019;"ANHUMAS (SP)";"SP";"ANHUMAS";81;16;9;106
2019;"APARECIDA (SP)";"SP";"APARECIDA";765;101;539;1405
2019;"APARECIDA D OESTE (SP)";"SP";"APARECIDA D OESTE";122;13;33;168
2019;"APIAI (SP)";"SP";"APIAI";419;72;104;595
2019;"ARACARIGUAMA (SP)";"SP";"ARACARIGUAMA";558;70;59;687
2019;"ARACATUBA (SP)";"SP";"ARACATUBA";3628;331;842;4801
2019;"ARACOIABA DA SERRA (SP)";"SP";"ARACOIABA DA SERRA";596;138;35;769
2019;"ARAMINA (SP)";"SP";"ARAMINA";94;15;30;139
2019;"ARANDU (SP)";"SP";"ARANDU";74;15;31;120
2019;"ARAPEI (SP)";"SP";"ARAPEI";45;11;11;67
2019;"ARARAQUARA (SP)";"SP";"ARARAQUARA";3974;499;1199;5672
2019;"ARARAS (SP)";"SP";"ARARAS";2429;348;386;3163
2019;"ARCO IRIS (SP)";"SP";"ARCO IRIS";75;4;11;90
2019;"AREALVA (SP)";"SP";"AREALVA";200;26;36;262
2019;"AREIAS (SP)";"SP";"AREIAS";57;3;8;68
2019;"AREIOPOLIS (SP)";"SP";"AREIOPOLIS";178;38;156;372
2019;"ARIRANHA (SP)";"SP";"ARIRANHA";275;26;184;485
2019;"ARTUR NOGUEIRA (SP)";"SP";"ARTUR NOGUEIRA";1105;131;191;1427
2019;"ARUJA (SP)";"SP";"ARUJA";2899;291;417;3607
2019;"ASPASIA (SP)";"SP";"ASPASIA";22;7;5;34
2019;"ASSIS (SP)";"SP";"ASSIS";2003;206;408;2617
2019;"ATIBAIA (SP)";"SP";"ATIBAIA";2626;432;367;3425
2019;"AURIFLAMA (SP)";"SP";"AURIFLAMA";377;33;61;471
2019;"AVAI (SP)";"SP";"AVAI";95;20;28;143
2019;"AVANHANDAVA (SP)";"SP";"AVANHANDAVA";184;11;75;270
2019;"AVARE (SP)";"SP";"AVARE";1479;157;297;1933
2019;"BADY BASSITT (SP)";"SP";"BADY BASSITT";408;33;70;511
2019;"BALBINOS (SP)";"SP";"BALBINOS";25;2;7;34
2019;"BALSAMO (SP)";"SP";"BALSAMO";239;10;25;274
2019;"BANANAL (SP)";"SP";"BANANAL";210;22;41;273
2019;"BARAO DE ANTONINA (SP)";"SP";"BARAO DE ANTONINA";34;8;14;56
2019;"BARBOSA (SP)";"SP";"BARBOSA";121;9;46;176
2019;"BARIRI (SP)";"SP";"BARIRI";906;70;99;1075
2019;"BARRA BONITA (SP)";"SP";"BARRA BONITA";1024;88;257;1369
2019;"BARRA DO CHAPEU (SP)";"SP";"BARRA DO CHAPEU";69;13;20;102
2019;"BARRA DO TURVO (SP)";"SP";"BARRA DO TURVO";79;25;62;166
2019;"BARRETOS (SP)";"SP";"BARRETOS";2272;266;539;3077
2019;"BARRINHA (SP)";"SP";"BARRINHA";520;78;220;818
2019;"BARUERI (SP)";"SP";"BARUERI";6178;923;1267;8368
2019;"BASTOS (SP)";"SP";"BASTOS";969;45;119;1133
2019;"BATATAIS (SP)";"SP";"BATATAIS";1267;143;203;1613
2019;"BAURU (SP)";"SP";"BAURU";6203;534;1367;8104
2019;"BEBEDOURO (SP)";"SP";"BEBEDOURO";1772;184;344;2300
2019;"BENTO DE ABREU (SP)";"SP";"BENTO DE ABREU";64;12;15;91
2019;"BERNARDINO DE CAMPOS (SP)";"SP";"BERNARDINO DE CAMPOS";394;37;44;475
2019;"BERTIOGA (SP)";"SP";"BERTIOGA";541;84;103;728
2019;"BILAC (SP)";"SP";"BILAC";171;5;24;200
2019;"BIRIGUI (SP)";"SP";"BIRIGUI";1942;155;183;2280
2019;"BIRITIBA MIRIM (SP)";"SP";"BIRITIBA MIRIM";473;61;50;584
2019;"BOA ESPERANCA DO SUL (SP)";"SP";"BOA ESPERANCA DO SUL";355;42;118;515
2019;"BOCAINA (SP)";"SP";"BOCAINA";192;47;43;282
2019;"BOFETE (SP)";"SP";"BOFETE";239;64;58;361
2019;"BOITUVA (SP)";"SP";"BOITUVA";1787;196;157;2140
2019;"BOM JESUS DOS PERDOES (SP)";"SP";"BOM JESUS DOS PERDOES";593;86;70;749
2019;"BOM SUCESSO DE ITARARE (SP)";"SP";"BOM SUCESSO DE ITARARE";86;9;16;111
2019;"BORA (SP)";"SP";"BORA";43;4;9;56
2019;"BORACEIA (SP)";"SP";"BORACEIA";212;14;21;247
2019;"BORBOREMA (SP)";"SP";"BORBOREMA";430;45;119;594
2019;"BOREBI (SP)";"SP";"BOREBI";54;8;7;69
2019;"BOTUCATU (SP)";"SP";"BOTUCATU";1907;402;475;2784
2019;"BRAGANCA PAULISTA (SP)";"SP";"BRAGANCA PAULISTA";3093;461;405;3959
2019;"BRAUNA (SP)";"SP";"BRAUNA";84;12;86;182
2019;"BREJO ALEGRE (SP)";"SP";"BREJO ALEGRE";165;0;19;184
2019;"BRODOWSKI (SP)";"SP";"BRODOWSKI";670;45;66;781
2019;"BROTAS (SP)";"SP";"BROTAS";542;66;222;830
2019;"BURI (SP)";"SP";"BURI";542;50;108;700
2019;"BURITAMA (SP)";"SP";"BURITAMA";384;39;83;506
2019;"BURITIZAL (SP)";"SP";"BURITIZAL";125;18;35;178
2019;"CABRALIA PAULISTA (SP)";"SP";"CABRALIA PAULISTA";146;10;19;175
2019;"CABREUVA (SP)";"SP";"CABREUVA";1043;154;69;1266
2019;"CACAPAVA (SP)";"SP";"CACAPAVA";1277;277;170;1724
2019;"CACHOEIRA PAULISTA (SP)";"SP";"CACHOEIRA PAULISTA";410;120;34;564
2019;"CACONDE (SP)";"SP";"CACONDE";296;86;77;459
2019;"CAFELANDIA (SP)";"SP";"CAFELANDIA";322;33;90;445
2019;"CAIABU (SP)";"SP";"CAIABU";41;9;42;92
2019;"CAIEIRAS (SP)";"SP";"CAIEIRAS";1080;303;445;1828
2019;"CAIUA (SP)";"SP";"CAIUA";60;16;25;101
2019;"CAJAMAR (SP)";"SP";"CAJAMAR";1638;263;380;2281
2019;"CAJATI (SP)";"SP";"CAJATI";687;99;230;1016
2019;"CAJOBI (SP)";"SP";"CAJOBI";260;12;106;378
2019;"CAJURU (SP)";"SP";"CAJURU";544;46;129;719
2019;"CAMPINA DO MONTE ALEGRE (SP)";"SP";"CAMPINA DO MONTE ALEGRE";100;20;35;155
2019;"CAMPINAS (SP)";"SP";"CAMPINAS";20392;3897;5748;30037
2019;"CAMPO LIMPO PAULISTA (SP)";"SP";"CAMPO LIMPO PAULISTA";726;127;65;918
2019;"CAMPOS DO JORDAO (SP)";"SP";"CAMPOS DO JORDAO";698;190;68;956
2019;"CAMPOS NOVOS PAULISTA (SP)";"SP";"CAMPOS NOVOS PAULISTA";123;6;47;176
2019;"CANANEIA (SP)";"SP";"CANANEIA";110;15;17;142
2019;"CANAS (SP)";"SP";"CANAS";152;11;9;172
2019;"CANDIDO MOTA (SP)";"SP";"CANDIDO MOTA";1084;77;83;1244
2019;"CANDIDO RODRIGUES (SP)";"SP";"CANDIDO RODRIGUES";122;13;14;149
2019;"CANITAR (SP)";"SP";"CANITAR";56;15;22;93
2019;"CAPAO BONITO (SP)";"SP";"CAPAO BONITO";1028;188;220;1436
2019;"CAPELA DO ALTO (SP)";"SP";"CAPELA DO ALTO";608;80;47;735
2019;"CAPIVARI (SP)";"SP";"CAPIVARI";1201;143;321;1665
2019;"CARAGUATATUBA (SP)";"SP";"CARAGUATATUBA";1669;195;138;2002
2019;"CARAPICUIBA (SP)";"SP";"CARAPICUIBA";4041;919;999;5959
2019;"CARDOSO (SP)";"SP";"CARDOSO";214;24;59;297
2019;"CASA BRANCA (SP)";"SP";"CASA BRANCA";617;70;117;804
2019;"CASSIA DOS COQUEIROS (SP)";"SP";"CASSIA DOS COQUEIROS";29;6;17;52
2019;"CASTILHO (SP)";"SP";"CASTILHO";259;37;120;416
2019;"CATANDUVA (SP)";"SP";"CATANDUVA";2905;308;510;3723
2019;"CATIGUA (SP)";"SP";"CATIGUA";81;10;33;124
2019;"CEDRAL (SP)";"SP";"CEDRAL";245;27;26;298
2019;"CERQUEIRA CESAR (SP)";"SP";"CERQUEIRA CESAR";431;53;165;649
2019;"CERQUILHO (SP)";"SP";"CERQUILHO";968;164;121;1253
2019;"CESARIO LANGE (SP)";"SP";"CESARIO LANGE";381;47;77;505
2019;"CHARQUEADA (SP)";"SP";"CHARQUEADA";446;49;98;593
2019;"CHAVANTES (SP)";"SP";"CHAVANTES";146;40;65;251
2019;"CLEMENTINA (SP)";"SP";"CLEMENTINA";317;13;64;394
2019;"COLINA (SP)";"SP";"COLINA";399;31;96;526
2019;"COLOMBIA (SP)";"SP";"COLOMBIA";154;33;73;260
2019;"CONCHAL (SP)";"SP";"CONCHAL";871;99;306;1276
2019;"CONCHAS (SP)";"SP";"CONCHAS";381;52;49;482
2019;"CORDEIROPOLIS (SP)";"SP";"CORDEIROPOLIS";777;85;63;925
2019;"COROADOS (SP)";"SP";"COROADOS";121;10;24;155
2019;"CORONEL MACEDO (SP)";"SP";"CORONEL MACEDO";75;12;25;112
2019;"CORUMBATAI (SP)";"SP";"CORUMBATAI";172;8;14;194
2019;"COSMOPOLIS (SP)";"SP";"COSMOPOLIS";874;287;226;1387
2019;"COSMORAMA (SP)";"SP";"COSMORAMA";230;15;50;295
2019;"COTIA (SP)";"SP";"COTIA";3253;826;847;4926
2019;"CRAVINHOS (SP)";"SP";"CRAVINHOS";978;65;181;1224
2019;"CRISTAIS PAULISTA (SP)";"SP";"CRISTAIS PAULISTA";153;16;33;202
2019;"CRUZALIA (SP)";"SP";"CRUZALIA";82;11;5;98
2019;"CRUZEIRO (SP)";"SP";"CRUZEIRO";794;207;61;1062
2019;"CUBATAO (SP)";"SP";"CUBATAO";2819;423;401;3643
2019;"CUNHA (SP)";"SP";"CUNHA";383;96;49;528
2019;"DESCALVADO (SP)";"SP";"DESCALVADO";1130;143;199;1472
2019;"DIADEMA (SP)";"SP";"DIADEMA";4450;674;649;5773
2019;"DIRCE REIS (SP)";"SP";"DIRCE REIS";74;9;8;91
2019;"DIVINOLANDIA (SP)";"SP";"DIVINOLANDIA";477;33;69;579
2019;"DOBRADA (SP)";"SP";"DOBRADA";80;23;92;195
2019;"DOIS CORREGOS (SP)";"SP";"DOIS CORREGOS";705;106;178;989
2019;"DOLCINOPOLIS (SP)";"SP";"DOLCINOPOLIS";34;7;12;53
2019;"DOURADO (SP)";"SP";"DOURADO";205;41;65;311
2019;"DRACENA (SP)";"SP";"DRACENA";1152;60;145;1357
2019;"DUARTINA (SP)";"SP";"DUARTINA";277;37;84;398
2019;"DUMONT (SP)";"SP";"DUMONT";408;11;59;478
2019;"ECHAPORA (SP)";"SP";"ECHAPORA";180;6;33;219
2019;"ELDORADO (SP)";"SP";"ELDORADO";301;34;67;402
2019;"ELIAS FAUSTO (SP)";"SP";"ELIAS FAUSTO";387;18;96;501
2019;"ELISIARIO (SP)";"SP";"ELISIARIO";55;8;11;74
2019;"EMBAUBA (SP)";"SP";"EMBAUBA";77;7;29;113
2019;"EMBU (SP)";"SP";"EMBU";2776;794;812;4382
2019;"EMBU GUACU (SP)";"SP";"EMBU GUACU";2313;282;381;2976
2019;"EMILIANOPOLIS (SP)";"SP";"EMILIANOPOLIS";54;8;15;77
2019;"ENGENHEIRO COELHO (SP)";"SP";"ENGENHEIRO COELHO";469;84;203;756
2019;"ESPIRITO SANTO DO PINHAL (SP)";"SP";"ESPIRITO SANTO DO PINHAL";677;137;94;908
2019;"ESPIRITO SANTO DO TURVO (SP)";"SP";"ESPIRITO SANTO DO TURVO";161;29;37;227
2019;"ESTIVA GERBI (SP)";"SP";"ESTIVA GERBI";279;29;32;340
2019;"ESTRELA D OESTE (SP)";"SP";"ESTRELA D OESTE";254;8;31;293
2019;"ESTRELA DO NORTE (SP)";"SP";"ESTRELA DO NORTE";31;0;9;40
2019;"EUCLIDES DA CUNHA PAULISTA (SP)";"SP";"EUCLIDES DA CUNHA PAULISTA";110;9;58;177
2019;"FARTURA (SP)";"SP";"FARTURA";359;49;49;457
2019;"FERNANDO PRESTES (SP)";"SP";"FERNANDO PRESTES";259;10;21;290
2019;"FERNANDOPOLIS (SP)";"SP";"FERNANDOPOLIS";1624;111;239;1974
2019;"FERNAO (SP)";"SP";"FERNAO";34;10;14;58
2019;"FERRAZ DE VASCONCELOS (SP)";"SP";"FERRAZ DE VASCONCELOS";2070;327;537;2934
2019;"FLORA RICA (SP)";"SP";"FLORA RICA";27;5;12;44
2019;"FLOREAL (SP)";"SP";"FLOREAL";66;10;8;84
2019;"FLORIDA PAULISTA (SP)";"SP";"FLORIDA PAULISTA";355;27;130;512
2019;"FLORINEA (SP)";"SP";"FLORINEA";54;7;10;71
2019;"FRANCA (SP)";"SP";"FRANCA";3975;467;718;5160
2019;"FRANCISCO MORATO (SP)";"SP";"FRANCISCO MORATO";600;278;238;1116
2019;"FRANCO DA ROCHA (SP)";"SP";"FRANCO DA ROCHA";1015;280;209;1504
2019;"GABRIEL MONTEIRO (SP)";"SP";"GABRIEL MONTEIRO";62;7;14;83
2019;"GALIA (SP)";"SP";"GALIA";167;29;48;244
2019;"GARCA (SP)";"SP";"GARCA";792;111;121;1024
2019;"GASTAO VIDIGAL (SP)";"SP";"GASTAO VIDIGAL";73;8;64;145
2019;"GAVIAO PEIXOTO (SP)";"SP";"GAVIAO PEIXOTO";77;16;30;123
2019;"GENERAL SALGADO (SP)";"SP";"GENERAL SALGADO";296;24;109;429
2019;"GETULINA (SP)";"SP";"GETULINA";134;13;78;225
2019;"GLICERIO (SP)";"SP";"GLICERIO";149;11;34;194
2019;"GUAICARA (SP)";"SP";"GUAICARA";126;18;36;180
2019;"GUAIMBE (SP)";"SP";"GUAIMBE";127;7;37;171
2019;"GUAIRA (SP)";"SP";"GUAIRA";1381;113;234;1728
2019;"GUAPIACU (SP)";"SP";"GUAPIACU";459;38;79;576
2019;"GUAPIARA (SP)";"SP";"GUAPIARA";418;51;66;535
2019;"GUARA (SP)";"SP";"GUARA";255;62;189;506
2019;"GUARACAI (SP)";"SP";"GUARACAI";298;24;34;356
2019;"GUARACI (SP)";"SP";"GUARACI";223;22;114;359
2019;"GUARANI D OESTE (SP)";"SP";"GUARANI D OESTE";36;5;8;49
2019;"GUARANTA (SP)";"SP";"GUARANTA";103;6;49;158
2019;"GUARARAPES (SP)";"SP";"GUARARAPES";709;71;157;937
2019;"GUARAREMA (SP)";"SP";"GUARAREMA";551;111;98;760
2019;"GUARATINGUETA (SP)";"SP";"GUARATINGUETA";1441;424;248;2113
2019;"GUAREI (SP)";"SP";"GUAREI";327;36;105;468
2019;"GUARIBA (SP)";"SP";"GUARIBA";859;80;331;1270
2019;"GUARUJA (SP)";"SP";"GUARUJA";2217;487;515;3219
2019;"GUARULHOS (SP)";"SP";"GUARULHOS";20801;4179;4117;29097
2019;"GUATAPARA (SP)";"SP";"GUATAPARA";198;18;64;280
2019;"GUZOLANDIA (SP)";"SP";"GUZOLANDIA";93;6;42;141
2019;"HERCULANDIA (SP)";"SP";"HERCULANDIA";521;12;34;567
2019;"HOLAMBRA (SP)";"SP";"HOLAMBRA";433;74;170;677
2019;"HORTOLANDIA (SP)";"SP";"HORTOLANDIA";2945;636;783;4364
2019;"IACANGA (SP)";"SP";"IACANGA";285;39;53;377
2019;"IACRI (SP)";"SP";"IACRI";166;10;22;198
2019;"IARAS (SP)";"SP";"IARAS";66;22;34;122
2019;"IBATE (SP)";"SP";"IBATE";648;145;291;1084
2019;"IBIRA (SP)";"SP";"IBIRA";182;27;55;264
2019;"IBIRAREMA (SP)";"SP";"IBIRAREMA";253;20;33;306
2019;"IBITINGA (SP)";"SP";"IBITINGA";976;123;236;1335
2019;"IBIUNA (SP)";"SP";"IBIUNA";2407;260;132;2799
2019;"ICEM (SP)";"SP";"ICEM";256;11;74;341
2019;"IEPE (SP)";"SP";"IEPE";204;16;37;257
2019;"IGARACU DO TIETE (SP)";"SP";"IGARACU DO TIETE";366;34;92;492
2019;"IGARAPAVA (SP)";"SP";"IGARAPAVA";476;67;137;680
2019;"IGARATA (SP)";"SP";"IGARATA";162;29;19;210
2019;"IGUAPE (SP)";"SP";"IGUAPE";260;49;123;432
2019;"ILHA COMPRIDA (SP)";"SP";"ILHA COMPRIDA";205;34;92;331
2019;"ILHA SOLTEIRA (SP)";"SP";"ILHA SOLTEIRA";285;33;96;414
2019;"ILHABELA (SP)";"SP";"ILHABELA";420;87;71;578
2019;"INDAIATUBA (SP)";"SP";"INDAIATUBA";3640;644;477;4761
2019;"INDIANA (SP)";"SP";"INDIANA";125;16;12;153
2019;"INDIAPORA (SP)";"SP";"INDIAPORA";77;5;19;101
2019;"INUBIA PAULISTA (SP)";"SP";"INUBIA PAULISTA";57;7;15;79
2019;"IPAUSSU (SP)";"SP";"IPAUSSU";210;28;64;302
2019;"IPERO (SP)";"SP";"IPERO";315;68;58;441
2019;"IPEUNA (SP)";"SP";"IPEUNA";189;36;45;270
2019;"IPIGUA (SP)";"SP";"IPIGUA";67;4;13;84
2019;"IPORANGA (SP)";"SP";"IPORANGA";34;19;9;62
2019;"IPUA (SP)";"SP";"IPUA";273;27;97;397
2019;"IRACEMAPOLIS (SP)";"SP";"IRACEMAPOLIS";576;68;110;754
2019;"IRAPUA (SP)";"SP";"IRAPUA";137;12;91;240
2019;"IRAPURU (SP)";"SP";"IRAPURU";113;19;30;162
2019;"ITABERA (SP)";"SP";"ITABERA";346;93;82;521
2019;"ITAI (SP)";"SP";"ITAI";594;88;216;898
2019;"ITAJOBI (SP)";"SP";"ITAJOBI";608;24;67;699
2019;"ITAJU (SP)";"SP";"ITAJU";79;4;24;107
2019;"ITANHAEM (SP)";"SP";"ITANHAEM";1117;288;148;1553
2019;"ITAOCA (SP)";"SP";"ITAOCA";41;17;10;68
2019;"ITAPECERICA DA SERRA (SP)";"SP";"ITAPECERICA DA SERRA";2432;662;817;3911
2019;"ITAPETININGA (SP)";"SP";"ITAPETININGA";3026;489;530;4045
2019;"ITAPEVA (SP)";"SP";"ITAPEVA";2142;360;440;2942
2019;"ITAPEVI (SP)";"SP";"ITAPEVI";2146;511;212;2869
2019;"ITAPIRA (SP)";"SP";"ITAPIRA";1869;136;244;2249
2019;"ITAPIRAPUA PAULISTA (SP)";"SP";"ITAPIRAPUA PAULISTA";52;21;22;95
2019;"ITAPOLIS (SP)";"SP";"ITAPOLIS";1362;142;247;1751
2019;"ITAPORANGA (SP)";"SP";"ITAPORANGA";280;33;88;401
2019;"ITAPUI (SP)";"SP";"ITAPUI";416;50;70;536
2019;"ITAPURA (SP)";"SP";"ITAPURA";31;10;20;61
2019;"ITAQUAQUECETUBA (SP)";"SP";"ITAQUAQUECETUBA";3462;514;445;4421
2019;"ITARARE (SP)";"SP";"ITARARE";1004;100;252;1356
2019;"ITARIRI (SP)";"SP";"ITARIRI";402;62;28;492
2019;"ITATIBA (SP)";"SP";"ITATIBA";2504;287;417;3208
2019;"ITATINGA (SP)";"SP";"ITATINGA";281;55;129;465
2019;"ITIRAPINA (SP)";"SP";"ITIRAPINA";350;56;68;474
2019;"ITIRAPUA (SP)";"SP";"ITIRAPUA";97;12;24;133
2019;"ITOBI (SP)";"SP";"ITOBI";179;41;109;329
2019;"ITU (SP)";"SP";"ITU";3285;532;688;4505
2019;"ITUPEVA (SP)";"SP";"ITUPEVA";1579;144;122;1845
2019;"ITUVERAVA (SP)";"SP";"ITUVERAVA";675;67;146;888
2019;"JABORANDI (SP)";"SP";"JABORANDI";195;9;52;256
2019;"JABOTICABAL (SP)";"SP";"JABOTICABAL";2218;125;223;2566
2019;"JACAREI (SP)";"SP";"JACAREI";2792;647;323;3762
2019;"JACI (SP)";"SP";"JACI";258;7;16;281
2019;"JACUPIRANGA (SP)";"SP";"JACUPIRANGA";439;61;398;898
2019;"JAGUARIUNA (SP)";"SP";"JAGUARIUNA";1102;93;136;1331
2019;"JALES (SP)";"SP";"JALES";1224;53;100;1377
2019;"JAMBEIRO (SP)";"SP";"JAMBEIRO";127;46;16;189
2019;"JANDIRA (SP)";"SP";"JANDIRA";1252;363;188;1803
2019;"JARDINOPOLIS (SP)";"SP";"JARDINOPOLIS";1123;123;162;1408
2019;"JARINU (SP)";"SP";"JARINU";698;84;65;847
2019;"JAU (SP)";"SP";"JAU";2568;356;553;3477
2019;"JERIQUARA (SP)";"SP";"JERIQUARA";75;9;22;106
2019;"JOANOPOLIS (SP)";"SP";"JOANOPOLIS";449;53;25;527
2019;"JOAO RAMALHO (SP)";"SP";"JOAO RAMALHO";38;9;36;83
2019;"JOSE BONIFACIO (SP)";"SP";"JOSE BONIFACIO";945;72;163;1180
2019;"JULIO MESQUITA (SP)";"SP";"JULIO MESQUITA";47;9;32;88
2019;"JUMIRIM (SP)";"SP";"JUMIRIM";118;19;7;144
2019;"JUNDIAI (SP)";"SP";"JUNDIAI";7945;874;1228;10047
2019;"JUNQUEIROPOLIS (SP)";"SP";"JUNQUEIROPOLIS";546;37;230;813
2019;"JUQUIA (SP)";"SP";"JUQUIA";468;44;30;542
2019;"JUQUITIBA (SP)";"SP";"JUQUITIBA";759;141;117;1017
2019;"LAGOINHA (SP)";"SP";"LAGOINHA";173;30;27;230
2019;"LARANJAL PAULISTA (SP)";"SP";"LARANJAL PAULISTA";840;80;258;1178
2019;"LAVINIA (SP)";"SP";"LAVINIA";82;5;20;107
2019;"LAVRINHAS (SP)";"SP";"LAVRINHAS";89;17;15;121
2019;"LEME (SP)";"SP";"LEME";2556;241;607;3404
2019;"LENCOIS PAULISTA (SP)";"SP";"LENCOIS PAULISTA";1525;256;387;2168
2019;"LIMEIRA (SP)";"SP";"LIMEIRA";4988;992;714;6694
2019;"LINDOIA (SP)";"SP";"LINDOIA";216;30;31;277
2019;"LINS (SP)";"SP";"LINS";1330;133;217;1680
2019;"LORENA (SP)";"SP";"LORENA";1003;233;49;1285
2019;"LOURDES (SP)";"SP";"LOURDES";23;4;17;44
2019;"LOUVEIRA (SP)";"SP";"LOUVEIRA";1032;178;101;1311
2019;"LUCELIA (SP)";"SP";"LUCELIA";396;33;216;645
2019;"LUCIANOPOLIS (SP)";"SP";"LUCIANOPOLIS";59;14;24;97
2019;"LUIS ANTONIO (SP)";"SP";"LUIS ANTONIO";291;34;241;566
2019;"LUIZIANIA (SP)";"SP";"LUIZIANIA";79;2;41;122
2019;"LUPERCIO (SP)";"SP";"LUPERCIO";52;5;33;90
2019;"LUTECIA (SP)";"SP";"LUTECIA";56;10;16;82
2019;"MACATUBA (SP)";"SP";"MACATUBA";449;34;94;577
2019;"MACAUBAL (SP)";"SP";"MACAUBAL";153;18;25;196
2019;"MACEDONIA (SP)";"SP";"MACEDONIA";50;5;14;69
2019;"MAGDA (SP)";"SP";"MAGDA";129;19;15;163
2019;"MAIRINQUE (SP)";"SP";"MAIRINQUE";637;134;87;858
2019;"MAIRIPORA (SP)";"SP";"MAIRIPORA";2124;289;202;2615
2019;"MANDURI (SP)";"SP";"MANDURI";272;46;111;429
2019;"MARABA PAULISTA (SP)";"SP";"MARABA PAULISTA";46;7;21;74
2019;"MARACAI (SP)";"SP";"MARACAI";330;55;59;444
2019;"MARAPOAMA (SP)";"SP";"MARAPOAMA";177;9;16;202
2019;"MARIAPOLIS (SP)";"SP";"MARIAPOLIS";51;8;34;93
2019;"MARILIA (SP)";"SP";"MARILIA";3513;380;610;4503
2019;"MARINOPOLIS (SP)";"SP";"MARINOPOLIS";76;6;14;96
2019;"MARTINOPOLIS (SP)";"SP";"MARTINOPOLIS";514;54;147;715
2019;"MATAO (SP)";"SP";"MATAO";1670;127;448;2245
2019;"MAUA (SP)";"SP";"MAUA";4214;1165;1555;6934
2019;"MENDONCA (SP)";"SP";"MENDONCA";124;9;30;163
2019;"MERIDIANO (SP)";"SP";"MERIDIANO";182;12;22;216
2019;"MESOPOLIS (SP)";"SP";"MESOPOLIS";20;7;14;41
2019;"MIGUELOPOLIS (SP)";"SP";"MIGUELOPOLIS";276;25;97;398
2019;"MINEIROS DO TIETE (SP)";"SP";"MINEIROS DO TIETE";252;30;57;339
2019;"MIRA ESTRELA (SP)";"SP";"MIRA ESTRELA";50;7;31;88
2019;"MIRACATU (SP)";"SP";"MIRACATU";773;80;45;898
2019;"MIRANDOPOLIS (SP)";"SP";"MIRANDOPOLIS";529;53;226;808
2019;"MIRANTE DO PARANAPANEMA (SP)";"SP";"MIRANTE DO PARANAPANEMA";327;58;103;488
2019;"MIRASSOL (SP)";"SP";"MIRASSOL";1335;69;107;1511
2019;"MIRASSOLANDIA (SP)";"SP";"MIRASSOLANDIA";74;18;11;103
2019;"MOCOCA (SP)";"SP";"MOCOCA";1287;168;369;1824
2019;"MOGI DAS CRUZES (SP)";"SP";"MOGI DAS CRUZES";6677;985;1365;9027
2019;"MOGI GUACU (SP)";"SP";"MOGI GUACU";2602;515;632;3749
2019;"MOGI MIRIM (SP)";"SP";"MOGI MIRIM";2150;243;228;2621
2019;"MOMBUCA (SP)";"SP";"MOMBUCA";101;8;20;129
2019;"MONCOES (SP)";"SP";"MONCOES";80;14;14;108
2019;"MONGAGUA (SP)";"SP";"MONGAGUA";563;113;114;790
2019;"MONTE ALEGRE DO SUL (SP)";"SP";"MONTE ALEGRE DO SUL";253;54;50;357
2019;"MONTE ALTO (SP)";"SP";"MONTE ALTO";1564;99;117;1780
2019;"MONTE APRAZIVEL (SP)";"SP";"MONTE APRAZIVEL";657;66;277;1000
2019;"MONTE AZUL PAULISTA (SP)";"SP";"MONTE AZUL PAULISTA";565;56;183;804
2019;"MONTE CASTELO (SP)";"SP";"MONTE CASTELO";95;9;11;115
2019;"MONTE MOR (SP)";"SP";"MONTE MOR";910;126;150;1186
2019;"MONTEIRO LOBATO (SP)";"SP";"MONTEIRO LOBATO";171;33;16;220
2019;"MORRO AGUDO (SP)";"SP";"MORRO AGUDO";797;54;200;1051
2019;"MORUNGABA (SP)";"SP";"MORUNGABA";416;65;32;513
2019;"MOTUCA (SP)";"SP";"MOTUCA";153;10;31;194
2019;"MUNICIPIO NAO INFORMADO (SP)";"SP";"MUNICIPIO NAO INFORMADO";0;0;0;0
2019;"MURUTINGA DO SUL (SP)";"SP";"MURUTINGA DO SUL";88;18;19;125
2019;"NANTES (SP)";"SP";"NANTES";25;13;18;56
2019;"NARANDIBA (SP)";"SP";"NARANDIBA";94;13;26;133
2019;"NATIVIDADE DA SERRA (SP)";"SP";"NATIVIDADE DA SERRA";119;58;10;187
2019;"NAZARE PAULISTA (SP)";"SP";"NAZARE PAULISTA";780;42;77;899
2019;"NEVES PAULISTA (SP)";"SP";"NEVES PAULISTA";208;13;28;249
2019;"NHANDEARA (SP)";"SP";"NHANDEARA";204;25;66;295
2019;"NIPOA (SP)";"SP";"NIPOA";119;10;37;166
2019;"NOVA ALIANCA (SP)";"SP";"NOVA ALIANCA";176;13;19;208
2019;"NOVA CAMPINA (SP)";"SP";"NOVA CAMPINA";100;17;24;141
2019;"NOVA CANAA PAULISTA (SP)";"SP";"NOVA CANAA PAULISTA";41;8;8;57
2019;"NOVA CASTILHO (SP)";"SP";"NOVA CASTILHO";23;2;6;31
2019;"NOVA EUROPA (SP)";"SP";"NOVA EUROPA";191;21;156;368
2019;"NOVA GRANADA (SP)";"SP";"NOVA GRANADA";388;69;135;592
2019;"NOVA GUATAPORANGA (SP)";"SP";"NOVA GUATAPORANGA";45;6;15;66
2019;"NOVA INDEPENDENCIA (SP)";"SP";"NOVA INDEPENDENCIA";84;11;12;107
2019;"NOVA LUZITANIA (SP)";"SP";"NOVA LUZITANIA";39;3;28;70
2019;"NOVA ODESSA (SP)";"SP";"NOVA ODESSA";986;171;130;1287
2019;"NOVAIS (SP)";"SP";"NOVAIS";113;9;47;169
2019;"NOVO HORIZONTE (SP)";"SP";"NOVO HORIZONTE";1222;61;340;1623
2019;"NUPORANGA (SP)";"SP";"NUPORANGA";233;25;67;325
2019;"OCAUCU (SP)";"SP";"OCAUCU";123;11;27;161
2019;"OLEO (SP)";"SP";"OLEO";44;20;10;74
2019;"OLIMPIA (SP)";"SP";"OLIMPIA";1024;128;234;1386
2019;"ONDA VERDE (SP)";"SP";"ONDA VERDE";127;11;33;171
2019;"ORIENTE (SP)";"SP";"ORIENTE";101;21;25;147
2019;"ORINDIUVA (SP)";"SP";"ORINDIUVA";288;15;64;367
2019;"ORLANDIA (SP)";"SP";"ORLANDIA";1049;71;340;1460
2019;"OSASCO (SP)";"SP";"OSASCO";9865;2238;2818;14921
2019;"OSCAR BRESSANE (SP)";"SP";"OSCAR BRESSANE";74;8;10;92
2019;"OSVALDO CRUZ (SP)";"SP";"OSVALDO CRUZ";496;39;125;660
2019;"OURINHOS (SP)";"SP";"OURINHOS";2296;185;647;3128
2019;"OURO VERDE (SP)";"SP";"OURO VERDE";123;9;66;198
2019;"OUROESTE (SP)";"SP";"OUROESTE";205;13;37;255
2019;"PACAEMBU (SP)";"SP";"PACAEMBU";216;26;42;284
2019;"PALESTINA (SP)";"SP";"PALESTINA";197;20;52;269
2019;"PALMARES PAULISTA (SP)";"SP";"PALMARES PAULISTA";98;16;116;230
2019;"PALMEIRA D OESTE (SP)";"SP";"PALMEIRA D OESTE";273;15;40;328
2019;"PALMITAL (SP)";"SP";"PALMITAL";722;44;68;834
2019;"PANORAMA (SP)";"SP";"PANORAMA";347;15;28;390
2019;"PARAGUACU PAULISTA (SP)";"SP";"PARAGUACU PAULISTA";927;153;175;1255
2019;"PARAIBUNA (SP)";"SP";"PARAIBUNA";277;100;80;457
2019;"PARAISO (SP)";"SP";"PARAISO";214;13;109;336
2019;"PARANAPANEMA (SP)";"SP";"PARANAPANEMA";638;64;95;797
2019;"PARANAPUA (SP)";"SP";"PARANAPUA";116;17;24;157
2019;"PARAPUA (SP)";"SP";"PARAPUA";339;13;67;419
2019;"PARDINHO (SP)";"SP";"PARDINHO";183;37;35;255
2019;"PARIQUERA ACU (SP)";"SP";"PARIQUERA ACU";450;40;22;512
2019;"PARISI (SP)";"SP";"PARISI";43;3;15;61
2019;"PATROCINIO PAULISTA (SP)";"SP";"PATROCINIO PAULISTA";327;25;67;419
2019;"PAULICEIA (SP)";"SP";"PAULICEIA";348;13;33;394
2019;"PAULINIA (SP)";"SP";"PAULINIA";2312;216;341;2869
2019;"PAULISTANIA (SP)";"SP";"PAULISTANIA";30;12;14;56
2019;"PAULO DE FARIA (SP)";"SP";"PAULO DE FARIA";119;19;54;192
2019;"PEDERNEIRAS (SP)";"SP";"PEDERNEIRAS";1209;126;242;1577
2019;"PEDRA BELA (SP)";"SP";"PEDRA BELA";257;13;17;287
2019;"PEDRANOPOLIS (SP)";"SP";"PEDRANOPOLIS";53;9;17;79
2019;"PEDREGULHO (SP)";"SP";"PEDREGULHO";335;52;139;526
2019;"PEDREIRA (SP)";"SP";"PEDREIRA";836;148;76;1060
2019;"PEDRINHAS PAULISTA (SP)";"SP";"PEDRINHAS PAULISTA";191;10;11;212
2019;"PEDRO DE TOLEDO (SP)";"SP";"PEDRO DE TOLEDO";188;49;22;259
2019;"PENAPOLIS (SP)";"SP";"PENAPOLIS";1534;126;317;1977
2019;"PEREIRA BARRETO (SP)";"SP";"PEREIRA BARRETO";431;56;119;606
2019;"PEREIRAS (SP)";"SP";"PEREIRAS";268;18;33;319
2019;"PERUIBE (SP)";"SP";"PERUIBE";730;252;117;1099
2019;"PIACATU (SP)";"SP";"PIACATU";100;8;30;138
2019;"PIEDADE (SP)";"SP";"PIEDADE";1689;170;121;1980
2019;"PILAR DO SUL (SP)";"SP";"PILAR DO SUL";1191;88;103;1382
2019;"PINDAMONHANGABA (SP)";"SP";"PINDAMONHANGABA";2044;502;211;2757
2019;"PINDORAMA (SP)";"SP";"PINDORAMA";323;47;65;435
2019;"PINHALZINHO (SP)";"SP";"PINHALZINHO";490;64;28;582
2019;"PIQUEROBI (SP)";"SP";"PIQUEROBI";60;9;12;81
2019;"PIQUETE (SP)";"SP";"PIQUETE";214;55;16;285
2019;"PIRACAIA (SP)";"SP";"PIRACAIA";584;93;29;706
2019;"PIRACICABA (SP)";"SP";"PIRACICABA";7939;965;1477;10381
2019;"PIRAJU (SP)";"SP";"PIRAJU";551;93;80;724
2019;"PIRAJUI (SP)";"SP";"PIRAJUI";352;26;97;475
2019;"PIRANGI (SP)";"SP";"PIRANGI";447;17;86;550
2019;"PIRAPORA DO BOM JESUS (SP)";"SP";"PIRAPORA DO BOM JESUS";373;84;130;587
2019;"PIRAPOZINHO (SP)";"SP";"PIRAPOZINHO";514;47;111;672
2019;"PIRASSUNUNGA (SP)";"SP";"PIRASSUNUNGA";1153;177;245;1575
2019;"PIRATININGA (SP)";"SP";"PIRATININGA";303;36;48;387
2019;"PITANGUEIRAS (SP)";"SP";"PITANGUEIRAS";1018;57;345;1420
2019;"PLANALTO (SP)";"SP";"PLANALTO";189;15;63;267
2019;"PLATINA (SP)";"SP";"PLATINA";66;15;17;98
2019;"POA (SP)";"SP";"POA";998;237;196;1431
2019;"POLONI (SP)";"SP";"POLONI";191;5;59;255
2019;"POMPEIA (SP)";"SP";"POMPEIA";318;22;62;402
2019;"PONGAI (SP)";"SP";"PONGAI";67;11;21;99
2019;"PONTAL (SP)";"SP";"PONTAL";1093;40;577;1710
2019;"PONTALINDA (SP)";"SP";"PONTALINDA";43;18;37;98
2019;"PONTES GESTAL (SP)";"SP";"PONTES GESTAL";73;6;27;106
2019;"POPULINA (SP)";"SP";"POPULINA";60;8;15;83
2019;"PORANGABA (SP)";"SP";"PORANGABA";199;18;19;236
2019;"PORTO FELIZ (SP)";"SP";"PORTO FELIZ";1414;148;212;1774
2019;"PORTO FERREIRA (SP)";"SP";"PORTO FERREIRA";1231;136;178;1545
2019;"POTIM (SP)";"SP";"POTIM";92;66;27;185
2019;"POTIRENDABA (SP)";"SP";"POTIRENDABA";557;21;91;669
2019;"PRACINHA (SP)";"SP";"PRACINHA";13;6;15;34
2019;"PRADOPOLIS (SP)";"SP";"PRADOPOLIS";436;29;252;717
2019;"PRAIA GRANDE (SP)";"SP";"PRAIA GRANDE";2350;438;375;3163
2019;"PRATANIA (SP)";"SP";"PRATANIA";136;22;87;245
2019;"PRESIDENTE ALVES (SP)";"SP";"PRESIDENTE ALVES";56;10;52;118
2019;"PRESIDENTE BERNARDES (SP)";"SP";"PRESIDENTE BERNARDES";279;44;51;374
2019;"PRESIDENTE EPITACIO (SP)";"SP";"PRESIDENTE EPITACIO";575;90;199;864
2019;"PRESIDENTE PRUDENTE (SP)";"SP";"PRESIDENTE PRUDENTE";4210;425;873;5508
2019;"PRESIDENTE VENCESLAU (SP)";"SP";"PRESIDENTE VENCESLAU";730;70;86;886
2019;"PROMISSAO (SP)";"SP";"PROMISSAO";798;185;198;1181
2019;"QUADRA (SP)";"SP";"QUADRA";77;11;20;108
2019;"QUATA (SP)";"SP";"QUATA";250;31;97;378
2019;"QUEIROZ (SP)";"SP";"QUEIROZ";30;10;16;56
2019;"QUELUZ (SP)";"SP";"QUELUZ";130;45;15;190
2019;"QUINTANA (SP)";"SP";"QUINTANA";223;20;29;272
2019;"RAFARD (SP)";"SP";"RAFARD";256;22;31;309
2019;"RANCHARIA (SP)";"SP";"RANCHARIA";681;85;101;867
2019;"REDENCAO DA SERRA (SP)";"SP";"REDENCAO DA SERRA";95;58;34;187
2019;"REGENTE FEIJO (SP)";"SP";"REGENTE FEIJO";450;53;72;575
2019;"REGINOPOLIS (SP)";"SP";"REGINOPOLIS";85;29;26;140
2019;"REGISTRO (SP)";"SP";"REGISTRO";1346;138;352;1836
2019;"RESTINGA (SP)";"SP";"RESTINGA";134;8;35;177
2019;"RIBEIRA (SP)";"SP";"RIBEIRA";35;19;22;76
2019;"RIBEIRAO BONITO (SP)";"SP";"RIBEIRAO BONITO";319;59;117;495
2019;"RIBEIRAO BRANCO (SP)";"SP";"RIBEIRAO BRANCO";288;57;88;433
2019;"RIBEIRAO CORRENTE (SP)";"SP";"RIBEIRAO CORRENTE";118;12;50;180
2019;"RIBEIRAO DO SUL (SP)";"SP";"RIBEIRAO DO SUL";158;14;17;189
2019;"RIBEIRAO DOS INDIOS (SP)";"SP";"RIBEIRAO DOS INDIOS";33;4;6;43
2019;"RIBEIRAO GRANDE (SP)";"SP";"RIBEIRAO GRANDE";82;21;16;119
2019;"RIBEIRAO PIRES (SP)";"SP";"RIBEIRAO PIRES";2786;479;471;3736
2019;"RIBEIRAO PRETO (SP)";"SP";"RIBEIRAO PRETO";11629;1255;2130;15014
2019;"RIFAINA (SP)";"SP";"RIFAINA";58;15;12;85
2019;"RINCAO (SP)";"SP";"RINCAO";272;30;52;354
2019;"RINOPOLIS (SP)";"SP";"RINOPOLIS";223;14;60;297
2019;"RIO CLARO (SP)";"SP";"RIO CLARO";3527;514;565;4606
2019;"RIO DAS PEDRAS (SP)";"SP";"RIO DAS PEDRAS";694;109;197;1000
2019;"RIO GRANDE DA SERRA (SP)";"SP";"RIO GRANDE DA SERRA";488;218;97;803
2019;"RIOLANDIA (SP)";"SP";"RIOLANDIA";100;21;66;187
2019;"RIVERSUL (SP)";"SP";"RIVERSUL";98;33;38;169
2019;"ROSANA (SP)";"SP";"ROSANA";196;45;79;320
2019;"ROSEIRA (SP)";"SP";"ROSEIRA";150;71;19;240
2019;"RUBIACEA (SP)";"SP";"RUBIACEA";32;5;13;50
2019;"RUBINEIA (SP)";"SP";"RUBINEIA";43;12;15;70
2019;"SABINO (SP)";"SP";"SABINO";65;8;16;89
2019;"SAGRES (SP)";"SP";"SAGRES";24;3;6;33
2019;"SALES (SP)";"SP";"SALES";105;6;42;153
2019;"SALES OLIVEIRA (SP)";"SP";"SALES OLIVEIRA";297;21;62;380
2019;"SALESOPOLIS (SP)";"SP";"SALESOPOLIS";855;89;115;1059
2019;"SALMOURAO (SP)";"SP";"SALMOURAO";40;9;50;99
2019;"SALTINHO (SP)";"SP";"SALTINHO";381;36;12;429
2019;"SALTO (SP)";"SP";"SALTO";2555;306;179;3040
2019;"SALTO DE PIRAPORA (SP)";"SP";"SALTO DE PIRAPORA";795;84;109;988
2019;"SALTO GRANDE (SP)";"SP";"SALTO GRANDE";169;20;34;223
2019;"SANDOVALINA (SP)";"SP";"SANDOVALINA";85;8;22;115
2019;"SANTA ADELIA (SP)";"SP";"SANTA ADELIA";572;27;80;679
2019;"SANTA ALBERTINA (SP)";"SP";"SANTA ALBERTINA";133;8;26;167
2019;"SANTA BARBARA D OESTE (SP)";"SP";"SANTA BARBARA D OESTE";2589;471;415;3475
2019;"SANTA BRANCA (SP)";"SP";"SANTA BRANCA";147;43;37;227
2019;"SANTA CLARA D OESTE (SP)";"SP";"SANTA CLARA D OESTE";35;6;11;52
2019;"SANTA CRUZ DA CONCEICAO (SP)";"SP";"SANTA CRUZ DA CONCEICAO";157;10;17;184
2019;"SANTA CRUZ DA ESPERANCA (SP)";"SP";"SANTA CRUZ DA ESPERANCA";59;4;6;69
2019;"SANTA CRUZ DAS PALMEIRAS (SP)";"SP";"SANTA CRUZ DAS PALMEIRAS";638;56;271;965
2019;"SANTA CRUZ DO RIO PARDO (SP)";"SP";"SANTA CRUZ DO RIO PARDO";1613;118;130;1861
2019;"SANTA ERNESTINA (SP)";"SP";"SANTA ERNESTINA";74;16;84;174
2019;"SANTA FE DO SUL (SP)";"SP";"SANTA FE DO SUL";716;39;63;818
2019;"SANTA GERTRUDES (SP)";"SP";"SANTA GERTRUDES";629;58;43;730
2019;"SANTA ISABEL (SP)";"SP";"SANTA ISABEL";1308;117;118;1543
2019;"SANTA LUCIA (SP)";"SP";"SANTA LUCIA";122;26;53;201
2019;"SANTA MARIA DA SERRA (SP)";"SP";"SANTA MARIA DA SERRA";245;35;35;315
2019;"SANTA MERCEDES (SP)";"SP";"SANTA MERCEDES";53;10;9;72
2019;"SANTA RITA D OESTE (SP)";"SP";"SANTA RITA D OESTE";43;4;7;54
2019;"SANTA RITA DO PASSA QUATRO (SP)";"SP";"SANTA RITA DO PASSA QUATRO";594;90;59;743
2019;"SANTA ROSA DE VITERBO (SP)";"SP";"SANTA ROSA DE VITERBO";482;50;109;641
2019;"SANTA SALETE (SP)";"SP";"SANTA SALETE";50;3;9;62
2019;"SANTANA DA PONTE PENSA (SP)";"SP";"SANTANA DA PONTE PENSA";30;4;6;40
2019;"SANTANA DE PARNAIBA (SP)";"SP";"SANTANA DE PARNAIBA";2016;359;231;2606
2019;"SANTO ANASTACIO (SP)";"SP";"SANTO ANASTACIO";515;43;71;629
2019;"SANTO ANDRE (SP)";"SP";"SANTO ANDRE";8877;1559;1814;12250
2019;"SANTO ANTONIO DA ALEGRIA (SP)";"SP";"SANTO ANTONIO DA ALEGRIA";135;12;34;181
2019;"SANTO ANTONIO DE POSSE (SP)";"SP";"SANTO ANTONIO DE POSSE";913;83;178;1174
2019;"SANTO ANTONIO DO ARACANGUA (SP)";"SP";"SANTO ANTONIO DO ARACANGUA";196;35;92;323
2019;"SANTO ANTONIO DO JARDIM (SP)";"SP";"SANTO ANTONIO DO JARDIM";229;27;21;277
2019;"SANTO ANTONIO DO PINHAL (SP)";"SP";"SANTO ANTONIO DO PINHAL";188;29;12;229
2019;"SANTO EXPEDITO (SP)";"SP";"SANTO EXPEDITO";30;4;19;53
2019;"SANTOPOLIS DO AGUAPEI (SP)";"SP";"SANTOPOLIS DO AGUAPEI";66;8;36;110
2019;"SANTOS (SP)";"SP";"SANTOS";5352;935;650;6937
2019;"SAO BENTO DO SAPUCAI (SP)";"SP";"SAO BENTO DO SAPUCAI";198;51;13;262
2019;"SAO BERNARDO DO CAMPO (SP)";"SP";"SAO BERNARDO DO CAMPO";11277;2632;4240;18149
2019;"SAO CAETANO DO SUL (SP)";"SP";"SAO CAETANO DO SUL";2700;496;542;3738
2019;"SAO CARLOS (SP)";"SP";"SAO CARLOS";4049;477;461;4987
2019;"SAO FRANCISCO (SP)";"SP";"SAO FRANCISCO";52;6;19;77
2019;"SAO JOAO DA BOA VISTA (SP)";"SP";"SAO JOAO DA BOA VISTA";2170;309;115;2594
2019;"SAO JOAO DAS DUAS PONTES (SP)";"SP";"SAO JOAO DAS DUAS PONTES";29;10;5;44
2019;"SAO JOAO DE IRACEMA (SP)";"SP";"SAO JOAO DE IRACEMA";29;5;12;46
2019;"SAO JOAO DO PAU D ALHO (SP)";"SP";"SAO JOAO DO PAU D ALHO";39;9;8;56
2019;"SAO JOAQUIM DA BARRA (SP)";"SP";"SAO JOAQUIM DA BARRA";807;117;220;1144
2019;"SAO JOSE DA BELA VISTA (SP)";"SP";"SAO JOSE DA BELA VISTA";84;19;53;156
2019;"SAO JOSE DO BARREIRO (SP)";"SP";"SAO JOSE DO BARREIRO";48;16;5;69
2019;"SAO JOSE DO RIO PARDO (SP)";"SP";"SAO JOSE DO RIO PARDO";1324;124;174;1622
2019;"SAO JOSE DO RIO PRETO (SP)";"SP";"SAO JOSE DO RIO PRETO";8272;640;1695;10607
2019;"SAO JOSE DOS CAMPOS (SP)";"SP";"SAO JOSE DOS CAMPOS";7118;1934;1852;10904
2019;"SAO LOURENCO DA SERRA (SP)";"SP";"SAO LOURENCO DA SERRA";361;46;32;439
2019;"SAO LUIZ DO PARAITINGA (SP)";"SP";"SAO LUIZ DO PARAITINGA";228;44;27;299
2019;"SAO MANUEL (SP)";"SP";"SAO MANUEL";793;153;244;1190
2019;"SAO MIGUEL ARCANJO (SP)";"SP";"SAO MIGUEL ARCANJO";795;131;97;1023
2019;"SAO PAULO (SP)";"SP";"SAO PAULO";135850;39869;47508;223227
2019;"SAO PEDRO (SP)";"SP";"SAO PEDRO";716;137;113;966
2019;"SAO PEDRO DO TURVO (SP)";"SP";"SAO PEDRO DO TURVO";198;27;53;278
2019;"SAO ROQUE (SP)";"SP";"SAO ROQUE";1266;258;244;1768
2019;"SAO SEBASTIAO (SP)";"SP";"SAO SEBASTIAO";925;144;207;1276
2019;"SAO SEBASTIAO DA GRAMA (SP)";"SP";"SAO SEBASTIAO DA GRAMA";276;36;53;365
2019;"SAO SIMAO (SP)";"SP";"SAO SIMAO";427;34;59;520
2019;"SAO VICENTE (SP)";"SP";"SAO VICENTE";2215;543;995;3753
2019;"SARAPUI (SP)";"SP";"SARAPUI";190;23;21;234
2019;"SARUTAIA (SP)";"SP";"SARUTAIA";68;15;37;120
2019;"SEBASTIANOPOLIS DO SUL (SP)";"SP";"SEBASTIANOPOLIS DO SUL";275;3;17;295
2019;"SERRA AZUL (SP)";"SP";"SERRA AZUL";208;22;130;360
2019;"SERRA NEGRA (SP)";"SP";"SERRA NEGRA";514;72;53;639
2019;"SERRANA (SP)";"SP";"SERRANA";734;135;273;1142
2019;"SERTAOZINHO (SP)";"SP";"SERTAOZINHO";2848;196;708;3752
2019;"SETE BARRAS (SP)";"SP";"SETE BARRAS";286;62;34;382
2019;"SEVERINIA (SP)";"SP";"SEVERINIA";332;30;280;642
2019;"SILVEIRAS (SP)";"SP";"SILVEIRAS";92;21;7;120
2019;"SOCORRO (SP)";"SP";"SOCORRO";1025;170;67;1262
2019;"SOROCABA (SP)";"SP";"SOROCABA";8246;1551;1617;11414
2019;"SUD MENNUCCI (SP)";"SP";"SUD MENNUCCI";159;20;71;250
2019;"SUMARE (SP)";"SP";"SUMARE";3171;730;748;4649
2019;"SUZANAPOLIS (SP)";"SP";"SUZANAPOLIS";90;10;22;122
2019;"SUZANO (SP)";"SP";"SUZANO";3705;1037;962;5704
2019;"TABAPUA (SP)";"SP";"TABAPUA";177;16;68;261
2019;"TABATINGA (SP)";"SP";"TABATINGA";359;30;216;605
2019;"TABOAO DA SERRA (SP)";"SP";"TABOAO DA SERRA";2657;991;545;4193
2019;"TACIBA (SP)";"SP";"TACIBA";98;14;27;139
2019;"TAGUAI (SP)";"SP";"TAGUAI";210;21;33;264
2019;"TAIACU (SP)";"SP";"TAIACU";161;13;33;207
2019;"TAIUVA (SP)";"SP";"TAIUVA";165;12;31;208
2019;"TAMBAU (SP)";"SP";"TAMBAU";610;71;89;770
2019;"TANABI (SP)";"SP";"TANABI";549;60;138;747
2019;"TAPIRAI (SP)";"SP";"TAPIRAI";216;24;14;254
2019;"TAPIRATIBA (SP)";"SP";"TAPIRATIBA";379;39;87;505
2019;"TAQUARAL (SP)";"SP";"TAQUARAL";65;8;25;98
2019;"TAQUARITINGA (SP)";"SP";"TAQUARITINGA";1721;127;382;2230
2019;"TAQUARITUBA (SP)";"SP";"TAQUARITUBA";879;66;132;1077
2019;"TAQUARIVAI (SP)";"SP";"TAQUARIVAI";102;16;20;138
2019;"TARABAI (SP)";"SP";"TARABAI";122;9;34;165
2019;"TARUMA (SP)";"SP";"TARUMA";384;47;189;620
2019;"TATUI (SP)";"SP";"TATUI";2677;201;702;3580
2019;"TAUBATE (SP)";"SP";"TAUBATE";3307;818;552;4677
2019;"TEJUPA (SP)";"SP";"TEJUPA";54;32;10;96
2019;"TEODORO SAMPAIO (SP)";"SP";"TEODORO SAMPAIO";404;48;317;769
2019;"TERRA ROXA (SP)";"SP";"TERRA ROXA";202;21;87;310
2019;"TIETE (SP)";"SP";"TIETE";1302;70;245;1617
2019;"TIMBURI (SP)";"SP";"TIMBURI";29;8;5;42
2019;"TORRE DE PEDRA (SP)";"SP";"TORRE DE PEDRA";50;12;9;71
2019;"TORRINHA (SP)";"SP";"TORRINHA";477;39;55;571
2019;"TRABIJU (SP)";"SP";"TRABIJU";50;11;9;70
2019;"TREMEMBE (SP)";"SP";"TREMEMBE";524;76;23;623
2019;"TRES FRONTEIRAS (SP)";"SP";"TRES FRONTEIRAS";80;14;14;108
2019;"TUIUTI (SP)";"SP";"TUIUTI";131;26;24;181
2019;"TUPA (SP)";"SP";"TUPA";1704;91;284;2079
2019;"TUPI PAULISTA (SP)";"SP";"TUPI PAULISTA";358;25;31;414
2019;"TURIUBA (SP)";"SP";"TURIUBA";33;3;15;51
2019;"TURMALINA (SP)";"SP";"TURMALINA";26;3;10;39
2019;"UBARANA (SP)";"SP";"UBARANA";146;5;45;196
2019;"UBATUBA (SP)";"SP";"UBATUBA";875;173;95;1143
2019;"UBIRAJARA (SP)";"SP";"UBIRAJARA";121;9;59;189
2019;"UCHOA (SP)";"SP";"UCHOA";188;17;51;256
2019;"UNIAO PAULISTA (SP)";"SP";"UNIAO PAULISTA";51;8;13;72
2019;"URANIA (SP)";"SP";"URANIA";180;26;37;243
2019;"URU (SP)";"SP";"URU";16;10;9;35
2019;"URUPES (SP)";"SP";"URUPES";442;23;60;525
2019;"VALENTIM GENTIL (SP)";"SP";"VALENTIM GENTIL";306;18;47;371
2019;"VALINHOS (SP)";"SP";"VALINHOS";2246;613;2006;4865
2019;"VALPARAISO (SP)";"SP";"VALPARAISO";489;42;172;703
2019;"VARGEM (SP)";"SP";"VARGEM";383;30;30;443
2019;"VARGEM GRANDE DO SUL (SP)";"SP";"VARGEM GRANDE DO SUL";1296;116;233;1645
2019;"VARGEM GRANDE PAULISTA (SP)";"SP";"VARGEM GRANDE PAULISTA";966;112;80;1158
2019;"VARZEA PAULISTA (SP)";"SP";"VARZEA PAULISTA";1246;461;437;2144
2019;"VERA CRUZ (SP)";"SP";"VERA CRUZ";180;36;43;259
2019;"VINHEDO (SP)";"SP";"VINHEDO";1549;168;167;1884
2019;"VIRADOURO (SP)";"SP";"VIRADOURO";416;30;111;557
2019;"VISTA ALEGRE DO ALTO (SP)";"SP";"VISTA ALEGRE DO ALTO";421;33;141;595
2019;"VITORIA BRASIL (SP)";"SP";"VITORIA BRASIL";35;7;10;52
2019;"VOTORANTIM (SP)";"SP";"VOTORANTIM";1303;277;249;1829
2019;"VOTUPORANGA (SP)";"SP";"VOTUPORANGA";2165;200;351;2716
2019;"ZACARIAS (SP)";"SP";"ZACARIAS";70;5;28;103
2019;"ABREULANDIA (TO)";"TO";"ABREULANDIA";30;1;3;34
2019;"AGUIARNOPOLIS (TO)";"TO";"AGUIARNOPOLIS";58;8;14;80
2019;"ALIANCA DO TOCANTINS (TO)";"TO";"ALIANCA DO TOCANTINS";92;11;16;119
2019;"ALMAS (TO)";"TO";"ALMAS";77;1;11;89
2019;"ALVORADA (TO)";"TO";"ALVORADA";212;3;20;235
2019;"ANANAS (TO)";"TO";"ANANAS";83;1;36;120
2019;"ANGICO (TO)";"TO";"ANGICO";39;7;10;56
2019;"APARECIDA DO RIO NEGRO (TO)";"TO";"APARECIDA DO RIO NEGRO";64;14;6;84
2019;"ARAGOMINAS (TO)";"TO";"ARAGOMINAS";54;3;17;74
2019;"ARAGUACEMA (TO)";"TO";"ARAGUACEMA";44;4;12;60
2019;"ARAGUACU (TO)";"TO";"ARAGUACU";135;14;14;163
2019;"ARAGUAINA (TO)";"TO";"ARAGUAINA";3734;153;765;4652
2019;"ARAGUANA (TO)";"TO";"ARAGUANA";89;4;19;112
2019;"ARAGUATINS (TO)";"TO";"ARAGUATINS";312;55;89;456
2019;"ARAPOEMA (TO)";"TO";"ARAPOEMA";55;7;16;78
2019;"ARRAIAS (TO)";"TO";"ARRAIAS";53;1;13;67
2019;"AUGUSTINOPOLIS (TO)";"TO";"AUGUSTINOPOLIS";203;34;44;281
2019;"AURORA DO TOCANTINS (TO)";"TO";"AURORA DO TOCANTINS";11;0;5;16
2019;"AXIXA DO TOCANTINS (TO)";"TO";"AXIXA DO TOCANTINS";49;12;13;74
2019;"BABACULANDIA (TO)";"TO";"BABACULANDIA";204;14;23;241
2019;"BANDEIRANTES DO TOCANTINS (TO)";"TO";"BANDEIRANTES DO TOCANTINS";32;4;4;40
2019;"BARRA DO OURO (TO)";"TO";"BARRA DO OURO";21;0;2;23
2019;"BARROLANDIA (TO)";"TO";"BARROLANDIA";69;4;7;80
2019;"BERNARDO SAYAO (TO)";"TO";"BERNARDO SAYAO";38;1;7;46
2019;"BOM JESUS DO TOCANTINS (TO)";"TO";"BOM JESUS DO TOCANTINS";12;1;4;17
2019;"BRASILANDIA DO TOCANTINS (TO)";"TO";"BRASILANDIA DO TOCANTINS";19;2;4;25
2019;"BREJINHO DE NAZARE (TO)";"TO";"BREJINHO DE NAZARE";62;3;24;89
2019;"BURITI DO TOCANTINS (TO)";"TO";"BURITI DO TOCANTINS";51;13;6;70
2019;"CACHOEIRINHA (TO)";"TO";"CACHOEIRINHA";9;0;1;10
2019;"CAMPOS LINDOS (TO)";"TO";"CAMPOS LINDOS";71;1;8;80
2019;"CARIRI DO TOCANTINS (TO)";"TO";"CARIRI DO TOCANTINS";66;7;23;96
2019;"CARMOLANDIA (TO)";"TO";"CARMOLANDIA";179;16;93;288
2019;"CARRASCO BONITO (TO)";"TO";"CARRASCO BONITO";12;3;3;18
2019;"CASEARA (TO)";"TO";"CASEARA";37;3;8;48
2019;"CENTENARIO (TO)";"TO";"CENTENARIO";9;0;3;12
2019;"CHAPADA DA NATIVIDADE (TO)";"TO";"CHAPADA DA NATIVIDADE";31;2;10;43
2019;"CHAPADA DE AREIA (TO)";"TO";"CHAPADA DE AREIA";8;2;2;12
2019;"COLINAS DO TOCANTINS (TO)";"TO";"COLINAS DO TOCANTINS";614;15;82;711
2019;"COLMEIA (TO)";"TO";"COLMEIA";134;7;21;162
2019;"COMBINADO (TO)";"TO";"COMBINADO";33;1;12;46
2019;"CONCEICAO DO TOCANTINS (TO)";"TO";"CONCEICAO DO TOCANTINS";22;1;3;26
2019;"COUTO DE MAGALHAES (TO)";"TO";"COUTO DE MAGALHAES";36;5;14;55
2019;"CRISTALANDIA (TO)";"TO";"CRISTALANDIA";111;2;9;122
2019;"CRIXAS DO TOCANTINS (TO)";"TO";"CRIXAS DO TOCANTINS";22;1;4;27
2019;"DARCINOPOLIS (TO)";"TO";"DARCINOPOLIS";102;10;17;129
2019;"DIANOPOLIS (TO)";"TO";"DIANOPOLIS";289;20;85;394
2019;"DIVINOPOLIS DO TOCANTINS (TO)";"TO";"DIVINOPOLIS DO TOCANTINS";115;2;7;124
2019;"DOIS IRMAOS DO TOCANTINS (TO)";"TO";"DOIS IRMAOS DO TOCANTINS";48;10;17;75
2019;"DUERE (TO)";"TO";"DUERE";54;6;5;65
2019;"ESPERANTINA (TO)";"TO";"ESPERANTINA";25;9;15;49
2019;"FATIMA (TO)";"TO";"FATIMA";60;2;12;74
2019;"FIGUEIROPOLIS (TO)";"TO";"FIGUEIROPOLIS";101;4;10;115
2019;"FILADELFIA (TO)";"TO";"FILADELFIA";53;10;14;77
2019;"FORMOSO DO ARAGUAIA (TO)";"TO";"FORMOSO DO ARAGUAIA";292;10;41;343
2019;"FORTALEZA DO TABOCAO (TO)";"TO";"FORTALEZA DO TABOCAO";33;6;7;46
2019;"GOIANORTE (TO)";"TO";"GOIANORTE";48;2;18;68
2019;"GOIATINS (TO)";"TO";"GOIATINS";58;5;12;75
2019;"GUARAI (TO)";"TO";"GUARAI";472;27;39;538
2019;"GURUPI (TO)";"TO";"GURUPI";1754;58;249;2061
2019;"IPUEIRAS (TO)";"TO";"IPUEIRAS";12;1;2;15
2019;"ITACAJA (TO)";"TO";"ITACAJA";60;3;4;67
2019;"ITAGUATINS (TO)";"TO";"ITAGUATINS";31;5;13;49
2019;"ITAPIRATINS (TO)";"TO";"ITAPIRATINS";30;3;12;45
2019;"ITAPORA DO TOCANTINS (TO)";"TO";"ITAPORA DO TOCANTINS";22;3;8;33
2019;"JAU DO TOCANTINS (TO)";"TO";"JAU DO TOCANTINS";25;2;9;36
2019;"JUARINA (TO)";"TO";"JUARINA";9;3;7;19
2019;"LAGOA DA CONFUSAO (TO)";"TO";"LAGOA DA CONFUSAO";239;5;31;275
2019;"LAGOA DO TOCANTINS (TO)";"TO";"LAGOA DO TOCANTINS";15;0;5;20
2019;"LAJEADO (TO)";"TO";"LAJEADO";36;3;11;50
2019;"LAVANDEIRA (TO)";"TO";"LAVANDEIRA";4;1;3;8
2019;"LIZARDA (TO)";"TO";"LIZARDA";20;0;1;21
2019;"LUZINOPOLIS (TO)";"TO";"LUZINOPOLIS";16;2;3;21
2019;"MARIANOPOLIS DO TOCANTINS (TO)";"TO";"MARIANOPOLIS DO TOCANTINS";53;0;11;64
2019;"MATEIROS (TO)";"TO";"MATEIROS";30;3;4;37
2019;"MAURILANDIA DO TOCANTINS (TO)";"TO";"MAURILANDIA DO TOCANTINS";12;8;7;27
2019;"MIRACEMA DO TOCANTINS (TO)";"TO";"MIRACEMA DO TOCANTINS";208;23;45;276
2019;"MIRANORTE (TO)";"TO";"MIRANORTE";294;13;27;334
2019;"MONTE DO CARMO (TO)";"TO";"MONTE DO CARMO";36;9;10;55
2019;"MONTE SANTO DO TOCANTINS (TO)";"TO";"MONTE SANTO DO TOCANTINS";20;3;4;27
2019;"MURICILANDIA (TO)";"TO";"MURICILANDIA";13;4;6;23
2019;"NATIVIDADE (TO)";"TO";"NATIVIDADE";116;4;9;129
2019;"NAZARE (TO)";"TO";"NAZARE";23;2;6;31
2019;"NOVA OLINDA (TO)";"TO";"NOVA OLINDA";118;2;33;153
2019;"NOVA ROSALANDIA (TO)";"TO";"NOVA ROSALANDIA";30;1;5;36
2019;"NOVO ACORDO (TO)";"TO";"NOVO ACORDO";36;1;10;47
2019;"NOVO ALEGRE (TO)";"TO";"NOVO ALEGRE";11;1;4;16
2019;"NOVO JARDIM (TO)";"TO";"NOVO JARDIM";20;2;4;26
2019;"OLIVEIRA DE FATIMA (TO)";"TO";"OLIVEIRA DE FATIMA";14;1;5;20
2019;"PALMAS (TO)";"TO";"PALMAS";4913;341;1958;7212
2019;"PALMEIRANTE (TO)";"TO";"PALMEIRANTE";25;3;9;37
2019;"PALMEIRAS DO TOCANTINS (TO)";"TO";"PALMEIRAS DO TOCANTINS";38;7;11;56
2019;"PALMEIROPOLIS (TO)";"TO";"PALMEIROPOLIS";131;3;23;157
2019;"PARAISO DO TOCANTINS (TO)";"TO";"PARAISO DO TOCANTINS";1284;42;136;1462
2019;"PARANA (TO)";"TO";"PARANA";46;5;3;54
2019;"PAU D ARCO (TO)";"TO";"PAU D ARCO";28;3;8;39
2019;"PEDRO AFONSO (TO)";"TO";"PEDRO AFONSO";257;13;51;321
2019;"PEIXE (TO)";"TO";"PEIXE";97;14;47;158
2019;"PEQUIZEIRO (TO)";"TO";"PEQUIZEIRO";45;3;14;62
2019;"PINDORAMA DO TOCANTINS (TO)";"TO";"PINDORAMA DO TOCANTINS";26;0;8;34
2019;"PIRAQUE (TO)";"TO";"PIRAQUE";12;0;7;19
2019;"PIUM (TO)";"TO";"PIUM";63;6;17;86
2019;"PONTE ALTA DO BOM JESUS (TO)";"TO";"PONTE ALTA DO BOM JESUS";26;3;4;33
2019;"PONTE ALTA DO TOCANTINS (TO)";"TO";"PONTE ALTA DO TOCANTINS";31;2;5;38
2019;"PORTO ALEGRE DO TOCANTINS (TO)";"TO";"PORTO ALEGRE DO TOCANTINS";13;0;8;21
2019;"PORTO NACIONAL (TO)";"TO";"PORTO NACIONAL";873;94;266;1233
2019;"PRAIA NORTE (TO)";"TO";"PRAIA NORTE";16;4;5;25
2019;"PRESIDENTE KENNEDY (TO)";"TO";"PRESIDENTE KENNEDY";27;1;3;31
2019;"PUGMIL (TO)";"TO";"PUGMIL";26;3;3;32
2019;"RECURSOLANDIA (TO)";"TO";"RECURSOLANDIA";15;1;3;19
2019;"RIACHINHO (TO)";"TO";"RIACHINHO";111;8;70;189
2019;"RIO DA CONCEICAO (TO)";"TO";"RIO DA CONCEICAO";11;1;3;15
2019;"RIO DOS BOIS (TO)";"TO";"RIO DOS BOIS";14;4;6;24
2019;"RIO SONO (TO)";"TO";"RIO SONO";30;2;7;39
2019;"SAMPAIO (TO)";"TO";"SAMPAIO";48;3;5;56
2019;"SANDOLANDIA (TO)";"TO";"SANDOLANDIA";26;10;1;37
2019;"SANTA FE DO ARAGUAIA (TO)";"TO";"SANTA FE DO ARAGUAIA";75;9;22;106
2019;"SANTA MARIA DO TOCANTINS (TO)";"TO";"SANTA MARIA DO TOCANTINS";20;3;8;31
2019;"SANTA RITA DO TOCANTINS (TO)";"TO";"SANTA RITA DO TOCANTINS";15;1;5;21
2019;"SANTA ROSA DO TOCANTINS (TO)";"TO";"SANTA ROSA DO TOCANTINS";50;1;5;56
2019;"SANTA TEREZA DO TOCANTINS (TO)";"TO";"SANTA TEREZA DO TOCANTINS";24;1;4;29
2019;"SANTA TEREZINHA DO TOCANTINS (TO)";"TO";"SANTA TEREZINHA DO TOCANTINS";15;3;5;23
2019;"SAO BENTO DO TOCANTINS (TO)";"TO";"SAO BENTO DO TOCANTINS";29;5;14;48
2019;"SAO FELIX DO TOCANTINS (TO)";"TO";"SAO FELIX DO TOCANTINS";9;1;1;11
2019;"SAO MIGUEL DO TOCANTINS (TO)";"TO";"SAO MIGUEL DO TOCANTINS";108;13;48;169
2019;"SAO SALVADOR DO TOCANTINS (TO)";"TO";"SAO SALVADOR DO TOCANTINS";24;4;4;32
2019;"SAO SEBASTIAO DO TOCANTINS (TO)";"TO";"SAO SEBASTIAO DO TOCANTINS";17;3;2;22
2019;"SAO VALERIO DA NATIVIDADE (TO)";"TO";"SAO VALERIO DA NATIVIDADE";60;3;9;72
2019;"SILVANOPOLIS (TO)";"TO";"SILVANOPOLIS";59;2;6;67
2019;"SITIO NOVO DO TOCANTINS (TO)";"TO";"SITIO NOVO DO TOCANTINS";46;8;16;70
2019;"SUCUPIRA (TO)";"TO";"SUCUPIRA";14;1;7;22
2019;"TAGUATINGA (TO)";"TO";"TAGUATINGA";203;15;32;250
2019;"TAIPAS DO TOCANTINS (TO)";"TO";"TAIPAS DO TOCANTINS";6;1;3;10
2019;"TALISMA (TO)";"TO";"TALISMA";28;5;7;40
2019;"TOCANTINIA (TO)";"TO";"TOCANTINIA";28;1;10;39
2019;"TOCANTINOPOLIS (TO)";"TO";"TOCANTINOPOLIS";1117;226;366;1709
2019;"TUPIRAMA (TO)";"TO";"TUPIRAMA";22;5;10;37
2019;"TUPIRATINS (TO)";"TO";"TUPIRATINS";12;1;9;22
2019;"WANDERLANDIA (TO)";"TO";"WANDERLANDIA";64;5;14;83
2019;"XAMBIOA (TO)";"TO";"XAMBIOA";150;11;26;187
