"ano";"chave";"UF";"MUNICIPIO";"CAMINHAO";"MICRO_ONIBUS";"ONIBUS";"total"
2004;"ACRELANDIA (AC)";"AC";"ACRELANDIA";48;0;9;57
2004;"ASSIS BRASIL (AC)";"AC";"ASSIS BRASIL";10;0;1;11
2004;"BRASILEIA (AC)";"AC";"BRASILEIA";83;0;3;86
2004;"BUJARI (AC)";"AC";"BUJARI";29;3;2;34
2004;"CAPIXABA (AC)";"AC";"CAPIXABA";12;1;2;15
2004;"CRUZEIRO DO SUL (AC)";"AC";"CRUZEIRO DO SUL";238;19;16;273
2004;"EPITACIOLANDIA (AC)";"AC";"EPITACIOLANDIA";71;0;7;78
2004;"FEIJO (AC)";"AC";"FEIJO";27;0;0;27
2004;"MANCIO LIMA (AC)";"AC";"MANCIO LIMA";14;1;4;19
2004;"MANOEL URBANO (AC)";"AC";"MANOEL URBANO";3;0;0;3
2004;"PLACIDO DE CASTRO (AC)";"AC";"PLACIDO DE CASTRO";38;1;1;40
2004;"PORTO ACRE (AC)";"AC";"PORTO ACRE";31;2;0;33
2004;"RIO BRANCO (AC)";"AC";"RIO BRANCO";2450;78;329;2857
2004;"RODRIGUES ALVES (AC)";"AC";"RODRIGUES ALVES";0;0;0;0
2004;"SANTA ROSA (AC)";"AC";"SANTA ROSA";0;0;0;0
2004;"SENA MADUREIRA (AC)";"AC";"SENA MADUREIRA";38;1;1;40
2004;"SENADOR GUIOMARD (AC)";"AC";"SENADOR GUIOMARD";92;0;5;97
2004;"TARAUACA (AC)";"AC";"TARAUACA";26;0;0;26
2004;"XAPURI (AC)";"AC";"XAPURI";18;0;0;18
2004;"ARAPIRACA (AL)";"AL";"ARAPIRACA";1919;291;225;2435
2004;"ATALAIA (AL)";"AL";"ATALAIA";415;112;113;640
2004;"CAJUEIRO (AL)";"AL";"CAJUEIRO";0;0;0;0
2004;"CAMPO GRANDE (AL)";"AL";"CAMPO GRANDE";0;0;0;0
2004;"CORURIPE (AL)";"AL";"CORURIPE";353;65;178;596
2004;"DELMIRO GOUVEIA (AL)";"AL";"DELMIRO GOUVEIA";442;158;27;627
2004;"GIRAU DO PONCIANO (AL)";"AL";"GIRAU DO PONCIANO";166;36;50;252
2004;"MACEIO (AL)";"AL";"MACEIO";4161;673;1437;6271
2004;"MATRIZ DE CAMARAGIBE (AL)";"AL";"MATRIZ DE CAMARAGIBE";625;203;164;992
2004;"PALMEIRA DOS INDIOS (AL)";"AL";"PALMEIRA DOS INDIOS";513;171;93;777
2004;"PENEDO (AL)";"AL";"PENEDO";479;81;190;750
2004;"PORTO DE PEDRAS (AL)";"AL";"PORTO DE PEDRAS";1;0;0;1
2004;"QUEBRANGULO (AL)";"AL";"QUEBRANGULO";0;0;0;0
2004;"SANTANA DO IPANEMA (AL)";"AL";"SANTANA DO IPANEMA";659;112;64;835
2004;"SAO MIGUEL DOS CAMPOS (AL)";"AL";"SAO MIGUEL DOS CAMPOS";758;177;230;1165
2004;"TRAIPU (AL)";"AL";"TRAIPU";0;0;0;0
2004;"UNIAO DOS PALMARES (AL)";"AL";"UNIAO DOS PALMARES";641;164;121;926
2004;"VICOSA (AL)";"AL";"VICOSA";210;32;35;277
2004;"ALVARAES (AM)";"AM";"ALVARAES";0;0;1;1
2004;"AMATURA (AM)";"AM";"AMATURA";0;0;0;0
2004;"ANAMA (AM)";"AM";"ANAMA";0;0;0;0
2004;"ANORI (AM)";"AM";"ANORI";1;0;0;1
2004;"APUI (AM)";"AM";"APUI";18;1;1;20
2004;"ATALAIA DO NORTE (AM)";"AM";"ATALAIA DO NORTE";1;0;0;1
2004;"AUTAZES (AM)";"AM";"AUTAZES";3;0;1;4
2004;"BARCELOS (AM)";"AM";"BARCELOS";4;0;0;4
2004;"BARREIRINHA (AM)";"AM";"BARREIRINHA";0;0;0;0
2004;"BENJAMIN CONSTANT (AM)";"AM";"BENJAMIN CONSTANT";2;1;0;3
2004;"BERURI (AM)";"AM";"BERURI";0;0;0;0
2004;"BOA VISTA DO RAMOS (AM)";"AM";"BOA VISTA DO RAMOS";1;0;0;1
2004;"BOCA DO ACRE (AM)";"AM";"BOCA DO ACRE";15;2;1;18
2004;"BORBA (AM)";"AM";"BORBA";2;0;0;2
2004;"CAAPIRANGA (AM)";"AM";"CAAPIRANGA";4;1;1;6
2004;"CANUTAMA (AM)";"AM";"CANUTAMA";0;0;0;0
2004;"CARAUARI (AM)";"AM";"CARAUARI";7;1;0;8
2004;"CAREIRO (AM)";"AM";"CAREIRO";16;3;22;41
2004;"CAREIRO DA VARZEA (AM)";"AM";"CAREIRO DA VARZEA";6;2;4;12
2004;"COARI (AM)";"AM";"COARI";32;1;1;34
2004;"CODAJAS (AM)";"AM";"CODAJAS";2;0;0;2
2004;"EIRUNEPE (AM)";"AM";"EIRUNEPE";9;0;0;9
2004;"ENVIRA (AM)";"AM";"ENVIRA";4;0;1;5
2004;"FONTE BOA (AM)";"AM";"FONTE BOA";10;0;0;10
2004;"GUAJARA (AM)";"AM";"GUAJARA";0;0;0;0
2004;"HUMAITA (AM)";"AM";"HUMAITA";54;0;6;60
2004;"IPIXUNA (AM)";"AM";"IPIXUNA";1;0;0;1
2004;"IRANDUBA (AM)";"AM";"IRANDUBA";67;3;14;84
2004;"ITACOATIARA (AM)";"AM";"ITACOATIARA";198;14;41;253
2004;"ITAMARATI (AM)";"AM";"ITAMARATI";2;0;0;2
2004;"ITAPIRANGA (AM)";"AM";"ITAPIRANGA";1;0;0;1
2004;"JAPURA (AM)";"AM";"JAPURA";2;0;0;2
2004;"JURUA (AM)";"AM";"JURUA";3;0;0;3
2004;"JUTAI (AM)";"AM";"JUTAI";1;0;0;1
2004;"LABREA (AM)";"AM";"LABREA";5;0;1;6
2004;"MANACAPURU (AM)";"AM";"MANACAPURU";114;6;40;160
2004;"MANAQUIRI (AM)";"AM";"MANAQUIRI";1;0;0;1
2004;"MANAUS (AM)";"AM";"MANAUS";9544;1267;3779;14590
2004;"MANICORE (AM)";"AM";"MANICORE";5;1;0;6
2004;"MARAA (AM)";"AM";"MARAA";1;0;0;1
2004;"MAUES (AM)";"AM";"MAUES";20;0;2;22
2004;"NHAMUNDA (AM)";"AM";"NHAMUNDA";2;0;0;2
2004;"NOVA OLINDA DO NORTE (AM)";"AM";"NOVA OLINDA DO NORTE";3;0;2;5
2004;"NOVO AIRAO (AM)";"AM";"NOVO AIRAO";8;0;2;10
2004;"NOVO ARIPUANA (AM)";"AM";"NOVO ARIPUANA";7;0;4;11
2004;"PARINTINS (AM)";"AM";"PARINTINS";75;2;4;81
2004;"PAUINI (AM)";"AM";"PAUINI";4;1;0;5
2004;"PRESIDENTE FIGUEIREDO (AM)";"AM";"PRESIDENTE FIGUEIREDO";109;13;19;141
2004;"RIO PRETO DA EVA (AM)";"AM";"RIO PRETO DA EVA";35;3;14;52
2004;"SANTA ISABEL DO RIO NEGRO (AM)";"AM";"SANTA ISABEL DO RIO NEGRO";5;2;3;10
2004;"SANTO ANTONIO DO ICA (AM)";"AM";"SANTO ANTONIO DO ICA";4;0;0;4
2004;"SAO GABRIEL DA CACHOEIRA (AM)";"AM";"SAO GABRIEL DA CACHOEIRA";61;5;4;70
2004;"SAO PAULO DE OLIVENCA (AM)";"AM";"SAO PAULO DE OLIVENCA";1;0;0;1
2004;"SAO SEBASTIAO DO UATUMA (AM)";"AM";"SAO SEBASTIAO DO UATUMA";1;0;0;1
2004;"SILVES (AM)";"AM";"SILVES";5;3;1;9
2004;"TABATINGA (AM)";"AM";"TABATINGA";24;2;1;27
2004;"TAPAUA (AM)";"AM";"TAPAUA";1;0;1;2
2004;"TEFE (AM)";"AM";"TEFE";26;2;1;29
2004;"TONANTINS (AM)";"AM";"TONANTINS";0;0;0;0
2004;"UARINI (AM)";"AM";"UARINI";0;0;0;0
2004;"URUCARA (AM)";"AM";"URUCARA";4;1;1;6
2004;"URUCURITUBA (AM)";"AM";"URUCURITUBA";3;0;0;3
2004;"AMAPA (AP)";"AP";"AMAPA";4;1;0;5
2004;"AMAPARI (AP)";"AP";"AMAPARI";0;0;0;0
2004;"CALCOENE (AP)";"AP";"CALCOENE";0;0;1;1
2004;"CUTIAS (AP)";"AP";"CUTIAS";1;0;0;1
2004;"FERREIRA GOMES (AP)";"AP";"FERREIRA GOMES";1;0;0;1
2004;"ITAUBAL (AP)";"AP";"ITAUBAL";1;0;2;3
2004;"LARANJAL DO JARI (AP)";"AP";"LARANJAL DO JARI";30;5;4;39
2004;"MACAPA (AP)";"AP";"MACAPA";1689;119;389;2197
2004;"MAZAGAO (AP)";"AP";"MAZAGAO";7;1;1;9
2004;"OIAPOQUE (AP)";"AP";"OIAPOQUE";33;1;1;35
2004;"PORTO GRANDE (AP)";"AP";"PORTO GRANDE";14;0;4;18
2004;"PRACUUBA (AP)";"AP";"PRACUUBA";0;0;0;0
2004;"SANTANA (AP)";"AP";"SANTANA";364;19;31;414
2004;"SERRA DO NAVIO (AP)";"AP";"SERRA DO NAVIO";0;0;0;0
2004;"TARTARUGALZINHO (AP)";"AP";"TARTARUGALZINHO";4;0;0;4
2004;"VITORIA DO JARI (AP)";"AP";"VITORIA DO JARI";0;0;1;1
2004;"ABAIRA (BA)";"BA";"ABAIRA";29;5;10;44
2004;"ABARE (BA)";"BA";"ABARE";16;2;9;27
2004;"ACAJUTIBA (BA)";"BA";"ACAJUTIBA";25;5;5;35
2004;"ADUSTINA (BA)";"BA";"ADUSTINA";12;5;2;19
2004;"AGUA FRIA (BA)";"BA";"AGUA FRIA";8;5;8;21
2004;"AIQUARA (BA)";"BA";"AIQUARA";5;1;0;6
2004;"ALAGOINHAS (BA)";"BA";"ALAGOINHAS";761;95;254;1110
2004;"ALCOBACA (BA)";"BA";"ALCOBACA";18;2;5;25
2004;"ALMADINA (BA)";"BA";"ALMADINA";7;1;1;9
2004;"AMARGOSA (BA)";"BA";"AMARGOSA";155;12;28;195
2004;"AMELIA RODRIGUES (BA)";"BA";"AMELIA RODRIGUES";116;26;14;156
2004;"AMERICA DOURADA (BA)";"BA";"AMERICA DOURADA";13;1;2;16
2004;"ANAGE (BA)";"BA";"ANAGE";38;18;22;78
2004;"ANDARAI (BA)";"BA";"ANDARAI";13;2;3;18
2004;"ANDORINHA (BA)";"BA";"ANDORINHA";33;3;17;53
2004;"ANGICAL (BA)";"BA";"ANGICAL";7;7;2;16
2004;"ANGUERA (BA)";"BA";"ANGUERA";10;5;5;20
2004;"ANTAS (BA)";"BA";"ANTAS";21;3;4;28
2004;"ANTONIO CARDOSO (BA)";"BA";"ANTONIO CARDOSO";0;16;8;24
2004;"ANTONIO GONCALVES (BA)";"BA";"ANTONIO GONCALVES";15;2;4;21
2004;"APORA (BA)";"BA";"APORA";17;9;8;34
2004;"APUAREMA (BA)";"BA";"APUAREMA";18;0;4;22
2004;"ARACAS (BA)";"BA";"ARACAS";32;13;17;62
2004;"ARACATU (BA)";"BA";"ARACATU";43;3;9;55
2004;"ARACI (BA)";"BA";"ARACI";97;3;27;127
2004;"ARAMARI (BA)";"BA";"ARAMARI";10;1;2;13
2004;"ARATACA (BA)";"BA";"ARATACA";11;0;2;13
2004;"ARATUIPE (BA)";"BA";"ARATUIPE";13;0;5;18
2004;"AURELINO LEAL (BA)";"BA";"AURELINO LEAL";32;2;4;38
2004;"BAIANOPOLIS (BA)";"BA";"BAIANOPOLIS";27;2;4;33
2004;"BAIXA GRANDE (BA)";"BA";"BAIXA GRANDE";37;7;11;55
2004;"BANZAE (BA)";"BA";"BANZAE";11;3;15;29
2004;"BARRA (BA)";"BA";"BARRA";17;3;7;27
2004;"BARRA DA ESTIVA (BA)";"BA";"BARRA DA ESTIVA";92;6;14;112
2004;"BARRA DO CHOCA (BA)";"BA";"BARRA DO CHOCA";64;26;12;102
2004;"BARRA DO MENDES (BA)";"BA";"BARRA DO MENDES";25;4;5;34
2004;"BARRA DO ROCHA (BA)";"BA";"BARRA DO ROCHA";7;2;0;9
2004;"BARREIRAS (BA)";"BA";"BARREIRAS";1492;45;169;1706
2004;"BARRO ALTO (BA)";"BA";"BARRO ALTO";28;1;7;36
2004;"BARRO PRETO (BA)";"BA";"BARRO PRETO";11;1;7;19
2004;"BARROCAS (BA)";"BA";"BARROCAS";50;2;5;57
2004;"BELMONTE (BA)";"BA";"BELMONTE";23;0;2;25
2004;"BELO CAMPO (BA)";"BA";"BELO CAMPO";51;6;11;68
2004;"BIRITINGA (BA)";"BA";"BIRITINGA";10;6;15;31
2004;"BOA NOVA (BA)";"BA";"BOA NOVA";12;7;10;29
2004;"BOA VISTA DO TUPIM (BA)";"BA";"BOA VISTA DO TUPIM";35;1;5;41
2004;"BOM JESUS DA LAPA (BA)";"BA";"BOM JESUS DA LAPA";262;20;51;333
2004;"BOM JESUS DA SERRA (BA)";"BA";"BOM JESUS DA SERRA";10;14;10;34
2004;"BONINAL (BA)";"BA";"BONINAL";48;5;10;63
2004;"BONITO (BA)";"BA";"BONITO";20;1;4;25
2004;"BOQUIRA (BA)";"BA";"BOQUIRA";56;4;26;86
2004;"BOTUPORA (BA)";"BA";"BOTUPORA";19;3;10;32
2004;"BREJOES (BA)";"BA";"BREJOES";56;1;14;71
2004;"BREJOLANDIA (BA)";"BA";"BREJOLANDIA";17;1;4;22
2004;"BROTAS DE MACAUBAS (BA)";"BA";"BROTAS DE MACAUBAS";14;4;5;23
2004;"BRUMADO (BA)";"BA";"BRUMADO";718;66;126;910
2004;"BUERAREMA (BA)";"BA";"BUERAREMA";72;2;11;85
2004;"BURITIRAMA (BA)";"BA";"BURITIRAMA";6;1;8;15
2004;"CAATIBA (BA)";"BA";"CAATIBA";2;0;0;2
2004;"CABACEIRAS DO PARAGUACU (BA)";"BA";"CABACEIRAS DO PARAGUACU";25;2;17;44
2004;"CACHOEIRA (BA)";"BA";"CACHOEIRA";58;42;41;141
2004;"CACULE (BA)";"BA";"CACULE";185;8;13;206
2004;"CAEM (BA)";"BA";"CAEM";11;3;7;21
2004;"CAETANOS (BA)";"BA";"CAETANOS";10;2;3;15
2004;"CAETITE (BA)";"BA";"CAETITE";317;22;34;373
2004;"CAFARNAUM (BA)";"BA";"CAFARNAUM";28;0;5;33
2004;"CAIRU (BA)";"BA";"CAIRU";4;0;1;5
2004;"CALDEIRAO GRANDE (BA)";"BA";"CALDEIRAO GRANDE";14;2;5;21
2004;"CAMACAN (BA)";"BA";"CAMACAN";152;4;27;183
2004;"CAMACARI (BA)";"BA";"CAMACARI";959;196;365;1520
2004;"CAMAMU (BA)";"BA";"CAMAMU";60;10;12;82
2004;"CAMPO ALEGRE DE LOURDES (BA)";"BA";"CAMPO ALEGRE DE LOURDES";25;3;0;28
2004;"CAMPO FORMOSO (BA)";"BA";"CAMPO FORMOSO";119;11;49;179
2004;"CANAPOLIS (BA)";"BA";"CANAPOLIS";6;6;7;19
2004;"CANARANA (BA)";"BA";"CANARANA";77;3;4;84
2004;"CANAVIEIRAS (BA)";"BA";"CANAVIEIRAS";52;5;3;60
2004;"CANDEAL (BA)";"BA";"CANDEAL";18;9;2;29
2004;"CANDEIAS (BA)";"BA";"CANDEIAS";404;117;167;688
2004;"CANDIBA (BA)";"BA";"CANDIBA";38;2;8;48
2004;"CANDIDO SALES (BA)";"BA";"CANDIDO SALES";236;13;18;267
2004;"CANSANCAO (BA)";"BA";"CANSANCAO";76;7;14;97
2004;"CANUDOS (BA)";"BA";"CANUDOS";23;5;15;43
2004;"CAPELA DO ALTO ALEGRE (BA)";"BA";"CAPELA DO ALTO ALEGRE";39;4;16;59
2004;"CAPIM GROSSO (BA)";"BA";"CAPIM GROSSO";326;14;20;360
2004;"CARAIBAS (BA)";"BA";"CARAIBAS";20;6;7;33
2004;"CARAVELAS (BA)";"BA";"CARAVELAS";14;5;28;47
2004;"CARDEAL DA SILVA (BA)";"BA";"CARDEAL DA SILVA";13;5;2;20
2004;"CARINHANHA (BA)";"BA";"CARINHANHA";81;4;9;94
2004;"CASA NOVA (BA)";"BA";"CASA NOVA";157;81;51;289
2004;"CASTRO ALVES (BA)";"BA";"CASTRO ALVES";77;5;26;108
2004;"CATOLANDIA (BA)";"BA";"CATOLANDIA";3;2;2;7
2004;"CATU (BA)";"BA";"CATU";251;56;58;365
2004;"CATURAMA (BA)";"BA";"CATURAMA";6;1;6;13
2004;"CENTRAL (BA)";"BA";"CENTRAL";54;1;2;57
2004;"CHORROCHO (BA)";"BA";"CHORROCHO";4;1;3;8
2004;"CICERO DANTAS (BA)";"BA";"CICERO DANTAS";57;8;20;85
2004;"CIPO (BA)";"BA";"CIPO";32;3;0;35
2004;"COARACI (BA)";"BA";"COARACI";71;3;13;87
2004;"COCOS (BA)";"BA";"COCOS";40;2;13;55
2004;"CONCEICAO DA FEIRA (BA)";"BA";"CONCEICAO DA FEIRA";103;33;10;146
2004;"CONCEICAO DO ALMEIDA (BA)";"BA";"CONCEICAO DO ALMEIDA";62;15;7;84
2004;"CONCEICAO DO COITE (BA)";"BA";"CONCEICAO DO COITE";289;33;32;354
2004;"CONCEICAO DO JACUIPE (BA)";"BA";"CONCEICAO DO JACUIPE";126;72;9;207
2004;"CONDE (BA)";"BA";"CONDE";22;5;3;30
2004;"CONDEUBA (BA)";"BA";"CONDEUBA";83;10;24;117
2004;"CONTENDAS DO SINCORA (BA)";"BA";"CONTENDAS DO SINCORA";3;3;0;6
2004;"CORACAO DE MARIA (BA)";"BA";"CORACAO DE MARIA";70;15;30;115
2004;"CORDEIROS (BA)";"BA";"CORDEIROS";16;7;9;32
2004;"CORIBE (BA)";"BA";"CORIBE";20;7;8;35
2004;"CORONEL JOAO SA (BA)";"BA";"CORONEL JOAO SA";25;1;9;35
2004;"CORRENTINA (BA)";"BA";"CORRENTINA";76;3;27;106
2004;"COTEGIPE (BA)";"BA";"COTEGIPE";15;4;4;23
2004;"CRAVOLANDIA (BA)";"BA";"CRAVOLANDIA";11;2;1;14
2004;"CRISOPOLIS (BA)";"BA";"CRISOPOLIS";41;5;11;57
2004;"CRISTOPOLIS (BA)";"BA";"CRISTOPOLIS";33;2;7;42
2004;"CRUZ DAS ALMAS (BA)";"BA";"CRUZ DAS ALMAS";540;80;32;652
2004;"CURACA (BA)";"BA";"CURACA";24;20;16;60
2004;"DARIO MEIRA (BA)";"BA";"DARIO MEIRA";11;3;2;16
2004;"DIAS D AVILA (BA)";"BA";"DIAS D AVILA";311;31;209;551
2004;"DOM BASILIO (BA)";"BA";"DOM BASILIO";134;3;8;145
2004;"DOM MACEDO COSTA (BA)";"BA";"DOM MACEDO COSTA";11;6;3;20
2004;"ELISIO MEDRADO (BA)";"BA";"ELISIO MEDRADO";18;6;9;33
2004;"ENCRUZILHADA (BA)";"BA";"ENCRUZILHADA";41;8;7;56
2004;"ENTRE RIOS (BA)";"BA";"ENTRE RIOS";118;23;27;168
2004;"ERICO CARDOSO (BA)";"BA";"ERICO CARDOSO";11;1;5;17
2004;"ESPLANADA (BA)";"BA";"ESPLANADA";63;16;25;104
2004;"EUCLIDES DA CUNHA (BA)";"BA";"EUCLIDES DA CUNHA";178;9;81;268
2004;"EUNAPOLIS (BA)";"BA";"EUNAPOLIS";844;25;197;1066
2004;"FATIMA (BA)";"BA";"FATIMA";6;3;5;14
2004;"FEIRA DA MATA (BA)";"BA";"FEIRA DA MATA";6;0;4;10
2004;"FEIRA DE SANTANA (BA)";"BA";"FEIRA DE SANTANA";5076;523;730;6329
2004;"FILADELFIA (BA)";"BA";"FILADELFIA";47;4;8;59
2004;"FIRMINO ALVES (BA)";"BA";"FIRMINO ALVES";7;0;0;7
2004;"FLORESTA AZUL (BA)";"BA";"FLORESTA AZUL";12;1;0;13
2004;"FORMOSA DO RIO PRETO (BA)";"BA";"FORMOSA DO RIO PRETO";32;0;5;37
2004;"GANDU (BA)";"BA";"GANDU";192;8;14;214
2004;"GAVIAO (BA)";"BA";"GAVIAO";14;4;1;19
2004;"GENTIO DO OURO (BA)";"BA";"GENTIO DO OURO";10;1;1;12
2004;"GLORIA (BA)";"BA";"GLORIA";35;9;22;66
2004;"GONGOGI (BA)";"BA";"GONGOGI";6;1;1;8
2004;"GOVERNADOR MANGABEIRA (BA)";"BA";"GOVERNADOR MANGABEIRA";120;15;23;158
2004;"GUAJERU (BA)";"BA";"GUAJERU";6;5;2;13
2004;"GUANAMBI (BA)";"BA";"GUANAMBI";845;36;101;982
2004;"GUARATINGA (BA)";"BA";"GUARATINGA";45;5;13;63
2004;"HELIOPOLIS (BA)";"BA";"HELIOPOLIS";16;2;1;19
2004;"IACU (BA)";"BA";"IACU";73;4;4;81
2004;"IBIASSUCE (BA)";"BA";"IBIASSUCE";38;5;3;46
2004;"IBICARAI (BA)";"BA";"IBICARAI";94;9;10;113
2004;"IBICOARA (BA)";"BA";"IBICOARA";86;8;22;116
2004;"IBICUI (BA)";"BA";"IBICUI";30;5;6;41
2004;"IBIPEBA (BA)";"BA";"IBIPEBA";19;5;3;27
2004;"IBIPITANGA (BA)";"BA";"IBIPITANGA";38;7;19;64
2004;"IBIQUERA (BA)";"BA";"IBIQUERA";4;1;0;5
2004;"IBIRAPITANGA (BA)";"BA";"IBIRAPITANGA";30;0;4;34
2004;"IBIRAPUA (BA)";"BA";"IBIRAPUA";12;3;2;17
2004;"IBIRATAIA (BA)";"BA";"IBIRATAIA";56;12;3;71
2004;"IBITIARA (BA)";"BA";"IBITIARA";51;8;14;73
2004;"IBITITA (BA)";"BA";"IBITITA";25;0;5;30
2004;"IBOTIRAMA (BA)";"BA";"IBOTIRAMA";114;19;9;142
2004;"ICHU (BA)";"BA";"ICHU";14;2;2;18
2004;"IGAPORA (BA)";"BA";"IGAPORA";73;8;8;89
2004;"IGRAPIUNA (BA)";"BA";"IGRAPIUNA";23;2;11;36
2004;"IGUAI (BA)";"BA";"IGUAI";40;8;20;68
2004;"ILHEUS (BA)";"BA";"ILHEUS";407;73;253;733
2004;"INHAMBUPE (BA)";"BA";"INHAMBUPE";91;28;32;151
2004;"IPECAETA (BA)";"BA";"IPECAETA";7;3;22;32
2004;"IPIAU (BA)";"BA";"IPIAU";271;14;15;300
2004;"IPIRA (BA)";"BA";"IPIRA";250;15;51;316
2004;"IPUPIARA (BA)";"BA";"IPUPIARA";21;4;0;25
2004;"IRAJUBA (BA)";"BA";"IRAJUBA";11;2;8;21
2004;"IRAMAIA (BA)";"BA";"IRAMAIA";17;1;5;23
2004;"IRAQUARA (BA)";"BA";"IRAQUARA";65;9;9;83
2004;"IRARA (BA)";"BA";"IRARA";63;17;21;101
2004;"IRECE (BA)";"BA";"IRECE";492;21;33;546
2004;"ITABELA (BA)";"BA";"ITABELA";162;3;30;195
2004;"ITABERABA (BA)";"BA";"ITABERABA";278;23;25;326
2004;"ITABUNA (BA)";"BA";"ITABUNA";1224;43;525;1792
2004;"ITACARE (BA)";"BA";"ITACARE";4;6;2;12
2004;"ITAETE (BA)";"BA";"ITAETE";41;0;9;50
2004;"ITAGI (BA)";"BA";"ITAGI";14;2;2;18
2004;"ITAGIBA (BA)";"BA";"ITAGIBA";13;5;5;23
2004;"ITAGIMIRIM (BA)";"BA";"ITAGIMIRIM";30;0;4;34
2004;"ITAGUACU DA BAHIA (BA)";"BA";"ITAGUACU DA BAHIA";10;0;6;16
2004;"ITAJU DO COLONIA (BA)";"BA";"ITAJU DO COLONIA";6;0;4;10
2004;"ITAJUIPE (BA)";"BA";"ITAJUIPE";58;1;8;67
2004;"ITAMARAJU (BA)";"BA";"ITAMARAJU";301;6;79;386
2004;"ITAMARI (BA)";"BA";"ITAMARI";29;0;0;29
2004;"ITAMBE (BA)";"BA";"ITAMBE";35;4;5;44
2004;"ITANAGRA (BA)";"BA";"ITANAGRA";8;0;0;8
2004;"ITANHEM (BA)";"BA";"ITANHEM";21;1;9;31
2004;"ITAPARICA (BA)";"BA";"ITAPARICA";16;21;15;52
2004;"ITAPE (BA)";"BA";"ITAPE";14;0;0;14
2004;"ITAPEBI (BA)";"BA";"ITAPEBI";36;0;2;38
2004;"ITAPETINGA (BA)";"BA";"ITAPETINGA";380;25;63;468
2004;"ITAPICURU (BA)";"BA";"ITAPICURU";15;9;16;40
2004;"ITAPITANGA (BA)";"BA";"ITAPITANGA";7;2;0;9
2004;"ITAQUARA (BA)";"BA";"ITAQUARA";13;1;0;14
2004;"ITARANTIM (BA)";"BA";"ITARANTIM";40;1;2;43
2004;"ITATIM (BA)";"BA";"ITATIM";71;2;15;88
2004;"ITIRUCU (BA)";"BA";"ITIRUCU";94;2;6;102
2004;"ITIUBA (BA)";"BA";"ITIUBA";43;5;26;74
2004;"ITORORO (BA)";"BA";"ITORORO";61;8;10;79
2004;"ITUACU (BA)";"BA";"ITUACU";84;3;6;93
2004;"ITUBERA (BA)";"BA";"ITUBERA";83;5;14;102
2004;"IUIU (BA)";"BA";"IUIU";14;4;0;18
2004;"JABORANDI (BA)";"BA";"JABORANDI";26;1;13;40
2004;"JACARACI (BA)";"BA";"JACARACI";22;7;11;40
2004;"JACOBINA (BA)";"BA";"JACOBINA";511;35;76;622
2004;"JAGUAQUARA (BA)";"BA";"JAGUAQUARA";344;7;31;382
2004;"JAGUARARI (BA)";"BA";"JAGUARARI";96;16;37;149
2004;"JAGUARIPE (BA)";"BA";"JAGUARIPE";17;2;6;25
2004;"JANDAIRA (BA)";"BA";"JANDAIRA";12;1;1;14
2004;"JEQUIE (BA)";"BA";"JEQUIE";1048;38;237;1323
2004;"JEREMOABO (BA)";"BA";"JEREMOABO";78;8;16;102
2004;"JIQUIRICA (BA)";"BA";"JIQUIRICA";27;4;7;38
2004;"JITAUNA (BA)";"BA";"JITAUNA";25;5;3;33
2004;"JOAO DOURADO (BA)";"BA";"JOAO DOURADO";55;3;9;67
2004;"JUAZEIRO (BA)";"BA";"JUAZEIRO";1877;290;412;2579
2004;"JUCURUCU (BA)";"BA";"JUCURUCU";9;0;1;10
2004;"JUSSARA (BA)";"BA";"JUSSARA";26;2;6;34
2004;"JUSSARI (BA)";"BA";"JUSSARI";9;0;0;9
2004;"JUSSIAPE (BA)";"BA";"JUSSIAPE";33;3;2;38
2004;"LAFAIETE COUTINHO (BA)";"BA";"LAFAIETE COUTINHO";5;0;3;8
2004;"LAGEDO DO TABOCAL (BA)";"BA";"LAGEDO DO TABOCAL";17;0;4;21
2004;"LAGOA REAL (BA)";"BA";"LAGOA REAL";15;2;12;29
2004;"LAJE (BA)";"BA";"LAJE";85;3;16;104
2004;"LAJEDAO (BA)";"BA";"LAJEDAO";8;0;4;12
2004;"LAJEDINHO (BA)";"BA";"LAJEDINHO";7;1;1;9
2004;"LAMARAO (BA)";"BA";"LAMARAO";2;1;1;4
2004;"LAPAO (BA)";"BA";"LAPAO";62;8;13;83
2004;"LAURO DE FREITAS (BA)";"BA";"LAURO DE FREITAS";1253;264;177;1694
2004;"LENCOIS (BA)";"BA";"LENCOIS";8;9;0;17
2004;"LICINIO DE ALMEIDA (BA)";"BA";"LICINIO DE ALMEIDA";77;5;9;91
2004;"LIVRAMENTO DO BRUMADO (BA)";"BA";"LIVRAMENTO DO BRUMADO";200;25;28;253
2004;"LUIZ EDUARDO MAGALHAES (BA)";"BA";"LUIZ EDUARDO MAGALHAES";396;16;21;433
2004;"MACAJUBA (BA)";"BA";"MACAJUBA";8;4;15;27
2004;"MACAUBAS (BA)";"BA";"MACAUBAS";129;9;202;340
2004;"MACURURE (BA)";"BA";"MACURURE";5;2;2;9
2004;"MADRE DE DEUS (BA)";"BA";"MADRE DE DEUS";51;4;18;73
2004;"MAETINGA (BA)";"BA";"MAETINGA";13;2;6;21
2004;"MAIQUINIQUE (BA)";"BA";"MAIQUINIQUE";29;3;4;36
2004;"MAIRI (BA)";"BA";"MAIRI";41;4;18;63
2004;"MALHADA (BA)";"BA";"MALHADA";17;3;4;24
2004;"MALHADA DAS PEDRAS (BA)";"BA";"MALHADA DAS PEDRAS";36;8;7;51
2004;"MANOEL VITORINO (BA)";"BA";"MANOEL VITORINO";27;0;3;30
2004;"MANSIDAO (BA)";"BA";"MANSIDAO";2;0;0;2
2004;"MARACANI (BA)";"BA";"MARACANI";47;2;7;56
2004;"MARACAS (BA)";"BA";"MARACAS";141;5;23;169
2004;"MARAGOGIPE (BA)";"BA";"MARAGOGIPE";98;5;15;118
2004;"MARAU (BA)";"BA";"MARAU";4;0;0;4
2004;"MARCIONILIO SOUZA (BA)";"BA";"MARCIONILIO SOUZA";14;3;7;24
2004;"MASCOTE (BA)";"BA";"MASCOTE";19;2;3;24
2004;"MATA DE SAO JOAO (BA)";"BA";"MATA DE SAO JOAO";108;14;24;146
2004;"MATINA (BA)";"BA";"MATINA";12;0;3;15
2004;"MEDEIROS NETO (BA)";"BA";"MEDEIROS NETO";48;2;10;60
2004;"MIGUEL CALMON (BA)";"BA";"MIGUEL CALMON";68;3;20;91
2004;"MILAGRES (BA)";"BA";"MILAGRES";104;5;9;118
2004;"MIRANGABA (BA)";"BA";"MIRANGABA";23;6;13;42
2004;"MIRANTE (BA)";"BA";"MIRANTE";15;5;10;30
2004;"MONTE SANTO (BA)";"BA";"MONTE SANTO";60;8;38;106
2004;"MORPARA (BA)";"BA";"MORPARA";3;1;0;4
2004;"MORRO DO CHAPEU (BA)";"BA";"MORRO DO CHAPEU";64;8;13;85
2004;"MORTUGABA (BA)";"BA";"MORTUGABA";29;3;4;36
2004;"MUCUGE (BA)";"BA";"MUCUGE";44;3;7;54
2004;"MUCURI (BA)";"BA";"MUCURI";48;6;30;84
2004;"MULUNGU DO MORRO (BA)";"BA";"MULUNGU DO MORRO";19;0;0;19
2004;"MUNDO NOVO (BA)";"BA";"MUNDO NOVO";41;3;14;58
2004;"MUNIZ FERREIRA (BA)";"BA";"MUNIZ FERREIRA";39;20;4;63
2004;"MUQUEM DO SAO FRANCISCO (BA)";"BA";"MUQUEM DO SAO FRANCISCO";6;5;6;17
2004;"MURITIBA (BA)";"BA";"MURITIBA";289;17;10;316
2004;"MUTUIPE (BA)";"BA";"MUTUIPE";84;19;23;126
2004;"NAZARE (BA)";"BA";"NAZARE";150;21;10;181
2004;"NILO PECANHA (BA)";"BA";"NILO PECANHA";18;2;5;25
2004;"NORDESTINA (BA)";"BA";"NORDESTINA";17;2;11;30
2004;"NOVA CANAA (BA)";"BA";"NOVA CANAA";25;1;5;31
2004;"NOVA FATIMA (BA)";"BA";"NOVA FATIMA";33;0;4;37
2004;"NOVA IBIA (BA)";"BA";"NOVA IBIA";13;0;1;14
2004;"NOVA ITARANA (BA)";"BA";"NOVA ITARANA";16;3;1;20
2004;"NOVA REDENCAO (BA)";"BA";"NOVA REDENCAO";8;6;2;16
2004;"NOVA SOURE (BA)";"BA";"NOVA SOURE";26;1;11;38
2004;"NOVA VICOSA (BA)";"BA";"NOVA VICOSA";59;6;28;93
2004;"NOVO HORIZONTE (BA)";"BA";"NOVO HORIZONTE";14;2;5;21
2004;"NOVO TRIUNFO (BA)";"BA";"NOVO TRIUNFO";3;1;1;5
2004;"OLINDINA (BA)";"BA";"OLINDINA";67;10;25;102
2004;"OLIVEIRA DOS BREJINHOS (BA)";"BA";"OLIVEIRA DOS BREJINHOS";33;5;3;41
2004;"OURICANGAS (BA)";"BA";"OURICANGAS";17;3;10;30
2004;"OUROLANDIA (BA)";"BA";"OUROLANDIA";19;4;1;24
2004;"PALMAS DE MONTE ALTO (BA)";"BA";"PALMAS DE MONTE ALTO";30;3;7;40
2004;"PALMEIRAS (BA)";"BA";"PALMEIRAS";21;7;1;29
2004;"PARAMIRIM (BA)";"BA";"PARAMIRIM";91;1;34;126
2004;"PARATINGA (BA)";"BA";"PARATINGA";23;12;27;62
2004;"PARIPIRANGA (BA)";"BA";"PARIPIRANGA";62;3;17;82
2004;"PAU BRASIL (BA)";"BA";"PAU BRASIL";21;2;2;25
2004;"PAULO AFONSO (BA)";"BA";"PAULO AFONSO";659;131;182;972
2004;"PE DE SERRA (BA)";"BA";"PE DE SERRA";16;1;11;28
2004;"PEDRAO (BA)";"BA";"PEDRAO";12;4;2;18
2004;"PEDRO ALEXANDRE (BA)";"BA";"PEDRO ALEXANDRE";1;1;1;3
2004;"PIATA (BA)";"BA";"PIATA";67;8;9;84
2004;"PILAO ARCADO (BA)";"BA";"PILAO ARCADO";25;11;4;40
2004;"PINDAI (BA)";"BA";"PINDAI";20;5;9;34
2004;"PINDOBACU (BA)";"BA";"PINDOBACU";23;13;12;48
2004;"PINTADAS (BA)";"BA";"PINTADAS";26;11;19;56
2004;"PIRAI DO NORTE (BA)";"BA";"PIRAI DO NORTE";2;1;0;3
2004;"PIRIPA (BA)";"BA";"PIRIPA";39;10;10;59
2004;"PIRITIBA (BA)";"BA";"PIRITIBA";36;8;15;59
2004;"PLANALTINO (BA)";"BA";"PLANALTINO";9;1;5;15
2004;"PLANALTO (BA)";"BA";"PLANALTO";70;6;28;104
2004;"POCOES (BA)";"BA";"POCOES";213;54;39;306
2004;"POJUCA (BA)";"BA";"POJUCA";208;31;47;286
2004;"PONTO NOVO (BA)";"BA";"PONTO NOVO";21;2;10;33
2004;"PORTO SEGURO (BA)";"BA";"PORTO SEGURO";383;90;357;830
2004;"POTIRIGUA (BA)";"BA";"POTIRIGUA";11;2;4;17
2004;"PRADO (BA)";"BA";"PRADO";30;10;12;52
2004;"PRESIDENTE DUTRA (BA)";"BA";"PRESIDENTE DUTRA";30;4;2;36
2004;"PRESIDENTE JANIO QUADROS (BA)";"BA";"PRESIDENTE JANIO QUADROS";12;6;3;21
2004;"PRESIDENTE TANCREDO NEVES (BA)";"BA";"PRESIDENTE TANCREDO NEVES";41;4;4;49
2004;"QUEIMADAS (BA)";"BA";"QUEIMADAS";62;4;61;127
2004;"QUIJINGUE (BA)";"BA";"QUIJINGUE";26;4;27;57
2004;"QUIXABEIRA (BA)";"BA";"QUIXABEIRA";14;2;6;22
2004;"RAFAEL JAMBEIRO (BA)";"BA";"RAFAEL JAMBEIRO";29;7;18;54
2004;"REMANSO (BA)";"BA";"REMANSO";119;14;9;142
2004;"RETIROLANDIA (BA)";"BA";"RETIROLANDIA";34;2;6;42
2004;"RIACHAO DAS NEVES (BA)";"BA";"RIACHAO DAS NEVES";18;4;7;29
2004;"RIACHAO DO JACUIPE (BA)";"BA";"RIACHAO DO JACUIPE";152;9;14;175
2004;"RIACHO DE SANTANA (BA)";"BA";"RIACHO DE SANTANA";139;7;27;173
2004;"RIBEIRA DO AMPARO (BA)";"BA";"RIBEIRA DO AMPARO";7;3;14;24
2004;"RIBEIRA DO POMBAL (BA)";"BA";"RIBEIRA DO POMBAL";190;16;63;269
2004;"RIBEIRAO DO LARGO (BA)";"BA";"RIBEIRAO DO LARGO";14;3;4;21
2004;"RIO DE CONTAS (BA)";"BA";"RIO DE CONTAS";44;10;8;62
2004;"RIO DO ANTONIO (BA)";"BA";"RIO DO ANTONIO";30;5;1;36
2004;"RIO DO PIRES (BA)";"BA";"RIO DO PIRES";35;2;5;42
2004;"RIO REAL (BA)";"BA";"RIO REAL";108;7;24;139
2004;"RODELAS (BA)";"BA";"RODELAS";6;1;1;8
2004;"RUY BARBOSA (BA)";"BA";"RUY BARBOSA";69;7;20;96
2004;"SALINAS DA MARGARIDA (BA)";"BA";"SALINAS DA MARGARIDA";15;1;4;20
2004;"SALVADOR (BA)";"BA";"SALVADOR";10697;2828;5393;18918
2004;"SANTA BARBARA (BA)";"BA";"SANTA BARBARA";22;3;11;36
2004;"SANTA BRIGIDA (BA)";"BA";"SANTA BRIGIDA";8;7;5;20
2004;"SANTA CRUZ CABRALIA (BA)";"BA";"SANTA CRUZ CABRALIA";50;6;12;68
2004;"SANTA CRUZ DA VITORIA (BA)";"BA";"SANTA CRUZ DA VITORIA";8;1;1;10
2004;"SANTA INES (BA)";"BA";"SANTA INES";39;1;1;41
2004;"SANTA LUZIA (BA)";"BA";"SANTA LUZIA";18;1;3;22
2004;"SANTA MARIA DA VITORIA (BA)";"BA";"SANTA MARIA DA VITORIA";193;26;25;244
2004;"SANTA RITA DE CASSIA (BA)";"BA";"SANTA RITA DE CASSIA";37;2;3;42
2004;"SANTA TERESINHA (BA)";"BA";"SANTA TERESINHA";17;0;8;25
2004;"SANTALUZ (BA)";"BA";"SANTALUZ";108;7;12;127
2004;"SANTANA (BA)";"BA";"SANTANA";90;6;33;129
2004;"SANTANOPOLIS (BA)";"BA";"SANTANOPOLIS";10;2;5;17
2004;"SANTO AMARO (BA)";"BA";"SANTO AMARO";151;54;249;454
2004;"SANTO ANTONIO DE JESUS (BA)";"BA";"SANTO ANTONIO DE JESUS";1540;59;102;1701
2004;"SANTO ESTEVAO (BA)";"BA";"SANTO ESTEVAO";130;50;26;206
2004;"SAO DESIDERIO (BA)";"BA";"SAO DESIDERIO";101;8;15;124
2004;"SAO DOMINGOS (BA)";"BA";"SAO DOMINGOS";22;3;4;29
2004;"SAO FELIPE (BA)";"BA";"SAO FELIPE";129;14;17;160
2004;"SAO FELIX (BA)";"BA";"SAO FELIX";33;9;8;50
2004;"SAO FELIX DO CORIBE (BA)";"BA";"SAO FELIX DO CORIBE";70;5;13;88
2004;"SAO FRANCISCO DO CONDE (BA)";"BA";"SAO FRANCISCO DO CONDE";68;23;42;133
2004;"SAO GABRIEL (BA)";"BA";"SAO GABRIEL";17;2;4;23
2004;"SAO GONCALO DOS CAMPOS (BA)";"BA";"SAO GONCALO DOS CAMPOS";39;81;32;152
2004;"SAO JOSE DA VITORIA (BA)";"BA";"SAO JOSE DA VITORIA";8;0;2;10
2004;"SAO JOSE DO JACUIPE (BA)";"BA";"SAO JOSE DO JACUIPE";43;3;4;50
2004;"SAO MIGUEL DAS MATAS (BA)";"BA";"SAO MIGUEL DAS MATAS";20;1;2;23
2004;"SAO SEBASTIAO DO PASSE (BA)";"BA";"SAO SEBASTIAO DO PASSE";109;22;78;209
2004;"SAPEACU (BA)";"BA";"SAPEACU";52;20;15;87
2004;"SATIRO DIAS (BA)";"BA";"SATIRO DIAS";10;8;4;22
2004;"SAUBARA (BA)";"BA";"SAUBARA";10;6;1;17
2004;"SAUDE (BA)";"BA";"SAUDE";19;8;5;32
2004;"SEABRA (BA)";"BA";"SEABRA";212;34;54;300
2004;"SEBASTIAO LARANJEIRAS (BA)";"BA";"SEBASTIAO LARANJEIRAS";5;2;8;15
2004;"SENHOR DO BONFIM (BA)";"BA";"SENHOR DO BONFIM";408;44;129;581
2004;"SENTO SE (BA)";"BA";"SENTO SE";32;3;8;43
2004;"SERRA DO RAMALHO (BA)";"BA";"SERRA DO RAMALHO";29;18;12;59
2004;"SERRA DOURADA (BA)";"BA";"SERRA DOURADA";24;5;7;36
2004;"SERRA PRETA (BA)";"BA";"SERRA PRETA";19;10;22;51
2004;"SERRINHA (BA)";"BA";"SERRINHA";378;26;83;487
2004;"SERROLANDIA (BA)";"BA";"SERROLANDIA";26;13;9;48
2004;"SIMOES FILHO (BA)";"BA";"SIMOES FILHO";1205;198;337;1740
2004;"SITIO DO MATO (BA)";"BA";"SITIO DO MATO";13;4;7;24
2004;"SITIO DO QUINTO (BA)";"BA";"SITIO DO QUINTO";13;0;6;19
2004;"SOBRADINHO (BA)";"BA";"SOBRADINHO";57;7;9;73
2004;"SOUTO SOARES (BA)";"BA";"SOUTO SOARES";43;0;8;51
2004;"TABOCAS DO BREJO VELHO (BA)";"BA";"TABOCAS DO BREJO VELHO";7;1;6;14
2004;"TANHACU (BA)";"BA";"TANHACU";74;10;12;96
2004;"TANQUE NOVO (BA)";"BA";"TANQUE NOVO";139;4;12;155
2004;"TANQUINHO (BA)";"BA";"TANQUINHO";19;6;4;29
2004;"TAPEROA (BA)";"BA";"TAPEROA";64;20;5;89
2004;"TAPIRAMUTA (BA)";"BA";"TAPIRAMUTA";19;3;2;24
2004;"TEIXEIRA DE FREITAS (BA)";"BA";"TEIXEIRA DE FREITAS";753;40;175;968
2004;"TEODORO SAMPAIO (BA)";"BA";"TEODORO SAMPAIO";9;3;7;19
2004;"TEOFILANDIA (BA)";"BA";"TEOFILANDIA";62;3;14;79
2004;"TEOLANDIA (BA)";"BA";"TEOLANDIA";71;4;2;77
2004;"TERRA NOVA (BA)";"BA";"TERRA NOVA";4;2;8;14
2004;"TREMEDAL (BA)";"BA";"TREMEDAL";21;4;9;34
2004;"TUCANO (BA)";"BA";"TUCANO";158;13;47;218
2004;"UAUA (BA)";"BA";"UAUA";63;3;11;77
2004;"UBAIRA (BA)";"BA";"UBAIRA";57;5;20;82
2004;"UBAITABA (BA)";"BA";"UBAITABA";120;6;10;136
2004;"UBATA (BA)";"BA";"UBATA";148;10;4;162
2004;"UIBAI (BA)";"BA";"UIBAI";33;0;0;33
2004;"UMBURANAS (BA)";"BA";"UMBURANAS";7;2;4;13
2004;"UNA (BA)";"BA";"UNA";28;3;10;41
2004;"URANDI (BA)";"BA";"URANDI";62;1;8;71
2004;"URUCUCA (BA)";"BA";"URUCUCA";53;1;2;56
2004;"UTINGA (BA)";"BA";"UTINGA";28;5;2;35
2004;"VALENCA (BA)";"BA";"VALENCA";423;38;42;503
2004;"VALENTE (BA)";"BA";"VALENTE";85;4;14;103
2004;"VARZEA DA ROCA (BA)";"BA";"VARZEA DA ROCA";20;5;8;33
2004;"VARZEA DO POCO (BA)";"BA";"VARZEA DO POCO";35;4;4;43
2004;"VARZEA NOVA (BA)";"BA";"VARZEA NOVA";45;3;9;57
2004;"VARZEDO (BA)";"BA";"VARZEDO";30;2;2;34
2004;"VERA CRUZ (BA)";"BA";"VERA CRUZ";83;72;13;168
2004;"VEREDA (BA)";"BA";"VEREDA";6;0;1;7
2004;"VITORIA DA CONQUISTA (BA)";"BA";"VITORIA DA CONQUISTA";2351;172;700;3223
2004;"WAGNER (BA)";"BA";"WAGNER";11;0;4;15
2004;"WANDERLEY (BA)";"BA";"WANDERLEY";24;4;9;37
2004;"WENCESLAU GUIMARAES (BA)";"BA";"WENCESLAU GUIMARAES";55;7;3;65
2004;"XIQUE XIQUE (BA)";"BA";"XIQUE XIQUE";71;4;8;83
2004;"ABAIARA (CE)";"CE";"ABAIARA";7;10;2;19
2004;"ACARAPE (CE)";"CE";"ACARAPE";65;19;7;91
2004;"ACARAU (CE)";"CE";"ACARAU";115;7;19;141
2004;"ACOPIARA (CE)";"CE";"ACOPIARA";155;7;17;179
2004;"AIUABA (CE)";"CE";"AIUABA";12;0;0;12
2004;"ALCANTARAS (CE)";"CE";"ALCANTARAS";29;1;3;33
2004;"ALTANEIRA (CE)";"CE";"ALTANEIRA";10;3;1;14
2004;"ALTO SANTO (CE)";"CE";"ALTO SANTO";85;3;12;100
2004;"AMONTADA (CE)";"CE";"AMONTADA";107;6;6;119
2004;"ANTONINA DO NORTE (CE)";"CE";"ANTONINA DO NORTE";24;1;0;25
2004;"APUIARES (CE)";"CE";"APUIARES";33;9;2;44
2004;"AQUIRAZ (CE)";"CE";"AQUIRAZ";260;60;26;346
2004;"ARACATI (CE)";"CE";"ARACATI";318;27;47;392
2004;"ARACOIABA (CE)";"CE";"ARACOIABA";55;7;7;69
2004;"ARARENDA (CE)";"CE";"ARARENDA";10;2;1;13
2004;"ARARIPE (CE)";"CE";"ARARIPE";37;22;8;67
2004;"ARATUBA (CE)";"CE";"ARATUBA";17;3;4;24
2004;"ARNEIROZ (CE)";"CE";"ARNEIROZ";15;1;0;16
2004;"ASSARE (CE)";"CE";"ASSARE";44;10;0;54
2004;"AURORA (CE)";"CE";"AURORA";48;9;2;59
2004;"BAIXIO (CE)";"CE";"BAIXIO";3;4;1;8
2004;"BANABUIU (CE)";"CE";"BANABUIU";52;5;11;68
2004;"BARBALHA (CE)";"CE";"BARBALHA";152;10;36;198
2004;"BARREIRA (CE)";"CE";"BARREIRA";73;3;6;82
2004;"BARRO (CE)";"CE";"BARRO";28;6;7;41
2004;"BARROQUINHA (CE)";"CE";"BARROQUINHA";14;3;0;17
2004;"BATURITE (CE)";"CE";"BATURITE";141;21;17;179
2004;"BEBERIBE (CE)";"CE";"BEBERIBE";99;26;28;153
2004;"BELA CRUZ (CE)";"CE";"BELA CRUZ";55;7;3;65
2004;"BOA VIAGEM (CE)";"CE";"BOA VIAGEM";238;14;24;276
2004;"BREJO SANTO (CE)";"CE";"BREJO SANTO";171;28;16;215
2004;"CAMOCIM (CE)";"CE";"CAMOCIM";88;15;9;112
2004;"CAMPOS SALES (CE)";"CE";"CAMPOS SALES";126;17;14;157
2004;"CANINDE (CE)";"CE";"CANINDE";272;14;53;339
2004;"CAPISTRANO (CE)";"CE";"CAPISTRANO";31;5;11;47
2004;"CARIDADE (CE)";"CE";"CARIDADE";35;5;4;44
2004;"CARIRE (CE)";"CE";"CARIRE";22;7;3;32
2004;"CARIRIACU (CE)";"CE";"CARIRIACU";33;7;2;42
2004;"CARIUS (CE)";"CE";"CARIUS";30;4;2;36
2004;"CARNAUBAL (CE)";"CE";"CARNAUBAL";45;11;5;61
2004;"CASCAVEL (CE)";"CE";"CASCAVEL";251;28;38;317
2004;"CATARINA (CE)";"CE";"CATARINA";26;4;0;30
2004;"CATUNDA (CE)";"CE";"CATUNDA";20;4;1;25
2004;"CAUCAIA (CE)";"CE";"CAUCAIA";712;54;258;1024
2004;"CEDRO (CE)";"CE";"CEDRO";62;19;19;100
2004;"CHAVAL (CE)";"CE";"CHAVAL";14;6;1;21
2004;"CHORO (CE)";"CE";"CHORO";18;4;8;30
2004;"CHOROZINHO (CE)";"CE";"CHOROZINHO";59;6;27;92
2004;"COREAU (CE)";"CE";"COREAU";60;11;7;78
2004;"CRATEUS (CE)";"CE";"CRATEUS";184;9;23;216
2004;"CRATO (CE)";"CE";"CRATO";564;37;71;672
2004;"CROATA (CE)";"CE";"CROATA";34;4;0;38
2004;"CRUZ (CE)";"CE";"CRUZ";81;19;17;117
2004;"DEPUTADO IRAPUAN PINHEIRO (CE)";"CE";"DEPUTADO IRAPUAN PINHEIRO";12;5;3;20
2004;"ERERE (CE)";"CE";"ERERE";4;2;0;6
2004;"EUSEBIO (CE)";"CE";"EUSEBIO";509;9;43;561
2004;"FARIAS BRITO (CE)";"CE";"FARIAS BRITO";48;26;4;78
2004;"FORQUILHA (CE)";"CE";"FORQUILHA";63;15;9;87
2004;"FORTALEZA (CE)";"CE";"FORTALEZA";15486;1781;4133;21400
2004;"FORTIM (CE)";"CE";"FORTIM";19;27;5;51
2004;"FRECHEIRINHA (CE)";"CE";"FRECHEIRINHA";38;13;10;61
2004;"GENERAL SAMPAIO (CE)";"CE";"GENERAL SAMPAIO";11;2;1;14
2004;"GRACA (CE)";"CE";"GRACA";13;5;5;23
2004;"GRANJA (CE)";"CE";"GRANJA";111;16;11;138
2004;"GRANJEIRO (CE)";"CE";"GRANJEIRO";5;1;0;6
2004;"GROAIRAS (CE)";"CE";"GROAIRAS";35;18;2;55
2004;"GUAIUBA (CE)";"CE";"GUAIUBA";38;27;8;73
2004;"GUARACIABA DO NORTE (CE)";"CE";"GUARACIABA DO NORTE";184;3;8;195
2004;"GUARAMIRANGA (CE)";"CE";"GUARAMIRANGA";13;1;1;15
2004;"HIDROLANDIA (CE)";"CE";"HIDROLANDIA";64;10;9;83
2004;"HORIZONTE (CE)";"CE";"HORIZONTE";188;35;69;292
2004;"IBARETAMA (CE)";"CE";"IBARETAMA";31;4;5;40
2004;"IBIAPINA (CE)";"CE";"IBIAPINA";85;10;8;103
2004;"IBICUITINGA (CE)";"CE";"IBICUITINGA";27;1;6;34
2004;"ICAPUI (CE)";"CE";"ICAPUI";47;11;25;83
2004;"ICO (CE)";"CE";"ICO";179;34;26;239
2004;"IGUATU (CE)";"CE";"IGUATU";534;33;77;644
2004;"INDEPENDENCIA (CE)";"CE";"INDEPENDENCIA";117;2;9;128
2004;"IPAPORANGA (CE)";"CE";"IPAPORANGA";13;0;0;13
2004;"IPAUMIRIM (CE)";"CE";"IPAUMIRIM";113;10;14;137
2004;"IPU (CE)";"CE";"IPU";199;22;11;232
2004;"IPUEIRAS (CE)";"CE";"IPUEIRAS";51;6;2;59
2004;"IRACEMA (CE)";"CE";"IRACEMA";42;6;3;51
2004;"IRAUCUBA (CE)";"CE";"IRAUCUBA";52;5;7;64
2004;"ITAICABA (CE)";"CE";"ITAICABA";22;3;4;29
2004;"ITAITINGA (CE)";"CE";"ITAITINGA";109;27;9;145
2004;"ITAPAGE (CE)";"CE";"ITAPAGE";181;22;9;212
2004;"ITAPIPOCA (CE)";"CE";"ITAPIPOCA";396;26;14;436
2004;"ITAPIUNA (CE)";"CE";"ITAPIUNA";37;6;5;48
2004;"ITAREMA (CE)";"CE";"ITAREMA";70;15;12;97
2004;"ITATIRA (CE)";"CE";"ITATIRA";51;4;5;60
2004;"JAGUARETAMA (CE)";"CE";"JAGUARETAMA";55;2;0;57
2004;"JAGUARIBARA (CE)";"CE";"JAGUARIBARA";35;4;5;44
2004;"JAGUARIBE (CE)";"CE";"JAGUARIBE";229;18;13;260
2004;"JAGUARUANA (CE)";"CE";"JAGUARUANA";142;9;4;155
2004;"JARDIM (CE)";"CE";"JARDIM";37;12;5;54
2004;"JATI (CE)";"CE";"JATI";1;2;0;3
2004;"JIJOCA DE JERICOACOARA (CE)";"CE";"JIJOCA DE JERICOACOARA";33;4;3;40
2004;"JUAZEIRO DO NORTE (CE)";"CE";"JUAZEIRO DO NORTE";1017;82;186;1285
2004;"JUCAS (CE)";"CE";"JUCAS";29;6;10;45
2004;"LAVRAS DA MANGABEIRA (CE)";"CE";"LAVRAS DA MANGABEIRA";42;6;12;60
2004;"LIMOEIRO DO NORTE (CE)";"CE";"LIMOEIRO DO NORTE";458;12;50;520
2004;"MADALENA (CE)";"CE";"MADALENA";36;3;7;46
2004;"MARACANAU (CE)";"CE";"MARACANAU";643;104;157;904
2004;"MARANGUAPE (CE)";"CE";"MARANGUAPE";394;27;82;503
2004;"MARCO (CE)";"CE";"MARCO";113;4;7;124
2004;"MARTINOPOLE (CE)";"CE";"MARTINOPOLE";6;5;1;12
2004;"MASSAPE (CE)";"CE";"MASSAPE";46;4;21;71
2004;"MAURITI (CE)";"CE";"MAURITI";44;8;5;57
2004;"MERUOCA (CE)";"CE";"MERUOCA";21;1;4;26
2004;"MILAGRES (CE)";"CE";"MILAGRES";56;4;8;68
2004;"MILHA (CE)";"CE";"MILHA";35;0;7;42
2004;"MIRAIMA (CE)";"CE";"MIRAIMA";24;1;2;27
2004;"MISSAO VELHA (CE)";"CE";"MISSAO VELHA";53;13;9;75
2004;"MOMBACA (CE)";"CE";"MOMBACA";133;5;3;141
2004;"MONSENHOR TABOSA (CE)";"CE";"MONSENHOR TABOSA";32;3;0;35
2004;"MORADA NOVA (CE)";"CE";"MORADA NOVA";244;19;34;297
2004;"MORAUJO (CE)";"CE";"MORAUJO";11;2;4;17
2004;"MORRINHOS (CE)";"CE";"MORRINHOS";32;6;3;41
2004;"MUCAMBO (CE)";"CE";"MUCAMBO";22;16;5;43
2004;"MULUNGU (CE)";"CE";"MULUNGU";32;7;1;40
2004;"NOVA OLINDA (CE)";"CE";"NOVA OLINDA";43;10;3;56
2004;"NOVA RUSSAS (CE)";"CE";"NOVA RUSSAS";135;7;6;148
2004;"NOVO ORIENTE (CE)";"CE";"NOVO ORIENTE";32;1;3;36
2004;"OCARA (CE)";"CE";"OCARA";57;21;14;92
2004;"OROS (CE)";"CE";"OROS";55;14;13;82
2004;"PACAJUS (CE)";"CE";"PACAJUS";380;25;19;424
2004;"PACATUBA (CE)";"CE";"PACATUBA";79;50;8;137
2004;"PACOTI (CE)";"CE";"PACOTI";55;3;5;63
2004;"PACUJA (CE)";"CE";"PACUJA";24;8;10;42
2004;"PALHANO (CE)";"CE";"PALHANO";33;6;6;45
2004;"PALMACIA (CE)";"CE";"PALMACIA";31;11;4;46
2004;"PARACURU (CE)";"CE";"PARACURU";102;10;5;117
2004;"PARAIPABA (CE)";"CE";"PARAIPABA";93;11;13;117
2004;"PARAMBU (CE)";"CE";"PARAMBU";125;2;1;128
2004;"PARAMOTI (CE)";"CE";"PARAMOTI";25;2;3;30
2004;"PEDRA BRANCA (CE)";"CE";"PEDRA BRANCA";128;9;7;144
2004;"PENAFORTE (CE)";"CE";"PENAFORTE";12;2;10;24
2004;"PENTECOSTE (CE)";"CE";"PENTECOSTE";136;11;5;152
2004;"PEREIRO (CE)";"CE";"PEREIRO";66;12;6;84
2004;"PINDORETAMA (CE)";"CE";"PINDORETAMA";83;5;4;92
2004;"PIQUET CARNEIRO (CE)";"CE";"PIQUET CARNEIRO";14;2;4;20
2004;"PIRES FERREIRA (CE)";"CE";"PIRES FERREIRA";16;2;1;19
2004;"PORANGA (CE)";"CE";"PORANGA";7;2;1;10
2004;"PORTEIRAS (CE)";"CE";"PORTEIRAS";15;3;3;21
2004;"POTENGI (CE)";"CE";"POTENGI";18;5;0;23
2004;"POTIRETAMA (CE)";"CE";"POTIRETAMA";17;1;4;22
2004;"QUITERIANOPOLIS (CE)";"CE";"QUITERIANOPOLIS";19;3;2;24
2004;"QUIXADA (CE)";"CE";"QUIXADA";380;37;60;477
2004;"QUIXELO (CE)";"CE";"QUIXELO";27;4;14;45
2004;"QUIXERAMOBIM (CE)";"CE";"QUIXERAMOBIM";256;17;53;326
2004;"QUIXERE (CE)";"CE";"QUIXERE";97;12;22;131
2004;"REDENCAO (CE)";"CE";"REDENCAO";133;12;17;162
2004;"RERIUTABA (CE)";"CE";"RERIUTABA";47;19;14;80
2004;"RUSSAS (CE)";"CE";"RUSSAS";422;19;41;482
2004;"SABOEIRO (CE)";"CE";"SABOEIRO";20;2;3;25
2004;"SALITRE (CE)";"CE";"SALITRE";18;2;4;24
2004;"SANTA QUITERIA (CE)";"CE";"SANTA QUITERIA";149;9;7;165
2004;"SANTANA DO ACARAU (CE)";"CE";"SANTANA DO ACARAU";73;9;11;93
2004;"SANTANA DO CARIRI (CE)";"CE";"SANTANA DO CARIRI";34;6;3;43
2004;"SAO BENEDITO (CE)";"CE";"SAO BENEDITO";269;36;26;331
2004;"SAO GONCALO DO AMARANTE (CE)";"CE";"SAO GONCALO DO AMARANTE";122;16;16;154
2004;"SAO JOAO DO JAGUARIBE (CE)";"CE";"SAO JOAO DO JAGUARIBE";36;7;2;45
2004;"SAO LUIS DO CURU (CE)";"CE";"SAO LUIS DO CURU";35;6;7;48
2004;"SENADOR POMPEU (CE)";"CE";"SENADOR POMPEU";96;5;20;121
2004;"SENADOR SA (CE)";"CE";"SENADOR SA";19;0;3;22
2004;"SOBRAL (CE)";"CE";"SOBRAL";1106;96;136;1338
2004;"SOLONOPOLE (CE)";"CE";"SOLONOPOLE";53;5;7;65
2004;"TABULEIRO DO NORTE (CE)";"CE";"TABULEIRO DO NORTE";222;18;25;265
2004;"TAMBORIL (CE)";"CE";"TAMBORIL";44;4;11;59
2004;"TARRAFAS (CE)";"CE";"TARRAFAS";14;4;1;19
2004;"TAUA (CE)";"CE";"TAUA";246;3;19;268
2004;"TEJUCUOCA (CE)";"CE";"TEJUCUOCA";43;0;3;46
2004;"TIANGUA (CE)";"CE";"TIANGUA";732;46;43;821
2004;"TRAIRI (CE)";"CE";"TRAIRI";105;8;9;122
2004;"TURURU (CE)";"CE";"TURURU";33;1;2;36
2004;"UBAJARA (CE)";"CE";"UBAJARA";128;12;12;152
2004;"UMARI (CE)";"CE";"UMARI";4;0;2;6
2004;"UMIRIM (CE)";"CE";"UMIRIM";36;35;8;79
2004;"URUBURETAMA (CE)";"CE";"URUBURETAMA";58;6;2;66
2004;"URUOCA (CE)";"CE";"URUOCA";17;4;6;27
2004;"VARJOTA (CE)";"CE";"VARJOTA";67;19;3;89
2004;"VARZEA ALEGRE (CE)";"CE";"VARZEA ALEGRE";121;11;23;155
2004;"VICOSA DO CEARA (CE)";"CE";"VICOSA DO CEARA";172;8;10;190
2004;"BRASILIA (DF)";"DF";"BRASILIA";15123;4940;6131;26194
2004;"AFONSO CLAUDIO (ES)";"ES";"AFONSO CLAUDIO";370;11;92;473
2004;"AGUA DOCE DO NORTE (ES)";"ES";"AGUA DOCE DO NORTE";46;3;11;60
2004;"AGUIA BRANCA (ES)";"ES";"AGUIA BRANCA";84;2;20;106
2004;"ALEGRE (ES)";"ES";"ALEGRE";146;5;9;160
2004;"ALFREDO CHAVES (ES)";"ES";"ALFREDO CHAVES";297;7;24;328
2004;"ALTO RIO NOVO (ES)";"ES";"ALTO RIO NOVO";56;5;8;69
2004;"ANCHIETA (ES)";"ES";"ANCHIETA";162;25;19;206
2004;"APIACA (ES)";"ES";"APIACA";27;6;2;35
2004;"ARACRUZ (ES)";"ES";"ARACRUZ";748;77;222;1047
2004;"ATILIO VIVACQUA (ES)";"ES";"ATILIO VIVACQUA";139;7;13;159
2004;"BAIXO GUANDU (ES)";"ES";"BAIXO GUANDU";300;8;84;392
2004;"BARRA DE SAO FRANCISCO (ES)";"ES";"BARRA DE SAO FRANCISCO";326;8;56;390
2004;"BOA ESPERANCA (ES)";"ES";"BOA ESPERANCA";144;4;22;170
2004;"BOM JESUS DO NORTE (ES)";"ES";"BOM JESUS DO NORTE";124;12;18;154
2004;"BREJETUBA (ES)";"ES";"BREJETUBA";103;3;17;123
2004;"CACHOEIRO DE ITAPEMIRIM (ES)";"ES";"CACHOEIRO DE ITAPEMIRIM";3870;114;1844;5828
2004;"CARIACICA (ES)";"ES";"CARIACICA";3566;297;1306;5169
2004;"CASTELO (ES)";"ES";"CASTELO";1025;33;41;1099
2004;"COLATINA (ES)";"ES";"COLATINA";1809;44;359;2212
2004;"CONCEICAO DA BARRA (ES)";"ES";"CONCEICAO DA BARRA";129;6;77;212
2004;"CONCEICAO DO CASTELO (ES)";"ES";"CONCEICAO DO CASTELO";139;11;24;174
2004;"DIVINO DE SAO LOURENCO (ES)";"ES";"DIVINO DE SAO LOURENCO";36;3;4;43
2004;"DOMINGOS MARTINS (ES)";"ES";"DOMINGOS MARTINS";668;38;43;749
2004;"DORES DO RIO PRETO (ES)";"ES";"DORES DO RIO PRETO";78;1;7;86
2004;"ECOPORANGA (ES)";"ES";"ECOPORANGA";82;6;50;138
2004;"FUNDAO (ES)";"ES";"FUNDAO";180;10;21;211
2004;"GOVERNADOR LINDENBERG (ES)";"ES";"GOVERNADOR LINDENBERG";92;3;1;96
2004;"GUACUI (ES)";"ES";"GUACUI";260;23;26;309
2004;"GUARAPARI (ES)";"ES";"GUARAPARI";689;97;127;913
2004;"IBATIBA (ES)";"ES";"IBATIBA";182;9;19;210
2004;"IBIRACU (ES)";"ES";"IBIRACU";282;15;25;322
2004;"IBITIRAMA (ES)";"ES";"IBITIRAMA";52;0;4;56
2004;"ICONHA (ES)";"ES";"ICONHA";584;7;16;607
2004;"IRUPI (ES)";"ES";"IRUPI";93;9;9;111
2004;"ITAGUACU (ES)";"ES";"ITAGUACU";176;5;45;226
2004;"ITAPEMIRIM (ES)";"ES";"ITAPEMIRIM";274;6;33;313
2004;"ITARANA (ES)";"ES";"ITARANA";223;12;36;271
2004;"IUNA (ES)";"ES";"IUNA";252;7;43;302
2004;"JAGUARE (ES)";"ES";"JAGUARE";274;7;46;327
2004;"JERONIMO MONTEIRO (ES)";"ES";"JERONIMO MONTEIRO";58;2;8;68
2004;"JOAO NEIVA (ES)";"ES";"JOAO NEIVA";250;8;26;284
2004;"LARANJA DA TERRA (ES)";"ES";"LARANJA DA TERRA";188;3;18;209
2004;"LINHARES (ES)";"ES";"LINHARES";2101;47;227;2375
2004;"MANTENOPOLIS (ES)";"ES";"MANTENOPOLIS";90;4;13;107
2004;"MARATAIZES (ES)";"ES";"MARATAIZES";455;16;30;501
2004;"MARECHAL FLORIANO (ES)";"ES";"MARECHAL FLORIANO";460;11;6;477
2004;"MARILANDIA (ES)";"ES";"MARILANDIA";226;2;16;244
2004;"MIMOSO DO SUL (ES)";"ES";"MIMOSO DO SUL";151;6;27;184
2004;"MONTANHA (ES)";"ES";"MONTANHA";124;8;17;149
2004;"MUCURICI (ES)";"ES";"MUCURICI";42;7;14;63
2004;"MUNIZ FREIRE (ES)";"ES";"MUNIZ FREIRE";109;9;27;145
2004;"MUQUI (ES)";"ES";"MUQUI";91;7;16;114
2004;"NOVA VENECIA (ES)";"ES";"NOVA VENECIA";595;9;122;726
2004;"PANCAS (ES)";"ES";"PANCAS";159;5;6;170
2004;"PEDRO CANARIO (ES)";"ES";"PEDRO CANARIO";251;9;128;388
2004;"PINHEIROS (ES)";"ES";"PINHEIROS";179;7;65;251
2004;"PIUMA (ES)";"ES";"PIUMA";121;32;10;163
2004;"PONTO BELO (ES)";"ES";"PONTO BELO";27;3;3;33
2004;"PRESIDENTE KENNEDY (ES)";"ES";"PRESIDENTE KENNEDY";156;21;16;193
2004;"RIO BANANAL (ES)";"ES";"RIO BANANAL";379;7;22;408
2004;"RIO NOVO DO SUL (ES)";"ES";"RIO NOVO DO SUL";180;5;14;199
2004;"SANTA LEOPOLDINA (ES)";"ES";"SANTA LEOPOLDINA";205;10;17;232
2004;"SANTA MARIA DE JETIBA (ES)";"ES";"SANTA MARIA DE JETIBA";1105;26;38;1169
2004;"SANTA TERESA (ES)";"ES";"SANTA TERESA";504;11;35;550
2004;"SAO DOMINGOS DO NORTE (ES)";"ES";"SAO DOMINGOS DO NORTE";128;3;6;137
2004;"SAO GABRIEL DA PALHA (ES)";"ES";"SAO GABRIEL DA PALHA";434;11;55;500
2004;"SAO JOSE DO CALCADO (ES)";"ES";"SAO JOSE DO CALCADO";64;1;10;75
2004;"SAO MATEUS (ES)";"ES";"SAO MATEUS";710;48;219;977
2004;"SAO ROQUE DO CANAA (ES)";"ES";"SAO ROQUE DO CANAA";204;6;9;219
2004;"SERRA (ES)";"ES";"SERRA";4718;226;1200;6144
2004;"SOORETAMA (ES)";"ES";"SOORETAMA";172;4;36;212
2004;"VARGEM ALTA (ES)";"ES";"VARGEM ALTA";260;6;27;293
2004;"VENDA NOVA DO IMIGRANTE (ES)";"ES";"VENDA NOVA DO IMIGRANTE";501;11;77;589
2004;"VIANA (ES)";"ES";"VIANA";593;25;163;781
2004;"VILA PAVAO (ES)";"ES";"VILA PAVAO";78;3;11;92
2004;"VILA VALERIO (ES)";"ES";"VILA VALERIO";228;2;16;246
2004;"VILA VELHA (ES)";"ES";"VILA VELHA";3105;537;665;4307
2004;"VITORIA (ES)";"ES";"VITORIA";2592;647;795;4034
2004;"ABADIA DE GOIAS (GO)";"GO";"ABADIA DE GOIAS";25;1;3;29
2004;"ABADIANIA (GO)";"GO";"ABADIANIA";127;7;14;148
2004;"ACREUNA (GO)";"GO";"ACREUNA";337;6;48;391
2004;"ADELANDIA (GO)";"GO";"ADELANDIA";10;0;0;10
2004;"AGUA FRIA DE GOIAS (GO)";"GO";"AGUA FRIA DE GOIAS";25;2;2;29
2004;"AGUA LIMPA (GO)";"GO";"AGUA LIMPA";13;2;1;16
2004;"AGUAS LINDAS DE GOIAS (GO)";"GO";"AGUAS LINDAS DE GOIAS";174;20;184;378
2004;"ALEXANIA (GO)";"GO";"ALEXANIA";267;14;13;294
2004;"ALOANDIA (GO)";"GO";"ALOANDIA";19;3;1;23
2004;"ALTO HORIZONTE (GO)";"GO";"ALTO HORIZONTE";8;2;2;12
2004;"ALTO PARAISO DE GOIAS (GO)";"GO";"ALTO PARAISO DE GOIAS";36;5;4;45
2004;"ALVORADA DO NORTE (GO)";"GO";"ALVORADA DO NORTE";75;3;2;80
2004;"AMARALINA (GO)";"GO";"AMARALINA";4;1;3;8
2004;"AMERICANO DO BRASIL (GO)";"GO";"AMERICANO DO BRASIL";22;1;8;31
2004;"AMORINOPOLIS (GO)";"GO";"AMORINOPOLIS";13;0;6;19
2004;"ANAPOLIS (GO)";"GO";"ANAPOLIS";6814;163;1024;8001
2004;"ANHANGUERA (GO)";"GO";"ANHANGUERA";6;2;1;9
2004;"ANICUNS (GO)";"GO";"ANICUNS";205;9;39;253
2004;"APARECIDA DE GOIANIA (GO)";"GO";"APARECIDA DE GOIANIA";2382;108;392;2882
2004;"APARECIDA DO RIO DOCE (GO)";"GO";"APARECIDA DO RIO DOCE";42;0;6;48
2004;"APORE (GO)";"GO";"APORE";38;3;6;47
2004;"ARACU (GO)";"GO";"ARACU";13;2;1;16
2004;"ARAGARCAS (GO)";"GO";"ARAGARCAS";459;6;13;478
2004;"ARAGOIANIA (GO)";"GO";"ARAGOIANIA";29;0;2;31
2004;"ARAGUAPAZ (GO)";"GO";"ARAGUAPAZ";56;2;4;62
2004;"ARENOPOLIS (GO)";"GO";"ARENOPOLIS";8;1;2;11
2004;"ARUANA (GO)";"GO";"ARUANA";15;1;6;22
2004;"AURILANDIA (GO)";"GO";"AURILANDIA";19;3;1;23
2004;"AVELINOPOLIS (GO)";"GO";"AVELINOPOLIS";20;1;1;22
2004;"BALIZA (GO)";"GO";"BALIZA";2;1;1;4
2004;"BARRO ALTO (GO)";"GO";"BARRO ALTO";51;3;9;63
2004;"BELA VISTA DE GOIAS (GO)";"GO";"BELA VISTA DE GOIAS";192;7;22;221
2004;"BOM JARDIM DE GOIAS (GO)";"GO";"BOM JARDIM DE GOIAS";62;4;7;73
2004;"BOM JESUS DE GOIAS (GO)";"GO";"BOM JESUS DE GOIAS";343;5;20;368
2004;"BONFINOPOLIS (GO)";"GO";"BONFINOPOLIS";23;1;9;33
2004;"BONOPOLIS (GO)";"GO";"BONOPOLIS";7;1;2;10
2004;"BRAZABRANTES (GO)";"GO";"BRAZABRANTES";17;3;2;22
2004;"BRITANIA (GO)";"GO";"BRITANIA";55;1;1;57
2004;"BURITI ALEGRE (GO)";"GO";"BURITI ALEGRE";130;5;1;136
2004;"BURITI DE GOIAS (GO)";"GO";"BURITI DE GOIAS";10;5;0;15
2004;"BURITINOPOLIS (GO)";"GO";"BURITINOPOLIS";9;1;3;13
2004;"CABECEIRAS (GO)";"GO";"CABECEIRAS";43;2;13;58
2004;"CACHOEIRA ALTA (GO)";"GO";"CACHOEIRA ALTA";96;8;10;114
2004;"CACHOEIRA DE GOIAS (GO)";"GO";"CACHOEIRA DE GOIAS";4;1;0;5
2004;"CACHOEIRA DOURADA (GO)";"GO";"CACHOEIRA DOURADA";69;4;12;85
2004;"CACU (GO)";"GO";"CACU";165;2;16;183
2004;"CAIAPONIA (GO)";"GO";"CAIAPONIA";97;3;4;104
2004;"CALDAS NOVAS (GO)";"GO";"CALDAS NOVAS";450;32;58;540
2004;"CALDAZINHA (GO)";"GO";"CALDAZINHA";26;1;2;29
2004;"CAMPESTRE DE GOIAS (GO)";"GO";"CAMPESTRE DE GOIAS";16;1;2;19
2004;"CAMPINACU (GO)";"GO";"CAMPINACU";3;0;2;5
2004;"CAMPINORTE (GO)";"GO";"CAMPINORTE";82;2;8;92
2004;"CAMPO ALEGRE DE GOIAS (GO)";"GO";"CAMPO ALEGRE DE GOIAS";83;3;8;94
2004;"CAMPO LIMPO DE GOIAS (GO)";"GO";"CAMPO LIMPO DE GOIAS";43;0;2;45
2004;"CAMPOS BELOS (GO)";"GO";"CAMPOS BELOS";125;3;17;145
2004;"CAMPOS VERDES (GO)";"GO";"CAMPOS VERDES";18;3;2;23
2004;"CARMO DO RIO VERDE (GO)";"GO";"CARMO DO RIO VERDE";45;3;27;75
2004;"CASTELANDIA (GO)";"GO";"CASTELANDIA";39;2;5;46
2004;"CATALAO (GO)";"GO";"CATALAO";1207;37;172;1416
2004;"CATURAI (GO)";"GO";"CATURAI";24;1;4;29
2004;"CAVALCANTE (GO)";"GO";"CAVALCANTE";12;1;2;15
2004;"CERES (GO)";"GO";"CERES";402;11;21;434
2004;"CEZARINA (GO)";"GO";"CEZARINA";71;3;5;79
2004;"CHAPADAO DO CEU (GO)";"GO";"CHAPADAO DO CEU";106;2;6;114
2004;"CIDADE OCIDENTAL (GO)";"GO";"CIDADE OCIDENTAL";53;9;38;100
2004;"COCALZINHO DE GOIAS (GO)";"GO";"COCALZINHO DE GOIAS";109;10;14;133
2004;"COLINAS DO SUL (GO)";"GO";"COLINAS DO SUL";3;1;2;6
2004;"CORREGO DO OURO (GO)";"GO";"CORREGO DO OURO";12;3;1;16
2004;"CORUMBA DE GOIAS (GO)";"GO";"CORUMBA DE GOIAS";64;4;7;75
2004;"CORUMBAIBA (GO)";"GO";"CORUMBAIBA";83;4;6;93
2004;"CRISTALINA (GO)";"GO";"CRISTALINA";521;9;87;617
2004;"CRISTIANOPOLIS (GO)";"GO";"CRISTIANOPOLIS";21;3;1;25
2004;"CRIXAS (GO)";"GO";"CRIXAS";56;4;17;77
2004;"CROMINIA (GO)";"GO";"CROMINIA";19;1;2;22
2004;"CUMARI (GO)";"GO";"CUMARI";11;2;0;13
2004;"DAMIANOPOLIS (GO)";"GO";"DAMIANOPOLIS";4;0;3;7
2004;"DAMOLANDIA (GO)";"GO";"DAMOLANDIA";17;1;3;21
2004;"DAVINOPOLIS (GO)";"GO";"DAVINOPOLIS";22;3;4;29
2004;"DIORAMA (GO)";"GO";"DIORAMA";8;2;4;14
2004;"DIVINOPOLIS DE GOIAS (GO)";"GO";"DIVINOPOLIS DE GOIAS";12;0;3;15
2004;"DOVERLANDIA (GO)";"GO";"DOVERLANDIA";77;2;17;96
2004;"EDEALINA (GO)";"GO";"EDEALINA";51;2;5;58
2004;"EDEIA (GO)";"GO";"EDEIA";132;1;7;140
2004;"ESTRELA DO NORTE (GO)";"GO";"ESTRELA DO NORTE";15;4;1;20
2004;"FAINA (GO)";"GO";"FAINA";22;0;6;28
2004;"FAZENDA NOVA (GO)";"GO";"FAZENDA NOVA";21;1;7;29
2004;"FIRMINOPOLIS (GO)";"GO";"FIRMINOPOLIS";49;0;3;52
2004;"FLORES DE GOIAS (GO)";"GO";"FLORES DE GOIAS";19;2;6;27
2004;"FORMOSA (GO)";"GO";"FORMOSA";1583;50;267;1900
2004;"FORMOSO (GO)";"GO";"FORMOSO";31;1;4;36
2004;"GAMELEIRA DE GOIAS (GO)";"GO";"GAMELEIRA DE GOIAS";17;5;8;30
2004;"GOIANAPOLIS (GO)";"GO";"GOIANAPOLIS";113;1;4;118
2004;"GOIANDIRA (GO)";"GO";"GOIANDIRA";28;2;2;32
2004;"GOIANESIA (GO)";"GO";"GOIANESIA";638;14;97;749
2004;"GOIANIA (GO)";"GO";"GOIANIA";20651;1501;4723;26875
2004;"GOIANIRA (GO)";"GO";"GOIANIRA";124;1;54;179
2004;"GOIAS (GO)";"GO";"GOIAS";169;5;24;198
2004;"GOIATUBA (GO)";"GO";"GOIATUBA";487;10;52;549
2004;"GOUVELANDIA (GO)";"GO";"GOUVELANDIA";42;3;7;52
2004;"GUAPO (GO)";"GO";"GUAPO";82;5;3;90
2004;"GUARAITA (GO)";"GO";"GUARAITA";11;1;0;12
2004;"GUARANI DE GOIAS (GO)";"GO";"GUARANI DE GOIAS";4;2;5;11
2004;"GUARINOS (GO)";"GO";"GUARINOS";2;3;2;7
2004;"HEITORAI (GO)";"GO";"HEITORAI";11;0;2;13
2004;"HIDROLANDIA (GO)";"GO";"HIDROLANDIA";130;10;9;149
2004;"HIDROLINA (GO)";"GO";"HIDROLINA";13;0;2;15
2004;"IACIARA (GO)";"GO";"IACIARA";95;2;10;107
2004;"INACIOLANDIA (GO)";"GO";"INACIOLANDIA";51;6;2;59
2004;"INDIARA (GO)";"GO";"INDIARA";110;6;21;137
2004;"INHUMAS (GO)";"GO";"INHUMAS";709;13;115;837
2004;"IPAMERI (GO)";"GO";"IPAMERI";179;4;35;218
2004;"IPIRANGA DE GOIAS (GO)";"GO";"IPIRANGA DE GOIAS";8;3;3;14
2004;"IPORA (GO)";"GO";"IPORA";292;9;29;330
2004;"ISRAELANDIA (GO)";"GO";"ISRAELANDIA";4;1;5;10
2004;"ITABERAI (GO)";"GO";"ITABERAI";393;12;27;432
2004;"ITAGUARI (GO)";"GO";"ITAGUARI";31;2;7;40
2004;"ITAGUARU (GO)";"GO";"ITAGUARU";43;5;5;53
2004;"ITAJA (GO)";"GO";"ITAJA";58;3;8;69
2004;"ITAPACI (GO)";"GO";"ITAPACI";142;3;29;174
2004;"ITAPIRAPUA (GO)";"GO";"ITAPIRAPUA";38;0;7;45
2004;"ITAPURANGA (GO)";"GO";"ITAPURANGA";208;8;27;243
2004;"ITARUMA (GO)";"GO";"ITARUMA";61;3;5;69
2004;"ITAUCU (GO)";"GO";"ITAUCU";54;2;7;63
2004;"ITUMBIARA (GO)";"GO";"ITUMBIARA";1539;72;128;1739
2004;"IVOLANDIA (GO)";"GO";"IVOLANDIA";6;2;3;11
2004;"JANDAIA (GO)";"GO";"JANDAIA";49;4;9;62
2004;"JARAGUA (GO)";"GO";"JARAGUA";195;7;21;223
2004;"JATAI (GO)";"GO";"JATAI";1450;29;110;1589
2004;"JAUPACI (GO)";"GO";"JAUPACI";15;2;2;19
2004;"JESUPOLIS (GO)";"GO";"JESUPOLIS";11;1;5;17
2004;"JOVIANIA (GO)";"GO";"JOVIANIA";119;4;6;129
2004;"JUSSARA (GO)";"GO";"JUSSARA";217;3;12;232
2004;"LAGOA SANTA (GO)";"GO";"LAGOA SANTA";4;2;0;6
2004;"LEOPOLDO DE BULHOES (GO)";"GO";"LEOPOLDO DE BULHOES";53;3;6;62
2004;"LUZIANIA (GO)";"GO";"LUZIANIA";1746;54;352;2152
2004;"MAIRIPOTABA (GO)";"GO";"MAIRIPOTABA";11;0;3;14
2004;"MAMBAI (GO)";"GO";"MAMBAI";34;3;5;42
2004;"MARA ROSA (GO)";"GO";"MARA ROSA";60;0;7;67
2004;"MARZAGAO (GO)";"GO";"MARZAGAO";22;2;1;25
2004;"MATRINCHA (GO)";"GO";"MATRINCHA";24;3;7;34
2004;"MAURILANDIA (GO)";"GO";"MAURILANDIA";212;2;44;258
2004;"MIMOSO DE GOIAS (GO)";"GO";"MIMOSO DE GOIAS";1;0;2;3
2004;"MINACU (GO)";"GO";"MINACU";214;17;27;258
2004;"MINEIROS (GO)";"GO";"MINEIROS";1041;15;51;1107
2004;"MOIPORA (GO)";"GO";"MOIPORA";5;1;2;8
2004;"MONTE ALEGRE DE GOIAS (GO)";"GO";"MONTE ALEGRE DE GOIAS";11;0;4;15
2004;"MONTES CLAROS DE GOIAS (GO)";"GO";"MONTES CLAROS DE GOIAS";35;2;5;42
2004;"MONTIVIDIU (GO)";"GO";"MONTIVIDIU";186;2;23;211
2004;"MONTIVIDIU DO NORTE (GO)";"GO";"MONTIVIDIU DO NORTE";10;2;4;16
2004;"MORRINHOS (GO)";"GO";"MORRINHOS";495;20;48;563
2004;"MORRO AGUDO DE GOIAS (GO)";"GO";"MORRO AGUDO DE GOIAS";7;2;1;10
2004;"MOSSAMEDES (GO)";"GO";"MOSSAMEDES";17;0;1;18
2004;"MOZARLANDIA (GO)";"GO";"MOZARLANDIA";100;2;15;117
2004;"MUNDO NOVO (GO)";"GO";"MUNDO NOVO";22;3;5;30
2004;"MUTUNOPOLIS (GO)";"GO";"MUTUNOPOLIS";17;1;3;21
2004;"NAZARIO (GO)";"GO";"NAZARIO";71;0;6;77
2004;"NEROPOLIS (GO)";"GO";"NEROPOLIS";258;16;13;287
2004;"NIQUELANDIA (GO)";"GO";"NIQUELANDIA";348;24;77;449
2004;"NOVA AMERICA (GO)";"GO";"NOVA AMERICA";10;2;2;14
2004;"NOVA AURORA (GO)";"GO";"NOVA AURORA";15;3;1;19
2004;"NOVA CRIXAS (GO)";"GO";"NOVA CRIXAS";43;2;12;57
2004;"NOVA GLORIA (GO)";"GO";"NOVA GLORIA";54;2;10;66
2004;"NOVA IGUACU DE GOIAS (GO)";"GO";"NOVA IGUACU DE GOIAS";8;2;4;14
2004;"NOVA ROMA (GO)";"GO";"NOVA ROMA";2;0;1;3
2004;"NOVA VENEZA (GO)";"GO";"NOVA VENEZA";178;3;11;192
2004;"NOVO BRASIL (GO)";"GO";"NOVO BRASIL";8;1;0;9
2004;"NOVO GAMA (GO)";"GO";"NOVO GAMA";162;21;49;232
2004;"NOVO PLANALTO (GO)";"GO";"NOVO PLANALTO";22;2;1;25
2004;"ORIZONA (GO)";"GO";"ORIZONA";116;5;26;147
2004;"OURO VERDE DE GOIAS (GO)";"GO";"OURO VERDE DE GOIAS";61;0;7;68
2004;"OUVIDOR (GO)";"GO";"OUVIDOR";73;5;7;85
2004;"PADRE BERNARDO (GO)";"GO";"PADRE BERNARDO";158;4;30;192
2004;"PALESTINA DE GOIAS (GO)";"GO";"PALESTINA DE GOIAS";19;6;2;27
2004;"PALMEIRAS DE GOIAS (GO)";"GO";"PALMEIRAS DE GOIAS";185;4;29;218
2004;"PALMELO (GO)";"GO";"PALMELO";12;1;1;14
2004;"PALMINOPOLIS (GO)";"GO";"PALMINOPOLIS";18;0;2;20
2004;"PANAMA (GO)";"GO";"PANAMA";15;0;4;19
2004;"PARANAIGUARA (GO)";"GO";"PARANAIGUARA";75;3;4;82
2004;"PARAUNA (GO)";"GO";"PARAUNA";116;4;14;134
2004;"PEROLANDIA (GO)";"GO";"PEROLANDIA";17;0;5;22
2004;"PETROLINA DE GOIAS (GO)";"GO";"PETROLINA DE GOIAS";90;2;13;105
2004;"PILAR DE GOIAS (GO)";"GO";"PILAR DE GOIAS";6;2;1;9
2004;"PIRACANJUBA (GO)";"GO";"PIRACANJUBA";224;6;18;248
2004;"PIRANHAS (GO)";"GO";"PIRANHAS";145;3;10;158
2004;"PIRENOPOLIS (GO)";"GO";"PIRENOPOLIS";179;3;17;199
2004;"PIRES DO RIO (GO)";"GO";"PIRES DO RIO";350;9;25;384
2004;"PLANALTINA (GO)";"GO";"PLANALTINA";218;13;293;524
2004;"PONTALINA (GO)";"GO";"PONTALINA";176;5;20;201
2004;"PORANGATU (GO)";"GO";"PORANGATU";395;3;31;429
2004;"PORTEIRAO (GO)";"GO";"PORTEIRAO";45;1;2;48
2004;"PORTELANDIA (GO)";"GO";"PORTELANDIA";35;7;2;44
2004;"POSSE (GO)";"GO";"POSSE";319;9;37;365
2004;"PROFESSOR JAMIL (GO)";"GO";"PROFESSOR JAMIL";21;0;2;23
2004;"QUIRINOPOLIS (GO)";"GO";"QUIRINOPOLIS";613;6;17;636
2004;"RIALMA (GO)";"GO";"RIALMA";223;7;18;248
2004;"RIANAPOLIS (GO)";"GO";"RIANAPOLIS";78;3;5;86
2004;"RIO QUENTE (GO)";"GO";"RIO QUENTE";26;11;4;41
2004;"RIO VERDE (GO)";"GO";"RIO VERDE";2271;86;263;2620
2004;"RUBIATABA (GO)";"GO";"RUBIATABA";185;4;28;217
2004;"SANCLERLANDIA (GO)";"GO";"SANCLERLANDIA";48;3;3;54
2004;"SANTA BARBARA DE GOIAS (GO)";"GO";"SANTA BARBARA DE GOIAS";63;3;5;71
2004;"SANTA CRUZ DE GOIAS (GO)";"GO";"SANTA CRUZ DE GOIAS";3;2;2;7
2004;"SANTA FE DE GOIAS (GO)";"GO";"SANTA FE DE GOIAS";25;0;2;27
2004;"SANTA HELENA DE GOIAS (GO)";"GO";"SANTA HELENA DE GOIAS";574;13;118;705
2004;"SANTA ISABEL (GO)";"GO";"SANTA ISABEL";6;2;1;9
2004;"SANTA RITA DO ARAGUAIA (GO)";"GO";"SANTA RITA DO ARAGUAIA";102;4;5;111
2004;"SANTA RITA DO NOVO DESTINO (GO)";"GO";"SANTA RITA DO NOVO DESTINO";12;0;13;25
2004;"SANTA ROSA DE GOIAS (GO)";"GO";"SANTA ROSA DE GOIAS";12;2;1;15
2004;"SANTA TEREZA DE GOIAS (GO)";"GO";"SANTA TEREZA DE GOIAS";27;1;3;31
2004;"SANTA TEREZINHA DE GOIAS (GO)";"GO";"SANTA TEREZINHA DE GOIAS";58;3;15;76
2004;"SANTO ANTONIO DA BARRA (GO)";"GO";"SANTO ANTONIO DA BARRA";15;1;7;23
2004;"SANTO ANTONIO DE GOIAS (GO)";"GO";"SANTO ANTONIO DE GOIAS";26;2;8;36
2004;"SANTO ANTONIO DO DESCOBERTO (GO)";"GO";"SANTO ANTONIO DO DESCOBERTO";180;13;132;325
2004;"SAO DOMINGOS (GO)";"GO";"SAO DOMINGOS";19;4;3;26
2004;"SAO FRANCISCO DE GOIAS (GO)";"GO";"SAO FRANCISCO DE GOIAS";27;2;6;35
2004;"SAO JOAO D ALIANCA (GO)";"GO";"SAO JOAO D ALIANCA";93;1;7;101
2004;"SAO JOAO DA PARAUNA (GO)";"GO";"SAO JOAO DA PARAUNA";5;1;3;9
2004;"SAO LUIS DE MONTES BELOS (GO)";"GO";"SAO LUIS DE MONTES BELOS";276;6;31;313
2004;"SAO LUIZ DO NORTE (GO)";"GO";"SAO LUIZ DO NORTE";17;2;3;22
2004;"SAO MIGUEL DO ARAGUAIA (GO)";"GO";"SAO MIGUEL DO ARAGUAIA";217;3;24;244
2004;"SAO MIGUEL DO PASSA QUATRO (GO)";"GO";"SAO MIGUEL DO PASSA QUATRO";24;0;3;27
2004;"SAO PATRICIO (GO)";"GO";"SAO PATRICIO";5;0;3;8
2004;"SAO SIMAO (GO)";"GO";"SAO SIMAO";107;6;16;129
2004;"SENADOR CANEDO (GO)";"GO";"SENADOR CANEDO";301;6;13;320
2004;"SERRANOPOLIS (GO)";"GO";"SERRANOPOLIS";78;3;6;87
2004;"SILVANIA (GO)";"GO";"SILVANIA";199;0;22;221
2004;"SIMOLANDIA (GO)";"GO";"SIMOLANDIA";63;1;5;69
2004;"SITIO D ABADIA (GO)";"GO";"SITIO D ABADIA";6;0;2;8
2004;"TAQUARAL DE GOIAS (GO)";"GO";"TAQUARAL DE GOIAS";12;1;2;15
2004;"TERESINA DE GOIAS (GO)";"GO";"TERESINA DE GOIAS";5;1;1;7
2004;"TEREZOPOLIS DE GOIAS (GO)";"GO";"TEREZOPOLIS DE GOIAS";45;2;9;56
2004;"TRES RANCHOS (GO)";"GO";"TRES RANCHOS";27;2;3;32
2004;"TRINDADE (GO)";"GO";"TRINDADE";563;21;86;670
2004;"TROMBAS (GO)";"GO";"TROMBAS";20;2;5;27
2004;"TURVANIA (GO)";"GO";"TURVANIA";36;2;3;41
2004;"TURVELANDIA (GO)";"GO";"TURVELANDIA";35;0;13;48
2004;"UIRAPURU (GO)";"GO";"UIRAPURU";6;2;1;9
2004;"URUACU (GO)";"GO";"URUACU";286;12;40;338
2004;"URUANA (GO)";"GO";"URUANA";189;0;5;194
2004;"URUTAI (GO)";"GO";"URUTAI";10;1;4;15
2004;"VALPARAISO DE GOIAS (GO)";"GO";"VALPARAISO DE GOIAS";298;133;71;502
2004;"VARJAO (GO)";"GO";"VARJAO";22;0;4;26
2004;"VIANOPOLIS (GO)";"GO";"VIANOPOLIS";249;3;8;260
2004;"VICENTINOPOLIS (GO)";"GO";"VICENTINOPOLIS";117;1;14;132
2004;"VILA BOA (GO)";"GO";"VILA BOA";5;2;1;8
2004;"VILA PROPICIO (GO)";"GO";"VILA PROPICIO";4;2;7;13
2004;"ACAILANDIA (MA)";"MA";"ACAILANDIA";602;15;100;717
2004;"AFONSO CUNHA (MA)";"MA";"AFONSO CUNHA";1;1;0;2
2004;"AGUA DOCE DO MARANHAO (MA)";"MA";"AGUA DOCE DO MARANHAO";2;2;0;4
2004;"ALCANTARA (MA)";"MA";"ALCANTARA";14;2;4;20
2004;"ALDEIAS ALTAS (MA)";"MA";"ALDEIAS ALTAS";7;2;2;11
2004;"ALTAMIRA DO MARANHAO (MA)";"MA";"ALTAMIRA DO MARANHAO";15;3;1;19
2004;"ALTO ALEGRE DO MARANHAO (MA)";"MA";"ALTO ALEGRE DO MARANHAO";13;6;0;19
2004;"ALTO ALEGRE DO PINDARE (MA)";"MA";"ALTO ALEGRE DO PINDARE";14;3;2;19
2004;"ALTO PARNAIBA (MA)";"MA";"ALTO PARNAIBA";15;1;2;18
2004;"AMAPA DO MARANHAO (MA)";"MA";"AMAPA DO MARANHAO";5;0;0;5
2004;"AMARANTE DO MARANHAO (MA)";"MA";"AMARANTE DO MARANHAO";35;1;4;40
2004;"ANAJATUBA (MA)";"MA";"ANAJATUBA";11;2;2;15
2004;"ANAPURUS (MA)";"MA";"ANAPURUS";13;1;1;15
2004;"APICUM ACU (MA)";"MA";"APICUM ACU";1;1;0;2
2004;"ARAGUANA (MA)";"MA";"ARAGUANA";4;1;1;6
2004;"ARAIOSES (MA)";"MA";"ARAIOSES";11;3;7;21
2004;"ARAME (MA)";"MA";"ARAME";62;4;0;66
2004;"ARARI (MA)";"MA";"ARARI";42;5;4;51
2004;"AXIXA (MA)";"MA";"AXIXA";8;5;2;15
2004;"BACABAL (MA)";"MA";"BACABAL";450;40;34;524
2004;"BACABEIRA (MA)";"MA";"BACABEIRA";30;1;1;32
2004;"BACURI (MA)";"MA";"BACURI";4;2;2;8
2004;"BACURITUBA (MA)";"MA";"BACURITUBA";2;1;0;3
2004;"BALSAS (MA)";"MA";"BALSAS";617;24;36;677
2004;"BARAO DE GRAJAU (MA)";"MA";"BARAO DE GRAJAU";12;1;2;15
2004;"BARRA DO CORDA (MA)";"MA";"BARRA DO CORDA";244;6;4;254
2004;"BARREIRINHAS (MA)";"MA";"BARREIRINHAS";17;7;10;34
2004;"BELA VISTA DO MARANHAO (MA)";"MA";"BELA VISTA DO MARANHAO";13;1;0;14
2004;"BELAGUA (MA)";"MA";"BELAGUA";3;3;2;8
2004;"BENEDITO LEITE (MA)";"MA";"BENEDITO LEITE";0;0;0;0
2004;"BEQUIMAO (MA)";"MA";"BEQUIMAO";34;4;5;43
2004;"BERNARDO DO MEARIM (MA)";"MA";"BERNARDO DO MEARIM";6;1;0;7
2004;"BOA VISTA DO GURUPI (MA)";"MA";"BOA VISTA DO GURUPI";2;1;1;4
2004;"BOM JARDIM (MA)";"MA";"BOM JARDIM";37;2;4;43
2004;"BOM JESUS DAS SELVAS (MA)";"MA";"BOM JESUS DAS SELVAS";46;3;2;51
2004;"BOM LUGAR (MA)";"MA";"BOM LUGAR";9;1;5;15
2004;"BREJO (MA)";"MA";"BREJO";33;6;4;43
2004;"BREJO DE AREIA (MA)";"MA";"BREJO DE AREIA";14;3;1;18
2004;"BURITI (MA)";"MA";"BURITI";4;1;2;7
2004;"BURITI BRAVO (MA)";"MA";"BURITI BRAVO";16;1;0;17
2004;"BURITICUPU (MA)";"MA";"BURITICUPU";122;8;4;134
2004;"BURITIRANA (MA)";"MA";"BURITIRANA";8;0;0;8
2004;"CACHOEIRA GRANDE (MA)";"MA";"CACHOEIRA GRANDE";2;1;0;3
2004;"CAJAPIO (MA)";"MA";"CAJAPIO";4;1;2;7
2004;"CAJARI (MA)";"MA";"CAJARI";0;0;0;0
2004;"CAMPESTRE DO MARANHAO (MA)";"MA";"CAMPESTRE DO MARANHAO";5;3;1;9
2004;"CANDIDO MENDES (MA)";"MA";"CANDIDO MENDES";2;1;0;3
2004;"CANTANHEDE (MA)";"MA";"CANTANHEDE";7;0;0;7
2004;"CAPINZAL DO NORTE (MA)";"MA";"CAPINZAL DO NORTE";10;8;1;19
2004;"CAROLINA (MA)";"MA";"CAROLINA";37;3;3;43
2004;"CARUTAPERA (MA)";"MA";"CARUTAPERA";11;2;5;18
2004;"CAXIAS (MA)";"MA";"CAXIAS";334;25;39;398
2004;"CEDRAL (MA)";"MA";"CEDRAL";3;0;3;6
2004;"CENTRAL DO MARANHAO (MA)";"MA";"CENTRAL DO MARANHAO";4;0;0;4
2004;"CENTRO DO GUILHERME (MA)";"MA";"CENTRO DO GUILHERME";3;1;0;4
2004;"CENTRO NOVO DO MARANHAO (MA)";"MA";"CENTRO NOVO DO MARANHAO";4;0;1;5
2004;"CHAPADINHA (MA)";"MA";"CHAPADINHA";146;22;6;174
2004;"CIDELANDIA (MA)";"MA";"CIDELANDIA";14;4;4;22
2004;"CODO (MA)";"MA";"CODO";315;8;8;331
2004;"COELHO NETO (MA)";"MA";"COELHO NETO";57;5;5;67
2004;"COLINAS (MA)";"MA";"COLINAS";55;6;2;63
2004;"CONCEICAO DO LAGO ACU (MA)";"MA";"CONCEICAO DO LAGO ACU";2;0;0;2
2004;"COROATA (MA)";"MA";"COROATA";91;16;6;113
2004;"CURURUPU (MA)";"MA";"CURURUPU";9;0;2;11
2004;"DAVINOPOLIS (MA)";"MA";"DAVINOPOLIS";5;0;0;5
2004;"DOM PEDRO (MA)";"MA";"DOM PEDRO";139;6;12;157
2004;"DUQUE BACELAR (MA)";"MA";"DUQUE BACELAR";0;1;2;3
2004;"ESPERANTINOPOLIS (MA)";"MA";"ESPERANTINOPOLIS";27;3;0;30
2004;"ESTREITO (MA)";"MA";"ESTREITO";28;2;1;31
2004;"FEIRA NOVA DO MARANHAO (MA)";"MA";"FEIRA NOVA DO MARANHAO";0;1;0;1
2004;"FERNANDO FALCAO (MA)";"MA";"FERNANDO FALCAO";13;1;2;16
2004;"FORMOSA DA SERRA NEGRA (MA)";"MA";"FORMOSA DA SERRA NEGRA";8;0;0;8
2004;"FORTALEZA DOS NOGUEIRAS (MA)";"MA";"FORTALEZA DOS NOGUEIRAS";11;1;1;13
2004;"FORTUNA (MA)";"MA";"FORTUNA";10;1;0;11
2004;"GODOFREDO VIANA (MA)";"MA";"GODOFREDO VIANA";3;1;2;6
2004;"GONCALVES DIAS (MA)";"MA";"GONCALVES DIAS";9;2;2;13
2004;"GOVERNADOR ARCHER (MA)";"MA";"GOVERNADOR ARCHER";11;4;2;17
2004;"GOVERNADOR EDISON LOBAO (MA)";"MA";"GOVERNADOR EDISON LOBAO";13;1;2;16
2004;"GOVERNADOR EUGENIO BARROS (MA)";"MA";"GOVERNADOR EUGENIO BARROS";11;2;4;17
2004;"GOVERNADOR LUIZ ROCHA (MA)";"MA";"GOVERNADOR LUIZ ROCHA";2;1;0;3
2004;"GOVERNADOR NEWTON BELLO (MA)";"MA";"GOVERNADOR NEWTON BELLO";9;0;1;10
2004;"GOVERNADOR NUNES FREIRE (MA)";"MA";"GOVERNADOR NUNES FREIRE";19;3;0;22
2004;"GRACA ARANHA (MA)";"MA";"GRACA ARANHA";9;4;1;14
2004;"GRAJAU (MA)";"MA";"GRAJAU";179;5;8;192
2004;"GUIMARAES (MA)";"MA";"GUIMARAES";5;2;1;8
2004;"HUMBERTO DE CAMPOS (MA)";"MA";"HUMBERTO DE CAMPOS";4;10;3;17
2004;"ICATU (MA)";"MA";"ICATU";7;2;3;12
2004;"IGARAPE DO MEIO (MA)";"MA";"IGARAPE DO MEIO";7;1;2;10
2004;"IGARAPE GRANDE (MA)";"MA";"IGARAPE GRANDE";35;10;4;49
2004;"IMPERATRIZ (MA)";"MA";"IMPERATRIZ";1723;59;187;1969
2004;"ITAIPAVA DO GRAJAU (MA)";"MA";"ITAIPAVA DO GRAJAU";6;1;0;7
2004;"ITAPECURU MIRIM (MA)";"MA";"ITAPECURU MIRIM";133;5;12;150
2004;"ITINGA DO MARANHAO (MA)";"MA";"ITINGA DO MARANHAO";67;4;1;72
2004;"JATOBA (MA)";"MA";"JATOBA";0;2;0;2
2004;"JENIPAPO DOS VIEIRAS (MA)";"MA";"JENIPAPO DOS VIEIRAS";15;0;1;16
2004;"JOAO LISBOA (MA)";"MA";"JOAO LISBOA";52;2;2;56
2004;"JOSELANDIA (MA)";"MA";"JOSELANDIA";27;3;3;33
2004;"JUNCO DO MARANHAO (MA)";"MA";"JUNCO DO MARANHAO";5;11;0;16
2004;"LAGO DA PEDRA (MA)";"MA";"LAGO DA PEDRA";121;15;2;138
2004;"LAGO DO JUNCO (MA)";"MA";"LAGO DO JUNCO";7;1;2;10
2004;"LAGO DOS RODRIGUES (MA)";"MA";"LAGO DOS RODRIGUES";18;2;2;22
2004;"LAGO VERDE (MA)";"MA";"LAGO VERDE";12;0;2;14
2004;"LAGOA DO MATO (MA)";"MA";"LAGOA DO MATO";2;0;1;3
2004;"LAGOA GRANDE DO MARANHAO (MA)";"MA";"LAGOA GRANDE DO MARANHAO";8;2;0;10
2004;"LAJEADO NOVO (MA)";"MA";"LAJEADO NOVO";0;2;0;2
2004;"LIMA CAMPOS (MA)";"MA";"LIMA CAMPOS";29;3;1;33
2004;"LORETO (MA)";"MA";"LORETO";1;1;1;3
2004;"LUIS DOMINGUES (MA)";"MA";"LUIS DOMINGUES";0;0;1;1
2004;"MAGALHAES DE ALMEIDA (MA)";"MA";"MAGALHAES DE ALMEIDA";2;2;1;5
2004;"MARACACUME (MA)";"MA";"MARACACUME";21;14;1;36
2004;"MARAJA DO SENA (MA)";"MA";"MARAJA DO SENA";4;2;0;6
2004;"MARANHAOZINHO (MA)";"MA";"MARANHAOZINHO";5;1;1;7
2004;"MATA ROMA (MA)";"MA";"MATA ROMA";19;1;6;26
2004;"MATINHA (MA)";"MA";"MATINHA";14;5;0;19
2004;"MATOES (MA)";"MA";"MATOES";7;1;3;11
2004;"MATOES DO NORTE (MA)";"MA";"MATOES DO NORTE";7;2;1;10
2004;"MILAGRES DO MARANHAO (MA)";"MA";"MILAGRES DO MARANHAO";3;2;1;6
2004;"MIRADOR (MA)";"MA";"MIRADOR";7;0;1;8
2004;"MIRANDA DO NORTE (MA)";"MA";"MIRANDA DO NORTE";46;2;4;52
2004;"MIRINZAL (MA)";"MA";"MIRINZAL";11;2;2;15
2004;"MONCAO (MA)";"MA";"MONCAO";3;5;2;10
2004;"MONTES ALTOS (MA)";"MA";"MONTES ALTOS";14;0;1;15
2004;"MORROS (MA)";"MA";"MORROS";2;3;2;7
2004;"NINA RODRIGUES (MA)";"MA";"NINA RODRIGUES";4;2;0;6
2004;"NOVA COLINAS (MA)";"MA";"NOVA COLINAS";2;0;1;3
2004;"NOVA IORQUE (MA)";"MA";"NOVA IORQUE";2;0;0;2
2004;"NOVA OLINDA DO MARANHAO (MA)";"MA";"NOVA OLINDA DO MARANHAO";16;9;0;25
2004;"OLHO D AGUA DAS CUNHAS (MA)";"MA";"OLHO D AGUA DAS CUNHAS";35;6;5;46
2004;"OLINDA NOVA DO MARANHAO (MA)";"MA";"OLINDA NOVA DO MARANHAO";5;2;0;7
2004;"PACO DO LUMIAR (MA)";"MA";"PACO DO LUMIAR";148;74;38;260
2004;"PALMEIRANDIA (MA)";"MA";"PALMEIRANDIA";4;1;4;9
2004;"PARAIBANO (MA)";"MA";"PARAIBANO";18;2;1;21
2004;"PARNARAMA (MA)";"MA";"PARNARAMA";11;0;0;11
2004;"PASSAGEM FRANCA (MA)";"MA";"PASSAGEM FRANCA";9;1;1;11
2004;"PASTOS BONS (MA)";"MA";"PASTOS BONS";33;3;1;37
2004;"PAULINO NEVES (MA)";"MA";"PAULINO NEVES";0;0;0;0
2004;"PAULO RAMOS (MA)";"MA";"PAULO RAMOS";31;2;0;33
2004;"PEDREIRAS (MA)";"MA";"PEDREIRAS";217;26;22;265
2004;"PEDRO DO ROSARIO (MA)";"MA";"PEDRO DO ROSARIO";11;0;1;12
2004;"PENALVA (MA)";"MA";"PENALVA";2;5;2;9
2004;"PERI MIRIM (MA)";"MA";"PERI MIRIM";10;4;4;18
2004;"PERITORO (MA)";"MA";"PERITORO";14;21;3;38
2004;"PINDARE MIRIM (MA)";"MA";"PINDARE MIRIM";54;3;11;68
2004;"PINHEIRO (MA)";"MA";"PINHEIRO";211;12;32;255
2004;"PIO XII (MA)";"MA";"PIO XII";47;4;1;52
2004;"PIRAPEMAS (MA)";"MA";"PIRAPEMAS";7;3;1;11
2004;"POCAO DE PEDRAS (MA)";"MA";"POCAO DE PEDRAS";24;5;3;32
2004;"PORTO FRANCO (MA)";"MA";"PORTO FRANCO";20;0;3;23
2004;"PORTO RICO DO MARANHAO (MA)";"MA";"PORTO RICO DO MARANHAO";1;0;1;2
2004;"PRESIDENTE DUTRA (MA)";"MA";"PRESIDENTE DUTRA";156;9;5;170
2004;"PRESIDENTE JUSCELINO (MA)";"MA";"PRESIDENTE JUSCELINO";4;0;2;6
2004;"PRESIDENTE MEDICI (MA)";"MA";"PRESIDENTE MEDICI";3;8;0;11
2004;"PRESIDENTE SARNEY (MA)";"MA";"PRESIDENTE SARNEY";1;0;1;2
2004;"PRESIDENTE VARGAS (MA)";"MA";"PRESIDENTE VARGAS";6;3;0;9
2004;"PRIMEIRA CRUZ (MA)";"MA";"PRIMEIRA CRUZ";0;1;0;1
2004;"RAPOSA (MA)";"MA";"RAPOSA";23;0;26;49
2004;"RIACHAO (MA)";"MA";"RIACHAO";13;1;3;17
2004;"RIBAMAR FIQUENE (MA)";"MA";"RIBAMAR FIQUENE";5;1;1;7
2004;"ROSARIO (MA)";"MA";"ROSARIO";98;5;10;113
2004;"SAMBAIBA (MA)";"MA";"SAMBAIBA";2;0;0;2
2004;"SANTA FILOMENA DO MARANHAO (MA)";"MA";"SANTA FILOMENA DO MARANHAO";2;2;0;4
2004;"SANTA HELENA (MA)";"MA";"SANTA HELENA";29;3;2;34
2004;"SANTA INES (MA)";"MA";"SANTA INES";311;64;56;431
2004;"SANTA LUZIA (MA)";"MA";"SANTA LUZIA";131;61;9;201
2004;"SANTA LUZIA DO PARUA (MA)";"MA";"SANTA LUZIA DO PARUA";48;9;2;59
2004;"SANTA QUITERIA DO MARANHAO (MA)";"MA";"SANTA QUITERIA DO MARANHAO";10;0;4;14
2004;"SANTA RITA (MA)";"MA";"SANTA RITA";42;3;1;46
2004;"SANTANA DO MARANHAO (MA)";"MA";"SANTANA DO MARANHAO";3;1;3;7
2004;"SANTO AMARO DO MARANHAO (MA)";"MA";"SANTO AMARO DO MARANHAO";0;3;0;3
2004;"SANTO ANTONIO DOS LOPES (MA)";"MA";"SANTO ANTONIO DOS LOPES";48;5;0;53
2004;"SAO BENEDITO DO RIO PRETO (MA)";"MA";"SAO BENEDITO DO RIO PRETO";8;6;1;15
2004;"SAO BENTO (MA)";"MA";"SAO BENTO";46;5;5;56
2004;"SAO BERNARDO (MA)";"MA";"SAO BERNARDO";30;0;6;36
2004;"SAO DOMINGOS DO AZEITAO (MA)";"MA";"SAO DOMINGOS DO AZEITAO";8;0;1;9
2004;"SAO DOMINGOS DO MARANHAO (MA)";"MA";"SAO DOMINGOS DO MARANHAO";68;3;1;72
2004;"SAO FELIX DE BALSAS (MA)";"MA";"SAO FELIX DE BALSAS";1;0;0;1
2004;"SAO FRANCISCO DO BREJAO (MA)";"MA";"SAO FRANCISCO DO BREJAO";21;1;1;23
2004;"SAO FRANCISCO DO MARANHAO (MA)";"MA";"SAO FRANCISCO DO MARANHAO";2;0;0;2
2004;"SAO JOAO BATISTA (MA)";"MA";"SAO JOAO BATISTA";15;5;4;24
2004;"SAO JOAO DO CARU (MA)";"MA";"SAO JOAO DO CARU";3;1;0;4
2004;"SAO JOAO DO PARAISO (MA)";"MA";"SAO JOAO DO PARAISO";3;0;1;4
2004;"SAO JOAO DO SOTER (MA)";"MA";"SAO JOAO DO SOTER";7;1;0;8
2004;"SAO JOAO DOS PATOS (MA)";"MA";"SAO JOAO DOS PATOS";67;1;0;68
2004;"SAO JOSE DE RIBAMAR (MA)";"MA";"SAO JOSE DE RIBAMAR";240;61;27;328
2004;"SAO JOSE DOS BASILIOS (MA)";"MA";"SAO JOSE DOS BASILIOS";4;0;1;5
2004;"SAO LUIS (MA)";"MA";"SAO LUIS";4499;684;2176;7359
2004;"SAO LUIS GONZAGA DO MARANHAO (MA)";"MA";"SAO LUIS GONZAGA DO MARANHAO";20;4;2;26
2004;"SAO MATEUS DO MARANHAO (MA)";"MA";"SAO MATEUS DO MARANHAO";58;27;8;93
2004;"SAO PEDRO DA AGUA BRANCA (MA)";"MA";"SAO PEDRO DA AGUA BRANCA";6;0;0;6
2004;"SAO PEDRO DOS CRENTES (MA)";"MA";"SAO PEDRO DOS CRENTES";0;1;0;1
2004;"SAO RAIMUNDO DAS MANGABEIRAS (MA)";"MA";"SAO RAIMUNDO DAS MANGABEIRAS";24;1;10;35
2004;"SAO RAIMUNDO DO DOCA BEZERRA (MA)";"MA";"SAO RAIMUNDO DO DOCA BEZERRA";11;0;0;11
2004;"SAO ROBERTO (MA)";"MA";"SAO ROBERTO";3;2;0;5
2004;"SAO VICENTE FERRER (MA)";"MA";"SAO VICENTE FERRER";13;1;2;16
2004;"SATUBINHA (MA)";"MA";"SATUBINHA";7;2;0;9
2004;"SENADOR ALEXANDRE COSTA (MA)";"MA";"SENADOR ALEXANDRE COSTA";10;2;0;12
2004;"SENADOR LA ROCQUE (MA)";"MA";"SENADOR LA ROCQUE";22;0;1;23
2004;"SERRANO DO MARANHAO (MA)";"MA";"SERRANO DO MARANHAO";0;0;1;1
2004;"SITIO NOVO (MA)";"MA";"SITIO NOVO";13;0;1;14
2004;"SUCUPIRA DO NORTE (MA)";"MA";"SUCUPIRA DO NORTE";8;1;1;10
2004;"SUCUPIRA DO RIACHAO (MA)";"MA";"SUCUPIRA DO RIACHAO";2;1;1;4
2004;"TASSO FRAGOSO (MA)";"MA";"TASSO FRAGOSO";13;1;1;15
2004;"TIMBIRAS (MA)";"MA";"TIMBIRAS";13;6;0;19
2004;"TIMON (MA)";"MA";"TIMON";258;29;32;319
2004;"TRIZIDELA DO VALE (MA)";"MA";"TRIZIDELA DO VALE";58;5;2;65
2004;"TUFILANDIA (MA)";"MA";"TUFILANDIA";2;4;0;6
2004;"TUNTUM (MA)";"MA";"TUNTUM";41;5;4;50
2004;"TURIACU (MA)";"MA";"TURIACU";8;1;1;10
2004;"TURILANDIA (MA)";"MA";"TURILANDIA";4;3;1;8
2004;"TUTOIA (MA)";"MA";"TUTOIA";9;1;3;13
2004;"URBANO SANTOS (MA)";"MA";"URBANO SANTOS";23;3;2;28
2004;"VARGEM GRANDE (MA)";"MA";"VARGEM GRANDE";49;1;2;52
2004;"VIANA (MA)";"MA";"VIANA";77;8;4;89
2004;"VILA NOVA DOS MARTIRIOS (MA)";"MA";"VILA NOVA DOS MARTIRIOS";3;1;0;4
2004;"VITORIA DO MEARIM (MA)";"MA";"VITORIA DO MEARIM";28;4;4;36
2004;"VITORINO FREIRE (MA)";"MA";"VITORINO FREIRE";74;5;3;82
2004;"ZE DOCA (MA)";"MA";"ZE DOCA";90;12;6;108
2004;"ABADIA DOS DOURADOS (MG)";"MG";"ABADIA DOS DOURADOS";74;16;4;94
2004;"ABAETE (MG)";"MG";"ABAETE";343;8;123;474
2004;"ABRE CAMPO (MG)";"MG";"ABRE CAMPO";88;8;36;132
2004;"ACAIACA (MG)";"MG";"ACAIACA";15;3;6;24
2004;"ACUCENA (MG)";"MG";"ACUCENA";21;2;20;43
2004;"AGUA BOA (MG)";"MG";"AGUA BOA";31;0;13;44
2004;"AGUA COMPRIDA (MG)";"MG";"AGUA COMPRIDA";29;4;5;38
2004;"AGUANIL (MG)";"MG";"AGUANIL";21;3;6;30
2004;"AGUAS FORMOSAS (MG)";"MG";"AGUAS FORMOSAS";56;7;10;73
2004;"AGUAS VERMELHAS (MG)";"MG";"AGUAS VERMELHAS";45;5;10;60
2004;"AIMORES (MG)";"MG";"AIMORES";139;9;17;165
2004;"AIURUOCA (MG)";"MG";"AIURUOCA";65;5;2;72
2004;"ALAGOA (MG)";"MG";"ALAGOA";11;0;7;18
2004;"ALBERTINA (MG)";"MG";"ALBERTINA";32;1;4;37
2004;"ALEM PARAIBA (MG)";"MG";"ALEM PARAIBA";1101;44;45;1190
2004;"ALFENAS (MG)";"MG";"ALFENAS";806;45;181;1032
2004;"ALFREDO VASCONCELOS (MG)";"MG";"ALFREDO VASCONCELOS";106;7;13;126
2004;"ALMENARA (MG)";"MG";"ALMENARA";134;11;46;191
2004;"ALPERCATA (MG)";"MG";"ALPERCATA";33;1;4;38
2004;"ALPINOPOLIS (MG)";"MG";"ALPINOPOLIS";310;5;24;339
2004;"ALTEROSA (MG)";"MG";"ALTEROSA";161;10;17;188
2004;"ALTO CAPARAO (MG)";"MG";"ALTO CAPARAO";39;4;2;45
2004;"ALTO JEQUITIBA (MG)";"MG";"ALTO JEQUITIBA";49;1;6;56
2004;"ALTO RIO DOCE (MG)";"MG";"ALTO RIO DOCE";60;6;14;80
2004;"ALVARENGA (MG)";"MG";"ALVARENGA";15;0;5;20
2004;"ALVINOPOLIS (MG)";"MG";"ALVINOPOLIS";114;8;21;143
2004;"ALVORADA DE MINAS (MG)";"MG";"ALVORADA DE MINAS";4;1;7;12
2004;"AMPARO DA SERRA (MG)";"MG";"AMPARO DA SERRA";19;2;9;30
2004;"ANDRADAS (MG)";"MG";"ANDRADAS";824;44;45;913
2004;"ANDRELANDIA (MG)";"MG";"ANDRELANDIA";102;8;3;113
2004;"ANGELANDIA (MG)";"MG";"ANGELANDIA";30;0;9;39
2004;"ANTONIO CARLOS (MG)";"MG";"ANTONIO CARLOS";106;5;7;118
2004;"ANTONIO DIAS (MG)";"MG";"ANTONIO DIAS";46;5;44;95
2004;"ANTONIO PRADO DE MINAS (MG)";"MG";"ANTONIO PRADO DE MINAS";7;0;4;11
2004;"ARACAI (MG)";"MG";"ARACAI";10;1;3;14
2004;"ARACITABA (MG)";"MG";"ARACITABA";9;2;1;12
2004;"ARACUAI (MG)";"MG";"ARACUAI";136;10;41;187
2004;"ARAGUARI (MG)";"MG";"ARAGUARI";1559;189;165;1913
2004;"ARANTINA (MG)";"MG";"ARANTINA";20;0;2;22
2004;"ARAPONGA (MG)";"MG";"ARAPONGA";28;1;7;36
2004;"ARAPORA (MG)";"MG";"ARAPORA";130;11;49;190
2004;"ARAPUA (MG)";"MG";"ARAPUA";31;1;10;42
2004;"ARAUJOS (MG)";"MG";"ARAUJOS";88;5;2;95
2004;"ARAXA (MG)";"MG";"ARAXA";1242;66;217;1525
2004;"ARCEBURGO (MG)";"MG";"ARCEBURGO";83;13;24;120
2004;"ARCOS (MG)";"MG";"ARCOS";755;36;106;897
2004;"AREADO (MG)";"MG";"AREADO";160;7;46;213
2004;"ARGIRITA (MG)";"MG";"ARGIRITA";16;3;2;21
2004;"ARICANDUVA (MG)";"MG";"ARICANDUVA";7;0;6;13
2004;"ARINOS (MG)";"MG";"ARINOS";91;7;26;124
2004;"ASTOLFO DUTRA (MG)";"MG";"ASTOLFO DUTRA";168;8;15;191
2004;"ATALEIA (MG)";"MG";"ATALEIA";53;8;14;75
2004;"AUGUSTO DE LIMA (MG)";"MG";"AUGUSTO DE LIMA";22;1;10;33
2004;"BAEPENDI (MG)";"MG";"BAEPENDI";281;13;13;307
2004;"BALDIM (MG)";"MG";"BALDIM";75;4;5;84
2004;"BAMBUI (MG)";"MG";"BAMBUI";326;10;58;394
2004;"BANDEIRA (MG)";"MG";"BANDEIRA";2;3;1;6
2004;"BANDEIRA DO SUL (MG)";"MG";"BANDEIRA DO SUL";97;14;4;115
2004;"BARAO DE COCAIS (MG)";"MG";"BARAO DE COCAIS";238;24;45;307
2004;"BARAO DE MONTE ALTO (MG)";"MG";"BARAO DE MONTE ALTO";11;6;3;20
2004;"BARBACENA (MG)";"MG";"BARBACENA";1243;169;157;1569
2004;"BARRA LONGA (MG)";"MG";"BARRA LONGA";40;1;5;46
2004;"BARROSO (MG)";"MG";"BARROSO";279;11;10;300
2004;"BELA VISTA DE MINAS (MG)";"MG";"BELA VISTA DE MINAS";78;12;9;99
2004;"BELMIRO BRAGA (MG)";"MG";"BELMIRO BRAGA";35;3;4;42
2004;"BELO HORIZONTE (MG)";"MG";"BELO HORIZONTE";23896;2852;6125;32873
2004;"BELO ORIENTE (MG)";"MG";"BELO ORIENTE";188;8;49;245
2004;"BELO VALE (MG)";"MG";"BELO VALE";59;3;12;74
2004;"BERILO (MG)";"MG";"BERILO";40;1;19;60
2004;"BERIZAL (MG)";"MG";"BERIZAL";4;1;3;8
2004;"BERTOPOLIS (MG)";"MG";"BERTOPOLIS";6;0;1;7
2004;"BETIM (MG)";"MG";"BETIM";2303;356;622;3281
2004;"BIAS FORTES (MG)";"MG";"BIAS FORTES";25;1;2;28
2004;"BICAS (MG)";"MG";"BICAS";177;12;20;209
2004;"BIQUINHAS (MG)";"MG";"BIQUINHAS";26;6;2;34
2004;"BOA ESPERANCA (MG)";"MG";"BOA ESPERANCA";433;18;86;537
2004;"BOCAINA DE MINAS (MG)";"MG";"BOCAINA DE MINAS";41;4;5;50
2004;"BOCAIUVA (MG)";"MG";"BOCAIUVA";236;13;50;299
2004;"BOM DESPACHO (MG)";"MG";"BOM DESPACHO";788;27;140;955
2004;"BOM JARDIM DE MINAS (MG)";"MG";"BOM JARDIM DE MINAS";61;5;8;74
2004;"BOM JESUS DA PENHA (MG)";"MG";"BOM JESUS DA PENHA";81;1;5;87
2004;"BOM JESUS DO AMPARO (MG)";"MG";"BOM JESUS DO AMPARO";41;3;4;48
2004;"BOM JESUS DO GALHO (MG)";"MG";"BOM JESUS DO GALHO";62;5;10;77
2004;"BOM REPOUSO (MG)";"MG";"BOM REPOUSO";127;3;4;134
2004;"BOM SUCESSO (MG)";"MG";"BOM SUCESSO";199;7;19;225
2004;"BONFIM (MG)";"MG";"BONFIM";72;5;13;90
2004;"BONFINOPOLIS DE MINAS (MG)";"MG";"BONFINOPOLIS DE MINAS";62;1;14;77
2004;"BONITO DE MINAS (MG)";"MG";"BONITO DE MINAS";14;2;7;23
2004;"BORDA DA MATA (MG)";"MG";"BORDA DA MATA";215;11;46;272
2004;"BOTELHOS (MG)";"MG";"BOTELHOS";192;21;21;234
2004;"BOTUMIRIM (MG)";"MG";"BOTUMIRIM";4;1;5;10
2004;"BRAS PIRES (MG)";"MG";"BRAS PIRES";22;6;3;31
2004;"BRASILANDIA DE MINAS (MG)";"MG";"BRASILANDIA DE MINAS";148;2;54;204
2004;"BRASILIA DE MINAS (MG)";"MG";"BRASILIA DE MINAS";117;7;53;177
2004;"BRASOPOLIS (MG)";"MG";"BRASOPOLIS";151;9;21;181
2004;"BRAUNAS (MG)";"MG";"BRAUNAS";7;2;7;16
2004;"BRUMADINHO (MG)";"MG";"BRUMADINHO";503;58;76;637
2004;"BUENO BRANDAO (MG)";"MG";"BUENO BRANDAO";117;9;22;148
2004;"BUENOPOLIS (MG)";"MG";"BUENOPOLIS";67;2;15;84
2004;"BUGRE (MG)";"MG";"BUGRE";16;0;4;20
2004;"BURITIS (MG)";"MG";"BURITIS";211;3;60;274
2004;"BURITIZEIRO (MG)";"MG";"BURITIZEIRO";128;3;35;166
2004;"CABECEIRA GRANDE (MG)";"MG";"CABECEIRA GRANDE";21;4;8;33
2004;"CABO VERDE (MG)";"MG";"CABO VERDE";152;7;16;175
2004;"CACHOEIRA DA PRATA (MG)";"MG";"CACHOEIRA DA PRATA";38;6;2;46
2004;"CACHOEIRA DE MINAS (MG)";"MG";"CACHOEIRA DE MINAS";102;16;10;128
2004;"CACHOEIRA DE PAJEU (MG)";"MG";"CACHOEIRA DE PAJEU";23;5;10;38
2004;"CACHOEIRA DOURADA (MG)";"MG";"CACHOEIRA DOURADA";11;6;3;20
2004;"CAETANOPOLIS (MG)";"MG";"CAETANOPOLIS";75;7;22;104
2004;"CAETE (MG)";"MG";"CAETE";345;37;53;435
2004;"CAIANA (MG)";"MG";"CAIANA";24;1;6;31
2004;"CAJURI (MG)";"MG";"CAJURI";28;2;5;35
2004;"CALDAS (MG)";"MG";"CALDAS";189;11;18;218
2004;"CAMACHO (MG)";"MG";"CAMACHO";41;3;4;48
2004;"CAMANDUCAIA (MG)";"MG";"CAMANDUCAIA";377;19;26;422
2004;"CAMBUI (MG)";"MG";"CAMBUI";357;16;74;447
2004;"CAMBUQUIRA (MG)";"MG";"CAMBUQUIRA";97;10;8;115
2004;"CAMPANARIO (MG)";"MG";"CAMPANARIO";5;2;2;9
2004;"CAMPANHA (MG)";"MG";"CAMPANHA";159;8;15;182
2004;"CAMPESTRE (MG)";"MG";"CAMPESTRE";338;17;30;385
2004;"CAMPINA VERDE (MG)";"MG";"CAMPINA VERDE";238;14;24;276
2004;"CAMPO AZUL (MG)";"MG";"CAMPO AZUL";1;0;4;5
2004;"CAMPO BELO (MG)";"MG";"CAMPO BELO";880;29;98;1007
2004;"CAMPO DO MEIO (MG)";"MG";"CAMPO DO MEIO";78;6;43;127
2004;"CAMPO FLORIDO (MG)";"MG";"CAMPO FLORIDO";76;11;27;114
2004;"CAMPOS ALTOS (MG)";"MG";"CAMPOS ALTOS";246;10;35;291
2004;"CAMPOS GERAIS (MG)";"MG";"CAMPOS GERAIS";199;9;40;248
2004;"CANA VERDE (MG)";"MG";"CANA VERDE";41;4;5;50
2004;"CANAA (MG)";"MG";"CANAA";36;1;6;43
2004;"CANAPOLIS (MG)";"MG";"CANAPOLIS";178;7;72;257
2004;"CANDEIAS (MG)";"MG";"CANDEIAS";174;10;19;203
2004;"CANTAGALO (MG)";"MG";"CANTAGALO";6;0;3;9
2004;"CAPARAO (MG)";"MG";"CAPARAO";28;1;3;32
2004;"CAPELA NOVA (MG)";"MG";"CAPELA NOVA";13;7;2;22
2004;"CAPELINHA (MG)";"MG";"CAPELINHA";387;11;86;484
2004;"CAPETINGA (MG)";"MG";"CAPETINGA";140;5;27;172
2004;"CAPIM BRANCO (MG)";"MG";"CAPIM BRANCO";50;7;10;67
2004;"CAPINOPOLIS (MG)";"MG";"CAPINOPOLIS";216;13;35;264
2004;"CAPITAO ANDRADE (MG)";"MG";"CAPITAO ANDRADE";18;1;2;21
2004;"CAPITAO ENEAS (MG)";"MG";"CAPITAO ENEAS";36;1;12;49
2004;"CAPITOLIO (MG)";"MG";"CAPITOLIO";115;11;8;134
2004;"CAPUTIRA (MG)";"MG";"CAPUTIRA";51;2;16;69
2004;"CARAI (MG)";"MG";"CARAI";28;14;20;62
2004;"CARANAIBA (MG)";"MG";"CARANAIBA";10;1;5;16
2004;"CARANDAI (MG)";"MG";"CARANDAI";358;15;66;439
2004;"CARANGOLA (MG)";"MG";"CARANGOLA";283;26;31;340
2004;"CARATINGA (MG)";"MG";"CARATINGA";904;24;1239;2167
2004;"CARBONITA (MG)";"MG";"CARBONITA";116;3;36;155
2004;"CAREACU (MG)";"MG";"CAREACU";63;5;4;72
2004;"CARLOS CHAGAS (MG)";"MG";"CARLOS CHAGAS";112;14;26;152
2004;"CARMESIA (MG)";"MG";"CARMESIA";39;3;798;840
2004;"CARMO DA CACHOEIRA (MG)";"MG";"CARMO DA CACHOEIRA";120;9;29;158
2004;"CARMO DA MATA (MG)";"MG";"CARMO DA MATA";88;7;30;125
2004;"CARMO DE MINAS (MG)";"MG";"CARMO DE MINAS";84;9;11;104
2004;"CARMO DO CAJURU (MG)";"MG";"CARMO DO CAJURU";211;8;43;262
2004;"CARMO DO PARANAIBA (MG)";"MG";"CARMO DO PARANAIBA";460;19;71;550
2004;"CARMO DO RIO CLARO (MG)";"MG";"CARMO DO RIO CLARO";237;17;53;307
2004;"CARMOPOLIS DE MINAS (MG)";"MG";"CARMOPOLIS DE MINAS";371;7;27;405
2004;"CARNEIRINHO (MG)";"MG";"CARNEIRINHO";124;22;39;185
2004;"CARRANCAS (MG)";"MG";"CARRANCAS";33;3;11;47
2004;"CARVALHOPOLIS (MG)";"MG";"CARVALHOPOLIS";32;9;2;43
2004;"CARVALHOS (MG)";"MG";"CARVALHOS";33;2;3;38
2004;"CASA GRANDE (MG)";"MG";"CASA GRANDE";17;1;1;19
2004;"CASCALHO RICO (MG)";"MG";"CASCALHO RICO";45;11;5;61
2004;"CASSIA (MG)";"MG";"CASSIA";326;11;24;361
2004;"CATAGUASES (MG)";"MG";"CATAGUASES";558;33;123;714
2004;"CATAS ALTAS (MG)";"MG";"CATAS ALTAS";72;7;6;85
2004;"CATAS ALTAS DA NORUEGA (MG)";"MG";"CATAS ALTAS DA NORUEGA";28;0;5;33
2004;"CATUJI (MG)";"MG";"CATUJI";19;5;3;27
2004;"CATUTI (MG)";"MG";"CATUTI";3;3;11;17
2004;"CAXAMBU (MG)";"MG";"CAXAMBU";177;17;19;213
2004;"CEDRO DO ABAETE (MG)";"MG";"CEDRO DO ABAETE";9;1;1;11
2004;"CENTRAL DE MINAS (MG)";"MG";"CENTRAL DE MINAS";47;5;9;61
2004;"CENTRALINA (MG)";"MG";"CENTRALINA";102;1;12;115
2004;"CHACARA (MG)";"MG";"CHACARA";19;4;1;24
2004;"CHALE (MG)";"MG";"CHALE";27;4;5;36
2004;"CHAPADA DO NORTE (MG)";"MG";"CHAPADA DO NORTE";20;7;12;39
2004;"CHAPADA GAUCHA (MG)";"MG";"CHAPADA GAUCHA";38;3;5;46
2004;"CHIADOR (MG)";"MG";"CHIADOR";23;2;5;30
2004;"CIPOTANEA (MG)";"MG";"CIPOTANEA";27;2;6;35
2004;"CLARAVAL (MG)";"MG";"CLARAVAL";226;5;21;252
2004;"CLARO DOS POCOES (MG)";"MG";"CLARO DOS POCOES";10;0;11;21
2004;"CLAUDIO (MG)";"MG";"CLAUDIO";484;15;33;532
2004;"COIMBRA (MG)";"MG";"COIMBRA";75;1;7;83
2004;"COLUNA (MG)";"MG";"COLUNA";20;0;9;29
2004;"COMENDADOR GOMES (MG)";"MG";"COMENDADOR GOMES";24;2;3;29
2004;"COMERCINHO (MG)";"MG";"COMERCINHO";16;3;9;28
2004;"CONCEICAO DA APARECIDA (MG)";"MG";"CONCEICAO DA APARECIDA";101;2;7;110
2004;"CONCEICAO DA BARRA DE MINAS (MG)";"MG";"CONCEICAO DA BARRA DE MINAS";23;5;5;33
2004;"CONCEICAO DAS ALAGOAS (MG)";"MG";"CONCEICAO DAS ALAGOAS";358;11;53;422
2004;"CONCEICAO DAS PEDRAS (MG)";"MG";"CONCEICAO DAS PEDRAS";17;3;2;22
2004;"CONCEICAO DE IPANEMA (MG)";"MG";"CONCEICAO DE IPANEMA";19;3;2;24
2004;"CONCEICAO DO MATO DENTRO (MG)";"MG";"CONCEICAO DO MATO DENTRO";70;3;49;122
2004;"CONCEICAO DO PARA (MG)";"MG";"CONCEICAO DO PARA";38;5;12;55
2004;"CONCEICAO DO RIO VERDE (MG)";"MG";"CONCEICAO DO RIO VERDE";163;18;13;194
2004;"CONCEICAO DOS OUROS (MG)";"MG";"CONCEICAO DOS OUROS";169;17;3;189
2004;"CONEGO MARINHO (MG)";"MG";"CONEGO MARINHO";5;2;3;10
2004;"CONFINS (MG)";"MG";"CONFINS";72;9;3;84
2004;"CONGONHAL (MG)";"MG";"CONGONHAL";158;3;9;170
2004;"CONGONHAS (MG)";"MG";"CONGONHAS";491;60;75;626
2004;"CONGONHAS DO NORTE (MG)";"MG";"CONGONHAS DO NORTE";15;2;1;18
2004;"CONQUISTA (MG)";"MG";"CONQUISTA";133;11;26;170
2004;"CONSELHEIRO LAFAIETE (MG)";"MG";"CONSELHEIRO LAFAIETE";889;126;287;1302
2004;"CONSELHEIRO PENA (MG)";"MG";"CONSELHEIRO PENA";158;2;37;197
2004;"CONSOLACAO (MG)";"MG";"CONSOLACAO";9;2;0;11
2004;"CONTAGEM (MG)";"MG";"CONTAGEM";8559;708;1505;10772
2004;"COQUEIRAL (MG)";"MG";"COQUEIRAL";77;4;8;89
2004;"CORACAO DE JESUS (MG)";"MG";"CORACAO DE JESUS";109;1;72;182
2004;"CORDISBURGO (MG)";"MG";"CORDISBURGO";53;2;7;62
2004;"CORDISLANDIA (MG)";"MG";"CORDISLANDIA";37;2;2;41
2004;"CORINTO (MG)";"MG";"CORINTO";201;2;43;246
2004;"COROACI (MG)";"MG";"COROACI";21;1;5;27
2004;"COROMANDEL (MG)";"MG";"COROMANDEL";416;16;68;500
2004;"CORONEL FABRICIANO (MG)";"MG";"CORONEL FABRICIANO";772;88;294;1154
2004;"CORONEL MURTA (MG)";"MG";"CORONEL MURTA";9;0;6;15
2004;"CORONEL PACHECO (MG)";"MG";"CORONEL PACHECO";26;3;7;36
2004;"CORONEL XAVIER CHAVES (MG)";"MG";"CORONEL XAVIER CHAVES";69;1;2;72
2004;"CORREGO DANTA (MG)";"MG";"CORREGO DANTA";21;2;6;29
2004;"CORREGO DO BOM JESUS (MG)";"MG";"CORREGO DO BOM JESUS";24;4;6;34
2004;"CORREGO FUNDO (MG)";"MG";"CORREGO FUNDO";251;4;11;266
2004;"CORREGO NOVO (MG)";"MG";"CORREGO NOVO";8;3;3;14
2004;"COUTO DE MAGALHAES DE MINAS (MG)";"MG";"COUTO DE MAGALHAES DE MINAS";31;1;6;38
2004;"CRISOLITA (MG)";"MG";"CRISOLITA";7;3;7;17
2004;"CRISTAIS (MG)";"MG";"CRISTAIS";98;4;10;112
2004;"CRISTALIA (MG)";"MG";"CRISTALIA";7;0;8;15
2004;"CRISTIANO OTONI (MG)";"MG";"CRISTIANO OTONI";72;4;6;82
2004;"CRISTINA (MG)";"MG";"CRISTINA";70;12;9;91
2004;"CRUCILANDIA (MG)";"MG";"CRUCILANDIA";79;3;6;88
2004;"CRUZEIRO DA FORTALEZA (MG)";"MG";"CRUZEIRO DA FORTALEZA";38;3;3;44
2004;"CRUZILIA (MG)";"MG";"CRUZILIA";242;10;12;264
2004;"CUPARAQUE (MG)";"MG";"CUPARAQUE";31;4;3;38
2004;"CURRAL DE DENTRO (MG)";"MG";"CURRAL DE DENTRO";36;4;1;41
2004;"CURVELO (MG)";"MG";"CURVELO";778;16;137;931
2004;"DATAS (MG)";"MG";"DATAS";15;2;7;24
2004;"DELFIM MOREIRA (MG)";"MG";"DELFIM MOREIRA";69;1;12;82
2004;"DELFINOPOLIS (MG)";"MG";"DELFINOPOLIS";65;10;6;81
2004;"DELTA (MG)";"MG";"DELTA";270;12;93;375
2004;"DESCOBERTO (MG)";"MG";"DESCOBERTO";24;3;1;28
2004;"DESTERRO DE ENTRE RIOS (MG)";"MG";"DESTERRO DE ENTRE RIOS";65;4;13;82
2004;"DESTERRO DO MELO (MG)";"MG";"DESTERRO DO MELO";17;3;7;27
2004;"DIAMANTINA (MG)";"MG";"DIAMANTINA";218;31;179;428
2004;"DIOGO DE VASCONCELOS (MG)";"MG";"DIOGO DE VASCONCELOS";13;1;5;19
2004;"DIONISIO (MG)";"MG";"DIONISIO";32;4;11;47
2004;"DIVINESIA (MG)";"MG";"DIVINESIA";27;6;2;35
2004;"DIVINO (MG)";"MG";"DIVINO";194;8;18;220
2004;"DIVINO DAS LARANJEIRAS (MG)";"MG";"DIVINO DAS LARANJEIRAS";23;0;4;27
2004;"DIVINOLANDIA DE MINAS (MG)";"MG";"DIVINOLANDIA DE MINAS";31;3;13;47
2004;"DIVINOPOLIS (MG)";"MG";"DIVINOPOLIS";2537;156;550;3243
2004;"DIVISA ALEGRE (MG)";"MG";"DIVISA ALEGRE";31;0;5;36
2004;"DIVISA NOVA (MG)";"MG";"DIVISA NOVA";41;6;9;56
2004;"DIVISOPOLIS (MG)";"MG";"DIVISOPOLIS";8;5;4;17
2004;"DOM BOSCO (MG)";"MG";"DOM BOSCO";12;3;11;26
2004;"DOM CAVATI (MG)";"MG";"DOM CAVATI";93;4;2;99
2004;"DOM JOAQUIM (MG)";"MG";"DOM JOAQUIM";4;2;4;10
2004;"DOM SILVERIO (MG)";"MG";"DOM SILVERIO";36;6;3;45
2004;"DOM VICOSO (MG)";"MG";"DOM VICOSO";15;10;5;30
2004;"DONA EUZEBIA (MG)";"MG";"DONA EUZEBIA";237;2;2;241
2004;"DORES DE CAMPOS (MG)";"MG";"DORES DE CAMPOS";49;4;16;69
2004;"DORES DE GUANHAES (MG)";"MG";"DORES DE GUANHAES";42;0;12;54
2004;"DORES DO INDAIA (MG)";"MG";"DORES DO INDAIA";187;10;9;206
2004;"DORES DO TURVO (MG)";"MG";"DORES DO TURVO";26;2;12;40
2004;"DORESOPOLIS (MG)";"MG";"DORESOPOLIS";7;6;1;14
2004;"DOURADOQUARA (MG)";"MG";"DOURADOQUARA";21;5;0;26
2004;"DURANDE (MG)";"MG";"DURANDE";45;1;9;55
2004;"ELOI MENDES (MG)";"MG";"ELOI MENDES";373;21;20;414
2004;"ENGENHEIRO CALDAS (MG)";"MG";"ENGENHEIRO CALDAS";87;5;2;94
2004;"ENGENHEIRO NAVARRO (MG)";"MG";"ENGENHEIRO NAVARRO";28;0;11;39
2004;"ENTRE RIOS DE MINAS (MG)";"MG";"ENTRE RIOS DE MINAS";161;10;27;198
2004;"ENTRE FOLHAS (MG)";"MG";"ENTRE FOLHAS";41;2;2;45
2004;"ERVALIA (MG)";"MG";"ERVALIA";189;4;18;211
2004;"ESMERALDAS (MG)";"MG";"ESMERALDAS";258;9;114;381
2004;"ESPERA FELIZ (MG)";"MG";"ESPERA FELIZ";238;15;22;275
2004;"ESPINOSA (MG)";"MG";"ESPINOSA";257;6;32;295
2004;"ESPIRITO SANTO DO DOURADO (MG)";"MG";"ESPIRITO SANTO DO DOURADO";52;0;4;56
2004;"ESTIVA (MG)";"MG";"ESTIVA";204;3;12;219
2004;"ESTRELA DALVA (MG)";"MG";"ESTRELA DALVA";20;1;0;21
2004;"ESTRELA DO INDAIA (MG)";"MG";"ESTRELA DO INDAIA";31;3;2;36
2004;"ESTRELA DO SUL (MG)";"MG";"ESTRELA DO SUL";71;3;11;85
2004;"EUGENOPOLIS (MG)";"MG";"EUGENOPOLIS";50;8;15;73
2004;"EWBANK DA CAMARA (MG)";"MG";"EWBANK DA CAMARA";34;2;4;40
2004;"EXTREMA (MG)";"MG";"EXTREMA";342;35;39;416
2004;"FAMA (MG)";"MG";"FAMA";8;5;1;14
2004;"FARIA LEMOS (MG)";"MG";"FARIA LEMOS";17;4;0;21
2004;"FELICIO DOS SANTOS (MG)";"MG";"FELICIO DOS SANTOS";12;4;11;27
2004;"FELISBURGO (MG)";"MG";"FELISBURGO";7;3;4;14
2004;"FELIXLANDIA (MG)";"MG";"FELIXLANDIA";135;3;33;171
2004;"FERNANDES TOURINHO (MG)";"MG";"FERNANDES TOURINHO";6;2;4;12
2004;"FERROS (MG)";"MG";"FERROS";63;3;26;92
2004;"FERVEDOURO (MG)";"MG";"FERVEDOURO";56;5;5;66
2004;"FLORESTAL (MG)";"MG";"FLORESTAL";43;3;13;59
2004;"FORMIGA (MG)";"MG";"FORMIGA";1140;36;168;1344
2004;"FORMOSO (MG)";"MG";"FORMOSO";27;0;12;39
2004;"FORTALEZA DE MINAS (MG)";"MG";"FORTALEZA DE MINAS";44;6;4;54
2004;"FORTUNA DE MINAS (MG)";"MG";"FORTUNA DE MINAS";14;3;5;22
2004;"FRANCISCO BADARO (MG)";"MG";"FRANCISCO BADARO";26;0;11;37
2004;"FRANCISCO DUMONT (MG)";"MG";"FRANCISCO DUMONT";31;1;13;45
2004;"FRANCISCO SA (MG)";"MG";"FRANCISCO SA";80;5;27;112
2004;"FRANCISCOPOLIS (MG)";"MG";"FRANCISCOPOLIS";6;2;4;12
2004;"FREI GASPAR (MG)";"MG";"FREI GASPAR";12;1;5;18
2004;"FREI INOCENCIO (MG)";"MG";"FREI INOCENCIO";106;6;18;130
2004;"FREI LAGONEGRO (MG)";"MG";"FREI LAGONEGRO";3;2;2;7
2004;"FRONTEIRA (MG)";"MG";"FRONTEIRA";196;14;34;244
2004;"FRONTEIRA DOS VALES (MG)";"MG";"FRONTEIRA DOS VALES";7;1;1;9
2004;"FRUTA DE LEITE (MG)";"MG";"FRUTA DE LEITE";13;1;13;27
2004;"FRUTAL (MG)";"MG";"FRUTAL";1097;56;102;1255
2004;"FUNILANDIA (MG)";"MG";"FUNILANDIA";26;2;7;35
2004;"GALILEIA (MG)";"MG";"GALILEIA";49;0;7;56
2004;"GAMELEIRAS (MG)";"MG";"GAMELEIRAS";16;0;8;24
2004;"GLAUCILANDIA (MG)";"MG";"GLAUCILANDIA";1;1;3;5
2004;"GOIABEIRA (MG)";"MG";"GOIABEIRA";19;5;3;27
2004;"GOIANA (MG)";"MG";"GOIANA";15;3;1;19
2004;"GONCALVES (MG)";"MG";"GONCALVES";61;12;4;77
2004;"GONZAGA (MG)";"MG";"GONZAGA";17;4;6;27
2004;"GOUVEA (MG)";"MG";"GOUVEA";103;4;14;121
2004;"GOVERNADOR VALADARES (MG)";"MG";"GOVERNADOR VALADARES";2450;150;299;2899
2004;"GRAO MOGOL (MG)";"MG";"GRAO MOGOL";33;0;43;76
2004;"GRUPIARA (MG)";"MG";"GRUPIARA";7;0;2;9
2004;"GUANHAES (MG)";"MG";"GUANHAES";271;20;82;373
2004;"GUAPE (MG)";"MG";"GUAPE";121;5;34;160
2004;"GUARACIABA (MG)";"MG";"GUARACIABA";39;3;14;56
2004;"GUARACIAMA (MG)";"MG";"GUARACIAMA";11;0;6;17
2004;"GUARANESIA (MG)";"MG";"GUARANESIA";257;14;60;331
2004;"GUARANI (MG)";"MG";"GUARANI";76;5;9;90
2004;"GUARARA (MG)";"MG";"GUARARA";44;7;1;52
2004;"GUARDA MOR (MG)";"MG";"GUARDA MOR";66;9;9;84
2004;"GUAXUPE (MG)";"MG";"GUAXUPE";637;35;83;755
2004;"GUIDOVAL (MG)";"MG";"GUIDOVAL";91;0;3;94
2004;"GUIMARANIA (MG)";"MG";"GUIMARANIA";102;4;9;115
2004;"GUIRICEMA (MG)";"MG";"GUIRICEMA";133;4;12;149
2004;"GURINHATA (MG)";"MG";"GURINHATA";79;5;14;98
2004;"HELIODORA (MG)";"MG";"HELIODORA";45;4;5;54
2004;"IAPU (MG)";"MG";"IAPU";86;8;12;106
2004;"IBERTIOGA (MG)";"MG";"IBERTIOGA";29;4;2;35
2004;"IBIA (MG)";"MG";"IBIA";292;15;55;362
2004;"IBIAI (MG)";"MG";"IBIAI";41;2;3;46
2004;"IBIRACATU (MG)";"MG";"IBIRACATU";3;2;5;10
2004;"IBIRACI (MG)";"MG";"IBIRACI";334;21;24;379
2004;"IBIRITE (MG)";"MG";"IBIRITE";589;59;176;824
2004;"IBITIURA DE MINAS (MG)";"MG";"IBITIURA DE MINAS";57;2;2;61
2004;"IBITURUNA (MG)";"MG";"IBITURUNA";21;5;1;27
2004;"ICARAI DE MINAS (MG)";"MG";"ICARAI DE MINAS";7;2;1;10
2004;"IGARAPE (MG)";"MG";"IGARAPE";442;25;77;544
2004;"IGARATINGA (MG)";"MG";"IGARATINGA";227;4;12;243
2004;"IGUATAMA (MG)";"MG";"IGUATAMA";104;4;11;119
2004;"IJACI (MG)";"MG";"IJACI";75;2;5;82
2004;"ILICINEA (MG)";"MG";"ILICINEA";133;3;21;157
2004;"IMBE DE MINAS (MG)";"MG";"IMBE DE MINAS";20;1;4;25
2004;"INCONFIDENTES (MG)";"MG";"INCONFIDENTES";60;9;7;76
2004;"INDAIABIRA (MG)";"MG";"INDAIABIRA";19;4;13;36
2004;"INDIANOPOLIS (MG)";"MG";"INDIANOPOLIS";45;20;10;75
2004;"INGAI (MG)";"MG";"INGAI";15;4;4;23
2004;"INHAPIM (MG)";"MG";"INHAPIM";187;5;34;226
2004;"INHAUMA (MG)";"MG";"INHAUMA";53;1;10;64
2004;"INIMUTABA (MG)";"MG";"INIMUTABA";18;2;3;23
2004;"IPABA (MG)";"MG";"IPABA";42;5;17;64
2004;"IPANEMA (MG)";"MG";"IPANEMA";139;9;17;165
2004;"IPATINGA (MG)";"MG";"IPATINGA";2151;316;400;2867
2004;"IPIACU (MG)";"MG";"IPIACU";37;3;5;45
2004;"IPUIUNA (MG)";"MG";"IPUIUNA";265;9;7;281
2004;"IRAI DE MINAS (MG)";"MG";"IRAI DE MINAS";138;11;17;166
2004;"ITABIRA (MG)";"MG";"ITABIRA";946;127;235;1308
2004;"ITABIRINHA DE MANTENA (MG)";"MG";"ITABIRINHA DE MANTENA";80;1;19;100
2004;"ITABIRITO (MG)";"MG";"ITABIRITO";538;49;123;710
2004;"ITACAMBIRA (MG)";"MG";"ITACAMBIRA";8;0;5;13
2004;"ITACARAMBI (MG)";"MG";"ITACARAMBI";52;4;16;72
2004;"ITAGUARA (MG)";"MG";"ITAGUARA";276;5;28;309
2004;"ITAIPE (MG)";"MG";"ITAIPE";35;4;11;50
2004;"ITAJUBA (MG)";"MG";"ITAJUBA";742;68;103;913
2004;"ITAMARANDIBA (MG)";"MG";"ITAMARANDIBA";376;8;54;438
2004;"ITAMARATI DE MINAS (MG)";"MG";"ITAMARATI DE MINAS";61;5;10;76
2004;"ITAMBACURI (MG)";"MG";"ITAMBACURI";125;5;22;152
2004;"ITAMBE DO MATO DENTRO (MG)";"MG";"ITAMBE DO MATO DENTRO";11;1;2;14
2004;"ITAMOGI (MG)";"MG";"ITAMOGI";169;8;16;193
2004;"ITAMONTE (MG)";"MG";"ITAMONTE";224;16;20;260
2004;"ITANHANDU (MG)";"MG";"ITANHANDU";227;20;22;269
2004;"ITANHOMI (MG)";"MG";"ITANHOMI";64;1;12;77
2004;"ITAOBIM (MG)";"MG";"ITAOBIM";152;16;19;187
2004;"ITAPAGIPE (MG)";"MG";"ITAPAGIPE";204;1;16;221
2004;"ITAPECERICA (MG)";"MG";"ITAPECERICA";243;16;45;304
2004;"ITAPEVA (MG)";"MG";"ITAPEVA";183;3;6;192
2004;"ITATIAIUCU (MG)";"MG";"ITATIAIUCU";192;5;13;210
2004;"ITAU DE MINAS (MG)";"MG";"ITAU DE MINAS";250;11;31;292
2004;"ITAUNA (MG)";"MG";"ITAUNA";1092;70;169;1331
2004;"ITAVERAVA (MG)";"MG";"ITAVERAVA";23;0;6;29
2004;"ITINGA (MG)";"MG";"ITINGA";24;9;10;43
2004;"ITUETA (MG)";"MG";"ITUETA";38;0;9;47
2004;"ITUIUTABA (MG)";"MG";"ITUIUTABA";1081;91;156;1328
2004;"ITUMIRIM (MG)";"MG";"ITUMIRIM";50;4;4;58
2004;"ITURAMA (MG)";"MG";"ITURAMA";547;25;127;699
2004;"ITUTINGA (MG)";"MG";"ITUTINGA";39;7;2;48
2004;"JABOTICATUBAS (MG)";"MG";"JABOTICATUBAS";114;6;25;145
2004;"JACINTO (MG)";"MG";"JACINTO";16;3;11;30
2004;"JACUI (MG)";"MG";"JACUI";87;9;10;106
2004;"JACUTINGA (MG)";"MG";"JACUTINGA";261;20;34;315
2004;"JAGUARACU (MG)";"MG";"JAGUARACU";19;2;3;24
2004;"JAIBA (MG)";"MG";"JAIBA";160;4;24;188
2004;"JAMPRUCA (MG)";"MG";"JAMPRUCA";6;1;11;18
2004;"JANAUBA (MG)";"MG";"JANAUBA";509;9;60;578
2004;"JANUARIA (MG)";"MG";"JANUARIA";203;8;51;262
2004;"JAPARAIBA (MG)";"MG";"JAPARAIBA";39;2;14;55
2004;"JAPONVAR (MG)";"MG";"JAPONVAR";3;0;8;11
2004;"JECEABA (MG)";"MG";"JECEABA";25;5;5;35
2004;"JENIPAPO DE MINAS (MG)";"MG";"JENIPAPO DE MINAS";11;3;7;21
2004;"JEQUERI (MG)";"MG";"JEQUERI";42;5;25;72
2004;"JEQUITAI (MG)";"MG";"JEQUITAI";43;3;8;54
2004;"JEQUITIBA (MG)";"MG";"JEQUITIBA";30;2;15;47
2004;"JEQUITINHONHA (MG)";"MG";"JEQUITINHONHA";40;6;13;59
2004;"JESUANIA (MG)";"MG";"JESUANIA";51;5;4;60
2004;"JOAIMA (MG)";"MG";"JOAIMA";40;4;14;58
2004;"JOANESIA (MG)";"MG";"JOANESIA";10;3;5;18
2004;"JOAO MONLEVADE (MG)";"MG";"JOAO MONLEVADE";710;54;163;927
2004;"JOAO PINHEIRO (MG)";"MG";"JOAO PINHEIRO";612;9;116;737
2004;"JOAQUIM FELICIO (MG)";"MG";"JOAQUIM FELICIO";25;1;6;32
2004;"JORDANIA (MG)";"MG";"JORDANIA";10;8;6;24
2004;"JOSE GONCALVES DE MINAS (MG)";"MG";"JOSE GONCALVES DE MINAS";17;5;5;27
2004;"JOSE RAYDAN (MG)";"MG";"JOSE RAYDAN";16;1;6;23
2004;"JOSENOPOLIS (MG)";"MG";"JOSENOPOLIS";11;2;2;15
2004;"JUATUBA (MG)";"MG";"JUATUBA";145;17;147;309
2004;"JUIZ DE FORA (MG)";"MG";"JUIZ DE FORA";3807;392;1141;5340
2004;"JURAMENTO (MG)";"MG";"JURAMENTO";9;1;6;16
2004;"JURUAIA (MG)";"MG";"JURUAIA";43;6;10;59
2004;"JUVENILIA (MG)";"MG";"JUVENILIA";7;2;7;16
2004;"LADAINHA (MG)";"MG";"LADAINHA";27;7;11;45
2004;"LAGAMAR (MG)";"MG";"LAGAMAR";56;6;12;74
2004;"LAGOA DA PRATA (MG)";"MG";"LAGOA DA PRATA";482;26;144;652
2004;"LAGOA DOS PATOS (MG)";"MG";"LAGOA DOS PATOS";24;1;5;30
2004;"LAGOA DOURADA (MG)";"MG";"LAGOA DOURADA";203;5;28;236
2004;"LAGOA FORMOSA (MG)";"MG";"LAGOA FORMOSA";167;8;60;235
2004;"LAGOA GRANDE (MG)";"MG";"LAGOA GRANDE";68;1;31;100
2004;"LAGOA SANTA (MG)";"MG";"LAGOA SANTA";537;53;80;670
2004;"LAJINHA (MG)";"MG";"LAJINHA";144;9;23;176
2004;"LAMBARI (MG)";"MG";"LAMBARI";225;20;21;266
2004;"LAMIM (MG)";"MG";"LAMIM";24;2;2;28
2004;"LARANJAL (MG)";"MG";"LARANJAL";117;3;2;122
2004;"LASSANCE (MG)";"MG";"LASSANCE";31;2;6;39
2004;"LAVRAS (MG)";"MG";"LAVRAS";804;84;150;1038
2004;"LEANDRO FERREIRA (MG)";"MG";"LEANDRO FERREIRA";33;2;3;38
2004;"LEME DO PRADO (MG)";"MG";"LEME DO PRADO";16;4;16;36
2004;"LEOPOLDINA (MG)";"MG";"LEOPOLDINA";529;36;50;615
2004;"LIBERDADE (MG)";"MG";"LIBERDADE";60;1;5;66
2004;"LIMA DUARTE (MG)";"MG";"LIMA DUARTE";151;7;28;186
2004;"LIMEIRA DO OESTE (MG)";"MG";"LIMEIRA DO OESTE";78;5;24;107
2004;"LONTRA (MG)";"MG";"LONTRA";7;1;3;11
2004;"LUISBURGO (MG)";"MG";"LUISBURGO";13;1;19;33
2004;"LUISLANDIA (MG)";"MG";"LUISLANDIA";2;3;2;7
2004;"LUMINARIAS (MG)";"MG";"LUMINARIAS";82;4;18;104
2004;"LUZ (MG)";"MG";"LUZ";250;27;19;296
2004;"MACHACALIS (MG)";"MG";"MACHACALIS";15;1;5;21
2004;"MACHADO (MG)";"MG";"MACHADO";573;46;73;692
2004;"MADRE DE DEUS DE MINAS (MG)";"MG";"MADRE DE DEUS DE MINAS";45;1;3;49
2004;"MALACACHETA (MG)";"MG";"MALACACHETA";66;1;25;92
2004;"MAMONAS (MG)";"MG";"MAMONAS";45;1;6;52
2004;"MANGA (MG)";"MG";"MANGA";82;5;23;110
2004;"MANHUACU (MG)";"MG";"MANHUACU";968;35;89;1092
2004;"MANHUMIRIM (MG)";"MG";"MANHUMIRIM";228;19;25;272
2004;"MANTENA (MG)";"MG";"MANTENA";457;13;52;522
2004;"MAR DE ESPANHA (MG)";"MG";"MAR DE ESPANHA";121;9;8;138
2004;"MARAVILHAS (MG)";"MG";"MARAVILHAS";130;4;3;137
2004;"MARIA DA FE (MG)";"MG";"MARIA DA FE";198;10;18;226
2004;"MARIANA (MG)";"MG";"MARIANA";315;72;146;533
2004;"MARILAC (MG)";"MG";"MARILAC";4;3;2;9
2004;"MARIO CAMPOS (MG)";"MG";"MARIO CAMPOS";126;5;8;139
2004;"MARIPA DE MINAS (MG)";"MG";"MARIPA DE MINAS";25;5;2;32
2004;"MARLIERIA (MG)";"MG";"MARLIERIA";20;2;8;30
2004;"MARMELOPOLIS (MG)";"MG";"MARMELOPOLIS";17;5;5;27
2004;"MARTINHO CAMPOS (MG)";"MG";"MARTINHO CAMPOS";274;13;45;332
2004;"MARTINS SOARES (MG)";"MG";"MARTINS SOARES";35;2;9;46
2004;"MATA VERDE (MG)";"MG";"MATA VERDE";11;1;2;14
2004;"MATERLANDIA (MG)";"MG";"MATERLANDIA";9;1;5;15
2004;"MATEUS LEME (MG)";"MG";"MATEUS LEME";287;33;52;372
2004;"MATHIAS LOBATO (MG)";"MG";"MATHIAS LOBATO";28;2;4;34
2004;"MATIAS BARBOSA (MG)";"MG";"MATIAS BARBOSA";248;10;23;281
2004;"MATIAS CARDOSO (MG)";"MG";"MATIAS CARDOSO";8;1;2;11
2004;"MATIPO (MG)";"MG";"MATIPO";171;8;14;193
2004;"MATO VERDE (MG)";"MG";"MATO VERDE";97;3;16;116
2004;"MATOZINHOS (MG)";"MG";"MATOZINHOS";233;28;65;326
2004;"MATUTINA (MG)";"MG";"MATUTINA";58;5;4;67
2004;"MEDEIROS (MG)";"MG";"MEDEIROS";19;1;2;22
2004;"MEDINA (MG)";"MG";"MEDINA";88;10;21;119
2004;"MENDES PIMENTEL (MG)";"MG";"MENDES PIMENTEL";20;2;10;32
2004;"MERCES (MG)";"MG";"MERCES";80;4;12;96
2004;"MESQUITA (MG)";"MG";"MESQUITA";18;1;4;23
2004;"MINAS NOVAS (MG)";"MG";"MINAS NOVAS";62;13;48;123
2004;"MINDURI (MG)";"MG";"MINDURI";37;3;4;44
2004;"MIRABELA (MG)";"MG";"MIRABELA";64;2;15;81
2004;"MIRADOURO (MG)";"MG";"MIRADOURO";74;3;16;93
2004;"MIRAI (MG)";"MG";"MIRAI";111;10;10;131
2004;"MIRAVANIA (MG)";"MG";"MIRAVANIA";7;0;4;11
2004;"MOEDA (MG)";"MG";"MOEDA";43;2;9;54
2004;"MOEMA (MG)";"MG";"MOEMA";105;5;98;208
2004;"MONJOLOS (MG)";"MG";"MONJOLOS";4;1;5;10
2004;"MONSENHOR PAULO (MG)";"MG";"MONSENHOR PAULO";108;6;5;119
2004;"MONTALVANIA (MG)";"MG";"MONTALVANIA";70;2;30;102
2004;"MONTE ALEGRE DE MINAS (MG)";"MG";"MONTE ALEGRE DE MINAS";413;6;24;443
2004;"MONTE AZUL (MG)";"MG";"MONTE AZUL";122;7;25;154
2004;"MONTE BELO (MG)";"MG";"MONTE BELO";179;7;36;222
2004;"MONTE CARMELO (MG)";"MG";"MONTE CARMELO";970;28;74;1072
2004;"MONTE FORMOSO (MG)";"MG";"MONTE FORMOSO";6;2;6;14
2004;"MONTE SANTO DE MINAS (MG)";"MG";"MONTE SANTO DE MINAS";363;13;62;438
2004;"MONTE SIAO (MG)";"MG";"MONTE SIAO";182;15;28;225
2004;"MONTES CLAROS (MG)";"MG";"MONTES CLAROS";3074;113;779;3966
2004;"MONTEZUMA (MG)";"MG";"MONTEZUMA";19;2;15;36
2004;"MORADA NOVA DE MINAS (MG)";"MG";"MORADA NOVA DE MINAS";76;8;16;100
2004;"MORRO DA GARCA (MG)";"MG";"MORRO DA GARCA";37;1;14;52
2004;"MORRO DO PILAR (MG)";"MG";"MORRO DO PILAR";19;3;1;23
2004;"MUNHOZ (MG)";"MG";"MUNHOZ";55;5;8;68
2004;"MURIAE (MG)";"MG";"MURIAE";1012;54;125;1191
2004;"MUTUM (MG)";"MG";"MUTUM";119;7;26;152
2004;"MUZAMBINHO (MG)";"MG";"MUZAMBINHO";242;20;25;287
2004;"NACIP RAYDAN (MG)";"MG";"NACIP RAYDAN";3;1;2;6
2004;"NANUQUE (MG)";"MG";"NANUQUE";457;32;113;602
2004;"NAQUE (MG)";"MG";"NAQUE";16;0;21;37
2004;"NATALANDIA (MG)";"MG";"NATALANDIA";8;2;10;20
2004;"NATERCIA (MG)";"MG";"NATERCIA";59;3;11;73
2004;"NAZARENO (MG)";"MG";"NAZARENO";107;8;14;129
2004;"NEPOMUCENO (MG)";"MG";"NEPOMUCENO";322;7;43;372
2004;"NINHEIRA (MG)";"MG";"NINHEIRA";13;2;10;25
2004;"NOVA BELEM (MG)";"MG";"NOVA BELEM";24;4;4;32
2004;"NOVA ERA (MG)";"MG";"NOVA ERA";134;14;69;217
2004;"NOVA LIMA (MG)";"MG";"NOVA LIMA";565;130;113;808
2004;"NOVA MODICA (MG)";"MG";"NOVA MODICA";10;3;8;21
2004;"NOVA PONTE (MG)";"MG";"NOVA PONTE";127;33;44;204
2004;"NOVA PORTEIRINHA (MG)";"MG";"NOVA PORTEIRINHA";19;2;9;30
2004;"NOVA RESENDE (MG)";"MG";"NOVA RESENDE";221;8;24;253
2004;"NOVA SERRANA (MG)";"MG";"NOVA SERRANA";264;20;36;320
2004;"NOVA UNIAO (MG)";"MG";"NOVA UNIAO";88;5;9;102
2004;"NOVO CRUZEIRO (MG)";"MG";"NOVO CRUZEIRO";75;13;46;134
2004;"NOVO ORIENTE DE MINAS (MG)";"MG";"NOVO ORIENTE DE MINAS";21;5;8;34
2004;"NOVORIZONTE (MG)";"MG";"NOVORIZONTE";26;0;8;34
2004;"OLARIA (MG)";"MG";"OLARIA";14;5;3;22
2004;"OLHOS D AGUA (MG)";"MG";"OLHOS D AGUA";22;5;22;49
2004;"OLIMPIO NORONHA (MG)";"MG";"OLIMPIO NORONHA";21;7;4;32
2004;"OLIVEIRA (MG)";"MG";"OLIVEIRA";578;25;55;658
2004;"OLIVEIRA FORTES (MG)";"MG";"OLIVEIRA FORTES";15;1;2;18
2004;"ONCA DE PITANGUI (MG)";"MG";"ONCA DE PITANGUI";16;3;7;26
2004;"ORATORIOS (MG)";"MG";"ORATORIOS";26;1;13;40
2004;"ORIZANIA (MG)";"MG";"ORIZANIA";25;3;6;34
2004;"OURO BRANCO (MG)";"MG";"OURO BRANCO";294;42;130;466
2004;"OURO FINO (MG)";"MG";"OURO FINO";391;16;56;463
2004;"OURO PRETO (MG)";"MG";"OURO PRETO";667;94;278;1039
2004;"OURO VERDE DE MINAS (MG)";"MG";"OURO VERDE DE MINAS";13;1;3;17
2004;"PADRE CARVALHO (MG)";"MG";"PADRE CARVALHO";6;1;4;11
2004;"PADRE PARAISO (MG)";"MG";"PADRE PARAISO";65;43;33;141
2004;"PAI PEDRO (MG)";"MG";"PAI PEDRO";10;5;15;30
2004;"PAINEIRAS (MG)";"MG";"PAINEIRAS";76;8;13;97
2004;"PAINS (MG)";"MG";"PAINS";182;10;13;205
2004;"PAIVA (MG)";"MG";"PAIVA";11;1;2;14
2004;"PALMA (MG)";"MG";"PALMA";61;3;3;67
2004;"PALMOPOLIS (MG)";"MG";"PALMOPOLIS";10;4;3;17
2004;"PAPAGAIOS (MG)";"MG";"PAPAGAIOS";460;7;38;505
2004;"PARA DE MINAS (MG)";"MG";"PARA DE MINAS";1375;92;171;1638
2004;"PARACATU (MG)";"MG";"PARACATU";895;28;206;1129
2004;"PARAGUACU (MG)";"MG";"PARAGUACU";228;22;18;268
2004;"PARAISOPOLIS (MG)";"MG";"PARAISOPOLIS";296;27;19;342
2004;"PARAOPEBA (MG)";"MG";"PARAOPEBA";338;14;34;386
2004;"PASSA QUATRO (MG)";"MG";"PASSA QUATRO";259;15;13;287
2004;"PASSA TEMPO (MG)";"MG";"PASSA TEMPO";104;13;12;129
2004;"PASSA VINTE (MG)";"MG";"PASSA VINTE";14;5;5;24
2004;"PASSABEM (MG)";"MG";"PASSABEM";5;0;1;6
2004;"PASSOS (MG)";"MG";"PASSOS";1351;61;244;1656
2004;"PATIS (MG)";"MG";"PATIS";1;0;7;8
2004;"PATOS DE MINAS (MG)";"MG";"PATOS DE MINAS";1976;69;1458;3503
2004;"PATROCINIO (MG)";"MG";"PATROCINIO";1158;29;327;1514
2004;"PATROCINIO DO MURIAE (MG)";"MG";"PATROCINIO DO MURIAE";43;2;3;48
2004;"PAULA CANDIDO (MG)";"MG";"PAULA CANDIDO";43;3;9;55
2004;"PAULISTAS (MG)";"MG";"PAULISTAS";13;2;9;24
2004;"PAVAO (MG)";"MG";"PAVAO";21;5;7;33
2004;"PECANHA (MG)";"MG";"PECANHA";96;3;38;137
2004;"PEDRA AZUL (MG)";"MG";"PEDRA AZUL";116;6;29;151
2004;"PEDRA BONITA (MG)";"MG";"PEDRA BONITA";13;6;5;24
2004;"PEDRA DO ANTA (MG)";"MG";"PEDRA DO ANTA";12;1;10;23
2004;"PEDRA DO INDAIA (MG)";"MG";"PEDRA DO INDAIA";48;0;3;51
2004;"PEDRA DOURADA (MG)";"MG";"PEDRA DOURADA";9;2;2;13
2004;"PEDRALVA (MG)";"MG";"PEDRALVA";118;7;13;138
2004;"PEDRAS DE MARIA DA CRUZ (MG)";"MG";"PEDRAS DE MARIA DA CRUZ";7;2;17;26
2004;"PEDRINOPOLIS (MG)";"MG";"PEDRINOPOLIS";57;6;6;69
2004;"PEDRO LEOPOLDO (MG)";"MG";"PEDRO LEOPOLDO";684;78;133;895
2004;"PEDRO TEIXEIRA (MG)";"MG";"PEDRO TEIXEIRA";16;2;1;19
2004;"PEQUERI (MG)";"MG";"PEQUERI";53;9;4;66
2004;"PEQUI (MG)";"MG";"PEQUI";38;2;6;46
2004;"PERDIGAO (MG)";"MG";"PERDIGAO";93;9;2;104
2004;"PERDIZES (MG)";"MG";"PERDIZES";191;17;18;226
2004;"PERDOES (MG)";"MG";"PERDOES";377;12;33;422
2004;"PERIQUITO (MG)";"MG";"PERIQUITO";20;2;21;43
2004;"PESCADOR (MG)";"MG";"PESCADOR";12;3;3;18
2004;"PIAU (MG)";"MG";"PIAU";32;3;4;39
2004;"PIEDADE DE CARATINGA (MG)";"MG";"PIEDADE DE CARATINGA";68;4;4;76
2004;"PIEDADE DE PONTE NOVA (MG)";"MG";"PIEDADE DE PONTE NOVA";30;2;6;38
2004;"PIEDADE DO RIO GRANDE (MG)";"MG";"PIEDADE DO RIO GRANDE";38;1;5;44
2004;"PIEDADE DOS GERAIS (MG)";"MG";"PIEDADE DOS GERAIS";42;2;12;56
2004;"PIMENTA (MG)";"MG";"PIMENTA";157;6;12;175
2004;"PINGO D AGUA (MG)";"MG";"PINGO D AGUA";11;4;5;20
2004;"PINTOPOLIS (MG)";"MG";"PINTOPOLIS";9;1;3;13
2004;"PIRACEMA (MG)";"MG";"PIRACEMA";53;4;10;67
2004;"PIRAJUBA (MG)";"MG";"PIRAJUBA";70;2;3;75
2004;"PIRANGA (MG)";"MG";"PIRANGA";82;12;31;125
2004;"PIRANGUCU (MG)";"MG";"PIRANGUCU";26;13;35;74
2004;"PIRANGUINHO (MG)";"MG";"PIRANGUINHO";69;2;6;77
2004;"PIRAPETINGA (MG)";"MG";"PIRAPETINGA";246;10;17;273
2004;"PIRAPORA (MG)";"MG";"PIRAPORA";392;14;93;499
2004;"PIRAUBA (MG)";"MG";"PIRAUBA";93;10;8;111
2004;"PITANGUI (MG)";"MG";"PITANGUI";520;20;58;598
2004;"PIUI (MG)";"MG";"PIUI";493;19;43;555
2004;"PLANURA (MG)";"MG";"PLANURA";135;4;30;169
2004;"POCO FUNDO (MG)";"MG";"POCO FUNDO";198;22;11;231
2004;"POCOS DE CALDAS (MG)";"MG";"POCOS DE CALDAS";2287;322;292;2901
2004;"POCRANE (MG)";"MG";"POCRANE";46;4;7;57
2004;"POMPEU (MG)";"MG";"POMPEU";341;14;62;417
2004;"PONTE NOVA (MG)";"MG";"PONTE NOVA";719;14;93;826
2004;"PONTO CHIQUE (MG)";"MG";"PONTO CHIQUE";3;0;8;11
2004;"PONTO DOS VOLANTES (MG)";"MG";"PONTO DOS VOLANTES";9;3;18;30
2004;"PORTEIRINHA (MG)";"MG";"PORTEIRINHA";213;3;84;300
2004;"PORTO FIRME (MG)";"MG";"PORTO FIRME";28;2;8;38
2004;"POTE (MG)";"MG";"POTE";37;3;8;48
2004;"POUSO ALEGRE (MG)";"MG";"POUSO ALEGRE";1638;108;389;2135
2004;"POUSO ALTO (MG)";"MG";"POUSO ALTO";79;7;3;89
2004;"PRADOS (MG)";"MG";"PRADOS";51;4;5;60
2004;"PRATA (MG)";"MG";"PRATA";307;39;53;399
2004;"PRATAPOLIS (MG)";"MG";"PRATAPOLIS";157;10;8;175
2004;"PRATINHA (MG)";"MG";"PRATINHA";43;3;3;49
2004;"PRESIDENTE BERNARDES (MG)";"MG";"PRESIDENTE BERNARDES";14;2;6;22
2004;"PRESIDENTE JUSCELINO (MG)";"MG";"PRESIDENTE JUSCELINO";24;1;9;34
2004;"PRESIDENTE KUBITSCHEK (MG)";"MG";"PRESIDENTE KUBITSCHEK";9;3;2;14
2004;"PRESIDENTE OLEGARIO (MG)";"MG";"PRESIDENTE OLEGARIO";174;8;75;257
2004;"PRUDENTE DE MORAIS (MG)";"MG";"PRUDENTE DE MORAIS";105;6;10;121
2004;"QUARTEL GERAL (MG)";"MG";"QUARTEL GERAL";34;6;0;40
2004;"QUELUZITA (MG)";"MG";"QUELUZITA";13;4;1;18
2004;"RAPOSOS (MG)";"MG";"RAPOSOS";42;19;9;70
2004;"RAUL SOARES (MG)";"MG";"RAUL SOARES";121;8;32;161
2004;"RECREIO (MG)";"MG";"RECREIO";133;6;13;152
2004;"REDUTO (MG)";"MG";"REDUTO";31;4;3;38
2004;"RESENDE COSTA (MG)";"MG";"RESENDE COSTA";117;4;7;128
2004;"RESPLENDOR (MG)";"MG";"RESPLENDOR";150;7;26;183
2004;"RESSAQUINHA (MG)";"MG";"RESSAQUINHA";83;3;9;95
2004;"RIACHINHO (MG)";"MG";"RIACHINHO";46;1;12;59
2004;"RIACHO DOS MACHADOS (MG)";"MG";"RIACHO DOS MACHADOS";42;3;20;65
2004;"RIBEIRAO DAS NEVES (MG)";"MG";"RIBEIRAO DAS NEVES";1748;171;432;2351
2004;"RIBEIRAO VERMELHO (MG)";"MG";"RIBEIRAO VERMELHO";17;6;2;25
2004;"RIO ACIMA (MG)";"MG";"RIO ACIMA";81;7;9;97
2004;"RIO CASCA (MG)";"MG";"RIO CASCA";184;5;26;215
2004;"RIO DO PRADO (MG)";"MG";"RIO DO PRADO";8;2;5;15
2004;"RIO DOCE (MG)";"MG";"RIO DOCE";17;2;4;23
2004;"RIO ESPERA (MG)";"MG";"RIO ESPERA";13;0;4;17
2004;"RIO MANSO (MG)";"MG";"RIO MANSO";77;2;10;89
2004;"RIO NOVO (MG)";"MG";"RIO NOVO";94;4;13;111
2004;"RIO PARANAIBA (MG)";"MG";"RIO PARANAIBA";105;6;29;140
2004;"RIO PARDO DE MINAS (MG)";"MG";"RIO PARDO DE MINAS";108;2;66;176
2004;"RIO PIRACICABA (MG)";"MG";"RIO PIRACICABA";145;18;23;186
2004;"RIO POMBA (MG)";"MG";"RIO POMBA";168;14;30;212
2004;"RIO PRETO (MG)";"MG";"RIO PRETO";142;55;26;223
2004;"RIO VERMELHO (MG)";"MG";"RIO VERMELHO";41;13;24;78
2004;"RITAPOLIS (MG)";"MG";"RITAPOLIS";19;1;4;24
2004;"ROCHEDO DE MINAS (MG)";"MG";"ROCHEDO DE MINAS";18;0;2;20
2004;"RODEIRO (MG)";"MG";"RODEIRO";104;4;5;113
2004;"ROMARIA (MG)";"MG";"ROMARIA";26;4;3;33
2004;"ROSARIO DA LIMEIRA (MG)";"MG";"ROSARIO DA LIMEIRA";30;3;11;44
2004;"RUBELITA (MG)";"MG";"RUBELITA";10;3;6;19
2004;"RUBIM (MG)";"MG";"RUBIM";16;4;11;31
2004;"SABARA (MG)";"MG";"SABARA";422;90;211;723
2004;"SABINOPOLIS (MG)";"MG";"SABINOPOLIS";73;8;23;104
2004;"SACRAMENTO (MG)";"MG";"SACRAMENTO";362;24;41;427
2004;"SALINAS (MG)";"MG";"SALINAS";250;19;71;340
2004;"SALTO DA DIVISA (MG)";"MG";"SALTO DA DIVISA";5;3;2;10
2004;"SANTA BARBARA (MG)";"MG";"SANTA BARBARA";267;29;83;379
2004;"SANTA BARBARA DO LESTE (MG)";"MG";"SANTA BARBARA DO LESTE";113;6;1;120
2004;"SANTA BARBARA DO MONTE VERDE (MG)";"MG";"SANTA BARBARA DO MONTE VERDE";157;49;25;231
2004;"SANTA BARBARA DO TUGURIO (MG)";"MG";"SANTA BARBARA DO TUGURIO";32;3;5;40
2004;"SANTA CRUZ DE MINAS (MG)";"MG";"SANTA CRUZ DE MINAS";33;4;2;39
2004;"SANTA CRUZ DE SALINAS (MG)";"MG";"SANTA CRUZ DE SALINAS";7;1;12;20
2004;"SANTA CRUZ DO ESCALVADO (MG)";"MG";"SANTA CRUZ DO ESCALVADO";24;1;17;42
2004;"SANTA EFIGENIA DE MINAS (MG)";"MG";"SANTA EFIGENIA DE MINAS";12;2;1;15
2004;"SANTA FE DE MINAS (MG)";"MG";"SANTA FE DE MINAS";4;1;1;6
2004;"SANTA HELENA DE MINAS (MG)";"MG";"SANTA HELENA DE MINAS";5;1;3;9
2004;"SANTA JULIANA (MG)";"MG";"SANTA JULIANA";189;13;26;228
2004;"SANTA LUZIA (MG)";"MG";"SANTA LUZIA";934;106;449;1489
2004;"SANTA MARGARIDA (MG)";"MG";"SANTA MARGARIDA";126;8;11;145
2004;"SANTA MARIA DE ITABIRA (MG)";"MG";"SANTA MARIA DE ITABIRA";70;5;23;98
2004;"SANTA MARIA DO SALTO (MG)";"MG";"SANTA MARIA DO SALTO";10;4;4;18
2004;"SANTA MARIA DO SUACUI (MG)";"MG";"SANTA MARIA DO SUACUI";50;1;20;71
2004;"SANTA RITA DE CALDAS (MG)";"MG";"SANTA RITA DE CALDAS";210;8;2;220
2004;"SANTA RITA DE JACUTINGA (MG)";"MG";"SANTA RITA DE JACUTINGA";35;4;3;42
2004;"SANTA RITA DE MINAS (MG)";"MG";"SANTA RITA DE MINAS";100;4;5;109
2004;"SANTA RITA DO IBITIPOCA (MG)";"MG";"SANTA RITA DO IBITIPOCA";29;0;1;30
2004;"SANTA RITA DO ITUETO (MG)";"MG";"SANTA RITA DO ITUETO";58;2;8;68
2004;"SANTA RITA DO SAPUCAI (MG)";"MG";"SANTA RITA DO SAPUCAI";279;25;49;353
2004;"SANTA ROSA DA SERRA (MG)";"MG";"SANTA ROSA DA SERRA";28;2;5;35
2004;"SANTA VITORIA (MG)";"MG";"SANTA VITORIA";237;9;15;261
2004;"SANTANA DA VARGEM (MG)";"MG";"SANTANA DA VARGEM";50;3;18;71
2004;"SANTANA DE CATAGUASES (MG)";"MG";"SANTANA DE CATAGUASES";34;4;7;45
2004;"SANTANA DE PIRAPAMA (MG)";"MG";"SANTANA DE PIRAPAMA";53;5;18;76
2004;"SANTANA DO DESERTO (MG)";"MG";"SANTANA DO DESERTO";38;3;5;46
2004;"SANTANA DO GARAMBEU (MG)";"MG";"SANTANA DO GARAMBEU";10;0;2;12
2004;"SANTANA DO JACARE (MG)";"MG";"SANTANA DO JACARE";33;3;3;39
2004;"SANTANA DO MANHUACU (MG)";"MG";"SANTANA DO MANHUACU";76;5;8;89
2004;"SANTANA DO PARAISO (MG)";"MG";"SANTANA DO PARAISO";71;4;23;98
2004;"SANTANA DO RIACHO (MG)";"MG";"SANTANA DO RIACHO";6;4;3;13
2004;"SANTANA DOS MONTES (MG)";"MG";"SANTANA DOS MONTES";23;4;8;35
2004;"SANTO ANTONIO DO AMPARO (MG)";"MG";"SANTO ANTONIO DO AMPARO";178;7;9;194
2004;"SANTO ANTONIO DO AVENTUREIRO (MG)";"MG";"SANTO ANTONIO DO AVENTUREIRO";38;1;4;43
2004;"SANTO ANTONIO DO GRAMA (MG)";"MG";"SANTO ANTONIO DO GRAMA";35;0;5;40
2004;"SANTO ANTONIO DO ITAMBE (MG)";"MG";"SANTO ANTONIO DO ITAMBE";9;2;5;16
2004;"SANTO ANTONIO DO JACINTO (MG)";"MG";"SANTO ANTONIO DO JACINTO";21;5;13;39
2004;"SANTO ANTONIO DO MONTE (MG)";"MG";"SANTO ANTONIO DO MONTE";341;15;72;428
2004;"SANTO ANTONIO DO RETIRO (MG)";"MG";"SANTO ANTONIO DO RETIRO";18;1;10;29
2004;"SANTO ANTONIO DO RIO ABAIXO (MG)";"MG";"SANTO ANTONIO DO RIO ABAIXO";8;2;3;13
2004;"SANTO HIPOLITO (MG)";"MG";"SANTO HIPOLITO";10;0;2;12
2004;"SANTOS DUMONT (MG)";"MG";"SANTOS DUMONT";320;13;90;423
2004;"SAO BENTO ABADE (MG)";"MG";"SAO BENTO ABADE";31;4;3;38
2004;"SAO BRAS DO SUACUI (MG)";"MG";"SAO BRAS DO SUACUI";20;3;3;26
2004;"SAO DOMINGOS DAS DORES (MG)";"MG";"SAO DOMINGOS DAS DORES";57;1;1;59
2004;"SAO DOMINGOS DO PRATA (MG)";"MG";"SAO DOMINGOS DO PRATA";143;6;35;184
2004;"SAO FELIX DE MINAS (MG)";"MG";"SAO FELIX DE MINAS";9;1;5;15
2004;"SAO FRANCISCO (MG)";"MG";"SAO FRANCISCO";139;2;55;196
2004;"SAO FRANCISCO DE PAULA (MG)";"MG";"SAO FRANCISCO DE PAULA";60;3;21;84
2004;"SAO FRANCISCO DE SALES (MG)";"MG";"SAO FRANCISCO DE SALES";64;3;14;81
2004;"SAO FRANCISCO DO GLORIA (MG)";"MG";"SAO FRANCISCO DO GLORIA";39;4;4;47
2004;"SAO GERALDO (MG)";"MG";"SAO GERALDO";90;3;3;96
2004;"SAO GERALDO DA PIEDADE (MG)";"MG";"SAO GERALDO DA PIEDADE";8;1;4;13
2004;"SAO GERALDO DO BAIXIO (MG)";"MG";"SAO GERALDO DO BAIXIO";8;1;4;13
2004;"SAO GONCALO DO ABAETE (MG)";"MG";"SAO GONCALO DO ABAETE";70;3;10;83
2004;"SAO GONCALO DO PARA (MG)";"MG";"SAO GONCALO DO PARA";121;4;7;132
2004;"SAO GONCALO DO RIO ABAIXO (MG)";"MG";"SAO GONCALO DO RIO ABAIXO";46;12;12;70
2004;"SAO GONCALO DO RIO PRETO (MG)";"MG";"SAO GONCALO DO RIO PRETO";15;4;3;22
2004;"SAO GONCALO DO SAPUCAI (MG)";"MG";"SAO GONCALO DO SAPUCAI";335;13;45;393
2004;"SAO GOTARDO (MG)";"MG";"SAO GOTARDO";626;25;91;742
2004;"SAO JOAO BATISTA DO GLORIA (MG)";"MG";"SAO JOAO BATISTA DO GLORIA";64;8;6;78
2004;"SAO JOAO DA LAGOA (MG)";"MG";"SAO JOAO DA LAGOA";22;1;6;29
2004;"SAO JOAO DA MATA (MG)";"MG";"SAO JOAO DA MATA";30;6;1;37
2004;"SAO JOAO DA PONTE (MG)";"MG";"SAO JOAO DA PONTE";35;2;28;65
2004;"SAO JOAO DAS MISSOES (MG)";"MG";"SAO JOAO DAS MISSOES";12;3;6;21
2004;"SAO JOAO DEL REI (MG)";"MG";"SAO JOAO DEL REI";823;74;165;1062
2004;"SAO JOAO DO MANHUACU (MG)";"MG";"SAO JOAO DO MANHUACU";97;5;9;111
2004;"SAO JOAO DO MANTENINHA (MG)";"MG";"SAO JOAO DO MANTENINHA";39;3;3;45
2004;"SAO JOAO DO ORIENTE (MG)";"MG";"SAO JOAO DO ORIENTE";62;4;4;70
2004;"SAO JOAO DO PACUI (MG)";"MG";"SAO JOAO DO PACUI";0;0;1;1
2004;"SAO JOAO DO PARAISO (MG)";"MG";"SAO JOAO DO PARAISO";81;4;39;124
2004;"SAO JOAO EVANGELISTA (MG)";"MG";"SAO JOAO EVANGELISTA";65;4;21;90
2004;"SAO JOAO NEPOMUCENO (MG)";"MG";"SAO JOAO NEPOMUCENO";221;13;32;266
2004;"SAO JOAQUIM DE BICAS (MG)";"MG";"SAO JOAQUIM DE BICAS";169;28;32;229
2004;"SAO JOSE DA BARRA (MG)";"MG";"SAO JOSE DA BARRA";50;2;14;66
2004;"SAO JOSE DA LAPA (MG)";"MG";"SAO JOSE DA LAPA";152;12;25;189
2004;"SAO JOSE DA SAFIRA (MG)";"MG";"SAO JOSE DA SAFIRA";1;1;1;3
2004;"SAO JOSE DA VARGINHA (MG)";"MG";"SAO JOSE DA VARGINHA";35;0;6;41
2004;"SAO JOSE DO ALEGRE (MG)";"MG";"SAO JOSE DO ALEGRE";34;5;1;40
2004;"SAO JOSE DO DIVINO (MG)";"MG";"SAO JOSE DO DIVINO";9;2;6;17
2004;"SAO JOSE DO GOIABAL (MG)";"MG";"SAO JOSE DO GOIABAL";40;8;32;80
2004;"SAO JOSE DO JACURI (MG)";"MG";"SAO JOSE DO JACURI";10;2;3;15
2004;"SAO JOSE DO MANTIMENTO (MG)";"MG";"SAO JOSE DO MANTIMENTO";5;2;2;9
2004;"SAO LOURENCO (MG)";"MG";"SAO LOURENCO";350;44;24;418
2004;"SAO MIGUEL DO ANTA (MG)";"MG";"SAO MIGUEL DO ANTA";56;3;6;65
2004;"SAO PEDRO DA UNIAO (MG)";"MG";"SAO PEDRO DA UNIAO";71;7;7;85
2004;"SAO PEDRO DO SUACUI (MG)";"MG";"SAO PEDRO DO SUACUI";14;3;5;22
2004;"SAO PEDRO DOS FERROS (MG)";"MG";"SAO PEDRO DOS FERROS";92;1;20;113
2004;"SAO ROMAO (MG)";"MG";"SAO ROMAO";14;1;8;23
2004;"SAO ROQUE DE MINAS (MG)";"MG";"SAO ROQUE DE MINAS";71;4;22;97
2004;"SAO SEBASTIAO DA BELA VISTA (MG)";"MG";"SAO SEBASTIAO DA BELA VISTA";26;3;7;36
2004;"SAO SEBASTIAO DA VARGEM ALEGRE (MG)";"MG";"SAO SEBASTIAO DA VARGEM ALEGRE";10;1;4;15
2004;"SAO SEBASTIAO DO ANTA (MG)";"MG";"SAO SEBASTIAO DO ANTA";22;2;1;25
2004;"SAO SEBASTIAO DO MARANHAO (MG)";"MG";"SAO SEBASTIAO DO MARANHAO";17;3;9;29
2004;"SAO SEBASTIAO DO OESTE (MG)";"MG";"SAO SEBASTIAO DO OESTE";64;3;10;77
2004;"SAO SEBASTIAO DO PARAISO (MG)";"MG";"SAO SEBASTIAO DO PARAISO";1120;46;96;1262
2004;"SAO SEBASTIAO DO RIO PRETO (MG)";"MG";"SAO SEBASTIAO DO RIO PRETO";7;3;1;11
2004;"SAO SEBASTIAO DO RIO VERDE (MG)";"MG";"SAO SEBASTIAO DO RIO VERDE";6;1;3;10
2004;"SAO TIAGO (MG)";"MG";"SAO TIAGO";85;6;10;101
2004;"SAO TOMAS DE AQUINO (MG)";"MG";"SAO TOMAS DE AQUINO";55;11;6;72
2004;"SAO TOME DAS LETRAS (MG)";"MG";"SAO TOME DAS LETRAS";74;4;9;87
2004;"SAO VICENTE DE MINAS (MG)";"MG";"SAO VICENTE DE MINAS";49;5;1;55
2004;"SAPUCAI MIRIM (MG)";"MG";"SAPUCAI MIRIM";123;17;11;151
2004;"SARDOA (MG)";"MG";"SARDOA";15;2;6;23
2004;"SARZEDO (MG)";"MG";"SARZEDO";198;8;21;227
2004;"SEM PEIXE (MG)";"MG";"SEM PEIXE";4;3;4;11
2004;"SENADOR AMARAL (MG)";"MG";"SENADOR AMARAL";71;3;4;78
2004;"SENADOR CORTES (MG)";"MG";"SENADOR CORTES";7;3;4;14
2004;"SENADOR FIRMINO (MG)";"MG";"SENADOR FIRMINO";56;3;7;66
2004;"SENADOR JOSE BENTO (MG)";"MG";"SENADOR JOSE BENTO";12;1;6;19
2004;"SENADOR MODESTINO GONCALVES (MG)";"MG";"SENADOR MODESTINO GONCALVES";20;5;5;30
2004;"SENHORA DE OLIVEIRA (MG)";"MG";"SENHORA DE OLIVEIRA";38;1;5;44
2004;"SENHORA DO PORTO (MG)";"MG";"SENHORA DO PORTO";13;2;5;20
2004;"SENHORA DOS REMEDIOS (MG)";"MG";"SENHORA DOS REMEDIOS";50;4;10;64
2004;"SERICITA (MG)";"MG";"SERICITA";42;2;2;46
2004;"SERITINGA (MG)";"MG";"SERITINGA";14;2;1;17
2004;"SERRA AZUL DE MINAS (MG)";"MG";"SERRA AZUL DE MINAS";10;1;5;16
2004;"SERRA DA SAUDADE (MG)";"MG";"SERRA DA SAUDADE";5;3;0;8
2004;"SERRA DO SALITRE (MG)";"MG";"SERRA DO SALITRE";149;3;32;184
2004;"SERRA DOS AIMORES (MG)";"MG";"SERRA DOS AIMORES";42;2;12;56
2004;"SERRANIA (MG)";"MG";"SERRANIA";89;9;9;107
2004;"SERRANOPOLIS DE MINAS (MG)";"MG";"SERRANOPOLIS DE MINAS";5;2;7;14
2004;"SERRANOS (MG)";"MG";"SERRANOS";8;2;1;11
2004;"SERRO (MG)";"MG";"SERRO";106;5;20;131
2004;"SETE LAGOAS (MG)";"MG";"SETE LAGOAS";2241;257;352;2850
2004;"SETUBINHA (MG)";"MG";"SETUBINHA";10;2;15;27
2004;"SILVEIRANIA (MG)";"MG";"SILVEIRANIA";5;1;4;10
2004;"SILVIANOPOLIS (MG)";"MG";"SILVIANOPOLIS";61;6;4;71
2004;"SIMAO PEREIRA (MG)";"MG";"SIMAO PEREIRA";36;6;1;43
2004;"SIMONESIA (MG)";"MG";"SIMONESIA";127;6;23;156
2004;"SOBRALIA (MG)";"MG";"SOBRALIA";19;1;5;25
2004;"SOLEDADE DE MINAS (MG)";"MG";"SOLEDADE DE MINAS";17;6;0;23
2004;"TABULEIRO (MG)";"MG";"TABULEIRO";50;3;7;60
2004;"TAIOBEIRAS (MG)";"MG";"TAIOBEIRAS";401;8;56;465
2004;"TAPARUBA (MG)";"MG";"TAPARUBA";16;3;4;23
2004;"TAPIRA (MG)";"MG";"TAPIRA";22;4;8;34
2004;"TAPIRAI (MG)";"MG";"TAPIRAI";9;2;2;13
2004;"TAQUARACU DE MINAS (MG)";"MG";"TAQUARACU DE MINAS";41;2;5;48
2004;"TARUMIRIM (MG)";"MG";"TARUMIRIM";92;5;20;117
2004;"TEIXEIRAS (MG)";"MG";"TEIXEIRAS";97;4;10;111
2004;"TEOFILO OTONI (MG)";"MG";"TEOFILO OTONI";1107;79;102;1288
2004;"TIMOTEO (MG)";"MG";"TIMOTEO";659;112;97;868
2004;"TIRADENTES (MG)";"MG";"TIRADENTES";53;5;8;66
2004;"TIROS (MG)";"MG";"TIROS";113;15;6;134
2004;"TOCANTINS (MG)";"MG";"TOCANTINS";166;3;3;172
2004;"TOCOS DO MOJI (MG)";"MG";"TOCOS DO MOJI";31;4;6;41
2004;"TOLEDO (MG)";"MG";"TOLEDO";33;2;5;40
2004;"TOMBOS (MG)";"MG";"TOMBOS";86;10;14;110
2004;"TRES CORACOES (MG)";"MG";"TRES CORACOES";731;56;102;889
2004;"TRES MARIAS (MG)";"MG";"TRES MARIAS";216;16;50;282
2004;"TRES PONTAS (MG)";"MG";"TRES PONTAS";656;29;102;787
2004;"TUMIRITINGA (MG)";"MG";"TUMIRITINGA";18;2;2;22
2004;"TUPACIGUARA (MG)";"MG";"TUPACIGUARA";364;29;42;435
2004;"TURMALINA (MG)";"MG";"TURMALINA";166;5;30;201
2004;"TURVOLANDIA (MG)";"MG";"TURVOLANDIA";82;7;3;92
2004;"UBA (MG)";"MG";"UBA";1239;32;86;1357
2004;"UBAI (MG)";"MG";"UBAI";9;2;8;19
2004;"UBAPORANGA (MG)";"MG";"UBAPORANGA";85;3;8;96
2004;"UBERABA (MG)";"MG";"UBERABA";3138;414;529;4081
2004;"UBERLANDIA (MG)";"MG";"UBERLANDIA";8203;686;1011;9900
2004;"UMBURATIBA (MG)";"MG";"UMBURATIBA";6;1;1;8
2004;"UNAI (MG)";"MG";"UNAI";1094;29;228;1351
2004;"UNIAO DE MINAS (MG)";"MG";"UNIAO DE MINAS";31;1;10;42
2004;"URUANA DE MINAS (MG)";"MG";"URUANA DE MINAS";11;1;7;19
2004;"URUCANIA (MG)";"MG";"URUCANIA";103;3;20;126
2004;"URUCUIA (MG)";"MG";"URUCUIA";28;1;10;39
2004;"VARGEM ALEGRE (MG)";"MG";"VARGEM ALEGRE";51;5;7;63
2004;"VARGEM BONITA (MG)";"MG";"VARGEM BONITA";11;4;4;19
2004;"VARGEM GRANDE DO RIO PARDO (MG)";"MG";"VARGEM GRANDE DO RIO PARDO";20;1;6;27
2004;"VARGINHA (MG)";"MG";"VARGINHA";1441;60;167;1668
2004;"VARJAO DE MINAS (MG)";"MG";"VARJAO DE MINAS";52;2;19;73
2004;"VARZEA DA PALMA (MG)";"MG";"VARZEA DA PALMA";345;8;59;412
2004;"VARZELANDIA (MG)";"MG";"VARZELANDIA";32;2;16;50
2004;"VAZANTE (MG)";"MG";"VAZANTE";249;10;80;339
2004;"VERDELANDIA (MG)";"MG";"VERDELANDIA";8;2;2;12
2004;"VEREDINHA (MG)";"MG";"VEREDINHA";14;0;13;27
2004;"VERISSIMO (MG)";"MG";"VERISSIMO";27;18;3;48
2004;"VERMELHO NOVO (MG)";"MG";"VERMELHO NOVO";39;1;9;49
2004;"VESPASIANO (MG)";"MG";"VESPASIANO";358;48;107;513
2004;"VICOSA (MG)";"MG";"VICOSA";494;66;127;687
2004;"VIEIRAS (MG)";"MG";"VIEIRAS";18;3;3;24
2004;"VIRGEM DA LAPA (MG)";"MG";"VIRGEM DA LAPA";43;2;14;59
2004;"VIRGINIA (MG)";"MG";"VIRGINIA";83;7;4;94
2004;"VIRGINOPOLIS (MG)";"MG";"VIRGINOPOLIS";66;5;5;76
2004;"VIRGOLANDIA (MG)";"MG";"VIRGOLANDIA";14;3;5;22
2004;"VISCONDE DO RIO BRANCO (MG)";"MG";"VISCONDE DO RIO BRANCO";603;23;43;669
2004;"VOLTA GRANDE (MG)";"MG";"VOLTA GRANDE";27;3;6;36
2004;"WENCESLAU BRAZ (MG)";"MG";"WENCESLAU BRAZ";34;2;4;40
2004;"AGUA CLARA (MS)";"MS";"AGUA CLARA";298;6;34;338
2004;"ALCINOPOLIS (MS)";"MS";"ALCINOPOLIS";47;4;10;61
2004;"AMAMBAI (MS)";"MS";"AMAMBAI";544;8;27;579
2004;"ANASTACIO (MS)";"MS";"ANASTACIO";229;4;11;244
2004;"ANAURILANDIA (MS)";"MS";"ANAURILANDIA";69;5;19;93
2004;"ANGELICA (MS)";"MS";"ANGELICA";114;2;15;131
2004;"ANTONIO JOAO (MS)";"MS";"ANTONIO JOAO";73;2;8;83
2004;"APARECIDA DO TABOADO (MS)";"MS";"APARECIDA DO TABOADO";295;7;34;336
2004;"AQUIDAUANA (MS)";"MS";"AQUIDAUANA";239;18;37;294
2004;"ARAL MOREIRA (MS)";"MS";"ARAL MOREIRA";107;8;11;126
2004;"BANDEIRANTES (MS)";"MS";"BANDEIRANTES";78;6;5;89
2004;"BATAGUASSU (MS)";"MS";"BATAGUASSU";458;16;90;564
2004;"BATAYPORA (MS)";"MS";"BATAYPORA";127;1;19;147
2004;"BELA VISTA (MS)";"MS";"BELA VISTA";136;13;19;168
2004;"BODOQUENA (MS)";"MS";"BODOQUENA";46;2;23;71
2004;"BONITO (MS)";"MS";"BONITO";175;33;34;242
2004;"BRASILANDIA (MS)";"MS";"BRASILANDIA";163;7;43;213
2004;"CAARAPO (MS)";"MS";"CAARAPO";374;5;49;428
2004;"CAMAPUA (MS)";"MS";"CAMAPUA";269;19;15;303
2004;"CAMPO GRANDE (MS)";"MS";"CAMPO GRANDE";9345;577;1297;11219
2004;"CARACOL (MS)";"MS";"CARACOL";21;5;4;30
2004;"CASSILANDIA (MS)";"MS";"CASSILANDIA";431;6;21;458
2004;"CHAPADAO DO SUL (MS)";"MS";"CHAPADAO DO SUL";473;8;34;515
2004;"CORGUINHO (MS)";"MS";"CORGUINHO";43;2;10;55
2004;"CORONEL SAPUCAIA (MS)";"MS";"CORONEL SAPUCAIA";170;1;10;181
2004;"CORUMBA (MS)";"MS";"CORUMBA";537;34;80;651
2004;"COSTA RICA (MS)";"MS";"COSTA RICA";351;7;27;385
2004;"COXIM (MS)";"MS";"COXIM";428;7;48;483
2004;"DEODAPOLIS (MS)";"MS";"DEODAPOLIS";186;3;24;213
2004;"DOIS IRMAOS DO BURITI (MS)";"MS";"DOIS IRMAOS DO BURITI";76;8;17;101
2004;"DOURADINA (MS)";"MS";"DOURADINA";153;0;8;161
2004;"DOURADOS (MS)";"MS";"DOURADOS";2979;102;221;3302
2004;"ELDORADO (MS)";"MS";"ELDORADO";177;3;15;195
2004;"FATIMA DO SUL (MS)";"MS";"FATIMA DO SUL";353;5;15;373
2004;"GLORIA DE DOURADOS (MS)";"MS";"GLORIA DE DOURADOS";168;2;17;187
2004;"GUIA LOPES DA LAGUNA (MS)";"MS";"GUIA LOPES DA LAGUNA";98;8;7;113
2004;"IGUATEMI (MS)";"MS";"IGUATEMI";167;3;27;197
2004;"INOCENCIA (MS)";"MS";"INOCENCIA";131;1;16;148
2004;"ITAPORA (MS)";"MS";"ITAPORA";317;7;33;357
2004;"ITAQUIRAI (MS)";"MS";"ITAQUIRAI";141;2;42;185
2004;"IVINHEMA (MS)";"MS";"IVINHEMA";410;6;152;568
2004;"JAPORA (MS)";"MS";"JAPORA";7;1;6;14
2004;"JARAGUARI (MS)";"MS";"JARAGUARI";49;2;9;60
2004;"JARDIM (MS)";"MS";"JARDIM";335;16;20;371
2004;"JATEI (MS)";"MS";"JATEI";27;3;12;42
2004;"JUTI (MS)";"MS";"JUTI";31;3;11;45
2004;"LADARIO (MS)";"MS";"LADARIO";121;11;23;155
2004;"LAGUNA CARAPA (MS)";"MS";"LAGUNA CARAPA";115;1;15;131
2004;"MARACAJU (MS)";"MS";"MARACAJU";638;14;48;700
2004;"MIRANDA (MS)";"MS";"MIRANDA";195;10;25;230
2004;"MUNDO NOVO (MS)";"MS";"MUNDO NOVO";205;10;25;240
2004;"NAVIRAI (MS)";"MS";"NAVIRAI";651;14;99;764
2004;"NIOAQUE (MS)";"MS";"NIOAQUE";82;10;24;116
2004;"NOVA ALVORADA DO SUL (MS)";"MS";"NOVA ALVORADA DO SUL";178;6;34;218
2004;"NOVA ANDRADINA (MS)";"MS";"NOVA ANDRADINA";775;6;85;866
2004;"NOVO HORIZONTE DO SUL (MS)";"MS";"NOVO HORIZONTE DO SUL";54;0;14;68
2004;"PARANAIBA (MS)";"MS";"PARANAIBA";684;10;46;740
2004;"PARANHOS (MS)";"MS";"PARANHOS";62;2;11;75
2004;"PEDRO GOMES (MS)";"MS";"PEDRO GOMES";66;4;4;74
2004;"PONTA PORA (MS)";"MS";"PONTA PORA";1221;30;99;1350
2004;"PORTO MURTINHO (MS)";"MS";"PORTO MURTINHO";31;7;6;44
2004;"RIBAS DO RIO PARDO (MS)";"MS";"RIBAS DO RIO PARDO";382;9;20;411
2004;"RIO BRILHANTE (MS)";"MS";"RIO BRILHANTE";440;12;93;545
2004;"RIO NEGRO (MS)";"MS";"RIO NEGRO";45;1;7;53
2004;"RIO VERDE DE MATO GROSSO (MS)";"MS";"RIO VERDE DE MATO GROSSO";239;10;7;256
2004;"ROCHEDO (MS)";"MS";"ROCHEDO";32;7;7;46
2004;"SANTA RITA DO PARDO (MS)";"MS";"SANTA RITA DO PARDO";90;5;21;116
2004;"SAO GABRIEL DO OESTE (MS)";"MS";"SAO GABRIEL DO OESTE";629;17;32;678
2004;"SELVIRIA (MS)";"MS";"SELVIRIA";74;2;13;89
2004;"SETE QUEDAS (MS)";"MS";"SETE QUEDAS";181;3;17;201
2004;"SIDROLANDIA (MS)";"MS";"SIDROLANDIA";448;16;88;552
2004;"SONORA (MS)";"MS";"SONORA";180;11;50;241
2004;"TACURU (MS)";"MS";"TACURU";86;0;10;96
2004;"TAQUARUSSU (MS)";"MS";"TAQUARUSSU";36;1;8;45
2004;"TERENOS (MS)";"MS";"TERENOS";186;4;10;200
2004;"TRES LAGOAS (MS)";"MS";"TRES LAGOAS";1282;29;213;1524
2004;"VICENTINA (MS)";"MS";"VICENTINA";79;2;21;102
2004;"ACORIZAL (MT)";"MT";"ACORIZAL";7;1;3;11
2004;"AGUA BOA (MT)";"MT";"AGUA BOA";337;5;15;357
2004;"ALTA FLORESTA (MT)";"MT";"ALTA FLORESTA";910;11;64;985
2004;"ALTO ARAGUAIA (MT)";"MT";"ALTO ARAGUAIA";83;4;12;99
2004;"ALTO BOA VISTA (MT)";"MT";"ALTO BOA VISTA";11;0;1;12
2004;"ALTO GARCAS (MT)";"MT";"ALTO GARCAS";251;4;27;282
2004;"ALTO PARAGUAI (MT)";"MT";"ALTO PARAGUAI";17;6;2;25
2004;"ALTO TAQUARI (MT)";"MT";"ALTO TAQUARI";101;3;6;110
2004;"APIACAS (MT)";"MT";"APIACAS";55;0;2;57
2004;"ARAGUAIANA (MT)";"MT";"ARAGUAIANA";7;0;1;8
2004;"ARAGUAINHA (MT)";"MT";"ARAGUAINHA";5;2;0;7
2004;"ARAPUTANGA (MT)";"MT";"ARAPUTANGA";221;5;13;239
2004;"ARENAPOLIS (MT)";"MT";"ARENAPOLIS";152;11;28;191
2004;"ARIPUANA (MT)";"MT";"ARIPUANA";181;5;12;198
2004;"BARAO DE MELGACO (MT)";"MT";"BARAO DE MELGACO";6;0;1;7
2004;"BARRA DO BUGRES (MT)";"MT";"BARRA DO BUGRES";394;9;96;499
2004;"BARRA DO GARCAS (MT)";"MT";"BARRA DO GARCAS";738;24;168;930
2004;"BOM JESUS DO ARAGUAIA (MT)";"MT";"BOM JESUS DO ARAGUAIA";5;0;1;6
2004;"BRASNORTE (MT)";"MT";"BRASNORTE";155;2;6;163
2004;"CACERES (MT)";"MT";"CACERES";633;35;135;803
2004;"CAMPINAPOLIS (MT)";"MT";"CAMPINAPOLIS";48;0;10;58
2004;"CAMPO NOVO DO PARECIS (MT)";"MT";"CAMPO NOVO DO PARECIS";582;12;40;634
2004;"CAMPO VERDE (MT)";"MT";"CAMPO VERDE";560;14;45;619
2004;"CAMPOS DE JULIO (MT)";"MT";"CAMPOS DE JULIO";110;5;7;122
2004;"CANABRAVA DO NORTE (MT)";"MT";"CANABRAVA DO NORTE";6;0;1;7
2004;"CANARANA (MT)";"MT";"CANARANA";358;0;25;383
2004;"CARLINDA (MT)";"MT";"CARLINDA";85;0;12;97
2004;"CASTANHEIRA (MT)";"MT";"CASTANHEIRA";71;1;7;79
2004;"CHAPADA DOS GUIMARAES (MT)";"MT";"CHAPADA DOS GUIMARAES";160;10;30;200
2004;"CLAUDIA (MT)";"MT";"CLAUDIA";340;2;11;353
2004;"COCALINHO (MT)";"MT";"COCALINHO";9;1;3;13
2004;"COLIDER (MT)";"MT";"COLIDER";599;10;61;670
2004;"COLNIZA (MT)";"MT";"COLNIZA";52;0;0;52
2004;"COMODORO (MT)";"MT";"COMODORO";285;3;32;320
2004;"CONFRESA (MT)";"MT";"CONFRESA";49;1;6;56
2004;"CONQUISTA D OESTE (MT)";"MT";"CONQUISTA D OESTE";16;1;6;23
2004;"COTRIGUACU (MT)";"MT";"COTRIGUACU";67;0;13;80
2004;"CUIABA (MT)";"MT";"CUIABA";5470;599;1436;7505
2004;"CURVELANDIA (MT)";"MT";"CURVELANDIA";33;0;6;39
2004;"DENISE (MT)";"MT";"DENISE";49;5;21;75
2004;"DIAMANTINO (MT)";"MT";"DIAMANTINO";376;13;47;436
2004;"DOM AQUINO (MT)";"MT";"DOM AQUINO";78;10;12;100
2004;"FELIZ NATAL (MT)";"MT";"FELIZ NATAL";127;1;6;134
2004;"FIGUEIROPOLIS D OESTE (MT)";"MT";"FIGUEIROPOLIS D OESTE";44;1;7;52
2004;"GAUCHA DO NORTE (MT)";"MT";"GAUCHA DO NORTE";32;3;1;36
2004;"GENERAL CARNEIRO (MT)";"MT";"GENERAL CARNEIRO";16;1;3;20
2004;"GLORIA D OESTE (MT)";"MT";"GLORIA D OESTE";25;3;6;34
2004;"GUARANTA DO NORTE (MT)";"MT";"GUARANTA DO NORTE";658;2;19;679
2004;"GUIRATINGA (MT)";"MT";"GUIRATINGA";94;4;3;101
2004;"INDIAVAI (MT)";"MT";"INDIAVAI";17;1;6;24
2004;"ITAUBA (MT)";"MT";"ITAUBA";89;3;4;96
2004;"ITIQUIRA (MT)";"MT";"ITIQUIRA";48;7;16;71
2004;"JACIARA (MT)";"MT";"JACIARA";407;12;69;488
2004;"JANGADA (MT)";"MT";"JANGADA";33;4;9;46
2004;"JAURU (MT)";"MT";"JAURU";137;1;15;153
2004;"JUARA (MT)";"MT";"JUARA";507;9;21;537
2004;"JUINA (MT)";"MT";"JUINA";555;5;40;600
2004;"JURUENA (MT)";"MT";"JURUENA";87;0;7;94
2004;"JUSCIMEIRA (MT)";"MT";"JUSCIMEIRA";85;2;35;122
2004;"LAMBARI D OESTE (MT)";"MT";"LAMBARI D OESTE";41;0;10;51
2004;"LUCAS DO RIO VERDE (MT)";"MT";"LUCAS DO RIO VERDE";931;22;41;994
2004;"LUCIARA (MT)";"MT";"LUCIARA";6;0;2;8
2004;"MARCELANDIA (MT)";"MT";"MARCELANDIA";304;4;10;318
2004;"MATUPA (MT)";"MT";"MATUPA";258;7;19;284
2004;"MIRASSOL D OESTE (MT)";"MT";"MIRASSOL D OESTE";520;9;33;562
2004;"NOBRES (MT)";"MT";"NOBRES";188;6;26;220
2004;"NORTELANDIA (MT)";"MT";"NORTELANDIA";49;7;11;67
2004;"NOSSA SENHORA DO LIVRAMENTO (MT)";"MT";"NOSSA SENHORA DO LIVRAMENTO";26;4;16;46
2004;"NOVA BANDEIRANTES (MT)";"MT";"NOVA BANDEIRANTES";55;2;11;68
2004;"NOVA BRASILANDIA (MT)";"MT";"NOVA BRASILANDIA";22;1;8;31
2004;"NOVA CANAA DO NORTE (MT)";"MT";"NOVA CANAA DO NORTE";141;1;18;160
2004;"NOVA GUARITA (MT)";"MT";"NOVA GUARITA";53;2;6;61
2004;"NOVA LACERDA (MT)";"MT";"NOVA LACERDA";22;1;10;33
2004;"NOVA MARILANDIA (MT)";"MT";"NOVA MARILANDIA";12;2;4;18
2004;"NOVA MARINGA (MT)";"MT";"NOVA MARINGA";50;0;4;54
2004;"NOVA MONTE VERDE (MT)";"MT";"NOVA MONTE VERDE";54;1;0;55
2004;"NOVA MUTUM (MT)";"MT";"NOVA MUTUM";501;5;22;528
2004;"NOVA NAZARE (MT)";"MT";"NOVA NAZARE";2;0;2;4
2004;"NOVA OLIMPIA (MT)";"MT";"NOVA OLIMPIA";183;14;71;268
2004;"NOVA SANTA HELENA (MT)";"MT";"NOVA SANTA HELENA";31;1;5;37
2004;"NOVA UBIRATA (MT)";"MT";"NOVA UBIRATA";60;3;1;64
2004;"NOVA XAVANTINA (MT)";"MT";"NOVA XAVANTINA";228;5;21;254
2004;"NOVO HORIZONTE DO NORTE (MT)";"MT";"NOVO HORIZONTE DO NORTE";21;0;4;25
2004;"NOVO MUNDO (MT)";"MT";"NOVO MUNDO";52;2;4;58
2004;"NOVO SANTO ANTONIO (MT)";"MT";"NOVO SANTO ANTONIO";0;0;1;1
2004;"NOVO SAO JOAQUIM (MT)";"MT";"NOVO SAO JOAQUIM";43;0;7;50
2004;"PARANAITA (MT)";"MT";"PARANAITA";150;2;13;165
2004;"PARANATINGA (MT)";"MT";"PARANATINGA";269;4;19;292
2004;"PEDRA PRETA (MT)";"MT";"PEDRA PRETA";197;14;15;226
2004;"PEIXOTO DE AZEVEDO (MT)";"MT";"PEIXOTO DE AZEVEDO";195;9;30;234
2004;"PLANALTO DA SERRA (MT)";"MT";"PLANALTO DA SERRA";6;1;3;10
2004;"POCONE (MT)";"MT";"POCONE";228;12;22;262
2004;"PONTAL DO ARAGUAIA (MT)";"MT";"PONTAL DO ARAGUAIA";13;0;1;14
2004;"PONTE BRANCA (MT)";"MT";"PONTE BRANCA";4;1;0;5
2004;"PONTES E LACERDA (MT)";"MT";"PONTES E LACERDA";650;14;47;711
2004;"PORTO ALEGRE DO NORTE (MT)";"MT";"PORTO ALEGRE DO NORTE";16;3;7;26
2004;"PORTO DOS GAUCHOS (MT)";"MT";"PORTO DOS GAUCHOS";69;1;3;73
2004;"PORTO ESPERIDIAO (MT)";"MT";"PORTO ESPERIDIAO";62;2;23;87
2004;"PORTO ESTRELA (MT)";"MT";"PORTO ESTRELA";17;3;3;23
2004;"POXOREO (MT)";"MT";"POXOREO";76;9;21;106
2004;"PRIMAVERA DO LESTE (MT)";"MT";"PRIMAVERA DO LESTE";1215;38;49;1302
2004;"QUERENCIA (MT)";"MT";"QUERENCIA";147;0;7;154
2004;"RESERVA DO CABACAL (MT)";"MT";"RESERVA DO CABACAL";17;1;5;23
2004;"RIBEIRAO CASCALHEIRA (MT)";"MT";"RIBEIRAO CASCALHEIRA";33;2;2;37
2004;"RIBEIRAOZINHO (MT)";"MT";"RIBEIRAOZINHO";7;1;3;11
2004;"RIO BRANCO (MT)";"MT";"RIO BRANCO";70;4;6;80
2004;"RONDOLANDIA (MT)";"MT";"RONDOLANDIA";3;0;4;7
2004;"RONDONOPOLIS (MT)";"MT";"RONDONOPOLIS";2787;80;210;3077
2004;"ROSARIO OESTE (MT)";"MT";"ROSARIO OESTE";92;7;9;108
2004;"SALTO DO CEU (MT)";"MT";"SALTO DO CEU";29;1;4;34
2004;"SANTA CARMEN (MT)";"MT";"SANTA CARMEN";113;0;6;119
2004;"SANTA CRUZ DO XINGU (MT)";"MT";"SANTA CRUZ DO XINGU";0;0;1;1
2004;"SANTA RITA DO TRIVELATO (MT)";"MT";"SANTA RITA DO TRIVELATO";30;1;2;33
2004;"SANTA TEREZINHA (MT)";"MT";"SANTA TEREZINHA";5;2;4;11
2004;"SANTO AFONSO (MT)";"MT";"SANTO AFONSO";20;0;5;25
2004;"SANTO ANTONIO DO LESTE (MT)";"MT";"SANTO ANTONIO DO LESTE";63;1;11;75
2004;"SANTO ANTONIO DO LEVERGER (MT)";"MT";"SANTO ANTONIO DO LEVERGER";52;8;10;70
2004;"SAO FELIX DO ARAGUAIA (MT)";"MT";"SAO FELIX DO ARAGUAIA";26;2;9;37
2004;"SAO JOSE DO POVO (MT)";"MT";"SAO JOSE DO POVO";12;1;3;16
2004;"SAO JOSE DO RIO CLARO (MT)";"MT";"SAO JOSE DO RIO CLARO";198;6;22;226
2004;"SAO JOSE DO XINGU (MT)";"MT";"SAO JOSE DO XINGU";5;1;4;10
2004;"SAO JOSE DOS QUATRO MARCOS (MT)";"MT";"SAO JOSE DOS QUATRO MARCOS";340;6;36;382
2004;"SAO PEDRO DA CIPA (MT)";"MT";"SAO PEDRO DA CIPA";14;2;14;30
2004;"SAPEZAL (MT)";"MT";"SAPEZAL";259;3;12;274
2004;"SERRA NOVA DOURADA (MT)";"MT";"SERRA NOVA DOURADA";1;0;0;1
2004;"SINOP (MT)";"MT";"SINOP";2312;30;116;2458
2004;"SORRISO (MT)";"MT";"SORRISO";1536;21;60;1617
2004;"TABAPORA (MT)";"MT";"TABAPORA";69;3;10;82
2004;"TANGARA DA SERRA (MT)";"MT";"TANGARA DA SERRA";1534;71;114;1719
2004;"TAPURAH (MT)";"MT";"TAPURAH";235;7;13;255
2004;"TERRA NOVA DO NORTE (MT)";"MT";"TERRA NOVA DO NORTE";202;4;16;222
2004;"TESOURO (MT)";"MT";"TESOURO";7;3;2;12
2004;"TORIXOREU (MT)";"MT";"TORIXOREU";15;0;3;18
2004;"UNIAO DO SUL (MT)";"MT";"UNIAO DO SUL";61;0;3;64
2004;"VALE DE SAO DOMINGOS (MT)";"MT";"VALE DE SAO DOMINGOS";4;0;6;10
2004;"VARZEA GRANDE (MT)";"MT";"VARZEA GRANDE";2952;153;311;3416
2004;"VERA (MT)";"MT";"VERA";235;2;10;247
2004;"VILA BELA DA SANTISSIMA TRINDA (MT)";"MT";"VILA BELA DA SANTISSIMA TRINDA";46;2;11;59
2004;"VILA RICA (MT)";"MT";"VILA RICA";136;2;11;149
2004;"ABAETETUBA (PA)";"PA";"ABAETETUBA";168;5;89;262
2004;"ABEL FIGUEIREDO (PA)";"PA";"ABEL FIGUEIREDO";25;6;3;34
2004;"ACARA (PA)";"PA";"ACARA";42;2;9;53
2004;"AFUA (PA)";"PA";"AFUA";0;0;0;0
2004;"AGUA AZUL DO NORTE (PA)";"PA";"AGUA AZUL DO NORTE";15;2;3;20
2004;"ALENQUER (PA)";"PA";"ALENQUER";81;2;21;104
2004;"ALMEIRIM (PA)";"PA";"ALMEIRIM";165;5;48;218
2004;"ALTAMIRA (PA)";"PA";"ALTAMIRA";587;60;31;678
2004;"ANAJAS (PA)";"PA";"ANAJAS";0;0;0;0
2004;"ANANINDEUA (PA)";"PA";"ANANINDEUA";2281;127;777;3185
2004;"ANAPU (PA)";"PA";"ANAPU";22;4;1;27
2004;"AUGUSTO CORREA (PA)";"PA";"AUGUSTO CORREA";17;1;21;39
2004;"AURORA DO PARA (PA)";"PA";"AURORA DO PARA";24;0;28;52
2004;"AVEIRO (PA)";"PA";"AVEIRO";0;0;0;0
2004;"BAGRE (PA)";"PA";"BAGRE";0;0;0;0
2004;"BAIAO (PA)";"PA";"BAIAO";13;0;3;16
2004;"BANNACH (PA)";"PA";"BANNACH";10;1;1;12
2004;"BARCARENA (PA)";"PA";"BARCARENA";336;98;289;723
2004;"BELEM (PA)";"PA";"BELEM";5703;678;2209;8590
2004;"BELTERRA (PA)";"PA";"BELTERRA";16;0;6;22
2004;"BENEVIDES (PA)";"PA";"BENEVIDES";211;9;40;260
2004;"BOM JESUS DO TOCANTINS (PA)";"PA";"BOM JESUS DO TOCANTINS";34;15;2;51
2004;"BONITO (PA)";"PA";"BONITO";18;0;15;33
2004;"BRAGANCA (PA)";"PA";"BRAGANCA";243;22;88;353
2004;"BRASIL NOVO (PA)";"PA";"BRASIL NOVO";52;23;5;80
2004;"BREJO GRANDE DO ARAGUAIA (PA)";"PA";"BREJO GRANDE DO ARAGUAIA";6;4;4;14
2004;"BREU BRANCO (PA)";"PA";"BREU BRANCO";155;13;25;193
2004;"BREVES (PA)";"PA";"BREVES";13;0;3;16
2004;"BUJARU (PA)";"PA";"BUJARU";19;2;4;25
2004;"CACHOEIRA DO ARARI (PA)";"PA";"CACHOEIRA DO ARARI";3;1;1;5
2004;"CACHOEIRA DO PIRIA (PA)";"PA";"CACHOEIRA DO PIRIA";11;2;6;19
2004;"CAMETA (PA)";"PA";"CAMETA";57;2;18;77
2004;"CANAA DOS CARAJAS (PA)";"PA";"CANAA DOS CARAJAS";55;18;9;82
2004;"CAPANEMA (PA)";"PA";"CAPANEMA";447;15;67;529
2004;"CAPITAO POCO (PA)";"PA";"CAPITAO POCO";221;9;34;264
2004;"CASTANHAL (PA)";"PA";"CASTANHAL";1551;86;198;1835
2004;"CHAVES (PA)";"PA";"CHAVES";0;0;0;0
2004;"COLARES (PA)";"PA";"COLARES";2;0;1;3
2004;"CONCEICAO DO ARAGUAIA (PA)";"PA";"CONCEICAO DO ARAGUAIA";237;22;42;301
2004;"CONCORDIA DO PARA (PA)";"PA";"CONCORDIA DO PARA";63;0;6;69
2004;"CUMARU DO NORTE (PA)";"PA";"CUMARU DO NORTE";7;0;3;10
2004;"CURIONOPOLIS (PA)";"PA";"CURIONOPOLIS";34;61;1;96
2004;"CURRALINHO (PA)";"PA";"CURRALINHO";1;0;0;1
2004;"CURUA (PA)";"PA";"CURUA";0;0;0;0
2004;"CURUCA (PA)";"PA";"CURUCA";30;3;3;36
2004;"DOM ELISEU (PA)";"PA";"DOM ELISEU";320;19;10;349
2004;"ELDORADO DOS CARAJAS (PA)";"PA";"ELDORADO DOS CARAJAS";59;1;1;61
2004;"FARO (PA)";"PA";"FARO";2;1;0;3
2004;"FLORESTA DO ARAGUAIA (PA)";"PA";"FLORESTA DO ARAGUAIA";37;1;3;41
2004;"GARRAFAO DO NORTE (PA)";"PA";"GARRAFAO DO NORTE";39;1;3;43
2004;"GOIANESIA DO PARA (PA)";"PA";"GOIANESIA DO PARA";120;5;15;140
2004;"GURUPA (PA)";"PA";"GURUPA";2;0;0;2
2004;"IGARAPE ACU (PA)";"PA";"IGARAPE ACU";87;35;35;157
2004;"IGARAPE MIRI (PA)";"PA";"IGARAPE MIRI";37;9;10;56
2004;"INHANGAPI (PA)";"PA";"INHANGAPI";11;0;15;26
2004;"IPIXUNA DO PARA (PA)";"PA";"IPIXUNA DO PARA";56;2;7;65
2004;"IRITUIA (PA)";"PA";"IRITUIA";38;2;21;61
2004;"ITAITUBA (PA)";"PA";"ITAITUBA";430;32;41;503
2004;"ITUPIRANGA (PA)";"PA";"ITUPIRANGA";51;50;13;114
2004;"JACAREACANGA (PA)";"PA";"JACAREACANGA";3;0;0;3
2004;"JACUNDA (PA)";"PA";"JACUNDA";309;8;29;346
2004;"JURUTI (PA)";"PA";"JURUTI";8;1;0;9
2004;"LIMOEIRO DO AJURU (PA)";"PA";"LIMOEIRO DO AJURU";0;0;0;0
2004;"MAE DO RIO (PA)";"PA";"MAE DO RIO";205;7;33;245
2004;"MAGALHAES BARATA (PA)";"PA";"MAGALHAES BARATA";6;1;2;9
2004;"MARABA (PA)";"PA";"MARABA";1689;140;196;2025
2004;"MARACANA (PA)";"PA";"MARACANA";6;4;10;20
2004;"MARAPANIM (PA)";"PA";"MARAPANIM";16;10;9;35
2004;"MARITUBA (PA)";"PA";"MARITUBA";295;10;74;379
2004;"MEDICILANDIA (PA)";"PA";"MEDICILANDIA";103;8;6;117
2004;"MELGACO (PA)";"PA";"MELGACO";1;0;0;1
2004;"MOCAJUBA (PA)";"PA";"MOCAJUBA";6;1;2;9
2004;"MOJU (PA)";"PA";"MOJU";82;4;50;136
2004;"MONTE ALEGRE (PA)";"PA";"MONTE ALEGRE";150;2;63;215
2004;"MUANA (PA)";"PA";"MUANA";0;1;0;1
2004;"NOVA ESPERANCA DO PIRIA (PA)";"PA";"NOVA ESPERANCA DO PIRIA";21;1;3;25
2004;"NOVA IPIXUNA (PA)";"PA";"NOVA IPIXUNA";62;5;12;79
2004;"NOVA TIMBOTEUA (PA)";"PA";"NOVA TIMBOTEUA";31;4;6;41
2004;"NOVO PROGRESSO (PA)";"PA";"NOVO PROGRESSO";36;2;1;39
2004;"NOVO REPARTIMENTO (PA)";"PA";"NOVO REPARTIMENTO";149;9;12;170
2004;"OBIDOS (PA)";"PA";"OBIDOS";102;0;19;121
2004;"OEIRAS DO PARA (PA)";"PA";"OEIRAS DO PARA";3;1;0;4
2004;"ORIXIMINA (PA)";"PA";"ORIXIMINA";153;6;12;171
2004;"OUREM (PA)";"PA";"OUREM";46;1;8;55
2004;"OURILANDIA DO NORTE (PA)";"PA";"OURILANDIA DO NORTE";45;1;5;51
2004;"PACAJA (PA)";"PA";"PACAJA";50;6;3;59
2004;"PALESTINA DO PARA (PA)";"PA";"PALESTINA DO PARA";9;2;1;12
2004;"PARAGOMINAS (PA)";"PA";"PARAGOMINAS";797;11;41;849
2004;"PARAUAPEBAS (PA)";"PA";"PARAUAPEBAS";532;273;88;893
2004;"PAU D ARCO (PA)";"PA";"PAU D ARCO";7;3;0;10
2004;"PEIXE BOI (PA)";"PA";"PEIXE BOI";12;1;9;22
2004;"PICARRA (PA)";"PA";"PICARRA";5;0;1;6
2004;"PLACAS (PA)";"PA";"PLACAS";17;2;1;20
2004;"PONTA DE PEDRAS (PA)";"PA";"PONTA DE PEDRAS";1;0;0;1
2004;"PORTEL (PA)";"PA";"PORTEL";9;0;0;9
2004;"PORTO DE MOZ (PA)";"PA";"PORTO DE MOZ";9;0;0;9
2004;"PRAINHA (PA)";"PA";"PRAINHA";10;0;1;11
2004;"PRIMAVERA (PA)";"PA";"PRIMAVERA";9;2;6;17
2004;"QUATIPURU (PA)";"PA";"QUATIPURU";3;2;11;16
2004;"REDENCAO (PA)";"PA";"REDENCAO";539;30;14;583
2004;"RIO MARIA (PA)";"PA";"RIO MARIA";118;26;8;152
2004;"RONDON DO PARA (PA)";"PA";"RONDON DO PARA";295;35;5;335
2004;"RUROPOLIS (PA)";"PA";"RUROPOLIS";79;1;6;86
2004;"SALINOPOLIS (PA)";"PA";"SALINOPOLIS";77;10;26;113
2004;"SALVATERRA (PA)";"PA";"SALVATERRA";14;10;4;28
2004;"SANTA BARBARA DO PARA (PA)";"PA";"SANTA BARBARA DO PARA";24;6;2;32
2004;"SANTA CRUZ DO ARARI (PA)";"PA";"SANTA CRUZ DO ARARI";1;0;0;1
2004;"SANTA ISABEL DO PARA (PA)";"PA";"SANTA ISABEL DO PARA";383;11;51;445
2004;"SANTA LUZIA DO PARA (PA)";"PA";"SANTA LUZIA DO PARA";70;1;19;90
2004;"SANTA MARIA DAS BARREIRAS (PA)";"PA";"SANTA MARIA DAS BARREIRAS";9;0;1;10
2004;"SANTA MARIA DO PARA (PA)";"PA";"SANTA MARIA DO PARA";155;18;27;200
2004;"SANTANA DO ARAGUAIA (PA)";"PA";"SANTANA DO ARAGUAIA";76;8;13;97
2004;"SANTAREM (PA)";"PA";"SANTAREM";1508;46;366;1920
2004;"SANTAREM NOVO (PA)";"PA";"SANTAREM NOVO";7;3;7;17
2004;"SANTO ANTONIO DO TAUA (PA)";"PA";"SANTO ANTONIO DO TAUA";52;4;40;96
2004;"SAO CAETANO DE ODIVELAS (PA)";"PA";"SAO CAETANO DE ODIVELAS";13;1;0;14
2004;"SAO DOMINGOS DO ARAGUAIA (PA)";"PA";"SAO DOMINGOS DO ARAGUAIA";58;14;14;86
2004;"SAO DOMINGOS DO CAPIM (PA)";"PA";"SAO DOMINGOS DO CAPIM";21;0;8;29
2004;"SAO FELIX DO XINGU (PA)";"PA";"SAO FELIX DO XINGU";58;2;6;66
2004;"SAO FRANCISCO DO PARA (PA)";"PA";"SAO FRANCISCO DO PARA";20;22;13;55
2004;"SAO GERALDO DO ARAGUAIA (PA)";"PA";"SAO GERALDO DO ARAGUAIA";65;1;7;73
2004;"SAO JOAO DA PONTA (PA)";"PA";"SAO JOAO DA PONTA";1;2;2;5
2004;"SAO JOAO DE PIRABAS (PA)";"PA";"SAO JOAO DE PIRABAS";11;6;7;24
2004;"SAO JOAO DO ARAGUAIA (PA)";"PA";"SAO JOAO DO ARAGUAIA";6;6;8;20
2004;"SAO MIGUEL DO GUAMA (PA)";"PA";"SAO MIGUEL DO GUAMA";252;17;41;310
2004;"SAO SEBASTIAO DA BOA VISTA (PA)";"PA";"SAO SEBASTIAO DA BOA VISTA";0;0;0;0
2004;"SAPUCAIA (PA)";"PA";"SAPUCAIA";17;2;1;20
2004;"SENADOR JOSE PORFIRIO (PA)";"PA";"SENADOR JOSE PORFIRIO";8;0;0;8
2004;"SOURE (PA)";"PA";"SOURE";15;1;6;22
2004;"TAILANDIA (PA)";"PA";"TAILANDIA";304;7;20;331
2004;"TERRA ALTA (PA)";"PA";"TERRA ALTA";9;7;9;25
2004;"TERRA SANTA (PA)";"PA";"TERRA SANTA";6;1;1;8
2004;"TOME ACU (PA)";"PA";"TOME ACU";245;8;43;296
2004;"TRACUATEUA (PA)";"PA";"TRACUATEUA";12;4;25;41
2004;"TRAIRAO (PA)";"PA";"TRAIRAO";45;0;0;45
2004;"TUCUMA (PA)";"PA";"TUCUMA";181;5;16;202
2004;"TUCURUI (PA)";"PA";"TUCURUI";440;62;93;595
2004;"ULIANOPOLIS (PA)";"PA";"ULIANOPOLIS";104;11;10;125
2004;"URUARA (PA)";"PA";"URUARA";237;1;8;246
2004;"VIGIA (PA)";"PA";"VIGIA";77;2;19;98
2004;"VISEU (PA)";"PA";"VISEU";22;3;16;41
2004;"VITORIA DO XINGU (PA)";"PA";"VITORIA DO XINGU";6;11;3;20
2004;"XINGUARA (PA)";"PA";"XINGUARA";411;17;73;501
2004;"AGUA BRANCA (PB)";"PB";"AGUA BRANCA";1;0;2;3
2004;"AGUIAR (PB)";"PB";"AGUIAR";4;0;2;6
2004;"ALAGOA GRANDE (PB)";"PB";"ALAGOA GRANDE";67;9;22;98
2004;"ALAGOA NOVA (PB)";"PB";"ALAGOA NOVA";46;5;10;61
2004;"ALAGOINHA (PB)";"PB";"ALAGOINHA";29;3;9;41
2004;"ALCANTIL (PB)";"PB";"ALCANTIL";21;2;2;25
2004;"ALGODAO DE JANDAIRA (PB)";"PB";"ALGODAO DE JANDAIRA";8;0;2;10
2004;"ALHANDRA (PB)";"PB";"ALHANDRA";49;8;9;66
2004;"AMPARO (PB)";"PB";"AMPARO";1;1;3;5
2004;"APARECIDA (PB)";"PB";"APARECIDA";15;1;1;17
2004;"ARACAGI (PB)";"PB";"ARACAGI";36;0;18;54
2004;"ARARA (PB)";"PB";"ARARA";31;2;13;46
2004;"ARARUNA (PB)";"PB";"ARARUNA";60;9;13;82
2004;"AREIA (PB)";"PB";"AREIA";90;10;8;108
2004;"AREIA DE BARAUNAS (PB)";"PB";"AREIA DE BARAUNAS";3;1;1;5
2004;"AREIAL (PB)";"PB";"AREIAL";8;1;4;13
2004;"AROEIRAS (PB)";"PB";"AROEIRAS";10;2;3;15
2004;"ASSUNCAO (PB)";"PB";"ASSUNCAO";2;2;1;5
2004;"BAIA DA TRAICAO (PB)";"PB";"BAIA DA TRAICAO";3;1;4;8
2004;"BANANEIRAS (PB)";"PB";"BANANEIRAS";43;3;16;62
2004;"BARAUNA (PB)";"PB";"BARAUNA";7;1;0;8
2004;"BARRA DE SANTA ROSA (PB)";"PB";"BARRA DE SANTA ROSA";23;1;9;33
2004;"BARRA DE SANTANA (PB)";"PB";"BARRA DE SANTANA";35;0;2;37
2004;"BARRA DE SAO MIGUEL (PB)";"PB";"BARRA DE SAO MIGUEL";0;0;2;2
2004;"BAYEUX (PB)";"PB";"BAYEUX";323;21;125;469
2004;"BELEM (PB)";"PB";"BELEM";84;3;9;96
2004;"BELEM DO BREJO DO CRUZ (PB)";"PB";"BELEM DO BREJO DO CRUZ";7;8;1;16
2004;"BERNARDINO BATISTA (PB)";"PB";"BERNARDINO BATISTA";0;0;1;1
2004;"BOA VENTURA (PB)";"PB";"BOA VENTURA";7;4;0;11
2004;"BOA VISTA (PB)";"PB";"BOA VISTA";58;1;6;65
2004;"BOM JESUS (PB)";"PB";"BOM JESUS";3;1;0;4
2004;"BOM SUCESSO (PB)";"PB";"BOM SUCESSO";5;1;3;9
2004;"BONITO DE SANTA FE (PB)";"PB";"BONITO DE SANTA FE";13;1;0;14
2004;"BOQUEIRAO (PB)";"PB";"BOQUEIRAO";95;3;12;110
2004;"BORBOREMA (PB)";"PB";"BORBOREMA";17;3;1;21
2004;"BREJO DO CRUZ (PB)";"PB";"BREJO DO CRUZ";39;4;2;45
2004;"BREJO DOS SANTOS (PB)";"PB";"BREJO DOS SANTOS";13;2;1;16
2004;"CAAPORA (PB)";"PB";"CAAPORA";15;8;1;24
2004;"CABACEIRAS (PB)";"PB";"CABACEIRAS";16;5;12;33
2004;"CABEDELO (PB)";"PB";"CABEDELO";191;22;14;227
2004;"CACHOEIRA DOS INDIOS (PB)";"PB";"CACHOEIRA DOS INDIOS";10;0;2;12
2004;"CACIMBA DE AREIA (PB)";"PB";"CACIMBA DE AREIA";9;0;3;12
2004;"CACIMBA DE DENTRO (PB)";"PB";"CACIMBA DE DENTRO";27;6;26;59
2004;"CACIMBAS (PB)";"PB";"CACIMBAS";3;0;2;5
2004;"CAICARA (PB)";"PB";"CAICARA";12;2;2;16
2004;"CAJAZEIRAS (PB)";"PB";"CAJAZEIRAS";405;10;30;445
2004;"CAJAZEIRINHAS (PB)";"PB";"CAJAZEIRINHAS";4;1;0;5
2004;"CALDAS BRANDAO (PB)";"PB";"CALDAS BRANDAO";8;1;2;11
2004;"CAMALAU (PB)";"PB";"CAMALAU";13;3;5;21
2004;"CAMPINA GRANDE (PB)";"PB";"CAMPINA GRANDE";3430;139;615;4184
2004;"CAPIM (PB)";"PB";"CAPIM";8;0;1;9
2004;"CARAUBAS (PB)";"PB";"CARAUBAS";2;1;1;4
2004;"CARRAPATEIRA (PB)";"PB";"CARRAPATEIRA";0;2;0;2
2004;"CASSERENGUE (PB)";"PB";"CASSERENGUE";8;0;6;14
2004;"CATINGUEIRA (PB)";"PB";"CATINGUEIRA";5;2;1;8
2004;"CATOLE DO ROCHA (PB)";"PB";"CATOLE DO ROCHA";232;11;11;254
2004;"CATURITE (PB)";"PB";"CATURITE";42;0;5;47
2004;"CONCEICAO (PB)";"PB";"CONCEICAO";66;8;6;80
2004;"CONDADO (PB)";"PB";"CONDADO";13;1;2;16
2004;"CONDE (PB)";"PB";"CONDE";32;3;3;38
2004;"CONGO (PB)";"PB";"CONGO";12;1;1;14
2004;"COREMAS (PB)";"PB";"COREMAS";22;2;4;28
2004;"COXIXOLA (PB)";"PB";"COXIXOLA";2;2;0;4
2004;"CRUZ DO ESPIRITO SANTO (PB)";"PB";"CRUZ DO ESPIRITO SANTO";13;3;6;22
2004;"CUBATI (PB)";"PB";"CUBATI";9;1;0;10
2004;"CUITE (PB)";"PB";"CUITE";72;0;8;80
2004;"CUITE DE MAMANGUAPE (PB)";"PB";"CUITE DE MAMANGUAPE";4;3;10;17
2004;"CUITEGI (PB)";"PB";"CUITEGI";5;2;1;8
2004;"CURRAL DE CIMA (PB)";"PB";"CURRAL DE CIMA";16;2;6;24
2004;"CURRAL VELHO (PB)";"PB";"CURRAL VELHO";2;1;2;5
2004;"DAMIAO (PB)";"PB";"DAMIAO";9;1;4;14
2004;"DESTERRO (PB)";"PB";"DESTERRO";14;0;2;16
2004;"DIAMANTE (PB)";"PB";"DIAMANTE";3;2;0;5
2004;"DONA INES (PB)";"PB";"DONA INES";13;0;8;21
2004;"DUAS ESTRADAS (PB)";"PB";"DUAS ESTRADAS";5;4;2;11
2004;"EMAS (PB)";"PB";"EMAS";3;0;2;5
2004;"ESPERANCA (PB)";"PB";"ESPERANCA";250;13;57;320
2004;"FAGUNDES (PB)";"PB";"FAGUNDES";22;2;13;37
2004;"FREI MARTINHO (PB)";"PB";"FREI MARTINHO";6;1;2;9
2004;"GADO BRAVO (PB)";"PB";"GADO BRAVO";16;2;4;22
2004;"GUARABIRA (PB)";"PB";"GUARABIRA";314;18;101;433
2004;"GURINHEM (PB)";"PB";"GURINHEM";19;2;8;29
2004;"GURJAO (PB)";"PB";"GURJAO";2;1;0;3
2004;"IBIARA (PB)";"PB";"IBIARA";3;1;1;5
2004;"IGARACY (PB)";"PB";"IGARACY";8;3;2;13
2004;"IMACULADA (PB)";"PB";"IMACULADA";6;1;1;8
2004;"INGA (PB)";"PB";"INGA";95;2;19;116
2004;"ITABAIANA (PB)";"PB";"ITABAIANA";178;8;24;210
2004;"ITAPORANGA (PB)";"PB";"ITAPORANGA";61;9;8;78
2004;"ITAPOROROCA (PB)";"PB";"ITAPOROROCA";48;2;5;55
2004;"ITATUBA (PB)";"PB";"ITATUBA";15;2;1;18
2004;"JACARAU (PB)";"PB";"JACARAU";27;2;10;39
2004;"JERICO (PB)";"PB";"JERICO";28;1;0;29
2004;"JOAO PESSOA (PB)";"PB";"JOAO PESSOA";3276;458;856;4590
2004;"JUAREZ TAVORA (PB)";"PB";"JUAREZ TAVORA";11;2;7;20
2004;"JUAZEIRINHO (PB)";"PB";"JUAZEIRINHO";40;6;3;49
2004;"JUNCO DO SERIDO (PB)";"PB";"JUNCO DO SERIDO";32;1;1;34
2004;"JURIPIRANGA (PB)";"PB";"JURIPIRANGA";25;2;15;42
2004;"JURU (PB)";"PB";"JURU";8;4;1;13
2004;"LAGOA (PB)";"PB";"LAGOA";7;2;3;12
2004;"LAGOA DE DENTRO (PB)";"PB";"LAGOA DE DENTRO";9;0;4;13
2004;"LAGOA SECA (PB)";"PB";"LAGOA SECA";79;12;9;100
2004;"LASTRO (PB)";"PB";"LASTRO";7;2;0;9
2004;"LIVRAMENTO (PB)";"PB";"LIVRAMENTO";20;3;1;24
2004;"LOGRADOURO (PB)";"PB";"LOGRADOURO";0;1;4;5
2004;"LUCENA (PB)";"PB";"LUCENA";12;3;9;24
2004;"MAE D AGUA (PB)";"PB";"MAE D AGUA";0;1;4;5
2004;"MALTA (PB)";"PB";"MALTA";2;2;2;6
2004;"MAMANGUAPE (PB)";"PB";"MAMANGUAPE";256;8;48;312
2004;"MANAIRA (PB)";"PB";"MANAIRA";4;0;1;5
2004;"MARCACAO (PB)";"PB";"MARCACAO";0;3;2;5
2004;"MARI (PB)";"PB";"MARI";52;6;26;84
2004;"MARIZOPOLIS (PB)";"PB";"MARIZOPOLIS";9;2;0;11
2004;"MASSARANDUBA (PB)";"PB";"MASSARANDUBA";14;1;4;19
2004;"MATARACA (PB)";"PB";"MATARACA";21;2;6;29
2004;"MATINHAS (PB)";"PB";"MATINHAS";3;0;0;3
2004;"MATO GROSSO (PB)";"PB";"MATO GROSSO";9;2;1;12
2004;"MATUREIA (PB)";"PB";"MATUREIA";10;0;1;11
2004;"MOGEIRO (PB)";"PB";"MOGEIRO";12;1;2;15
2004;"MONTADAS (PB)";"PB";"MONTADAS";10;0;5;15
2004;"MONTE HOREBE (PB)";"PB";"MONTE HOREBE";6;0;2;8
2004;"MONTEIRO (PB)";"PB";"MONTEIRO";200;24;24;248
2004;"MULUNGU (PB)";"PB";"MULUNGU";20;0;8;28
2004;"NATUBA (PB)";"PB";"NATUBA";8;1;0;9
2004;"NAZAREZINHO (PB)";"PB";"NAZAREZINHO";16;0;2;18
2004;"NOVA FLORESTA (PB)";"PB";"NOVA FLORESTA";23;2;5;30
2004;"NOVA OLINDA (PB)";"PB";"NOVA OLINDA";5;2;1;8
2004;"NOVA PALMEIRA (PB)";"PB";"NOVA PALMEIRA";9;1;2;12
2004;"OLHO D AGUA (PB)";"PB";"OLHO D AGUA";5;3;3;11
2004;"OLIVEDOS (PB)";"PB";"OLIVEDOS";14;2;6;22
2004;"OURO VELHO (PB)";"PB";"OURO VELHO";6;5;0;11
2004;"PARARI (PB)";"PB";"PARARI";0;1;0;1
2004;"PASSAGEM (PB)";"PB";"PASSAGEM";8;0;1;9
2004;"PATOS (PB)";"PB";"PATOS";674;26;33;733
2004;"PAULISTA (PB)";"PB";"PAULISTA";30;2;2;34
2004;"PEDRA BRANCA (PB)";"PB";"PEDRA BRANCA";6;0;3;9
2004;"PEDRA LAVRADA (PB)";"PB";"PEDRA LAVRADA";9;2;2;13
2004;"PEDRAS DE FOGO (PB)";"PB";"PEDRAS DE FOGO";199;12;37;248
2004;"PEDRO REGIS (PB)";"PB";"PEDRO REGIS";15;1;2;18
2004;"PIANCO (PB)";"PB";"PIANCO";51;5;2;58
2004;"PICUI (PB)";"PB";"PICUI";61;1;9;71
2004;"PILAR (PB)";"PB";"PILAR";10;1;9;20
2004;"PILOES (PB)";"PB";"PILOES";8;1;3;12
2004;"PILOEZINHOS (PB)";"PB";"PILOEZINHOS";7;2;3;12
2004;"PIRPIRITUBA (PB)";"PB";"PIRPIRITUBA";16;1;4;21
2004;"PITIMBU (PB)";"PB";"PITIMBU";9;6;3;18
2004;"POCINHOS (PB)";"PB";"POCINHOS";51;4;10;65
2004;"POCO DANTAS (PB)";"PB";"POCO DANTAS";2;1;1;4
2004;"POCO DE JOSE DE MOURA (PB)";"PB";"POCO DE JOSE DE MOURA";2;1;1;4
2004;"POMBAL (PB)";"PB";"POMBAL";254;2;11;267
2004;"PRATA (PB)";"PB";"PRATA";10;1;1;12
2004;"PRINCESA ISABEL (PB)";"PB";"PRINCESA ISABEL";74;18;1;93
2004;"PUXINANA (PB)";"PB";"PUXINANA";32;3;3;38
2004;"QUEIMADAS (PB)";"PB";"QUEIMADAS";214;19;49;282
2004;"QUIXABA (PB)";"PB";"QUIXABA";3;0;2;5
2004;"REMIGIO (PB)";"PB";"REMIGIO";149;3;13;165
2004;"RIACHAO (PB)";"PB";"RIACHAO";3;0;2;5
2004;"RIACHAO DO BACAMARTE (PB)";"PB";"RIACHAO DO BACAMARTE";1;0;2;3
2004;"RIACHAO DO POCO (PB)";"PB";"RIACHAO DO POCO";3;0;5;8
2004;"RIACHO DE SANTO ANTONIO (PB)";"PB";"RIACHO DE SANTO ANTONIO";0;0;1;1
2004;"RIACHO DOS CAVALOS (PB)";"PB";"RIACHO DOS CAVALOS";6;0;2;8
2004;"RIO TINTO (PB)";"PB";"RIO TINTO";39;1;12;52
2004;"SALGADINHO (PB)";"PB";"SALGADINHO";4;0;0;4
2004;"SALGADO DE SAO FELIX (PB)";"PB";"SALGADO DE SAO FELIX";15;3;0;18
2004;"SANTA CECILIA (PB)";"PB";"SANTA CECILIA";1;0;2;3
2004;"SANTA CRUZ (PB)";"PB";"SANTA CRUZ";8;2;5;15
2004;"SANTA HELENA (PB)";"PB";"SANTA HELENA";6;0;4;10
2004;"SANTA INES (PB)";"PB";"SANTA INES";9;0;0;9
2004;"SANTA LUZIA (PB)";"PB";"SANTA LUZIA";190;9;12;211
2004;"SANTA RITA (PB)";"PB";"SANTA RITA";399;26;136;561
2004;"SANTA TERESINHA (PB)";"PB";"SANTA TERESINHA";16;0;5;21
2004;"SANTANA DE MANGUEIRA (PB)";"PB";"SANTANA DE MANGUEIRA";5;0;0;5
2004;"SANTANA DOS GARROTES (PB)";"PB";"SANTANA DOS GARROTES";12;2;0;14
2004;"SANTAREM (PB)";"PB";"SANTAREM";3;0;0;3
2004;"SANTO ANDRE (PB)";"PB";"SANTO ANDRE";8;0;0;8
2004;"SAO BENTO (PB)";"PB";"SAO BENTO";182;12;7;201
2004;"SAO BENTO DE POMBAL (PB)";"PB";"SAO BENTO DE POMBAL";3;2;2;7
2004;"SAO DOMINGOS DE POMBAL (PB)";"PB";"SAO DOMINGOS DE POMBAL";1;0;2;3
2004;"SAO DOMINGOS DO CARIRI (PB)";"PB";"SAO DOMINGOS DO CARIRI";2;0;1;3
2004;"SAO FRANCISCO (PB)";"PB";"SAO FRANCISCO";11;0;1;12
2004;"SAO JOAO DO CARIRI (PB)";"PB";"SAO JOAO DO CARIRI";0;1;3;4
2004;"SAO JOAO DO RIO DO PEIXE (PB)";"PB";"SAO JOAO DO RIO DO PEIXE";25;3;4;32
2004;"SAO JOAO DO TIGRE (PB)";"PB";"SAO JOAO DO TIGRE";7;0;1;8
2004;"SAO JOSE DA LAGOA TAPADA (PB)";"PB";"SAO JOSE DA LAGOA TAPADA";5;0;0;5
2004;"SAO JOSE DE CAIANA (PB)";"PB";"SAO JOSE DE CAIANA";4;2;1;7
2004;"SAO JOSE DE ESPINHARAS (PB)";"PB";"SAO JOSE DE ESPINHARAS";10;0;2;12
2004;"SAO JOSE DE PIRANHAS (PB)";"PB";"SAO JOSE DE PIRANHAS";20;4;1;25
2004;"SAO JOSE DE PRINCESA (PB)";"PB";"SAO JOSE DE PRINCESA";4;0;0;4
2004;"SAO JOSE DO BONFIM (PB)";"PB";"SAO JOSE DO BONFIM";5;0;1;6
2004;"SAO JOSE DO BREJO DO CRUZ (PB)";"PB";"SAO JOSE DO BREJO DO CRUZ";0;0;0;0
2004;"SAO JOSE DO SABUGI (PB)";"PB";"SAO JOSE DO SABUGI";14;2;1;17
2004;"SAO JOSE DOS CORDEIROS (PB)";"PB";"SAO JOSE DOS CORDEIROS";2;2;0;4
2004;"SAO JOSE DOS RAMOS (PB)";"PB";"SAO JOSE DOS RAMOS";20;2;3;25
2004;"SAO MAMEDE (PB)";"PB";"SAO MAMEDE";12;1;1;14
2004;"SAO MIGUEL DE TAIPU (PB)";"PB";"SAO MIGUEL DE TAIPU";14;0;2;16
2004;"SAO SEBASTIAO DE LAGOA DE ROCA (PB)";"PB";"SAO SEBASTIAO DE LAGOA DE ROCA";14;1;4;19
2004;"SAO SEBASTIAO DO UMBUZEIRO (PB)";"PB";"SAO SEBASTIAO DO UMBUZEIRO";4;0;2;6
2004;"SAPE (PB)";"PB";"SAPE";328;9;53;390
2004;"SERIDO (PB)";"PB";"SERIDO";12;1;2;15
2004;"SERRA BRANCA (PB)";"PB";"SERRA BRANCA";49;6;3;58
2004;"SERRA DA RAIZ (PB)";"PB";"SERRA DA RAIZ";2;0;3;5
2004;"SERRA GRANDE (PB)";"PB";"SERRA GRANDE";3;0;0;3
2004;"SERRA REDONDA (PB)";"PB";"SERRA REDONDA";11;0;1;12
2004;"SERRARIA (PB)";"PB";"SERRARIA";11;3;3;17
2004;"SERTAOZINHO (PB)";"PB";"SERTAOZINHO";4;1;0;5
2004;"SOBRADO (PB)";"PB";"SOBRADO";13;1;0;14
2004;"SOLANEA (PB)";"PB";"SOLANEA";127;7;22;156
2004;"SOLEDADE (PB)";"PB";"SOLEDADE";64;2;6;72
2004;"SOSSEGO (PB)";"PB";"SOSSEGO";9;1;2;12
2004;"SOUSA (PB)";"PB";"SOUSA";477;15;40;532
2004;"SUME (PB)";"PB";"SUME";53;7;9;69
2004;"TACIMA (PB)";"PB";"TACIMA";20;0;9;29
2004;"TAPEROA (PB)";"PB";"TAPEROA";29;3;3;35
2004;"TAVARES (PB)";"PB";"TAVARES";18;5;2;25
2004;"TEIXEIRA (PB)";"PB";"TEIXEIRA";84;4;11;99
2004;"TENORIO (PB)";"PB";"TENORIO";3;0;0;3
2004;"TRIUNFO (PB)";"PB";"TRIUNFO";4;1;1;6
2004;"UIRAUNA (PB)";"PB";"UIRAUNA";48;3;4;55
2004;"UMBUZEIRO (PB)";"PB";"UMBUZEIRO";28;9;12;49
2004;"VARZEA (PB)";"PB";"VARZEA";4;4;1;9
2004;"VIEIROPOLIS (PB)";"PB";"VIEIROPOLIS";7;0;2;9
2004;"VISTA SERRANA (PB)";"PB";"VISTA SERRANA";6;1;3;10
2004;"ZABELE (PB)";"PB";"ZABELE";2;0;0;2
2004;"ABREU E LIMA (PE)";"PE";"ABREU E LIMA";355;39;217;611
2004;"AFOGADOS DA INGAZEIRA (PE)";"PE";"AFOGADOS DA INGAZEIRA";196;16;12;224
2004;"AFRANIO (PE)";"PE";"AFRANIO";45;7;5;57
2004;"AGRESTINA (PE)";"PE";"AGRESTINA";83;4;8;95
2004;"AGUA PRETA (PE)";"PE";"AGUA PRETA";104;33;20;157
2004;"AGUAS BELAS (PE)";"PE";"AGUAS BELAS";164;27;23;214
2004;"ALAGOINHA (PE)";"PE";"ALAGOINHA";61;6;7;74
2004;"ALIANCA (PE)";"PE";"ALIANCA";77;1;43;121
2004;"ALTINHO (PE)";"PE";"ALTINHO";37;6;15;58
2004;"AMARAJI (PE)";"PE";"AMARAJI";44;6;9;59
2004;"ANGELIM (PE)";"PE";"ANGELIM";21;3;2;26
2004;"ARACOIABA (PE)";"PE";"ARACOIABA";34;11;41;86
2004;"ARARIPINA (PE)";"PE";"ARARIPINA";651;19;35;705
2004;"ARCOVERDE (PE)";"PE";"ARCOVERDE";830;57;54;941
2004;"BARRA DE GUABIRABA (PE)";"PE";"BARRA DE GUABIRABA";35;2;10;47
2004;"BARREIROS (PE)";"PE";"BARREIROS";210;6;17;233
2004;"BELEM DE MARIA (PE)";"PE";"BELEM DE MARIA";49;7;3;59
2004;"BELEM DE SAO FRANCISCO (PE)";"PE";"BELEM DE SAO FRANCISCO";60;7;4;71
2004;"BELO JARDIM (PE)";"PE";"BELO JARDIM";385;23;39;447
2004;"BETANIA (PE)";"PE";"BETANIA";22;4;2;28
2004;"BEZERROS (PE)";"PE";"BEZERROS";441;19;41;501
2004;"BODOCO (PE)";"PE";"BODOCO";95;3;11;109
2004;"BOM CONSELHO (PE)";"PE";"BOM CONSELHO";257;30;18;305
2004;"BOM JARDIM (PE)";"PE";"BOM JARDIM";84;4;15;103
2004;"BONITO (PE)";"PE";"BONITO";183;8;17;208
2004;"BREJAO (PE)";"PE";"BREJAO";22;0;6;28
2004;"BREJINHO (PE)";"PE";"BREJINHO";10;3;2;15
2004;"BREJO DA MADRE DE DEUS (PE)";"PE";"BREJO DA MADRE DE DEUS";100;3;5;108
2004;"BUENOS AIRES (PE)";"PE";"BUENOS AIRES";38;2;3;43
2004;"BUIQUE (PE)";"PE";"BUIQUE";151;10;16;177
2004;"CABO DE SANTO AGOSTINHO (PE)";"PE";"CABO DE SANTO AGOSTINHO";677;82;253;1012
2004;"CABROBO (PE)";"PE";"CABROBO";147;8;4;159
2004;"CACHOEIRINHA (PE)";"PE";"CACHOEIRINHA";83;4;6;93
2004;"CAETES (PE)";"PE";"CAETES";160;11;6;177
2004;"CALCADO (PE)";"PE";"CALCADO";22;2;12;36
2004;"CALUMBI (PE)";"PE";"CALUMBI";44;1;1;46
2004;"CAMARAGIBE (PE)";"PE";"CAMARAGIBE";487;97;142;726
2004;"CAMOCIM DE SAO FELIX (PE)";"PE";"CAMOCIM DE SAO FELIX";110;7;2;119
2004;"CAMUTANGA (PE)";"PE";"CAMUTANGA";67;0;11;78
2004;"CANHOTINHO (PE)";"PE";"CANHOTINHO";129;9;5;143
2004;"CAPOEIRAS (PE)";"PE";"CAPOEIRAS";120;15;3;138
2004;"CARNAIBA (PE)";"PE";"CARNAIBA";24;8;3;35
2004;"CARNAUBEIRA DA PENHA (PE)";"PE";"CARNAUBEIRA DA PENHA";19;1;0;20
2004;"CARPINA (PE)";"PE";"CARPINA";576;71;51;698
2004;"CARUARU (PE)";"PE";"CARUARU";2753;198;356;3307
2004;"CASINHAS (PE)";"PE";"CASINHAS";12;2;5;19
2004;"CATENDE (PE)";"PE";"CATENDE";139;8;25;172
2004;"CEDRO (PE)";"PE";"CEDRO";24;3;8;35
2004;"CHA DE ALEGRIA (PE)";"PE";"CHA DE ALEGRIA";27;5;10;42
2004;"CHA GRANDE (PE)";"PE";"CHA GRANDE";132;12;12;156
2004;"CONDADO (PE)";"PE";"CONDADO";94;4;42;140
2004;"CORRENTES (PE)";"PE";"CORRENTES";54;17;2;73
2004;"CORTES (PE)";"PE";"CORTES";47;6;11;64
2004;"CUMARU (PE)";"PE";"CUMARU";58;1;3;62
2004;"CUPIRA (PE)";"PE";"CUPIRA";163;13;10;186
2004;"CUSTODIA (PE)";"PE";"CUSTODIA";186;17;12;215
2004;"DORMENTES (PE)";"PE";"DORMENTES";33;3;1;37
2004;"ESCADA (PE)";"PE";"ESCADA";265;26;73;364
2004;"EXU (PE)";"PE";"EXU";213;5;14;232
2004;"FEIRA NOVA (PE)";"PE";"FEIRA NOVA";112;8;6;126
2004;"FERNANDO DE NORONHA (PE)";"PE";"FERNANDO DE NORONHA";10;14;7;31
2004;"FERREIROS (PE)";"PE";"FERREIROS";32;3;19;54
2004;"FLORES (PE)";"PE";"FLORES";33;3;3;39
2004;"FLORESTA (PE)";"PE";"FLORESTA";219;2;3;224
2004;"FREI MIGUELINHO (PE)";"PE";"FREI MIGUELINHO";81;2;13;96
2004;"GAMELEIRA (PE)";"PE";"GAMELEIRA";47;7;16;70
2004;"GARANHUNS (PE)";"PE";"GARANHUNS";1259;73;64;1396
2004;"GLORIA DO GOITA (PE)";"PE";"GLORIA DO GOITA";94;22;2;118
2004;"GOIANA (PE)";"PE";"GOIANA";657;38;85;780
2004;"GRANITO (PE)";"PE";"GRANITO";11;0;2;13
2004;"GRAVATA (PE)";"PE";"GRAVATA";584;26;31;641
2004;"IATI (PE)";"PE";"IATI";21;6;8;35
2004;"IBIMIRIM (PE)";"PE";"IBIMIRIM";98;8;6;112
2004;"IBIRAJUBA (PE)";"PE";"IBIRAJUBA";27;0;2;29
2004;"IGARASSU (PE)";"PE";"IGARASSU";568;39;273;880
2004;"IGUARACI (PE)";"PE";"IGUARACI";52;4;8;64
2004;"INAJA (PE)";"PE";"INAJA";26;2;3;31
2004;"INGAZEIRA (PE)";"PE";"INGAZEIRA";6;0;1;7
2004;"IPOJUCA (PE)";"PE";"IPOJUCA";310;109;75;494
2004;"IPUBI (PE)";"PE";"IPUBI";99;5;15;119
2004;"ITACURUBA (PE)";"PE";"ITACURUBA";11;0;2;13
2004;"ITAIBA (PE)";"PE";"ITAIBA";49;8;2;59
2004;"ITAMARACA (PE)";"PE";"ITAMARACA";37;15;6;58
2004;"ITAMBE (PE)";"PE";"ITAMBE";287;7;57;351
2004;"ITAPETIM (PE)";"PE";"ITAPETIM";31;2;4;37
2004;"ITAPISSUMA (PE)";"PE";"ITAPISSUMA";32;76;4;112
2004;"ITAQUITINGA (PE)";"PE";"ITAQUITINGA";18;2;16;36
2004;"JABOATAO DOS GUARARAPES (PE)";"PE";"JABOATAO DOS GUARARAPES";3148;706;1470;5324
2004;"JAQUEIRA (PE)";"PE";"JAQUEIRA";31;2;4;37
2004;"JATAUBA (PE)";"PE";"JATAUBA";31;2;4;37
2004;"JATOBA (PE)";"PE";"JATOBA";12;2;2;16
2004;"JOAO ALFREDO (PE)";"PE";"JOAO ALFREDO";103;6;4;113
2004;"JOAQUIM NABUCO (PE)";"PE";"JOAQUIM NABUCO";85;9;13;107
2004;"JUCATI (PE)";"PE";"JUCATI";61;1;7;69
2004;"JUPI (PE)";"PE";"JUPI";105;4;6;115
2004;"JUREMA (PE)";"PE";"JUREMA";47;6;3;56
2004;"LAGOA DO CARRO (PE)";"PE";"LAGOA DO CARRO";47;10;6;63
2004;"LAGOA DO ITAENGA (PE)";"PE";"LAGOA DO ITAENGA";170;5;26;201
2004;"LAGOA DO OURO (PE)";"PE";"LAGOA DO OURO";29;10;2;41
2004;"LAGOA DOS GATOS (PE)";"PE";"LAGOA DOS GATOS";80;3;2;85
2004;"LAGOA GRANDE (PE)";"PE";"LAGOA GRANDE";44;6;12;62
2004;"LAJEDO (PE)";"PE";"LAJEDO";357;19;23;399
2004;"LIMOEIRO (PE)";"PE";"LIMOEIRO";307;18;34;359
2004;"MACAPARANA (PE)";"PE";"MACAPARANA";114;10;21;145
2004;"MACHADOS (PE)";"PE";"MACHADOS";72;0;3;75
2004;"MANARI (PE)";"PE";"MANARI";12;3;3;18
2004;"MARAIAL (PE)";"PE";"MARAIAL";100;2;10;112
2004;"MIRANDIBA (PE)";"PE";"MIRANDIBA";57;2;0;59
2004;"MOREILANDIA (PE)";"PE";"MOREILANDIA";11;0;3;14
2004;"MORENO (PE)";"PE";"MORENO";306;32;42;380
2004;"NAZARE DA MATA (PE)";"PE";"NAZARE DA MATA";155;9;17;181
2004;"OLINDA (PE)";"PE";"OLINDA";1918;275;842;3035
2004;"OROBO (PE)";"PE";"OROBO";44;4;10;58
2004;"OROCO (PE)";"PE";"OROCO";39;1;2;42
2004;"OURICURI (PE)";"PE";"OURICURI";376;14;52;442
2004;"PALMARES (PE)";"PE";"PALMARES";486;36;115;637
2004;"PALMEIRINA (PE)";"PE";"PALMEIRINA";10;5;1;16
2004;"PANELAS (PE)";"PE";"PANELAS";62;6;7;75
2004;"PARANATAMA (PE)";"PE";"PARANATAMA";23;2;7;32
2004;"PARNAMIRIM (PE)";"PE";"PARNAMIRIM";78;0;7;85
2004;"PASSIRA (PE)";"PE";"PASSIRA";115;8;14;137
2004;"PAUDALHO (PE)";"PE";"PAUDALHO";255;12;27;294
2004;"PAULISTA (PE)";"PE";"PAULISTA";869;164;166;1199
2004;"PEDRA (PE)";"PE";"PEDRA";61;3;7;71
2004;"PESQUEIRA (PE)";"PE";"PESQUEIRA";382;19;67;468
2004;"PETROLANDIA (PE)";"PE";"PETROLANDIA";187;3;11;201
2004;"PETROLINA (PE)";"PE";"PETROLINA";1791;182;253;2226
2004;"POCAO (PE)";"PE";"POCAO";42;5;2;49
2004;"POMBOS (PE)";"PE";"POMBOS";172;4;15;191
2004;"PRIMAVERA (PE)";"PE";"PRIMAVERA";46;3;20;69
2004;"QUIPAPA (PE)";"PE";"QUIPAPA";36;7;10;53
2004;"QUIXABA (PE)";"PE";"QUIXABA";9;2;1;12
2004;"RECIFE (PE)";"PE";"RECIFE";11031;1216;2536;14783
2004;"RIACHO DAS ALMAS (PE)";"PE";"RIACHO DAS ALMAS";147;2;24;173
2004;"RIBEIRAO (PE)";"PE";"RIBEIRAO";180;26;39;245
2004;"RIO FORMOSO (PE)";"PE";"RIO FORMOSO";89;6;31;126
2004;"SAIRE (PE)";"PE";"SAIRE";48;3;16;67
2004;"SALGADINHO (PE)";"PE";"SALGADINHO";6;1;2;9
2004;"SALGUEIRO (PE)";"PE";"SALGUEIRO";343;21;28;392
2004;"SALOA (PE)";"PE";"SALOA";36;7;1;44
2004;"SANHARO (PE)";"PE";"SANHARO";63;2;10;75
2004;"SANTA CRUZ (PE)";"PE";"SANTA CRUZ";49;2;7;58
2004;"SANTA CRUZ DA BAIXA VERDE (PE)";"PE";"SANTA CRUZ DA BAIXA VERDE";129;2;1;132
2004;"SANTA CRUZ DO CAPIBARIBE (PE)";"PE";"SANTA CRUZ DO CAPIBARIBE";410;23;24;457
2004;"SANTA FILOMENA (PE)";"PE";"SANTA FILOMENA";18;0;11;29
2004;"SANTA MARIA DA BOA VISTA (PE)";"PE";"SANTA MARIA DA BOA VISTA";101;6;18;125
2004;"SANTA MARIA DO CAMBUCA (PE)";"PE";"SANTA MARIA DO CAMBUCA";93;3;8;104
2004;"SANTA TEREZINHA (PE)";"PE";"SANTA TEREZINHA";23;3;2;28
2004;"SAO BENEDITO DO SUL (PE)";"PE";"SAO BENEDITO DO SUL";17;4;5;26
2004;"SAO BENTO DO UNA (PE)";"PE";"SAO BENTO DO UNA";407;14;35;456
2004;"SAO CAITANO (PE)";"PE";"SAO CAITANO";172;6;21;199
2004;"SAO JOAO (PE)";"PE";"SAO JOAO";53;11;7;71
2004;"SAO JOAQUIM DO MONTE (PE)";"PE";"SAO JOAQUIM DO MONTE";41;4;11;56
2004;"SAO JOSE DA COROA GRANDE (PE)";"PE";"SAO JOSE DA COROA GRANDE";40;3;4;47
2004;"SAO JOSE DO BELMONTE (PE)";"PE";"SAO JOSE DO BELMONTE";177;5;21;203
2004;"SAO JOSE DO EGITO (PE)";"PE";"SAO JOSE DO EGITO";299;15;22;336
2004;"SAO LOURENCO DA MATA (PE)";"PE";"SAO LOURENCO DA MATA";216;36;192;444
2004;"SAO VICENTE FERRER (PE)";"PE";"SAO VICENTE FERRER";76;2;7;85
2004;"SERRA TALHADA (PE)";"PE";"SERRA TALHADA";989;25;26;1040
2004;"SERRITA (PE)";"PE";"SERRITA";50;2;5;57
2004;"SERTANIA (PE)";"PE";"SERTANIA";264;12;19;295
2004;"SIRINHAEM (PE)";"PE";"SIRINHAEM";145;7;21;173
2004;"SOLIDAO (PE)";"PE";"SOLIDAO";9;0;1;10
2004;"SURUBIM (PE)";"PE";"SURUBIM";437;12;37;486
2004;"TABIRA (PE)";"PE";"TABIRA";102;6;6;114
2004;"TACAIMBO (PE)";"PE";"TACAIMBO";48;0;6;54
2004;"TACARATU (PE)";"PE";"TACARATU";23;7;3;33
2004;"TAMANDARE (PE)";"PE";"TAMANDARE";39;7;8;54
2004;"TAQUARITINGA DO NORTE (PE)";"PE";"TAQUARITINGA DO NORTE";93;11;6;110
2004;"TEREZINHA (PE)";"PE";"TEREZINHA";10;3;2;15
2004;"TERRA NOVA (PE)";"PE";"TERRA NOVA";71;1;4;76
2004;"TIMBAUBA (PE)";"PE";"TIMBAUBA";549;15;40;604
2004;"TORITAMA (PE)";"PE";"TORITAMA";141;7;8;156
2004;"TRACUNHAEM (PE)";"PE";"TRACUNHAEM";24;9;13;46
2004;"TRINDADE (PE)";"PE";"TRINDADE";165;4;7;176
2004;"TRIUNFO (PE)";"PE";"TRIUNFO";134;4;4;142
2004;"TUPANATINGA (PE)";"PE";"TUPANATINGA";72;4;2;78
2004;"TUPARETAMA (PE)";"PE";"TUPARETAMA";61;6;8;75
2004;"VENTUROSA (PE)";"PE";"VENTUROSA";73;10;3;86
2004;"VERDEJANTE (PE)";"PE";"VERDEJANTE";33;1;9;43
2004;"VERTENTE DO LERIO (PE)";"PE";"VERTENTE DO LERIO";37;0;3;40
2004;"VERTENTES (PE)";"PE";"VERTENTES";80;6;13;99
2004;"VICENCIA (PE)";"PE";"VICENCIA";208;6;38;252
2004;"VITORIA DE SANTO ANTAO (PE)";"PE";"VITORIA DE SANTO ANTAO";1803;47;208;2058
2004;"XEXEU (PE)";"PE";"XEXEU";26;5;5;36
2004;"ACAUA (PI)";"PI";"ACAUA";5;1;0;6
2004;"AGRICOLANDIA (PI)";"PI";"AGRICOLANDIA";8;0;4;12
2004;"AGUA BRANCA (PI)";"PI";"AGUA BRANCA";38;2;3;43
2004;"ALAGOINHA DO PIAUI (PI)";"PI";"ALAGOINHA DO PIAUI";6;1;2;9
2004;"ALEGRETE DO PIAUI (PI)";"PI";"ALEGRETE DO PIAUI";3;2;1;6
2004;"ALTO LONGA (PI)";"PI";"ALTO LONGA";9;1;3;13
2004;"ALTOS (PI)";"PI";"ALTOS";88;0;9;97
2004;"ALVORADA DO GURGUEIA (PI)";"PI";"ALVORADA DO GURGUEIA";7;1;1;9
2004;"AMARANTE (PI)";"PI";"AMARANTE";18;0;1;19
2004;"ANGICAL DO PIAUI (PI)";"PI";"ANGICAL DO PIAUI";8;0;1;9
2004;"ANISIO DE ABREU (PI)";"PI";"ANISIO DE ABREU";1;1;1;3
2004;"ANTONIO ALMEIDA (PI)";"PI";"ANTONIO ALMEIDA";9;1;1;11
2004;"AROAZES (PI)";"PI";"AROAZES";2;1;1;4
2004;"ARRAIAL (PI)";"PI";"ARRAIAL";0;0;1;1
2004;"ASSUNCAO DO PIAUI (PI)";"PI";"ASSUNCAO DO PIAUI";3;0;0;3
2004;"AVELINO LOPES (PI)";"PI";"AVELINO LOPES";7;3;1;11
2004;"BAIXA GRANDE DO RIBEIRO (PI)";"PI";"BAIXA GRANDE DO RIBEIRO";1;0;0;1
2004;"BARRA D ALCANTARA (PI)";"PI";"BARRA D ALCANTARA";5;0;0;5
2004;"BARRAS (PI)";"PI";"BARRAS";59;3;7;69
2004;"BARREIRAS DO PIAUI (PI)";"PI";"BARREIRAS DO PIAUI";3;0;0;3
2004;"BARRO DURO (PI)";"PI";"BARRO DURO";31;2;1;34
2004;"BATALHA (PI)";"PI";"BATALHA";27;1;5;33
2004;"BELA VISTA DO PIAUI (PI)";"PI";"BELA VISTA DO PIAUI";2;1;0;3
2004;"BELEM DO PIAUI (PI)";"PI";"BELEM DO PIAUI";1;0;0;1
2004;"BENEDITINOS (PI)";"PI";"BENEDITINOS";10;1;3;14
2004;"BERTOLINIA (PI)";"PI";"BERTOLINIA";3;2;0;5
2004;"BETANIA DO PIAUI (PI)";"PI";"BETANIA DO PIAUI";0;3;1;4
2004;"BOA HORA (PI)";"PI";"BOA HORA";0;0;1;1
2004;"BOCAINA (PI)";"PI";"BOCAINA";5;4;1;10
2004;"BOM JESUS (PI)";"PI";"BOM JESUS";84;0;5;89
2004;"BOM PRINCIPIO DO PIAUI (PI)";"PI";"BOM PRINCIPIO DO PIAUI";1;1;1;3
2004;"BONFIM DO PIAUI (PI)";"PI";"BONFIM DO PIAUI";4;1;1;6
2004;"BOQUEIRAO DO PIAUI (PI)";"PI";"BOQUEIRAO DO PIAUI";0;0;0;0
2004;"BRASILEIRA (PI)";"PI";"BRASILEIRA";3;0;1;4
2004;"BREJO DO PIAUI (PI)";"PI";"BREJO DO PIAUI";2;0;0;2
2004;"BURITI DOS LOPES (PI)";"PI";"BURITI DOS LOPES";6;0;3;9
2004;"BURITI DOS MONTES (PI)";"PI";"BURITI DOS MONTES";2;1;0;3
2004;"CABECEIRAS DO PIAUI (PI)";"PI";"CABECEIRAS DO PIAUI";2;0;1;3
2004;"CAJAZEIRAS DO PIAUI (PI)";"PI";"CAJAZEIRAS DO PIAUI";0;0;0;0
2004;"CAJUEIRO DA PRAIA (PI)";"PI";"CAJUEIRO DA PRAIA";4;0;0;4
2004;"CALDEIRAO GRANDE DO PIAUI (PI)";"PI";"CALDEIRAO GRANDE DO PIAUI";1;1;1;3
2004;"CAMPINAS DO PIAUI (PI)";"PI";"CAMPINAS DO PIAUI";0;0;1;1
2004;"CAMPO ALEGRE DO FIDALGO (PI)";"PI";"CAMPO ALEGRE DO FIDALGO";0;1;0;1
2004;"CAMPO GRANDE DO PIAUI (PI)";"PI";"CAMPO GRANDE DO PIAUI";5;0;0;5
2004;"CAMPO LARGO DO PIAUI (PI)";"PI";"CAMPO LARGO DO PIAUI";0;2;0;2
2004;"CAMPO MAIOR (PI)";"PI";"CAMPO MAIOR";233;10;25;268
2004;"CANAVIEIRA (PI)";"PI";"CANAVIEIRA";0;1;0;1
2004;"CANTO DO BURITI (PI)";"PI";"CANTO DO BURITI";40;5;4;49
2004;"CAPITAO DE CAMPOS (PI)";"PI";"CAPITAO DE CAMPOS";5;1;1;7
2004;"CAPITAO GERVASIO OLIVEIRA (PI)";"PI";"CAPITAO GERVASIO OLIVEIRA";1;0;2;3
2004;"CARACOL (PI)";"PI";"CARACOL";11;1;0;12
2004;"CARAUBAS DO PIAUI (PI)";"PI";"CARAUBAS DO PIAUI";5;0;0;5
2004;"CARIDADE DO PIAUI (PI)";"PI";"CARIDADE DO PIAUI";4;0;1;5
2004;"CASTELO DO PIAUI (PI)";"PI";"CASTELO DO PIAUI";17;0;3;20
2004;"CAXINGO (PI)";"PI";"CAXINGO";5;1;0;6
2004;"COCAL (PI)";"PI";"COCAL";24;2;3;29
2004;"COCAL DE TELHA (PI)";"PI";"COCAL DE TELHA";2;1;0;3
2004;"COCAL DOS ALVES (PI)";"PI";"COCAL DOS ALVES";0;2;0;2
2004;"COIVARAS (PI)";"PI";"COIVARAS";2;0;1;3
2004;"COLONIA DO GURGUEIA (PI)";"PI";"COLONIA DO GURGUEIA";3;3;0;6
2004;"COLONIA DO PIAUI (PI)";"PI";"COLONIA DO PIAUI";5;0;0;5
2004;"CONCEICAO DO CANINDE (PI)";"PI";"CONCEICAO DO CANINDE";1;1;0;2
2004;"CORONEL JOSE DIAS (PI)";"PI";"CORONEL JOSE DIAS";3;0;1;4
2004;"CORRENTE (PI)";"PI";"CORRENTE";42;2;0;44
2004;"CRISTALANDIA DO PIAUI (PI)";"PI";"CRISTALANDIA DO PIAUI";1;0;1;2
2004;"CRISTINO CASTRO (PI)";"PI";"CRISTINO CASTRO";24;1;4;29
2004;"CURIMATA (PI)";"PI";"CURIMATA";4;0;1;5
2004;"CURRAIS (PI)";"PI";"CURRAIS";1;2;0;3
2004;"CURRAL NOVO DO PIAUI (PI)";"PI";"CURRAL NOVO DO PIAUI";0;1;0;1
2004;"CURRALINHOS (PI)";"PI";"CURRALINHOS";0;0;0;0
2004;"DEMERVAL LOBAO (PI)";"PI";"DEMERVAL LOBAO";15;2;0;17
2004;"DIRCEU ARCOVERDE (PI)";"PI";"DIRCEU ARCOVERDE";3;0;0;3
2004;"DOM EXPEDITO LOPES (PI)";"PI";"DOM EXPEDITO LOPES";37;2;2;41
2004;"DOM INOCENCIO (PI)";"PI";"DOM INOCENCIO";6;1;2;9
2004;"DOMINGOS MOURAO (PI)";"PI";"DOMINGOS MOURAO";1;0;0;1
2004;"ELESBAO VELOSO (PI)";"PI";"ELESBAO VELOSO";25;2;3;30
2004;"ELISEU MARTINS (PI)";"PI";"ELISEU MARTINS";4;1;1;6
2004;"ESPERANTINA (PI)";"PI";"ESPERANTINA";85;8;12;105
2004;"FARTURA DO PIAUI (PI)";"PI";"FARTURA DO PIAUI";4;0;0;4
2004;"FLORES DO PIAUI (PI)";"PI";"FLORES DO PIAUI";2;0;0;2
2004;"FLORESTA DO PIAUI (PI)";"PI";"FLORESTA DO PIAUI";0;1;0;1
2004;"FLORIANO (PI)";"PI";"FLORIANO";806;38;20;864
2004;"FRANCINOPOLIS (PI)";"PI";"FRANCINOPOLIS";6;3;0;9
2004;"FRANCISCO AYRES (PI)";"PI";"FRANCISCO AYRES";2;1;1;4
2004;"FRANCISCO MACEDO (PI)";"PI";"FRANCISCO MACEDO";1;1;0;2
2004;"FRANCISCO SANTOS (PI)";"PI";"FRANCISCO SANTOS";33;2;1;36
2004;"FRONTEIRAS (PI)";"PI";"FRONTEIRAS";53;7;3;63
2004;"GEMINIANO (PI)";"PI";"GEMINIANO";7;1;4;12
2004;"GILBUES (PI)";"PI";"GILBUES";4;1;1;6
2004;"GUADALUPE (PI)";"PI";"GUADALUPE";29;5;1;35
2004;"GUARIBAS (PI)";"PI";"GUARIBAS";2;0;0;2
2004;"HUGO NAPOLEAO (PI)";"PI";"HUGO NAPOLEAO";3;0;0;3
2004;"ILHA GRANDE (PI)";"PI";"ILHA GRANDE";0;2;0;2
2004;"INHUMA (PI)";"PI";"INHUMA";51;6;6;63
2004;"IPIRANGA DO PIAUI (PI)";"PI";"IPIRANGA DO PIAUI";17;1;4;22
2004;"ISAIAS COELHO (PI)";"PI";"ISAIAS COELHO";1;0;2;3
2004;"ITAINOPOLIS (PI)";"PI";"ITAINOPOLIS";10;1;3;14
2004;"ITAUEIRA (PI)";"PI";"ITAUEIRA";17;2;0;19
2004;"JACOBINA DO PIAUI (PI)";"PI";"JACOBINA DO PIAUI";9;1;0;10
2004;"JAICOS (PI)";"PI";"JAICOS";45;4;1;50
2004;"JARDIM DO MULATO (PI)";"PI";"JARDIM DO MULATO";2;0;0;2
2004;"JATOBA DO PIAUI (PI)";"PI";"JATOBA DO PIAUI";5;0;0;5
2004;"JERUMENHA (PI)";"PI";"JERUMENHA";6;0;0;6
2004;"JOAO COSTA (PI)";"PI";"JOAO COSTA";1;0;0;1
2004;"JOAQUIM PIRES (PI)";"PI";"JOAQUIM PIRES";3;0;0;3
2004;"JOCA MARQUES (PI)";"PI";"JOCA MARQUES";1;0;1;2
2004;"JOSE DE FREITAS (PI)";"PI";"JOSE DE FREITAS";40;0;8;48
2004;"JUAZEIRO DO PIAUI (PI)";"PI";"JUAZEIRO DO PIAUI";0;0;0;0
2004;"JULIO BORGES (PI)";"PI";"JULIO BORGES";1;1;0;2
2004;"JUREMA (PI)";"PI";"JUREMA";1;0;1;2
2004;"LAGOA ALEGRE (PI)";"PI";"LAGOA ALEGRE";1;0;2;3
2004;"LAGOA DE SAO FRANCISCO (PI)";"PI";"LAGOA DE SAO FRANCISCO";0;0;0;0
2004;"LAGOA DO BARRO DO PIAUI (PI)";"PI";"LAGOA DO BARRO DO PIAUI";1;1;4;6
2004;"LAGOA DO PIAUI (PI)";"PI";"LAGOA DO PIAUI";3;0;0;3
2004;"LAGOA DO SITIO (PI)";"PI";"LAGOA DO SITIO";6;0;1;7
2004;"LAGOINHA DO PIAUI (PI)";"PI";"LAGOINHA DO PIAUI";3;2;1;6
2004;"LANDRI SALES (PI)";"PI";"LANDRI SALES";2;1;0;3
2004;"LUIS CORREIA (PI)";"PI";"LUIS CORREIA";14;2;3;19
2004;"LUZILANDIA (PI)";"PI";"LUZILANDIA";14;0;6;20
2004;"MADEIRO (PI)";"PI";"MADEIRO";3;1;1;5
2004;"MANOEL EMIDIO (PI)";"PI";"MANOEL EMIDIO";3;1;1;5
2004;"MARCOLANDIA (PI)";"PI";"MARCOLANDIA";49;7;1;57
2004;"MARCOS PARENTE (PI)";"PI";"MARCOS PARENTE";2;1;0;3
2004;"MASSAPE DO PIAUI (PI)";"PI";"MASSAPE DO PIAUI";2;1;0;3
2004;"MATIAS OLIMPIO (PI)";"PI";"MATIAS OLIMPIO";1;3;0;4
2004;"MIGUEL ALVES (PI)";"PI";"MIGUEL ALVES";8;1;2;11
2004;"MIGUEL LEAO (PI)";"PI";"MIGUEL LEAO";2;0;0;2
2004;"MILTON BRANDAO (PI)";"PI";"MILTON BRANDAO";0;0;0;0
2004;"MONSENHOR GIL (PI)";"PI";"MONSENHOR GIL";4;3;1;8
2004;"MONSENHOR HIPOLITO (PI)";"PI";"MONSENHOR HIPOLITO";6;5;1;12
2004;"MONTE ALEGRE DO PIAUI (PI)";"PI";"MONTE ALEGRE DO PIAUI";5;2;2;9
2004;"MORRO CABECA NO TEMPO (PI)";"PI";"MORRO CABECA NO TEMPO";0;0;0;0
2004;"MORRO DO CHAPEU DO PIAUI (PI)";"PI";"MORRO DO CHAPEU DO PIAUI";1;1;1;3
2004;"MURICI DOS PORTELAS (PI)";"PI";"MURICI DOS PORTELAS";2;0;1;3
2004;"NAZARE DO PIAUI (PI)";"PI";"NAZARE DO PIAUI";4;0;1;5
2004;"NOSSA SENHORA DE NAZARE (PI)";"PI";"NOSSA SENHORA DE NAZARE";0;0;1;1
2004;"NOSSA SENHORA DOS REMEDIOS (PI)";"PI";"NOSSA SENHORA DOS REMEDIOS";1;0;0;1
2004;"NOVA SANTA RITA (PI)";"PI";"NOVA SANTA RITA";0;2;0;2
2004;"NOVO ORIENTE DO PIAUI (PI)";"PI";"NOVO ORIENTE DO PIAUI";6;0;2;8
2004;"NOVO SANTO ANTONIO (PI)";"PI";"NOVO SANTO ANTONIO";1;0;0;1
2004;"OEIRAS (PI)";"PI";"OEIRAS";169;12;12;193
2004;"OLHO D AGUA DO PIAUI (PI)";"PI";"OLHO D AGUA DO PIAUI";2;1;0;3
2004;"PADRE MARCOS (PI)";"PI";"PADRE MARCOS";6;3;0;9
2004;"PAES LANDIM (PI)";"PI";"PAES LANDIM";3;1;0;4
2004;"PAJEU DO PIAUI (PI)";"PI";"PAJEU DO PIAUI";2;1;0;3
2004;"PALMEIRA DO PIAUI (PI)";"PI";"PALMEIRA DO PIAUI";7;1;0;8
2004;"PALMEIRAIS (PI)";"PI";"PALMEIRAIS";5;1;0;6
2004;"PAQUETA (PI)";"PI";"PAQUETA";4;2;2;8
2004;"PARNAGUA (PI)";"PI";"PARNAGUA";1;0;0;1
2004;"PARNAIBA (PI)";"PI";"PARNAIBA";640;70;130;840
2004;"PASSAGEM FRANCA DO PIAUI (PI)";"PI";"PASSAGEM FRANCA DO PIAUI";1;0;0;1
2004;"PATOS DO PIAUI (PI)";"PI";"PATOS DO PIAUI";7;1;1;9
2004;"PAU D ARCO DO PIAUI (PI)";"PI";"PAU D ARCO DO PIAUI";2;0;1;3
2004;"PAULISTANA (PI)";"PI";"PAULISTANA";62;9;5;76
2004;"PAVUSSU (PI)";"PI";"PAVUSSU";1;0;0;1
2004;"PEDRO II (PI)";"PI";"PEDRO II";41;5;3;49
2004;"PEDRO LAURENTINO (PI)";"PI";"PEDRO LAURENTINO";0;0;0;0
2004;"PICOS (PI)";"PI";"PICOS";1159;92;35;1286
2004;"PIMENTEIRAS (PI)";"PI";"PIMENTEIRAS";16;3;1;20
2004;"PIO IX (PI)";"PI";"PIO IX";21;2;2;25
2004;"PIRACURUCA (PI)";"PI";"PIRACURUCA";82;4;16;102
2004;"PIRIPIRI (PI)";"PI";"PIRIPIRI";192;8;44;244
2004;"PORTO (PI)";"PI";"PORTO";1;1;1;3
2004;"PORTO ALEGRE DO PIAUI (PI)";"PI";"PORTO ALEGRE DO PIAUI";3;3;0;6
2004;"PRATA DO PIAUI (PI)";"PI";"PRATA DO PIAUI";1;1;1;3
2004;"QUEIMADA NOVA (PI)";"PI";"QUEIMADA NOVA";6;2;2;10
2004;"REDENCAO DO GURGUEIA (PI)";"PI";"REDENCAO DO GURGUEIA";1;0;7;8
2004;"REGENERACAO (PI)";"PI";"REGENERACAO";34;4;2;40
2004;"RIACHO FRIO (PI)";"PI";"RIACHO FRIO";1;1;0;2
2004;"RIBEIRA DO PIAUI (PI)";"PI";"RIBEIRA DO PIAUI";1;0;0;1
2004;"RIBEIRO GONCALVES (PI)";"PI";"RIBEIRO GONCALVES";5;0;0;5
2004;"RIO GRANDE DO PIAUI (PI)";"PI";"RIO GRANDE DO PIAUI";3;1;2;6
2004;"SANTA CRUZ DO PIAUI (PI)";"PI";"SANTA CRUZ DO PIAUI";7;4;0;11
2004;"SANTA CRUZ DOS MILAGRES (PI)";"PI";"SANTA CRUZ DOS MILAGRES";1;0;0;1
2004;"SANTA FILOMENA (PI)";"PI";"SANTA FILOMENA";5;1;1;7
2004;"SANTA LUZ (PI)";"PI";"SANTA LUZ";5;0;0;5
2004;"SANTA ROSA DO PIAUI (PI)";"PI";"SANTA ROSA DO PIAUI";2;0;2;4
2004;"SANTANA DO PIAUI (PI)";"PI";"SANTANA DO PIAUI";13;2;3;18
2004;"SANTO ANTONIO DE LISBOA (PI)";"PI";"SANTO ANTONIO DE LISBOA";14;8;2;24
2004;"SANTO ANTONIO DOS MILAGRES (PI)";"PI";"SANTO ANTONIO DOS MILAGRES";0;3;0;3
2004;"SANTO INACIO DO PIAUI (PI)";"PI";"SANTO INACIO DO PIAUI";1;3;0;4
2004;"SAO BRAZ DO PIAUI (PI)";"PI";"SAO BRAZ DO PIAUI";1;0;0;1
2004;"SAO FELIX DO PIAUI (PI)";"PI";"SAO FELIX DO PIAUI";2;0;2;4
2004;"SAO FRANCISCO DE ASSIS DO PIAU (PI)";"PI";"SAO FRANCISCO DE ASSIS DO PIAU";1;0;2;3
2004;"SAO FRANCISCO DO PIAUI (PI)";"PI";"SAO FRANCISCO DO PIAUI";1;1;1;3
2004;"SAO GONCALO DO GURGUEIA (PI)";"PI";"SAO GONCALO DO GURGUEIA";1;2;0;3
2004;"SAO GONCALO DO PIAUI (PI)";"PI";"SAO GONCALO DO PIAUI";4;2;6;12
2004;"SAO JOAO DA CANABRAVA (PI)";"PI";"SAO JOAO DA CANABRAVA";7;1;2;10
2004;"SAO JOAO DA FRONTEIRA (PI)";"PI";"SAO JOAO DA FRONTEIRA";0;1;3;4
2004;"SAO JOAO DA SERRA (PI)";"PI";"SAO JOAO DA SERRA";1;0;0;1
2004;"SAO JOAO DA VARJOTA (PI)";"PI";"SAO JOAO DA VARJOTA";1;0;1;2
2004;"SAO JOAO DO ARRAIAL (PI)";"PI";"SAO JOAO DO ARRAIAL";1;1;0;2
2004;"SAO JOAO DO PIAUI (PI)";"PI";"SAO JOAO DO PIAUI";40;5;2;47
2004;"SAO JOSE DO DIVINO (PI)";"PI";"SAO JOSE DO DIVINO";4;1;0;5
2004;"SAO JOSE DO PEIXE (PI)";"PI";"SAO JOSE DO PEIXE";1;1;0;2
2004;"SAO JOSE DO PIAUI (PI)";"PI";"SAO JOSE DO PIAUI";10;0;0;10
2004;"SAO JULIAO (PI)";"PI";"SAO JULIAO";9;1;1;11
2004;"SAO LOURENCO DO PIAUI (PI)";"PI";"SAO LOURENCO DO PIAUI";0;0;1;1
2004;"SAO LUIS DO PIAUI (PI)";"PI";"SAO LUIS DO PIAUI";4;1;0;5
2004;"SAO MIGUEL DA BAIXA GRANDE (PI)";"PI";"SAO MIGUEL DA BAIXA GRANDE";1;0;0;1
2004;"SAO MIGUEL DO FIDALGO (PI)";"PI";"SAO MIGUEL DO FIDALGO";2;1;1;4
2004;"SAO MIGUEL DO TAPUIO (PI)";"PI";"SAO MIGUEL DO TAPUIO";2;0;3;5
2004;"SAO PEDRO DO PIAUI (PI)";"PI";"SAO PEDRO DO PIAUI";15;1;1;17
2004;"SAO RAIMUNDO NONATO (PI)";"PI";"SAO RAIMUNDO NONATO";148;4;14;166
2004;"SEBASTIAO BARROS (PI)";"PI";"SEBASTIAO BARROS";0;2;0;2
2004;"SEBASTIAO LEAL (PI)";"PI";"SEBASTIAO LEAL";2;1;0;3
2004;"SIGEFREDO PACHECO (PI)";"PI";"SIGEFREDO PACHECO";6;1;0;7
2004;"SIMOES (PI)";"PI";"SIMOES";32;4;1;37
2004;"SIMPLICIO MENDES (PI)";"PI";"SIMPLICIO MENDES";24;4;3;31
2004;"SOCORRO DO PIAUI (PI)";"PI";"SOCORRO DO PIAUI";0;0;0;0
2004;"SUSSUAPARA (PI)";"PI";"SUSSUAPARA";8;5;1;14
2004;"TAMBORIL DO PIAUI (PI)";"PI";"TAMBORIL DO PIAUI";1;0;0;1
2004;"TANQUE DO PIAUI (PI)";"PI";"TANQUE DO PIAUI";3;0;1;4
2004;"TERESINA (PI)";"PI";"TERESINA";6851;596;1698;9145
2004;"UNIAO (PI)";"PI";"UNIAO";52;11;5;68
2004;"URUCUI (PI)";"PI";"URUCUI";32;1;4;37
2004;"VALENCA DO PIAUI (PI)";"PI";"VALENCA DO PIAUI";63;12;7;82
2004;"VARZEA BRANCA (PI)";"PI";"VARZEA BRANCA";1;0;4;5
2004;"VARZEA GRANDE (PI)";"PI";"VARZEA GRANDE";3;2;2;7
2004;"VERA MENDES (PI)";"PI";"VERA MENDES";1;3;0;4
2004;"VILA NOVA DO PIAUI (PI)";"PI";"VILA NOVA DO PIAUI";2;0;1;3
2004;"WALL FERRAZ (PI)";"PI";"WALL FERRAZ";3;2;0;5
2004;"ABATIA (PR)";"PR";"ABATIA";99;2;20;121
2004;"ADRIANOPOLIS (PR)";"PR";"ADRIANOPOLIS";46;2;12;60
2004;"AGUDOS DO SUL (PR)";"PR";"AGUDOS DO SUL";208;5;11;224
2004;"ALMIRANTE TAMANDARE (PR)";"PR";"ALMIRANTE TAMANDARE";813;49;183;1045
2004;"ALTAMIRA DO PARANA (PR)";"PR";"ALTAMIRA DO PARANA";26;2;10;38
2004;"ALTO PARANA (PR)";"PR";"ALTO PARANA";183;4;39;226
2004;"ALTO PIQUIRI (PR)";"PR";"ALTO PIQUIRI";155;4;19;178
2004;"ALTONIA (PR)";"PR";"ALTONIA";320;8;30;358
2004;"ALVORADA DO SUL (PR)";"PR";"ALVORADA DO SUL";228;5;37;270
2004;"AMAPORA (PR)";"PR";"AMAPORA";61;2;22;85
2004;"AMPERE (PR)";"PR";"AMPERE";278;10;16;304
2004;"ANAHY (PR)";"PR";"ANAHY";45;2;5;52
2004;"ANDIRA (PR)";"PR";"ANDIRA";459;10;55;524
2004;"ANGULO (PR)";"PR";"ANGULO";62;1;3;66
2004;"ANTONINA (PR)";"PR";"ANTONINA";79;11;21;111
2004;"ANTONIO OLINTO (PR)";"PR";"ANTONIO OLINTO";86;3;12;101
2004;"APUCARANA (PR)";"PR";"APUCARANA";1936;135;203;2274
2004;"ARAPONGAS (PR)";"PR";"ARAPONGAS";2610;89;84;2783
2004;"ARAPOTI (PR)";"PR";"ARAPOTI";385;13;50;448
2004;"ARAPUA (PR)";"PR";"ARAPUA";72;2;12;86
2004;"ARARUNA (PR)";"PR";"ARARUNA";286;6;18;310
2004;"ARAUCARIA (PR)";"PR";"ARAUCARIA";2090;159;337;2586
2004;"ARIRANHA DO IVAI (PR)";"PR";"ARIRANHA DO IVAI";25;3;12;40
2004;"ASSAI (PR)";"PR";"ASSAI";436;7;28;471
2004;"ASSIS CHATEAUBRIAND (PR)";"PR";"ASSIS CHATEAUBRIAND";1012;12;63;1087
2004;"ASTORGA (PR)";"PR";"ASTORGA";499;18;60;577
2004;"ATALAIA (PR)";"PR";"ATALAIA";84;8;13;105
2004;"BALSA NOVA (PR)";"PR";"BALSA NOVA";183;7;26;216
2004;"BANDEIRANTES (PR)";"PR";"BANDEIRANTES";756;15;76;847
2004;"BARBOSA FERRAZ (PR)";"PR";"BARBOSA FERRAZ";129;10;17;156
2004;"BARRA DO JACARE (PR)";"PR";"BARRA DO JACARE";41;3;6;50
2004;"BARRACAO (PR)";"PR";"BARRACAO";161;10;25;196
2004;"BELA VISTA DO CAROBA (PR)";"PR";"BELA VISTA DO CAROBA";37;2;9;48
2004;"BELA VISTA DO PARAISO (PR)";"PR";"BELA VISTA DO PARAISO";335;12;46;393
2004;"BITURUNA (PR)";"PR";"BITURUNA";301;8;60;369
2004;"BOA ESPERANCA (PR)";"PR";"BOA ESPERANCA";144;3;10;157
2004;"BOA ESPERANCA DO IGUACU (PR)";"PR";"BOA ESPERANCA DO IGUACU";43;3;8;54
2004;"BOA VENTURA DE SAO ROQUE (PR)";"PR";"BOA VENTURA DE SAO ROQUE";126;1;20;147
2004;"BOA VISTA DA APARECIDA (PR)";"PR";"BOA VISTA DA APARECIDA";108;4;17;129
2004;"BOCAIUVA DO SUL (PR)";"PR";"BOCAIUVA DO SUL";189;6;14;209
2004;"BOM JESUS DO SUL (PR)";"PR";"BOM JESUS DO SUL";22;4;4;30
2004;"BOM SUCESSO (PR)";"PR";"BOM SUCESSO";79;2;22;103
2004;"BOM SUCESSO DO SUL (PR)";"PR";"BOM SUCESSO DO SUL";76;9;5;90
2004;"BORRAZOPOLIS (PR)";"PR";"BORRAZOPOLIS";198;3;8;209
2004;"BRAGANEY (PR)";"PR";"BRAGANEY";118;2;9;129
2004;"BRASILANDIA DO SUL (PR)";"PR";"BRASILANDIA DO SUL";44;1;7;52
2004;"CAFEARA (PR)";"PR";"CAFEARA";25;1;7;33
2004;"CAFELANDIA (PR)";"PR";"CAFELANDIA";391;5;28;424
2004;"CAFEZAL DO SUL (PR)";"PR";"CAFEZAL DO SUL";96;2;25;123
2004;"CALIFORNIA (PR)";"PR";"CALIFORNIA";156;3;10;169
2004;"CAMBARA (PR)";"PR";"CAMBARA";623;19;51;693
2004;"CAMBE (PR)";"PR";"CAMBE";1310;94;102;1506
2004;"CAMBIRA (PR)";"PR";"CAMBIRA";182;2;9;193
2004;"CAMPINA DA LAGOA (PR)";"PR";"CAMPINA DA LAGOA";279;11;28;318
2004;"CAMPINA DO SIMAO (PR)";"PR";"CAMPINA DO SIMAO";56;4;13;73
2004;"CAMPINA GRANDE DO SUL (PR)";"PR";"CAMPINA GRANDE DO SUL";466;23;46;535
2004;"CAMPO BONITO (PR)";"PR";"CAMPO BONITO";76;3;7;86
2004;"CAMPO DO TENENTE (PR)";"PR";"CAMPO DO TENENTE";88;1;23;112
2004;"CAMPO LARGO (PR)";"PR";"CAMPO LARGO";1795;126;277;2198
2004;"CAMPO MAGRO (PR)";"PR";"CAMPO MAGRO";236;17;15;268
2004;"CAMPO MOURAO (PR)";"PR";"CAMPO MOURAO";1712;34;404;2150
2004;"CANDIDO DE ABREU (PR)";"PR";"CANDIDO DE ABREU";159;4;26;189
2004;"CANDOI (PR)";"PR";"CANDOI";277;2;54;333
2004;"CANTAGALO (PR)";"PR";"CANTAGALO";182;6;23;211
2004;"CAPANEMA (PR)";"PR";"CAPANEMA";312;12;35;359
2004;"CAPITAO LEONIDAS MARQUES (PR)";"PR";"CAPITAO LEONIDAS MARQUES";316;14;20;350
2004;"CARAMBEI (PR)";"PR";"CARAMBEI";389;14;38;441
2004;"CARLOPOLIS (PR)";"PR";"CARLOPOLIS";228;11;25;264
2004;"CASCAVEL (PR)";"PR";"CASCAVEL";5636;214;607;6457
2004;"CASTRO (PR)";"PR";"CASTRO";1292;50;151;1493
2004;"CATANDUVAS (PR)";"PR";"CATANDUVAS";155;4;21;180
2004;"CENTENARIO DO SUL (PR)";"PR";"CENTENARIO DO SUL";109;10;33;152
2004;"CERRO AZUL (PR)";"PR";"CERRO AZUL";268;4;34;306
2004;"CEU AZUL (PR)";"PR";"CEU AZUL";261;11;36;308
2004;"CHOPINZINHO (PR)";"PR";"CHOPINZINHO";407;12;56;475
2004;"CIANORTE (PR)";"PR";"CIANORTE";1171;21;138;1330
2004;"CIDADE GAUCHA (PR)";"PR";"CIDADE GAUCHA";164;5;56;225
2004;"CLEVELANDIA (PR)";"PR";"CLEVELANDIA";414;20;29;463
2004;"COLOMBO (PR)";"PR";"COLOMBO";2661;96;362;3119
2004;"COLORADO (PR)";"PR";"COLORADO";509;23;61;593
2004;"CONGONHINHAS (PR)";"PR";"CONGONHINHAS";96;6;16;118
2004;"CONSELHEIRO MAIRINCK (PR)";"PR";"CONSELHEIRO MAIRINCK";22;1;8;31
2004;"CONTENDA (PR)";"PR";"CONTENDA";550;14;30;594
2004;"CORBELIA (PR)";"PR";"CORBELIA";563;12;26;601
2004;"CORNELIO PROCOPIO (PR)";"PR";"CORNELIO PROCOPIO";853;70;87;1010
2004;"CORONEL DOMINGOS SOARES (PR)";"PR";"CORONEL DOMINGOS SOARES";48;3;11;62
2004;"CORONEL VIVIDA (PR)";"PR";"CORONEL VIVIDA";583;17;68;668
2004;"CORUMBATAI DO SUL (PR)";"PR";"CORUMBATAI DO SUL";38;0;10;48
2004;"CRUZ MACHADO (PR)";"PR";"CRUZ MACHADO";295;8;33;336
2004;"CRUZEIRO DO IGUACU (PR)";"PR";"CRUZEIRO DO IGUACU";56;2;9;67
2004;"CRUZEIRO DO OESTE (PR)";"PR";"CRUZEIRO DO OESTE";332;5;50;387
2004;"CRUZEIRO DO SUL (PR)";"PR";"CRUZEIRO DO SUL";69;3;15;87
2004;"CRUZMALTINA (PR)";"PR";"CRUZMALTINA";47;0;5;52
2004;"CURITIBA (PR)";"PR";"CURITIBA";27827;2640;5001;35468
2004;"CURIUVA (PR)";"PR";"CURIUVA";154;8;41;203
2004;"DIAMANTE D OESTE (PR)";"PR";"DIAMANTE D OESTE";50;7;10;67
2004;"DIAMANTE DO NORTE (PR)";"PR";"DIAMANTE DO NORTE";67;1;9;77
2004;"DIAMANTE DO SUL (PR)";"PR";"DIAMANTE DO SUL";30;2;2;34
2004;"DOIS VIZINHOS (PR)";"PR";"DOIS VIZINHOS";660;23;68;751
2004;"DOURADINA (PR)";"PR";"DOURADINA";151;2;8;161
2004;"DOUTOR CAMARGO (PR)";"PR";"DOUTOR CAMARGO";145;2;33;180
2004;"DOUTOR ULYSSES (PR)";"PR";"DOUTOR ULYSSES";31;2;4;37
2004;"ENEAS MARQUES (PR)";"PR";"ENEAS MARQUES";113;7;12;132
2004;"ENGENHEIRO BELTRAO (PR)";"PR";"ENGENHEIRO BELTRAO";367;3;49;419
2004;"ENTRE RIOS DO OESTE (PR)";"PR";"ENTRE RIOS DO OESTE";102;1;6;109
2004;"ESPERANCA NOVA (PR)";"PR";"ESPERANCA NOVA";15;3;4;22
2004;"ESPIGAO ALTO DO IGUACU (PR)";"PR";"ESPIGAO ALTO DO IGUACU";47;2;2;51
2004;"FAROL (PR)";"PR";"FAROL";55;0;8;63
2004;"FAXINAL (PR)";"PR";"FAXINAL";294;3;12;309
2004;"FAZENDA RIO GRANDE (PR)";"PR";"FAZENDA RIO GRANDE";629;22;159;810
2004;"FENIX (PR)";"PR";"FENIX";93;1;5;99
2004;"FERNANDES PINHEIRO (PR)";"PR";"FERNANDES PINHEIRO";64;4;10;78
2004;"FIGUEIRA (PR)";"PR";"FIGUEIRA";93;4;18;115
2004;"FLOR DA SERRA DO SUL (PR)";"PR";"FLOR DA SERRA DO SUL";79;3;16;98
2004;"FLORAI (PR)";"PR";"FLORAI";128;2;16;146
2004;"FLORESTA (PR)";"PR";"FLORESTA";188;4;12;204
2004;"FLORESTOPOLIS (PR)";"PR";"FLORESTOPOLIS";147;2;54;203
2004;"FLORIDA (PR)";"PR";"FLORIDA";40;5;7;52
2004;"FORMOSA DO OESTE (PR)";"PR";"FORMOSA DO OESTE";143;5;16;164
2004;"FOZ DO IGUACU (PR)";"PR";"FOZ DO IGUACU";2552;673;738;3963
2004;"FOZ DO JORDAO (PR)";"PR";"FOZ DO JORDAO";45;1;7;53
2004;"FRANCISCO ALVES (PR)";"PR";"FRANCISCO ALVES";136;1;13;150
2004;"FRANCISCO BELTRAO (PR)";"PR";"FRANCISCO BELTRAO";1420;45;142;1607
2004;"GENERAL CARNEIRO (PR)";"PR";"GENERAL CARNEIRO";353;6;36;395
2004;"GODOY MOREIRA (PR)";"PR";"GODOY MOREIRA";30;1;8;39
2004;"GOIO ERE (PR)";"PR";"GOIO ERE";669;11;59;739
2004;"GOIOXIM (PR)";"PR";"GOIOXIM";66;3;13;82
2004;"GRANDES RIOS (PR)";"PR";"GRANDES RIOS";61;5;11;77
2004;"GUAIRA (PR)";"PR";"GUAIRA";1143;25;86;1254
2004;"GUAIRACA (PR)";"PR";"GUAIRACA";129;0;15;144
2004;"GUAMIRANGA (PR)";"PR";"GUAMIRANGA";119;4;7;130
2004;"GUAPIRAMA (PR)";"PR";"GUAPIRAMA";75;2;14;91
2004;"GUAPOREMA (PR)";"PR";"GUAPOREMA";35;0;4;39
2004;"GUARACI (PR)";"PR";"GUARACI";75;1;11;87
2004;"GUARANIACU (PR)";"PR";"GUARANIACU";284;8;43;335
2004;"GUARAPUAVA (PR)";"PR";"GUARAPUAVA";3492;148;281;3921
2004;"GUARAQUECABA (PR)";"PR";"GUARAQUECABA";14;1;0;15
2004;"GUARATUBA (PR)";"PR";"GUARATUBA";180;12;42;234
2004;"HONORIO SERPA (PR)";"PR";"HONORIO SERPA";103;3;15;121
2004;"IBAITI (PR)";"PR";"IBAITI";400;12;116;528
2004;"IBEMA (PR)";"PR";"IBEMA";112;3;7;122
2004;"IBIPORA (PR)";"PR";"IBIPORA";700;18;76;794
2004;"ICARAIMA (PR)";"PR";"ICARAIMA";97;0;26;123
2004;"IGUARACU (PR)";"PR";"IGUARACU";54;0;12;66
2004;"IGUATU (PR)";"PR";"IGUATU";33;0;6;39
2004;"IMBAU (PR)";"PR";"IMBAU";124;6;24;154
2004;"IMBITUVA (PR)";"PR";"IMBITUVA";622;10;40;672
2004;"INACIO MARTINS (PR)";"PR";"INACIO MARTINS";188;6;15;209
2004;"INAJA (PR)";"PR";"INAJA";27;0;17;44
2004;"INDIANOPOLIS (PR)";"PR";"INDIANOPOLIS";101;2;6;109
2004;"IPIRANGA (PR)";"PR";"IPIRANGA";271;7;24;302
2004;"IPORA (PR)";"PR";"IPORA";289;8;28;325
2004;"IRACEMA DO OESTE (PR)";"PR";"IRACEMA DO OESTE";60;5;3;68
2004;"IRATI (PR)";"PR";"IRATI";1165;42;108;1315
2004;"IRETAMA (PR)";"PR";"IRETAMA";113;3;13;129
2004;"ITAGUAJE (PR)";"PR";"ITAGUAJE";81;2;19;102
2004;"ITAIPULANDIA (PR)";"PR";"ITAIPULANDIA";141;14;21;176
2004;"ITAMBARACA (PR)";"PR";"ITAMBARACA";126;4;18;148
2004;"ITAMBE (PR)";"PR";"ITAMBE";161;2;17;180
2004;"ITAPEJARA D OESTE (PR)";"PR";"ITAPEJARA D OESTE";217;4;14;235
2004;"ITAPERUCU (PR)";"PR";"ITAPERUCU";325;20;35;380
2004;"ITAUNA DO SUL (PR)";"PR";"ITAUNA DO SUL";42;0;6;48
2004;"IVAI (PR)";"PR";"IVAI";210;6;18;234
2004;"IVAIPORA (PR)";"PR";"IVAIPORA";649;13;63;725
2004;"IVATE (PR)";"PR";"IVATE";122;1;30;153
2004;"IVATUBA (PR)";"PR";"IVATUBA";45;2;7;54
2004;"JABOTI (PR)";"PR";"JABOTI";51;2;6;59
2004;"JACAREZINHO (PR)";"PR";"JACAREZINHO";422;20;97;539
2004;"JAGUAPITA (PR)";"PR";"JAGUAPITA";234;11;34;279
2004;"JAGUARIAIVA (PR)";"PR";"JAGUARIAIVA";490;17;74;581
2004;"JANDAIA DO SUL (PR)";"PR";"JANDAIA DO SUL";414;16;83;513
2004;"JANIOPOLIS (PR)";"PR";"JANIOPOLIS";104;4;15;123
2004;"JAPIRA (PR)";"PR";"JAPIRA";30;1;3;34
2004;"JAPURA (PR)";"PR";"JAPURA";182;2;13;197
2004;"JARDIM ALEGRE (PR)";"PR";"JARDIM ALEGRE";168;8;15;191
2004;"JARDIM OLINDA (PR)";"PR";"JARDIM OLINDA";37;2;4;43
2004;"JATAIZINHO (PR)";"PR";"JATAIZINHO";270;18;14;302
2004;"JESUITAS (PR)";"PR";"JESUITAS";200;7;15;222
2004;"JOAQUIM TAVORA (PR)";"PR";"JOAQUIM TAVORA";164;7;10;181
2004;"JUNDIAI DO SUL (PR)";"PR";"JUNDIAI DO SUL";14;2;7;23
2004;"JURANDA (PR)";"PR";"JURANDA";286;2;7;295
2004;"JUSSARA (PR)";"PR";"JUSSARA";156;3;17;176
2004;"KALORE (PR)";"PR";"KALORE";127;5;12;144
2004;"LAPA (PR)";"PR";"LAPA";909;30;88;1027
2004;"LARANJAL (PR)";"PR";"LARANJAL";26;3;3;32
2004;"LARANJEIRAS DO SUL (PR)";"PR";"LARANJEIRAS DO SUL";515;8;55;578
2004;"LEOPOLIS (PR)";"PR";"LEOPOLIS";53;2;4;59
2004;"LIDIANOPOLIS (PR)";"PR";"LIDIANOPOLIS";57;4;9;70
2004;"LINDOESTE (PR)";"PR";"LINDOESTE";68;3;12;83
2004;"LOANDA (PR)";"PR";"LOANDA";319;7;35;361
2004;"LOBATO (PR)";"PR";"LOBATO";130;2;13;145
2004;"LONDRINA (PR)";"PR";"LONDRINA";7052;454;1462;8968
2004;"LUIZIANA (PR)";"PR";"LUIZIANA";124;1;11;136
2004;"LUNARDELLI (PR)";"PR";"LUNARDELLI";76;4;5;85
2004;"LUPIONOPOLIS (PR)";"PR";"LUPIONOPOLIS";54;1;22;77
2004;"MALLET (PR)";"PR";"MALLET";249;9;22;280
2004;"MAMBORE (PR)";"PR";"MAMBORE";464;5;25;494
2004;"MANDAGUACU (PR)";"PR";"MANDAGUACU";310;4;33;347
2004;"MANDAGUARI (PR)";"PR";"MANDAGUARI";561;14;49;624
2004;"MANDIRITUBA (PR)";"PR";"MANDIRITUBA";594;11;41;646
2004;"MANFRINOPOLIS (PR)";"PR";"MANFRINOPOLIS";20;2;11;33
2004;"MANGUEIRINHA (PR)";"PR";"MANGUEIRINHA";356;11;39;406
2004;"MANOEL RIBAS (PR)";"PR";"MANOEL RIBAS";252;7;17;276
2004;"MARECHAL CANDIDO RONDON (PR)";"PR";"MARECHAL CANDIDO RONDON";1104;37;109;1250
2004;"MARIA HELENA (PR)";"PR";"MARIA HELENA";64;3;10;77
2004;"MARIALVA (PR)";"PR";"MARIALVA";664;24;33;721
2004;"MARILANDIA DO SUL (PR)";"PR";"MARILANDIA DO SUL";186;4;8;198
2004;"MARILENA (PR)";"PR";"MARILENA";83;2;41;126
2004;"MARILUZ (PR)";"PR";"MARILUZ";154;3;36;193
2004;"MARINGA (PR)";"PR";"MARINGA";6586;279;658;7523
2004;"MARIOPOLIS (PR)";"PR";"MARIOPOLIS";159;4;15;178
2004;"MARIPA (PR)";"PR";"MARIPA";236;4;11;251
2004;"MARMELEIRO (PR)";"PR";"MARMELEIRO";239;8;29;276
2004;"MARQUINHO (PR)";"PR";"MARQUINHO";39;1;9;49
2004;"MARUMBI (PR)";"PR";"MARUMBI";65;4;12;81
2004;"MATELANDIA (PR)";"PR";"MATELANDIA";311;3;28;342
2004;"MATINHOS (PR)";"PR";"MATINHOS";181;14;22;217
2004;"MATO RICO (PR)";"PR";"MATO RICO";23;1;5;29
2004;"MAUA DA SERRA (PR)";"PR";"MAUA DA SERRA";155;2;16;173
2004;"MEDIANEIRA (PR)";"PR";"MEDIANEIRA";873;23;80;976
2004;"MERCEDES (PR)";"PR";"MERCEDES";147;5;11;163
2004;"MIRADOR (PR)";"PR";"MIRADOR";11;1;4;16
2004;"MIRASELVA (PR)";"PR";"MIRASELVA";23;3;11;37
2004;"MISSAL (PR)";"PR";"MISSAL";266;8;29;303
2004;"MOREIRA SALES (PR)";"PR";"MOREIRA SALES";156;6;38;200
2004;"MORRETES (PR)";"PR";"MORRETES";106;5;17;128
2004;"MUNHOZ DE MELO (PR)";"PR";"MUNHOZ DE MELO";46;2;4;52
2004;"NOSSA SENHORA DAS GRACAS (PR)";"PR";"NOSSA SENHORA DAS GRACAS";16;3;15;34
2004;"NOVA ALIANCA DO IVAI (PR)";"PR";"NOVA ALIANCA DO IVAI";15;4;2;21
2004;"NOVA AMERICA DA COLINA (PR)";"PR";"NOVA AMERICA DA COLINA";72;1;11;84
2004;"NOVA AURORA (PR)";"PR";"NOVA AURORA";366;1;18;385
2004;"NOVA CANTU (PR)";"PR";"NOVA CANTU";88;0;16;104
2004;"NOVA ESPERANCA (PR)";"PR";"NOVA ESPERANCA";676;21;32;729
2004;"NOVA ESPERANCA DO SUDOESTE (PR)";"PR";"NOVA ESPERANCA DO SUDOESTE";36;5;8;49
2004;"NOVA FATIMA (PR)";"PR";"NOVA FATIMA";188;3;17;208
2004;"NOVA LARANJEIRAS (PR)";"PR";"NOVA LARANJEIRAS";112;5;20;137
2004;"NOVA LONDRINA (PR)";"PR";"NOVA LONDRINA";320;9;33;362
2004;"NOVA OLIMPIA (PR)";"PR";"NOVA OLIMPIA";88;4;11;103
2004;"NOVA PRATA DO IGUACU (PR)";"PR";"NOVA PRATA DO IGUACU";163;3;27;193
2004;"NOVA SANTA BARBARA (PR)";"PR";"NOVA SANTA BARBARA";103;3;4;110
2004;"NOVA SANTA ROSA (PR)";"PR";"NOVA SANTA ROSA";251;7;7;265
2004;"NOVA TEBAS (PR)";"PR";"NOVA TEBAS";68;2;10;80
2004;"NOVO ITACOLOMI (PR)";"PR";"NOVO ITACOLOMI";58;1;5;64
2004;"ORTIGUEIRA (PR)";"PR";"ORTIGUEIRA";168;4;37;209
2004;"OURIZONA (PR)";"PR";"OURIZONA";63;2;18;83
2004;"OURO VERDE DO OESTE (PR)";"PR";"OURO VERDE DO OESTE";101;1;8;110
2004;"PAICANDU (PR)";"PR";"PAICANDU";348;6;19;373
2004;"PALMAS (PR)";"PR";"PALMAS";690;28;49;767
2004;"PALMEIRA (PR)";"PR";"PALMEIRA";734;27;42;803
2004;"PALMITAL (PR)";"PR";"PALMITAL";174;8;34;216
2004;"PALOTINA (PR)";"PR";"PALOTINA";919;16;53;988
2004;"PARAISO DO NORTE (PR)";"PR";"PARAISO DO NORTE";167;9;31;207
2004;"PARANACITY (PR)";"PR";"PARANACITY";131;9;28;168
2004;"PARANAGUA (PR)";"PR";"PARANAGUA";1315;91;95;1501
2004;"PARANAPOEMA (PR)";"PR";"PARANAPOEMA";34;0;9;43
2004;"PARANAVAI (PR)";"PR";"PARANAVAI";1508;30;131;1669
2004;"PATO BRAGADO (PR)";"PR";"PATO BRAGADO";98;2;10;110
2004;"PATO BRANCO (PR)";"PR";"PATO BRANCO";1397;80;273;1750
2004;"PAULA FREITAS (PR)";"PR";"PAULA FREITAS";101;2;12;115
2004;"PAULO FRONTIN (PR)";"PR";"PAULO FRONTIN";111;0;10;121
2004;"PEABIRU (PR)";"PR";"PEABIRU";249;7;11;267
2004;"PEROBAL (PR)";"PR";"PEROBAL";86;2;23;111
2004;"PEROLA (PR)";"PR";"PEROLA";180;4;10;194
2004;"PEROLA D OESTE (PR)";"PR";"PEROLA D OESTE";114;2;20;136
2004;"PIEN (PR)";"PR";"PIEN";253;16;19;288
2004;"PINHAIS (PR)";"PR";"PINHAIS";1298;67;210;1575
2004;"PINHAL DO SAO BENTO (PR)";"PR";"PINHAL DO SAO BENTO";28;1;6;35
2004;"PINHALAO (PR)";"PR";"PINHALAO";63;3;7;73
2004;"PINHAO (PR)";"PR";"PINHAO";305;3;57;365
2004;"PIRAI DO SUL (PR)";"PR";"PIRAI DO SUL";329;13;48;390
2004;"PIRAQUARA (PR)";"PR";"PIRAQUARA";316;34;80;430
2004;"PITANGA (PR)";"PR";"PITANGA";622;17;79;718
2004;"PITANGUEIRAS (PR)";"PR";"PITANGUEIRAS";51;3;14;68
2004;"PLANALTINA DO PARANA (PR)";"PR";"PLANALTINA DO PARANA";72;4;7;83
2004;"PLANALTO (PR)";"PR";"PLANALTO";256;7;22;285
2004;"PONTA GROSSA (PR)";"PR";"PONTA GROSSA";4629;327;805;5761
2004;"PONTAL DO PARANA (PR)";"PR";"PONTAL DO PARANA";112;5;13;130
2004;"PORECATU (PR)";"PR";"PORECATU";282;14;75;371
2004;"PORTO AMAZONAS (PR)";"PR";"PORTO AMAZONAS";45;4;8;57
2004;"PORTO BARREIRO (PR)";"PR";"PORTO BARREIRO";48;1;17;66
2004;"PORTO RICO (PR)";"PR";"PORTO RICO";10;1;6;17
2004;"PORTO VITORIA (PR)";"PR";"PORTO VITORIA";120;1;6;127
2004;"PRADO FERREIRA (PR)";"PR";"PRADO FERREIRA";57;4;7;68
2004;"PRANCHITA (PR)";"PR";"PRANCHITA";173;4;10;187
2004;"PRESIDENTE CASTELO BRANCO (PR)";"PR";"PRESIDENTE CASTELO BRANCO";69;2;14;85
2004;"PRIMEIRO DE MAIO (PR)";"PR";"PRIMEIRO DE MAIO";254;5;14;273
2004;"PRUDENTOPOLIS (PR)";"PR";"PRUDENTOPOLIS";816;15;76;907
2004;"QUARTO CENTENARIO (PR)";"PR";"QUARTO CENTENARIO";107;3;7;117
2004;"QUATIGUA (PR)";"PR";"QUATIGUA";283;5;5;293
2004;"QUATRO BARRAS (PR)";"PR";"QUATRO BARRAS";428;24;90;542
2004;"QUATRO PONTES (PR)";"PR";"QUATRO PONTES";142;3;5;150
2004;"QUEDAS DO IGUACU (PR)";"PR";"QUEDAS DO IGUACU";472;9;76;557
2004;"QUERENCIA DO NORTE (PR)";"PR";"QUERENCIA DO NORTE";149;5;17;171
2004;"QUINTA DO SOL (PR)";"PR";"QUINTA DO SOL";109;3;12;124
2004;"QUITANDINHA (PR)";"PR";"QUITANDINHA";357;3;33;393
2004;"RAMILANDIA (PR)";"PR";"RAMILANDIA";35;1;7;43
2004;"RANCHO ALEGRE (PR)";"PR";"RANCHO ALEGRE";100;1;10;111
2004;"RANCHO ALEGRE D OESTE (PR)";"PR";"RANCHO ALEGRE D OESTE";71;0;6;77
2004;"REALEZA (PR)";"PR";"REALEZA";359;10;26;395
2004;"REBOUCAS (PR)";"PR";"REBOUCAS";186;7;19;212
2004;"RENASCENCA (PR)";"PR";"RENASCENCA";162;5;16;183
2004;"RESERVA (PR)";"PR";"RESERVA";370;9;28;407
2004;"RESERVA DO IGUACU (PR)";"PR";"RESERVA DO IGUACU";59;3;15;77
2004;"RIBEIRAO CLARO (PR)";"PR";"RIBEIRAO CLARO";132;15;14;161
2004;"RIBEIRAO DO PINHAL (PR)";"PR";"RIBEIRAO DO PINHAL";185;34;12;231
2004;"RIO AZUL (PR)";"PR";"RIO AZUL";197;4;24;225
2004;"RIO BOM (PR)";"PR";"RIO BOM";50;4;3;57
2004;"RIO BONITO DO IGUACU (PR)";"PR";"RIO BONITO DO IGUACU";179;4;53;236
2004;"RIO BRANCO DO IVAI (PR)";"PR";"RIO BRANCO DO IVAI";25;0;7;32
2004;"RIO BRANCO DO SUL (PR)";"PR";"RIO BRANCO DO SUL";534;39;65;638
2004;"RIO NEGRO (PR)";"PR";"RIO NEGRO";696;48;44;788
2004;"ROLANDIA (PR)";"PR";"ROLANDIA";1307;34;80;1421
2004;"RONCADOR (PR)";"PR";"RONCADOR";208;4;19;231
2004;"RONDON (PR)";"PR";"RONDON";234;5;36;275
2004;"ROSARIO DO IVAI (PR)";"PR";"ROSARIO DO IVAI";41;2;14;57
2004;"SABAUDIA (PR)";"PR";"SABAUDIA";112;4;8;124
2004;"SALGADO FILHO (PR)";"PR";"SALGADO FILHO";114;3;10;127
2004;"SALTO DO ITARARE (PR)";"PR";"SALTO DO ITARARE";81;3;18;102
2004;"SALTO DO LONTRA (PR)";"PR";"SALTO DO LONTRA";191;7;25;223
2004;"SANTA AMELIA (PR)";"PR";"SANTA AMELIA";55;3;9;67
2004;"SANTA CECILIA DO PAVAO (PR)";"PR";"SANTA CECILIA DO PAVAO";63;3;7;73
2004;"SANTA CRUZ DO MONTE CASTELO (PR)";"PR";"SANTA CRUZ DO MONTE CASTELO";169;4;18;191
2004;"SANTA FE (PR)";"PR";"SANTA FE";146;9;21;176
2004;"SANTA HELENA (PR)";"PR";"SANTA HELENA";511;22;69;602
2004;"SANTA INES (PR)";"PR";"SANTA INES";9;1;5;15
2004;"SANTA ISABEL DO IVAI (PR)";"PR";"SANTA ISABEL DO IVAI";140;2;15;157
2004;"SANTA IZABEL DO OESTE (PR)";"PR";"SANTA IZABEL DO OESTE";190;13;18;221
2004;"SANTA LUCIA (PR)";"PR";"SANTA LUCIA";59;1;7;67
2004;"SANTA MARIA DO OESTE (PR)";"PR";"SANTA MARIA DO OESTE";111;4;16;131
2004;"SANTA MARIANA (PR)";"PR";"SANTA MARIANA";279;10;29;318
2004;"SANTA MONICA (PR)";"PR";"SANTA MONICA";34;2;5;41
2004;"SANTA TEREZA DO OESTE (PR)";"PR";"SANTA TEREZA DO OESTE";118;7;9;134
2004;"SANTA TEREZINHA DE ITAIPU (PR)";"PR";"SANTA TEREZINHA DE ITAIPU";320;18;26;364
2004;"SANTANA DO ITARARE (PR)";"PR";"SANTANA DO ITARARE";79;1;10;90
2004;"SANTO ANTONIO DA PLATINA (PR)";"PR";"SANTO ANTONIO DA PLATINA";510;24;194;728
2004;"SANTO ANTONIO DO CAIUA (PR)";"PR";"SANTO ANTONIO DO CAIUA";16;2;9;27
2004;"SANTO ANTONIO DO PARAISO (PR)";"PR";"SANTO ANTONIO DO PARAISO";58;2;6;66
2004;"SANTO ANTONIO DO SUDOESTE (PR)";"PR";"SANTO ANTONIO DO SUDOESTE";281;5;34;320
2004;"SANTO INACIO (PR)";"PR";"SANTO INACIO";60;2;8;70
2004;"SAO CARLOS DO IVAI (PR)";"PR";"SAO CARLOS DO IVAI";196;5;14;215
2004;"SAO JERONIMO DA SERRA (PR)";"PR";"SAO JERONIMO DA SERRA";85;3;16;104
2004;"SAO JOAO (PR)";"PR";"SAO JOAO";258;11;27;296
2004;"SAO JOAO DO CAIUA (PR)";"PR";"SAO JOAO DO CAIUA";39;4;10;53
2004;"SAO JOAO DO IVAI (PR)";"PR";"SAO JOAO DO IVAI";230;8;34;272
2004;"SAO JOAO DO TRIUNFO (PR)";"PR";"SAO JOAO DO TRIUNFO";151;4;31;186
2004;"SAO JORGE D OESTE (PR)";"PR";"SAO JORGE D OESTE";139;4;23;166
2004;"SAO JORGE DO IVAI (PR)";"PR";"SAO JORGE DO IVAI";237;6;10;253
2004;"SAO JORGE DO PATROCINIO (PR)";"PR";"SAO JORGE DO PATROCINIO";79;4;7;90
2004;"SAO JOSE DA BOA VISTA (PR)";"PR";"SAO JOSE DA BOA VISTA";83;2;13;98
2004;"SAO JOSE DAS PALMEIRAS (PR)";"PR";"SAO JOSE DAS PALMEIRAS";52;6;6;64
2004;"SAO JOSE DOS PINHAIS (PR)";"PR";"SAO JOSE DOS PINHAIS";4295;286;427;5008
2004;"SAO MANOEL DO PARANA (PR)";"PR";"SAO MANOEL DO PARANA";28;3;6;37
2004;"SAO MATEUS DO SUL (PR)";"PR";"SAO MATEUS DO SUL";665;24;76;765
2004;"SAO MIGUEL DO IGUACU (PR)";"PR";"SAO MIGUEL DO IGUACU";675;11;60;746
2004;"SAO PEDRO DO IGUACU (PR)";"PR";"SAO PEDRO DO IGUACU";126;9;11;146
2004;"SAO PEDRO DO IVAI (PR)";"PR";"SAO PEDRO DO IVAI";217;2;36;255
2004;"SAO PEDRO DO PARANA (PR)";"PR";"SAO PEDRO DO PARANA";25;1;5;31
2004;"SAO SEBASTIAO DA AMOREIRA (PR)";"PR";"SAO SEBASTIAO DA AMOREIRA";171;6;17;194
2004;"SAO TOME (PR)";"PR";"SAO TOME";71;2;20;93
2004;"SAPOPEMA (PR)";"PR";"SAPOPEMA";55;1;7;63
2004;"SARANDI (PR)";"PR";"SARANDI";628;15;78;721
2004;"SAUDADE DO IGUACU (PR)";"PR";"SAUDADE DO IGUACU";56;6;9;71
2004;"SENGES (PR)";"PR";"SENGES";408;17;39;464
2004;"SERRANOPOLIS DO IGUACU (PR)";"PR";"SERRANOPOLIS DO IGUACU";119;12;10;141
2004;"SERTANEJA (PR)";"PR";"SERTANEJA";192;5;13;210
2004;"SERTANOPOLIS (PR)";"PR";"SERTANOPOLIS";443;6;30;479
2004;"SIQUEIRA CAMPOS (PR)";"PR";"SIQUEIRA CAMPOS";286;6;34;326
2004;"SULINA (PR)";"PR";"SULINA";65;3;9;77
2004;"TAMARANA (PR)";"PR";"TAMARANA";207;6;25;238
2004;"TAMBOARA (PR)";"PR";"TAMBOARA";55;2;6;63
2004;"TAPEJARA (PR)";"PR";"TAPEJARA";262;6;42;310
2004;"TAPIRA (PR)";"PR";"TAPIRA";110;3;5;118
2004;"TEIXEIRA SOARES (PR)";"PR";"TEIXEIRA SOARES";173;5;20;198
2004;"TELEMACO BORBA (PR)";"PR";"TELEMACO BORBA";946;107;180;1233
2004;"TERRA BOA (PR)";"PR";"TERRA BOA";271;6;35;312
2004;"TERRA RICA (PR)";"PR";"TERRA RICA";244;2;25;271
2004;"TERRA ROXA (PR)";"PR";"TERRA ROXA";379;11;16;406
2004;"TIBAGI (PR)";"PR";"TIBAGI";222;14;32;268
2004;"TIJUCAS DO SUL (PR)";"PR";"TIJUCAS DO SUL";236;6;23;265
2004;"TOLEDO (PR)";"PR";"TOLEDO";2267;119;194;2580
2004;"TOMAZINA (PR)";"PR";"TOMAZINA";56;3;14;73
2004;"TRES BARRAS DO PARANA (PR)";"PR";"TRES BARRAS DO PARANA";252;3;16;271
2004;"TUNAS DO PARANA (PR)";"PR";"TUNAS DO PARANA";62;3;8;73
2004;"TUNEIRAS DO OESTE (PR)";"PR";"TUNEIRAS DO OESTE";102;1;23;126
2004;"TUPASSI (PR)";"PR";"TUPASSI";282;4;10;296
2004;"TURVO (PR)";"PR";"TURVO";256;8;28;292
2004;"UBIRATA (PR)";"PR";"UBIRATA";520;14;33;567
2004;"UMUARAMA (PR)";"PR";"UMUARAMA";1911;38;161;2110
2004;"UNIAO DA VITORIA (PR)";"PR";"UNIAO DA VITORIA";1043;26;56;1125
2004;"UNIFLOR (PR)";"PR";"UNIFLOR";17;5;7;29
2004;"URAI (PR)";"PR";"URAI";263;11;19;293
2004;"VENTANIA (PR)";"PR";"VENTANIA";99;3;19;121
2004;"VERA CRUZ DO OESTE (PR)";"PR";"VERA CRUZ DO OESTE";235;8;12;255
2004;"VERE (PR)";"PR";"VERE";152;7;16;175
2004;"VILA ALTA (PR)";"PR";"VILA ALTA";34;1;10;45
2004;"VIRMOND (PR)";"PR";"VIRMOND";78;1;11;90
2004;"VITORINO (PR)";"PR";"VITORINO";196;4;9;209
2004;"WENCESLAU BRAZ (PR)";"PR";"WENCESLAU BRAZ";332;13;50;395
2004;"XAMBRE (PR)";"PR";"XAMBRE";67;6;7;80
2004;"ANGRA DOS REIS (RJ)";"RJ";"ANGRA DOS REIS";867;160;244;1271
2004;"APERIBE (RJ)";"RJ";"APERIBE";67;7;3;77
2004;"ARARUAMA (RJ)";"RJ";"ARARUAMA";968;176;62;1206
2004;"AREAL (RJ)";"RJ";"AREAL";84;6;18;108
2004;"ARMACAO DE BUZIOS (RJ)";"RJ";"ARMACAO DE BUZIOS";123;118;14;255
2004;"ARRAIAL DO CABO (RJ)";"RJ";"ARRAIAL DO CABO";117;32;15;164
2004;"BARRA DO PIRAI (RJ)";"RJ";"BARRA DO PIRAI";2257;98;189;2544
2004;"BARRA MANSA (RJ)";"RJ";"BARRA MANSA";1402;79;435;1916
2004;"BELFORD ROXO (RJ)";"RJ";"BELFORD ROXO";685;219;428;1332
2004;"BOM JARDIM (RJ)";"RJ";"BOM JARDIM";295;13;13;321
2004;"BOM JESUS DO ITABAPOANA (RJ)";"RJ";"BOM JESUS DO ITABAPOANA";285;18;26;329
2004;"CABO FRIO (RJ)";"RJ";"CABO FRIO";2265;220;306;2791
2004;"CACHOEIRAS DE MACACU (RJ)";"RJ";"CACHOEIRAS DE MACACU";599;81;28;708
2004;"CAMBUCI (RJ)";"RJ";"CAMBUCI";64;6;7;77
2004;"CAMPOS DOS GOITACAZES (RJ)";"RJ";"CAMPOS DOS GOITACAZES";4274;280;769;5323
2004;"CANTAGALO (RJ)";"RJ";"CANTAGALO";101;14;20;135
2004;"CARAPEBUS (RJ)";"RJ";"CARAPEBUS";45;20;6;71
2004;"CARDOSO MOREIRA (RJ)";"RJ";"CARDOSO MOREIRA";120;5;13;138
2004;"CARMO (RJ)";"RJ";"CARMO";85;12;23;120
2004;"CASIMIRO DE ABREU (RJ)";"RJ";"CASIMIRO DE ABREU";406;54;23;483
2004;"COMENDADOR LEVY GASPARIAN (RJ)";"RJ";"COMENDADOR LEVY GASPARIAN";84;24;11;119
2004;"CONCEICAO DE MACABU (RJ)";"RJ";"CONCEICAO DE MACABU";130;26;49;205
2004;"CORDEIRO (RJ)";"RJ";"CORDEIRO";204;30;37;271
2004;"DUAS BARRAS (RJ)";"RJ";"DUAS BARRAS";39;19;5;63
2004;"DUQUE DE CAXIAS (RJ)";"RJ";"DUQUE DE CAXIAS";5647;622;2183;8452
2004;"ENGENHEIRO PAULO DE FRONTIN (RJ)";"RJ";"ENGENHEIRO PAULO DE FRONTIN";153;17;16;186
2004;"GUAPIMIRIM (RJ)";"RJ";"GUAPIMIRIM";228;45;29;302
2004;"IGUABA GRANDE (RJ)";"RJ";"IGUABA GRANDE";67;76;9;152
2004;"ITABORAI (RJ)";"RJ";"ITABORAI";2371;730;595;3696
2004;"ITAGUAI (RJ)";"RJ";"ITAGUAI";972;227;176;1375
2004;"ITALVA (RJ)";"RJ";"ITALVA";146;8;13;167
2004;"ITAOCARA (RJ)";"RJ";"ITAOCARA";235;24;19;278
2004;"ITAPERUNA (RJ)";"RJ";"ITAPERUNA";849;67;73;989
2004;"ITATIAIA (RJ)";"RJ";"ITATIAIA";172;65;23;260
2004;"JAPERI (RJ)";"RJ";"JAPERI";104;23;11;138
2004;"LAJE DO MURIAE (RJ)";"RJ";"LAJE DO MURIAE";39;4;4;47
2004;"MACAE (RJ)";"RJ";"MACAE";1708;439;487;2634
2004;"MACUCO (RJ)";"RJ";"MACUCO";78;5;3;86
2004;"MAGE (RJ)";"RJ";"MAGE";873;218;173;1264
2004;"MANGARATIBA (RJ)";"RJ";"MANGARATIBA";113;81;125;319
2004;"MARICA (RJ)";"RJ";"MARICA";452;209;155;816
2004;"MENDES (RJ)";"RJ";"MENDES";242;33;21;296
2004;"MESQUITA (RJ)";"RJ";"MESQUITA";196;68;291;555
2004;"MIGUEL PEREIRA (RJ)";"RJ";"MIGUEL PEREIRA";194;40;16;250
2004;"MIRACEMA (RJ)";"RJ";"MIRACEMA";167;8;19;194
2004;"NATIVIDADE (RJ)";"RJ";"NATIVIDADE";61;9;15;85
2004;"NILOPOLIS (RJ)";"RJ";"NILOPOLIS";433;117;254;804
2004;"NITEROI (RJ)";"RJ";"NITEROI";1934;1206;1550;4690
2004;"NOVA FRIBURGO (RJ)";"RJ";"NOVA FRIBURGO";3365;161;274;3800
2004;"NOVA IGUACU (RJ)";"RJ";"NOVA IGUACU";4339;720;1392;6451
2004;"PARACAMBI (RJ)";"RJ";"PARACAMBI";131;25;33;189
2004;"PARAIBA DO SUL (RJ)";"RJ";"PARAIBA DO SUL";321;45;226;592
2004;"PARATI (RJ)";"RJ";"PARATI";131;46;31;208
2004;"PATY DO ALFERES (RJ)";"RJ";"PATY DO ALFERES";352;37;36;425
2004;"PETROPOLIS (RJ)";"RJ";"PETROPOLIS";2853;520;632;4005
2004;"PINHEIRAL (RJ)";"RJ";"PINHEIRAL";108;28;25;161
2004;"PIRAI (RJ)";"RJ";"PIRAI";502;26;69;597
2004;"PORCIUNCULA (RJ)";"RJ";"PORCIUNCULA";61;3;5;69
2004;"PORTO REAL (RJ)";"RJ";"PORTO REAL";284;20;22;326
2004;"QUATIS (RJ)";"RJ";"QUATIS";204;124;29;357
2004;"QUEIMADOS (RJ)";"RJ";"QUEIMADOS";276;160;92;528
2004;"QUISSAMA (RJ)";"RJ";"QUISSAMA";124;10;32;166
2004;"RESENDE (RJ)";"RJ";"RESENDE";664;114;214;992
2004;"RIO BONITO (RJ)";"RJ";"RIO BONITO";3016;252;169;3437
2004;"RIO CLARO (RJ)";"RJ";"RIO CLARO";61;7;6;74
2004;"RIO DAS FLORES (RJ)";"RJ";"RIO DAS FLORES";55;12;4;71
2004;"RIO DAS OSTRAS (RJ)";"RJ";"RIO DAS OSTRAS";506;145;43;694
2004;"RIO DE JANEIRO (RJ)";"RJ";"RIO DE JANEIRO";26515;11315;10930;48760
2004;"SANTA MARIA MADALENA (RJ)";"RJ";"SANTA MARIA MADALENA";38;7;1;46
2004;"SANTO ANTONIO DE PADUA (RJ)";"RJ";"SANTO ANTONIO DE PADUA";424;42;20;486
2004;"SAO FIDELIS (RJ)";"RJ";"SAO FIDELIS";273;19;42;334
2004;"SAO FRANCISCO DE ITABAPOANA (RJ)";"RJ";"SAO FRANCISCO DE ITABAPOANA";207;20;17;244
2004;"SAO GONCALO (RJ)";"RJ";"SAO GONCALO";2116;1248;1549;4913
2004;"SAO JOAO DA BARRA (RJ)";"RJ";"SAO JOAO DA BARRA";205;25;20;250
2004;"SAO JOAO DE MERITI (RJ)";"RJ";"SAO JOAO DE MERITI";2087;275;1102;3464
2004;"SAO JOSE DE UBA (RJ)";"RJ";"SAO JOSE DE UBA";8;0;2;10
2004;"SAO JOSE DO VALE DO RIO PRETO (RJ)";"RJ";"SAO JOSE DO VALE DO RIO PRETO";449;39;25;513
2004;"SAO PEDRO DA ALDEIA (RJ)";"RJ";"SAO PEDRO DA ALDEIA";345;43;33;421
2004;"SAO SEBASTIAO DO ALTO (RJ)";"RJ";"SAO SEBASTIAO DO ALTO";53;3;2;58
2004;"SAPUCAIA (RJ)";"RJ";"SAPUCAIA";104;5;6;115
2004;"SAQUAREMA (RJ)";"RJ";"SAQUAREMA";363;72;45;480
2004;"SEROPEDICA (RJ)";"RJ";"SEROPEDICA";322;33;144;499
2004;"SILVA JARDIM (RJ)";"RJ";"SILVA JARDIM";239;33;14;286
2004;"SUMIDOURO (RJ)";"RJ";"SUMIDOURO";191;8;11;210
2004;"TANGUA (RJ)";"RJ";"TANGUA";151;13;14;178
2004;"TERESOPOLIS (RJ)";"RJ";"TERESOPOLIS";1461;147;247;1855
2004;"TRAJANO DE MORAIS (RJ)";"RJ";"TRAJANO DE MORAIS";37;3;4;44
2004;"TRES RIOS (RJ)";"RJ";"TRES RIOS";661;61;181;903
2004;"VALENCA (RJ)";"RJ";"VALENCA";236;38;41;315
2004;"VARRE SAI (RJ)";"RJ";"VARRE SAI";29;3;1;33
2004;"VASSOURAS (RJ)";"RJ";"VASSOURAS";372;37;62;471
2004;"VOLTA REDONDA (RJ)";"RJ";"VOLTA REDONDA";1711;202;428;2341
2004;"ACARI (RN)";"RN";"ACARI";60;7;4;71
2004;"AFONSO BEZERRA (RN)";"RN";"AFONSO BEZERRA";17;3;1;21
2004;"AGUA NOVA (RN)";"RN";"AGUA NOVA";3;2;0;5
2004;"ALEXANDRIA (RN)";"RN";"ALEXANDRIA";28;6;7;41
2004;"ALMINO AFONSO (RN)";"RN";"ALMINO AFONSO";4;6;0;10
2004;"ALTO DO RODRIGUES (RN)";"RN";"ALTO DO RODRIGUES";61;5;12;78
2004;"ANGICOS (RN)";"RN";"ANGICOS";71;6;7;84
2004;"ANTONIO MARTINS (RN)";"RN";"ANTONIO MARTINS";8;5;0;13
2004;"APODI (RN)";"RN";"APODI";122;14;13;149
2004;"AREIA BRANCA (RN)";"RN";"AREIA BRANCA";76;32;30;138
2004;"ARES (RN)";"RN";"ARES";73;2;7;82
2004;"ASSU (RN)";"RN";"ASSU";343;27;18;388
2004;"BAIA FORMOSA (RN)";"RN";"BAIA FORMOSA";32;1;3;36
2004;"BARAUNA (RN)";"RN";"BARAUNA";100;17;4;121
2004;"BARCELONA (RN)";"RN";"BARCELONA";20;4;1;25
2004;"BENTO FERNANDES (RN)";"RN";"BENTO FERNANDES";7;4;0;11
2004;"BOA SAUDE (RN)";"RN";"BOA SAUDE";29;3;0;32
2004;"BODO (RN)";"RN";"BODO";7;6;2;15
2004;"BOM JESUS (RN)";"RN";"BOM JESUS";33;1;2;36
2004;"BREJINHO (RN)";"RN";"BREJINHO";40;7;6;53
2004;"CAICARA DO NORTE (RN)";"RN";"CAICARA DO NORTE";6;0;1;7
2004;"CAICARA DO RIO DO VENTO (RN)";"RN";"CAICARA DO RIO DO VENTO";14;2;1;17
2004;"CAICO (RN)";"RN";"CAICO";838;38;31;907
2004;"CAMPO GRANDE (RN)";"RN";"CAMPO GRANDE";22;6;0;28
2004;"CAMPO REDONDO (RN)";"RN";"CAMPO REDONDO";24;6;1;31
2004;"CANGUARETAMA (RN)";"RN";"CANGUARETAMA";108;17;24;149
2004;"CARAUBAS (RN)";"RN";"CARAUBAS";73;13;2;88
2004;"CARNAUBA DOS DANTAS (RN)";"RN";"CARNAUBA DOS DANTAS";80;3;4;87
2004;"CARNAUBAIS (RN)";"RN";"CARNAUBAIS";35;11;8;54
2004;"CEARA MIRIM (RN)";"RN";"CEARA MIRIM";219;25;40;284
2004;"CERRO CORA (RN)";"RN";"CERRO CORA";53;6;3;62
2004;"CORONEL EZEQUIEL (RN)";"RN";"CORONEL EZEQUIEL";14;4;3;21
2004;"CORONEL JOAO PESSOA (RN)";"RN";"CORONEL JOAO PESSOA";8;2;0;10
2004;"CRUZETA (RN)";"RN";"CRUZETA";43;5;1;49
2004;"CURRAIS NOVOS (RN)";"RN";"CURRAIS NOVOS";433;20;32;485
2004;"DOUTOR SEVERIANO (RN)";"RN";"DOUTOR SEVERIANO";4;6;1;11
2004;"ENCANTO (RN)";"RN";"ENCANTO";7;1;1;9
2004;"EQUADOR (RN)";"RN";"EQUADOR";38;1;1;40
2004;"ESPIRITO SANTO (RN)";"RN";"ESPIRITO SANTO";12;3;4;19
2004;"ESPIRITO SANTO DO OESTE (RN)";"RN";"ESPIRITO SANTO DO OESTE";12;3;1;16
2004;"EXTREMOZ (RN)";"RN";"EXTREMOZ";30;16;51;97
2004;"FELIPE GUERRA (RN)";"RN";"FELIPE GUERRA";9;5;1;15
2004;"FERNANDO PEDROZA (RN)";"RN";"FERNANDO PEDROZA";12;0;1;13
2004;"FLORANIA (RN)";"RN";"FLORANIA";34;5;2;41
2004;"FRANCISCO DANTAS (RN)";"RN";"FRANCISCO DANTAS";5;2;1;8
2004;"FRUTUOSO GOMES (RN)";"RN";"FRUTUOSO GOMES";13;4;0;17
2004;"GALINHOS (RN)";"RN";"GALINHOS";7;2;1;10
2004;"GOIANINHA (RN)";"RN";"GOIANINHA";81;26;24;131
2004;"GOVERNADOR DIX SEPT ROSADO (RN)";"RN";"GOVERNADOR DIX SEPT ROSADO";71;6;6;83
2004;"GROSSOS (RN)";"RN";"GROSSOS";21;5;3;29
2004;"GUAMARE (RN)";"RN";"GUAMARE";19;10;13;42
2004;"IELMO MARINHO (RN)";"RN";"IELMO MARINHO";28;3;3;34
2004;"IPANGUACU (RN)";"RN";"IPANGUACU";37;10;33;80
2004;"IPUEIRA (RN)";"RN";"IPUEIRA";12;7;4;23
2004;"ITAJA (RN)";"RN";"ITAJA";38;0;3;41
2004;"ITAU (RN)";"RN";"ITAU";11;2;0;13
2004;"JACANA (RN)";"RN";"JACANA";54;12;11;77
2004;"JANDAIRA (RN)";"RN";"JANDAIRA";24;2;3;29
2004;"JANDUIS (RN)";"RN";"JANDUIS";8;1;0;9
2004;"JAPI (RN)";"RN";"JAPI";23;2;5;30
2004;"JARDIM DE ANGICOS (RN)";"RN";"JARDIM DE ANGICOS";5;0;1;6
2004;"JARDIM DE PIRANHAS (RN)";"RN";"JARDIM DE PIRANHAS";42;11;5;58
2004;"JARDIM DO SERIDO (RN)";"RN";"JARDIM DO SERIDO";103;6;57;166
2004;"JOAO CAMARA (RN)";"RN";"JOAO CAMARA";166;7;13;186
2004;"JOAO DIAS (RN)";"RN";"JOAO DIAS";3;1;0;4
2004;"JOSE DA PENHA (RN)";"RN";"JOSE DA PENHA";14;8;1;23
2004;"JUCURUTU (RN)";"RN";"JUCURUTU";67;11;4;82
2004;"JUNDIA (RN)";"RN";"JUNDIA";2;0;2;4
2004;"LAGOA DANTA (RN)";"RN";"LAGOA DANTA";21;2;4;27
2004;"LAGOA DE PEDRAS (RN)";"RN";"LAGOA DE PEDRAS";18;1;2;21
2004;"LAGOA DE VELHOS (RN)";"RN";"LAGOA DE VELHOS";7;0;0;7
2004;"LAGOA NOVA (RN)";"RN";"LAGOA NOVA";40;5;2;47
2004;"LAGOA SALGADA (RN)";"RN";"LAGOA SALGADA";30;5;0;35
2004;"LAJES (RN)";"RN";"LAJES";41;3;5;49
2004;"LAJES PINTADAS (RN)";"RN";"LAJES PINTADAS";10;7;4;21
2004;"LUCRECIA (RN)";"RN";"LUCRECIA";12;1;1;14
2004;"LUIS GOMES (RN)";"RN";"LUIS GOMES";9;4;1;14
2004;"MACAIBA (RN)";"RN";"MACAIBA";261;25;18;304
2004;"MACAU (RN)";"RN";"MACAU";88;22;30;140
2004;"MAJOR SALES (RN)";"RN";"MAJOR SALES";4;2;0;6
2004;"MARCELINO VIEIRA (RN)";"RN";"MARCELINO VIEIRA";10;7;1;18
2004;"MARTINS (RN)";"RN";"MARTINS";24;3;2;29
2004;"MAXARANGUAPE (RN)";"RN";"MAXARANGUAPE";12;6;3;21
2004;"MESSIAS TARGINO (RN)";"RN";"MESSIAS TARGINO";16;5;1;22
2004;"MONTANHAS (RN)";"RN";"MONTANHAS";16;3;6;25
2004;"MONTE ALEGRE (RN)";"RN";"MONTE ALEGRE";51;6;8;65
2004;"MONTE DAS GAMELEIRAS (RN)";"RN";"MONTE DAS GAMELEIRAS";7;3;5;15
2004;"MOSSORO (RN)";"RN";"MOSSORO";2327;114;106;2547
2004;"NATAL (RN)";"RN";"NATAL";4969;993;1681;7643
2004;"NISIA FLORESTA (RN)";"RN";"NISIA FLORESTA";56;16;47;119
2004;"NOVA CRUZ (RN)";"RN";"NOVA CRUZ";197;16;24;237
2004;"OLHO D AGUA DO BORGES (RN)";"RN";"OLHO D AGUA DO BORGES";14;3;0;17
2004;"OURO BRANCO (RN)";"RN";"OURO BRANCO";35;5;4;44
2004;"PARANA (RN)";"RN";"PARANA";5;3;1;9
2004;"PARAZINHO (RN)";"RN";"PARAZINHO";13;0;4;17
2004;"PARELHAS (RN)";"RN";"PARELHAS";192;9;17;218
2004;"PARNAMIRIM (RN)";"RN";"PARNAMIRIM";878;203;147;1228
2004;"PASSA E FICA (RN)";"RN";"PASSA E FICA";53;8;4;65
2004;"PASSAGEM (RN)";"RN";"PASSAGEM";13;5;0;18
2004;"PATU (RN)";"RN";"PATU";62;15;2;79
2004;"PAU DOS FERROS (RN)";"RN";"PAU DOS FERROS";203;20;5;228
2004;"PEDRA GRANDE (RN)";"RN";"PEDRA GRANDE";9;1;3;13
2004;"PEDRA PRETA (RN)";"RN";"PEDRA PRETA";19;1;2;22
2004;"PEDRO AVELINO (RN)";"RN";"PEDRO AVELINO";22;1;1;24
2004;"PEDRO VELHO (RN)";"RN";"PEDRO VELHO";30;1;6;37
2004;"PENDENCIAS (RN)";"RN";"PENDENCIAS";35;6;14;55
2004;"PILOES (RN)";"RN";"PILOES";1;3;0;4
2004;"POCO BRANCO (RN)";"RN";"POCO BRANCO";23;3;2;28
2004;"PORTALEGRE (RN)";"RN";"PORTALEGRE";24;4;1;29
2004;"PORTO DO MANGUE (RN)";"RN";"PORTO DO MANGUE";31;6;2;39
2004;"PUREZA (RN)";"RN";"PUREZA";34;1;4;39
2004;"RAFAEL FERNANDES (RN)";"RN";"RAFAEL FERNANDES";8;3;1;12
2004;"RAFAEL GODEIRO (RN)";"RN";"RAFAEL GODEIRO";8;2;0;10
2004;"RIACHO DA CRUZ (RN)";"RN";"RIACHO DA CRUZ";3;2;0;5
2004;"RIACHO DE SANTANA (RN)";"RN";"RIACHO DE SANTANA";2;5;1;8
2004;"RIACHUELO (RN)";"RN";"RIACHUELO";18;3;2;23
2004;"RIO DO FOGO (RN)";"RN";"RIO DO FOGO";17;1;0;18
2004;"RODOLFO FERNANDES (RN)";"RN";"RODOLFO FERNANDES";15;5;0;20
2004;"RUY BARBOSA (RN)";"RN";"RUY BARBOSA";11;1;1;13
2004;"SANTA CRUZ (RN)";"RN";"SANTA CRUZ";236;10;15;261
2004;"SANTA MARIA (RN)";"RN";"SANTA MARIA";21;0;1;22
2004;"SANTANA DO MATOS (RN)";"RN";"SANTANA DO MATOS";45;6;1;52
2004;"SANTANA DO SERIDO (RN)";"RN";"SANTANA DO SERIDO";13;1;0;14
2004;"SANTO ANTONIO (RN)";"RN";"SANTO ANTONIO";77;23;10;110
2004;"SAO BENTO DO NORTE (RN)";"RN";"SAO BENTO DO NORTE";7;3;1;11
2004;"SAO BENTO DO TRAIRI (RN)";"RN";"SAO BENTO DO TRAIRI";13;2;2;17
2004;"SAO FERNANDO (RN)";"RN";"SAO FERNANDO";5;3;1;9
2004;"SAO FRANCISCO DO OESTE (RN)";"RN";"SAO FRANCISCO DO OESTE";7;2;2;11
2004;"SAO GONCALO DO AMARANTE (RN)";"RN";"SAO GONCALO DO AMARANTE";166;25;36;227
2004;"SAO JOAO DO SABUGI (RN)";"RN";"SAO JOAO DO SABUGI";23;0;2;25
2004;"SAO JOSE DE MIPIBU (RN)";"RN";"SAO JOSE DE MIPIBU";163;27;20;210
2004;"SAO JOSE DO CAMPESTRE (RN)";"RN";"SAO JOSE DO CAMPESTRE";52;5;3;60
2004;"SAO JOSE DO SERIDO (RN)";"RN";"SAO JOSE DO SERIDO";18;6;1;25
2004;"SAO MIGUEL (RN)";"RN";"SAO MIGUEL";75;12;16;103
2004;"SAO MIGUEL DE TOUROS (RN)";"RN";"SAO MIGUEL DE TOUROS";10;1;2;13
2004;"SAO PAULO DO POTENGI (RN)";"RN";"SAO PAULO DO POTENGI";79;3;5;87
2004;"SAO PEDRO (RN)";"RN";"SAO PEDRO";23;2;2;27
2004;"SAO RAFAEL (RN)";"RN";"SAO RAFAEL";17;6;0;23
2004;"SAO TOME (RN)";"RN";"SAO TOME";28;2;16;46
2004;"SAO VICENTE (RN)";"RN";"SAO VICENTE";37;0;0;37
2004;"SENADOR ELOI DE SOUZA (RN)";"RN";"SENADOR ELOI DE SOUZA";10;4;3;17
2004;"SENADOR GEORGINO AVELINO (RN)";"RN";"SENADOR GEORGINO AVELINO";6;1;1;8
2004;"SERRA CAIADA (RN)";"RN";"SERRA CAIADA";20;4;6;30
2004;"SERRA DE SAO BENTO (RN)";"RN";"SERRA DE SAO BENTO";11;2;2;15
2004;"SERRA DO MEL (RN)";"RN";"SERRA DO MEL";35;6;4;45
2004;"SERRA NEGRA DO NORTE (RN)";"RN";"SERRA NEGRA DO NORTE";61;8;3;72
2004;"SERRINHA (RN)";"RN";"SERRINHA";13;5;1;19
2004;"SERRINHA DOS PINTOS (RN)";"RN";"SERRINHA DOS PINTOS";23;3;0;26
2004;"SEVERIANO MELO (RN)";"RN";"SEVERIANO MELO";28;5;3;36
2004;"SITIO NOVO (RN)";"RN";"SITIO NOVO";10;1;0;11
2004;"TABOLEIRO GRANDE (RN)";"RN";"TABOLEIRO GRANDE";3;1;0;4
2004;"TAIPU (RN)";"RN";"TAIPU";35;2;4;41
2004;"TANGARA (RN)";"RN";"TANGARA";58;3;10;71
2004;"TENENTE ANANIAS (RN)";"RN";"TENENTE ANANIAS";17;4;0;21
2004;"TENENTE LAURENTINO CRUZ (RN)";"RN";"TENENTE LAURENTINO CRUZ";29;7;2;38
2004;"TIBAU (RN)";"RN";"TIBAU";11;14;5;30
2004;"TIBAU DO SUL (RN)";"RN";"TIBAU DO SUL";24;33;7;64
2004;"TIMBAUBA DOS BATISTAS (RN)";"RN";"TIMBAUBA DOS BATISTAS";10;6;2;18
2004;"TOUROS (RN)";"RN";"TOUROS";101;16;15;132
2004;"TRIUNFO POTIGUAR (RN)";"RN";"TRIUNFO POTIGUAR";10;4;0;14
2004;"UMARIZAL (RN)";"RN";"UMARIZAL";35;11;2;48
2004;"UPANEMA (RN)";"RN";"UPANEMA";24;11;5;40
2004;"VARZEA (RN)";"RN";"VARZEA";16;2;3;21
2004;"VENHA VER (RN)";"RN";"VENHA VER";8;2;0;10
2004;"VERA CRUZ (RN)";"RN";"VERA CRUZ";76;2;11;89
2004;"VICOSA (RN)";"RN";"VICOSA";4;4;0;8
2004;"VILA FLOR (RN)";"RN";"VILA FLOR";4;1;1;6
2004;"ALTA FLORESTA D OESTE (RO)";"RO";"ALTA FLORESTA D OESTE";328;8;18;354
2004;"ALTO ALEGRE DOS PARECIS (RO)";"RO";"ALTO ALEGRE DOS PARECIS";46;1;4;51
2004;"ALTO PARAISO (RO)";"RO";"ALTO PARAISO";68;3;11;82
2004;"ALVORADA D OESTE (RO)";"RO";"ALVORADA D OESTE";197;3;16;216
2004;"ARIQUEMES (RO)";"RO";"ARIQUEMES";1430;17;110;1557
2004;"BURITIS (RO)";"RO";"BURITIS";174;1;10;185
2004;"CABIXI (RO)";"RO";"CABIXI";54;1;7;62
2004;"CACAULANDIA (RO)";"RO";"CACAULANDIA";21;1;6;28
2004;"CACOAL (RO)";"RO";"CACOAL";1186;22;134;1342
2004;"CAMPO NOVO DE RONDONIA (RO)";"RO";"CAMPO NOVO DE RONDONIA";22;0;5;27
2004;"CANDEIAS DO JAMARI (RO)";"RO";"CANDEIAS DO JAMARI";54;2;5;61
2004;"CASTANHEIRAS (RO)";"RO";"CASTANHEIRAS";19;2;4;25
2004;"CEREJEIRAS (RO)";"RO";"CEREJEIRAS";298;10;23;331
2004;"CHUPINGUAIA (RO)";"RO";"CHUPINGUAIA";30;1;10;41
2004;"COLORADO DO OESTE (RO)";"RO";"COLORADO DO OESTE";290;6;27;323
2004;"CORUMBIARA (RO)";"RO";"CORUMBIARA";24;2;3;29
2004;"COSTA MARQUES (RO)";"RO";"COSTA MARQUES";29;2;1;32
2004;"CUJUBIM (RO)";"RO";"CUJUBIM";17;0;3;20
2004;"ESPIGAO D OESTE (RO)";"RO";"ESPIGAO D OESTE";363;3;39;405
2004;"GOVERNADOR JORGE TEIXEIRA (RO)";"RO";"GOVERNADOR JORGE TEIXEIRA";19;0;7;26
2004;"GUAJARA MIRIM (RO)";"RO";"GUAJARA MIRIM";307;6;9;322
2004;"JAMARI (RO)";"RO";"JAMARI";36;0;7;43
2004;"JARU (RO)";"RO";"JARU";788;15;87;890
2004;"JI PARANA (RO)";"RO";"JI PARANA";1885;39;466;2390
2004;"MACHADINHO D OESTE (RO)";"RO";"MACHADINHO D OESTE";150;0;30;180
2004;"MINISTRO ANDREAZZA (RO)";"RO";"MINISTRO ANDREAZZA";89;1;7;97
2004;"MIRANTE DA SERRA (RO)";"RO";"MIRANTE DA SERRA";112;1;7;120
2004;"MONTE NEGRO (RO)";"RO";"MONTE NEGRO";141;1;29;171
2004;"NOVA BRASILANDIA D OESTE (RO)";"RO";"NOVA BRASILANDIA D OESTE";162;3;15;180
2004;"NOVA UNIAO (RO)";"RO";"NOVA UNIAO";7;1;0;8
2004;"NOVO HORIZONTE DO OESTE (RO)";"RO";"NOVO HORIZONTE DO OESTE";37;1;6;44
2004;"OURO PRETO DO OESTE (RO)";"RO";"OURO PRETO DO OESTE";590;17;74;681
2004;"PARECIS (RO)";"RO";"PARECIS";15;0;3;18
2004;"PIMENTA BUENO (RO)";"RO";"PIMENTA BUENO";639;7;39;685
2004;"PIMENTEIRAS DO OESTE (RO)";"RO";"PIMENTEIRAS DO OESTE";9;0;6;15
2004;"PORTO VELHO (RO)";"RO";"PORTO VELHO";2942;159;544;3645
2004;"PRESIDENTE MEDICI (RO)";"RO";"PRESIDENTE MEDICI";207;1;31;239
2004;"PRIMAVERA DE RONDONIA (RO)";"RO";"PRIMAVERA DE RONDONIA";24;2;5;31
2004;"RIO CRESPO (RO)";"RO";"RIO CRESPO";18;1;4;23
2004;"ROLIM DE MOURA (RO)";"RO";"ROLIM DE MOURA";852;19;52;923
2004;"SANTA LUZIA D OESTE (RO)";"RO";"SANTA LUZIA D OESTE";84;2;29;115
2004;"SAO FELIPE D OESTE (RO)";"RO";"SAO FELIPE D OESTE";19;1;7;27
2004;"SAO FRANCISCO DO GUAPORE (RO)";"RO";"SAO FRANCISCO DO GUAPORE";109;0;6;115
2004;"SAO MIGUEL DO GUAPORE (RO)";"RO";"SAO MIGUEL DO GUAPORE";117;2;12;131
2004;"SERINGUEIRAS (RO)";"RO";"SERINGUEIRAS";41;3;7;51
2004;"TEIXEIROPOLIS (RO)";"RO";"TEIXEIROPOLIS";6;0;4;10
2004;"THEOBROMA (RO)";"RO";"THEOBROMA";21;0;15;36
2004;"URUPA (RO)";"RO";"URUPA";64;1;15;80
2004;"VALE DO ANARI (RO)";"RO";"VALE DO ANARI";19;1;1;21
2004;"VALE DO PARAISO (RO)";"RO";"VALE DO PARAISO";25;0;3;28
2004;"VILA NOVA DO MAMORE (RO)";"RO";"VILA NOVA DO MAMORE";83;0;8;91
2004;"VILHENA (RO)";"RO";"VILHENA";996;21;94;1111
2004;"ALTO ALEGRE (RR)";"RR";"ALTO ALEGRE";10;1;1;12
2004;"AMAJARI (RR)";"RR";"AMAJARI";3;1;0;4
2004;"BOA VISTA (RR)";"RR";"BOA VISTA";2160;171;299;2630
2004;"BONFIM (RR)";"RR";"BONFIM";4;0;0;4
2004;"CANTA (RR)";"RR";"CANTA";9;0;1;10
2004;"CARACARAI (RR)";"RR";"CARACARAI";21;1;0;22
2004;"CAROEBE (RR)";"RR";"CAROEBE";9;1;2;12
2004;"IRACEMA (RR)";"RR";"IRACEMA";0;1;0;1
2004;"MUCAJAI (RR)";"RR";"MUCAJAI";51;15;2;68
2004;"NORMANDIA (RR)";"RR";"NORMANDIA";3;0;0;3
2004;"PACARAIMA (RR)";"RR";"PACARAIMA";11;0;1;12
2004;"RORAINOPOLIS (RR)";"RR";"RORAINOPOLIS";20;2;2;24
2004;"SAO JOAO DA BALIZA (RR)";"RR";"SAO JOAO DA BALIZA";9;1;0;10
2004;"SAO LUIZ (RR)";"RR";"SAO LUIZ";11;1;0;12
2004;"UIRAMUTA (RR)";"RR";"UIRAMUTA";2;0;0;2
2004;"ACEGUA (RS)";"RS";"ACEGUA";41;9;7;57
2004;"AGUA SANTA (RS)";"RS";"AGUA SANTA";118;1;11;130
2004;"AGUDO (RS)";"RS";"AGUDO";239;8;42;289
2004;"AJURICABA (RS)";"RS";"AJURICABA";287;9;22;318
2004;"ALECRIM (RS)";"RS";"ALECRIM";73;3;15;91
2004;"ALEGRETE (RS)";"RS";"ALEGRETE";818;21;129;968
2004;"ALEGRIA (RS)";"RS";"ALEGRIA";69;3;9;81
2004;"ALMIRANTE TAMANDARE DO SUL (RS)";"RS";"ALMIRANTE TAMANDARE DO SUL";67;4;3;74
2004;"ALPESTRE (RS)";"RS";"ALPESTRE";87;8;27;122
2004;"ALTO ALEGRE (RS)";"RS";"ALTO ALEGRE";61;2;8;71
2004;"ALTO FELIZ (RS)";"RS";"ALTO FELIZ";71;7;12;90
2004;"ALVORADA (RS)";"RS";"ALVORADA";970;83;445;1498
2004;"AMARAL FERRADOR (RS)";"RS";"AMARAL FERRADOR";102;3;9;114
2004;"AMETISTA DO SUL (RS)";"RS";"AMETISTA DO SUL";39;1;16;56
2004;"ANDRE DA ROCHA (RS)";"RS";"ANDRE DA ROCHA";37;3;0;40
2004;"ANTA GORDA (RS)";"RS";"ANTA GORDA";150;6;18;174
2004;"ANTONIO PRADO (RS)";"RS";"ANTONIO PRADO";571;17;37;625
2004;"ARAMBARE (RS)";"RS";"ARAMBARE";27;2;5;34
2004;"ARARICA (RS)";"RS";"ARARICA";47;6;3;56
2004;"ARATIBA (RS)";"RS";"ARATIBA";124;16;20;160
2004;"ARROIO DO MEIO (RS)";"RS";"ARROIO DO MEIO";355;12;41;408
2004;"ARROIO DO PADRE (RS)";"RS";"ARROIO DO PADRE";68;7;6;81
2004;"ARROIO DO SAL (RS)";"RS";"ARROIO DO SAL";56;5;7;68
2004;"ARROIO DO TIGRE (RS)";"RS";"ARROIO DO TIGRE";239;13;28;280
2004;"ARROIO DOS RATOS (RS)";"RS";"ARROIO DOS RATOS";165;5;45;215
2004;"ARROIO GRANDE (RS)";"RS";"ARROIO GRANDE";189;9;27;225
2004;"ARVOREZINHA (RS)";"RS";"ARVOREZINHA";324;24;33;381
2004;"AUGUSTO PESTANA (RS)";"RS";"AUGUSTO PESTANA";308;9;19;336
2004;"AUREA (RS)";"RS";"AUREA";74;6;5;85
2004;"BAGE (RS)";"RS";"BAGE";904;79;224;1207
2004;"BALNEARIO PINHAL (RS)";"RS";"BALNEARIO PINHAL";68;6;7;81
2004;"BARAO (RS)";"RS";"BARAO";140;9;35;184
2004;"BARAO DE COTEGIPE (RS)";"RS";"BARAO DE COTEGIPE";151;9;13;173
2004;"BARAO DO TRIUNFO (RS)";"RS";"BARAO DO TRIUNFO";120;11;15;146
2004;"BARRA DO GUARITA (RS)";"RS";"BARRA DO GUARITA";14;2;4;20
2004;"BARRA DO QUARAI (RS)";"RS";"BARRA DO QUARAI";19;0;5;24
2004;"BARRA DO RIBEIRO (RS)";"RS";"BARRA DO RIBEIRO";141;8;34;183
2004;"BARRA DO RIO AZUL (RS)";"RS";"BARRA DO RIO AZUL";30;9;6;45
2004;"BARRA FUNDA (RS)";"RS";"BARRA FUNDA";121;2;8;131
2004;"BARRACAO (RS)";"RS";"BARRACAO";100;7;10;117
2004;"BARROS CASSAL (RS)";"RS";"BARROS CASSAL";128;5;28;161
2004;"BENJAMIN CONSTANT DO SUL (RS)";"RS";"BENJAMIN CONSTANT DO SUL";20;4;4;28
2004;"BENTO GONCALVES (RS)";"RS";"BENTO GONCALVES";2677;157;265;3099
2004;"BOA VISTA DAS MISSOES (RS)";"RS";"BOA VISTA DAS MISSOES";83;3;5;91
2004;"BOA VISTA DO BURICA (RS)";"RS";"BOA VISTA DO BURICA";129;7;19;155
2004;"BOA VISTA DO CADEADO (RS)";"RS";"BOA VISTA DO CADEADO";33;5;7;45
2004;"BOA VISTA DO INCRA (RS)";"RS";"BOA VISTA DO INCRA";43;1;5;49
2004;"BOA VISTA DO SUL (RS)";"RS";"BOA VISTA DO SUL";256;7;7;270
2004;"BOM JESUS (RS)";"RS";"BOM JESUS";218;5;29;252
2004;"BOM PRINCIPIO (RS)";"RS";"BOM PRINCIPIO";299;19;29;347
2004;"BOM PROGRESSO (RS)";"RS";"BOM PROGRESSO";27;2;5;34
2004;"BOM RETIRO DO SUL (RS)";"RS";"BOM RETIRO DO SUL";128;9;24;161
2004;"BOQUEIRAO DO LEAO (RS)";"RS";"BOQUEIRAO DO LEAO";127;4;17;148
2004;"BOSSOROCA (RS)";"RS";"BOSSOROCA";138;5;12;155
2004;"BOZANO (RS)";"RS";"BOZANO";101;2;6;109
2004;"BRAGA (RS)";"RS";"BRAGA";50;0;8;58
2004;"BROCHIER (RS)";"RS";"BROCHIER";185;15;16;216
2004;"BUTIA (RS)";"RS";"BUTIA";253;8;56;317
2004;"CACAPAVA DO SUL (RS)";"RS";"CACAPAVA DO SUL";464;13;76;553
2004;"CACEQUI (RS)";"RS";"CACEQUI";125;3;17;145
2004;"CACHOEIRA DO SUL (RS)";"RS";"CACHOEIRA DO SUL";914;33;184;1131
2004;"CACHOEIRINHA (RS)";"RS";"CACHOEIRINHA";1522;137;365;2024
2004;"CACIQUE DOBLE (RS)";"RS";"CACIQUE DOBLE";71;5;7;83
2004;"CAIBATE (RS)";"RS";"CAIBATE";113;6;4;123
2004;"CAICARA (RS)";"RS";"CAICARA";59;7;13;79
2004;"CAMAQUA (RS)";"RS";"CAMAQUA";1127;27;166;1320
2004;"CAMARGO (RS)";"RS";"CAMARGO";84;3;15;102
2004;"CAMBARA DO SUL (RS)";"RS";"CAMBARA DO SUL";264;10;22;296
2004;"CAMPESTRE DA SERRA (RS)";"RS";"CAMPESTRE DA SERRA";114;7;5;126
2004;"CAMPINA DAS MISSOES (RS)";"RS";"CAMPINA DAS MISSOES";100;8;20;128
2004;"CAMPINAS DO SUL (RS)";"RS";"CAMPINAS DO SUL";169;9;16;194
2004;"CAMPO BOM (RS)";"RS";"CAMPO BOM";538;79;101;718
2004;"CAMPO NOVO (RS)";"RS";"CAMPO NOVO";133;8;13;154
2004;"CAMPOS BORGES (RS)";"RS";"CAMPOS BORGES";80;5;10;95
2004;"CANDELARIA (RS)";"RS";"CANDELARIA";295;19;56;370
2004;"CANDIDO GODOI (RS)";"RS";"CANDIDO GODOI";157;14;14;185
2004;"CANDIOTA (RS)";"RS";"CANDIOTA";70;14;23;107
2004;"CANELA (RS)";"RS";"CANELA";417;48;97;562
2004;"CANGUCU (RS)";"RS";"CANGUCU";836;16;110;962
2004;"CANOAS (RS)";"RS";"CANOAS";3319;291;836;4446
2004;"CANUDOS DO VALE (RS)";"RS";"CANUDOS DO VALE";16;6;1;23
2004;"CAPAO BONITO DO SUL (RS)";"RS";"CAPAO BONITO DO SUL";24;1;3;28
2004;"CAPAO DA CANOA (RS)";"RS";"CAPAO DA CANOA";327;53;70;450
2004;"CAPAO DO CIPO (RS)";"RS";"CAPAO DO CIPO";42;3;3;48
2004;"CAPAO DO LEAO (RS)";"RS";"CAPAO DO LEAO";200;9;25;234
2004;"CAPELA DE SANTANA (RS)";"RS";"CAPELA DE SANTANA";85;5;21;111
2004;"CAPITAO (RS)";"RS";"CAPITAO";44;8;6;58
2004;"CAPIVARI DO SUL (RS)";"RS";"CAPIVARI DO SUL";82;6;5;93
2004;"CARAA (RS)";"RS";"CARAA";64;1;11;76
2004;"CARAZINHO (RS)";"RS";"CARAZINHO";1198;48;198;1444
2004;"CARLOS BARBOSA (RS)";"RS";"CARLOS BARBOSA";538;39;62;639
2004;"CARLOS GOMES (RS)";"RS";"CARLOS GOMES";23;2;6;31
2004;"CASCA (RS)";"RS";"CASCA";298;10;11;319
2004;"CASEIROS (RS)";"RS";"CASEIROS";105;5;8;118
2004;"CATUIPE (RS)";"RS";"CATUIPE";271;3;19;293
2004;"CAXIAS DO SUL (RS)";"RS";"CAXIAS DO SUL";6345;887;1074;8306
2004;"CENTENARIO (RS)";"RS";"CENTENARIO";75;7;3;85
2004;"CERRITO (RS)";"RS";"CERRITO";80;1;5;86
2004;"CERRO BRANCO (RS)";"RS";"CERRO BRANCO";53;4;12;69
2004;"CERRO GRANDE (RS)";"RS";"CERRO GRANDE";51;0;8;59
2004;"CERRO GRANDE DO SUL (RS)";"RS";"CERRO GRANDE DO SUL";205;9;12;226
2004;"CERRO LARGO (RS)";"RS";"CERRO LARGO";235;7;39;281
2004;"CHAPADA (RS)";"RS";"CHAPADA";249;30;23;302
2004;"CHARQUEADAS (RS)";"RS";"CHARQUEADAS";229;42;48;319
2004;"CHARRUA (RS)";"RS";"CHARRUA";66;2;7;75
2004;"CHIAPETTA (RS)";"RS";"CHIAPETTA";107;4;13;124
2004;"CHUI (RS)";"RS";"CHUI";144;11;11;166
2004;"CHUVISCA (RS)";"RS";"CHUVISCA";90;2;17;109
2004;"CIDREIRA (RS)";"RS";"CIDREIRA";69;9;19;97
2004;"CIRIACO (RS)";"RS";"CIRIACO";102;5;14;121
2004;"COLINAS (RS)";"RS";"COLINAS";52;5;9;66
2004;"COLORADO (RS)";"RS";"COLORADO";185;9;11;205
2004;"CONDOR (RS)";"RS";"CONDOR";174;3;19;196
2004;"CONSTANTINA (RS)";"RS";"CONSTANTINA";223;20;56;299
2004;"COQUEIRO BAIXO (RS)";"RS";"COQUEIRO BAIXO";13;8;2;23
2004;"COQUEIROS DO SUL (RS)";"RS";"COQUEIROS DO SUL";77;2;11;90
2004;"CORONEL BARROS (RS)";"RS";"CORONEL BARROS";67;2;7;76
2004;"CORONEL BICACO (RS)";"RS";"CORONEL BICACO";147;12;10;169
2004;"CORONEL PILAR (RS)";"RS";"CORONEL PILAR";132;3;5;140
2004;"COTIPORA (RS)";"RS";"COTIPORA";127;10;8;145
2004;"COXILHA (RS)";"RS";"COXILHA";85;3;8;96
2004;"CRISSIUMAL (RS)";"RS";"CRISSIUMAL";243;14;35;292
2004;"CRISTAL (RS)";"RS";"CRISTAL";149;2;18;169
2004;"CRISTAL DO SUL (RS)";"RS";"CRISTAL DO SUL";14;1;10;25
2004;"CRUZ ALTA (RS)";"RS";"CRUZ ALTA";1139;43;117;1299
2004;"CRUZALTENSE (RS)";"RS";"CRUZALTENSE";51;1;5;57
2004;"CRUZEIRO DO SUL (RS)";"RS";"CRUZEIRO DO SUL";235;5;11;251
2004;"DAVID CANABARRO (RS)";"RS";"DAVID CANABARRO";133;5;17;155
2004;"DERRUBADAS (RS)";"RS";"DERRUBADAS";59;9;1;69
2004;"DEZESSEIS DE NOVEMBRO (RS)";"RS";"DEZESSEIS DE NOVEMBRO";42;1;4;47
2004;"DILERMANDO DE AGUIAR (RS)";"RS";"DILERMANDO DE AGUIAR";21;1;16;38
2004;"DOIS IRMAOS (RS)";"RS";"DOIS IRMAOS";340;15;95;450
2004;"DOIS IRMAOS DAS MISSOES (RS)";"RS";"DOIS IRMAOS DAS MISSOES";32;1;5;38
2004;"DOIS LAJEADOS (RS)";"RS";"DOIS LAJEADOS";88;2;8;98
2004;"DOM FELICIANO (RS)";"RS";"DOM FELICIANO";190;6;50;246
2004;"DOM PEDRITO (RS)";"RS";"DOM PEDRITO";475;16;28;519
2004;"DOM PEDRO DE ALCANTARA (RS)";"RS";"DOM PEDRO DE ALCANTARA";55;3;5;63
2004;"DONA FRANCISCA (RS)";"RS";"DONA FRANCISCA";35;0;5;40
2004;"DOUTOR MAURICIO CARDOSO (RS)";"RS";"DOUTOR MAURICIO CARDOSO";148;17;20;185
2004;"DOUTOR RICARDO (RS)";"RS";"DOUTOR RICARDO";44;2;7;53
2004;"ELDORADO DO SUL (RS)";"RS";"ELDORADO DO SUL";296;12;25;333
2004;"ENCANTADO (RS)";"RS";"ENCANTADO";465;20;83;568
2004;"ENCRUZILHADA DO SUL (RS)";"RS";"ENCRUZILHADA DO SUL";256;7;74;337
2004;"ENGENHO VELHO (RS)";"RS";"ENGENHO VELHO";21;1;6;28
2004;"ENTRE IJUIS (RS)";"RS";"ENTRE IJUIS";226;11;33;270
2004;"ENTRE RIOS DO SUL (RS)";"RS";"ENTRE RIOS DO SUL";38;9;12;59
2004;"EREBANGO (RS)";"RS";"EREBANGO";95;2;3;100
2004;"ERECHIM (RS)";"RS";"ERECHIM";1439;180;562;2181
2004;"ERNESTINA (RS)";"RS";"ERNESTINA";116;6;13;135
2004;"ERVAL GRANDE (RS)";"RS";"ERVAL GRANDE";79;7;8;94
2004;"ERVAL SECO (RS)";"RS";"ERVAL SECO";118;4;20;142
2004;"ESMERALDA (RS)";"RS";"ESMERALDA";61;2;10;73
2004;"ESPERANCA DO SUL (RS)";"RS";"ESPERANCA DO SUL";35;2;6;43
2004;"ESPUMOSO (RS)";"RS";"ESPUMOSO";495;24;59;578
2004;"ESTACAO (RS)";"RS";"ESTACAO";165;5;5;175
2004;"ESTANCIA VELHA (RS)";"RS";"ESTANCIA VELHA";655;42;118;815
2004;"ESTEIO (RS)";"RS";"ESTEIO";1081;96;215;1392
2004;"ESTRELA (RS)";"RS";"ESTRELA";599;26;80;705
2004;"ESTRELA VELHA (RS)";"RS";"ESTRELA VELHA";76;5;8;89
2004;"EUGENIO DE CASTRO (RS)";"RS";"EUGENIO DE CASTRO";79;5;5;89
2004;"FAGUNDES VARELA (RS)";"RS";"FAGUNDES VARELA";73;7;7;87
2004;"FARROUPILHA (RS)";"RS";"FARROUPILHA";1705;192;164;2061
2004;"FAXINAL DO SOTURNO (RS)";"RS";"FAXINAL DO SOTURNO";108;6;5;119
2004;"FAXINALZINHO (RS)";"RS";"FAXINALZINHO";54;2;6;62
2004;"FAZENDA VILANOVA (RS)";"RS";"FAZENDA VILANOVA";91;9;11;111
2004;"FELIZ (RS)";"RS";"FELIZ";349;24;73;446
2004;"FLORES DA CUNHA (RS)";"RS";"FLORES DA CUNHA";1108;42;88;1238
2004;"FLORIANO PEIXOTO (RS)";"RS";"FLORIANO PEIXOTO";37;5;7;49
2004;"FONTOURA XAVIER (RS)";"RS";"FONTOURA XAVIER";120;8;22;150
2004;"FORMIGUEIRO (RS)";"RS";"FORMIGUEIRO";85;2;13;100
2004;"FORQUETINHA (RS)";"RS";"FORQUETINHA";30;2;2;34
2004;"FORTALEZA DOS VALOS (RS)";"RS";"FORTALEZA DOS VALOS";242;1;13;256
2004;"FREDERICO WESTPHALEN (RS)";"RS";"FREDERICO WESTPHALEN";505;26;58;589
2004;"GARIBALDI (RS)";"RS";"GARIBALDI";1067;59;79;1205
2004;"GARRUCHOS (RS)";"RS";"GARRUCHOS";20;5;10;35
2004;"GAURAMA (RS)";"RS";"GAURAMA";140;6;10;156
2004;"GENERAL CAMARA (RS)";"RS";"GENERAL CAMARA";68;10;10;88
2004;"GENTIL (RS)";"RS";"GENTIL";79;5;11;95
2004;"GETULIO VARGAS (RS)";"RS";"GETULIO VARGAS";422;18;31;471
2004;"GIRUA (RS)";"RS";"GIRUA";426;19;34;479
2004;"GLORINHA (RS)";"RS";"GLORINHA";141;16;10;167
2004;"GRAMADO (RS)";"RS";"GRAMADO";545;79;96;720
2004;"GRAMADO DOS LOUREIROS (RS)";"RS";"GRAMADO DOS LOUREIROS";22;2;8;32
2004;"GRAMADO XAVIER (RS)";"RS";"GRAMADO XAVIER";49;2;9;60
2004;"GRAVATAI (RS)";"RS";"GRAVATAI";2245;285;433;2963
2004;"GUABIJU (RS)";"RS";"GUABIJU";42;4;6;52
2004;"GUAIBA (RS)";"RS";"GUAIBA";872;85;371;1328
2004;"GUAPORE (RS)";"RS";"GUAPORE";311;29;39;379
2004;"GUARANI DAS MISSOES (RS)";"RS";"GUARANI DAS MISSOES";166;4;13;183
2004;"HARMONIA (RS)";"RS";"HARMONIA";172;5;6;183
2004;"HERVAL (RS)";"RS";"HERVAL";71;2;5;78
2004;"HERVEIRAS (RS)";"RS";"HERVEIRAS";40;4;2;46
2004;"HORIZONTINA (RS)";"RS";"HORIZONTINA";275;35;50;360
2004;"HULHA NEGRA (RS)";"RS";"HULHA NEGRA";18;4;9;31
2004;"HUMAITA (RS)";"RS";"HUMAITA";89;5;7;101
2004;"IBARAMA (RS)";"RS";"IBARAMA";68;4;13;85
2004;"IBIACA (RS)";"RS";"IBIACA";220;4;14;238
2004;"IBIRAIARAS (RS)";"RS";"IBIRAIARAS";368;8;21;397
2004;"IBIRAPUITA (RS)";"RS";"IBIRAPUITA";86;4;16;106
2004;"IBIRUBA (RS)";"RS";"IBIRUBA";769;25;51;845
2004;"IGREJINHA (RS)";"RS";"IGREJINHA";285;28;55;368
2004;"IJUI (RS)";"RS";"IJUI";1541;64;121;1726
2004;"ILOPOLIS (RS)";"RS";"ILOPOLIS";111;10;6;127
2004;"IMBE (RS)";"RS";"IMBE";138;13;30;181
2004;"IMIGRANTE (RS)";"RS";"IMIGRANTE";88;13;21;122
2004;"INDEPENDENCIA (RS)";"RS";"INDEPENDENCIA";154;17;30;201
2004;"INHACORA (RS)";"RS";"INHACORA";52;5;4;61
2004;"IPE (RS)";"RS";"IPE";194;17;23;234
2004;"IPIRANGA DO SUL (RS)";"RS";"IPIRANGA DO SUL";80;4;5;89
2004;"IRAI (RS)";"RS";"IRAI";90;15;12;117
2004;"ITAARA (RS)";"RS";"ITAARA";114;2;8;124
2004;"ITACURUBI (RS)";"RS";"ITACURUBI";27;5;6;38
2004;"ITAPUCA (RS)";"RS";"ITAPUCA";29;5;4;38
2004;"ITAQUI (RS)";"RS";"ITAQUI";534;8;43;585
2004;"ITATI (RS)";"RS";"ITATI";51;3;4;58
2004;"ITATIBA DO SUL (RS)";"RS";"ITATIBA DO SUL";59;7;5;71
2004;"IVORA (RS)";"RS";"IVORA";52;4;2;58
2004;"IVOTI (RS)";"RS";"IVOTI";415;35;106;556
2004;"JABOTICABA (RS)";"RS";"JABOTICABA";56;2;13;71
2004;"JACUIZINHO (RS)";"RS";"JACUIZINHO";27;2;3;32
2004;"JACUTINGA (RS)";"RS";"JACUTINGA";94;9;6;109
2004;"JAGUARAO (RS)";"RS";"JAGUARAO";287;10;25;322
2004;"JAGUARI (RS)";"RS";"JAGUARI";177;16;41;234
2004;"JAQUIRANA (RS)";"RS";"JAQUIRANA";133;4;6;143
2004;"JARI (RS)";"RS";"JARI";35;1;10;46
2004;"JOIA (RS)";"RS";"JOIA";253;5;24;282
2004;"JULIO DE CASTILHOS (RS)";"RS";"JULIO DE CASTILHOS";499;12;45;556
2004;"LAGOA BONITA DO SUL (RS)";"RS";"LAGOA BONITA DO SUL";32;0;16;48
2004;"LAGOA DOS TRES CANTOS (RS)";"RS";"LAGOA DOS TRES CANTOS";60;8;7;75
2004;"LAGOA VERMELHA (RS)";"RS";"LAGOA VERMELHA";502;19;71;592
2004;"LAGOAO (RS)";"RS";"LAGOAO";43;1;16;60
2004;"LAJEADO (RS)";"RS";"LAJEADO";1490;89;232;1811
2004;"LAJEADO DO BUGRE (RS)";"RS";"LAJEADO DO BUGRE";18;1;5;24
2004;"LAVRAS DO SUL (RS)";"RS";"LAVRAS DO SUL";56;12;14;82
2004;"LIBERATO SALZANO (RS)";"RS";"LIBERATO SALZANO";88;7;19;114
2004;"LINDOLFO COLLOR (RS)";"RS";"LINDOLFO COLLOR";85;9;11;105
2004;"LINHA NOVA (RS)";"RS";"LINHA NOVA";57;6;5;68
2004;"MACAMBARA (RS)";"RS";"MACAMBARA";22;0;17;39
2004;"MACHADINHO (RS)";"RS";"MACHADINHO";85;2;16;103
2004;"MAMPITUBA (RS)";"RS";"MAMPITUBA";16;0;4;20
2004;"MANOEL VIANA (RS)";"RS";"MANOEL VIANA";113;4;8;125
2004;"MAQUINE (RS)";"RS";"MAQUINE";204;11;10;225
2004;"MARATA (RS)";"RS";"MARATA";73;5;22;100
2004;"MARAU (RS)";"RS";"MARAU";747;54;112;913
2004;"MARCELINO RAMOS (RS)";"RS";"MARCELINO RAMOS";107;17;15;139
2004;"MARIANA PIMENTEL (RS)";"RS";"MARIANA PIMENTEL";85;4;17;106
2004;"MARIANO MORO (RS)";"RS";"MARIANO MORO";58;7;3;68
2004;"MARQUES DE SOUZA (RS)";"RS";"MARQUES DE SOUZA";99;10;16;125
2004;"MATA (RS)";"RS";"MATA";68;4;14;86
2004;"MATO CASTELHANO (RS)";"RS";"MATO CASTELHANO";100;1;9;110
2004;"MATO LEITAO (RS)";"RS";"MATO LEITAO";145;6;10;161
2004;"MATO QUEIMADO (RS)";"RS";"MATO QUEIMADO";28;2;5;35
2004;"MAXIMILIANO DE ALMEIDA (RS)";"RS";"MAXIMILIANO DE ALMEIDA";126;6;50;182
2004;"MINAS DO LEAO (RS)";"RS";"MINAS DO LEAO";76;8;17;101
2004;"MIRAGUAI (RS)";"RS";"MIRAGUAI";49;3;15;67
2004;"MONTAURI (RS)";"RS";"MONTAURI";46;6;2;54
2004;"MONTE ALEGRE DOS CAMPOS (RS)";"RS";"MONTE ALEGRE DOS CAMPOS";47;1;16;64
2004;"MONTE BELO DO SUL (RS)";"RS";"MONTE BELO DO SUL";160;2;10;172
2004;"MONTENEGRO (RS)";"RS";"MONTENEGRO";982;120;183;1285
2004;"MORMACO (RS)";"RS";"MORMACO";52;4;8;64
2004;"MORRINHOS DO SUL (RS)";"RS";"MORRINHOS DO SUL";113;2;4;119
2004;"MORRO REDONDO (RS)";"RS";"MORRO REDONDO";184;4;18;206
2004;"MORRO REUTER (RS)";"RS";"MORRO REUTER";125;7;30;162
2004;"MOSTARDAS (RS)";"RS";"MOSTARDAS";194;7;41;242
2004;"MUCUM (RS)";"RS";"MUCUM";93;10;20;123
2004;"MUITOS CAPOES (RS)";"RS";"MUITOS CAPOES";35;1;3;39
2004;"MULITERNO (RS)";"RS";"MULITERNO";67;3;6;76
2004;"NAO ME TOQUE (RS)";"RS";"NAO ME TOQUE";433;13;42;488
2004;"NICOLAU VERGUEIRO (RS)";"RS";"NICOLAU VERGUEIRO";76;3;9;88
2004;"NONOAI (RS)";"RS";"NONOAI";159;11;31;201
2004;"NOVA ALVORADA (RS)";"RS";"NOVA ALVORADA";94;3;7;104
2004;"NOVA ARACA (RS)";"RS";"NOVA ARACA";140;12;18;170
2004;"NOVA BASSANO (RS)";"RS";"NOVA BASSANO";334;20;23;377
2004;"NOVA BOA VISTA (RS)";"RS";"NOVA BOA VISTA";50;6;7;63
2004;"NOVA BRESCIA (RS)";"RS";"NOVA BRESCIA";77;10;6;93
2004;"NOVA CANDELARIA (RS)";"RS";"NOVA CANDELARIA";52;4;9;65
2004;"NOVA ESPERANCA DO SUL (RS)";"RS";"NOVA ESPERANCA DO SUL";42;9;24;75
2004;"NOVA HARTZ (RS)";"RS";"NOVA HARTZ";98;14;49;161
2004;"NOVA PADUA (RS)";"RS";"NOVA PADUA";233;5;5;243
2004;"NOVA PALMA (RS)";"RS";"NOVA PALMA";179;5;22;206
2004;"NOVA PETROPOLIS (RS)";"RS";"NOVA PETROPOLIS";443;36;71;550
2004;"NOVA PRATA (RS)";"RS";"NOVA PRATA";449;24;36;509
2004;"NOVA RAMADA (RS)";"RS";"NOVA RAMADA";67;2;9;78
2004;"NOVA ROMA DO SUL (RS)";"RS";"NOVA ROMA DO SUL";160;9;16;185
2004;"NOVA SANTA RITA (RS)";"RS";"NOVA SANTA RITA";367;34;35;436
2004;"NOVO BARREIRO (RS)";"RS";"NOVO BARREIRO";70;11;10;91
2004;"NOVO CABRAIS (RS)";"RS";"NOVO CABRAIS";48;2;6;56
2004;"NOVO HAMBURGO (RS)";"RS";"NOVO HAMBURGO";2200;207;450;2857
2004;"NOVO MACHADO (RS)";"RS";"NOVO MACHADO";117;17;5;139
2004;"NOVO TIRADENTES (RS)";"RS";"NOVO TIRADENTES";21;1;7;29
2004;"NOVO XINGU (RS)";"RS";"NOVO XINGU";17;5;8;30
2004;"OSORIO (RS)";"RS";"OSORIO";667;36;113;816
2004;"PAIM FILHO (RS)";"RS";"PAIM FILHO";96;4;11;111
2004;"PALMARES DO SUL (RS)";"RS";"PALMARES DO SUL";149;16;32;197
2004;"PALMEIRA DAS MISSOES (RS)";"RS";"PALMEIRA DAS MISSOES";667;19;52;738
2004;"PALMITINHO (RS)";"RS";"PALMITINHO";111;5;19;135
2004;"PANAMBI (RS)";"RS";"PANAMBI";821;34;93;948
2004;"PANTANO GRANDE (RS)";"RS";"PANTANO GRANDE";255;10;16;281
2004;"PARAI (RS)";"RS";"PARAI";226;11;20;257
2004;"PARAISO DO SUL (RS)";"RS";"PARAISO DO SUL";76;4;7;87
2004;"PARECI NOVO (RS)";"RS";"PARECI NOVO";394;6;24;424
2004;"PAROBE (RS)";"RS";"PAROBE";389;42;118;549
2004;"PASSA SETE (RS)";"RS";"PASSA SETE";47;3;14;64
2004;"PASSO DO SOBRADO (RS)";"RS";"PASSO DO SOBRADO";115;5;35;155
2004;"PASSO FUNDO (RS)";"RS";"PASSO FUNDO";2445;129;306;2880
2004;"PAULO BENTO (RS)";"RS";"PAULO BENTO";48;8;5;61
2004;"PAVERAMA (RS)";"RS";"PAVERAMA";120;17;40;177
2004;"PEDRAS ALTAS (RS)";"RS";"PEDRAS ALTAS";11;3;2;16
2004;"PEDRO OSORIO (RS)";"RS";"PEDRO OSORIO";92;4;19;115
2004;"PEJUCARA (RS)";"RS";"PEJUCARA";201;3;13;217
2004;"PELOTAS (RS)";"RS";"PELOTAS";4249;172;880;5301
2004;"PICADA CAFE (RS)";"RS";"PICADA CAFE";78;12;33;123
2004;"PINHAL (RS)";"RS";"PINHAL";41;1;9;51
2004;"PINHAL DA SERRA (RS)";"RS";"PINHAL DA SERRA";23;3;6;32
2004;"PINHAL GRANDE (RS)";"RS";"PINHAL GRANDE";73;5;12;90
2004;"PINHEIRINHO DO VALE (RS)";"RS";"PINHEIRINHO DO VALE";37;0;12;49
2004;"PINHEIRO MACHADO (RS)";"RS";"PINHEIRO MACHADO";119;8;22;149
2004;"PINTO BANDEIRA (RS)";"RS";"PINTO BANDEIRA";108;3;1;112
2004;"PIRAPO (RS)";"RS";"PIRAPO";22;3;4;29
2004;"PIRATINI (RS)";"RS";"PIRATINI";205;14;73;292
2004;"PLANALTO (RS)";"RS";"PLANALTO";149;7;27;183
2004;"POCO DAS ANTAS (RS)";"RS";"POCO DAS ANTAS";60;7;11;78
2004;"PONTAO (RS)";"RS";"PONTAO";71;2;12;85
2004;"PONTE PRETA (RS)";"RS";"PONTE PRETA";43;7;3;53
2004;"PORTAO (RS)";"RS";"PORTAO";1073;62;83;1218
2004;"PORTO ALEGRE (RS)";"RS";"PORTO ALEGRE";12233;1981;3402;17616
2004;"PORTO LUCENA (RS)";"RS";"PORTO LUCENA";67;6;16;89
2004;"PORTO MAUA (RS)";"RS";"PORTO MAUA";34;6;4;44
2004;"PORTO VERA CRUZ (RS)";"RS";"PORTO VERA CRUZ";7;1;4;12
2004;"PORTO XAVIER (RS)";"RS";"PORTO XAVIER";155;7;24;186
2004;"POUSO NOVO (RS)";"RS";"POUSO NOVO";25;1;5;31
2004;"PRESIDENTE LUCENA (RS)";"RS";"PRESIDENTE LUCENA";83;4;2;89
2004;"PROGRESSO (RS)";"RS";"PROGRESSO";96;8;13;117
2004;"PROTASIO ALVES (RS)";"RS";"PROTASIO ALVES";50;2;5;57
2004;"PUTINGA (RS)";"RS";"PUTINGA";63;4;8;75
2004;"QUARAI (RS)";"RS";"QUARAI";136;9;33;178
2004;"QUATRO IRMAOS (RS)";"RS";"QUATRO IRMAOS";33;9;3;45
2004;"QUEVEDOS (RS)";"RS";"QUEVEDOS";16;0;4;20
2004;"QUINZE DE NOVEMBRO (RS)";"RS";"QUINZE DE NOVEMBRO";153;9;17;179
2004;"REDENTORA (RS)";"RS";"REDENTORA";75;4;15;94
2004;"RELVADO (RS)";"RS";"RELVADO";29;5;2;36
2004;"RESTINGA SECA (RS)";"RS";"RESTINGA SECA";234;5;44;283
2004;"RIO DOS INDIOS (RS)";"RS";"RIO DOS INDIOS";47;2;15;64
2004;"RIO GRANDE (RS)";"RS";"RIO GRANDE";1420;87;349;1856
2004;"RIO PARDO (RS)";"RS";"RIO PARDO";343;16;56;415
2004;"RIOZINHO (RS)";"RS";"RIOZINHO";35;3;24;62
2004;"ROCA SALES (RS)";"RS";"ROCA SALES";135;14;33;182
2004;"RODEIO BONITO (RS)";"RS";"RODEIO BONITO";74;3;26;103
2004;"ROLADOR (RS)";"RS";"ROLADOR";32;2;6;40
2004;"ROLANTE (RS)";"RS";"ROLANTE";151;11;46;208
2004;"RONDA ALTA (RS)";"RS";"RONDA ALTA";220;9;19;248
2004;"RONDINHA (RS)";"RS";"RONDINHA";118;10;19;147
2004;"ROQUE GONZALES (RS)";"RS";"ROQUE GONZALES";97;2;17;116
2004;"ROSARIO DO SUL (RS)";"RS";"ROSARIO DO SUL";377;15;37;429
2004;"SAGRADA FAMILIA (RS)";"RS";"SAGRADA FAMILIA";15;3;5;23
2004;"SALDANHA MARINHO (RS)";"RS";"SALDANHA MARINHO";130;7;10;147
2004;"SALTO DO JACUI (RS)";"RS";"SALTO DO JACUI";168;14;19;201
2004;"SALVADOR DAS MISSOES (RS)";"RS";"SALVADOR DAS MISSOES";69;0;7;76
2004;"SALVADOR DO SUL (RS)";"RS";"SALVADOR DO SUL";197;16;24;237
2004;"SANANDUVA (RS)";"RS";"SANANDUVA";490;8;36;534
2004;"SANTA BARBARA DO SUL (RS)";"RS";"SANTA BARBARA DO SUL";300;10;26;336
2004;"SANTA CECILIA DO SUL (RS)";"RS";"SANTA CECILIA DO SUL";31;3;8;42
2004;"SANTA CLARA DO SUL (RS)";"RS";"SANTA CLARA DO SUL";95;13;7;115
2004;"SANTA CRUZ DO SUL (RS)";"RS";"SANTA CRUZ DO SUL";1399;120;442;1961
2004;"SANTA MARGARIDA DO SUL (RS)";"RS";"SANTA MARGARIDA DO SUL";29;5;2;36
2004;"SANTA MARIA (RS)";"RS";"SANTA MARIA";2425;221;824;3470
2004;"SANTA MARIA DO HERVAL (RS)";"RS";"SANTA MARIA DO HERVAL";144;8;49;201
2004;"SANTA ROSA (RS)";"RS";"SANTA ROSA";1214;72;142;1428
2004;"SANTA TEREZA (RS)";"RS";"SANTA TEREZA";58;5;4;67
2004;"SANTA VITORIA DO PALMAR (RS)";"RS";"SANTA VITORIA DO PALMAR";435;9;63;507
2004;"SANTANA DA BOA VISTA (RS)";"RS";"SANTANA DA BOA VISTA";46;4;23;73
2004;"SANTANA DO LIVRAMENTO (RS)";"RS";"SANTANA DO LIVRAMENTO";622;35;109;766
2004;"SANTIAGO (RS)";"RS";"SANTIAGO";643;34;74;751
2004;"SANTO ANGELO (RS)";"RS";"SANTO ANGELO";967;62;86;1115
2004;"SANTO ANTONIO DA PATRULHA (RS)";"RS";"SANTO ANTONIO DA PATRULHA";640;30;124;794
2004;"SANTO ANTONIO DAS MISSOES (RS)";"RS";"SANTO ANTONIO DAS MISSOES";138;18;17;173
2004;"SANTO ANTONIO DO PALMA (RS)";"RS";"SANTO ANTONIO DO PALMA";35;3;7;45
2004;"SANTO ANTONIO DO PLANALTO (RS)";"RS";"SANTO ANTONIO DO PLANALTO";74;1;5;80
2004;"SANTO AUGUSTO (RS)";"RS";"SANTO AUGUSTO";421;21;21;463
2004;"SANTO CRISTO (RS)";"RS";"SANTO CRISTO";316;17;47;380
2004;"SANTO EXPEDITO DO SUL (RS)";"RS";"SANTO EXPEDITO DO SUL";75;3;7;85
2004;"SAO BORJA (RS)";"RS";"SAO BORJA";919;22;72;1013
2004;"SAO DOMINGOS DO SUL (RS)";"RS";"SAO DOMINGOS DO SUL";70;4;2;76
2004;"SAO FRANCISCO DE ASSIS (RS)";"RS";"SAO FRANCISCO DE ASSIS";219;9;62;290
2004;"SAO FRANCISCO DE PAULA (RS)";"RS";"SAO FRANCISCO DE PAULA";428;22;34;484
2004;"SAO GABRIEL (RS)";"RS";"SAO GABRIEL";716;12;71;799
2004;"SAO JERONIMO (RS)";"RS";"SAO JERONIMO";225;17;98;340
2004;"SAO JOAO DA URTIGA (RS)";"RS";"SAO JOAO DA URTIGA";121;1;14;136
2004;"SAO JOAO DO POLESINE (RS)";"RS";"SAO JOAO DO POLESINE";53;0;5;58
2004;"SAO JORGE (RS)";"RS";"SAO JORGE";122;3;17;142
2004;"SAO JOSE DAS MISSOES (RS)";"RS";"SAO JOSE DAS MISSOES";25;1;6;32
2004;"SAO JOSE DO HERVAL (RS)";"RS";"SAO JOSE DO HERVAL";49;2;10;61
2004;"SAO JOSE DO HORTENCIO (RS)";"RS";"SAO JOSE DO HORTENCIO";179;6;33;218
2004;"SAO JOSE DO INHACORA (RS)";"RS";"SAO JOSE DO INHACORA";31;4;6;41
2004;"SAO JOSE DO NORTE (RS)";"RS";"SAO JOSE DO NORTE";248;3;29;280
2004;"SAO JOSE DO OURO (RS)";"RS";"SAO JOSE DO OURO";231;5;14;250
2004;"SAO JOSE DO SUL (RS)";"RS";"SAO JOSE DO SUL";82;12;2;96
2004;"SAO JOSE DOS AUSENTES (RS)";"RS";"SAO JOSE DOS AUSENTES";55;2;8;65
2004;"SAO LEOPOLDO (RS)";"RS";"SAO LEOPOLDO";1542;175;466;2183
2004;"SAO LOURENCO DO SUL (RS)";"RS";"SAO LOURENCO DO SUL";832;30;96;958
2004;"SAO LUIZ GONZAGA (RS)";"RS";"SAO LUIZ GONZAGA";447;32;63;542
2004;"SAO MARCOS (RS)";"RS";"SAO MARCOS";557;13;74;644
2004;"SAO MARTINHO (RS)";"RS";"SAO MARTINHO";154;7;11;172
2004;"SAO MARTINHO DA SERRA (RS)";"RS";"SAO MARTINHO DA SERRA";29;1;4;34
2004;"SAO MIGUEL DAS MISSOES (RS)";"RS";"SAO MIGUEL DAS MISSOES";161;12;30;203
2004;"SAO NICOLAU (RS)";"RS";"SAO NICOLAU";45;5;7;57
2004;"SAO PAULO DAS MISSOES (RS)";"RS";"SAO PAULO DAS MISSOES";91;3;17;111
2004;"SAO PEDRO DA SERRA (RS)";"RS";"SAO PEDRO DA SERRA";91;4;13;108
2004;"SAO PEDRO DAS MISSOES (RS)";"RS";"SAO PEDRO DAS MISSOES";21;1;4;26
2004;"SAO PEDRO DO BUTIA (RS)";"RS";"SAO PEDRO DO BUTIA";83;2;7;92
2004;"SAO PEDRO DO SUL (RS)";"RS";"SAO PEDRO DO SUL";196;19;34;249
2004;"SAO SEBASTIAO DO CAI (RS)";"RS";"SAO SEBASTIAO DO CAI";612;19;54;685
2004;"SAO SEPE (RS)";"RS";"SAO SEPE";361;5;58;424
2004;"SAO VALENTIM (RS)";"RS";"SAO VALENTIM";53;3;6;62
2004;"SAO VALENTIM DO SUL (RS)";"RS";"SAO VALENTIM DO SUL";60;3;8;71
2004;"SAO VALERIO DO SUL (RS)";"RS";"SAO VALERIO DO SUL";35;3;4;42
2004;"SAO VENDELINO (RS)";"RS";"SAO VENDELINO";71;8;2;81
2004;"SAO VICENTE DO SUL (RS)";"RS";"SAO VICENTE DO SUL";88;4;20;112
2004;"SAPIRANGA (RS)";"RS";"SAPIRANGA";784;97;154;1035
2004;"SAPUCAIA DO SUL (RS)";"RS";"SAPUCAIA DO SUL";1259;139;172;1570
2004;"SARANDI (RS)";"RS";"SARANDI";488;16;48;552
2004;"SEBERI (RS)";"RS";"SEBERI";184;7;26;217
2004;"SEDE NOVA (RS)";"RS";"SEDE NOVA";51;6;10;67
2004;"SEGREDO (RS)";"RS";"SEGREDO";81;5;19;105
2004;"SELBACH (RS)";"RS";"SELBACH";233;6;11;250
2004;"SENADOR SALGADO FILHO (RS)";"RS";"SENADOR SALGADO FILHO";81;4;12;97
2004;"SENTINELA DO SUL (RS)";"RS";"SENTINELA DO SUL";93;3;4;100
2004;"SERAFINA CORREA (RS)";"RS";"SERAFINA CORREA";217;20;30;267
2004;"SERIO (RS)";"RS";"SERIO";53;7;5;65
2004;"SERTAO (RS)";"RS";"SERTAO";206;8;22;236
2004;"SERTAO SANTANA (RS)";"RS";"SERTAO SANTANA";140;9;16;165
2004;"SETE DE SETEMBRO (RS)";"RS";"SETE DE SETEMBRO";48;1;4;53
2004;"SEVERIANO DE ALMEIDA (RS)";"RS";"SEVERIANO DE ALMEIDA";69;6;9;84
2004;"SILVEIRA MARTINS (RS)";"RS";"SILVEIRA MARTINS";97;1;5;103
2004;"SINIMBU (RS)";"RS";"SINIMBU";98;5;4;107
2004;"SOBRADINHO (RS)";"RS";"SOBRADINHO";233;15;46;294
2004;"SOLEDADE (RS)";"RS";"SOLEDADE";407;14;74;495
2004;"TABAI (RS)";"RS";"TABAI";86;7;6;99
2004;"TAPEJARA (RS)";"RS";"TAPEJARA";543;20;46;609
2004;"TAPERA (RS)";"RS";"TAPERA";318;20;25;363
2004;"TAPES (RS)";"RS";"TAPES";250;12;17;279
2004;"TAQUARA (RS)";"RS";"TAQUARA";580;44;213;837
2004;"TAQUARI (RS)";"RS";"TAQUARI";349;34;101;484
2004;"TAQUARUCU DO SUL (RS)";"RS";"TAQUARUCU DO SUL";48;2;7;57
2004;"TAVARES (RS)";"RS";"TAVARES";71;5;7;83
2004;"TENENTE PORTELA (RS)";"RS";"TENENTE PORTELA";222;6;29;257
2004;"TERRA DE AREIA (RS)";"RS";"TERRA DE AREIA";273;16;20;309
2004;"TEUTONIA (RS)";"RS";"TEUTONIA";433;33;59;525
2004;"TIO HUGO (RS)";"RS";"TIO HUGO";51;4;3;58
2004;"TIRADENTES DO SUL (RS)";"RS";"TIRADENTES DO SUL";81;5;6;92
2004;"TOROPI (RS)";"RS";"TOROPI";37;2;13;52
2004;"TORRES (RS)";"RS";"TORRES";318;23;48;389
2004;"TRAMANDAI (RS)";"RS";"TRAMANDAI";455;51;113;619
2004;"TRAVESSEIRO (RS)";"RS";"TRAVESSEIRO";30;4;5;39
2004;"TRES ARROIOS (RS)";"RS";"TRES ARROIOS";59;4;3;66
2004;"TRES CACHOEIRAS (RS)";"RS";"TRES CACHOEIRAS";548;9;9;566
2004;"TRES COROAS (RS)";"RS";"TRES COROAS";168;24;41;233
2004;"TRES DE MAIO (RS)";"RS";"TRES DE MAIO";586;52;70;708
2004;"TRES FORQUILHAS (RS)";"RS";"TRES FORQUILHAS";68;2;2;72
2004;"TRES PALMEIRAS (RS)";"RS";"TRES PALMEIRAS";59;4;11;74
2004;"TRES PASSOS (RS)";"RS";"TRES PASSOS";368;18;102;488
2004;"TRINDADE DO SUL (RS)";"RS";"TRINDADE DO SUL";79;2;12;93
2004;"TRIUNFO (RS)";"RS";"TRIUNFO";316;48;118;482
2004;"TUCUNDUVA (RS)";"RS";"TUCUNDUVA";196;10;15;221
2004;"TUNAS (RS)";"RS";"TUNAS";29;2;11;42
2004;"TUPANCI DO SUL (RS)";"RS";"TUPANCI DO SUL";49;2;7;58
2004;"TUPANCIRETA (RS)";"RS";"TUPANCIRETA";454;22;37;513
2004;"TUPANDI (RS)";"RS";"TUPANDI";55;11;21;87
2004;"TUPARENDI (RS)";"RS";"TUPARENDI";175;10;20;205
2004;"TURUCU (RS)";"RS";"TURUCU";67;4;5;76
2004;"UBIRETAMA (RS)";"RS";"UBIRETAMA";58;1;4;63
2004;"UNIAO DA SERRA (RS)";"RS";"UNIAO DA SERRA";42;2;9;53
2004;"UNISTALDA (RS)";"RS";"UNISTALDA";19;1;8;28
2004;"URUGUAIANA (RS)";"RS";"URUGUAIANA";1520;58;137;1715
2004;"VACARIA (RS)";"RS";"VACARIA";1355;76;291;1722
2004;"VALE DO SOL (RS)";"RS";"VALE DO SOL";156;5;22;183
2004;"VALE REAL (RS)";"RS";"VALE REAL";210;10;18;238
2004;"VALE VERDE (RS)";"RS";"VALE VERDE";31;2;4;37
2004;"VANINI (RS)";"RS";"VANINI";63;9;9;81
2004;"VENANCIO AIRES (RS)";"RS";"VENANCIO AIRES";927;44;162;1133
2004;"VERA CRUZ (RS)";"RS";"VERA CRUZ";275;11;60;346
2004;"VERANOPOLIS (RS)";"RS";"VERANOPOLIS";766;25;67;858
2004;"VESPASIANO CORREA (RS)";"RS";"VESPASIANO CORREA";55;3;12;70
2004;"VIADUTOS (RS)";"RS";"VIADUTOS";110;8;12;130
2004;"VIAMAO (RS)";"RS";"VIAMAO";1380;175;441;1996
2004;"VICENTE DUTRA (RS)";"RS";"VICENTE DUTRA";37;2;11;50
2004;"VICTOR GRAEFF (RS)";"RS";"VICTOR GRAEFF";138;16;4;158
2004;"VILA FLORES (RS)";"RS";"VILA FLORES";147;17;9;173
2004;"VILA LANGARO (RS)";"RS";"VILA LANGARO";66;5;10;81
2004;"VILA MARIA (RS)";"RS";"VILA MARIA";185;6;28;219
2004;"VILA NOVA DO SUL (RS)";"RS";"VILA NOVA DO SUL";60;1;7;68
2004;"VISTA ALEGRE (RS)";"RS";"VISTA ALEGRE";42;0;11;53
2004;"VISTA ALEGRE DO PRATA (RS)";"RS";"VISTA ALEGRE DO PRATA";25;6;3;34
2004;"VISTA GAUCHA (RS)";"RS";"VISTA GAUCHA";39;0;9;48
2004;"VITORIA DAS MISSOES (RS)";"RS";"VITORIA DAS MISSOES";73;2;10;85
2004;"WESTFALIA (RS)";"RS";"WESTFALIA";78;15;7;100
2004;"XANGRI LA (RS)";"RS";"XANGRI LA";105;6;4;115
2004;"ABDON BATISTA (SC)";"SC";"ABDON BATISTA";35;2;6;43
2004;"ABELARDO LUZ (SC)";"SC";"ABELARDO LUZ";291;8;36;335
2004;"AGROLANDIA (SC)";"SC";"AGROLANDIA";171;10;12;193
2004;"AGRONOMICA (SC)";"SC";"AGRONOMICA";114;1;9;124
2004;"AGUA DOCE (SC)";"SC";"AGUA DOCE";135;7;11;153
2004;"AGUAS DE CHAPECO (SC)";"SC";"AGUAS DE CHAPECO";60;4;11;75
2004;"AGUAS FRIAS (SC)";"SC";"AGUAS FRIAS";25;0;6;31
2004;"AGUAS MORNAS (SC)";"SC";"AGUAS MORNAS";174;2;7;183
2004;"ALFREDO WAGNER (SC)";"SC";"ALFREDO WAGNER";187;11;8;206
2004;"ALTO BELA VISTA (SC)";"SC";"ALTO BELA VISTA";38;6;5;49
2004;"ANCHIETA (SC)";"SC";"ANCHIETA";114;7;12;133
2004;"ANGELINA (SC)";"SC";"ANGELINA";132;9;5;146
2004;"ANITA GARIBALDI (SC)";"SC";"ANITA GARIBALDI";98;7;16;121
2004;"ANITAPOLIS (SC)";"SC";"ANITAPOLIS";62;4;7;73
2004;"ANTONIO CARLOS (SC)";"SC";"ANTONIO CARLOS";431;3;6;440
2004;"APIUNA (SC)";"SC";"APIUNA";122;9;11;142
2004;"ARABUTA (SC)";"SC";"ARABUTA";67;5;19;91
2004;"ARAQUARI (SC)";"SC";"ARAQUARI";221;7;13;241
2004;"ARARANGUA (SC)";"SC";"ARARANGUA";1054;37;139;1230
2004;"ARMAZEM (SC)";"SC";"ARMAZEM";189;9;5;203
2004;"ARROIO TRINTA (SC)";"SC";"ARROIO TRINTA";117;5;6;128
2004;"ARVOREDO (SC)";"SC";"ARVOREDO";24;4;5;33
2004;"ASCURRA (SC)";"SC";"ASCURRA";152;10;20;182
2004;"ATALANTA (SC)";"SC";"ATALANTA";68;2;4;74
2004;"AURORA (SC)";"SC";"AURORA";120;4;4;128
2004;"BALNEARIO ARROIO DO SILVA (SC)";"SC";"BALNEARIO ARROIO DO SILVA";51;8;7;66
2004;"BALNEARIO CAMBORIU (SC)";"SC";"BALNEARIO CAMBORIU";660;145;139;944
2004;"BALNEARIO GAIVOTA (SC)";"SC";"BALNEARIO GAIVOTA";100;3;7;110
2004;"BANDEIRANTE (SC)";"SC";"BANDEIRANTE";15;1;12;28
2004;"BARRA BONITA (SC)";"SC";"BARRA BONITA";24;0;9;33
2004;"BARRA DO SUL (SC)";"SC";"BARRA DO SUL";54;3;1;58
2004;"BARRA VELHA (SC)";"SC";"BARRA VELHA";205;14;14;233
2004;"BELA VISTA DO TOLDO (SC)";"SC";"BELA VISTA DO TOLDO";60;2;7;69
2004;"BELMONTE (SC)";"SC";"BELMONTE";44;1;3;48
2004;"BENEDITO NOVO (SC)";"SC";"BENEDITO NOVO";214;16;15;245
2004;"BIGUACU (SC)";"SC";"BIGUACU";605;41;166;812
2004;"BLUMENAU (SC)";"SC";"BLUMENAU";3609;309;785;4703
2004;"BOCAINA DO SUL (SC)";"SC";"BOCAINA DO SUL";32;6;11;49
2004;"BOM JARDIM DA SERRA (SC)";"SC";"BOM JARDIM DA SERRA";70;1;13;84
2004;"BOM JESUS (SC)";"SC";"BOM JESUS";42;0;6;48
2004;"BOM JESUS DO OESTE (SC)";"SC";"BOM JESUS DO OESTE";31;3;8;42
2004;"BOM RETIRO (SC)";"SC";"BOM RETIRO";130;9;11;150
2004;"BOMBINHAS (SC)";"SC";"BOMBINHAS";77;12;13;102
2004;"BOTUVERA (SC)";"SC";"BOTUVERA";134;2;8;144
2004;"BRACO DO NORTE (SC)";"SC";"BRACO DO NORTE";704;38;42;784
2004;"BRACO DO TROMBUDO (SC)";"SC";"BRACO DO TROMBUDO";92;5;5;102
2004;"BRUNOPOLIS (SC)";"SC";"BRUNOPOLIS";44;2;6;52
2004;"BRUSQUE (SC)";"SC";"BRUSQUE";1445;68;140;1653
2004;"CACADOR (SC)";"SC";"CACADOR";1604;75;741;2420
2004;"CAIBI (SC)";"SC";"CAIBI";135;5;16;156
2004;"CALMON (SC)";"SC";"CALMON";32;4;18;54
2004;"CAMBORIU (SC)";"SC";"CAMBORIU";583;25;32;640
2004;"CAMPO ALEGRE (SC)";"SC";"CAMPO ALEGRE";286;11;7;304
2004;"CAMPO BELO DO SUL (SC)";"SC";"CAMPO BELO DO SUL";154;4;12;170
2004;"CAMPO ERE (SC)";"SC";"CAMPO ERE";198;8;23;229
2004;"CAMPOS NOVOS (SC)";"SC";"CAMPOS NOVOS";753;28;89;870
2004;"CANELINHA (SC)";"SC";"CANELINHA";362;6;3;371
2004;"CANOINHAS (SC)";"SC";"CANOINHAS";999;40;105;1144
2004;"CAPAO ALTO (SC)";"SC";"CAPAO ALTO";27;3;5;35
2004;"CAPINZAL (SC)";"SC";"CAPINZAL";340;16;24;380
2004;"CAPIVARI DE BAIXO (SC)";"SC";"CAPIVARI DE BAIXO";215;11;23;249
2004;"CATANDUVAS (SC)";"SC";"CATANDUVAS";248;11;20;279
2004;"CAXAMBU DO SUL (SC)";"SC";"CAXAMBU DO SUL";69;3;10;82
2004;"CELSO RAMOS (SC)";"SC";"CELSO RAMOS";34;4;3;41
2004;"CERRO NEGRO (SC)";"SC";"CERRO NEGRO";23;2;11;36
2004;"CHAPADAO DO LAGEADO (SC)";"SC";"CHAPADAO DO LAGEADO";32;0;4;36
2004;"CHAPECO (SC)";"SC";"CHAPECO";2691;111;232;3034
2004;"COCAL DO SUL (SC)";"SC";"COCAL DO SUL";199;9;9;217
2004;"CONCORDIA (SC)";"SC";"CONCORDIA";1457;84;150;1691
2004;"CORDILHEIRA ALTA (SC)";"SC";"CORDILHEIRA ALTA";151;6;5;162
2004;"CORONEL FREITAS (SC)";"SC";"CORONEL FREITAS";216;6;23;245
2004;"CORONEL MARTINS (SC)";"SC";"CORONEL MARTINS";31;4;6;41
2004;"CORREIA PINTO (SC)";"SC";"CORREIA PINTO";276;13;41;330
2004;"CORUPA (SC)";"SC";"CORUPA";307;8;25;340
2004;"CRICIUMA (SC)";"SC";"CRICIUMA";2897;257;326;3480
2004;"CUNHA PORA (SC)";"SC";"CUNHA PORA";261;11;37;309
2004;"CUNHATAI (SC)";"SC";"CUNHATAI";15;2;5;22
2004;"CURITIBANOS (SC)";"SC";"CURITIBANOS";812;24;75;911
2004;"DESCANSO (SC)";"SC";"DESCANSO";167;8;20;195
2004;"DIONISIO CERQUEIRA (SC)";"SC";"DIONISIO CERQUEIRA";101;7;16;124
2004;"DONA EMMA (SC)";"SC";"DONA EMMA";62;4;6;72
2004;"DOUTOR PEDRINHO (SC)";"SC";"DOUTOR PEDRINHO";88;4;6;98
2004;"ENTRE RIOS (SC)";"SC";"ENTRE RIOS";22;2;5;29
2004;"ERMO (SC)";"SC";"ERMO";52;0;3;55
2004;"ERVAL VELHO (SC)";"SC";"ERVAL VELHO";86;2;17;105
2004;"FAXINAL DOS GUEDES (SC)";"SC";"FAXINAL DOS GUEDES";291;10;20;321
2004;"FLOR DO SERTAO (SC)";"SC";"FLOR DO SERTAO";19;4;6;29
2004;"FLORIANOPOLIS (SC)";"SC";"FLORIANOPOLIS";3038;820;1174;5032
2004;"FORMOSA DO SUL (SC)";"SC";"FORMOSA DO SUL";45;3;13;61
2004;"FORQUILHINHA (SC)";"SC";"FORQUILHINHA";398;6;28;432
2004;"FRAIBURGO (SC)";"SC";"FRAIBURGO";682;34;154;870
2004;"FREI ROGERIO (SC)";"SC";"FREI ROGERIO";55;1;12;68
2004;"GALVAO (SC)";"SC";"GALVAO";68;3;6;77
2004;"GAROPABA (SC)";"SC";"GAROPABA";137;17;27;181
2004;"GARUVA (SC)";"SC";"GARUVA";240;13;10;263
2004;"GASPAR (SC)";"SC";"GASPAR";950;45;64;1059
2004;"GOVERNADOR CELSO RAMOS (SC)";"SC";"GOVERNADOR CELSO RAMOS";99;15;8;122
2004;"GRAO PARA (SC)";"SC";"GRAO PARA";171;5;6;182
2004;"GRAVATAL (SC)";"SC";"GRAVATAL";163;4;10;177
2004;"GUABIRUBA (SC)";"SC";"GUABIRUBA";197;8;10;215
2004;"GUARACIABA (SC)";"SC";"GUARACIABA";161;5;26;192
2004;"GUARAMIRIM (SC)";"SC";"GUARAMIRIM";678;19;13;710
2004;"GUARUJA DO SUL (SC)";"SC";"GUARUJA DO SUL";133;8;10;151
2004;"GUATAMBU (SC)";"SC";"GUATAMBU";54;2;17;73
2004;"HERVAL D OESTE (SC)";"SC";"HERVAL D OESTE";225;26;47;298
2004;"IBIAM (SC)";"SC";"IBIAM";40;1;7;48
2004;"IBICARE (SC)";"SC";"IBICARE";90;4;4;98
2004;"IBIRAMA (SC)";"SC";"IBIRAMA";271;19;45;335
2004;"ICARA (SC)";"SC";"ICARA";916;37;84;1037
2004;"ILHOTA (SC)";"SC";"ILHOTA";197;15;10;222
2004;"IMARUI (SC)";"SC";"IMARUI";77;8;18;103
2004;"IMBITUBA (SC)";"SC";"IMBITUBA";422;49;52;523
2004;"IMBUIA (SC)";"SC";"IMBUIA";126;3;14;143
2004;"INDAIAL (SC)";"SC";"INDAIAL";857;33;59;949
2004;"IOMERE (SC)";"SC";"IOMERE";107;6;4;117
2004;"IPIRA (SC)";"SC";"IPIRA";65;5;13;83
2004;"IPORA DO OESTE (SC)";"SC";"IPORA DO OESTE";161;3;26;190
2004;"IPUACU (SC)";"SC";"IPUACU";69;4;16;89
2004;"IPUMIRIM (SC)";"SC";"IPUMIRIM";172;3;13;188
2004;"IRACEMINHA (SC)";"SC";"IRACEMINHA";72;4;16;92
2004;"IRANI (SC)";"SC";"IRANI";185;9;34;228
2004;"IRATI (SC)";"SC";"IRATI";23;5;3;31
2004;"IRINEOPOLIS (SC)";"SC";"IRINEOPOLIS";177;2;9;188
2004;"ITA (SC)";"SC";"ITA";68;11;20;99
2004;"ITAIOPOLIS (SC)";"SC";"ITAIOPOLIS";394;8;38;440
2004;"ITAJAI (SC)";"SC";"ITAJAI";2930;251;239;3420
2004;"ITAPEMA (SC)";"SC";"ITAPEMA";306;39;32;377
2004;"ITAPIRANGA (SC)";"SC";"ITAPIRANGA";188;13;41;242
2004;"ITAPOA (SC)";"SC";"ITAPOA";98;6;4;108
2004;"ITUPORANGA (SC)";"SC";"ITUPORANGA";484;11;37;532
2004;"JABORA (SC)";"SC";"JABORA";94;4;12;110
2004;"JACINTO MACHADO (SC)";"SC";"JACINTO MACHADO";310;4;18;332
2004;"JAGUARUNA (SC)";"SC";"JAGUARUNA";332;8;20;360
2004;"JARAGUA DO SUL (SC)";"SC";"JARAGUA DO SUL";1820;148;234;2202
2004;"JARDINOPOLIS (SC)";"SC";"JARDINOPOLIS";21;3;3;27
2004;"JOACABA (SC)";"SC";"JOACABA";613;39;26;678
2004;"JOINVILLE (SC)";"SC";"JOINVILLE";5977;553;704;7234
2004;"JOSE BOITEUX (SC)";"SC";"JOSE BOITEUX";72;5;7;84
2004;"JUPIA (SC)";"SC";"JUPIA";33;3;5;41
2004;"LACERDOPOLIS (SC)";"SC";"LACERDOPOLIS";91;6;4;101
2004;"LAGEADO GRANDE (SC)";"SC";"LAGEADO GRANDE";29;3;5;37
2004;"LAGES (SC)";"SC";"LAGES";2843;140;245;3228
2004;"LAGUNA (SC)";"SC";"LAGUNA";367;35;66;468
2004;"LAURENTINO (SC)";"SC";"LAURENTINO";199;4;6;209
2004;"LAURO MULLER (SC)";"SC";"LAURO MULLER";273;12;20;305
2004;"LEBON REGIS (SC)";"SC";"LEBON REGIS";156;3;32;191
2004;"LEOBERTO LEAL (SC)";"SC";"LEOBERTO LEAL";92;5;6;103
2004;"LINDOIA DO SUL (SC)";"SC";"LINDOIA DO SUL";97;8;35;140
2004;"LONTRAS (SC)";"SC";"LONTRAS";194;9;7;210
2004;"LUIZ ALVES (SC)";"SC";"LUIZ ALVES";302;5;12;319
2004;"LUZERNA (SC)";"SC";"LUZERNA";81;6;13;100
2004;"MACIEIRA (SC)";"SC";"MACIEIRA";45;1;8;54
2004;"MAFRA (SC)";"SC";"MAFRA";957;49;102;1108
2004;"MAJOR GERCINO (SC)";"SC";"MAJOR GERCINO";93;5;4;102
2004;"MAJOR VIEIRA (SC)";"SC";"MAJOR VIEIRA";119;5;8;132
2004;"MARACAJA (SC)";"SC";"MARACAJA";154;3;6;163
2004;"MARAVILHA (SC)";"SC";"MARAVILHA";410;18;42;470
2004;"MAREMA (SC)";"SC";"MAREMA";51;5;4;60
2004;"MASSARANDUBA (SC)";"SC";"MASSARANDUBA";349;12;21;382
2004;"MATOS COSTA (SC)";"SC";"MATOS COSTA";27;2;7;36
2004;"MELEIRO (SC)";"SC";"MELEIRO";167;1;13;181
2004;"MIRIM DOCE (SC)";"SC";"MIRIM DOCE";42;1;6;49
2004;"MODELO (SC)";"SC";"MODELO";68;2;4;74
2004;"MONDAI (SC)";"SC";"MONDAI";130;2;28;160
2004;"MONTE CARLO (SC)";"SC";"MONTE CARLO";174;7;52;233
2004;"MONTE CASTELO (SC)";"SC";"MONTE CASTELO";134;7;12;153
2004;"MORRO DA FUMACA (SC)";"SC";"MORRO DA FUMACA";622;24;27;673
2004;"MORRO GRANDE (SC)";"SC";"MORRO GRANDE";78;0;6;84
2004;"NAVEGANTES (SC)";"SC";"NAVEGANTES";400;35;30;465
2004;"NOVA ERECHIM (SC)";"SC";"NOVA ERECHIM";64;2;9;75
2004;"NOVA ITABERABA (SC)";"SC";"NOVA ITABERABA";47;2;11;60
2004;"NOVA TRENTO (SC)";"SC";"NOVA TRENTO";153;13;23;189
2004;"NOVA VENEZA (SC)";"SC";"NOVA VENEZA";317;23;12;352
2004;"NOVO HORIZONTE (SC)";"SC";"NOVO HORIZONTE";53;6;8;67
2004;"ORLEANS (SC)";"SC";"ORLEANS";682;6;40;728
2004;"OTACILIO COSTA (SC)";"SC";"OTACILIO COSTA";313;24;24;361
2004;"OURO (SC)";"SC";"OURO";170;12;19;201
2004;"OURO VERDE (SC)";"SC";"OURO VERDE";66;2;4;72
2004;"PAIAL (SC)";"SC";"PAIAL";10;4;7;21
2004;"PAINEL (SC)";"SC";"PAINEL";19;2;6;27
2004;"PALHOCA (SC)";"SC";"PALHOCA";1218;83;231;1532
2004;"PALMA SOLA (SC)";"SC";"PALMA SOLA";150;5;17;172
2004;"PALMEIRA (SC)";"SC";"PALMEIRA";42;5;1;48
2004;"PALMITOS (SC)";"SC";"PALMITOS";247;11;46;304
2004;"PAPANDUVA (SC)";"SC";"PAPANDUVA";394;7;42;443
2004;"PARAISO (SC)";"SC";"PARAISO";50;0;4;54
2004;"PASSO DE TORRES (SC)";"SC";"PASSO DE TORRES";88;5;12;105
2004;"PASSOS MAIA (SC)";"SC";"PASSOS MAIA";74;1;17;92
2004;"PAULO LOPES (SC)";"SC";"PAULO LOPES";149;8;9;166
2004;"PEDRAS GRANDES (SC)";"SC";"PEDRAS GRANDES";190;8;5;203
2004;"PENHA (SC)";"SC";"PENHA";208;7;24;239
2004;"PERITIBA (SC)";"SC";"PERITIBA";63;3;9;75
2004;"PETROLANDIA (SC)";"SC";"PETROLANDIA";138;5;17;160
2004;"PICARRAS (SC)";"SC";"PICARRAS";179;12;13;204
2004;"PINHALZINHO (SC)";"SC";"PINHALZINHO";301;9;32;342
2004;"PINHEIRO PRETO (SC)";"SC";"PINHEIRO PRETO";211;7;4;222
2004;"PIRATUBA (SC)";"SC";"PIRATUBA";58;8;12;78
2004;"PLANALTO ALEGRE (SC)";"SC";"PLANALTO ALEGRE";45;3;3;51
2004;"POMERODE (SC)";"SC";"POMERODE";403;20;82;505
2004;"PONTE ALTA (SC)";"SC";"PONTE ALTA";86;3;9;98
2004;"PONTE ALTA DO NORTE (SC)";"SC";"PONTE ALTA DO NORTE";53;1;5;59
2004;"PONTE SERRADA (SC)";"SC";"PONTE SERRADA";246;13;33;292
2004;"PORTO BELO (SC)";"SC";"PORTO BELO";125;12;13;150
2004;"PORTO UNIAO (SC)";"SC";"PORTO UNIAO";454;13;33;500
2004;"POUSO REDONDO (SC)";"SC";"POUSO REDONDO";288;12;22;322
2004;"PRAIA GRANDE (SC)";"SC";"PRAIA GRANDE";161;8;20;189
2004;"PRESIDENTE CASTELO BRANCO (SC)";"SC";"PRESIDENTE CASTELO BRANCO";36;3;6;45
2004;"PRESIDENTE GETULIO (SC)";"SC";"PRESIDENTE GETULIO";212;14;55;281
2004;"PRESIDENTE NEREU (SC)";"SC";"PRESIDENTE NEREU";18;3;4;25
2004;"PRINCESA (SC)";"SC";"PRINCESA";31;2;7;40
2004;"QUILOMBO (SC)";"SC";"QUILOMBO";149;7;28;184
2004;"RANCHO QUEIMADO (SC)";"SC";"RANCHO QUEIMADO";105;4;5;114
2004;"RIO DAS ANTAS (SC)";"SC";"RIO DAS ANTAS";156;6;18;180
2004;"RIO DO CAMPO (SC)";"SC";"RIO DO CAMPO";122;6;14;142
2004;"RIO DO OESTE (SC)";"SC";"RIO DO OESTE";145;10;13;168
2004;"RIO DO SUL (SC)";"SC";"RIO DO SUL";1119;44;112;1275
2004;"RIO DOS CEDROS (SC)";"SC";"RIO DOS CEDROS";193;13;25;231
2004;"RIO FORTUNA (SC)";"SC";"RIO FORTUNA";183;6;9;198
2004;"RIO NEGRINHO (SC)";"SC";"RIO NEGRINHO";742;45;54;841
2004;"RIO RUFINO (SC)";"SC";"RIO RUFINO";22;3;8;33
2004;"RIQUEZA (SC)";"SC";"RIQUEZA";71;1;16;88
2004;"RODEIO (SC)";"SC";"RODEIO";153;4;13;170
2004;"ROMELANDIA (SC)";"SC";"ROMELANDIA";72;2;15;89
2004;"SALETE (SC)";"SC";"SALETE";134;6;12;152
2004;"SALTINHO (SC)";"SC";"SALTINHO";36;2;13;51
2004;"SALTO VELOSO (SC)";"SC";"SALTO VELOSO";89;2;4;95
2004;"SANGAO (SC)";"SC";"SANGAO";307;4;11;322
2004;"SANTA CECILIA (SC)";"SC";"SANTA CECILIA";319;11;29;359
2004;"SANTA HELENA (SC)";"SC";"SANTA HELENA";44;6;5;55
2004;"SANTA ROSA DE LIMA (SC)";"SC";"SANTA ROSA DE LIMA";72;3;6;81
2004;"SANTA ROSA DO SUL (SC)";"SC";"SANTA ROSA DO SUL";211;8;11;230
2004;"SANTA TEREZINHA (SC)";"SC";"SANTA TEREZINHA";107;4;17;128
2004;"SANTA TEREZINHA DO PROGRESSO (SC)";"SC";"SANTA TEREZINHA DO PROGRESSO";38;4;9;51
2004;"SANTIAGO DO SUL (SC)";"SC";"SANTIAGO DO SUL";31;2;4;37
2004;"SANTO AMARO DA IMPERATRIZ (SC)";"SC";"SANTO AMARO DA IMPERATRIZ";417;17;59;493
2004;"SAO BENTO DO SUL (SC)";"SC";"SAO BENTO DO SUL";1074;92;124;1290
2004;"SAO BERNARDINO (SC)";"SC";"SAO BERNARDINO";29;0;14;43
2004;"SAO BONIFACIO (SC)";"SC";"SAO BONIFACIO";88;3;8;99
2004;"SAO CARLOS (SC)";"SC";"SAO CARLOS";138;8;33;179
2004;"SAO CRISTOVAO DO SUL (SC)";"SC";"SAO CRISTOVAO DO SUL";98;2;7;107
2004;"SAO DOMINGOS (SC)";"SC";"SAO DOMINGOS";243;7;26;276
2004;"SAO FRANCISCO DO SUL (SC)";"SC";"SAO FRANCISCO DO SUL";432;29;52;513
2004;"SAO JOAO BATISTA (SC)";"SC";"SAO JOAO BATISTA";333;11;20;364
2004;"SAO JOAO DO ITAPERIU (SC)";"SC";"SAO JOAO DO ITAPERIU";124;0;5;129
2004;"SAO JOAO DO OESTE (SC)";"SC";"SAO JOAO DO OESTE";107;4;6;117
2004;"SAO JOAO DO SUL (SC)";"SC";"SAO JOAO DO SUL";172;5;6;183
2004;"SAO JOAQUIM (SC)";"SC";"SAO JOAQUIM";609;28;141;778
2004;"SAO JOSE (SC)";"SC";"SAO JOSE";2778;215;156;3149
2004;"SAO JOSE DO CEDRO (SC)";"SC";"SAO JOSE DO CEDRO";284;8;108;400
2004;"SAO JOSE DO CERRITO (SC)";"SC";"SAO JOSE DO CERRITO";102;2;24;128
2004;"SAO LOURENCO D OESTE (SC)";"SC";"SAO LOURENCO D OESTE";622;18;51;691
2004;"SAO LUDGERO (SC)";"SC";"SAO LUDGERO";411;4;15;430
2004;"SAO MARTINHO (SC)";"SC";"SAO MARTINHO";104;7;6;117
2004;"SAO MIGUEL D OESTE (SC)";"SC";"SAO MIGUEL D OESTE";721;23;84;828
2004;"SAO MIGUEL DA BOA VISTA (SC)";"SC";"SAO MIGUEL DA BOA VISTA";15;3;6;24
2004;"SAO PEDRO DE ALCANTARA (SC)";"SC";"SAO PEDRO DE ALCANTARA";93;4;4;101
2004;"SAUDADES (SC)";"SC";"SAUDADES";123;5;28;156
2004;"SCHROEDER (SC)";"SC";"SCHROEDER";141;4;21;166
2004;"SEARA (SC)";"SC";"SEARA";276;14;51;341
2004;"SERRA ALTA (SC)";"SC";"SERRA ALTA";40;4;7;51
2004;"SIDEROPOLIS (SC)";"SC";"SIDEROPOLIS";294;11;43;348
2004;"SOMBRIO (SC)";"SC";"SOMBRIO";621;19;27;667
2004;"SUL BRASIL (SC)";"SC";"SUL BRASIL";28;3;9;40
2004;"TAIO (SC)";"SC";"TAIO";394;11;28;433
2004;"TANGARA (SC)";"SC";"TANGARA";295;4;25;324
2004;"TIGRINHOS (SC)";"SC";"TIGRINHOS";14;0;12;26
2004;"TIJUCAS (SC)";"SC";"TIJUCAS";571;34;32;637
2004;"TIMBE DO SUL (SC)";"SC";"TIMBE DO SUL";135;3;6;144
2004;"TIMBO (SC)";"SC";"TIMBO";494;44;37;575
2004;"TIMBO GRANDE (SC)";"SC";"TIMBO GRANDE";105;2;6;113
2004;"TRES BARRAS (SC)";"SC";"TRES BARRAS";221;7;35;263
2004;"TREVISO (SC)";"SC";"TREVISO";59;3;5;67
2004;"TREZE DE MAIO (SC)";"SC";"TREZE DE MAIO";324;6;13;343
2004;"TREZE TILIAS (SC)";"SC";"TREZE TILIAS";185;9;13;207
2004;"TROMBUDO CENTRAL (SC)";"SC";"TROMBUDO CENTRAL";180;8;5;193
2004;"TUBARAO (SC)";"SC";"TUBARAO";1863;70;346;2279
2004;"TUNAPOLIS (SC)";"SC";"TUNAPOLIS";63;6;12;81
2004;"TURVO (SC)";"SC";"TURVO";287;5;23;315
2004;"UNIAO DO OESTE (SC)";"SC";"UNIAO DO OESTE";43;1;9;53
2004;"URUBICI (SC)";"SC";"URUBICI";177;8;25;210
2004;"URUPEMA (SC)";"SC";"URUPEMA";36;4;6;46
2004;"URUSSANGA (SC)";"SC";"URUSSANGA";309;25;77;411
2004;"VARGEAO (SC)";"SC";"VARGEAO";100;2;4;106
2004;"VARGEM (SC)";"SC";"VARGEM";34;4;4;42
2004;"VARGEM BONITA (SC)";"SC";"VARGEM BONITA";129;11;21;161
2004;"VIDAL RAMOS (SC)";"SC";"VIDAL RAMOS";110;8;6;124
2004;"VIDEIRA (SC)";"SC";"VIDEIRA";1142;73;90;1305
2004;"VITOR MEIRELES (SC)";"SC";"VITOR MEIRELES";68;5;10;83
2004;"WITMARSUM (SC)";"SC";"WITMARSUM";63;1;6;70
2004;"XANXERE (SC)";"SC";"XANXERE";948;58;83;1089
2004;"XAVANTINA (SC)";"SC";"XAVANTINA";111;11;5;127
2004;"XAXIM (SC)";"SC";"XAXIM";549;19;77;645
2004;"ZORTEA (SC)";"SC";"ZORTEA";28;5;4;37
2004;"AMPARO DE SAO FRANCISCO (SE)";"SE";"AMPARO DE SAO FRANCISCO";3;3;1;7
2004;"AQUIDABA (SE)";"SE";"AQUIDABA";103;5;23;131
2004;"ARACAJU (SE)";"SE";"ARACAJU";4004;614;1376;5994
2004;"ARAUA (SE)";"SE";"ARAUA";43;9;12;64
2004;"AREIA BRANCA (SE)";"SE";"AREIA BRANCA";109;9;8;126
2004;"BARRA DOS COQUEIROS (SE)";"SE";"BARRA DOS COQUEIROS";26;5;10;41
2004;"BOQUIM (SE)";"SE";"BOQUIM";189;9;17;215
2004;"BREJO GRANDE (SE)";"SE";"BREJO GRANDE";5;3;5;13
2004;"CAMPO DO BRITO (SE)";"SE";"CAMPO DO BRITO";237;16;20;273
2004;"CANHOBA (SE)";"SE";"CANHOBA";3;3;2;8
2004;"CANINDE DE SAO FRANCISCO (SE)";"SE";"CANINDE DE SAO FRANCISCO";92;15;10;117
2004;"CAPELA (SE)";"SE";"CAPELA";53;16;22;91
2004;"CARIRA (SE)";"SE";"CARIRA";162;37;31;230
2004;"CARMOPOLIS (SE)";"SE";"CARMOPOLIS";55;14;11;80
2004;"CEDRO DE SAO JOAO (SE)";"SE";"CEDRO DE SAO JOAO";20;6;1;27
2004;"CRISTINAPOLIS (SE)";"SE";"CRISTINAPOLIS";44;22;14;80
2004;"CUMBE (SE)";"SE";"CUMBE";10;2;2;14
2004;"DIVINA PASTORA (SE)";"SE";"DIVINA PASTORA";6;3;0;9
2004;"ESTANCIA (SE)";"SE";"ESTANCIA";301;79;70;450
2004;"FEIRA NOVA (SE)";"SE";"FEIRA NOVA";9;4;2;15
2004;"FREI PAULO (SE)";"SE";"FREI PAULO";72;19;12;103
2004;"GARARU (SE)";"SE";"GARARU";23;6;10;39
2004;"GENERAL MAYNARD (SE)";"SE";"GENERAL MAYNARD";8;11;28;47
2004;"GRACCHO CARDOSO (SE)";"SE";"GRACCHO CARDOSO";13;0;2;15
2004;"ILHA DAS FLORES (SE)";"SE";"ILHA DAS FLORES";7;4;4;15
2004;"INDIAROBA (SE)";"SE";"INDIAROBA";23;11;4;38
2004;"ITABAIANA (SE)";"SE";"ITABAIANA";2067;110;61;2238
2004;"ITABAIANINHA (SE)";"SE";"ITABAIANINHA";288;28;29;345
2004;"ITABI (SE)";"SE";"ITABI";14;3;4;21
2004;"ITAPORANGA D AJUDA (SE)";"SE";"ITAPORANGA D AJUDA";111;12;18;141
2004;"JAPARATUBA (SE)";"SE";"JAPARATUBA";36;9;22;67
2004;"JAPOATA (SE)";"SE";"JAPOATA";31;2;18;51
2004;"LAGARTO (SE)";"SE";"LAGARTO";668;70;110;848
2004;"LARANJEIRAS (SE)";"SE";"LARANJEIRAS";83;8;27;118
2004;"MACAMBIRA (SE)";"SE";"MACAMBIRA";37;10;3;50
2004;"MALHADA DOS BOIS (SE)";"SE";"MALHADA DOS BOIS";13;0;3;16
2004;"MALHADOR (SE)";"SE";"MALHADOR";114;22;18;154
2004;"MARUIM (SE)";"SE";"MARUIM";27;14;11;52
2004;"MOITA BONITA (SE)";"SE";"MOITA BONITA";301;22;6;329
2004;"MONTE ALEGRE DE SERGIPE (SE)";"SE";"MONTE ALEGRE DE SERGIPE";47;7;10;64
2004;"MURIBECA (SE)";"SE";"MURIBECA";9;6;14;29
2004;"NEOPOLIS (SE)";"SE";"NEOPOLIS";32;7;14;53
2004;"NOSSA SENHORA APARECIDA (SE)";"SE";"NOSSA SENHORA APARECIDA";96;12;5;113
2004;"NOSSA SENHORA DA GLORIA (SE)";"SE";"NOSSA SENHORA DA GLORIA";269;11;44;324
2004;"NOSSA SENHORA DAS DORES (SE)";"SE";"NOSSA SENHORA DAS DORES";90;18;34;142
2004;"NOSSA SENHORA DE LOURDES (SE)";"SE";"NOSSA SENHORA DE LOURDES";22;2;3;27
2004;"NOSSA SENHORA DO SOCORRO (SE)";"SE";"NOSSA SENHORA DO SOCORRO";434;34;71;539
2004;"PACATUBA (SE)";"SE";"PACATUBA";19;3;15;37
2004;"PEDRA MOLE (SE)";"SE";"PEDRA MOLE";7;3;0;10
2004;"PEDRINHAS (SE)";"SE";"PEDRINHAS";55;5;2;62
2004;"PINHAO (SE)";"SE";"PINHAO";18;13;2;33
2004;"PIRAMBU (SE)";"SE";"PIRAMBU";11;8;13;32
2004;"POCO REDONDO (SE)";"SE";"POCO REDONDO";68;7;27;102
2004;"POCO VERDE (SE)";"SE";"POCO VERDE";64;11;33;108
2004;"PORTO DA FOLHA (SE)";"SE";"PORTO DA FOLHA";57;5;18;80
2004;"PROPRIA (SE)";"SE";"PROPRIA";182;18;47;247
2004;"RIACHAO DO DANTAS (SE)";"SE";"RIACHAO DO DANTAS";14;5;12;31
2004;"RIACHUELO (SE)";"SE";"RIACHUELO";16;2;10;28
2004;"RIBEIROPOLIS (SE)";"SE";"RIBEIROPOLIS";234;42;16;292
2004;"ROSARIO DO CATETE (SE)";"SE";"ROSARIO DO CATETE";26;21;11;58
2004;"SALGADO (SE)";"SE";"SALGADO";88;5;18;111
2004;"SANTA LUZIA DO ITANHY (SE)";"SE";"SANTA LUZIA DO ITANHY";11;1;8;20
2004;"SANTA ROSA DE LIMA (SE)";"SE";"SANTA ROSA DE LIMA";11;6;5;22
2004;"SANTANA DO SAO FRANCISCO (SE)";"SE";"SANTANA DO SAO FRANCISCO";4;4;3;11
2004;"SANTO AMARO DAS BROTAS (SE)";"SE";"SANTO AMARO DAS BROTAS";13;4;7;24
2004;"SAO CRISTOVAO (SE)";"SE";"SAO CRISTOVAO";185;44;35;264
2004;"SAO DOMINGOS (SE)";"SE";"SAO DOMINGOS";84;6;6;96
2004;"SAO FRANCISCO (SE)";"SE";"SAO FRANCISCO";13;3;15;31
2004;"SAO MIGUEL DO ALEIXO (SE)";"SE";"SAO MIGUEL DO ALEIXO";21;5;1;27
2004;"SIMAO DIAS (SE)";"SE";"SIMAO DIAS";148;25;137;310
2004;"SIRIRI (SE)";"SE";"SIRIRI";30;3;7;40
2004;"TELHA (SE)";"SE";"TELHA";7;0;4;11
2004;"TOBIAS BARRETO (SE)";"SE";"TOBIAS BARRETO";162;39;55;256
2004;"TOMAR DO GERU (SE)";"SE";"TOMAR DO GERU";25;9;6;40
2004;"UMBAUBA (SE)";"SE";"UMBAUBA";190;32;24;246
2004;"ADAMANTINA (SP)";"SP";"ADAMANTINA";591;37;102;730
2004;"ADOLFO (SP)";"SP";"ADOLFO";57;3;18;78
2004;"AGUAI (SP)";"SP";"AGUAI";615;21;96;732
2004;"AGUAS DA PRATA (SP)";"SP";"AGUAS DA PRATA";94;10;3;107
2004;"AGUAS DE LINDOIA (SP)";"SP";"AGUAS DE LINDOIA";141;32;30;203
2004;"AGUAS DE SANTA BARBARA (SP)";"SP";"AGUAS DE SANTA BARBARA";83;4;12;99
2004;"AGUAS DE SAO PEDRO (SP)";"SP";"AGUAS DE SAO PEDRO";20;11;1;32
2004;"AGUDOS (SP)";"SP";"AGUDOS";385;25;64;474
2004;"ALAMBARI (SP)";"SP";"ALAMBARI";53;10;1;64
2004;"ALFREDO MARCONDES (SP)";"SP";"ALFREDO MARCONDES";37;2;5;44
2004;"ALTAIR (SP)";"SP";"ALTAIR";59;4;27;90
2004;"ALTINOPOLIS (SP)";"SP";"ALTINOPOLIS";284;11;66;361
2004;"ALTO ALEGRE (SP)";"SP";"ALTO ALEGRE";61;1;27;89
2004;"ALUMINIO (SP)";"SP";"ALUMINIO";150;14;26;190
2004;"ALVARES FLORENCE (SP)";"SP";"ALVARES FLORENCE";48;1;6;55
2004;"ALVARES MACHADO (SP)";"SP";"ALVARES MACHADO";354;16;18;388
2004;"ALVARO DE CARVALHO (SP)";"SP";"ALVARO DE CARVALHO";21;1;12;34
2004;"ALVINLANDIA (SP)";"SP";"ALVINLANDIA";22;2;8;32
2004;"AMERICANA (SP)";"SP";"AMERICANA";2536;297;736;3569
2004;"AMERICO BRASILIENSE (SP)";"SP";"AMERICO BRASILIENSE";538;16;174;728
2004;"AMERICO DE CAMPOS (SP)";"SP";"AMERICO DE CAMPOS";110;3;19;132
2004;"AMPARO (SP)";"SP";"AMPARO";1039;119;76;1234
2004;"ANALANDIA (SP)";"SP";"ANALANDIA";57;5;12;74
2004;"ANDRADINA (SP)";"SP";"ANDRADINA";727;25;80;832
2004;"ANGATUBA (SP)";"SP";"ANGATUBA";301;26;50;377
2004;"ANHEMBI (SP)";"SP";"ANHEMBI";48;6;6;60
2004;"ANHUMAS (SP)";"SP";"ANHUMAS";52;4;3;59
2004;"APARECIDA (SP)";"SP";"APARECIDA";732;51;502;1285
2004;"APARECIDA D OESTE (SP)";"SP";"APARECIDA D OESTE";76;5;17;98
2004;"APIAI (SP)";"SP";"APIAI";221;23;53;297
2004;"ARACARIGUAMA (SP)";"SP";"ARACARIGUAMA";312;21;30;363
2004;"ARACATUBA (SP)";"SP";"ARACATUBA";2451;143;484;3078
2004;"ARACOIABA DA SERRA (SP)";"SP";"ARACOIABA DA SERRA";322;40;17;379
2004;"ARAMINA (SP)";"SP";"ARAMINA";57;5;17;79
2004;"ARANDU (SP)";"SP";"ARANDU";43;8;9;60
2004;"ARAPEI (SP)";"SP";"ARAPEI";17;3;2;22
2004;"ARARAQUARA (SP)";"SP";"ARARAQUARA";2524;273;729;3526
2004;"ARARAS (SP)";"SP";"ARARAS";1772;153;182;2107
2004;"ARCO IRIS (SP)";"SP";"ARCO IRIS";38;1;7;46
2004;"AREALVA (SP)";"SP";"AREALVA";138;6;12;156
2004;"AREIAS (SP)";"SP";"AREIAS";35;2;0;37
2004;"AREIOPOLIS (SP)";"SP";"AREIOPOLIS";97;9;37;143
2004;"ARIRANHA (SP)";"SP";"ARIRANHA";225;15;82;322
2004;"ARTUR NOGUEIRA (SP)";"SP";"ARTUR NOGUEIRA";674;49;106;829
2004;"ARUJA (SP)";"SP";"ARUJA";1665;152;246;2063
2004;"ASPASIA (SP)";"SP";"ASPASIA";25;1;3;29
2004;"ASSIS (SP)";"SP";"ASSIS";1315;83;248;1646
2004;"ATIBAIA (SP)";"SP";"ATIBAIA";1653;187;194;2034
2004;"AURIFLAMA (SP)";"SP";"AURIFLAMA";299;9;32;340
2004;"AVAI (SP)";"SP";"AVAI";47;6;16;69
2004;"AVANHANDAVA (SP)";"SP";"AVANHANDAVA";107;5;25;137
2004;"AVARE (SP)";"SP";"AVARE";995;55;230;1280
2004;"BADY BASSITT (SP)";"SP";"BADY BASSITT";198;21;18;237
2004;"BALBINOS (SP)";"SP";"BALBINOS";9;1;4;14
2004;"BALSAMO (SP)";"SP";"BALSAMO";135;6;9;150
2004;"BANANAL (SP)";"SP";"BANANAL";76;10;17;103
2004;"BARAO DE ANTONINA (SP)";"SP";"BARAO DE ANTONINA";18;5;6;29
2004;"BARBOSA (SP)";"SP";"BARBOSA";67;5;9;81
2004;"BARIRI (SP)";"SP";"BARIRI";642;20;57;719
2004;"BARRA BONITA (SP)";"SP";"BARRA BONITA";937;51;166;1154
2004;"BARRA DO CHAPEU (SP)";"SP";"BARRA DO CHAPEU";30;0;5;35
2004;"BARRA DO TURVO (SP)";"SP";"BARRA DO TURVO";39;3;18;60
2004;"BARRETOS (SP)";"SP";"BARRETOS";1641;77;340;2058
2004;"BARRINHA (SP)";"SP";"BARRINHA";253;17;111;381
2004;"BARUERI (SP)";"SP";"BARUERI";2988;384;624;3996
2004;"BASTOS (SP)";"SP";"BASTOS";523;14;53;590
2004;"BATATAIS (SP)";"SP";"BATATAIS";816;27;114;957
2004;"BAURU (SP)";"SP";"BAURU";3689;327;871;4887
2004;"BEBEDOURO (SP)";"SP";"BEBEDOURO";1435;75;177;1687
2004;"BENTO DE ABREU (SP)";"SP";"BENTO DE ABREU";65;5;7;77
2004;"BERNARDINO DE CAMPOS (SP)";"SP";"BERNARDINO DE CAMPOS";223;13;20;256
2004;"BERTIOGA (SP)";"SP";"BERTIOGA";320;38;50;408
2004;"BILAC (SP)";"SP";"BILAC";93;5;15;113
2004;"BIRIGUI (SP)";"SP";"BIRIGUI";1204;41;94;1339
2004;"BIRITIBA MIRIM (SP)";"SP";"BIRITIBA MIRIM";214;6;21;241
2004;"BOA ESPERANCA DO SUL (SP)";"SP";"BOA ESPERANCA DO SUL";339;10;58;407
2004;"BOCAINA (SP)";"SP";"BOCAINA";149;21;21;191
2004;"BOFETE (SP)";"SP";"BOFETE";139;10;20;169
2004;"BOITUVA (SP)";"SP";"BOITUVA";751;42;76;869
2004;"BOM JESUS DOS PERDOES (SP)";"SP";"BOM JESUS DOS PERDOES";255;33;23;311
2004;"BOM SUCESSO DE ITARARE (SP)";"SP";"BOM SUCESSO DE ITARARE";49;6;2;57
2004;"BORA (SP)";"SP";"BORA";14;0;4;18
2004;"BORACEIA (SP)";"SP";"BORACEIA";147;6;13;166
2004;"BORBOREMA (SP)";"SP";"BORBOREMA";251;8;40;299
2004;"BOREBI (SP)";"SP";"BOREBI";29;4;4;37
2004;"BOTUCATU (SP)";"SP";"BOTUCATU";1218;126;382;1726
2004;"BRAGANCA PAULISTA (SP)";"SP";"BRAGANCA PAULISTA";1925;163;192;2280
2004;"BRAUNA (SP)";"SP";"BRAUNA";45;1;16;62
2004;"BREJO ALEGRE (SP)";"SP";"BREJO ALEGRE";34;1;7;42
2004;"BRODOSQUI (SP)";"SP";"BRODOSQUI";392;15;26;433
2004;"BROTAS (SP)";"SP";"BROTAS";350;23;80;453
2004;"BURI (SP)";"SP";"BURI";256;15;37;308
2004;"BURITAMA (SP)";"SP";"BURITAMA";211;15;28;254
2004;"BURITIZAL (SP)";"SP";"BURITIZAL";78;11;18;107
2004;"CABRALIA PAULISTA (SP)";"SP";"CABRALIA PAULISTA";106;1;6;113
2004;"CABREUVA (SP)";"SP";"CABREUVA";741;76;43;860
2004;"CACAPAVA (SP)";"SP";"CACAPAVA";577;133;80;790
2004;"CACHOEIRA PAULISTA (SP)";"SP";"CACHOEIRA PAULISTA";259;25;6;290
2004;"CACONDE (SP)";"SP";"CACONDE";147;17;52;216
2004;"CAFELANDIA (SP)";"SP";"CAFELANDIA";215;7;32;254
2004;"CAIABU (SP)";"SP";"CAIABU";26;3;28;57
2004;"CAIEIRAS (SP)";"SP";"CAIEIRAS";589;88;326;1003
2004;"CAIUA (SP)";"SP";"CAIUA";23;2;9;34
2004;"CAJAMAR (SP)";"SP";"CAJAMAR";665;70;69;804
2004;"CAJATI (SP)";"SP";"CAJATI";272;23;51;346
2004;"CAJOBI (SP)";"SP";"CAJOBI";248;2;53;303
2004;"CAJURU (SP)";"SP";"CAJURU";353;12;77;442
2004;"CAMPINA DO MONTE ALEGRE (SP)";"SP";"CAMPINA DO MONTE ALEGRE";57;5;20;82
2004;"CAMPINAS (SP)";"SP";"CAMPINAS";12374;2261;3097;17732
2004;"CAMPO LIMPO PAULISTA (SP)";"SP";"CAMPO LIMPO PAULISTA";445;80;18;543
2004;"CAMPOS DO JORDAO (SP)";"SP";"CAMPOS DO JORDAO";448;119;25;592
2004;"CAMPOS NOVOS PAULISTA (SP)";"SP";"CAMPOS NOVOS PAULISTA";67;1;15;83
2004;"CANANEIA (SP)";"SP";"CANANEIA";56;2;8;66
2004;"CANAS (SP)";"SP";"CANAS";33;4;3;40
2004;"CANDIDO MOTA (SP)";"SP";"CANDIDO MOTA";672;10;40;722
2004;"CANDIDO RODRIGUES (SP)";"SP";"CANDIDO RODRIGUES";80;5;2;87
2004;"CANITAR (SP)";"SP";"CANITAR";44;6;22;72
2004;"CAPAO BONITO (SP)";"SP";"CAPAO BONITO";730;50;116;896
2004;"CAPELA DO ALTO (SP)";"SP";"CAPELA DO ALTO";296;14;17;327
2004;"CAPIVARI (SP)";"SP";"CAPIVARI";937;46;171;1154
2004;"CARAGUATATUBA (SP)";"SP";"CARAGUATATUBA";927;72;88;1087
2004;"CARAPICUIBA (SP)";"SP";"CARAPICUIBA";1557;328;654;2539
2004;"CARDOSO (SP)";"SP";"CARDOSO";130;6;30;166
2004;"CASA BRANCA (SP)";"SP";"CASA BRANCA";382;39;56;477
2004;"CASSIA DOS COQUEIROS (SP)";"SP";"CASSIA DOS COQUEIROS";14;4;6;24
2004;"CASTILHO (SP)";"SP";"CASTILHO";131;11;63;205
2004;"CATANDUVA (SP)";"SP";"CATANDUVA";2310;106;330;2746
2004;"CATIGUA (SP)";"SP";"CATIGUA";94;2;30;126
2004;"CEDRAL (SP)";"SP";"CEDRAL";121;8;6;135
2004;"CERQUEIRA CESAR (SP)";"SP";"CERQUEIRA CESAR";233;14;43;290
2004;"CERQUILHO (SP)";"SP";"CERQUILHO";665;50;60;775
2004;"CESARIO LANGE (SP)";"SP";"CESARIO LANGE";245;25;30;300
2004;"CHARQUEADA (SP)";"SP";"CHARQUEADA";323;18;61;402
2004;"CHAVANTES (SP)";"SP";"CHAVANTES";128;11;25;164
2004;"CLEMENTINA (SP)";"SP";"CLEMENTINA";146;2;23;171
2004;"COLINA (SP)";"SP";"COLINA";296;12;54;362
2004;"COLOMBIA (SP)";"SP";"COLOMBIA";101;3;43;147
2004;"CONCHAL (SP)";"SP";"CONCHAL";568;20;116;704
2004;"CONCHAS (SP)";"SP";"CONCHAS";244;20;21;285
2004;"CORDEIROPOLIS (SP)";"SP";"CORDEIROPOLIS";467;31;25;523
2004;"COROADOS (SP)";"SP";"COROADOS";55;3;10;68
2004;"CORONEL MACEDO (SP)";"SP";"CORONEL MACEDO";48;6;16;70
2004;"CORUMBATAI (SP)";"SP";"CORUMBATAI";119;8;5;132
2004;"COSMOPOLIS (SP)";"SP";"COSMOPOLIS";547;82;207;836
2004;"COSMORAMA (SP)";"SP";"COSMORAMA";116;5;24;145
2004;"COTIA (SP)";"SP";"COTIA";1565;550;157;2272
2004;"CRAVINHOS (SP)";"SP";"CRAVINHOS";657;57;101;815
2004;"CRISTAIS PAULISTA (SP)";"SP";"CRISTAIS PAULISTA";69;1;14;84
2004;"CRUZALIA (SP)";"SP";"CRUZALIA";69;10;3;82
2004;"CRUZEIRO (SP)";"SP";"CRUZEIRO";512;48;35;595
2004;"CUBATAO (SP)";"SP";"CUBATAO";1794;277;288;2359
2004;"CUNHA (SP)";"SP";"CUNHA";190;13;17;220
2004;"DESCALVADO (SP)";"SP";"DESCALVADO";680;37;118;835
2004;"DIADEMA (SP)";"SP";"DIADEMA";2709;453;454;3616
2004;"DIRCE REIS (SP)";"SP";"DIRCE REIS";47;1;5;53
2004;"DIVINOLANDIA (SP)";"SP";"DIVINOLANDIA";355;14;15;384
2004;"DOBRADA (SP)";"SP";"DOBRADA";65;3;40;108
2004;"DOIS CORREGOS (SP)";"SP";"DOIS CORREGOS";512;15;84;611
2004;"DOLCINOPOLIS (SP)";"SP";"DOLCINOPOLIS";23;2;3;28
2004;"DOURADO (SP)";"SP";"DOURADO";132;9;35;176
2004;"DRACENA (SP)";"SP";"DRACENA";873;23;96;992
2004;"DUARTINA (SP)";"SP";"DUARTINA";198;14;31;243
2004;"DUMONT (SP)";"SP";"DUMONT";247;9;38;294
2004;"ECHAPORA (SP)";"SP";"ECHAPORA";86;2;15;103
2004;"ELDORADO (SP)";"SP";"ELDORADO";167;5;29;201
2004;"ELIAS FAUSTO (SP)";"SP";"ELIAS FAUSTO";230;10;30;270
2004;"ELISIARIO (SP)";"SP";"ELISIARIO";49;3;6;58
2004;"EMBAUBA (SP)";"SP";"EMBAUBA";85;0;24;109
2004;"EMBU (SP)";"SP";"EMBU";1168;335;441;1944
2004;"EMBU GUACU (SP)";"SP";"EMBU GUACU";758;133;113;1004
2004;"EMILIANOPOLIS (SP)";"SP";"EMILIANOPOLIS";44;1;6;51
2004;"ENGENHEIRO COELHO (SP)";"SP";"ENGENHEIRO COELHO";239;26;98;363
2004;"ESPIRITO SANTO DO PINHAL (SP)";"SP";"ESPIRITO SANTO DO PINHAL";488;72;50;610
2004;"ESPIRITO SANTO DO TURVO (SP)";"SP";"ESPIRITO SANTO DO TURVO";85;7;16;108
2004;"ESTIVA GERBI (SP)";"SP";"ESTIVA GERBI";191;8;13;212
2004;"ESTRELA D OESTE (SP)";"SP";"ESTRELA D OESTE";191;8;13;212
2004;"ESTRELA DO NORTE (SP)";"SP";"ESTRELA DO NORTE";16;3;6;25
2004;"EUCLIDES DA CUNHA PAULISTA (SP)";"SP";"EUCLIDES DA CUNHA PAULISTA";65;4;25;94
2004;"FARTURA (SP)";"SP";"FARTURA";196;14;15;225
2004;"FERNANDO PRESTES (SP)";"SP";"FERNANDO PRESTES";200;5;7;212
2004;"FERNANDOPOLIS (SP)";"SP";"FERNANDOPOLIS";1077;30;119;1226
2004;"FERNAO (SP)";"SP";"FERNAO";15;2;3;20
2004;"FERRAZ DE VASCONCELOS (SP)";"SP";"FERRAZ DE VASCONCELOS";733;78;147;958
2004;"FLORA RICA (SP)";"SP";"FLORA RICA";20;1;7;28
2004;"FLOREAL (SP)";"SP";"FLOREAL";44;4;5;53
2004;"FLORIDA PAULISTA (SP)";"SP";"FLORIDA PAULISTA";222;4;72;298
2004;"FLORINEA (SP)";"SP";"FLORINEA";30;2;5;37
2004;"FRANCA (SP)";"SP";"FRANCA";2162;177;354;2693
2004;"FRANCISCO MORATO (SP)";"SP";"FRANCISCO MORATO";327;87;103;517
2004;"FRANCO DA ROCHA (SP)";"SP";"FRANCO DA ROCHA";425;104;114;643
2004;"GABRIEL MONTEIRO (SP)";"SP";"GABRIEL MONTEIRO";38;2;7;47
2004;"GALIA (SP)";"SP";"GALIA";111;6;17;134
2004;"GARCA (SP)";"SP";"GARCA";598;41;84;723
2004;"GASTAO VIDIGAL (SP)";"SP";"GASTAO VIDIGAL";61;1;16;78
2004;"GAVIAO PEIXOTO (SP)";"SP";"GAVIAO PEIXOTO";41;4;18;63
2004;"GENERAL SALGADO (SP)";"SP";"GENERAL SALGADO";199;4;37;240
2004;"GETULINA (SP)";"SP";"GETULINA";122;5;30;157
2004;"GLICERIO (SP)";"SP";"GLICERIO";75;2;20;97
2004;"GUAICARA (SP)";"SP";"GUAICARA";54;5;9;68
2004;"GUAIMBE (SP)";"SP";"GUAIMBE";90;4;12;106
2004;"GUAIRA (SP)";"SP";"GUAIRA";823;20;77;920
2004;"GUAPIACU (SP)";"SP";"GUAPIACU";341;15;35;391
2004;"GUAPIARA (SP)";"SP";"GUAPIARA";223;8;28;259
2004;"GUARA (SP)";"SP";"GUARA";209;10;97;316
2004;"GUARACAI (SP)";"SP";"GUARACAI";273;4;15;292
2004;"GUARACI (SP)";"SP";"GUARACI";101;4;38;143
2004;"GUARANI D OESTE (SP)";"SP";"GUARANI D OESTE";22;2;6;30
2004;"GUARANTA (SP)";"SP";"GUARANTA";83;1;20;104
2004;"GUARARAPES (SP)";"SP";"GUARARAPES";572;20;88;680
2004;"GUARAREMA (SP)";"SP";"GUARAREMA";200;19;4;223
2004;"GUARATINGUETA (SP)";"SP";"GUARATINGUETA";804;119;245;1168
2004;"GUAREI (SP)";"SP";"GUAREI";168;19;22;209
2004;"GUARIBA (SP)";"SP";"GUARIBA";682;22;218;922
2004;"GUARUJA (SP)";"SP";"GUARUJA";1336;339;294;1969
2004;"GUARULHOS (SP)";"SP";"GUARULHOS";11864;2275;2334;16473
2004;"GUATAPARA (SP)";"SP";"GUATAPARA";116;5;32;153
2004;"GUZOLANDIA (SP)";"SP";"GUZOLANDIA";53;3;22;78
2004;"HERCULANDIA (SP)";"SP";"HERCULANDIA";302;2;15;319
2004;"HOLAMBRA (SP)";"SP";"HOLAMBRA";306;16;42;364
2004;"HORTOLANDIA (SP)";"SP";"HORTOLANDIA";933;197;186;1316
2004;"IACANGA (SP)";"SP";"IACANGA";134;5;22;161
2004;"IACRI (SP)";"SP";"IACRI";101;2;9;112
2004;"IARAS (SP)";"SP";"IARAS";33;13;6;52
2004;"IBATE (SP)";"SP";"IBATE";379;26;150;555
2004;"IBIRA (SP)";"SP";"IBIRA";152;17;38;207
2004;"IBIRAREMA (SP)";"SP";"IBIRAREMA";113;5;17;135
2004;"IBITINGA (SP)";"SP";"IBITINGA";588;33;97;718
2004;"IBIUNA (SP)";"SP";"IBIUNA";1198;78;80;1356
2004;"ICEM (SP)";"SP";"ICEM";142;5;55;202
2004;"IEPE (SP)";"SP";"IEPE";118;5;19;142
2004;"IGARACU DO TIETE (SP)";"SP";"IGARACU DO TIETE";302;11;32;345
2004;"IGARAPAVA (SP)";"SP";"IGARAPAVA";421;19;85;525
2004;"IGARATA (SP)";"SP";"IGARATA";81;5;6;92
2004;"IGUAPE (SP)";"SP";"IGUAPE";184;13;19;216
2004;"ILHA COMPRIDA (SP)";"SP";"ILHA COMPRIDA";80;5;25;110
2004;"ILHA SOLTEIRA (SP)";"SP";"ILHA SOLTEIRA";190;18;45;253
2004;"ILHABELA (SP)";"SP";"ILHABELA";177;17;32;226
2004;"INDAIATUBA (SP)";"SP";"INDAIATUBA";1980;190;195;2365
2004;"INDIANA (SP)";"SP";"INDIANA";103;3;5;111
2004;"INDIAPORA (SP)";"SP";"INDIAPORA";53;3;12;68
2004;"INUBIA PAULISTA (SP)";"SP";"INUBIA PAULISTA";38;3;10;51
2004;"IPAUCU (SP)";"SP";"IPAUCU";131;9;31;171
2004;"IPERO (SP)";"SP";"IPERO";164;10;28;202
2004;"IPEUNA (SP)";"SP";"IPEUNA";101;13;11;125
2004;"IPIGUA (SP)";"SP";"IPIGUA";14;2;4;20
2004;"IPORANGA (SP)";"SP";"IPORANGA";24;1;7;32
2004;"IPUA (SP)";"SP";"IPUA";245;2;51;298
2004;"IRACEMAPOLIS (SP)";"SP";"IRACEMAPOLIS";507;17;65;589
2004;"IRAPUA (SP)";"SP";"IRAPUA";141;2;45;188
2004;"IRAPURU (SP)";"SP";"IRAPURU";104;8;16;128
2004;"ITABERA (SP)";"SP";"ITABERA";183;10;25;218
2004;"ITAI (SP)";"SP";"ITAI";389;19;69;477
2004;"ITAJOBI (SP)";"SP";"ITAJOBI";438;12;37;487
2004;"ITAJU (SP)";"SP";"ITAJU";58;0;6;64
2004;"ITANHAEM (SP)";"SP";"ITANHAEM";569;57;92;718
2004;"ITAOCA (SP)";"SP";"ITAOCA";13;6;4;23
2004;"ITAPECERICA DA SERRA (SP)";"SP";"ITAPECERICA DA SERRA";1308;373;287;1968
2004;"ITAPETININGA (SP)";"SP";"ITAPETININGA";1922;174;220;2316
2004;"ITAPEVA (SP)";"SP";"ITAPEVA";1416;101;220;1737
2004;"ITAPEVI (SP)";"SP";"ITAPEVI";938;100;81;1119
2004;"ITAPIRA (SP)";"SP";"ITAPIRA";1235;58;159;1452
2004;"ITAPIRAPUA PAULISTA (SP)";"SP";"ITAPIRAPUA PAULISTA";25;4;3;32
2004;"ITAPOLIS (SP)";"SP";"ITAPOLIS";1116;22;137;1275
2004;"ITAPORANGA (SP)";"SP";"ITAPORANGA";181;8;29;218
2004;"ITAPUI (SP)";"SP";"ITAPUI";291;9;32;332
2004;"ITAPURA (SP)";"SP";"ITAPURA";13;3;6;22
2004;"ITAQUAQUECETUBA (SP)";"SP";"ITAQUAQUECETUBA";1324;221;407;1952
2004;"ITARARE (SP)";"SP";"ITARARE";790;27;224;1041
2004;"ITARIRI (SP)";"SP";"ITARIRI";242;7;24;273
2004;"ITATIBA (SP)";"SP";"ITATIBA";1758;115;155;2028
2004;"ITATINGA (SP)";"SP";"ITATINGA";143;21;66;230
2004;"ITIRAPINA (SP)";"SP";"ITIRAPINA";174;11;34;219
2004;"ITIRAPUA (SP)";"SP";"ITIRAPUA";48;4;13;65
2004;"ITOBI (SP)";"SP";"ITOBI";107;4;42;153
2004;"ITU (SP)";"SP";"ITU";2225;196;371;2792
2004;"ITUPEVA (SP)";"SP";"ITUPEVA";597;67;39;703
2004;"ITUVERAVA (SP)";"SP";"ITUVERAVA";599;23;102;724
2004;"JABORANDI (SP)";"SP";"JABORANDI";133;5;28;166
2004;"JABOTICABAL (SP)";"SP";"JABOTICABAL";1329;58;164;1551
2004;"JACAREI (SP)";"SP";"JACAREI";1948;324;276;2548
2004;"JACI (SP)";"SP";"JACI";98;4;10;112
2004;"JACUPIRANGA (SP)";"SP";"JACUPIRANGA";306;8;136;450
2004;"JAGUARIUNA (SP)";"SP";"JAGUARIUNA";793;64;66;923
2004;"JALES (SP)";"SP";"JALES";922;32;74;1028
2004;"JAMBEIRO (SP)";"SP";"JAMBEIRO";22;5;6;33
2004;"JANDIRA (SP)";"SP";"JANDIRA";901;127;95;1123
2004;"JARDINOPOLIS (SP)";"SP";"JARDINOPOLIS";668;44;63;775
2004;"JARINU (SP)";"SP";"JARINU";353;17;27;397
2004;"JAU (SP)";"SP";"JAU";1646;162;224;2032
2004;"JERIQUARA (SP)";"SP";"JERIQUARA";29;3;5;37
2004;"JOANOPOLIS (SP)";"SP";"JOANOPOLIS";212;9;5;226
2004;"JOAO RAMALHO (SP)";"SP";"JOAO RAMALHO";24;3;16;43
2004;"JOSE BONIFACIO (SP)";"SP";"JOSE BONIFACIO";592;16;57;665
2004;"JULIO MESQUITA (SP)";"SP";"JULIO MESQUITA";33;0;10;43
2004;"JUMIRIM (SP)";"SP";"JUMIRIM";59;2;2;63
2004;"JUNDIAI (SP)";"SP";"JUNDIAI";5244;694;787;6725
2004;"JUNQUEIROPOLIS (SP)";"SP";"JUNQUEIROPOLIS";325;15;60;400
2004;"JUQUIA (SP)";"SP";"JUQUIA";316;14;38;368
2004;"JUQUITIBA (SP)";"SP";"JUQUITIBA";293;55;35;383
2004;"LAGOINHA (SP)";"SP";"LAGOINHA";62;7;5;74
2004;"LARANJAL PAULISTA (SP)";"SP";"LARANJAL PAULISTA";479;27;69;575
2004;"LAVINIA (SP)";"SP";"LAVINIA";65;7;8;80
2004;"LAVRINHAS (SP)";"SP";"LAVRINHAS";106;11;8;125
2004;"LEME (SP)";"SP";"LEME";1732;65;302;2099
2004;"LENCOIS PAULISTA (SP)";"SP";"LENCOIS PAULISTA";1055;59;122;1236
2004;"LIMEIRA (SP)";"SP";"LIMEIRA";3494;396;489;4379
2004;"LINDOIA (SP)";"SP";"LINDOIA";87;6;10;103
2004;"LINS (SP)";"SP";"LINS";844;43;111;998
2004;"LORENA (SP)";"SP";"LORENA";582;65;18;665
2004;"LOURDES (SP)";"SP";"LOURDES";23;3;8;34
2004;"LOUVEIRA (SP)";"SP";"LOUVEIRA";656;54;36;746
2004;"LUCELIA (SP)";"SP";"LUCELIA";340;20;95;455
2004;"LUCIANOPOLIS (SP)";"SP";"LUCIANOPOLIS";40;3;7;50
2004;"LUIS ANTONIO (SP)";"SP";"LUIS ANTONIO";222;16;71;309
2004;"LUIZIANIA (SP)";"SP";"LUIZIANIA";51;1;11;63
2004;"LUPERCIO (SP)";"SP";"LUPERCIO";53;2;16;71
2004;"LUTECIA (SP)";"SP";"LUTECIA";30;3;4;37
2004;"MACATUBA (SP)";"SP";"MACATUBA";592;13;47;652
2004;"MACAUBAL (SP)";"SP";"MACAUBAL";116;5;12;133
2004;"MACEDONIA (SP)";"SP";"MACEDONIA";43;1;10;54
2004;"MAGDA (SP)";"SP";"MAGDA";66;4;8;78
2004;"MAIRINQUE (SP)";"SP";"MAIRINQUE";352;45;56;453
2004;"MAIRIPORA (SP)";"SP";"MAIRIPORA";791;80;115;986
2004;"MANDURI (SP)";"SP";"MANDURI";119;7;29;155
2004;"MARABA PAULISTA (SP)";"SP";"MARABA PAULISTA";30;2;11;43
2004;"MARACAI (SP)";"SP";"MARACAI";268;19;41;328
2004;"MARAPOAMA (SP)";"SP";"MARAPOAMA";95;3;9;107
2004;"MARIAPOLIS (SP)";"SP";"MARIAPOLIS";31;0;11;42
2004;"MARILIA (SP)";"SP";"MARILIA";2384;147;373;2904
2004;"MARINOPOLIS (SP)";"SP";"MARINOPOLIS";53;2;3;58
2004;"MARTINOPOLIS (SP)";"SP";"MARTINOPOLIS";340;20;61;421
2004;"MATAO (SP)";"SP";"MATAO";1219;38;207;1464
2004;"MAUA (SP)";"SP";"MAUA";2517;651;744;3912
2004;"MENDONCA (SP)";"SP";"MENDONCA";82;2;11;95
2004;"MERIDIANO (SP)";"SP";"MERIDIANO";52;1;13;66
2004;"MESOPOLIS (SP)";"SP";"MESOPOLIS";15;3;7;25
2004;"MIGUELOPOLIS (SP)";"SP";"MIGUELOPOLIS";303;7;70;380
2004;"MINEIROS DO TIETE (SP)";"SP";"MINEIROS DO TIETE";221;5;25;251
2004;"MIRA ESTRELA (SP)";"SP";"MIRA ESTRELA";35;1;11;47
2004;"MIRACATU (SP)";"SP";"MIRACATU";448;22;29;499
2004;"MIRANDOPOLIS (SP)";"SP";"MIRANDOPOLIS";401;14;84;499
2004;"MIRANTE DO PARANAPANEMA (SP)";"SP";"MIRANTE DO PARANAPANEMA";178;8;34;220
2004;"MIRASSOL (SP)";"SP";"MIRASSOL";832;34;35;901
2004;"MIRASSOLANDIA (SP)";"SP";"MIRASSOLANDIA";22;5;6;33
2004;"MOCOCA (SP)";"SP";"MOCOCA";807;42;177;1026
2004;"MOGI DAS CRUZES (SP)";"SP";"MOGI DAS CRUZES";3340;434;603;4377
2004;"MOGI GUACU (SP)";"SP";"MOGI GUACU";1502;212;294;2008
2004;"MOGI MIRIM (SP)";"SP";"MOGI MIRIM";1545;130;417;2092
2004;"MOMBUCA (SP)";"SP";"MOMBUCA";63;3;16;82
2004;"MONCOES (SP)";"SP";"MONCOES";38;1;7;46
2004;"MONGAGUA (SP)";"SP";"MONGAGUA";333;38;52;423
2004;"MONTE ALEGRE DO SUL (SP)";"SP";"MONTE ALEGRE DO SUL";137;14;12;163
2004;"MONTE ALTO (SP)";"SP";"MONTE ALTO";1159;31;78;1268
2004;"MONTE APRAZIVEL (SP)";"SP";"MONTE APRAZIVEL";423;6;44;473
2004;"MONTE AZUL PAULISTA (SP)";"SP";"MONTE AZUL PAULISTA";451;16;82;549
2004;"MONTE CASTELO (SP)";"SP";"MONTE CASTELO";60;3;5;68
2004;"MONTE MOR (SP)";"SP";"MONTE MOR";466;68;98;632
2004;"MONTEIRO LOBATO (SP)";"SP";"MONTEIRO LOBATO";41;9;9;59
2004;"MORRO AGUDO (SP)";"SP";"MORRO AGUDO";497;17;95;609
2004;"MORUNGABA (SP)";"SP";"MORUNGABA";240;31;17;288
2004;"MOTUCA (SP)";"SP";"MOTUCA";138;5;49;192
2004;"MUNICIPIO NAO INFORMADO (SP)";"SP";"MUNICIPIO NAO INFORMADO";0;0;0;0
2004;"MURUTINGA DO SUL (SP)";"SP";"MURUTINGA DO SUL";76;5;3;84
2004;"NANTES (SP)";"SP";"NANTES";16;0;12;28
2004;"NARANDIBA (SP)";"SP";"NARANDIBA";21;2;11;34
2004;"NATIVIDADE DA SERRA (SP)";"SP";"NATIVIDADE DA SERRA";43;7;5;55
2004;"NAZARE PAULISTA (SP)";"SP";"NAZARE PAULISTA";332;9;43;384
2004;"NEVES PAULISTA (SP)";"SP";"NEVES PAULISTA";165;2;21;188
2004;"NHANDEARA (SP)";"SP";"NHANDEARA";159;9;20;188
2004;"NIPOA (SP)";"SP";"NIPOA";76;4;9;89
2004;"NOVA ALIANCA (SP)";"SP";"NOVA ALIANCA";94;5;13;112
2004;"NOVA CAMPINA (SP)";"SP";"NOVA CAMPINA";62;4;8;74
2004;"NOVA CANAA PAULISTA (SP)";"SP";"NOVA CANAA PAULISTA";21;2;4;27
2004;"NOVA CASTILHO (SP)";"SP";"NOVA CASTILHO";12;2;4;18
2004;"NOVA EUROPA (SP)";"SP";"NOVA EUROPA";135;3;57;195
2004;"NOVA GRANADA (SP)";"SP";"NOVA GRANADA";246;9;59;314
2004;"NOVA GUATAPORANGA (SP)";"SP";"NOVA GUATAPORANGA";26;2;8;36
2004;"NOVA INDEPENDENCIA (SP)";"SP";"NOVA INDEPENDENCIA";20;3;2;25
2004;"NOVA LUZITANIA (SP)";"SP";"NOVA LUZITANIA";36;3;16;55
2004;"NOVA ODESSA (SP)";"SP";"NOVA ODESSA";626;75;99;800
2004;"NOVAIS (SP)";"SP";"NOVAIS";98;3;27;128
2004;"NOVO HORIZONTE (SP)";"SP";"NOVO HORIZONTE";694;9;124;827
2004;"NUPORANGA (SP)";"SP";"NUPORANGA";153;7;19;179
2004;"OCAUCU (SP)";"SP";"OCAUCU";69;1;8;78
2004;"OLEO (SP)";"SP";"OLEO";16;8;3;27
2004;"OLIMPIA (SP)";"SP";"OLIMPIA";904;23;119;1046
2004;"ONDA VERDE (SP)";"SP";"ONDA VERDE";68;3;13;84
2004;"ORIENTE (SP)";"SP";"ORIENTE";46;3;10;59
2004;"ORINDIUVA (SP)";"SP";"ORINDIUVA";100;9;51;160
2004;"ORLANDIA (SP)";"SP";"ORLANDIA";783;30;165;978
2004;"OSASCO (SP)";"SP";"OSASCO";5400;1078;1708;8186
2004;"OSCAR BRESSANE (SP)";"SP";"OSCAR BRESSANE";35;3;7;45
2004;"OSVALDO CRUZ (SP)";"SP";"OSVALDO CRUZ";466;13;58;537
2004;"OURINHOS (SP)";"SP";"OURINHOS";1646;69;215;1930
2004;"OURO VERDE (SP)";"SP";"OURO VERDE";103;2;23;128
2004;"OUROESTE (SP)";"SP";"OUROESTE";65;7;18;90
2004;"PACAEMBU (SP)";"SP";"PACAEMBU";158;18;27;203
2004;"PALESTINA (SP)";"SP";"PALESTINA";97;3;21;121
2004;"PALMARES PAULISTA (SP)";"SP";"PALMARES PAULISTA";66;3;60;129
2004;"PALMEIRA D OESTE (SP)";"SP";"PALMEIRA D OESTE";174;4;24;202
2004;"PALMITAL (SP)";"SP";"PALMITAL";531;25;49;605
2004;"PANORAMA (SP)";"SP";"PANORAMA";183;6;14;203
2004;"PARAGUACU PAULISTA (SP)";"SP";"PARAGUACU PAULISTA";477;20;75;572
2004;"PARAIBUNA (SP)";"SP";"PARAIBUNA";158;32;27;217
2004;"PARAISO (SP)";"SP";"PARAISO";161;5;32;198
2004;"PARANAPANEMA (SP)";"SP";"PARANAPANEMA";347;10;32;389
2004;"PARANAPUA (SP)";"SP";"PARANAPUA";50;5;7;62
2004;"PARAPUA (SP)";"SP";"PARAPUA";216;6;24;246
2004;"PARDINHO (SP)";"SP";"PARDINHO";127;8;14;149
2004;"PARIQUERA ACU (SP)";"SP";"PARIQUERA ACU";212;9;8;229
2004;"PARISI (SP)";"SP";"PARISI";21;2;7;30
2004;"PATROCINIO PAULISTA (SP)";"SP";"PATROCINIO PAULISTA";138;3;25;166
2004;"PAULICEIA (SP)";"SP";"PAULICEIA";101;3;10;114
2004;"PAULINIA (SP)";"SP";"PAULINIA";1361;98;241;1700
2004;"PAULISTANIA (SP)";"SP";"PAULISTANIA";20;6;3;29
2004;"PAULO DE FARIA (SP)";"SP";"PAULO DE FARIA";82;7;31;120
2004;"PEDERNEIRAS (SP)";"SP";"PEDERNEIRAS";725;44;129;898
2004;"PEDRA BELA (SP)";"SP";"PEDRA BELA";83;3;10;96
2004;"PEDRANOPOLIS (SP)";"SP";"PEDRANOPOLIS";34;0;5;39
2004;"PEDREGULHO (SP)";"SP";"PEDREGULHO";191;10;57;258
2004;"PEDREIRA (SP)";"SP";"PEDREIRA";503;61;54;618
2004;"PEDRINHAS PAULISTA (SP)";"SP";"PEDRINHAS PAULISTA";123;3;13;139
2004;"PEDRO DE TOLEDO (SP)";"SP";"PEDRO DE TOLEDO";125;8;4;137
2004;"PENAPOLIS (SP)";"SP";"PENAPOLIS";1065;27;172;1264
2004;"PEREIRA BARRETO (SP)";"SP";"PEREIRA BARRETO";360;17;75;452
2004;"PEREIRAS (SP)";"SP";"PEREIRAS";165;12;15;192
2004;"PERUIBE (SP)";"SP";"PERUIBE";409;95;38;542
2004;"PIACATU (SP)";"SP";"PIACATU";70;2;5;77
2004;"PIEDADE (SP)";"SP";"PIEDADE";1002;60;66;1128
2004;"PILAR DO SUL (SP)";"SP";"PILAR DO SUL";592;32;58;682
2004;"PINDAMONHANGABA (SP)";"SP";"PINDAMONHANGABA";977;129;132;1238
2004;"PINDORAMA (SP)";"SP";"PINDORAMA";213;6;43;262
2004;"PINHALZINHO (SP)";"SP";"PINHALZINHO";262;12;7;281
2004;"PIQUEROBI (SP)";"SP";"PIQUEROBI";20;5;5;30
2004;"PIQUETE (SP)";"SP";"PIQUETE";89;26;15;130
2004;"PIRACAIA (SP)";"SP";"PIRACAIA";379;33;20;432
2004;"PIRACICABA (SP)";"SP";"PIRACICABA";5467;517;954;6938
2004;"PIRAJU (SP)";"SP";"PIRAJU";351;31;63;445
2004;"PIRAJUI (SP)";"SP";"PIRAJUI";266;10;35;311
2004;"PIRANGI (SP)";"SP";"PIRANGI";353;16;44;413
2004;"PIRAPORA DO BOM JESUS (SP)";"SP";"PIRAPORA DO BOM JESUS";152;11;13;176
2004;"PIRAPOZINHO (SP)";"SP";"PIRAPOZINHO";366;15;21;402
2004;"PIRASSUNUNGA (SP)";"SP";"PIRASSUNUNGA";800;99;225;1124
2004;"PIRATININGA (SP)";"SP";"PIRATININGA";181;6;24;211
2004;"PITANGUEIRAS (SP)";"SP";"PITANGUEIRAS";599;18;160;777
2004;"PLANALTO (SP)";"SP";"PLANALTO";69;4;16;89
2004;"PLATINA (SP)";"SP";"PLATINA";36;1;5;42
2004;"POA (SP)";"SP";"POA";576;87;37;700
2004;"POLONI (SP)";"SP";"POLONI";115;5;26;146
2004;"POMPEIA (SP)";"SP";"POMPEIA";223;16;35;274
2004;"PONGAI (SP)";"SP";"PONGAI";36;2;11;49
2004;"PONTAL (SP)";"SP";"PONTAL";641;8;322;971
2004;"PONTALINDA (SP)";"SP";"PONTALINDA";31;2;16;49
2004;"PONTES GESTAL (SP)";"SP";"PONTES GESTAL";35;2;7;44
2004;"POPULINA (SP)";"SP";"POPULINA";60;7;13;80
2004;"PORANGABA (SP)";"SP";"PORANGABA";73;9;13;95
2004;"PORTO FELIZ (SP)";"SP";"PORTO FELIZ";942;38;105;1085
2004;"PORTO FERREIRA (SP)";"SP";"PORTO FERREIRA";739;39;123;901
2004;"POTIM (SP)";"SP";"POTIM";40;11;10;61
2004;"POTIRENDABA (SP)";"SP";"POTIRENDABA";335;13;31;379
2004;"PRACINHA (SP)";"SP";"PRACINHA";10;3;8;21
2004;"PRADOPOLIS (SP)";"SP";"PRADOPOLIS";302;20;99;421
2004;"PRAIA GRANDE (SP)";"SP";"PRAIA GRANDE";1265;155;299;1719
2004;"PRATANIA (SP)";"SP";"PRATANIA";71;4;11;86
2004;"PRESIDENTE ALVES (SP)";"SP";"PRESIDENTE ALVES";76;2;24;102
2004;"PRESIDENTE BERNARDES (SP)";"SP";"PRESIDENTE BERNARDES";179;9;19;207
2004;"PRESIDENTE EPITACIO (SP)";"SP";"PRESIDENTE EPITACIO";329;16;71;416
2004;"PRESIDENTE PRUDENTE (SP)";"SP";"PRESIDENTE PRUDENTE";3027;189;792;4008
2004;"PRESIDENTE VENCESLAU (SP)";"SP";"PRESIDENTE VENCESLAU";519;22;46;587
2004;"PROMISSAO (SP)";"SP";"PROMISSAO";560;19;139;718
2004;"QUADRA (SP)";"SP";"QUADRA";33;6;11;50
2004;"QUATA (SP)";"SP";"QUATA";126;6;42;174
2004;"QUEIROZ (SP)";"SP";"QUEIROZ";17;0;5;22
2004;"QUELUZ (SP)";"SP";"QUELUZ";97;8;6;111
2004;"QUINTANA (SP)";"SP";"QUINTANA";71;6;6;83
2004;"RAFARD (SP)";"SP";"RAFARD";203;11;14;228
2004;"RANCHARIA (SP)";"SP";"RANCHARIA";478;33;51;562
2004;"REDENCAO DA SERRA (SP)";"SP";"REDENCAO DA SERRA";33;5;15;53
2004;"REGENTE FEIJO (SP)";"SP";"REGENTE FEIJO";267;17;18;302
2004;"REGINOPOLIS (SP)";"SP";"REGINOPOLIS";70;0;16;86
2004;"REGISTRO (SP)";"SP";"REGISTRO";767;61;205;1033
2004;"RESTINGA (SP)";"SP";"RESTINGA";39;6;12;57
2004;"RIBEIRA (SP)";"SP";"RIBEIRA";22;4;7;33
2004;"RIBEIRAO BONITO (SP)";"SP";"RIBEIRAO BONITO";240;20;42;302
2004;"RIBEIRAO BRANCO (SP)";"SP";"RIBEIRAO BRANCO";123;9;21;153
2004;"RIBEIRAO CORRENTE (SP)";"SP";"RIBEIRAO CORRENTE";34;5;15;54
2004;"RIBEIRAO DO SUL (SP)";"SP";"RIBEIRAO DO SUL";93;4;10;107
2004;"RIBEIRAO DOS INDIOS (SP)";"SP";"RIBEIRAO DOS INDIOS";18;1;6;25
2004;"RIBEIRAO GRANDE (SP)";"SP";"RIBEIRAO GRANDE";54;7;9;70
2004;"RIBEIRAO PIRES (SP)";"SP";"RIBEIRAO PIRES";941;225;249;1415
2004;"RIBEIRAO PRETO (SP)";"SP";"RIBEIRAO PRETO";6771;638;1208;8617
2004;"RIFAINA (SP)";"SP";"RIFAINA";25;3;6;34
2004;"RINCAO (SP)";"SP";"RINCAO";159;7;30;196
2004;"RINOPOLIS (SP)";"SP";"RINOPOLIS";152;6;32;190
2004;"RIO CLARO (SP)";"SP";"RIO CLARO";2411;190;365;2966
2004;"RIO DAS PEDRAS (SP)";"SP";"RIO DAS PEDRAS";595;33;112;740
2004;"RIO GRANDE DA SERRA (SP)";"SP";"RIO GRANDE DA SERRA";191;36;20;247
2004;"RIOLANDIA (SP)";"SP";"RIOLANDIA";77;4;27;108
2004;"RIVERSUL (SP)";"SP";"RIVERSUL";52;1;12;65
2004;"ROSANA (SP)";"SP";"ROSANA";119;6;42;167
2004;"ROSEIRA (SP)";"SP";"ROSEIRA";100;20;10;130
2004;"RUBIACEA (SP)";"SP";"RUBIACEA";20;2;14;36
2004;"RUBINEIA (SP)";"SP";"RUBINEIA";13;2;6;21
2004;"SABINO (SP)";"SP";"SABINO";42;4;6;52
2004;"SAGRES (SP)";"SP";"SAGRES";11;2;4;17
2004;"SALES (SP)";"SP";"SALES";64;1;16;81
2004;"SALES OLIVEIRA (SP)";"SP";"SALES OLIVEIRA";194;8;31;233
2004;"SALESOPOLIS (SP)";"SP";"SALESOPOLIS";473;25;39;537
2004;"SALMORAO (SP)";"SP";"SALMORAO";20;2;17;39
2004;"SALTINHO (SP)";"SP";"SALTINHO";272;4;6;282
2004;"SALTO (SP)";"SP";"SALTO";1343;121;160;1624
2004;"SALTO DE PIRAPORA (SP)";"SP";"SALTO DE PIRAPORA";453;21;44;518
2004;"SALTO GRANDE (SP)";"SP";"SALTO GRANDE";105;6;14;125
2004;"SANDOVALINA (SP)";"SP";"SANDOVALINA";18;3;6;27
2004;"SANTA ADELIA (SP)";"SP";"SANTA ADELIA";512;15;67;594
2004;"SANTA ALBERTINA (SP)";"SP";"SANTA ALBERTINA";73;3;7;83
2004;"SANTA BARBARA D OESTE (SP)";"SP";"SANTA BARBARA D OESTE";1927;267;176;2370
2004;"SANTA BRANCA (SP)";"SP";"SANTA BRANCA";65;10;46;121
2004;"SANTA CLARA D OESTE (SP)";"SP";"SANTA CLARA D OESTE";15;0;2;17
2004;"SANTA CRUZ DA CONCEICAO (SP)";"SP";"SANTA CRUZ DA CONCEICAO";104;6;13;123
2004;"SANTA CRUZ DA ESPERANCA (SP)";"SP";"SANTA CRUZ DA ESPERANCA";14;0;4;18
2004;"SANTA CRUZ DAS PALMEIRAS (SP)";"SP";"SANTA CRUZ DAS PALMEIRAS";644;17;170;831
2004;"SANTA CRUZ DO RIO PARDO (SP)";"SP";"SANTA CRUZ DO RIO PARDO";958;49;63;1070
2004;"SANTA ERNESTINA (SP)";"SP";"SANTA ERNESTINA";71;3;21;95
2004;"SANTA FE DO SUL (SP)";"SP";"SANTA FE DO SUL";547;8;39;594
2004;"SANTA GERTRUDES (SP)";"SP";"SANTA GERTRUDES";345;15;22;382
2004;"SANTA ISABEL (SP)";"SP";"SANTA ISABEL";580;47;36;663
2004;"SANTA LUCIA (SP)";"SP";"SANTA LUCIA";114;8;41;163
2004;"SANTA MARIA DA SERRA (SP)";"SP";"SANTA MARIA DA SERRA";151;17;14;182
2004;"SANTA MERCEDES (SP)";"SP";"SANTA MERCEDES";25;4;5;34
2004;"SANTA RITA D OESTE (SP)";"SP";"SANTA RITA D OESTE";27;0;4;31
2004;"SANTA RITA DO PASSA QUATRO (SP)";"SP";"SANTA RITA DO PASSA QUATRO";488;38;29;555
2004;"SANTA ROSA DE VITERBO (SP)";"SP";"SANTA ROSA DE VITERBO";317;27;72;416
2004;"SANTA SALETE (SP)";"SP";"SANTA SALETE";39;1;3;43
2004;"SANTANA DA PONTE PENSA (SP)";"SP";"SANTANA DA PONTE PENSA";27;1;0;28
2004;"SANTANA DE PARNAIBA (SP)";"SP";"SANTANA DE PARNAIBA";1115;144;68;1327
2004;"SANTO ANASTACIO (SP)";"SP";"SANTO ANASTACIO";367;10;40;417
2004;"SANTO ANDRE (SP)";"SP";"SANTO ANDRE";6992;1336;1319;9647
2004;"SANTO ANTONIO DA ALEGRIA (SP)";"SP";"SANTO ANTONIO DA ALEGRIA";74;5;14;93
2004;"SANTO ANTONIO DE POSSE (SP)";"SP";"SANTO ANTONIO DE POSSE";502;23;76;601
2004;"SANTO ANTONIO DO ARACANGUA (SP)";"SP";"SANTO ANTONIO DO ARACANGUA";131;5;41;177
2004;"SANTO ANTONIO DO JARDIM (SP)";"SP";"SANTO ANTONIO DO JARDIM";146;12;8;166
2004;"SANTO ANTONIO DO PINHAL (SP)";"SP";"SANTO ANTONIO DO PINHAL";82;6;4;92
2004;"SANTO EXPEDITO (SP)";"SP";"SANTO EXPEDITO";16;1;5;22
2004;"SANTOPOLIS DO AGUAPEI (SP)";"SP";"SANTOPOLIS DO AGUAPEI";63;3;26;92
2004;"SANTOS (SP)";"SP";"SANTOS";3692;615;522;4829
2004;"SAO BENTO DO SAPUCAI (SP)";"SP";"SAO BENTO DO SAPUCAI";93;24;6;123
2004;"SAO BERNARDO DO CAMPO (SP)";"SP";"SAO BERNARDO DO CAMPO";8771;1426;1956;12153
2004;"SAO CAETANO DO SUL (SP)";"SP";"SAO CAETANO DO SUL";2344;377;383;3104
2004;"SAO CARLOS (SP)";"SP";"SAO CARLOS";2721;234;313;3268
2004;"SAO FRANCISCO (SP)";"SP";"SAO FRANCISCO";27;2;7;36
2004;"SAO JOAO DA BOA VISTA (SP)";"SP";"SAO JOAO DA BOA VISTA";1581;97;71;1749
2004;"SAO JOAO DAS DUAS PONTES (SP)";"SP";"SAO JOAO DAS DUAS PONTES";16;3;6;25
2004;"SAO JOAO DE IRACEMA (SP)";"SP";"SAO JOAO DE IRACEMA";12;1;8;21
2004;"SAO JOAO DO PAU D ALHO (SP)";"SP";"SAO JOAO DO PAU D ALHO";34;5;3;42
2004;"SAO JOAQUIM DA BARRA (SP)";"SP";"SAO JOAQUIM DA BARRA";731;34;118;883
2004;"SAO JOSE DA BELA VISTA (SP)";"SP";"SAO JOSE DA BELA VISTA";61;4;27;92
2004;"SAO JOSE DO BARREIRO (SP)";"SP";"SAO JOSE DO BARREIRO";30;2;3;35
2004;"SAO JOSE DO RIO PARDO (SP)";"SP";"SAO JOSE DO RIO PARDO";1044;44;122;1210
2004;"SAO JOSE DO RIO PRETO (SP)";"SP";"SAO JOSE DO RIO PRETO";5228;373;864;6465
2004;"SAO JOSE DOS CAMPOS (SP)";"SP";"SAO JOSE DOS CAMPOS";4297;1047;966;6310
2004;"SAO LOURENCO DA SERRA (SP)";"SP";"SAO LOURENCO DA SERRA";151;12;16;179
2004;"SAO LUIS DO PARAITINGA (SP)";"SP";"SAO LUIS DO PARAITINGA";105;10;13;128
2004;"SAO MANUEL (SP)";"SP";"SAO MANUEL";625;36;76;737
2004;"SAO MIGUEL ARCANJO (SP)";"SP";"SAO MIGUEL ARCANJO";534;33;32;599
2004;"SAO PAULO (SP)";"SP";"SAO PAULO";118576;26383;33912;178871
2004;"SAO PEDRO (SP)";"SP";"SAO PEDRO";438;46;63;547
2004;"SAO PEDRO DO TURVO (SP)";"SP";"SAO PEDRO DO TURVO";121;8;16;145
2004;"SAO ROQUE (SP)";"SP";"SAO ROQUE";696;86;140;922
2004;"SAO SEBASTIAO (SP)";"SP";"SAO SEBASTIAO";410;49;89;548
2004;"SAO SEBASTIAO DA GRAMA (SP)";"SP";"SAO SEBASTIAO DA GRAMA";202;9;25;236
2004;"SAO SIMAO (SP)";"SP";"SAO SIMAO";246;11;34;291
2004;"SAO VICENTE (SP)";"SP";"SAO VICENTE";1233;631;382;2246
2004;"SARAPUI (SP)";"SP";"SARAPUI";99;5;7;111
2004;"SARUTAIA (SP)";"SP";"SARUTAIA";34;9;8;51
2004;"SEBASTIANOPOLIS DO SUL (SP)";"SP";"SEBASTIANOPOLIS DO SUL";53;3;7;63
2004;"SERRA AZUL (SP)";"SP";"SERRA AZUL";104;10;41;155
2004;"SERRA NEGRA (SP)";"SP";"SERRA NEGRA";312;31;43;386
2004;"SERRANA (SP)";"SP";"SERRANA";480;86;140;706
2004;"SERTAOZINHO (SP)";"SP";"SERTAOZINHO";1908;82;285;2275
2004;"SETE BARRAS (SP)";"SP";"SETE BARRAS";153;5;23;181
2004;"SEVERINIA (SP)";"SP";"SEVERINIA";292;6;113;411
2004;"SILVEIRAS (SP)";"SP";"SILVEIRAS";66;6;4;76
2004;"SOCORRO (SP)";"SP";"SOCORRO";543;62;32;637
2004;"SOROCABA (SP)";"SP";"SOROCABA";5603;820;995;7418
2004;"SUD MENUCCI (SP)";"SP";"SUD MENUCCI";111;6;34;151
2004;"SUMARE (SP)";"SP";"SUMARE";1745;373;308;2426
2004;"SUZANO (SP)";"SP";"SUZANO";2120;233;267;2620
2004;"SUZANOPOLIS (SP)";"SP";"SUZANOPOLIS";45;4;9;58
2004;"TABAPUA (SP)";"SP";"TABAPUA";131;10;35;176
2004;"TABATINGA (SP)";"SP";"TABATINGA";325;9;87;421
2004;"TABOAO DA SERRA (SP)";"SP";"TABOAO DA SERRA";1383;448;369;2200
2004;"TACIBA (SP)";"SP";"TACIBA";56;2;6;64
2004;"TAGUAI (SP)";"SP";"TAGUAI";123;3;16;142
2004;"TAIACU (SP)";"SP";"TAIACU";138;4;13;155
2004;"TAIUVA (SP)";"SP";"TAIUVA";152;2;23;177
2004;"TAMBAU (SP)";"SP";"TAMBAU";442;22;45;509
2004;"TANABI (SP)";"SP";"TANABI";360;13;58;431
2004;"TAPIRAI (SP)";"SP";"TAPIRAI";134;7;8;149
2004;"TAPIRATIBA (SP)";"SP";"TAPIRATIBA";234;9;40;283
2004;"TAQUARAL (SP)";"SP";"TAQUARAL";43;3;16;62
2004;"TAQUARITINGA (SP)";"SP";"TAQUARITINGA";1322;27;210;1559
2004;"TAQUARITUBA (SP)";"SP";"TAQUARITUBA";471;20;47;538
2004;"TAQUARIVAI (SP)";"SP";"TAQUARIVAI";45;4;7;56
2004;"TARABAI (SP)";"SP";"TARABAI";80;2;17;99
2004;"TARUMA (SP)";"SP";"TARUMA";216;11;105;332
2004;"TATUI (SP)";"SP";"TATUI";1312;77;293;1682
2004;"TAUBATE (SP)";"SP";"TAUBATE";2123;459;612;3194
2004;"TEJUPA (SP)";"SP";"TEJUPA";38;5;3;46
2004;"TEODORO SAMPAIO (SP)";"SP";"TEODORO SAMPAIO";155;7;27;189
2004;"TERRA ROXA (SP)";"SP";"TERRA ROXA";165;8;37;210
2004;"TIETE (SP)";"SP";"TIETE";943;29;116;1088
2004;"TIMBURI (SP)";"SP";"TIMBURI";23;3;6;32
2004;"TORRE DE PEDRA (SP)";"SP";"TORRE DE PEDRA";45;1;3;49
2004;"TORRINHA (SP)";"SP";"TORRINHA";307;10;29;346
2004;"TRABIJU (SP)";"SP";"TRABIJU";23;11;9;43
2004;"TREMEMBE (SP)";"SP";"TREMEMBE";302;40;10;352
2004;"TRES FRONTEIRAS (SP)";"SP";"TRES FRONTEIRAS";62;2;5;69
2004;"TUIUTI (SP)";"SP";"TUIUTI";55;8;8;71
2004;"TUPA (SP)";"SP";"TUPA";1125;27;165;1317
2004;"TUPI PAULISTA (SP)";"SP";"TUPI PAULISTA";252;9;14;275
2004;"TURIUBA (SP)";"SP";"TURIUBA";14;3;1;18
2004;"TURMALINA (SP)";"SP";"TURMALINA";37;3;5;45
2004;"UBARANA (SP)";"SP";"UBARANA";70;2;15;87
2004;"UBATUBA (SP)";"SP";"UBATUBA";517;55;71;643
2004;"UBIRAJARA (SP)";"SP";"UBIRAJARA";67;6;8;81
2004;"UCHOA (SP)";"SP";"UCHOA";127;3;27;157
2004;"UNIAO PAULISTA (SP)";"SP";"UNIAO PAULISTA";18;2;5;25
2004;"URANIA (SP)";"SP";"URANIA";123;8;18;149
2004;"URU (SP)";"SP";"URU";14;4;4;22
2004;"URUPES (SP)";"SP";"URUPES";310;11;38;359
2004;"VALENTIM GENTIL (SP)";"SP";"VALENTIM GENTIL";143;13;19;175
2004;"VALINHOS (SP)";"SP";"VALINHOS";1603;300;746;2649
2004;"VALPARAISO (SP)";"SP";"VALPARAISO";257;17;91;365
2004;"VARGEM (SP)";"SP";"VARGEM";149;7;13;169
2004;"VARGEM GRANDE DO SUL (SP)";"SP";"VARGEM GRANDE DO SUL";841;43;118;1002
2004;"VARGEM GRANDE PAULISTA (SP)";"SP";"VARGEM GRANDE PAULISTA";661;66;37;764
2004;"VARZEA PAULISTA (SP)";"SP";"VARZEA PAULISTA";693;169;118;980
2004;"VERA CRUZ (SP)";"SP";"VERA CRUZ";129;14;14;157
2004;"VINHEDO (SP)";"SP";"VINHEDO";913;105;61;1079
2004;"VIRADOURO (SP)";"SP";"VIRADOURO";335;11;52;398
2004;"VISTA ALEGRE DO ALTO (SP)";"SP";"VISTA ALEGRE DO ALTO";264;15;39;318
2004;"VITORIA BRASIL (SP)";"SP";"VITORIA BRASIL";14;0;5;19
2004;"VOTORANTIM (SP)";"SP";"VOTORANTIM";868;162;37;1067
2004;"VOTUPORANGA (SP)";"SP";"VOTUPORANGA";1346;39;128;1513
2004;"ZACARIAS (SP)";"SP";"ZACARIAS";27;6;10;43
2004;"ABREULANDIA (TO)";"TO";"ABREULANDIA";13;0;0;13
2004;"AGUIARNOPOLIS (TO)";"TO";"AGUIARNOPOLIS";15;2;3;20
2004;"ALIANCA DO TOCANTINS (TO)";"TO";"ALIANCA DO TOCANTINS";57;3;2;62
2004;"ALMAS (TO)";"TO";"ALMAS";22;0;1;23
2004;"ALVORADA (TO)";"TO";"ALVORADA";105;0;5;110
2004;"ANANAS (TO)";"TO";"ANANAS";35;4;8;47
2004;"ANGICO (TO)";"TO";"ANGICO";5;1;0;6
2004;"APARECIDA DO RIO NEGRO (TO)";"TO";"APARECIDA DO RIO NEGRO";15;1;2;18
2004;"ARAGOMINAS (TO)";"TO";"ARAGOMINAS";180;6;3;189
2004;"ARAGUACEMA (TO)";"TO";"ARAGUACEMA";12;1;4;17
2004;"ARAGUACU (TO)";"TO";"ARAGUACU";58;3;2;63
2004;"ARAGUAINA (TO)";"TO";"ARAGUAINA";2323;81;209;2613
2004;"ARAGUANA (TO)";"TO";"ARAGUANA";179;4;2;185
2004;"ARAGUATINS (TO)";"TO";"ARAGUATINS";135;24;43;202
2004;"ARAPOEMA (TO)";"TO";"ARAPOEMA";35;0;5;40
2004;"ARRAIAS (TO)";"TO";"ARRAIAS";21;0;4;25
2004;"AUGUSTINOPOLIS (TO)";"TO";"AUGUSTINOPOLIS";57;31;3;91
2004;"AURORA DO TOCANTINS (TO)";"TO";"AURORA DO TOCANTINS";1;0;1;2
2004;"AXIXA DO TOCANTINS (TO)";"TO";"AXIXA DO TOCANTINS";14;15;4;33
2004;"BABACULANDIA (TO)";"TO";"BABACULANDIA";237;10;7;254
2004;"BANDEIRANTES DO TOCANTINS (TO)";"TO";"BANDEIRANTES DO TOCANTINS";14;2;2;18
2004;"BARRA DO OURO (TO)";"TO";"BARRA DO OURO";2;0;1;3
2004;"BARROLANDIA (TO)";"TO";"BARROLANDIA";29;1;2;32
2004;"BERNARDO SAYAO (TO)";"TO";"BERNARDO SAYAO";23;2;4;29
2004;"BOM JESUS DO TOCANTINS (TO)";"TO";"BOM JESUS DO TOCANTINS";0;2;0;2
2004;"BRASILANDIA DO TOCANTINS (TO)";"TO";"BRASILANDIA DO TOCANTINS";8;1;1;10
2004;"BREJINHO DE NAZARE (TO)";"TO";"BREJINHO DE NAZARE";25;0;2;27
2004;"BURITI DO TOCANTINS (TO)";"TO";"BURITI DO TOCANTINS";10;7;1;18
2004;"CACHOEIRINHA (TO)";"TO";"CACHOEIRINHA";3;1;1;5
2004;"CAMPOS LINDOS (TO)";"TO";"CAMPOS LINDOS";26;0;1;27
2004;"CARIRI DO TOCANTINS (TO)";"TO";"CARIRI DO TOCANTINS";25;1;2;28
2004;"CARMOLANDIA (TO)";"TO";"CARMOLANDIA";543;32;23;598
2004;"CARRASCO BONITO (TO)";"TO";"CARRASCO BONITO";3;3;1;7
2004;"CASEARA (TO)";"TO";"CASEARA";11;3;2;16
2004;"CENTENARIO (TO)";"TO";"CENTENARIO";2;0;0;2
2004;"CHAPADA DA NATIVIDADE (TO)";"TO";"CHAPADA DA NATIVIDADE";12;0;3;15
2004;"CHAPADA DE AREIA (TO)";"TO";"CHAPADA DE AREIA";1;0;2;3
2004;"COLINAS DO TOCANTINS (TO)";"TO";"COLINAS DO TOCANTINS";360;14;22;396
2004;"COLMEIA (TO)";"TO";"COLMEIA";92;6;7;105
2004;"COMBINADO (TO)";"TO";"COMBINADO";7;1;3;11
2004;"CONCEICAO DO TOCANTINS (TO)";"TO";"CONCEICAO DO TOCANTINS";5;1;0;6
2004;"COUTO DE MAGALHAES (TO)";"TO";"COUTO DE MAGALHAES";5;4;0;9
2004;"CRISTALANDIA (TO)";"TO";"CRISTALANDIA";66;0;2;68
2004;"CRIXAS DO TOCANTINS (TO)";"TO";"CRIXAS DO TOCANTINS";3;4;0;7
2004;"DARCINOPOLIS (TO)";"TO";"DARCINOPOLIS";153;21;3;177
2004;"DIANOPOLIS (TO)";"TO";"DIANOPOLIS";64;0;15;79
2004;"DIVINOPOLIS DO TOCANTINS (TO)";"TO";"DIVINOPOLIS DO TOCANTINS";37;1;2;40
2004;"DOIS IRMAOS DO TOCANTINS (TO)";"TO";"DOIS IRMAOS DO TOCANTINS";26;1;2;29
2004;"DUERE (TO)";"TO";"DUERE";19;1;2;22
2004;"ESPERANTINA (TO)";"TO";"ESPERANTINA";9;5;1;15
2004;"FATIMA (TO)";"TO";"FATIMA";18;2;3;23
2004;"FIGUEIROPOLIS (TO)";"TO";"FIGUEIROPOLIS";35;4;2;41
2004;"FILADELFIA (TO)";"TO";"FILADELFIA";25;7;4;36
2004;"FORMOSO DO ARAGUAIA (TO)";"TO";"FORMOSO DO ARAGUAIA";99;2;15;116
2004;"FORTALEZA DO TABOCAO (TO)";"TO";"FORTALEZA DO TABOCAO";17;4;1;22
2004;"GOIANORTE (TO)";"TO";"GOIANORTE";10;1;3;14
2004;"GOIATINS (TO)";"TO";"GOIATINS";7;3;1;11
2004;"GUARAI (TO)";"TO";"GUARAI";228;7;9;244
2004;"GURUPI (TO)";"TO";"GURUPI";1010;26;98;1134
2004;"IPUEIRAS (TO)";"TO";"IPUEIRAS";0;0;2;2
2004;"ITACAJA (TO)";"TO";"ITACAJA";17;1;0;18
2004;"ITAGUATINS (TO)";"TO";"ITAGUATINS";17;2;1;20
2004;"ITAPIRATINS (TO)";"TO";"ITAPIRATINS";5;0;5;10
2004;"ITAPORA DO TOCANTINS (TO)";"TO";"ITAPORA DO TOCANTINS";9;1;1;11
2004;"JAU DO TOCANTINS (TO)";"TO";"JAU DO TOCANTINS";9;0;4;13
2004;"JUARINA (TO)";"TO";"JUARINA";9;1;0;10
2004;"LAGOA DA CONFUSAO (TO)";"TO";"LAGOA DA CONFUSAO";35;1;2;38
2004;"LAGOA DO TOCANTINS (TO)";"TO";"LAGOA DO TOCANTINS";5;0;2;7
2004;"LAJEADO (TO)";"TO";"LAJEADO";9;0;9;18
2004;"LAVANDEIRA (TO)";"TO";"LAVANDEIRA";0;1;1;2
2004;"LIZARDA (TO)";"TO";"LIZARDA";3;1;0;4
2004;"LUZINOPOLIS (TO)";"TO";"LUZINOPOLIS";4;1;0;5
2004;"MARIANOPOLIS DO TOCANTINS (TO)";"TO";"MARIANOPOLIS DO TOCANTINS";18;0;3;21
2004;"MATEIROS (TO)";"TO";"MATEIROS";7;0;2;9
2004;"MAURILANDIA DO TOCANTINS (TO)";"TO";"MAURILANDIA DO TOCANTINS";2;0;1;3
2004;"MIRACEMA DO TOCANTINS (TO)";"TO";"MIRACEMA DO TOCANTINS";118;9;34;161
2004;"MIRANORTE (TO)";"TO";"MIRANORTE";132;7;5;144
2004;"MONTE DO CARMO (TO)";"TO";"MONTE DO CARMO";6;0;2;8
2004;"MONTE SANTO DO TOCANTINS (TO)";"TO";"MONTE SANTO DO TOCANTINS";54;2;2;58
2004;"MURICILANDIA (TO)";"TO";"MURICILANDIA";14;0;0;14
2004;"NATIVIDADE (TO)";"TO";"NATIVIDADE";31;1;1;33
2004;"NAZARE (TO)";"TO";"NAZARE";11;2;1;14
2004;"NOVA OLINDA (TO)";"TO";"NOVA OLINDA";38;4;5;47
2004;"NOVA ROSALANDIA (TO)";"TO";"NOVA ROSALANDIA";13;0;3;16
2004;"NOVO ACORDO (TO)";"TO";"NOVO ACORDO";14;0;1;15
2004;"NOVO ALEGRE (TO)";"TO";"NOVO ALEGRE";3;2;0;5
2004;"NOVO JARDIM (TO)";"TO";"NOVO JARDIM";5;0;1;6
2004;"OLIVEIRA DE FATIMA (TO)";"TO";"OLIVEIRA DE FATIMA";4;0;2;6
2004;"PALMAS (TO)";"TO";"PALMAS";1997;145;362;2504
2004;"PALMEIRANTE (TO)";"TO";"PALMEIRANTE";3;1;1;5
2004;"PALMEIRAS DO TOCANTINS (TO)";"TO";"PALMEIRAS DO TOCANTINS";17;1;1;19
2004;"PALMEIROPOLIS (TO)";"TO";"PALMEIROPOLIS";43;2;7;52
2004;"PARAISO DO TOCANTINS (TO)";"TO";"PARAISO DO TOCANTINS";731;21;66;818
2004;"PARANA (TO)";"TO";"PARANA";2;2;1;5
2004;"PAU D ARCO (TO)";"TO";"PAU D ARCO";7;1;1;9
2004;"PEDRO AFONSO (TO)";"TO";"PEDRO AFONSO";60;1;7;68
2004;"PEIXE (TO)";"TO";"PEIXE";43;4;51;98
2004;"PEQUIZEIRO (TO)";"TO";"PEQUIZEIRO";14;0;3;17
2004;"PINDORAMA DO TOCANTINS (TO)";"TO";"PINDORAMA DO TOCANTINS";13;0;2;15
2004;"PIRAQUE (TO)";"TO";"PIRAQUE";6;0;2;8
2004;"PIUM (TO)";"TO";"PIUM";18;1;3;22
2004;"PONTE ALTA DO BOM JESUS (TO)";"TO";"PONTE ALTA DO BOM JESUS";3;0;0;3
2004;"PONTE ALTA DO TOCANTINS (TO)";"TO";"PONTE ALTA DO TOCANTINS";11;4;3;18
2004;"PORTO ALEGRE DO TOCANTINS (TO)";"TO";"PORTO ALEGRE DO TOCANTINS";4;0;2;6
2004;"PORTO NACIONAL (TO)";"TO";"PORTO NACIONAL";434;13;74;521
2004;"PRAIA NORTE (TO)";"TO";"PRAIA NORTE";4;4;0;8
2004;"PRESIDENTE KENNEDY (TO)";"TO";"PRESIDENTE KENNEDY";12;0;1;13
2004;"PUGMIL (TO)";"TO";"PUGMIL";16;3;0;19
2004;"RECURSOLANDIA (TO)";"TO";"RECURSOLANDIA";6;0;0;6
2004;"RIACHINHO (TO)";"TO";"RIACHINHO";107;3;8;118
2004;"RIO DA CONCEICAO (TO)";"TO";"RIO DA CONCEICAO";1;1;1;3
2004;"RIO DOS BOIS (TO)";"TO";"RIO DOS BOIS";5;1;1;7
2004;"RIO SONO (TO)";"TO";"RIO SONO";13;1;2;16
2004;"SAMPAIO (TO)";"TO";"SAMPAIO";14;2;1;17
2004;"SANDOLANDIA (TO)";"TO";"SANDOLANDIA";5;1;1;7
2004;"SANTA FE DO ARAGUAIA (TO)";"TO";"SANTA FE DO ARAGUAIA";29;19;1;49
2004;"SANTA MARIA DO TOCANTINS (TO)";"TO";"SANTA MARIA DO TOCANTINS";2;1;0;3
2004;"SANTA RITA DO TOCANTINS (TO)";"TO";"SANTA RITA DO TOCANTINS";9;0;0;9
2004;"SANTA ROSA DO TOCANTINS (TO)";"TO";"SANTA ROSA DO TOCANTINS";11;1;2;14
2004;"SANTA TEREZA DO TOCANTINS (TO)";"TO";"SANTA TEREZA DO TOCANTINS";3;1;0;4
2004;"SANTA TEREZINHA DO TOCANTINS (TO)";"TO";"SANTA TEREZINHA DO TOCANTINS";5;1;2;8
2004;"SAO BENTO DO TOCANTINS (TO)";"TO";"SAO BENTO DO TOCANTINS";3;1;2;6
2004;"SAO FELIX DO TOCANTINS (TO)";"TO";"SAO FELIX DO TOCANTINS";0;0;0;0
2004;"SAO MIGUEL DO TOCANTINS (TO)";"TO";"SAO MIGUEL DO TOCANTINS";11;5;1;17
2004;"SAO SALVADOR DO TOCANTINS (TO)";"TO";"SAO SALVADOR DO TOCANTINS";12;0;0;12
2004;"SAO SEBASTIAO DO TOCANTINS (TO)";"TO";"SAO SEBASTIAO DO TOCANTINS";5;2;1;8
2004;"SAO VALERIO DA NATIVIDADE (TO)";"TO";"SAO VALERIO DA NATIVIDADE";24;2;3;29
2004;"SILVANOPOLIS (TO)";"TO";"SILVANOPOLIS";13;0;0;13
2004;"SITIO NOVO DO TOCANTINS (TO)";"TO";"SITIO NOVO DO TOCANTINS";22;4;3;29
2004;"SUCUPIRA (TO)";"TO";"SUCUPIRA";4;0;3;7
2004;"TAGUATINGA (TO)";"TO";"TAGUATINGA";39;2;6;47
2004;"TAIPAS DO TOCANTINS (TO)";"TO";"TAIPAS DO TOCANTINS";4;1;0;5
2004;"TALISMA (TO)";"TO";"TALISMA";6;5;0;11
2004;"TOCANTINIA (TO)";"TO";"TOCANTINIA";12;1;1;14
2004;"TOCANTINOPOLIS (TO)";"TO";"TOCANTINOPOLIS";1366;236;153;1755
2004;"TUPIRAMA (TO)";"TO";"TUPIRAMA";4;2;0;6
2004;"TUPIRATINS (TO)";"TO";"TUPIRATINS";5;0;1;6
2004;"WANDERLANDIA (TO)";"TO";"WANDERLANDIA";30;4;4;38
2004;"XAMBIOA (TO)";"TO";"XAMBIOA";43;3;1;47
