"ano";"chave";"UF";"MUNICIPIO";"CAMINHAO";"MICRO_ONIBUS";"ONIBUS";"total"
2015;"ACRELANDIA (AC)";"AC";"ACRELANDIA";230;7;44;281
2015;"ASSIS BRASIL (AC)";"AC";"ASSIS BRASIL";22;2;3;27
2015;"BRASILEIA (AC)";"AC";"BRASILEIA";218;3;13;234
2015;"BUJARI (AC)";"AC";"BUJARI";102;3;11;116
2015;"CAPIXABA (AC)";"AC";"CAPIXABA";76;1;12;89
2015;"CRUZEIRO DO SUL (AC)";"AC";"CRUZEIRO DO SUL";698;58;68;824
2015;"EPITACIOLANDIA (AC)";"AC";"EPITACIOLANDIA";207;2;14;223
2015;"FEIJO (AC)";"AC";"FEIJO";111;2;6;119
2015;"JORDAO (AC)";"AC";"JORDAO";3;0;0;3
2015;"MANCIO LIMA (AC)";"AC";"MANCIO LIMA";79;3;9;91
2015;"MANOEL URBANO (AC)";"AC";"MANOEL URBANO";25;1;5;31
2015;"MARECHAL THAUMATURGO (AC)";"AC";"MARECHAL THAUMATURGO";10;0;5;15
2015;"PLACIDO DE CASTRO (AC)";"AC";"PLACIDO DE CASTRO";142;3;17;162
2015;"PORTO ACRE (AC)";"AC";"PORTO ACRE";154;1;30;185
2015;"PORTO WALTER (AC)";"AC";"PORTO WALTER";8;0;3;11
2015;"RIO BRANCO (AC)";"AC";"RIO BRANCO";4102;218;730;5050
2015;"RODRIGUES ALVES (AC)";"AC";"RODRIGUES ALVES";15;0;7;22
2015;"SANTA ROSA DO PURUS (AC)";"AC";"SANTA ROSA DO PURUS";4;0;3;7
2015;"SENA MADUREIRA (AC)";"AC";"SENA MADUREIRA";96;3;8;107
2015;"SENADOR GUIOMARD (AC)";"AC";"SENADOR GUIOMARD";340;9;27;376
2015;"TARAUACA (AC)";"AC";"TARAUACA";138;21;24;183
2015;"XAPURI (AC)";"AC";"XAPURI";68;4;5;77
2015;"AGUA BRANCA (AL)";"AL";"AGUA BRANCA";69;69;11;149
2015;"ANADIA (AL)";"AL";"ANADIA";46;44;40;130
2015;"ARAPIRACA (AL)";"AL";"ARAPIRACA";2894;401;343;3638
2015;"ATALAIA (AL)";"AL";"ATALAIA";199;49;135;383
2015;"BARRA DE SANTO ANTONIO (AL)";"AL";"BARRA DE SANTO ANTONIO";29;5;22;56
2015;"BARRA DE SAO MIGUEL (AL)";"AL";"BARRA DE SAO MIGUEL";29;3;7;39
2015;"BATALHA (AL)";"AL";"BATALHA";104;37;10;151
2015;"BELEM (AL)";"AL";"BELEM";11;21;6;38
2015;"BELO MONTE (AL)";"AL";"BELO MONTE";35;11;7;53
2015;"BOCA DA MATA (AL)";"AL";"BOCA DA MATA";220;73;98;391
2015;"BRANQUINHA (AL)";"AL";"BRANQUINHA";31;18;19;68
2015;"CACIMBINHAS (AL)";"AL";"CACIMBINHAS";59;44;12;115
2015;"CAJUEIRO (AL)";"AL";"CAJUEIRO";85;9;47;141
2015;"CAMPESTRE (AL)";"AL";"CAMPESTRE";28;52;8;88
2015;"CAMPO ALEGRE (AL)";"AL";"CAMPO ALEGRE";130;110;122;362
2015;"CAMPO GRANDE (AL)";"AL";"CAMPO GRANDE";43;19;19;81
2015;"CANAPI (AL)";"AL";"CANAPI";42;38;19;99
2015;"CAPELA (AL)";"AL";"CAPELA";64;6;53;123
2015;"CARNEIROS (AL)";"AL";"CARNEIROS";35;9;5;49
2015;"CHA PRETA (AL)";"AL";"CHA PRETA";28;6;6;40
2015;"COITE DO NOIA (AL)";"AL";"COITE DO NOIA";60;8;25;93
2015;"COLONIA LEOPOLDINA (AL)";"AL";"COLONIA LEOPOLDINA";70;25;32;127
2015;"COQUEIRO SECO (AL)";"AL";"COQUEIRO SECO";9;3;8;20
2015;"CORURIPE (AL)";"AL";"CORURIPE";341;78;221;640
2015;"CRAIBAS (AL)";"AL";"CRAIBAS";132;34;26;192
2015;"DELMIRO GOUVEIA (AL)";"AL";"DELMIRO GOUVEIA";536;387;61;984
2015;"DOIS RIACHOS (AL)";"AL";"DOIS RIACHOS";74;14;12;100
2015;"ESTRELA DE ALAGOAS (AL)";"AL";"ESTRELA DE ALAGOAS";49;95;25;169
2015;"FEIRA GRANDE (AL)";"AL";"FEIRA GRANDE";78;2;44;124
2015;"FELIZ DESERTO (AL)";"AL";"FELIZ DESERTO";10;4;11;25
2015;"FLEXEIRAS (AL)";"AL";"FLEXEIRAS";31;19;40;90
2015;"GIRAU DO PONCIANO (AL)";"AL";"GIRAU DO PONCIANO";188;58;65;311
2015;"IBATEGUARA (AL)";"AL";"IBATEGUARA";41;58;17;116
2015;"IGACI (AL)";"AL";"IGACI";113;112;39;264
2015;"IGREJA NOVA (AL)";"AL";"IGREJA NOVA";83;26;93;202
2015;"INHAPI (AL)";"AL";"INHAPI";70;21;7;98
2015;"JACARE DOS HOMENS (AL)";"AL";"JACARE DOS HOMENS";35;6;12;53
2015;"JACUIPE (AL)";"AL";"JACUIPE";11;12;16;39
2015;"JAPARATINGA (AL)";"AL";"JAPARATINGA";14;26;11;51
2015;"JARAMATAIA (AL)";"AL";"JARAMATAIA";27;10;7;44
2015;"JEQUIA DA PRAIA (AL)";"AL";"JEQUIA DA PRAIA";40;8;37;85
2015;"JOAQUIM GOMES (AL)";"AL";"JOAQUIM GOMES";101;27;75;203
2015;"JUNDIA (AL)";"AL";"JUNDIA";16;5;13;34
2015;"JUNQUEIRO (AL)";"AL";"JUNQUEIRO";194;33;110;337
2015;"LAGOA DA CANOA (AL)";"AL";"LAGOA DA CANOA";99;21;30;150
2015;"LIMOEIRO DE ANADIA (AL)";"AL";"LIMOEIRO DE ANADIA";124;24;49;197
2015;"MACEIO (AL)";"AL";"MACEIO";7283;1147;2016;10446
2015;"MAJOR ISIDORO (AL)";"AL";"MAJOR ISIDORO";89;28;26;143
2015;"MAR VERMELHO (AL)";"AL";"MAR VERMELHO";13;2;9;24
2015;"MARAGOGI (AL)";"AL";"MARAGOGI";76;117;36;229
2015;"MARAVILHA (AL)";"AL";"MARAVILHA";54;44;8;106
2015;"MARECHAL DEODORO (AL)";"AL";"MARECHAL DEODORO";289;71;142;502
2015;"MARIBONDO (AL)";"AL";"MARIBONDO";69;17;15;101
2015;"MATA GRANDE (AL)";"AL";"MATA GRANDE";62;34;13;109
2015;"MATRIZ DE CAMARAGIBE (AL)";"AL";"MATRIZ DE CAMARAGIBE";133;28;123;284
2015;"MESSIAS (AL)";"AL";"MESSIAS";69;41;91;201
2015;"MINADOR DO NEGRAO (AL)";"AL";"MINADOR DO NEGRAO";45;15;8;68
2015;"MONTEIROPOLIS (AL)";"AL";"MONTEIROPOLIS";12;2;5;19
2015;"MURICI (AL)";"AL";"MURICI";109;23;101;233
2015;"NOVO LINO (AL)";"AL";"NOVO LINO";52;32;59;143
2015;"OLHO D AGUA DAS FLORES (AL)";"AL";"OLHO D AGUA DAS FLORES";113;100;27;240
2015;"OLHO D AGUA DO CASADO (AL)";"AL";"OLHO D AGUA DO CASADO";32;16;7;55
2015;"OLHO D AGUA GRANDE (AL)";"AL";"OLHO D AGUA GRANDE";16;2;13;31
2015;"OLIVENCA (AL)";"AL";"OLIVENCA";63;24;9;96
2015;"OURO BRANCO (AL)";"AL";"OURO BRANCO";73;36;28;137
2015;"PALESTINA (AL)";"AL";"PALESTINA";14;12;5;31
2015;"PALMEIRA DOS INDIOS (AL)";"AL";"PALMEIRA DOS INDIOS";606;243;69;918
2015;"PAO DE ACUCAR (AL)";"AL";"PAO DE ACUCAR";78;37;13;128
2015;"PARICONHA (AL)";"AL";"PARICONHA";42;25;15;82
2015;"PARIPUEIRA (AL)";"AL";"PARIPUEIRA";60;7;17;84
2015;"PASSO DE CAMARAGIBE (AL)";"AL";"PASSO DE CAMARAGIBE";37;8;32;77
2015;"PAULO JACINTO (AL)";"AL";"PAULO JACINTO";15;9;10;34
2015;"PENEDO (AL)";"AL";"PENEDO";252;68;232;552
2015;"PIACABUCU (AL)";"AL";"PIACABUCU";31;12;17;60
2015;"PILAR (AL)";"AL";"PILAR";156;53;67;276
2015;"PINDOBA (AL)";"AL";"PINDOBA";7;1;4;12
2015;"PIRANHAS (AL)";"AL";"PIRANHAS";85;90;16;191
2015;"POCO DAS TRINCHEIRAS (AL)";"AL";"POCO DAS TRINCHEIRAS";62;57;23;142
2015;"PORTO CALVO (AL)";"AL";"PORTO CALVO";192;117;70;379
2015;"PORTO DE PEDRAS (AL)";"AL";"PORTO DE PEDRAS";15;11;10;36
2015;"PORTO REAL DO COLEGIO (AL)";"AL";"PORTO REAL DO COLEGIO";30;31;21;82
2015;"QUEBRANGULO (AL)";"AL";"QUEBRANGULO";41;7;10;58
2015;"RIO LARGO (AL)";"AL";"RIO LARGO";451;192;196;839
2015;"ROTEIRO (AL)";"AL";"ROTEIRO";11;26;10;47
2015;"SANTA LUZIA DO NORTE (AL)";"AL";"SANTA LUZIA DO NORTE";21;7;56;84
2015;"SANTANA DO IPANEMA (AL)";"AL";"SANTANA DO IPANEMA";428;210;41;679
2015;"SANTANA DO MUNDAU (AL)";"AL";"SANTANA DO MUNDAU";76;39;11;126
2015;"SAO BRAS (AL)";"AL";"SAO BRAS";4;5;6;15
2015;"SAO JOSE DA LAJE (AL)";"AL";"SAO JOSE DA LAJE";107;75;51;233
2015;"SAO JOSE DA TAPERA (AL)";"AL";"SAO JOSE DA TAPERA";123;69;26;218
2015;"SAO LUIS DO QUITUNDE (AL)";"AL";"SAO LUIS DO QUITUNDE";219;31;170;420
2015;"SAO MIGUEL DOS CAMPOS (AL)";"AL";"SAO MIGUEL DOS CAMPOS";446;151;154;751
2015;"SAO MIGUEL DOS MILAGRES (AL)";"AL";"SAO MIGUEL DOS MILAGRES";31;4;8;43
2015;"SAO SEBASTIAO (AL)";"AL";"SAO SEBASTIAO";164;40;132;336
2015;"SATUBA (AL)";"AL";"SATUBA";58;15;24;97
2015;"SENADOR RUI PALMEIRA (AL)";"AL";"SENADOR RUI PALMEIRA";36;18;15;69
2015;"TANQUE D ARCA (AL)";"AL";"TANQUE D ARCA";15;20;8;43
2015;"TAQUARANA (AL)";"AL";"TAQUARANA";101;63;34;198
2015;"TEOTONIO VILELA (AL)";"AL";"TEOTONIO VILELA";196;89;180;465
2015;"TRAIPU (AL)";"AL";"TRAIPU";97;18;20;135
2015;"UNIAO DOS PALMARES (AL)";"AL";"UNIAO DOS PALMARES";497;237;187;921
2015;"VICOSA (AL)";"AL";"VICOSA";141;24;48;213
2015;"ALVARAES (AM)";"AM";"ALVARAES";8;0;3;11
2015;"AMATURA (AM)";"AM";"AMATURA";3;0;1;4
2015;"ANAMA (AM)";"AM";"ANAMA";1;0;6;7
2015;"ANORI (AM)";"AM";"ANORI";7;0;3;10
2015;"APUI (AM)";"AM";"APUI";140;2;27;169
2015;"ATALAIA DO NORTE (AM)";"AM";"ATALAIA DO NORTE";2;1;1;4
2015;"AUTAZES (AM)";"AM";"AUTAZES";31;5;20;56
2015;"BARCELOS (AM)";"AM";"BARCELOS";11;1;1;13
2015;"BARREIRINHA (AM)";"AM";"BARREIRINHA";7;0;6;13
2015;"BENJAMIN CONSTANT (AM)";"AM";"BENJAMIN CONSTANT";12;6;4;22
2015;"BERURI (AM)";"AM";"BERURI";2;0;0;2
2015;"BOA VISTA DO RAMOS (AM)";"AM";"BOA VISTA DO RAMOS";3;0;1;4
2015;"BOCA DO ACRE (AM)";"AM";"BOCA DO ACRE";56;4;7;67
2015;"BORBA (AM)";"AM";"BORBA";18;0;5;23
2015;"CAAPIRANGA (AM)";"AM";"CAAPIRANGA";9;1;8;18
2015;"CANUTAMA (AM)";"AM";"CANUTAMA";5;0;1;6
2015;"CARAUARI (AM)";"AM";"CARAUARI";39;1;1;41
2015;"CAREIRO (AM)";"AM";"CAREIRO";71;44;65;180
2015;"CAREIRO DA VARZEA (AM)";"AM";"CAREIRO DA VARZEA";23;24;40;87
2015;"COARI (AM)";"AM";"COARI";140;6;13;159
2015;"CODAJAS (AM)";"AM";"CODAJAS";9;2;4;15
2015;"EIRUNEPE (AM)";"AM";"EIRUNEPE";34;1;5;40
2015;"ENVIRA (AM)";"AM";"ENVIRA";16;0;4;20
2015;"FONTE BOA (AM)";"AM";"FONTE BOA";15;0;0;15
2015;"GUAJARA (AM)";"AM";"GUAJARA";2;0;6;8
2015;"HUMAITA (AM)";"AM";"HUMAITA";172;5;24;201
2015;"IPIXUNA (AM)";"AM";"IPIXUNA";4;0;3;7
2015;"IRANDUBA (AM)";"AM";"IRANDUBA";378;41;111;530
2015;"ITACOATIARA (AM)";"AM";"ITACOATIARA";397;38;151;586
2015;"ITAMARATI (AM)";"AM";"ITAMARATI";9;0;0;9
2015;"ITAPIRANGA (AM)";"AM";"ITAPIRANGA";20;1;6;27
2015;"JAPURA (AM)";"AM";"JAPURA";4;0;4;8
2015;"JURUA (AM)";"AM";"JURUA";10;0;4;14
2015;"JUTAI (AM)";"AM";"JUTAI";4;0;0;4
2015;"LABREA (AM)";"AM";"LABREA";36;1;6;43
2015;"MANACAPURU (AM)";"AM";"MANACAPURU";374;86;103;563
2015;"MANAQUIRI (AM)";"AM";"MANAQUIRI";11;7;8;26
2015;"MANAUS (AM)";"AM";"MANAUS";16634;3042;7816;27492
2015;"MANICORE (AM)";"AM";"MANICORE";49;1;14;64
2015;"MARAA (AM)";"AM";"MARAA";5;1;0;6
2015;"MAUES (AM)";"AM";"MAUES";45;4;20;69
2015;"NHAMUNDA (AM)";"AM";"NHAMUNDA";8;0;1;9
2015;"NOVA OLINDA DO NORTE (AM)";"AM";"NOVA OLINDA DO NORTE";21;6;10;37
2015;"NOVO AIRAO (AM)";"AM";"NOVO AIRAO";29;7;10;46
2015;"NOVO ARIPUANA (AM)";"AM";"NOVO ARIPUANA";29;2;7;38
2015;"PARINTINS (AM)";"AM";"PARINTINS";163;7;25;195
2015;"PAUINI (AM)";"AM";"PAUINI";3;1;1;5
2015;"PRESIDENTE FIGUEIREDO (AM)";"AM";"PRESIDENTE FIGUEIREDO";321;51;91;463
2015;"RIO PRETO DA EVA (AM)";"AM";"RIO PRETO DA EVA";179;18;75;272
2015;"SANTA ISABEL DO RIO NEGRO (AM)";"AM";"SANTA ISABEL DO RIO NEGRO";9;3;3;15
2015;"SANTO ANTONIO DO ICA (AM)";"AM";"SANTO ANTONIO DO ICA";6;0;0;6
2015;"SAO GABRIEL DA CACHOEIRA (AM)";"AM";"SAO GABRIEL DA CACHOEIRA";87;12;26;125
2015;"SAO PAULO DE OLIVENCA (AM)";"AM";"SAO PAULO DE OLIVENCA";7;0;5;12
2015;"SAO SEBASTIAO DO UATUMA (AM)";"AM";"SAO SEBASTIAO DO UATUMA";6;0;1;7
2015;"SILVES (AM)";"AM";"SILVES";11;6;4;21
2015;"TABATINGA (AM)";"AM";"TABATINGA";70;9;5;84
2015;"TAPAUA (AM)";"AM";"TAPAUA";4;0;2;6
2015;"TEFE (AM)";"AM";"TEFE";74;18;11;103
2015;"TONANTINS (AM)";"AM";"TONANTINS";5;0;1;6
2015;"UARINI (AM)";"AM";"UARINI";10;0;4;14
2015;"URUCARA (AM)";"AM";"URUCARA";18;4;1;23
2015;"URUCURITUBA (AM)";"AM";"URUCURITUBA";7;0;2;9
2015;"AMAPA (AP)";"AP";"AMAPA";10;1;2;13
2015;"CALCOENE (AP)";"AP";"CALCOENE";19;2;3;24
2015;"CUTIAS (AP)";"AP";"CUTIAS";5;2;0;7
2015;"FERREIRA GOMES (AP)";"AP";"FERREIRA GOMES";6;4;5;15
2015;"ITAUBAL (AP)";"AP";"ITAUBAL";8;0;5;13
2015;"LARANJAL DO JARI (AP)";"AP";"LARANJAL DO JARI";100;9;15;124
2015;"MACAPA (AP)";"AP";"MACAPA";2961;345;827;4133
2015;"MAZAGAO (AP)";"AP";"MAZAGAO";55;16;22;93
2015;"OIAPOQUE (AP)";"AP";"OIAPOQUE";69;7;19;95
2015;"PEDRA BRANCA DO AMAPARI (AP)";"AP";"PEDRA BRANCA DO AMAPARI";37;7;17;61
2015;"PORTO GRANDE (AP)";"AP";"PORTO GRANDE";51;5;16;72
2015;"PRACUUBA (AP)";"AP";"PRACUUBA";5;1;2;8
2015;"SANTANA (AP)";"AP";"SANTANA";655;46;178;879
2015;"SERRA DO NAVIO (AP)";"AP";"SERRA DO NAVIO";12;3;3;18
2015;"TARTARUGALZINHO (AP)";"AP";"TARTARUGALZINHO";22;5;5;32
2015;"VITORIA DO JARI (AP)";"AP";"VITORIA DO JARI";3;1;4;8
2015;"ABAIRA (BA)";"BA";"ABAIRA";56;25;16;97
2015;"ABARE (BA)";"BA";"ABARE";51;42;25;118
2015;"ACAJUTIBA (BA)";"BA";"ACAJUTIBA";73;17;18;108
2015;"ADUSTINA (BA)";"BA";"ADUSTINA";14;9;10;33
2015;"AGUA FRIA (BA)";"BA";"AGUA FRIA";27;18;40;85
2015;"AIQUARA (BA)";"BA";"AIQUARA";6;6;6;18
2015;"ALAGOINHAS (BA)";"BA";"ALAGOINHAS";1362;353;578;2293
2015;"ALCOBACA (BA)";"BA";"ALCOBACA";53;8;35;96
2015;"ALMADINA (BA)";"BA";"ALMADINA";14;2;6;22
2015;"AMARGOSA (BA)";"BA";"AMARGOSA";321;80;84;485
2015;"AMELIA RODRIGUES (BA)";"BA";"AMELIA RODRIGUES";212;117;38;367
2015;"AMERICA DOURADA (BA)";"BA";"AMERICA DOURADA";36;18;11;65
2015;"ANAGE (BA)";"BA";"ANAGE";115;75;49;239
2015;"ANDARAI (BA)";"BA";"ANDARAI";38;11;23;72
2015;"ANDORINHA (BA)";"BA";"ANDORINHA";86;17;55;158
2015;"ANGICAL (BA)";"BA";"ANGICAL";40;13;26;79
2015;"ANGUERA (BA)";"BA";"ANGUERA";20;7;17;44
2015;"ANTAS (BA)";"BA";"ANTAS";30;9;10;49
2015;"ANTONIO CARDOSO (BA)";"BA";"ANTONIO CARDOSO";6;34;25;65
2015;"ANTONIO GONCALVES (BA)";"BA";"ANTONIO GONCALVES";27;12;13;52
2015;"APORA (BA)";"BA";"APORA";49;34;41;124
2015;"APUAREMA (BA)";"BA";"APUAREMA";24;6;10;40
2015;"ARACAS (BA)";"BA";"ARACAS";78;23;36;137
2015;"ARACATU (BA)";"BA";"ARACATU";129;35;33;197
2015;"ARACI (BA)";"BA";"ARACI";288;28;65;381
2015;"ARAMARI (BA)";"BA";"ARAMARI";48;5;12;65
2015;"ARATACA (BA)";"BA";"ARATACA";31;0;4;35
2015;"ARATUIPE (BA)";"BA";"ARATUIPE";42;6;15;63
2015;"AURELINO LEAL (BA)";"BA";"AURELINO LEAL";52;5;12;69
2015;"BAIANOPOLIS (BA)";"BA";"BAIANOPOLIS";57;6;43;106
2015;"BAIXA GRANDE (BA)";"BA";"BAIXA GRANDE";107;68;48;223
2015;"BANZAE (BA)";"BA";"BANZAE";23;5;23;51
2015;"BARRA (BA)";"BA";"BARRA";89;38;36;163
2015;"BARRA DA ESTIVA (BA)";"BA";"BARRA DA ESTIVA";271;66;65;402
2015;"BARRA DO CHOCA (BA)";"BA";"BARRA DO CHOCA";149;199;35;383
2015;"BARRA DO MENDES (BA)";"BA";"BARRA DO MENDES";77;31;23;131
2015;"BARRA DO ROCHA (BA)";"BA";"BARRA DO ROCHA";12;5;6;23
2015;"BARREIRAS (BA)";"BA";"BARREIRAS";2682;178;485;3345
2015;"BARRO ALTO (BA)";"BA";"BARRO ALTO";56;21;24;101
2015;"BARRO PRETO (BA)";"BA";"BARRO PRETO";20;1;11;32
2015;"BARROCAS (BA)";"BA";"BARROCAS";108;9;23;140
2015;"BELMONTE (BA)";"BA";"BELMONTE";60;9;12;81
2015;"BELO CAMPO (BA)";"BA";"BELO CAMPO";126;23;38;187
2015;"BIRITINGA (BA)";"BA";"BIRITINGA";35;18;35;88
2015;"BOA NOVA (BA)";"BA";"BOA NOVA";41;51;23;115
2015;"BOA VISTA DO TUPIM (BA)";"BA";"BOA VISTA DO TUPIM";68;15;24;107
2015;"BOM JESUS DA LAPA (BA)";"BA";"BOM JESUS DA LAPA";484;79;166;729
2015;"BOM JESUS DA SERRA (BA)";"BA";"BOM JESUS DA SERRA";38;53;22;113
2015;"BONINAL (BA)";"BA";"BONINAL";88;29;40;157
2015;"BONITO (BA)";"BA";"BONITO";102;15;16;133
2015;"BOQUIRA (BA)";"BA";"BOQUIRA";150;12;72;234
2015;"BOTUPORA (BA)";"BA";"BOTUPORA";65;5;51;121
2015;"BREJOES (BA)";"BA";"BREJOES";101;11;41;153
2015;"BREJOLANDIA (BA)";"BA";"BREJOLANDIA";33;7;19;59
2015;"BROTAS DE MACAUBAS (BA)";"BA";"BROTAS DE MACAUBAS";35;57;25;117
2015;"BRUMADO (BA)";"BA";"BRUMADO";1539;286;357;2182
2015;"BUERAREMA (BA)";"BA";"BUERAREMA";156;10;41;207
2015;"BURITIRAMA (BA)";"BA";"BURITIRAMA";42;11;26;79
2015;"CAATIBA (BA)";"BA";"CAATIBA";22;5;3;30
2015;"CABACEIRAS DO PARAGUACU (BA)";"BA";"CABACEIRAS DO PARAGUACU";97;30;57;184
2015;"CACHOEIRA (BA)";"BA";"CACHOEIRA";120;121;82;323
2015;"CACULE (BA)";"BA";"CACULE";406;38;50;494
2015;"CAEM (BA)";"BA";"CAEM";29;19;19;67
2015;"CAETANOS (BA)";"BA";"CAETANOS";85;15;18;118
2015;"CAETITE (BA)";"BA";"CAETITE";636;124;129;889
2015;"CAFARNAUM (BA)";"BA";"CAFARNAUM";81;7;39;127
2015;"CAIRU (BA)";"BA";"CAIRU";16;14;10;40
2015;"CALDEIRAO GRANDE (BA)";"BA";"CALDEIRAO GRANDE";27;7;19;53
2015;"CAMACAN (BA)";"BA";"CAMACAN";191;23;45;259
2015;"CAMACARI (BA)";"BA";"CAMACARI";2620;595;1280;4495
2015;"CAMAMU (BA)";"BA";"CAMAMU";178;49;38;265
2015;"CAMPO ALEGRE DE LOURDES (BA)";"BA";"CAMPO ALEGRE DE LOURDES";85;10;17;112
2015;"CAMPO FORMOSO (BA)";"BA";"CAMPO FORMOSO";310;32;114;456
2015;"CANAPOLIS (BA)";"BA";"CANAPOLIS";21;29;13;63
2015;"CANARANA (BA)";"BA";"CANARANA";198;36;36;270
2015;"CANAVIEIRAS (BA)";"BA";"CANAVIEIRAS";95;10;18;123
2015;"CANDEAL (BA)";"BA";"CANDEAL";24;23;28;75
2015;"CANDEIAS (BA)";"BA";"CANDEIAS";887;383;365;1635
2015;"CANDIBA (BA)";"BA";"CANDIBA";75;0;26;101
2015;"CANDIDO SALES (BA)";"BA";"CANDIDO SALES";338;46;56;440
2015;"CANSANCAO (BA)";"BA";"CANSANCAO";211;69;82;362
2015;"CANUDOS (BA)";"BA";"CANUDOS";68;10;47;125
2015;"CAPELA DO ALTO ALEGRE (BA)";"BA";"CAPELA DO ALTO ALEGRE";94;25;24;143
2015;"CAPIM GROSSO (BA)";"BA";"CAPIM GROSSO";576;87;73;736
2015;"CARAIBAS (BA)";"BA";"CARAIBAS";64;31;25;120
2015;"CARAVELAS (BA)";"BA";"CARAVELAS";52;17;44;113
2015;"CARDEAL DA SILVA (BA)";"BA";"CARDEAL DA SILVA";30;13;19;62
2015;"CARINHANHA (BA)";"BA";"CARINHANHA";120;54;49;223
2015;"CASA NOVA (BA)";"BA";"CASA NOVA";444;227;236;907
2015;"CASTRO ALVES (BA)";"BA";"CASTRO ALVES";158;24;62;244
2015;"CATOLANDIA (BA)";"BA";"CATOLANDIA";10;3;9;22
2015;"CATU (BA)";"BA";"CATU";436;152;115;703
2015;"CATURAMA (BA)";"BA";"CATURAMA";44;11;18;73
2015;"CENTRAL (BA)";"BA";"CENTRAL";91;30;13;134
2015;"CHORROCHO (BA)";"BA";"CHORROCHO";37;6;15;58
2015;"CICERO DANTAS (BA)";"BA";"CICERO DANTAS";148;36;58;242
2015;"CIPO (BA)";"BA";"CIPO";57;11;19;87
2015;"COARACI (BA)";"BA";"COARACI";125;7;25;157
2015;"COCOS (BA)";"BA";"COCOS";88;7;43;138
2015;"CONCEICAO DA FEIRA (BA)";"BA";"CONCEICAO DA FEIRA";246;127;21;394
2015;"CONCEICAO DO ALMEIDA (BA)";"BA";"CONCEICAO DO ALMEIDA";129;47;35;211
2015;"CONCEICAO DO COITE (BA)";"BA";"CONCEICAO DO COITE";589;129;134;852
2015;"CONCEICAO DO JACUIPE (BA)";"BA";"CONCEICAO DO JACUIPE";362;164;32;558
2015;"CONDE (BA)";"BA";"CONDE";63;24;25;112
2015;"CONDEUBA (BA)";"BA";"CONDEUBA";138;52;77;267
2015;"CONTENDAS DO SINCORA (BA)";"BA";"CONTENDAS DO SINCORA";30;11;10;51
2015;"CORACAO DE MARIA (BA)";"BA";"CORACAO DE MARIA";114;51;65;230
2015;"CORDEIROS (BA)";"BA";"CORDEIROS";41;17;24;82
2015;"CORIBE (BA)";"BA";"CORIBE";52;23;30;105
2015;"CORONEL JOAO SA (BA)";"BA";"CORONEL JOAO SA";12;2;24;38
2015;"CORRENTINA (BA)";"BA";"CORRENTINA";160;40;91;291
2015;"COTEGIPE (BA)";"BA";"COTEGIPE";57;29;24;110
2015;"CRAVOLANDIA (BA)";"BA";"CRAVOLANDIA";20;2;8;30
2015;"CRISOPOLIS (BA)";"BA";"CRISOPOLIS";71;34;38;143
2015;"CRISTOPOLIS (BA)";"BA";"CRISTOPOLIS";60;11;36;107
2015;"CRUZ DAS ALMAS (BA)";"BA";"CRUZ DAS ALMAS";1110;337;103;1550
2015;"CURACA (BA)";"BA";"CURACA";97;37;48;182
2015;"DARIO MEIRA (BA)";"BA";"DARIO MEIRA";21;20;5;46
2015;"DIAS D AVILA (BA)";"BA";"DIAS D AVILA";689;117;390;1196
2015;"DOM BASILIO (BA)";"BA";"DOM BASILIO";348;17;36;401
2015;"DOM MACEDO COSTA (BA)";"BA";"DOM MACEDO COSTA";13;28;8;49
2015;"ELISIO MEDRADO (BA)";"BA";"ELISIO MEDRADO";40;22;15;77
2015;"ENCRUZILHADA (BA)";"BA";"ENCRUZILHADA";84;34;20;138
2015;"ENTRE RIOS (BA)";"BA";"ENTRE RIOS";230;100;109;439
2015;"ERICO CARDOSO (BA)";"BA";"ERICO CARDOSO";39;9;26;74
2015;"ESPLANADA (BA)";"BA";"ESPLANADA";150;39;97;286
2015;"EUCLIDES DA CUNHA (BA)";"BA";"EUCLIDES DA CUNHA";294;78;185;557
2015;"EUNAPOLIS (BA)";"BA";"EUNAPOLIS";1390;134;446;1970
2015;"FATIMA (BA)";"BA";"FATIMA";19;9;22;50
2015;"FEIRA DA MATA (BA)";"BA";"FEIRA DA MATA";24;12;12;48
2015;"FEIRA DE SANTANA (BA)";"BA";"FEIRA DE SANTANA";8967;1354;1440;11761
2015;"FILADELFIA (BA)";"BA";"FILADELFIA";140;16;27;183
2015;"FIRMINO ALVES (BA)";"BA";"FIRMINO ALVES";16;3;4;23
2015;"FLORESTA AZUL (BA)";"BA";"FLORESTA AZUL";42;3;3;48
2015;"FORMOSA DO RIO PRETO (BA)";"BA";"FORMOSA DO RIO PRETO";167;12;27;206
2015;"GANDU (BA)";"BA";"GANDU";323;151;29;503
2015;"GAVIAO (BA)";"BA";"GAVIAO";24;14;9;47
2015;"GENTIO DO OURO (BA)";"BA";"GENTIO DO OURO";26;13;8;47
2015;"GLORIA (BA)";"BA";"GLORIA";57;25;47;129
2015;"GONGOGI (BA)";"BA";"GONGOGI";12;4;3;19
2015;"GOVERNADOR MANGABEIRA (BA)";"BA";"GOVERNADOR MANGABEIRA";226;46;44;316
2015;"GUAJERU (BA)";"BA";"GUAJERU";30;34;18;82
2015;"GUANAMBI (BA)";"BA";"GUANAMBI";1332;105;212;1649
2015;"GUARATINGA (BA)";"BA";"GUARATINGA";92;8;36;136
2015;"HELIOPOLIS (BA)";"BA";"HELIOPOLIS";27;8;22;57
2015;"IACU (BA)";"BA";"IACU";155;28;40;223
2015;"IBIASSUCE (BA)";"BA";"IBIASSUCE";93;24;23;140
2015;"IBICARAI (BA)";"BA";"IBICARAI";142;16;32;190
2015;"IBICOARA (BA)";"BA";"IBICOARA";273;64;69;406
2015;"IBICUI (BA)";"BA";"IBICUI";55;22;16;93
2015;"IBIPEBA (BA)";"BA";"IBIPEBA";53;31;19;103
2015;"IBIPITANGA (BA)";"BA";"IBIPITANGA";92;27;40;159
2015;"IBIQUERA (BA)";"BA";"IBIQUERA";10;8;4;22
2015;"IBIRAPITANGA (BA)";"BA";"IBIRAPITANGA";78;39;15;132
2015;"IBIRAPUA (BA)";"BA";"IBIRAPUA";89;6;10;105
2015;"IBIRATAIA (BA)";"BA";"IBIRATAIA";84;51;18;153
2015;"IBITIARA (BA)";"BA";"IBITIARA";116;60;52;228
2015;"IBITITA (BA)";"BA";"IBITITA";62;17;29;108
2015;"IBOTIRAMA (BA)";"BA";"IBOTIRAMA";258;80;38;376
2015;"ICHU (BA)";"BA";"ICHU";39;27;15;81
2015;"IGAPORA (BA)";"BA";"IGAPORA";122;36;41;199
2015;"IGRAPIUNA (BA)";"BA";"IGRAPIUNA";55;33;28;116
2015;"IGUAI (BA)";"BA";"IGUAI";71;44;43;158
2015;"ILHEUS (BA)";"BA";"ILHEUS";790;182;315;1287
2015;"INHAMBUPE (BA)";"BA";"INHAMBUPE";212;111;88;411
2015;"IPECAETA (BA)";"BA";"IPECAETA";30;11;55;96
2015;"IPIAU (BA)";"BA";"IPIAU";406;54;76;536
2015;"IPIRA (BA)";"BA";"IPIRA";461;74;118;653
2015;"IPUPIARA (BA)";"BA";"IPUPIARA";69;26;7;102
2015;"IRAJUBA (BA)";"BA";"IRAJUBA";45;2;22;69
2015;"IRAMAIA (BA)";"BA";"IRAMAIA";44;12;23;79
2015;"IRAQUARA (BA)";"BA";"IRAQUARA";134;36;48;218
2015;"IRARA (BA)";"BA";"IRARA";162;34;81;277
2015;"IRECE (BA)";"BA";"IRECE";978;119;283;1380
2015;"ITABELA (BA)";"BA";"ITABELA";295;12;111;418
2015;"ITABERABA (BA)";"BA";"ITABERABA";572;109;90;771
2015;"ITABUNA (BA)";"BA";"ITABUNA";2003;93;830;2926
2015;"ITACARE (BA)";"BA";"ITACARE";35;30;9;74
2015;"ITAETE (BA)";"BA";"ITAETE";81;20;25;126
2015;"ITAGI (BA)";"BA";"ITAGI";45;4;6;55
2015;"ITAGIBA (BA)";"BA";"ITAGIBA";32;58;20;110
2015;"ITAGIMIRIM (BA)";"BA";"ITAGIMIRIM";58;4;6;68
2015;"ITAGUACU DA BAHIA (BA)";"BA";"ITAGUACU DA BAHIA";28;14;8;50
2015;"ITAJU DO COLONIA (BA)";"BA";"ITAJU DO COLONIA";28;3;7;38
2015;"ITAJUIPE (BA)";"BA";"ITAJUIPE";88;21;18;127
2015;"ITAMARAJU (BA)";"BA";"ITAMARAJU";481;53;174;708
2015;"ITAMARI (BA)";"BA";"ITAMARI";50;12;2;64
2015;"ITAMBE (BA)";"BA";"ITAMBE";87;70;9;166
2015;"ITANAGRA (BA)";"BA";"ITANAGRA";21;1;5;27
2015;"ITANHEM (BA)";"BA";"ITANHEM";67;10;29;106
2015;"ITAPARICA (BA)";"BA";"ITAPARICA";45;36;63;144
2015;"ITAPE (BA)";"BA";"ITAPE";31;0;5;36
2015;"ITAPEBI (BA)";"BA";"ITAPEBI";59;2;8;69
2015;"ITAPETINGA (BA)";"BA";"ITAPETINGA";510;79;149;738
2015;"ITAPICURU (BA)";"BA";"ITAPICURU";51;16;47;114
2015;"ITAPITANGA (BA)";"BA";"ITAPITANGA";13;4;4;21
2015;"ITAQUARA (BA)";"BA";"ITAQUARA";45;8;10;63
2015;"ITARANTIM (BA)";"BA";"ITARANTIM";94;16;6;116
2015;"ITATIM (BA)";"BA";"ITATIM";245;34;34;313
2015;"ITIRUCU (BA)";"BA";"ITIRUCU";119;18;21;158
2015;"ITIUBA (BA)";"BA";"ITIUBA";124;47;77;248
2015;"ITORORO (BA)";"BA";"ITORORO";96;23;25;144
2015;"ITUACU (BA)";"BA";"ITUACU";180;61;49;290
2015;"ITUBERA (BA)";"BA";"ITUBERA";162;21;37;220
2015;"IUIU (BA)";"BA";"IUIU";48;9;14;71
2015;"JABORANDI (BA)";"BA";"JABORANDI";89;1;33;123
2015;"JACARACI (BA)";"BA";"JACARACI";54;19;37;110
2015;"JACOBINA (BA)";"BA";"JACOBINA";781;135;238;1154
2015;"JAGUAQUARA (BA)";"BA";"JAGUAQUARA";641;40;70;751
2015;"JAGUARARI (BA)";"BA";"JAGUARARI";269;83;86;438
2015;"JAGUARIPE (BA)";"BA";"JAGUARIPE";46;30;30;106
2015;"JANDAIRA (BA)";"BA";"JANDAIRA";20;5;16;41
2015;"JEQUIE (BA)";"BA";"JEQUIE";1816;144;419;2379
2015;"JEREMOABO (BA)";"BA";"JEREMOABO";102;33;59;194
2015;"JIQUIRICA (BA)";"BA";"JIQUIRICA";54;23;22;99
2015;"JITAUNA (BA)";"BA";"JITAUNA";32;13;17;62
2015;"JOAO DOURADO (BA)";"BA";"JOAO DOURADO";144;39;37;220
2015;"JUAZEIRO (BA)";"BA";"JUAZEIRO";2788;1002;1018;4808
2015;"JUCURUCU (BA)";"BA";"JUCURUCU";15;1;5;21
2015;"JUSSARA (BA)";"BA";"JUSSARA";71;21;22;114
2015;"JUSSARI (BA)";"BA";"JUSSARI";19;1;3;23
2015;"JUSSIAPE (BA)";"BA";"JUSSIAPE";74;33;23;130
2015;"LAFAIETE COUTINHO (BA)";"BA";"LAFAIETE COUTINHO";24;3;11;38
2015;"LAGEDO DO TABOCAL (BA)";"BA";"LAGEDO DO TABOCAL";39;5;10;54
2015;"LAGOA REAL (BA)";"BA";"LAGOA REAL";81;13;30;124
2015;"LAJE (BA)";"BA";"LAJE";185;92;50;327
2015;"LAJEDAO (BA)";"BA";"LAJEDAO";14;1;13;28
2015;"LAJEDINHO (BA)";"BA";"LAJEDINHO";11;7;14;32
2015;"LAMARAO (BA)";"BA";"LAMARAO";8;13;8;29
2015;"LAPAO (BA)";"BA";"LAPAO";156;17;50;223
2015;"LAURO DE FREITAS (BA)";"BA";"LAURO DE FREITAS";2598;534;738;3870
2015;"LENCOIS (BA)";"BA";"LENCOIS";37;22;5;64
2015;"LICINIO DE ALMEIDA (BA)";"BA";"LICINIO DE ALMEIDA";129;18;23;170
2015;"LIVRAMENTO DE NOSSA SENHORA (BA)";"BA";"LIVRAMENTO DE NOSSA SENHORA";514;72;139;725
2015;"LUIS EDUARDO MAGALHAES (BA)";"BA";"LUIS EDUARDO MAGALHAES";1734;100;177;2011
2015;"MACAJUBA (BA)";"BA";"MACAJUBA";32;29;42;103
2015;"MACARANI (BA)";"BA";"MACARANI";100;12;18;130
2015;"MACAUBAS (BA)";"BA";"MACAUBAS";245;42;240;527
2015;"MACURURE (BA)";"BA";"MACURURE";28;5;14;47
2015;"MADRE DE DEUS (BA)";"BA";"MADRE DE DEUS";100;55;35;190
2015;"MAETINGA (BA)";"BA";"MAETINGA";44;12;15;71
2015;"MAIQUINIQUE (BA)";"BA";"MAIQUINIQUE";55;7;14;76
2015;"MAIRI (BA)";"BA";"MAIRI";84;34;44;162
2015;"MALHADA (BA)";"BA";"MALHADA";51;25;27;103
2015;"MALHADA DE PEDRAS (BA)";"BA";"MALHADA DE PEDRAS";96;44;40;180
2015;"MANOEL VITORINO (BA)";"BA";"MANOEL VITORINO";64;19;12;95
2015;"MANSIDAO (BA)";"BA";"MANSIDAO";30;0;11;41
2015;"MARACAS (BA)";"BA";"MARACAS";251;29;59;339
2015;"MARAGOGIPE (BA)";"BA";"MARAGOGIPE";162;53;57;272
2015;"MARAU (BA)";"BA";"MARAU";34;4;8;46
2015;"MARCIONILIO SOUZA (BA)";"BA";"MARCIONILIO SOUZA";39;24;17;80
2015;"MASCOTE (BA)";"BA";"MASCOTE";51;4;11;66
2015;"MATA DE SAO JOAO (BA)";"BA";"MATA DE SAO JOAO";269;95;98;462
2015;"MATINA (BA)";"BA";"MATINA";25;18;34;77
2015;"MEDEIROS NETO (BA)";"BA";"MEDEIROS NETO";99;19;49;167
2015;"MIGUEL CALMON (BA)";"BA";"MIGUEL CALMON";94;36;40;170
2015;"MILAGRES (BA)";"BA";"MILAGRES";161;14;20;195
2015;"MIRANGABA (BA)";"BA";"MIRANGABA";66;14;50;130
2015;"MIRANTE (BA)";"BA";"MIRANTE";67;23;20;110
2015;"MONTE SANTO (BA)";"BA";"MONTE SANTO";262;70;167;499
2015;"MORPARA (BA)";"BA";"MORPARA";25;17;9;51
2015;"MORRO DO CHAPEU (BA)";"BA";"MORRO DO CHAPEU";198;59;22;279
2015;"MORTUGABA (BA)";"BA";"MORTUGABA";91;7;19;117
2015;"MUCUGE (BA)";"BA";"MUCUGE";109;20;67;196
2015;"MUCURI (BA)";"BA";"MUCURI";154;41;114;309
2015;"MULUNGU DO MORRO (BA)";"BA";"MULUNGU DO MORRO";100;10;17;127
2015;"MUNDO NOVO (BA)";"BA";"MUNDO NOVO";67;27;29;123
2015;"MUNIZ FERREIRA (BA)";"BA";"MUNIZ FERREIRA";69;43;10;122
2015;"MUQUEM DO SAO FRANCISCO (BA)";"BA";"MUQUEM DO SAO FRANCISCO";39;19;34;92
2015;"MURITIBA (BA)";"BA";"MURITIBA";152;54;39;245
2015;"MUTUIPE (BA)";"BA";"MUTUIPE";154;84;58;296
2015;"NAZARE (BA)";"BA";"NAZARE";268;76;44;388
2015;"NILO PECANHA (BA)";"BA";"NILO PECANHA";48;31;25;104
2015;"NORDESTINA (BA)";"BA";"NORDESTINA";90;12;31;133
2015;"NOVA CANAA (BA)";"BA";"NOVA CANAA";68;22;16;106
2015;"NOVA FATIMA (BA)";"BA";"NOVA FATIMA";87;7;14;108
2015;"NOVA IBIA (BA)";"BA";"NOVA IBIA";20;10;7;37
2015;"NOVA ITARANA (BA)";"BA";"NOVA ITARANA";39;7;7;53
2015;"NOVA REDENCAO (BA)";"BA";"NOVA REDENCAO";17;9;7;33
2015;"NOVA SOURE (BA)";"BA";"NOVA SOURE";64;12;36;112
2015;"NOVA VICOSA (BA)";"BA";"NOVA VICOSA";204;57;82;343
2015;"NOVO HORIZONTE (BA)";"BA";"NOVO HORIZONTE";55;13;14;82
2015;"NOVO TRIUNFO (BA)";"BA";"NOVO TRIUNFO";20;3;4;27
2015;"OLINDINA (BA)";"BA";"OLINDINA";99;41;72;212
2015;"OLIVEIRA DOS BREJINHOS (BA)";"BA";"OLIVEIRA DOS BREJINHOS";139;56;50;245
2015;"OURICANGAS (BA)";"BA";"OURICANGAS";45;12;26;83
2015;"OUROLANDIA (BA)";"BA";"OUROLANDIA";75;25;9;109
2015;"PALMAS DE MONTE ALTO (BA)";"BA";"PALMAS DE MONTE ALTO";76;11;41;128
2015;"PALMEIRAS (BA)";"BA";"PALMEIRAS";46;34;9;89
2015;"PARAMIRIM (BA)";"BA";"PARAMIRIM";202;25;72;299
2015;"PARATINGA (BA)";"BA";"PARATINGA";72;40;48;160
2015;"PARIPIRANGA (BA)";"BA";"PARIPIRANGA";72;11;43;126
2015;"PAU BRASIL (BA)";"BA";"PAU BRASIL";56;14;40;110
2015;"PAULO AFONSO (BA)";"BA";"PAULO AFONSO";903;334;366;1603
2015;"PE DE SERRA (BA)";"BA";"PE DE SERRA";87;15;30;132
2015;"PEDRAO (BA)";"BA";"PEDRAO";9;6;10;25
2015;"PEDRO ALEXANDRE (BA)";"BA";"PEDRO ALEXANDRE";3;5;11;19
2015;"PIATA (BA)";"BA";"PIATA";100;49;37;186
2015;"PILAO ARCADO (BA)";"BA";"PILAO ARCADO";66;37;7;110
2015;"PINDAI (BA)";"BA";"PINDAI";57;15;35;107
2015;"PINDOBACU (BA)";"BA";"PINDOBACU";61;27;34;122
2015;"PINTADAS (BA)";"BA";"PINTADAS";66;28;56;150
2015;"PIRAI DO NORTE (BA)";"BA";"PIRAI DO NORTE";34;5;2;41
2015;"PIRIPA (BA)";"BA";"PIRIPA";96;30;21;147
2015;"PIRITIBA (BA)";"BA";"PIRITIBA";82;26;23;131
2015;"PLANALTINO (BA)";"BA";"PLANALTINO";52;10;26;88
2015;"PLANALTO (BA)";"BA";"PLANALTO";122;54;65;241
2015;"POCOES (BA)";"BA";"POCOES";428;344;94;866
2015;"POJUCA (BA)";"BA";"POJUCA";404;113;78;595
2015;"PONTO NOVO (BA)";"BA";"PONTO NOVO";82;10;38;130
2015;"PORTO SEGURO (BA)";"BA";"PORTO SEGURO";737;340;399;1476
2015;"POTIRAGUA (BA)";"BA";"POTIRAGUA";49;6;7;62
2015;"PRADO (BA)";"BA";"PRADO";80;15;46;141
2015;"PRESIDENTE DUTRA (BA)";"BA";"PRESIDENTE DUTRA";76;7;11;94
2015;"PRESIDENTE JANIO QUADROS (BA)";"BA";"PRESIDENTE JANIO QUADROS";49;31;23;103
2015;"PRESIDENTE TANCREDO NEVES (BA)";"BA";"PRESIDENTE TANCREDO NEVES";303;190;39;532
2015;"QUEIMADAS (BA)";"BA";"QUEIMADAS";128;28;70;226
2015;"QUIJINGUE (BA)";"BA";"QUIJINGUE";61;28;73;162
2015;"QUIXABEIRA (BA)";"BA";"QUIXABEIRA";55;21;15;91
2015;"RAFAEL JAMBEIRO (BA)";"BA";"RAFAEL JAMBEIRO";81;35;84;200
2015;"REMANSO (BA)";"BA";"REMANSO";266;97;33;396
2015;"RETIROLANDIA (BA)";"BA";"RETIROLANDIA";105;14;21;140
2015;"RIACHAO DAS NEVES (BA)";"BA";"RIACHAO DAS NEVES";75;22;31;128
2015;"RIACHAO DO JACUIPE (BA)";"BA";"RIACHAO DO JACUIPE";353;54;43;450
2015;"RIACHO DE SANTANA (BA)";"BA";"RIACHO DE SANTANA";261;25;76;362
2015;"RIBEIRA DO AMPARO (BA)";"BA";"RIBEIRA DO AMPARO";11;12;34;57
2015;"RIBEIRA DO POMBAL (BA)";"BA";"RIBEIRA DO POMBAL";289;95;131;515
2015;"RIBEIRAO DO LARGO (BA)";"BA";"RIBEIRAO DO LARGO";34;19;7;60
2015;"RIO DE CONTAS (BA)";"BA";"RIO DE CONTAS";81;38;24;143
2015;"RIO DO ANTONIO (BA)";"BA";"RIO DO ANTONIO";180;30;24;234
2015;"RIO DO PIRES (BA)";"BA";"RIO DO PIRES";86;14;22;122
2015;"RIO REAL (BA)";"BA";"RIO REAL";228;24;65;317
2015;"RODELAS (BA)";"BA";"RODELAS";31;8;7;46
2015;"RUY BARBOSA (BA)";"BA";"RUY BARBOSA";139;72;33;244
2015;"SALINAS DA MARGARIDA (BA)";"BA";"SALINAS DA MARGARIDA";29;13;12;54
2015;"SALVADOR (BA)";"BA";"SALVADOR";18113;4363;9275;31751
2015;"SANTA BARBARA (BA)";"BA";"SANTA BARBARA";85;19;21;125
2015;"SANTA BRIGIDA (BA)";"BA";"SANTA BRIGIDA";24;37;30;91
2015;"SANTA CRUZ CABRALIA (BA)";"BA";"SANTA CRUZ CABRALIA";101;41;40;182
2015;"SANTA CRUZ DA VITORIA (BA)";"BA";"SANTA CRUZ DA VITORIA";15;5;5;25
2015;"SANTA INES (BA)";"BA";"SANTA INES";45;18;6;69
2015;"SANTA LUZIA (BA)";"BA";"SANTA LUZIA";40;6;7;53
2015;"SANTA MARIA DA VITORIA (BA)";"BA";"SANTA MARIA DA VITORIA";434;57;70;561
2015;"SANTA RITA DE CASSIA (BA)";"BA";"SANTA RITA DE CASSIA";71;9;20;100
2015;"SANTA TERESINHA (BA)";"BA";"SANTA TERESINHA";45;12;34;91
2015;"SANTALUZ (BA)";"BA";"SANTALUZ";342;39;54;435
2015;"SANTANA (BA)";"BA";"SANTANA";177;12;72;261
2015;"SANTANOPOLIS (BA)";"BA";"SANTANOPOLIS";30;11;15;56
2015;"SANTO AMARO (BA)";"BA";"SANTO AMARO";251;136;211;598
2015;"SANTO ANTONIO DE JESUS (BA)";"BA";"SANTO ANTONIO DE JESUS";2277;259;191;2727
2015;"SANTO ESTEVAO (BA)";"BA";"SANTO ESTEVAO";332;101;71;504
2015;"SAO DESIDERIO (BA)";"BA";"SAO DESIDERIO";318;32;108;458
2015;"SAO DOMINGOS (BA)";"BA";"SAO DOMINGOS";49;2;9;60
2015;"SAO FELIPE (BA)";"BA";"SAO FELIPE";283;54;52;389
2015;"SAO FELIX (BA)";"BA";"SAO FELIX";59;30;19;108
2015;"SAO FELIX DO CORIBE (BA)";"BA";"SAO FELIX DO CORIBE";163;21;22;206
2015;"SAO FRANCISCO DO CONDE (BA)";"BA";"SAO FRANCISCO DO CONDE";156;100;98;354
2015;"SAO GABRIEL (BA)";"BA";"SAO GABRIEL";41;9;22;72
2015;"SAO GONCALO DOS CAMPOS (BA)";"BA";"SAO GONCALO DOS CAMPOS";228;208;44;480
2015;"SAO JOSE DA VITORIA (BA)";"BA";"SAO JOSE DA VITORIA";18;0;5;23
2015;"SAO JOSE DO JACUIPE (BA)";"BA";"SAO JOSE DO JACUIPE";75;21;9;105
2015;"SAO MIGUEL DAS MATAS (BA)";"BA";"SAO MIGUEL DAS MATAS";66;8;21;95
2015;"SAO SEBASTIAO DO PASSE (BA)";"BA";"SAO SEBASTIAO DO PASSE";229;232;151;612
2015;"SAPEACU (BA)";"BA";"SAPEACU";101;73;40;214
2015;"SATIRO DIAS (BA)";"BA";"SATIRO DIAS";33;17;19;69
2015;"SAUBARA (BA)";"BA";"SAUBARA";34;29;3;66
2015;"SAUDE (BA)";"BA";"SAUDE";47;26;19;92
2015;"SEABRA (BA)";"BA";"SEABRA";503;131;154;788
2015;"SEBASTIAO LARANJEIRAS (BA)";"BA";"SEBASTIAO LARANJEIRAS";33;3;29;65
2015;"SENHOR DO BONFIM (BA)";"BA";"SENHOR DO BONFIM";674;151;209;1034
2015;"SENTO SE (BA)";"BA";"SENTO SE";53;12;22;87
2015;"SERRA DO RAMALHO (BA)";"BA";"SERRA DO RAMALHO";108;37;46;191
2015;"SERRA DOURADA (BA)";"BA";"SERRA DOURADA";69;19;38;126
2015;"SERRA PRETA (BA)";"BA";"SERRA PRETA";60;15;61;136
2015;"SERRINHA (BA)";"BA";"SERRINHA";771;153;225;1149
2015;"SERROLANDIA (BA)";"BA";"SERROLANDIA";64;48;22;134
2015;"SIMOES FILHO (BA)";"BA";"SIMOES FILHO";2516;515;816;3847
2015;"SITIO DO MATO (BA)";"BA";"SITIO DO MATO";41;10;26;77
2015;"SITIO DO QUINTO (BA)";"BA";"SITIO DO QUINTO";22;2;12;36
2015;"SOBRADINHO (BA)";"BA";"SOBRADINHO";101;40;37;178
2015;"SOUTO SOARES (BA)";"BA";"SOUTO SOARES";118;16;26;160
2015;"TABOCAS DO BREJO VELHO (BA)";"BA";"TABOCAS DO BREJO VELHO";37;4;15;56
2015;"TANHACU (BA)";"BA";"TANHACU";270;66;51;387
2015;"TANQUE NOVO (BA)";"BA";"TANQUE NOVO";274;12;47;333
2015;"TANQUINHO (BA)";"BA";"TANQUINHO";29;22;15;66
2015;"TAPEROA (BA)";"BA";"TAPEROA";149;28;19;196
2015;"TAPIRAMUTA (BA)";"BA";"TAPIRAMUTA";57;12;19;88
2015;"TEIXEIRA DE FREITAS (BA)";"BA";"TEIXEIRA DE FREITAS";1593;127;388;2108
2015;"TEODORO SAMPAIO (BA)";"BA";"TEODORO SAMPAIO";14;14;13;41
2015;"TEOFILANDIA (BA)";"BA";"TEOFILANDIA";129;48;35;212
2015;"TEOLANDIA (BA)";"BA";"TEOLANDIA";159;39;15;213
2015;"TERRA NOVA (BA)";"BA";"TERRA NOVA";25;13;21;59
2015;"TREMEDAL (BA)";"BA";"TREMEDAL";58;28;42;128
2015;"TUCANO (BA)";"BA";"TUCANO";308;55;102;465
2015;"UAUA (BA)";"BA";"UAUA";249;43;37;329
2015;"UBAIRA (BA)";"BA";"UBAIRA";125;36;55;216
2015;"UBAITABA (BA)";"BA";"UBAITABA";198;17;26;241
2015;"UBATA (BA)";"BA";"UBATA";217;22;17;256
2015;"UIBAI (BA)";"BA";"UIBAI";63;18;18;99
2015;"UMBURANAS (BA)";"BA";"UMBURANAS";57;22;23;102
2015;"UNA (BA)";"BA";"UNA";68;11;43;122
2015;"URANDI (BA)";"BA";"URANDI";143;18;36;197
2015;"URUCUCA (BA)";"BA";"URUCUCA";104;9;18;131
2015;"UTINGA (BA)";"BA";"UTINGA";77;17;10;104
2015;"VALENCA (BA)";"BA";"VALENCA";792;265;135;1192
2015;"VALENTE (BA)";"BA";"VALENTE";186;21;33;240
2015;"VARZEA DA ROCA (BA)";"BA";"VARZEA DA ROCA";52;18;22;92
2015;"VARZEA DO POCO (BA)";"BA";"VARZEA DO POCO";72;15;17;104
2015;"VARZEA NOVA (BA)";"BA";"VARZEA NOVA";65;14;18;97
2015;"VARZEDO (BA)";"BA";"VARZEDO";76;14;29;119
2015;"VERA CRUZ (BA)";"BA";"VERA CRUZ";211;205;58;474
2015;"VEREDA (BA)";"BA";"VEREDA";11;5;3;19
2015;"VITORIA DA CONQUISTA (BA)";"BA";"VITORIA DA CONQUISTA";4543;965;1505;7013
2015;"WAGNER (BA)";"BA";"WAGNER";35;5;14;54
2015;"WANDERLEY (BA)";"BA";"WANDERLEY";86;5;23;114
2015;"WENCESLAU GUIMARAES (BA)";"BA";"WENCESLAU GUIMARAES";143;23;18;184
2015;"XIQUE XIQUE (BA)";"BA";"XIQUE XIQUE";174;37;28;239
2015;"ABAIARA (CE)";"CE";"ABAIARA";29;29;8;66
2015;"ACARAPE (CE)";"CE";"ACARAPE";110;16;133;259
2015;"ACARAU (CE)";"CE";"ACARAU";239;36;64;339
2015;"ACOPIARA (CE)";"CE";"ACOPIARA";408;30;44;482
2015;"AIUABA (CE)";"CE";"AIUABA";41;7;4;52
2015;"ALCANTARAS (CE)";"CE";"ALCANTARAS";47;11;23;81
2015;"ALTANEIRA (CE)";"CE";"ALTANEIRA";25;8;6;39
2015;"ALTO SANTO (CE)";"CE";"ALTO SANTO";157;12;19;188
2015;"AMONTADA (CE)";"CE";"AMONTADA";199;30;29;258
2015;"ANTONINA DO NORTE (CE)";"CE";"ANTONINA DO NORTE";54;2;8;64
2015;"APUIARES (CE)";"CE";"APUIARES";99;7;10;116
2015;"AQUIRAZ (CE)";"CE";"AQUIRAZ";741;154;124;1019
2015;"ARACATI (CE)";"CE";"ARACATI";556;122;156;834
2015;"ARACOIABA (CE)";"CE";"ARACOIABA";130;20;29;179
2015;"ARARENDA (CE)";"CE";"ARARENDA";38;10;7;55
2015;"ARARIPE (CE)";"CE";"ARARIPE";82;117;48;247
2015;"ARATUBA (CE)";"CE";"ARATUBA";79;0;16;95
2015;"ARNEIROZ (CE)";"CE";"ARNEIROZ";35;18;5;58
2015;"ASSARE (CE)";"CE";"ASSARE";108;38;13;159
2015;"AURORA (CE)";"CE";"AURORA";102;34;19;155
2015;"BAIXIO (CE)";"CE";"BAIXIO";17;17;9;43
2015;"BANABUIU (CE)";"CE";"BANABUIU";176;10;27;213
2015;"BARBALHA (CE)";"CE";"BARBALHA";388;97;102;587
2015;"BARREIRA (CE)";"CE";"BARREIRA";150;13;22;185
2015;"BARRO (CE)";"CE";"BARRO";85;35;17;137
2015;"BARROQUINHA (CE)";"CE";"BARROQUINHA";59;21;7;87
2015;"BATURITE (CE)";"CE";"BATURITE";230;23;33;286
2015;"BEBERIBE (CE)";"CE";"BEBERIBE";276;74;76;426
2015;"BELA CRUZ (CE)";"CE";"BELA CRUZ";136;14;41;191
2015;"BOA VIAGEM (CE)";"CE";"BOA VIAGEM";552;23;74;649
2015;"BREJO SANTO (CE)";"CE";"BREJO SANTO";502;102;68;672
2015;"CAMOCIM (CE)";"CE";"CAMOCIM";246;53;38;337
2015;"CAMPOS SALES (CE)";"CE";"CAMPOS SALES";240;90;62;392
2015;"CANINDE (CE)";"CE";"CANINDE";620;57;120;797
2015;"CAPISTRANO (CE)";"CE";"CAPISTRANO";66;10;22;98
2015;"CARIDADE (CE)";"CE";"CARIDADE";89;9;17;115
2015;"CARIRE (CE)";"CE";"CARIRE";82;13;32;127
2015;"CARIRIACU (CE)";"CE";"CARIRIACU";76;41;13;130
2015;"CARIUS (CE)";"CE";"CARIUS";55;24;8;87
2015;"CARNAUBAL (CE)";"CE";"CARNAUBAL";82;26;10;118
2015;"CASCAVEL (CE)";"CE";"CASCAVEL";538;77;176;791
2015;"CATARINA (CE)";"CE";"CATARINA";54;4;2;60
2015;"CATUNDA (CE)";"CE";"CATUNDA";52;7;9;68
2015;"CAUCAIA (CE)";"CE";"CAUCAIA";1900;340;451;2691
2015;"CEDRO (CE)";"CE";"CEDRO";111;46;45;202
2015;"CHAVAL (CE)";"CE";"CHAVAL";34;18;11;63
2015;"CHORO (CE)";"CE";"CHORO";70;10;45;125
2015;"CHOROZINHO (CE)";"CE";"CHOROZINHO";156;22;41;219
2015;"COREAU (CE)";"CE";"COREAU";111;13;40;164
2015;"CRATEUS (CE)";"CE";"CRATEUS";394;92;106;592
2015;"CRATO (CE)";"CE";"CRATO";1100;189;128;1417
2015;"CROATA (CE)";"CE";"CROATA";74;25;17;116
2015;"CRUZ (CE)";"CE";"CRUZ";194;32;86;312
2015;"DEPUTADO IRAPUAN PINHEIRO (CE)";"CE";"DEPUTADO IRAPUAN PINHEIRO";24;5;14;43
2015;"ERERE (CE)";"CE";"ERERE";6;2;6;14
2015;"EUSEBIO (CE)";"CE";"EUSEBIO";1650;77;77;1804
2015;"FARIAS BRITO (CE)";"CE";"FARIAS BRITO";118;40;23;181
2015;"FORQUILHA (CE)";"CE";"FORQUILHA";134;30;56;220
2015;"FORTALEZA (CE)";"CE";"FORTALEZA";22178;3546;6977;32701
2015;"FORTIM (CE)";"CE";"FORTIM";40;28;20;88
2015;"FRECHEIRINHA (CE)";"CE";"FRECHEIRINHA";103;18;24;145
2015;"GENERAL SAMPAIO (CE)";"CE";"GENERAL SAMPAIO";36;3;9;48
2015;"GRACA (CE)";"CE";"GRACA";35;14;12;61
2015;"GRANJA (CE)";"CE";"GRANJA";233;105;40;378
2015;"GRANJEIRO (CE)";"CE";"GRANJEIRO";10;4;2;16
2015;"GROAIRAS (CE)";"CE";"GROAIRAS";74;25;27;126
2015;"GUAIUBA (CE)";"CE";"GUAIUBA";93;24;10;127
2015;"GUARACIABA DO NORTE (CE)";"CE";"GUARACIABA DO NORTE";486;31;24;541
2015;"GUARAMIRANGA (CE)";"CE";"GUARAMIRANGA";37;2;11;50
2015;"HIDROLANDIA (CE)";"CE";"HIDROLANDIA";169;19;18;206
2015;"HORIZONTE (CE)";"CE";"HORIZONTE";515;88;82;685
2015;"IBARETAMA (CE)";"CE";"IBARETAMA";105;7;24;136
2015;"IBIAPINA (CE)";"CE";"IBIAPINA";178;32;25;235
2015;"IBICUITINGA (CE)";"CE";"IBICUITINGA";100;7;22;129
2015;"ICAPUI (CE)";"CE";"ICAPUI";102;29;61;192
2015;"ICO (CE)";"CE";"ICO";367;96;84;547
2015;"IGUATU (CE)";"CE";"IGUATU";1062;77;147;1286
2015;"INDEPENDENCIA (CE)";"CE";"INDEPENDENCIA";257;4;21;282
2015;"IPAPORANGA (CE)";"CE";"IPAPORANGA";35;4;8;47
2015;"IPAUMIRIM (CE)";"CE";"IPAUMIRIM";298;77;40;415
2015;"IPU (CE)";"CE";"IPU";309;28;29;366
2015;"IPUEIRAS (CE)";"CE";"IPUEIRAS";104;44;13;161
2015;"IRACEMA (CE)";"CE";"IRACEMA";60;21;14;95
2015;"IRAUCUBA (CE)";"CE";"IRAUCUBA";113;23;35;171
2015;"ITAICABA (CE)";"CE";"ITAICABA";37;5;14;56
2015;"ITAITINGA (CE)";"CE";"ITAITINGA";433;72;52;557
2015;"ITAPAJE (CE)";"CE";"ITAPAJE";338;42;60;440
2015;"ITAPIPOCA (CE)";"CE";"ITAPIPOCA";959;57;81;1097
2015;"ITAPIUNA (CE)";"CE";"ITAPIUNA";74;8;28;110
2015;"ITAREMA (CE)";"CE";"ITAREMA";149;19;43;211
2015;"ITATIRA (CE)";"CE";"ITATIRA";158;7;34;199
2015;"JAGUARETAMA (CE)";"CE";"JAGUARETAMA";130;11;19;160
2015;"JAGUARIBARA (CE)";"CE";"JAGUARIBARA";101;12;15;128
2015;"JAGUARIBE (CE)";"CE";"JAGUARIBE";405;63;47;515
2015;"JAGUARUANA (CE)";"CE";"JAGUARUANA";287;23;22;332
2015;"JARDIM (CE)";"CE";"JARDIM";147;70;31;248
2015;"JATI (CE)";"CE";"JATI";38;68;13;119
2015;"JIJOCA DE JERICOACOARA (CE)";"CE";"JIJOCA DE JERICOACOARA";91;15;20;126
2015;"JUAZEIRO DO NORTE (CE)";"CE";"JUAZEIRO DO NORTE";1970;199;247;2416
2015;"JUCAS (CE)";"CE";"JUCAS";125;8;27;160
2015;"LAVRAS DA MANGABEIRA (CE)";"CE";"LAVRAS DA MANGABEIRA";108;29;35;172
2015;"LIMOEIRO DO NORTE (CE)";"CE";"LIMOEIRO DO NORTE";775;45;129;949
2015;"MADALENA (CE)";"CE";"MADALENA";153;7;23;183
2015;"MARACANAU (CE)";"CE";"MARACANAU";2046;272;403;2721
2015;"MARANGUAPE (CE)";"CE";"MARANGUAPE";667;165;288;1120
2015;"MARCO (CE)";"CE";"MARCO";290;21;22;333
2015;"MARTINOPOLE (CE)";"CE";"MARTINOPOLE";47;17;2;66
2015;"MASSAPE (CE)";"CE";"MASSAPE";114;36;97;247
2015;"MAURITI (CE)";"CE";"MAURITI";169;61;57;287
2015;"MERUOCA (CE)";"CE";"MERUOCA";46;16;21;83
2015;"MILAGRES (CE)";"CE";"MILAGRES";110;64;27;201
2015;"MILHA (CE)";"CE";"MILHA";105;6;16;127
2015;"MIRAIMA (CE)";"CE";"MIRAIMA";33;1;13;47
2015;"MISSAO VELHA (CE)";"CE";"MISSAO VELHA";248;67;31;346
2015;"MOMBACA (CE)";"CE";"MOMBACA";271;36;33;340
2015;"MONSENHOR TABOSA (CE)";"CE";"MONSENHOR TABOSA";89;7;9;105
2015;"MORADA NOVA (CE)";"CE";"MORADA NOVA";565;62;107;734
2015;"MORAUJO (CE)";"CE";"MORAUJO";23;4;10;37
2015;"MORRINHOS (CE)";"CE";"MORRINHOS";98;14;29;141
2015;"MUCAMBO (CE)";"CE";"MUCAMBO";39;19;16;74
2015;"MULUNGU (CE)";"CE";"MULUNGU";76;9;14;99
2015;"NOVA OLINDA (CE)";"CE";"NOVA OLINDA";120;31;16;167
2015;"NOVA RUSSAS (CE)";"CE";"NOVA RUSSAS";211;26;12;249
2015;"NOVO ORIENTE (CE)";"CE";"NOVO ORIENTE";82;36;21;139
2015;"OCARA (CE)";"CE";"OCARA";177;16;52;245
2015;"OROS (CE)";"CE";"OROS";135;35;31;201
2015;"PACAJUS (CE)";"CE";"PACAJUS";725;114;178;1017
2015;"PACATUBA (CE)";"CE";"PACATUBA";241;79;33;353
2015;"PACOTI (CE)";"CE";"PACOTI";107;5;17;129
2015;"PACUJA (CE)";"CE";"PACUJA";23;5;8;36
2015;"PALHANO (CE)";"CE";"PALHANO";85;13;14;112
2015;"PALMACIA (CE)";"CE";"PALMACIA";49;10;18;77
2015;"PARACURU (CE)";"CE";"PARACURU";222;27;44;293
2015;"PARAIPABA (CE)";"CE";"PARAIPABA";277;19;35;331
2015;"PARAMBU (CE)";"CE";"PARAMBU";241;12;22;275
2015;"PARAMOTI (CE)";"CE";"PARAMOTI";69;7;22;98
2015;"PEDRA BRANCA (CE)";"CE";"PEDRA BRANCA";416;32;49;497
2015;"PENAFORTE (CE)";"CE";"PENAFORTE";71;55;24;150
2015;"PENTECOSTE (CE)";"CE";"PENTECOSTE";284;18;24;326
2015;"PEREIRO (CE)";"CE";"PEREIRO";100;12;34;146
2015;"PINDORETAMA (CE)";"CE";"PINDORETAMA";174;18;21;213
2015;"PIQUET CARNEIRO (CE)";"CE";"PIQUET CARNEIRO";60;6;16;82
2015;"PIRES FERREIRA (CE)";"CE";"PIRES FERREIRA";20;6;5;31
2015;"PORANGA (CE)";"CE";"PORANGA";28;12;7;47
2015;"PORTEIRAS (CE)";"CE";"PORTEIRAS";52;349;60;461
2015;"POTENGI (CE)";"CE";"POTENGI";41;6;10;57
2015;"POTIRETAMA (CE)";"CE";"POTIRETAMA";54;6;6;66
2015;"QUITERIANOPOLIS (CE)";"CE";"QUITERIANOPOLIS";85;15;9;109
2015;"QUIXADA (CE)";"CE";"QUIXADA";917;71;132;1120
2015;"QUIXELO (CE)";"CE";"QUIXELO";77;21;39;137
2015;"QUIXERAMOBIM (CE)";"CE";"QUIXERAMOBIM";575;32;132;739
2015;"QUIXERE (CE)";"CE";"QUIXERE";260;17;45;322
2015;"REDENCAO (CE)";"CE";"REDENCAO";246;44;65;355
2015;"RERIUTABA (CE)";"CE";"RERIUTABA";114;26;22;162
2015;"RUSSAS (CE)";"CE";"RUSSAS";955;62;168;1185
2015;"SABOEIRO (CE)";"CE";"SABOEIRO";47;10;11;68
2015;"SALITRE (CE)";"CE";"SALITRE";116;17;36;169
2015;"SANTA QUITERIA (CE)";"CE";"SANTA QUITERIA";328;45;26;399
2015;"SANTANA DO ACARAU (CE)";"CE";"SANTANA DO ACARAU";164;57;50;271
2015;"SANTANA DO CARIRI (CE)";"CE";"SANTANA DO CARIRI";77;35;18;130
2015;"SAO BENEDITO (CE)";"CE";"SAO BENEDITO";483;111;61;655
2015;"SAO GONCALO DO AMARANTE (CE)";"CE";"SAO GONCALO DO AMARANTE";433;100;179;712
2015;"SAO JOAO DO JAGUARIBE (CE)";"CE";"SAO JOAO DO JAGUARIBE";47;3;10;60
2015;"SAO LUIS DO CURU (CE)";"CE";"SAO LUIS DO CURU";73;2;11;86
2015;"SENADOR POMPEU (CE)";"CE";"SENADOR POMPEU";176;26;65;267
2015;"SENADOR SA (CE)";"CE";"SENADOR SA";25;6;17;48
2015;"SOBRAL (CE)";"CE";"SOBRAL";1680;253;430;2363
2015;"SOLONOPOLE (CE)";"CE";"SOLONOPOLE";100;22;20;142
2015;"TABULEIRO DO NORTE (CE)";"CE";"TABULEIRO DO NORTE";384;40;56;480
2015;"TAMBORIL (CE)";"CE";"TAMBORIL";136;20;28;184
2015;"TARRAFAS (CE)";"CE";"TARRAFAS";17;12;8;37
2015;"TAUA (CE)";"CE";"TAUA";515;104;55;674
2015;"TEJUCUOCA (CE)";"CE";"TEJUCUOCA";114;11;25;150
2015;"TIANGUA (CE)";"CE";"TIANGUA";1484;179;201;1864
2015;"TRAIRI (CE)";"CE";"TRAIRI";251;39;65;355
2015;"TURURU (CE)";"CE";"TURURU";67;11;13;91
2015;"UBAJARA (CE)";"CE";"UBAJARA";293;27;78;398
2015;"UMARI (CE)";"CE";"UMARI";12;4;7;23
2015;"UMIRIM (CE)";"CE";"UMIRIM";61;41;39;141
2015;"URUBURETAMA (CE)";"CE";"URUBURETAMA";100;10;36;146
2015;"URUOCA (CE)";"CE";"URUOCA";79;13;21;113
2015;"VARJOTA (CE)";"CE";"VARJOTA";158;34;13;205
2015;"VARZEA ALEGRE (CE)";"CE";"VARZEA ALEGRE";267;54;59;380
2015;"VICOSA DO CEARA (CE)";"CE";"VICOSA DO CEARA";431;50;81;562
2015;"BRASILIA (DF)";"DF";"BRASILIA";23200;5347;11959;40506
2015;"MUNICIPIO NAO INFORMADO (DF)";"DF";"MUNICIPIO NAO INFORMADO";0;0;0;0
2015;"AFONSO CLAUDIO (ES)";"ES";"AFONSO CLAUDIO";687;97;110;894
2015;"AGUA DOCE DO NORTE (ES)";"ES";"AGUA DOCE DO NORTE";127;34;35;196
2015;"AGUIA BRANCA (ES)";"ES";"AGUIA BRANCA";183;6;24;213
2015;"ALEGRE (ES)";"ES";"ALEGRE";280;47;33;360
2015;"ALFREDO CHAVES (ES)";"ES";"ALFREDO CHAVES";485;36;38;559
2015;"ALTO RIO NOVO (ES)";"ES";"ALTO RIO NOVO";126;27;23;176
2015;"ANCHIETA (ES)";"ES";"ANCHIETA";328;97;63;488
2015;"APIACA (ES)";"ES";"APIACA";151;22;7;180
2015;"ARACRUZ (ES)";"ES";"ARACRUZ";1398;231;528;2157
2015;"ATILIO VIVACQUA (ES)";"ES";"ATILIO VIVACQUA";210;14;26;250
2015;"BAIXO GUANDU (ES)";"ES";"BAIXO GUANDU";579;45;89;713
2015;"BARRA DE SAO FRANCISCO (ES)";"ES";"BARRA DE SAO FRANCISCO";620;50;142;812
2015;"BOA ESPERANCA (ES)";"ES";"BOA ESPERANCA";274;22;58;354
2015;"BOM JESUS DO NORTE (ES)";"ES";"BOM JESUS DO NORTE";274;42;33;349
2015;"BREJETUBA (ES)";"ES";"BREJETUBA";265;28;56;349
2015;"CACHOEIRO DE ITAPEMIRIM (ES)";"ES";"CACHOEIRO DE ITAPEMIRIM";5147;255;1782;7184
2015;"CARIACICA (ES)";"ES";"CARIACICA";5892;686;1603;8181
2015;"CASTELO (ES)";"ES";"CASTELO";1219;103;98;1420
2015;"COLATINA (ES)";"ES";"COLATINA";2633;195;598;3426
2015;"CONCEICAO DA BARRA (ES)";"ES";"CONCEICAO DA BARRA";256;25;125;406
2015;"CONCEICAO DO CASTELO (ES)";"ES";"CONCEICAO DO CASTELO";298;45;57;400
2015;"DIVINO DE SAO LOURENCO (ES)";"ES";"DIVINO DE SAO LOURENCO";87;9;11;107
2015;"DOMINGOS MARTINS (ES)";"ES";"DOMINGOS MARTINS";1263;130;79;1472
2015;"DORES DO RIO PRETO (ES)";"ES";"DORES DO RIO PRETO";151;28;17;196
2015;"ECOPORANGA (ES)";"ES";"ECOPORANGA";200;52;103;355
2015;"FUNDAO (ES)";"ES";"FUNDAO";368;54;53;475
2015;"GOVERNADOR LINDENBERG (ES)";"ES";"GOVERNADOR LINDENBERG";314;8;7;329
2015;"GUACUI (ES)";"ES";"GUACUI";688;55;53;796
2015;"GUARAPARI (ES)";"ES";"GUARAPARI";1305;356;276;1937
2015;"IBATIBA (ES)";"ES";"IBATIBA";543;93;70;706
2015;"IBIRACU (ES)";"ES";"IBIRACU";382;35;55;472
2015;"IBITIRAMA (ES)";"ES";"IBITIRAMA";148;32;26;206
2015;"ICONHA (ES)";"ES";"ICONHA";805;29;62;896
2015;"IRUPI (ES)";"ES";"IRUPI";252;44;31;327
2015;"ITAGUACU (ES)";"ES";"ITAGUACU";310;14;63;387
2015;"ITAPEMIRIM (ES)";"ES";"ITAPEMIRIM";607;48;84;739
2015;"ITARANA (ES)";"ES";"ITARANA";417;42;41;500
2015;"IUNA (ES)";"ES";"IUNA";506;86;91;683
2015;"JAGUARE (ES)";"ES";"JAGUARE";492;30;105;627
2015;"JERONIMO MONTEIRO (ES)";"ES";"JERONIMO MONTEIRO";117;27;19;163
2015;"JOAO NEIVA (ES)";"ES";"JOAO NEIVA";353;29;37;419
2015;"LARANJA DA TERRA (ES)";"ES";"LARANJA DA TERRA";323;25;32;380
2015;"LINHARES (ES)";"ES";"LINHARES";3036;219;556;3811
2015;"MANTENOPOLIS (ES)";"ES";"MANTENOPOLIS";172;28;31;231
2015;"MARATAIZES (ES)";"ES";"MARATAIZES";1121;56;92;1269
2015;"MARECHAL FLORIANO (ES)";"ES";"MARECHAL FLORIANO";774;54;43;871
2015;"MARILANDIA (ES)";"ES";"MARILANDIA";431;24;29;484
2015;"MIMOSO DO SUL (ES)";"ES";"MIMOSO DO SUL";364;65;90;519
2015;"MONTANHA (ES)";"ES";"MONTANHA";238;14;86;338
2015;"MUCURICI (ES)";"ES";"MUCURICI";71;12;22;105
2015;"MUNIZ FREIRE (ES)";"ES";"MUNIZ FREIRE";265;54;49;368
2015;"MUQUI (ES)";"ES";"MUQUI";211;26;33;270
2015;"NOVA VENECIA (ES)";"ES";"NOVA VENECIA";995;65;213;1273
2015;"PANCAS (ES)";"ES";"PANCAS";335;37;21;393
2015;"PEDRO CANARIO (ES)";"ES";"PEDRO CANARIO";602;58;290;950
2015;"PINHEIROS (ES)";"ES";"PINHEIROS";343;25;149;517
2015;"PIUMA (ES)";"ES";"PIUMA";289;36;16;341
2015;"PONTO BELO (ES)";"ES";"PONTO BELO";71;12;15;98
2015;"PRESIDENTE KENNEDY (ES)";"ES";"PRESIDENTE KENNEDY";350;19;25;394
2015;"RIO BANANAL (ES)";"ES";"RIO BANANAL";680;29;66;775
2015;"RIO NOVO DO SUL (ES)";"ES";"RIO NOVO DO SUL";377;28;30;435
2015;"SANTA LEOPOLDINA (ES)";"ES";"SANTA LEOPOLDINA";487;43;35;565
2015;"SANTA MARIA DE JETIBA (ES)";"ES";"SANTA MARIA DE JETIBA";2532;93;76;2701
2015;"SANTA TERESA (ES)";"ES";"SANTA TERESA";760;53;126;939
2015;"SAO DOMINGOS DO NORTE (ES)";"ES";"SAO DOMINGOS DO NORTE";261;22;36;319
2015;"SAO GABRIEL DA PALHA (ES)";"ES";"SAO GABRIEL DA PALHA";756;37;126;919
2015;"SAO JOSE DO CALCADO (ES)";"ES";"SAO JOSE DO CALCADO";108;27;20;155
2015;"SAO MATEUS (ES)";"ES";"SAO MATEUS";1300;120;386;1806
2015;"SAO ROQUE DO CANAA (ES)";"ES";"SAO ROQUE DO CANAA";353;22;29;404
2015;"SERRA (ES)";"ES";"SERRA";8949;788;2310;12047
2015;"SOORETAMA (ES)";"ES";"SOORETAMA";367;20;60;447
2015;"VARGEM ALTA (ES)";"ES";"VARGEM ALTA";530;36;63;629
2015;"VENDA NOVA DO IMIGRANTE (ES)";"ES";"VENDA NOVA DO IMIGRANTE";856;31;120;1007
2015;"VIANA (ES)";"ES";"VIANA";1299;115;389;1803
2015;"VILA PAVAO (ES)";"ES";"VILA PAVAO";171;11;34;216
2015;"VILA VALERIO (ES)";"ES";"VILA VALERIO";424;17;61;502
2015;"VILA VELHA (ES)";"ES";"VILA VELHA";4491;952;1036;6479
2015;"VITORIA (ES)";"ES";"VITORIA";4204;1109;1010;6323
2015;"ABADIA DE GOIAS (GO)";"GO";"ABADIA DE GOIAS";126;8;8;142
2015;"ABADIANIA (GO)";"GO";"ABADIANIA";309;36;31;376
2015;"ACREUNA (GO)";"GO";"ACREUNA";427;16;127;570
2015;"ADELANDIA (GO)";"GO";"ADELANDIA";40;1;6;47
2015;"AGUA FRIA DE GOIAS (GO)";"GO";"AGUA FRIA DE GOIAS";51;8;21;80
2015;"AGUA LIMPA (GO)";"GO";"AGUA LIMPA";20;6;2;28
2015;"AGUAS LINDAS DE GOIAS (GO)";"GO";"AGUAS LINDAS DE GOIAS";1302;194;705;2201
2015;"ALEXANIA (GO)";"GO";"ALEXANIA";481;54;48;583
2015;"ALOANDIA (GO)";"GO";"ALOANDIA";27;1;3;31
2015;"ALTO HORIZONTE (GO)";"GO";"ALTO HORIZONTE";64;7;20;91
2015;"ALTO PARAISO DE GOIAS (GO)";"GO";"ALTO PARAISO DE GOIAS";75;11;15;101
2015;"ALVORADA DO NORTE (GO)";"GO";"ALVORADA DO NORTE";147;10;16;173
2015;"AMARALINA (GO)";"GO";"AMARALINA";13;3;10;26
2015;"AMERICANO DO BRASIL (GO)";"GO";"AMERICANO DO BRASIL";72;8;21;101
2015;"AMORINOPOLIS (GO)";"GO";"AMORINOPOLIS";41;6;10;57
2015;"ANAPOLIS (GO)";"GO";"ANAPOLIS";10142;336;1868;12346
2015;"ANHANGUERA (GO)";"GO";"ANHANGUERA";7;2;1;10
2015;"ANICUNS (GO)";"GO";"ANICUNS";396;23;115;534
2015;"APARECIDA DE GOIANIA (GO)";"GO";"APARECIDA DE GOIANIA";7076;414;595;8085
2015;"APARECIDA DO RIO DOCE (GO)";"GO";"APARECIDA DO RIO DOCE";56;8;10;74
2015;"APORE (GO)";"GO";"APORE";101;14;28;143
2015;"ARACU (GO)";"GO";"ARACU";33;8;12;53
2015;"ARAGARCAS (GO)";"GO";"ARAGARCAS";559;16;30;605
2015;"ARAGOIANIA (GO)";"GO";"ARAGOIANIA";95;1;8;104
2015;"ARAGUAPAZ (GO)";"GO";"ARAGUAPAZ";101;13;18;132
2015;"ARENOPOLIS (GO)";"GO";"ARENOPOLIS";25;9;8;42
2015;"ARUANA (GO)";"GO";"ARUANA";64;1;19;84
2015;"AURILANDIA (GO)";"GO";"AURILANDIA";33;4;3;40
2015;"AVELINOPOLIS (GO)";"GO";"AVELINOPOLIS";64;3;3;70
2015;"BALIZA (GO)";"GO";"BALIZA";14;0;5;19
2015;"BARRO ALTO (GO)";"GO";"BARRO ALTO";167;33;69;269
2015;"BELA VISTA DE GOIAS (GO)";"GO";"BELA VISTA DE GOIAS";485;22;50;557
2015;"BOM JARDIM DE GOIAS (GO)";"GO";"BOM JARDIM DE GOIAS";150;7;36;193
2015;"BOM JESUS (GO)";"GO";"BOM JESUS";427;62;106;595
2015;"BONFINOPOLIS (GO)";"GO";"BONFINOPOLIS";66;6;10;82
2015;"BONOPOLIS (GO)";"GO";"BONOPOLIS";19;5;8;32
2015;"BRAZABRANTES (GO)";"GO";"BRAZABRANTES";71;3;5;79
2015;"BRITANIA (GO)";"GO";"BRITANIA";96;8;12;116
2015;"BURITI ALEGRE (GO)";"GO";"BURITI ALEGRE";236;37;21;294
2015;"BURITI DE GOIAS (GO)";"GO";"BURITI DE GOIAS";17;8;2;27
2015;"BURITINOPOLIS (GO)";"GO";"BURITINOPOLIS";23;3;9;35
2015;"CABECEIRAS (GO)";"GO";"CABECEIRAS";163;10;24;197
2015;"CACHOEIRA ALTA (GO)";"GO";"CACHOEIRA ALTA";161;23;42;226
2015;"CACHOEIRA DE GOIAS (GO)";"GO";"CACHOEIRA DE GOIAS";8;2;2;12
2015;"CACHOEIRA DOURADA (GO)";"GO";"CACHOEIRA DOURADA";119;14;37;170
2015;"CACU (GO)";"GO";"CACU";286;29;39;354
2015;"CAIAPONIA (GO)";"GO";"CAIAPONIA";220;10;16;246
2015;"CALDAS NOVAS (GO)";"GO";"CALDAS NOVAS";818;115;119;1052
2015;"CALDAZINHA (GO)";"GO";"CALDAZINHA";36;3;3;42
2015;"CAMPESTRE DE GOIAS (GO)";"GO";"CAMPESTRE DE GOIAS";52;1;6;59
2015;"CAMPINACU (GO)";"GO";"CAMPINACU";37;2;6;45
2015;"CAMPINORTE (GO)";"GO";"CAMPINORTE";192;19;18;229
2015;"CAMPO ALEGRE DE GOIAS (GO)";"GO";"CAMPO ALEGRE DE GOIAS";155;20;26;201
2015;"CAMPO LIMPO DE GOIAS (GO)";"GO";"CAMPO LIMPO DE GOIAS";163;1;6;170
2015;"CAMPOS BELOS (GO)";"GO";"CAMPOS BELOS";286;17;50;353
2015;"CAMPOS VERDES (GO)";"GO";"CAMPOS VERDES";36;8;2;46
2015;"CARMO DO RIO VERDE (GO)";"GO";"CARMO DO RIO VERDE";95;12;54;161
2015;"CASTELANDIA (GO)";"GO";"CASTELANDIA";61;6;8;75
2015;"CATALAO (GO)";"GO";"CATALAO";2008;199;385;2592
2015;"CATURAI (GO)";"GO";"CATURAI";48;4;8;60
2015;"CAVALCANTE (GO)";"GO";"CAVALCANTE";45;4;5;54
2015;"CERES (GO)";"GO";"CERES";501;28;49;578
2015;"CEZARINA (GO)";"GO";"CEZARINA";143;10;22;175
2015;"CHAPADAO DO CEU (GO)";"GO";"CHAPADAO DO CEU";323;18;30;371
2015;"CIDADE OCIDENTAL (GO)";"GO";"CIDADE OCIDENTAL";170;73;88;331
2015;"COCALZINHO DE GOIAS (GO)";"GO";"COCALZINHO DE GOIAS";212;27;34;273
2015;"COLINAS DO SUL (GO)";"GO";"COLINAS DO SUL";22;4;1;27
2015;"CORREGO DO OURO (GO)";"GO";"CORREGO DO OURO";17;3;3;23
2015;"CORUMBA DE GOIAS (GO)";"GO";"CORUMBA DE GOIAS";97;17;31;145
2015;"CORUMBAIBA (GO)";"GO";"CORUMBAIBA";171;26;10;207
2015;"CRISTALINA (GO)";"GO";"CRISTALINA";1737;109;432;2278
2015;"CRISTIANOPOLIS (GO)";"GO";"CRISTIANOPOLIS";62;7;4;73
2015;"CRIXAS (GO)";"GO";"CRIXAS";169;22;23;214
2015;"CROMINIA (GO)";"GO";"CROMINIA";50;7;4;61
2015;"CUMARI (GO)";"GO";"CUMARI";28;8;2;38
2015;"DAMIANOPOLIS (GO)";"GO";"DAMIANOPOLIS";30;4;17;51
2015;"DAMOLANDIA (GO)";"GO";"DAMOLANDIA";57;6;6;69
2015;"DAVINOPOLIS (GO)";"GO";"DAVINOPOLIS";31;4;4;39
2015;"DIORAMA (GO)";"GO";"DIORAMA";15;5;7;27
2015;"DIVINOPOLIS DE GOIAS (GO)";"GO";"DIVINOPOLIS DE GOIAS";33;5;10;48
2015;"DOVERLANDIA (GO)";"GO";"DOVERLANDIA";146;12;39;197
2015;"EDEALINA (GO)";"GO";"EDEALINA";78;15;13;106
2015;"EDEIA (GO)";"GO";"EDEIA";240;10;21;271
2015;"ESTRELA DO NORTE (GO)";"GO";"ESTRELA DO NORTE";43;2;2;47
2015;"FAINA (GO)";"GO";"FAINA";60;17;9;86
2015;"FAZENDA NOVA (GO)";"GO";"FAZENDA NOVA";52;8;9;69
2015;"FIRMINOPOLIS (GO)";"GO";"FIRMINOPOLIS";118;6;6;130
2015;"FLORES DE GOIAS (GO)";"GO";"FLORES DE GOIAS";52;4;11;67
2015;"FORMOSA (GO)";"GO";"FORMOSA";3404;201;661;4266
2015;"FORMOSO (GO)";"GO";"FORMOSO";47;6;8;61
2015;"GAMELEIRA DE GOIAS (GO)";"GO";"GAMELEIRA DE GOIAS";32;5;15;52
2015;"GOIANAPOLIS (GO)";"GO";"GOIANAPOLIS";248;19;23;290
2015;"GOIANDIRA (GO)";"GO";"GOIANDIRA";56;8;5;69
2015;"GOIANESIA (GO)";"GO";"GOIANESIA";1066;96;278;1440
2015;"GOIANIA (GO)";"GO";"GOIANIA";25625;2080;6607;34312
2015;"GOIANIRA (GO)";"GO";"GOIANIRA";398;23;82;503
2015;"GOIAS (GO)";"GO";"GOIAS";264;20;50;334
2015;"GOIATUBA (GO)";"GO";"GOIATUBA";761;48;128;937
2015;"GOUVELANDIA (GO)";"GO";"GOUVELANDIA";63;11;9;83
2015;"GUAPO (GO)";"GO";"GUAPO";245;27;60;332
2015;"GUARAITA (GO)";"GO";"GUARAITA";24;2;3;29
2015;"GUARANI DE GOIAS (GO)";"GO";"GUARANI DE GOIAS";14;4;9;27
2015;"GUARINOS (GO)";"GO";"GUARINOS";12;7;4;23
2015;"HEITORAI (GO)";"GO";"HEITORAI";37;4;6;47
2015;"HIDROLANDIA (GO)";"GO";"HIDROLANDIA";724;34;43;801
2015;"HIDROLINA (GO)";"GO";"HIDROLINA";26;1;2;29
2015;"IACIARA (GO)";"GO";"IACIARA";140;14;24;178
2015;"INACIOLANDIA (GO)";"GO";"INACIOLANDIA";61;8;14;83
2015;"INDIARA (GO)";"GO";"INDIARA";250;16;33;299
2015;"INHUMAS (GO)";"GO";"INHUMAS";1193;83;191;1467
2015;"IPAMERI (GO)";"GO";"IPAMERI";384;79;81;544
2015;"IPIRANGA DE GOIAS (GO)";"GO";"IPIRANGA DE GOIAS";31;8;6;45
2015;"IPORA (GO)";"GO";"IPORA";536;45;57;638
2015;"ISRAELANDIA (GO)";"GO";"ISRAELANDIA";43;4;8;55
2015;"ITABERAI (GO)";"GO";"ITABERAI";849;42;94;985
2015;"ITAGUARI (GO)";"GO";"ITAGUARI";60;8;12;80
2015;"ITAGUARU (GO)";"GO";"ITAGUARU";109;12;12;133
2015;"ITAJA (GO)";"GO";"ITAJA";106;10;20;136
2015;"ITAPACI (GO)";"GO";"ITAPACI";209;24;100;333
2015;"ITAPIRAPUA (GO)";"GO";"ITAPIRAPUA";72;6;13;91
2015;"ITAPURANGA (GO)";"GO";"ITAPURANGA";408;27;74;509
2015;"ITARUMA (GO)";"GO";"ITARUMA";99;21;18;138
2015;"ITAUCU (GO)";"GO";"ITAUCU";138;9;14;161
2015;"ITUMBIARA (GO)";"GO";"ITUMBIARA";2108;233;426;2767
2015;"IVOLANDIA (GO)";"GO";"IVOLANDIA";10;4;1;15
2015;"JANDAIA (GO)";"GO";"JANDAIA";123;7;19;149
2015;"JARAGUA (GO)";"GO";"JARAGUA";447;39;42;528
2015;"JATAI (GO)";"GO";"JATAI";2337;148;267;2752
2015;"JAUPACI (GO)";"GO";"JAUPACI";29;3;7;39
2015;"JESUPOLIS (GO)";"GO";"JESUPOLIS";24;3;7;34
2015;"JOVIANIA (GO)";"GO";"JOVIANIA";138;16;20;174
2015;"JUSSARA (GO)";"GO";"JUSSARA";434;21;25;480
2015;"LAGOA SANTA (GO)";"GO";"LAGOA SANTA";19;3;7;29
2015;"LEOPOLDO DE BULHOES (GO)";"GO";"LEOPOLDO DE BULHOES";172;20;8;200
2015;"LUZIANIA (GO)";"GO";"LUZIANIA";2419;250;550;3219
2015;"MAIRIPOTABA (GO)";"GO";"MAIRIPOTABA";37;6;4;47
2015;"MAMBAI (GO)";"GO";"MAMBAI";87;4;25;116
2015;"MARA ROSA (GO)";"GO";"MARA ROSA";154;10;16;180
2015;"MARZAGAO (GO)";"GO";"MARZAGAO";30;2;3;35
2015;"MATRINCHA (GO)";"GO";"MATRINCHA";43;3;10;56
2015;"MAURILANDIA (GO)";"GO";"MAURILANDIA";398;20;124;542
2015;"MIMOSO DE GOIAS (GO)";"GO";"MIMOSO DE GOIAS";10;5;6;21
2015;"MINACU (GO)";"GO";"MINACU";508;56;44;608
2015;"MINEIROS (GO)";"GO";"MINEIROS";1380;88;181;1649
2015;"MOIPORA (GO)";"GO";"MOIPORA";9;0;2;11
2015;"MONTE ALEGRE DE GOIAS (GO)";"GO";"MONTE ALEGRE DE GOIAS";31;5;6;42
2015;"MONTES CLAROS DE GOIAS (GO)";"GO";"MONTES CLAROS DE GOIAS";103;17;25;145
2015;"MONTIVIDIU (GO)";"GO";"MONTIVIDIU";368;35;77;480
2015;"MONTIVIDIU DO NORTE (GO)";"GO";"MONTIVIDIU DO NORTE";29;5;18;52
2015;"MORRINHOS (GO)";"GO";"MORRINHOS";891;73;151;1115
2015;"MORRO AGUDO DE GOIAS (GO)";"GO";"MORRO AGUDO DE GOIAS";32;4;4;40
2015;"MOSSAMEDES (GO)";"GO";"MOSSAMEDES";45;11;5;61
2015;"MOZARLANDIA (GO)";"GO";"MOZARLANDIA";151;18;43;212
2015;"MUNDO NOVO (GO)";"GO";"MUNDO NOVO";44;7;20;71
2015;"MUTUNOPOLIS (GO)";"GO";"MUTUNOPOLIS";37;4;16;57
2015;"NAZARIO (GO)";"GO";"NAZARIO";119;9;18;146
2015;"NEROPOLIS (GO)";"GO";"NEROPOLIS";586;23;39;648
2015;"NIQUELANDIA (GO)";"GO";"NIQUELANDIA";716;88;162;966
2015;"NOVA AMERICA (GO)";"GO";"NOVA AMERICA";31;1;2;34
2015;"NOVA AURORA (GO)";"GO";"NOVA AURORA";46;6;5;57
2015;"NOVA CRIXAS (GO)";"GO";"NOVA CRIXAS";120;10;40;170
2015;"NOVA GLORIA (GO)";"GO";"NOVA GLORIA";102;8;25;135
2015;"NOVA IGUACU DE GOIAS (GO)";"GO";"NOVA IGUACU DE GOIAS";28;7;6;41
2015;"NOVA ROMA (GO)";"GO";"NOVA ROMA";5;4;6;15
2015;"NOVA VENEZA (GO)";"GO";"NOVA VENEZA";157;16;18;191
2015;"NOVO BRASIL (GO)";"GO";"NOVO BRASIL";26;8;3;37
2015;"NOVO GAMA (GO)";"GO";"NOVO GAMA";436;118;134;688
2015;"NOVO PLANALTO (GO)";"GO";"NOVO PLANALTO";46;11;3;60
2015;"ORIZONA (GO)";"GO";"ORIZONA";227;52;46;325
2015;"OURO VERDE DE GOIAS (GO)";"GO";"OURO VERDE DE GOIAS";101;1;13;115
2015;"OUVIDOR (GO)";"GO";"OUVIDOR";88;5;16;109
2015;"PADRE BERNARDO (GO)";"GO";"PADRE BERNARDO";488;37;95;620
2015;"PALESTINA DE GOIAS (GO)";"GO";"PALESTINA DE GOIAS";22;13;11;46
2015;"PALMEIRAS DE GOIAS (GO)";"GO";"PALMEIRAS DE GOIAS";415;22;110;547
2015;"PALMELO (GO)";"GO";"PALMELO";28;3;6;37
2015;"PALMINOPOLIS (GO)";"GO";"PALMINOPOLIS";59;1;6;66
2015;"PANAMA (GO)";"GO";"PANAMA";60;12;10;82
2015;"PARANAIGUARA (GO)";"GO";"PARANAIGUARA";109;13;19;141
2015;"PARAUNA (GO)";"GO";"PARAUNA";197;20;44;261
2015;"PEROLANDIA (GO)";"GO";"PEROLANDIA";59;8;9;76
2015;"PETROLINA DE GOIAS (GO)";"GO";"PETROLINA DE GOIAS";166;5;21;192
2015;"PILAR DE GOIAS (GO)";"GO";"PILAR DE GOIAS";24;5;7;36
2015;"PIRACANJUBA (GO)";"GO";"PIRACANJUBA";467;38;33;538
2015;"PIRANHAS (GO)";"GO";"PIRANHAS";228;12;42;282
2015;"PIRENOPOLIS (GO)";"GO";"PIRENOPOLIS";310;61;39;410
2015;"PIRES DO RIO (GO)";"GO";"PIRES DO RIO";561;36;52;649
2015;"PLANALTINA (GO)";"GO";"PLANALTINA";756;95;498;1349
2015;"PONTALINA (GO)";"GO";"PONTALINA";302;20;35;357
2015;"PORANGATU (GO)";"GO";"PORANGATU";764;56;87;907
2015;"PORTEIRAO (GO)";"GO";"PORTEIRAO";114;9;50;173
2015;"PORTELANDIA (GO)";"GO";"PORTELANDIA";59;29;4;92
2015;"POSSE (GO)";"GO";"POSSE";695;55;121;871
2015;"PROFESSOR JAMIL (GO)";"GO";"PROFESSOR JAMIL";36;3;6;45
2015;"QUIRINOPOLIS (GO)";"GO";"QUIRINOPOLIS";1010;60;250;1320
2015;"RIALMA (GO)";"GO";"RIALMA";306;26;39;371
2015;"RIANAPOLIS (GO)";"GO";"RIANAPOLIS";92;5;8;105
2015;"RIO QUENTE (GO)";"GO";"RIO QUENTE";51;20;55;126
2015;"RIO VERDE (GO)";"GO";"RIO VERDE";3829;379;608;4816
2015;"RUBIATABA (GO)";"GO";"RUBIATABA";362;30;92;484
2015;"SANCLERLANDIA (GO)";"GO";"SANCLERLANDIA";129;10;9;148
2015;"SANTA BARBARA DE GOIAS (GO)";"GO";"SANTA BARBARA DE GOIAS";129;7;7;143
2015;"SANTA CRUZ DE GOIAS (GO)";"GO";"SANTA CRUZ DE GOIAS";10;5;4;19
2015;"SANTA FE DE GOIAS (GO)";"GO";"SANTA FE DE GOIAS";48;7;5;60
2015;"SANTA HELENA DE GOIAS (GO)";"GO";"SANTA HELENA DE GOIAS";972;60;274;1306
2015;"SANTA ISABEL (GO)";"GO";"SANTA ISABEL";12;10;6;28
2015;"SANTA RITA DO ARAGUAIA (GO)";"GO";"SANTA RITA DO ARAGUAIA";148;18;8;174
2015;"SANTA RITA DO NOVO DESTINO (GO)";"GO";"SANTA RITA DO NOVO DESTINO";21;12;10;43
2015;"SANTA ROSA DE GOIAS (GO)";"GO";"SANTA ROSA DE GOIAS";32;3;5;40
2015;"SANTA TEREZA DE GOIAS (GO)";"GO";"SANTA TEREZA DE GOIAS";47;4;7;58
2015;"SANTA TEREZINHA DE GOIAS (GO)";"GO";"SANTA TEREZINHA DE GOIAS";113;12;22;147
2015;"SANTO ANTONIO DA BARRA (GO)";"GO";"SANTO ANTONIO DA BARRA";39;15;20;74
2015;"SANTO ANTONIO DE GOIAS (GO)";"GO";"SANTO ANTONIO DE GOIAS";85;6;22;113
2015;"SANTO ANTONIO DO DESCOBERTO (GO)";"GO";"SANTO ANTONIO DO DESCOBERTO";319;60;194;573
2015;"SAO DOMINGOS (GO)";"GO";"SAO DOMINGOS";42;6;35;83
2015;"SAO FRANCISCO DE GOIAS (GO)";"GO";"SAO FRANCISCO DE GOIAS";58;6;12;76
2015;"SAO JOAO D ALIANCA (GO)";"GO";"SAO JOAO D ALIANCA";134;6;19;159
2015;"SAO JOAO DA PARAUNA (GO)";"GO";"SAO JOAO DA PARAUNA";28;2;3;33
2015;"SAO LUIS DE MONTES BELOS (GO)";"GO";"SAO LUIS DE MONTES BELOS";463;31;93;587
2015;"SAO LUIZ DO NORTE (GO)";"GO";"SAO LUIZ DO NORTE";64;10;18;92
2015;"SAO MIGUEL DO ARAGUAIA (GO)";"GO";"SAO MIGUEL DO ARAGUAIA";351;20;69;440
2015;"SAO MIGUEL DO PASSA QUATRO (GO)";"GO";"SAO MIGUEL DO PASSA QUATRO";64;2;5;71
2015;"SAO PATRICIO (GO)";"GO";"SAO PATRICIO";13;1;4;18
2015;"SAO SIMAO (GO)";"GO";"SAO SIMAO";242;33;66;341
2015;"SENADOR CANEDO (GO)";"GO";"SENADOR CANEDO";913;98;93;1104
2015;"SERRANOPOLIS (GO)";"GO";"SERRANOPOLIS";118;13;23;154
2015;"SILVANIA (GO)";"GO";"SILVANIA";432;42;47;521
2015;"SIMOLANDIA (GO)";"GO";"SIMOLANDIA";146;5;9;160
2015;"SITIO D ABADIA (GO)";"GO";"SITIO D ABADIA";13;1;8;22
2015;"TAQUARAL DE GOIAS (GO)";"GO";"TAQUARAL DE GOIAS";33;6;6;45
2015;"TERESINA DE GOIAS (GO)";"GO";"TERESINA DE GOIAS";16;1;2;19
2015;"TEREZOPOLIS DE GOIAS (GO)";"GO";"TEREZOPOLIS DE GOIAS";110;3;27;140
2015;"TRES RANCHOS (GO)";"GO";"TRES RANCHOS";46;10;5;61
2015;"TRINDADE (GO)";"GO";"TRINDADE";1245;89;134;1468
2015;"TROMBAS (GO)";"GO";"TROMBAS";40;4;13;57
2015;"TURVANIA (GO)";"GO";"TURVANIA";69;5;8;82
2015;"TURVELANDIA (GO)";"GO";"TURVELANDIA";54;8;21;83
2015;"UIRAPURU (GO)";"GO";"UIRAPURU";18;10;7;35
2015;"URUACU (GO)";"GO";"URUACU";663;40;97;800
2015;"URUANA (GO)";"GO";"URUANA";283;7;14;304
2015;"URUTAI (GO)";"GO";"URUTAI";27;2;10;39
2015;"VALPARAISO DE GOIAS (GO)";"GO";"VALPARAISO DE GOIAS";730;228;243;1201
2015;"VARJAO (GO)";"GO";"VARJAO";56;0;8;64
2015;"VIANOPOLIS (GO)";"GO";"VIANOPOLIS";540;34;39;613
2015;"VICENTINOPOLIS (GO)";"GO";"VICENTINOPOLIS";211;11;65;287
2015;"VILA BOA (GO)";"GO";"VILA BOA";33;3;23;59
2015;"VILA PROPICIO (GO)";"GO";"VILA PROPICIO";28;15;23;66
2015;"ACAILANDIA (MA)";"MA";"ACAILANDIA";1450;122;212;1784
2015;"AFONSO CUNHA (MA)";"MA";"AFONSO CUNHA";7;1;5;13
2015;"AGUA DOCE DO MARANHAO (MA)";"MA";"AGUA DOCE DO MARANHAO";2;2;9;13
2015;"ALCANTARA (MA)";"MA";"ALCANTARA";47;19;17;83
2015;"ALDEIAS ALTAS (MA)";"MA";"ALDEIAS ALTAS";46;3;23;72
2015;"ALTAMIRA DO MARANHAO (MA)";"MA";"ALTAMIRA DO MARANHAO";23;3;2;28
2015;"ALTO ALEGRE DO MARANHAO (MA)";"MA";"ALTO ALEGRE DO MARANHAO";56;27;3;86
2015;"ALTO ALEGRE DO PINDARE (MA)";"MA";"ALTO ALEGRE DO PINDARE";43;11;4;58
2015;"ALTO PARNAIBA (MA)";"MA";"ALTO PARNAIBA";75;3;7;85
2015;"AMAPA DO MARANHAO (MA)";"MA";"AMAPA DO MARANHAO";18;2;3;23
2015;"AMARANTE DO MARANHAO (MA)";"MA";"AMARANTE DO MARANHAO";115;7;6;128
2015;"ANAJATUBA (MA)";"MA";"ANAJATUBA";40;6;11;57
2015;"ANAPURUS (MA)";"MA";"ANAPURUS";52;1;18;71
2015;"APICUM ACU (MA)";"MA";"APICUM ACU";16;9;3;28
2015;"ARAGUANA (MA)";"MA";"ARAGUANA";12;0;7;19
2015;"ARAIOSES (MA)";"MA";"ARAIOSES";33;5;27;65
2015;"ARAME (MA)";"MA";"ARAME";112;12;4;128
2015;"ARARI (MA)";"MA";"ARARI";106;8;6;120
2015;"AXIXA (MA)";"MA";"AXIXA";22;7;9;38
2015;"BACABAL (MA)";"MA";"BACABAL";929;87;91;1107
2015;"BACABEIRA (MA)";"MA";"BACABEIRA";110;9;32;151
2015;"BACURI (MA)";"MA";"BACURI";11;8;4;23
2015;"BACURITUBA (MA)";"MA";"BACURITUBA";4;0;5;9
2015;"BALSAS (MA)";"MA";"BALSAS";1789;53;123;1965
2015;"BARAO DE GRAJAU (MA)";"MA";"BARAO DE GRAJAU";77;4;11;92
2015;"BARRA DO CORDA (MA)";"MA";"BARRA DO CORDA";696;28;19;743
2015;"BARREIRINHAS (MA)";"MA";"BARREIRINHAS";94;5;21;120
2015;"BELA VISTA DO MARANHAO (MA)";"MA";"BELA VISTA DO MARANHAO";49;4;4;57
2015;"BELAGUA (MA)";"MA";"BELAGUA";2;6;2;10
2015;"BENEDITO LEITE (MA)";"MA";"BENEDITO LEITE";7;3;2;12
2015;"BEQUIMAO (MA)";"MA";"BEQUIMAO";93;12;18;123
2015;"BERNARDO DO MEARIM (MA)";"MA";"BERNARDO DO MEARIM";39;1;1;41
2015;"BOA VISTA DO GURUPI (MA)";"MA";"BOA VISTA DO GURUPI";8;5;3;16
2015;"BOM JARDIM (MA)";"MA";"BOM JARDIM";125;8;9;142
2015;"BOM JESUS DAS SELVAS (MA)";"MA";"BOM JESUS DAS SELVAS";136;6;6;148
2015;"BOM LUGAR (MA)";"MA";"BOM LUGAR";35;15;13;63
2015;"BREJO (MA)";"MA";"BREJO";78;18;14;110
2015;"BREJO DE AREIA (MA)";"MA";"BREJO DE AREIA";24;3;6;33
2015;"BURITI (MA)";"MA";"BURITI";25;12;18;55
2015;"BURITI BRAVO (MA)";"MA";"BURITI BRAVO";40;2;8;50
2015;"BURITICUPU (MA)";"MA";"BURITICUPU";476;47;19;542
2015;"BURITIRANA (MA)";"MA";"BURITIRANA";25;2;1;28
2015;"CACHOEIRA GRANDE (MA)";"MA";"CACHOEIRA GRANDE";8;2;5;15
2015;"CAJAPIO (MA)";"MA";"CAJAPIO";11;0;2;13
2015;"CAJARI (MA)";"MA";"CAJARI";9;3;5;17
2015;"CAMPESTRE DO MARANHAO (MA)";"MA";"CAMPESTRE DO MARANHAO";31;18;13;62
2015;"CANDIDO MENDES (MA)";"MA";"CANDIDO MENDES";9;7;3;19
2015;"CANTANHEDE (MA)";"MA";"CANTANHEDE";25;3;8;36
2015;"CAPINZAL DO NORTE (MA)";"MA";"CAPINZAL DO NORTE";39;14;2;55
2015;"CAROLINA (MA)";"MA";"CAROLINA";83;3;11;97
2015;"CARUTAPERA (MA)";"MA";"CARUTAPERA";29;15;11;55
2015;"CAXIAS (MA)";"MA";"CAXIAS";900;66;154;1120
2015;"CEDRAL (MA)";"MA";"CEDRAL";11;0;7;18
2015;"CENTRAL DO MARANHAO (MA)";"MA";"CENTRAL DO MARANHAO";13;5;4;22
2015;"CENTRO DO GUILHERME (MA)";"MA";"CENTRO DO GUILHERME";20;0;4;24
2015;"CENTRO NOVO DO MARANHAO (MA)";"MA";"CENTRO NOVO DO MARANHAO";31;2;10;43
2015;"CHAPADINHA (MA)";"MA";"CHAPADINHA";374;31;20;425
2015;"CIDELANDIA (MA)";"MA";"CIDELANDIA";59;10;12;81
2015;"CODO (MA)";"MA";"CODO";657;30;43;730
2015;"COELHO NETO (MA)";"MA";"COELHO NETO";114;18;47;179
2015;"COLINAS (MA)";"MA";"COLINAS";163;16;20;199
2015;"CONCEICAO DO LAGO ACU (MA)";"MA";"CONCEICAO DO LAGO ACU";23;3;1;27
2015;"COROATA (MA)";"MA";"COROATA";205;46;12;263
2015;"CURURUPU (MA)";"MA";"CURURUPU";33;12;8;53
2015;"DAVINOPOLIS (MA)";"MA";"DAVINOPOLIS";88;3;5;96
2015;"DOM PEDRO (MA)";"MA";"DOM PEDRO";450;11;37;498
2015;"DUQUE BACELAR (MA)";"MA";"DUQUE BACELAR";3;3;8;14
2015;"ESPERANTINOPOLIS (MA)";"MA";"ESPERANTINOPOLIS";98;16;1;115
2015;"ESTREITO (MA)";"MA";"ESTREITO";158;17;19;194
2015;"FEIRA NOVA DO MARANHAO (MA)";"MA";"FEIRA NOVA DO MARANHAO";15;0;5;20
2015;"FERNANDO FALCAO (MA)";"MA";"FERNANDO FALCAO";16;0;5;21
2015;"FORMOSA DA SERRA NEGRA (MA)";"MA";"FORMOSA DA SERRA NEGRA";38;4;8;50
2015;"FORTALEZA DOS NOGUEIRAS (MA)";"MA";"FORTALEZA DOS NOGUEIRAS";93;7;9;109
2015;"FORTUNA (MA)";"MA";"FORTUNA";42;16;4;62
2015;"GODOFREDO VIANA (MA)";"MA";"GODOFREDO VIANA";13;10;12;35
2015;"GONCALVES DIAS (MA)";"MA";"GONCALVES DIAS";61;5;10;76
2015;"GOVERNADOR ARCHER (MA)";"MA";"GOVERNADOR ARCHER";36;11;7;54
2015;"GOVERNADOR EDISON LOBAO (MA)";"MA";"GOVERNADOR EDISON LOBAO";83;1;8;92
2015;"GOVERNADOR EUGENIO BARROS (MA)";"MA";"GOVERNADOR EUGENIO BARROS";57;11;18;86
2015;"GOVERNADOR LUIZ ROCHA (MA)";"MA";"GOVERNADOR LUIZ ROCHA";20;3;5;28
2015;"GOVERNADOR NEWTON BELLO (MA)";"MA";"GOVERNADOR NEWTON BELLO";20;0;1;21
2015;"GOVERNADOR NUNES FREIRE (MA)";"MA";"GOVERNADOR NUNES FREIRE";92;6;7;105
2015;"GRACA ARANHA (MA)";"MA";"GRACA ARANHA";15;4;5;24
2015;"GRAJAU (MA)";"MA";"GRAJAU";516;30;46;592
2015;"GUIMARAES (MA)";"MA";"GUIMARAES";17;3;17;37
2015;"HUMBERTO DE CAMPOS (MA)";"MA";"HUMBERTO DE CAMPOS";18;9;8;35
2015;"ICATU (MA)";"MA";"ICATU";23;2;7;32
2015;"IGARAPE DO MEIO (MA)";"MA";"IGARAPE DO MEIO";31;3;9;43
2015;"IGARAPE GRANDE (MA)";"MA";"IGARAPE GRANDE";72;8;7;87
2015;"IMPERATRIZ (MA)";"MA";"IMPERATRIZ";3814;244;419;4477
2015;"ITAIPAVA DO GRAJAU (MA)";"MA";"ITAIPAVA DO GRAJAU";30;5;7;42
2015;"ITAPECURU MIRIM (MA)";"MA";"ITAPECURU MIRIM";394;34;38;466
2015;"ITINGA DO MARANHAO (MA)";"MA";"ITINGA DO MARANHAO";152;9;9;170
2015;"JATOBA (MA)";"MA";"JATOBA";5;2;5;12
2015;"JENIPAPO DOS VIEIRAS (MA)";"MA";"JENIPAPO DOS VIEIRAS";52;2;10;64
2015;"JOAO LISBOA (MA)";"MA";"JOAO LISBOA";135;5;6;146
2015;"JOSELANDIA (MA)";"MA";"JOSELANDIA";70;11;8;89
2015;"JUNCO DO MARANHAO (MA)";"MA";"JUNCO DO MARANHAO";12;15;3;30
2015;"LAGO DA PEDRA (MA)";"MA";"LAGO DA PEDRA";303;47;12;362
2015;"LAGO DO JUNCO (MA)";"MA";"LAGO DO JUNCO";20;2;12;34
2015;"LAGO DOS RODRIGUES (MA)";"MA";"LAGO DOS RODRIGUES";48;12;7;67
2015;"LAGO VERDE (MA)";"MA";"LAGO VERDE";32;0;11;43
2015;"LAGOA DO MATO (MA)";"MA";"LAGOA DO MATO";26;0;11;37
2015;"LAGOA GRANDE DO MARANHAO (MA)";"MA";"LAGOA GRANDE DO MARANHAO";31;1;2;34
2015;"LAJEADO NOVO (MA)";"MA";"LAJEADO NOVO";18;5;2;25
2015;"LIMA CAMPOS (MA)";"MA";"LIMA CAMPOS";88;35;8;131
2015;"LORETO (MA)";"MA";"LORETO";27;3;8;38
2015;"LUIS DOMINGUES (MA)";"MA";"LUIS DOMINGUES";5;2;3;10
2015;"MAGALHAES DE ALMEIDA (MA)";"MA";"MAGALHAES DE ALMEIDA";19;2;11;32
2015;"MARACACUME (MA)";"MA";"MARACACUME";77;50;3;130
2015;"MARAJA DO SENA (MA)";"MA";"MARAJA DO SENA";14;0;1;15
2015;"MARANHAOZINHO (MA)";"MA";"MARANHAOZINHO";42;2;3;47
2015;"MATA ROMA (MA)";"MA";"MATA ROMA";44;7;17;68
2015;"MATINHA (MA)";"MA";"MATINHA";53;8;7;68
2015;"MATOES (MA)";"MA";"MATOES";44;5;21;70
2015;"MATOES DO NORTE (MA)";"MA";"MATOES DO NORTE";21;6;6;33
2015;"MILAGRES DO MARANHAO (MA)";"MA";"MILAGRES DO MARANHAO";7;2;7;16
2015;"MIRADOR (MA)";"MA";"MIRADOR";34;3;3;40
2015;"MIRANDA DO NORTE (MA)";"MA";"MIRANDA DO NORTE";150;10;13;173
2015;"MIRINZAL (MA)";"MA";"MIRINZAL";47;4;6;57
2015;"MONCAO (MA)";"MA";"MONCAO";29;6;8;43
2015;"MONTES ALTOS (MA)";"MA";"MONTES ALTOS";35;0;2;37
2015;"MORROS (MA)";"MA";"MORROS";19;4;6;29
2015;"NINA RODRIGUES (MA)";"MA";"NINA RODRIGUES";11;3;4;18
2015;"NOVA COLINAS (MA)";"MA";"NOVA COLINAS";18;2;12;32
2015;"NOVA IORQUE (MA)";"MA";"NOVA IORQUE";10;1;2;13
2015;"NOVA OLINDA DO MARANHAO (MA)";"MA";"NOVA OLINDA DO MARANHAO";53;15;7;75
2015;"OLHO D AGUA DAS CUNHAS (MA)";"MA";"OLHO D AGUA DAS CUNHAS";74;17;12;103
2015;"OLINDA NOVA DO MARANHAO (MA)";"MA";"OLINDA NOVA DO MARANHAO";34;1;10;45
2015;"PACO DO LUMIAR (MA)";"MA";"PACO DO LUMIAR";447;136;152;735
2015;"PALMEIRANDIA (MA)";"MA";"PALMEIRANDIA";24;2;11;37
2015;"PARAIBANO (MA)";"MA";"PARAIBANO";77;18;8;103
2015;"PARNARAMA (MA)";"MA";"PARNARAMA";50;3;6;59
2015;"PASSAGEM FRANCA (MA)";"MA";"PASSAGEM FRANCA";39;5;8;52
2015;"PASTOS BONS (MA)";"MA";"PASTOS BONS";127;9;10;146
2015;"PAULINO NEVES (MA)";"MA";"PAULINO NEVES";9;1;8;18
2015;"PAULO RAMOS (MA)";"MA";"PAULO RAMOS";86;10;6;102
2015;"PEDREIRAS (MA)";"MA";"PEDREIRAS";396;64;42;502
2015;"PEDRO DO ROSARIO (MA)";"MA";"PEDRO DO ROSARIO";20;1;6;27
2015;"PENALVA (MA)";"MA";"PENALVA";38;3;4;45
2015;"PERI MIRIM (MA)";"MA";"PERI MIRIM";25;8;8;41
2015;"PERITORO (MA)";"MA";"PERITORO";53;69;11;133
2015;"PINDARE MIRIM (MA)";"MA";"PINDARE MIRIM";103;17;15;135
2015;"PINHEIRO (MA)";"MA";"PINHEIRO";482;37;83;602
2015;"PIO XII (MA)";"MA";"PIO XII";122;6;7;135
2015;"PIRAPEMAS (MA)";"MA";"PIRAPEMAS";23;8;3;34
2015;"POCAO DE PEDRAS (MA)";"MA";"POCAO DE PEDRAS";50;17;7;74
2015;"PORTO FRANCO (MA)";"MA";"PORTO FRANCO";105;22;12;139
2015;"PORTO RICO DO MARANHAO (MA)";"MA";"PORTO RICO DO MARANHAO";4;1;3;8
2015;"PRESIDENTE DUTRA (MA)";"MA";"PRESIDENTE DUTRA";471;21;29;521
2015;"PRESIDENTE JUSCELINO (MA)";"MA";"PRESIDENTE JUSCELINO";8;2;2;12
2015;"PRESIDENTE MEDICI (MA)";"MA";"PRESIDENTE MEDICI";16;6;3;25
2015;"PRESIDENTE SARNEY (MA)";"MA";"PRESIDENTE SARNEY";15;7;8;30
2015;"PRESIDENTE VARGAS (MA)";"MA";"PRESIDENTE VARGAS";25;5;5;35
2015;"PRIMEIRA CRUZ (MA)";"MA";"PRIMEIRA CRUZ";2;1;1;4
2015;"RAPOSA (MA)";"MA";"RAPOSA";111;5;58;174
2015;"RIACHAO (MA)";"MA";"RIACHAO";85;10;19;114
2015;"RIBAMAR FIQUENE (MA)";"MA";"RIBAMAR FIQUENE";26;3;4;33
2015;"ROSARIO (MA)";"MA";"ROSARIO";225;26;52;303
2015;"SAMBAIBA (MA)";"MA";"SAMBAIBA";24;5;6;35
2015;"SANTA FILOMENA DO MARANHAO (MA)";"MA";"SANTA FILOMENA DO MARANHAO";8;7;4;19
2015;"SANTA HELENA (MA)";"MA";"SANTA HELENA";109;8;11;128
2015;"SANTA INES (MA)";"MA";"SANTA INES";876;186;119;1181
2015;"SANTA LUZIA (MA)";"MA";"SANTA LUZIA";288;94;14;396
2015;"SANTA LUZIA DO PARUA (MA)";"MA";"SANTA LUZIA DO PARUA";149;16;11;176
2015;"SANTA QUITERIA DO MARANHAO (MA)";"MA";"SANTA QUITERIA DO MARANHAO";47;3;17;67
2015;"SANTA RITA (MA)";"MA";"SANTA RITA";176;11;19;206
2015;"SANTANA DO MARANHAO (MA)";"MA";"SANTANA DO MARANHAO";12;1;6;19
2015;"SANTO AMARO DO MARANHAO (MA)";"MA";"SANTO AMARO DO MARANHAO";2;4;2;8
2015;"SANTO ANTONIO DOS LOPES (MA)";"MA";"SANTO ANTONIO DOS LOPES";110;10;12;132
2015;"SAO BENEDITO DO RIO PRETO (MA)";"MA";"SAO BENEDITO DO RIO PRETO";18;9;4;31
2015;"SAO BENTO (MA)";"MA";"SAO BENTO";159;37;20;216
2015;"SAO BERNARDO (MA)";"MA";"SAO BERNARDO";93;7;20;120
2015;"SAO DOMINGOS DO AZEITAO (MA)";"MA";"SAO DOMINGOS DO AZEITAO";49;3;2;54
2015;"SAO DOMINGOS DO MARANHAO (MA)";"MA";"SAO DOMINGOS DO MARANHAO";220;2;21;243
2015;"SAO FELIX DE BALSAS (MA)";"MA";"SAO FELIX DE BALSAS";6;2;1;9
2015;"SAO FRANCISCO DO BREJAO (MA)";"MA";"SAO FRANCISCO DO BREJAO";61;2;3;66
2015;"SAO FRANCISCO DO MARANHAO (MA)";"MA";"SAO FRANCISCO DO MARANHAO";11;0;2;13
2015;"SAO JOAO BATISTA (MA)";"MA";"SAO JOAO BATISTA";35;6;11;52
2015;"SAO JOAO DO CARU (MA)";"MA";"SAO JOAO DO CARU";32;1;1;34
2015;"SAO JOAO DO PARAISO (MA)";"MA";"SAO JOAO DO PARAISO";19;6;6;31
2015;"SAO JOAO DO SOTER (MA)";"MA";"SAO JOAO DO SOTER";29;1;9;39
2015;"SAO JOAO DOS PATOS (MA)";"MA";"SAO JOAO DOS PATOS";198;8;7;213
2015;"SAO JOSE DE RIBAMAR (MA)";"MA";"SAO JOSE DE RIBAMAR";845;160;252;1257
2015;"SAO JOSE DOS BASILIOS (MA)";"MA";"SAO JOSE DOS BASILIOS";17;3;2;22
2015;"SAO LUIS (MA)";"MA";"SAO LUIS";9758;1435;4248;15441
2015;"SAO LUIS GONZAGA DO MARANHAO (MA)";"MA";"SAO LUIS GONZAGA DO MARANHAO";37;11;9;57
2015;"SAO MATEUS DO MARANHAO (MA)";"MA";"SAO MATEUS DO MARANHAO";130;42;23;195
2015;"SAO PEDRO DA AGUA BRANCA (MA)";"MA";"SAO PEDRO DA AGUA BRANCA";15;6;6;27
2015;"SAO PEDRO DOS CRENTES (MA)";"MA";"SAO PEDRO DOS CRENTES";31;1;8;40
2015;"SAO RAIMUNDO DAS MANGABEIRAS (MA)";"MA";"SAO RAIMUNDO DAS MANGABEIRAS";157;8;50;215
2015;"SAO RAIMUNDO DO DOCA BEZERRA (MA)";"MA";"SAO RAIMUNDO DO DOCA BEZERRA";16;0;1;17
2015;"SAO ROBERTO (MA)";"MA";"SAO ROBERTO";18;5;3;26
2015;"SAO VICENTE FERRER (MA)";"MA";"SAO VICENTE FERRER";30;2;5;37
2015;"SATUBINHA (MA)";"MA";"SATUBINHA";16;6;2;24
2015;"SENADOR ALEXANDRE COSTA (MA)";"MA";"SENADOR ALEXANDRE COSTA";25;8;6;39
2015;"SENADOR LA ROCQUE (MA)";"MA";"SENADOR LA ROCQUE";76;0;3;79
2015;"SERRANO DO MARANHAO (MA)";"MA";"SERRANO DO MARANHAO";6;1;5;12
2015;"SITIO NOVO (MA)";"MA";"SITIO NOVO";70;5;7;82
2015;"SUCUPIRA DO NORTE (MA)";"MA";"SUCUPIRA DO NORTE";22;4;5;31
2015;"SUCUPIRA DO RIACHAO (MA)";"MA";"SUCUPIRA DO RIACHAO";11;6;5;22
2015;"TASSO FRAGOSO (MA)";"MA";"TASSO FRAGOSO";85;4;7;96
2015;"TIMBIRAS (MA)";"MA";"TIMBIRAS";39;4;4;47
2015;"TIMON (MA)";"MA";"TIMON";673;49;104;826
2015;"TRIZIDELA DO VALE (MA)";"MA";"TRIZIDELA DO VALE";150;30;9;189
2015;"TUFILANDIA (MA)";"MA";"TUFILANDIA";9;6;1;16
2015;"TUNTUM (MA)";"MA";"TUNTUM";141;8;16;165
2015;"TURIACU (MA)";"MA";"TURIACU";39;4;6;49
2015;"TURILANDIA (MA)";"MA";"TURILANDIA";16;4;3;23
2015;"TUTOIA (MA)";"MA";"TUTOIA";87;19;11;117
2015;"URBANO SANTOS (MA)";"MA";"URBANO SANTOS";70;7;14;91
2015;"VARGEM GRANDE (MA)";"MA";"VARGEM GRANDE";134;9;15;158
2015;"VIANA (MA)";"MA";"VIANA";220;11;5;236
2015;"VILA NOVA DOS MARTIRIOS (MA)";"MA";"VILA NOVA DOS MARTIRIOS";36;5;4;45
2015;"VITORIA DO MEARIM (MA)";"MA";"VITORIA DO MEARIM";109;10;9;128
2015;"VITORINO FREIRE (MA)";"MA";"VITORINO FREIRE";130;8;11;149
2015;"ZE DOCA (MA)";"MA";"ZE DOCA";241;26;32;299
2015;"ABADIA DOS DOURADOS (MG)";"MG";"ABADIA DOS DOURADOS";155;33;12;200
2015;"ABAETE (MG)";"MG";"ABAETE";487;39;176;702
2015;"ABRE CAMPO (MG)";"MG";"ABRE CAMPO";229;18;54;301
2015;"ACAIACA (MG)";"MG";"ACAIACA";35;9;10;54
2015;"ACUCENA (MG)";"MG";"ACUCENA";49;15;37;101
2015;"AGUA BOA (MG)";"MG";"AGUA BOA";75;11;34;120
2015;"AGUA COMPRIDA (MG)";"MG";"AGUA COMPRIDA";34;11;9;54
2015;"AGUANIL (MG)";"MG";"AGUANIL";67;6;12;85
2015;"AGUAS FORMOSAS (MG)";"MG";"AGUAS FORMOSAS";114;26;52;192
2015;"AGUAS VERMELHAS (MG)";"MG";"AGUAS VERMELHAS";90;22;25;137
2015;"AIMORES (MG)";"MG";"AIMORES";202;40;41;283
2015;"AIURUOCA (MG)";"MG";"AIURUOCA";115;27;10;152
2015;"ALAGOA (MG)";"MG";"ALAGOA";32;4;21;57
2015;"ALBERTINA (MG)";"MG";"ALBERTINA";54;19;7;80
2015;"ALEM PARAIBA (MG)";"MG";"ALEM PARAIBA";1412;122;80;1614
2015;"ALFENAS (MG)";"MG";"ALFENAS";1309;155;359;1823
2015;"ALFREDO VASCONCELOS (MG)";"MG";"ALFREDO VASCONCELOS";162;14;27;203
2015;"ALMENARA (MG)";"MG";"ALMENARA";290;82;126;498
2015;"ALPERCATA (MG)";"MG";"ALPERCATA";98;4;7;109
2015;"ALPINOPOLIS (MG)";"MG";"ALPINOPOLIS";477;51;71;599
2015;"ALTEROSA (MG)";"MG";"ALTEROSA";265;36;60;361
2015;"ALTO CAPARAO (MG)";"MG";"ALTO CAPARAO";77;18;15;110
2015;"ALTO JEQUITIBA (MG)";"MG";"ALTO JEQUITIBA";101;10;19;130
2015;"ALTO RIO DOCE (MG)";"MG";"ALTO RIO DOCE";128;37;34;199
2015;"ALVARENGA (MG)";"MG";"ALVARENGA";37;4;15;56
2015;"ALVINOPOLIS (MG)";"MG";"ALVINOPOLIS";211;19;25;255
2015;"ALVORADA DE MINAS (MG)";"MG";"ALVORADA DE MINAS";27;17;18;62
2015;"AMPARO DA SERRA (MG)";"MG";"AMPARO DA SERRA";49;8;37;94
2015;"ANDRADAS (MG)";"MG";"ANDRADAS";1140;100;114;1354
2015;"ANDRELANDIA (MG)";"MG";"ANDRELANDIA";159;39;24;222
2015;"ANGELANDIA (MG)";"MG";"ANGELANDIA";83;12;36;131
2015;"ANTONIO CARLOS (MG)";"MG";"ANTONIO CARLOS";170;29;46;245
2015;"ANTONIO DIAS (MG)";"MG";"ANTONIO DIAS";116;15;53;184
2015;"ANTONIO PRADO DE MINAS (MG)";"MG";"ANTONIO PRADO DE MINAS";18;4;5;27
2015;"ARACAI (MG)";"MG";"ARACAI";17;9;8;34
2015;"ARACITABA (MG)";"MG";"ARACITABA";14;2;3;19
2015;"ARACUAI (MG)";"MG";"ARACUAI";268;18;106;392
2015;"ARAGUARI (MG)";"MG";"ARAGUARI";2578;380;189;3147
2015;"ARANTINA (MG)";"MG";"ARANTINA";42;3;4;49
2015;"ARAPONGA (MG)";"MG";"ARAPONGA";69;8;14;91
2015;"ARAPORA (MG)";"MG";"ARAPORA";204;15;61;280
2015;"ARAPUA (MG)";"MG";"ARAPUA";53;4;13;70
2015;"ARAUJOS (MG)";"MG";"ARAUJOS";154;17;9;180
2015;"ARAXA (MG)";"MG";"ARAXA";1974;210;356;2540
2015;"ARCEBURGO (MG)";"MG";"ARCEBURGO";146;27;64;237
2015;"ARCOS (MG)";"MG";"ARCOS";1221;107;299;1627
2015;"AREADO (MG)";"MG";"AREADO";233;28;85;346
2015;"ARGIRITA (MG)";"MG";"ARGIRITA";27;5;9;41
2015;"ARICANDUVA (MG)";"MG";"ARICANDUVA";26;6;16;48
2015;"ARINOS (MG)";"MG";"ARINOS";423;33;128;584
2015;"ASTOLFO DUTRA (MG)";"MG";"ASTOLFO DUTRA";266;9;25;300
2015;"ATALEIA (MG)";"MG";"ATALEIA";102;27;36;165
2015;"AUGUSTO DE LIMA (MG)";"MG";"AUGUSTO DE LIMA";37;7;22;66
2015;"BAEPENDI (MG)";"MG";"BAEPENDI";407;72;35;514
2015;"BALDIM (MG)";"MG";"BALDIM";195;14;20;229
2015;"BAMBUI (MG)";"MG";"BAMBUI";554;53;85;692
2015;"BANDEIRA (MG)";"MG";"BANDEIRA";19;8;13;40
2015;"BANDEIRA DO SUL (MG)";"MG";"BANDEIRA DO SUL";130;30;9;169
2015;"BARAO DE COCAIS (MG)";"MG";"BARAO DE COCAIS";547;113;91;751
2015;"BARAO D0 MONTE ALTO (MG)";"MG";"BARAO D0 MONTE ALTO";55;7;12;74
2015;"BARBACENA (MG)";"MG";"BARBACENA";1857;343;259;2459
2015;"BARRA LONGA (MG)";"MG";"BARRA LONGA";44;6;11;61
2015;"BARROSO (MG)";"MG";"BARROSO";456;32;42;530
2015;"BELA VISTA DE MINAS (MG)";"MG";"BELA VISTA DE MINAS";172;17;12;201
2015;"BELMIRO BRAGA (MG)";"MG";"BELMIRO BRAGA";72;14;8;94
2015;"BELO HORIZONTE (MG)";"MG";"BELO HORIZONTE";35689;6265;8769;50723
2015;"BELO ORIENTE (MG)";"MG";"BELO ORIENTE";253;28;106;387
2015;"BELO VALE (MG)";"MG";"BELO VALE";228;27;36;291
2015;"BERILO (MG)";"MG";"BERILO";78;7;36;121
2015;"BERIZAL (MG)";"MG";"BERIZAL";35;8;10;53
2015;"BERTOPOLIS (MG)";"MG";"BERTOPOLIS";14;5;4;23
2015;"BETIM (MG)";"MG";"BETIM";6166;743;1518;8427
2015;"BIAS FORTES (MG)";"MG";"BIAS FORTES";30;5;6;41
2015;"BICAS (MG)";"MG";"BICAS";233;35;40;308
2015;"BIQUINHAS (MG)";"MG";"BIQUINHAS";62;8;4;74
2015;"BOA ESPERANCA (MG)";"MG";"BOA ESPERANCA";817;113;214;1144
2015;"BOCAINA DE MINAS (MG)";"MG";"BOCAINA DE MINAS";91;20;13;124
2015;"BOCAIUVA (MG)";"MG";"BOCAIUVA";571;73;191;835
2015;"BOM DESPACHO (MG)";"MG";"BOM DESPACHO";1124;102;463;1689
2015;"BOM JARDIM DE MINAS (MG)";"MG";"BOM JARDIM DE MINAS";137;20;19;176
2015;"BOM JESUS DA PENHA (MG)";"MG";"BOM JESUS DA PENHA";137;19;18;174
2015;"BOM JESUS DO AMPARO (MG)";"MG";"BOM JESUS DO AMPARO";87;10;15;112
2015;"BOM JESUS DO GALHO (MG)";"MG";"BOM JESUS DO GALHO";109;9;23;141
2015;"BOM REPOUSO (MG)";"MG";"BOM REPOUSO";216;17;16;249
2015;"BOM SUCESSO (MG)";"MG";"BOM SUCESSO";233;34;60;327
2015;"BONFIM (MG)";"MG";"BONFIM";154;21;25;200
2015;"BONFINOPOLIS DE MINAS (MG)";"MG";"BONFINOPOLIS DE MINAS";93;3;32;128
2015;"BONITO DE MINAS (MG)";"MG";"BONITO DE MINAS";35;7;34;76
2015;"BORDA DA MATA (MG)";"MG";"BORDA DA MATA";306;40;83;429
2015;"BOTELHOS (MG)";"MG";"BOTELHOS";250;88;48;386
2015;"BOTUMIRIM (MG)";"MG";"BOTUMIRIM";41;6;29;76
2015;"BRAS PIRES (MG)";"MG";"BRAS PIRES";51;9;10;70
2015;"BRASILANDIA DE MINAS (MG)";"MG";"BRASILANDIA DE MINAS";237;25;114;376
2015;"BRASILIA DE MINAS (MG)";"MG";"BRASILIA DE MINAS";310;24;88;422
2015;"BRASOPOLIS (MG)";"MG";"BRASOPOLIS";214;38;43;295
2015;"BRAUNAS (MG)";"MG";"BRAUNAS";22;10;21;53
2015;"BRUMADINHO (MG)";"MG";"BRUMADINHO";969;133;236;1338
2015;"BUENO BRANDAO (MG)";"MG";"BUENO BRANDAO";226;47;23;296
2015;"BUENOPOLIS (MG)";"MG";"BUENOPOLIS";113;13;29;155
2015;"BUGRE (MG)";"MG";"BUGRE";27;3;8;38
2015;"BURITIS (MG)";"MG";"BURITIS";302;14;105;421
2015;"BURITIZEIRO (MG)";"MG";"BURITIZEIRO";266;41;114;421
2015;"CABECEIRA GRANDE (MG)";"MG";"CABECEIRA GRANDE";62;3;10;75
2015;"CABO VERDE (MG)";"MG";"CABO VERDE";189;48;44;281
2015;"CACHOEIRA DA PRATA (MG)";"MG";"CACHOEIRA DA PRATA";59;3;7;69
2015;"CACHOEIRA DE MINAS (MG)";"MG";"CACHOEIRA DE MINAS";143;26;21;190
2015;"CACHOEIRA DE PAJEU (MG)";"MG";"CACHOEIRA DE PAJEU";43;17;23;83
2015;"CACHOEIRA DOURADA (MG)";"MG";"CACHOEIRA DOURADA";13;10;3;26
2015;"CAETANOPOLIS (MG)";"MG";"CAETANOPOLIS";156;20;50;226
2015;"CAETE (MG)";"MG";"CAETE";547;124;63;734
2015;"CAIANA (MG)";"MG";"CAIANA";53;13;14;80
2015;"CAJURI (MG)";"MG";"CAJURI";62;8;12;82
2015;"CALDAS (MG)";"MG";"CALDAS";323;43;29;395
2015;"CAMACHO (MG)";"MG";"CAMACHO";47;11;15;73
2015;"CAMANDUCAIA (MG)";"MG";"CAMANDUCAIA";527;50;60;637
2015;"CAMBUI (MG)";"MG";"CAMBUI";629;82;112;823
2015;"CAMBUQUIRA (MG)";"MG";"CAMBUQUIRA";155;39;34;228
2015;"CAMPANARIO (MG)";"MG";"CAMPANARIO";19;5;4;28
2015;"CAMPANHA (MG)";"MG";"CAMPANHA";282;64;51;397
2015;"CAMPESTRE (MG)";"MG";"CAMPESTRE";524;63;67;654
2015;"CAMPINA VERDE (MG)";"MG";"CAMPINA VERDE";289;44;55;388
2015;"CAMPO AZUL (MG)";"MG";"CAMPO AZUL";11;3;8;22
2015;"CAMPO BELO (MG)";"MG";"CAMPO BELO";1336;97;130;1563
2015;"CAMPO DO MEIO (MG)";"MG";"CAMPO DO MEIO";131;27;76;234
2015;"CAMPO FLORIDO (MG)";"MG";"CAMPO FLORIDO";203;35;77;315
2015;"CAMPOS ALTOS (MG)";"MG";"CAMPOS ALTOS";360;37;109;506
2015;"CAMPOS GERAIS (MG)";"MG";"CAMPOS GERAIS";385;39;142;566
2015;"CANA VERDE (MG)";"MG";"CANA VERDE";77;10;17;104
2015;"CANAA (MG)";"MG";"CANAA";62;5;10;77
2015;"CANAPOLIS (MG)";"MG";"CANAPOLIS";250;14;90;354
2015;"CANDEIAS (MG)";"MG";"CANDEIAS";271;38;40;349
2015;"CANTAGALO (MG)";"MG";"CANTAGALO";24;6;7;37
2015;"CAPARAO (MG)";"MG";"CAPARAO";73;7;13;93
2015;"CAPELA NOVA (MG)";"MG";"CAPELA NOVA";26;14;5;45
2015;"CAPELINHA (MG)";"MG";"CAPELINHA";794;59;181;1034
2015;"CAPETINGA (MG)";"MG";"CAPETINGA";189;26;41;256
2015;"CAPIM BRANCO (MG)";"MG";"CAPIM BRANCO";94;19;12;125
2015;"CAPINOPOLIS (MG)";"MG";"CAPINOPOLIS";290;31;66;387
2015;"CAPITAO ANDRADE (MG)";"MG";"CAPITAO ANDRADE";55;6;8;69
2015;"CAPITAO ENEAS (MG)";"MG";"CAPITAO ENEAS";91;5;33;129
2015;"CAPITOLIO (MG)";"MG";"CAPITOLIO";171;22;25;218
2015;"CAPUTIRA (MG)";"MG";"CAPUTIRA";144;9;52;205
2015;"CARAI (MG)";"MG";"CARAI";81;54;54;189
2015;"CARANAIBA (MG)";"MG";"CARANAIBA";26;11;15;52
2015;"CARANDAI (MG)";"MG";"CARANDAI";603;69;115;787
2015;"CARANGOLA (MG)";"MG";"CARANGOLA";428;66;64;558
2015;"CARATINGA (MG)";"MG";"CARATINGA";1324;85;490;1899
2015;"CARBONITA (MG)";"MG";"CARBONITA";170;26;42;238
2015;"CAREACU (MG)";"MG";"CAREACU";137;17;12;166
2015;"CARLOS CHAGAS (MG)";"MG";"CARLOS CHAGAS";167;43;54;264
2015;"CARMESIA (MG)";"MG";"CARMESIA";80;3;1503;1586
2015;"CARMO DA CACHOEIRA (MG)";"MG";"CARMO DA CACHOEIRA";199;46;60;305
2015;"CARMO DA MATA (MG)";"MG";"CARMO DA MATA";144;37;53;234
2015;"CARMO DE MINAS (MG)";"MG";"CARMO DE MINAS";167;51;31;249
2015;"CARMO DO CAJURU (MG)";"MG";"CARMO DO CAJURU";425;70;101;596
2015;"CARMO DO PARANAIBA (MG)";"MG";"CARMO DO PARANAIBA";717;81;123;921
2015;"CARMO DO RIO CLARO (MG)";"MG";"CARMO DO RIO CLARO";383;37;99;519
2015;"CARMOPOLIS DE MINAS (MG)";"MG";"CARMOPOLIS DE MINAS";532;65;53;650
2015;"CARNEIRINHO (MG)";"MG";"CARNEIRINHO";205;22;68;295
2015;"CARRANCAS (MG)";"MG";"CARRANCAS";53;8;11;72
2015;"CARVALHOPOLIS (MG)";"MG";"CARVALHOPOLIS";47;12;8;67
2015;"CARVALHOS (MG)";"MG";"CARVALHOS";77;9;9;95
2015;"CASA GRANDE (MG)";"MG";"CASA GRANDE";43;5;5;53
2015;"CASCALHO RICO (MG)";"MG";"CASCALHO RICO";51;34;4;89
2015;"CASSIA (MG)";"MG";"CASSIA";431;59;70;560
2015;"CATAGUASES (MG)";"MG";"CATAGUASES";799;95;173;1067
2015;"CATAS ALTAS (MG)";"MG";"CATAS ALTAS";162;21;8;191
2015;"CATAS ALTAS DA NORUEGA (MG)";"MG";"CATAS ALTAS DA NORUEGA";48;5;12;65
2015;"CATUJI (MG)";"MG";"CATUJI";49;22;17;88
2015;"CATUTI (MG)";"MG";"CATUTI";37;5;26;68
2015;"CAXAMBU (MG)";"MG";"CAXAMBU";227;46;26;299
2015;"CEDRO DO ABAETE (MG)";"MG";"CEDRO DO ABAETE";12;2;3;17
2015;"CENTRAL DE MINAS (MG)";"MG";"CENTRAL DE MINAS";84;9;20;113
2015;"CENTRALINA (MG)";"MG";"CENTRALINA";111;9;17;137
2015;"CHACARA (MG)";"MG";"CHACARA";37;6;14;57
2015;"CHALE (MG)";"MG";"CHALE";73;11;17;101
2015;"CHAPADA DO NORTE (MG)";"MG";"CHAPADA DO NORTE";53;21;30;104
2015;"CHAPADA GAUCHA (MG)";"MG";"CHAPADA GAUCHA";140;9;49;198
2015;"CHIADOR (MG)";"MG";"CHIADOR";128;17;11;156
2015;"CIPOTANEA (MG)";"MG";"CIPOTANEA";63;7;18;88
2015;"CLARAVAL (MG)";"MG";"CLARAVAL";120;10;25;155
2015;"CLARO DOS POCOES (MG)";"MG";"CLARO DOS POCOES";64;9;34;107
2015;"CLAUDIO (MG)";"MG";"CLAUDIO";792;52;64;908
2015;"COIMBRA (MG)";"MG";"COIMBRA";137;7;13;157
2015;"COLUNA (MG)";"MG";"COLUNA";67;6;16;89
2015;"COMENDADOR GOMES (MG)";"MG";"COMENDADOR GOMES";47;10;13;70
2015;"COMERCINHO (MG)";"MG";"COMERCINHO";31;10;20;61
2015;"CONCEICAO DA APARECIDA (MG)";"MG";"CONCEICAO DA APARECIDA";174;17;27;218
2015;"CONCEICAO DA BARRA DE MINAS (MG)";"MG";"CONCEICAO DA BARRA DE MINAS";41;17;10;68
2015;"CONCEICAO DAS ALAGOAS (MG)";"MG";"CONCEICAO DAS ALAGOAS";549;55;126;730
2015;"CONCEICAO DAS PEDRAS (MG)";"MG";"CONCEICAO DAS PEDRAS";26;6;7;39
2015;"CONCEICAO DE IPANEMA (MG)";"MG";"CONCEICAO DE IPANEMA";53;8;6;67
2015;"CONCEICAO DO MATO DENTRO (MG)";"MG";"CONCEICAO DO MATO DENTRO";183;64;212;459
2015;"CONCEICAO DO PARA (MG)";"MG";"CONCEICAO DO PARA";79;18;17;114
2015;"CONCEICAO DO RIO VERDE (MG)";"MG";"CONCEICAO DO RIO VERDE";206;60;36;302
2015;"CONCEICAO DOS OUROS (MG)";"MG";"CONCEICAO DOS OUROS";284;24;17;325
2015;"CONEGO MARINHO (MG)";"MG";"CONEGO MARINHO";27;5;22;54
2015;"CONFINS (MG)";"MG";"CONFINS";163;23;26;212
2015;"CONGONHAL (MG)";"MG";"CONGONHAL";278;12;15;305
2015;"CONGONHAS (MG)";"MG";"CONGONHAS";1198;171;145;1514
2015;"CONGONHAS DO NORTE (MG)";"MG";"CONGONHAS DO NORTE";54;8;10;72
2015;"CONQUISTA (MG)";"MG";"CONQUISTA";169;25;41;235
2015;"CONSELHEIRO LAFAIETE (MG)";"MG";"CONSELHEIRO LAFAIETE";1564;370;711;2645
2015;"CONSELHEIRO PENA (MG)";"MG";"CONSELHEIRO PENA";221;7;64;292
2015;"CONSOLACAO (MG)";"MG";"CONSOLACAO";16;9;3;28
2015;"CONTAGEM (MG)";"MG";"CONTAGEM";14849;1696;3003;19548
2015;"COQUEIRAL (MG)";"MG";"COQUEIRAL";126;17;27;170
2015;"CORACAO DE JESUS (MG)";"MG";"CORACAO DE JESUS";201;9;112;322
2015;"CORDISBURGO (MG)";"MG";"CORDISBURGO";104;16;16;136
2015;"CORDISLANDIA (MG)";"MG";"CORDISLANDIA";44;15;8;67
2015;"CORINTO (MG)";"MG";"CORINTO";356;31;89;476
2015;"COROACI (MG)";"MG";"COROACI";81;8;14;103
2015;"COROMANDEL (MG)";"MG";"COROMANDEL";658;101;98;857
2015;"CORONEL FABRICIANO (MG)";"MG";"CORONEL FABRICIANO";1254;224;612;2090
2015;"CORONEL MURTA (MG)";"MG";"CORONEL MURTA";34;6;17;57
2015;"CORONEL PACHECO (MG)";"MG";"CORONEL PACHECO";34;5;8;47
2015;"CORONEL XAVIER CHAVES (MG)";"MG";"CORONEL XAVIER CHAVES";89;9;3;101
2015;"CORREGO DANTA (MG)";"MG";"CORREGO DANTA";46;5;15;66
2015;"CORREGO DO BOM JESUS (MG)";"MG";"CORREGO DO BOM JESUS";40;10;12;62
2015;"CORREGO FUNDO (MG)";"MG";"CORREGO FUNDO";356;22;21;399
2015;"CORREGO NOVO (MG)";"MG";"CORREGO NOVO";12;5;7;24
2015;"COUTO DE MAGALHAES DE MINAS (MG)";"MG";"COUTO DE MAGALHAES DE MINAS";62;3;12;77
2015;"CRISOLITA (MG)";"MG";"CRISOLITA";16;20;13;49
2015;"CRISTAIS (MG)";"MG";"CRISTAIS";166;32;32;230
2015;"CRISTALIA (MG)";"MG";"CRISTALIA";32;6;27;65
2015;"CRISTIANO OTONI (MG)";"MG";"CRISTIANO OTONI";103;13;10;126
2015;"CRISTINA (MG)";"MG";"CRISTINA";111;28;15;154
2015;"CRUCILANDIA (MG)";"MG";"CRUCILANDIA";168;10;14;192
2015;"CRUZEIRO DA FORTALEZA (MG)";"MG";"CRUZEIRO DA FORTALEZA";104;7;15;126
2015;"CRUZILIA (MG)";"MG";"CRUZILIA";369;42;49;460
2015;"CUPARAQUE (MG)";"MG";"CUPARAQUE";52;9;6;67
2015;"CURRAL DE DENTRO (MG)";"MG";"CURRAL DE DENTRO";61;12;17;90
2015;"CURVELO (MG)";"MG";"CURVELO";1256;69;1768;3093
2015;"DATAS (MG)";"MG";"DATAS";43;4;18;65
2015;"DELFIM MOREIRA (MG)";"MG";"DELFIM MOREIRA";90;13;25;128
2015;"DELFINOPOLIS (MG)";"MG";"DELFINOPOLIS";109;19;18;146
2015;"DELTA (MG)";"MG";"DELTA";469;42;142;653
2015;"DESCOBERTO (MG)";"MG";"DESCOBERTO";41;10;3;54
2015;"DESTERRO DE ENTRE RIOS (MG)";"MG";"DESTERRO DE ENTRE RIOS";122;25;27;174
2015;"DESTERRO DO MELO (MG)";"MG";"DESTERRO DO MELO";39;11;16;66
2015;"DIAMANTINA (MG)";"MG";"DIAMANTINA";447;100;379;926
2015;"DIOGO DE VASCONCELOS (MG)";"MG";"DIOGO DE VASCONCELOS";22;5;9;36
2015;"DIONISIO (MG)";"MG";"DIONISIO";54;6;19;79
2015;"DIVINESIA (MG)";"MG";"DIVINESIA";90;7;15;112
2015;"DIVINO (MG)";"MG";"DIVINO";274;21;56;351
2015;"DIVINO DAS LARANJEIRAS (MG)";"MG";"DIVINO DAS LARANJEIRAS";50;1;6;57
2015;"DIVINOLANDIA DE MINAS (MG)";"MG";"DIVINOLANDIA DE MINAS";74;6;17;97
2015;"DIVINOPOLIS (MG)";"MG";"DIVINOPOLIS";3393;265;747;4405
2015;"DIVISA ALEGRE (MG)";"MG";"DIVISA ALEGRE";53;5;9;67
2015;"DIVISA NOVA (MG)";"MG";"DIVISA NOVA";89;29;39;157
2015;"DIVISOPOLIS (MG)";"MG";"DIVISOPOLIS";61;13;14;88
2015;"DOM BOSCO (MG)";"MG";"DOM BOSCO";27;5;13;45
2015;"DOM CAVATI (MG)";"MG";"DOM CAVATI";171;8;12;191
2015;"DOM JOAQUIM (MG)";"MG";"DOM JOAQUIM";31;7;12;50
2015;"DOM SILVERIO (MG)";"MG";"DOM SILVERIO";72;11;9;92
2015;"DOM VICOSO (MG)";"MG";"DOM VICOSO";34;13;11;58
2015;"DONA EUZEBIA (MG)";"MG";"DONA EUZEBIA";316;4;5;325
2015;"DORES DE CAMPOS (MG)";"MG";"DORES DE CAMPOS";120;21;40;181
2015;"DORES DE GUANHAES (MG)";"MG";"DORES DE GUANHAES";38;7;23;68
2015;"DORES DO INDAIA (MG)";"MG";"DORES DO INDAIA";259;43;17;319
2015;"DORES DO TURVO (MG)";"MG";"DORES DO TURVO";56;5;17;78
2015;"DORESOPOLIS (MG)";"MG";"DORESOPOLIS";19;7;4;30
2015;"DOURADOQUARA (MG)";"MG";"DOURADOQUARA";20;7;2;29
2015;"DURANDE (MG)";"MG";"DURANDE";105;11;23;139
2015;"ELOI MENDES (MG)";"MG";"ELOI MENDES";555;82;55;692
2015;"ENGENHEIRO CALDAS (MG)";"MG";"ENGENHEIRO CALDAS";164;9;19;192
2015;"ENGENHEIRO NAVARRO (MG)";"MG";"ENGENHEIRO NAVARRO";73;3;24;100
2015;"ENTRE FOLHAS (MG)";"MG";"ENTRE FOLHAS";63;6;10;79
2015;"ENTRE RIOS DE MINAS (MG)";"MG";"ENTRE RIOS DE MINAS";317;26;80;423
2015;"ERVALIA (MG)";"MG";"ERVALIA";330;24;54;408
2015;"ESMERALDAS (MG)";"MG";"ESMERALDAS";526;52;324;902
2015;"ESPERA FELIZ (MG)";"MG";"ESPERA FELIZ";382;43;55;480
2015;"ESPINOSA (MG)";"MG";"ESPINOSA";351;32;89;472
2015;"ESPIRITO SANTO DO DOURADO (MG)";"MG";"ESPIRITO SANTO DO DOURADO";99;8;9;116
2015;"ESTIVA (MG)";"MG";"ESTIVA";278;21;24;323
2015;"ESTRELA DALVA (MG)";"MG";"ESTRELA DALVA";32;3;3;38
2015;"ESTRELA DO INDAIA (MG)";"MG";"ESTRELA DO INDAIA";52;10;6;68
2015;"ESTRELA DO SUL (MG)";"MG";"ESTRELA DO SUL";111;17;21;149
2015;"EUGENOPOLIS (MG)";"MG";"EUGENOPOLIS";130;28;35;193
2015;"EWBANK DA CAMARA (MG)";"MG";"EWBANK DA CAMARA";38;4;4;46
2015;"EXTREMA (MG)";"MG";"EXTREMA";548;128;120;796
2015;"FAMA (MG)";"MG";"FAMA";19;8;1;28
2015;"FARIA LEMOS (MG)";"MG";"FARIA LEMOS";28;4;3;35
2015;"FELICIO DOS SANTOS (MG)";"MG";"FELICIO DOS SANTOS";44;13;29;86
2015;"FELISBURGO (MG)";"MG";"FELISBURGO";26;9;15;50
2015;"FELIXLANDIA (MG)";"MG";"FELIXLANDIA";232;20;63;315
2015;"FERNANDES TOURINHO (MG)";"MG";"FERNANDES TOURINHO";23;11;13;47
2015;"FERROS (MG)";"MG";"FERROS";119;19;54;192
2015;"FERVEDOURO (MG)";"MG";"FERVEDOURO";144;13;15;172
2015;"FLORESTAL (MG)";"MG";"FLORESTAL";114;12;43;169
2015;"FORMIGA (MG)";"MG";"FORMIGA";1719;191;245;2155
2015;"FORMOSO (MG)";"MG";"FORMOSO";49;1;34;84
2015;"FORTALEZA DE MINAS (MG)";"MG";"FORTALEZA DE MINAS";71;21;16;108
2015;"FORTUNA DE MINAS (MG)";"MG";"FORTUNA DE MINAS";37;7;13;57
2015;"FRANCISCO BADARO (MG)";"MG";"FRANCISCO BADARO";58;11;24;93
2015;"FRANCISCO DUMONT (MG)";"MG";"FRANCISCO DUMONT";61;10;32;103
2015;"FRANCISCO SA (MG)";"MG";"FRANCISCO SA";181;15;105;301
2015;"FRANCISCOPOLIS (MG)";"MG";"FRANCISCOPOLIS";21;8;19;48
2015;"FREI GASPAR (MG)";"MG";"FREI GASPAR";30;11;14;55
2015;"FREI INOCENCIO (MG)";"MG";"FREI INOCENCIO";106;10;28;144
2015;"FREI LAGONEGRO (MG)";"MG";"FREI LAGONEGRO";10;2;13;25
2015;"FRONTEIRA (MG)";"MG";"FRONTEIRA";236;47;83;366
2015;"FRONTEIRA DOS VALES (MG)";"MG";"FRONTEIRA DOS VALES";15;4;2;21
2015;"FRUTA DE LEITE (MG)";"MG";"FRUTA DE LEITE";24;4;23;51
2015;"FRUTAL (MG)";"MG";"FRUTAL";1579;142;212;1933
2015;"FUNILANDIA (MG)";"MG";"FUNILANDIA";60;2;19;81
2015;"GALILEIA (MG)";"MG";"GALILEIA";70;2;10;82
2015;"GAMELEIRAS (MG)";"MG";"GAMELEIRAS";32;5;17;54
2015;"GLAUCILANDIA (MG)";"MG";"GLAUCILANDIA";4;2;6;12
2015;"GOIABEIRA (MG)";"MG";"GOIABEIRA";27;9;4;40
2015;"GOIANA (MG)";"MG";"GOIANA";31;6;6;43
2015;"GONCALVES (MG)";"MG";"GONCALVES";101;18;8;127
2015;"GONZAGA (MG)";"MG";"GONZAGA";40;7;15;62
2015;"GOUVEA (MG)";"MG";"GOUVEA";139;19;36;194
2015;"GOVERNADOR VALADARES (MG)";"MG";"GOVERNADOR VALADARES";3456;320;367;4143
2015;"GRAO MOGOL (MG)";"MG";"GRAO MOGOL";100;25;77;202
2015;"GRUPIARA (MG)";"MG";"GRUPIARA";13;4;5;22
2015;"GUANHAES (MG)";"MG";"GUANHAES";635;61;134;830
2015;"GUAPE (MG)";"MG";"GUAPE";274;28;63;365
2015;"GUARACIABA (MG)";"MG";"GUARACIABA";92;25;35;152
2015;"GUARACIAMA (MG)";"MG";"GUARACIAMA";55;3;18;76
2015;"GUARANESIA (MG)";"MG";"GUARANESIA";369;64;112;545
2015;"GUARANI (MG)";"MG";"GUARANI";86;23;14;123
2015;"GUARARA (MG)";"MG";"GUARARA";52;12;3;67
2015;"GUARDA MOR (MG)";"MG";"GUARDA MOR";112;15;27;154
2015;"GUAXUPE (MG)";"MG";"GUAXUPE";902;89;148;1139
2015;"GUIDOVAL (MG)";"MG";"GUIDOVAL";156;3;8;167
2015;"GUIMARANIA (MG)";"MG";"GUIMARANIA";169;16;42;227
2015;"GUIRICEMA (MG)";"MG";"GUIRICEMA";268;18;27;313
2015;"GURINHATA (MG)";"MG";"GURINHATA";91;14;33;138
2015;"HELIODORA (MG)";"MG";"HELIODORA";88;11;16;115
2015;"IAPU (MG)";"MG";"IAPU";163;16;27;206
2015;"IBERTIOGA (MG)";"MG";"IBERTIOGA";54;14;9;77
2015;"IBIA (MG)";"MG";"IBIA";421;56;116;593
2015;"IBIAI (MG)";"MG";"IBIAI";69;10;11;90
2015;"IBIRACATU (MG)";"MG";"IBIRACATU";23;8;24;55
2015;"IBIRACI (MG)";"MG";"IBIRACI";409;37;42;488
2015;"IBIRITE (MG)";"MG";"IBIRITE";1478;241;329;2048
2015;"IBITIURA DE MINAS (MG)";"MG";"IBITIURA DE MINAS";102;8;6;116
2015;"IBITURUNA (MG)";"MG";"IBITURUNA";29;5;5;39
2015;"ICARAI DE MINAS (MG)";"MG";"ICARAI DE MINAS";30;1;14;45
2015;"IGARAPE (MG)";"MG";"IGARAPE";720;53;192;965
2015;"IGARATINGA (MG)";"MG";"IGARATINGA";556;8;20;584
2015;"IGUATAMA (MG)";"MG";"IGUATAMA";136;19;19;174
2015;"IJACI (MG)";"MG";"IJACI";241;9;24;274
2015;"ILICINEA (MG)";"MG";"ILICINEA";243;18;41;302
2015;"IMBE DE MINAS (MG)";"MG";"IMBE DE MINAS";53;6;12;71
2015;"INCONFIDENTES (MG)";"MG";"INCONFIDENTES";92;25;37;154
2015;"INDAIABIRA (MG)";"MG";"INDAIABIRA";90;14;27;131
2015;"INDIANOPOLIS (MG)";"MG";"INDIANOPOLIS";102;33;21;156
2015;"INGAI (MG)";"MG";"INGAI";20;20;14;54
2015;"INHAPIM (MG)";"MG";"INHAPIM";441;30;84;555
2015;"INHAUMA (MG)";"MG";"INHAUMA";112;8;21;141
2015;"INIMUTABA (MG)";"MG";"INIMUTABA";51;4;11;66
2015;"IPABA (MG)";"MG";"IPABA";93;18;25;136
2015;"IPANEMA (MG)";"MG";"IPANEMA";270;33;39;342
2015;"IPATINGA (MG)";"MG";"IPATINGA";3229;624;651;4504
2015;"IPIACU (MG)";"MG";"IPIACU";66;3;11;80
2015;"IPUIUNA (MG)";"MG";"IPUIUNA";416;45;37;498
2015;"IRAI DE MINAS (MG)";"MG";"IRAI DE MINAS";229;25;32;286
2015;"ITABIRA (MG)";"MG";"ITABIRA";1903;368;695;2966
2015;"ITABIRINHA (MG)";"MG";"ITABIRINHA";147;8;32;187
2015;"ITABIRITO (MG)";"MG";"ITABIRITO";1025;261;402;1688
2015;"ITACAMBIRA (MG)";"MG";"ITACAMBIRA";16;2;8;26
2015;"ITACARAMBI (MG)";"MG";"ITACARAMBI";139;12;40;191
2015;"ITAGUARA (MG)";"MG";"ITAGUARA";475;26;81;582
2015;"ITAIPE (MG)";"MG";"ITAIPE";83;16;29;128
2015;"ITAJUBA (MG)";"MG";"ITAJUBA";841;117;123;1081
2015;"ITAMARANDIBA (MG)";"MG";"ITAMARANDIBA";707;48;148;903
2015;"ITAMARATI DE MINAS (MG)";"MG";"ITAMARATI DE MINAS";119;13;11;143
2015;"ITAMBACURI (MG)";"MG";"ITAMBACURI";200;34;51;285
2015;"ITAMBE DO MATO DENTRO (MG)";"MG";"ITAMBE DO MATO DENTRO";18;4;6;28
2015;"ITAMOGI (MG)";"MG";"ITAMOGI";282;29;39;350
2015;"ITAMONTE (MG)";"MG";"ITAMONTE";310;27;33;370
2015;"ITANHANDU (MG)";"MG";"ITANHANDU";495;33;37;565
2015;"ITANHOMI (MG)";"MG";"ITANHOMI";115;21;22;158
2015;"ITAOBIM (MG)";"MG";"ITAOBIM";231;31;44;306
2015;"ITAPAGIPE (MG)";"MG";"ITAPAGIPE";277;24;47;348
2015;"ITAPECERICA (MG)";"MG";"ITAPECERICA";352;66;56;474
2015;"ITAPEVA (MG)";"MG";"ITAPEVA";263;35;13;311
2015;"ITATIAIUCU (MG)";"MG";"ITATIAIUCU";336;20;52;408
2015;"ITAU DE MINAS (MG)";"MG";"ITAU DE MINAS";353;48;54;455
2015;"ITAUNA (MG)";"MG";"ITAUNA";1620;239;294;2153
2015;"ITAVERAVA (MG)";"MG";"ITAVERAVA";67;12;18;97
2015;"ITINGA (MG)";"MG";"ITINGA";78;30;40;148
2015;"ITUETA (MG)";"MG";"ITUETA";70;10;20;100
2015;"ITUIUTABA (MG)";"MG";"ITUIUTABA";1418;266;365;2049
2015;"ITUMIRIM (MG)";"MG";"ITUMIRIM";73;27;9;109
2015;"ITURAMA (MG)";"MG";"ITURAMA";885;91;322;1298
2015;"ITUTINGA (MG)";"MG";"ITUTINGA";66;26;5;97
2015;"JABOTICATUBAS (MG)";"MG";"JABOTICATUBAS";308;20;71;399
2015;"JACINTO (MG)";"MG";"JACINTO";43;7;42;92
2015;"JACUI (MG)";"MG";"JACUI";157;18;35;210
2015;"JACUTINGA (MG)";"MG";"JACUTINGA";386;85;76;547
2015;"JAGUARACU (MG)";"MG";"JAGUARACU";50;2;6;58
2015;"JAIBA (MG)";"MG";"JAIBA";425;29;160;614
2015;"JAMPRUCA (MG)";"MG";"JAMPRUCA";18;4;25;47
2015;"JANAUBA (MG)";"MG";"JANAUBA";889;45;171;1105
2015;"JANUARIA (MG)";"MG";"JANUARIA";440;29;148;617
2015;"JAPARAIBA (MG)";"MG";"JAPARAIBA";88;14;20;122
2015;"JAPONVAR (MG)";"MG";"JAPONVAR";51;13;17;81
2015;"JECEABA (MG)";"MG";"JECEABA";124;33;17;174
2015;"JENIPAPO DE MINAS (MG)";"MG";"JENIPAPO DE MINAS";43;9;27;79
2015;"JEQUERI (MG)";"MG";"JEQUERI";136;10;55;201
2015;"JEQUITAI (MG)";"MG";"JEQUITAI";74;3;31;108
2015;"JEQUITIBA (MG)";"MG";"JEQUITIBA";104;11;30;145
2015;"JEQUITINHONHA (MG)";"MG";"JEQUITINHONHA";114;43;36;193
2015;"JESUANIA (MG)";"MG";"JESUANIA";75;20;13;108
2015;"JOAIMA (MG)";"MG";"JOAIMA";63;12;37;112
2015;"JOANESIA (MG)";"MG";"JOANESIA";18;9;14;41
2015;"JOAO MONLEVADE (MG)";"MG";"JOAO MONLEVADE";1268;162;266;1696
2015;"JOAO PINHEIRO (MG)";"MG";"JOAO PINHEIRO";973;71;277;1321
2015;"JOAQUIM FELICIO (MG)";"MG";"JOAQUIM FELICIO";53;2;12;67
2015;"JORDANIA (MG)";"MG";"JORDANIA";38;16;24;78
2015;"JOSE GONCALVES DE MINAS (MG)";"MG";"JOSE GONCALVES DE MINAS";30;11;19;60
2015;"JOSE RAYDAN (MG)";"MG";"JOSE RAYDAN";31;2;19;52
2015;"JOSENOPOLIS (MG)";"MG";"JOSENOPOLIS";20;6;19;45
2015;"JUATUBA (MG)";"MG";"JUATUBA";302;48;202;552
2015;"JUIZ DE FORA (MG)";"MG";"JUIZ DE FORA";6309;859;1688;8856
2015;"JURAMENTO (MG)";"MG";"JURAMENTO";22;2;15;39
2015;"JURUAIA (MG)";"MG";"JURUAIA";103;23;28;154
2015;"JUVENILIA (MG)";"MG";"JUVENILIA";28;4;11;43
2015;"LADAINHA (MG)";"MG";"LADAINHA";55;23;49;127
2015;"LAGAMAR (MG)";"MG";"LAGAMAR";120;32;23;175
2015;"LAGOA DA PRATA (MG)";"MG";"LAGOA DA PRATA";1196;75;185;1456
2015;"LAGOA DOS PATOS (MG)";"MG";"LAGOA DOS PATOS";40;0;13;53
2015;"LAGOA DOURADA (MG)";"MG";"LAGOA DOURADA";415;37;136;588
2015;"LAGOA FORMOSA (MG)";"MG";"LAGOA FORMOSA";390;29;96;515
2015;"LAGOA GRANDE (MG)";"MG";"LAGOA GRANDE";122;12;57;191
2015;"LAGOA SANTA (MG)";"MG";"LAGOA SANTA";866;140;153;1159
2015;"LAJINHA (MG)";"MG";"LAJINHA";302;47;57;406
2015;"LAMBARI (MG)";"MG";"LAMBARI";392;68;33;493
2015;"LAMIM (MG)";"MG";"LAMIM";45;4;8;57
2015;"LARANJAL (MG)";"MG";"LARANJAL";126;12;5;143
2015;"LASSANCE (MG)";"MG";"LASSANCE";50;13;10;73
2015;"LAVRAS (MG)";"MG";"LAVRAS";1463;236;287;1986
2015;"LEANDRO FERREIRA (MG)";"MG";"LEANDRO FERREIRA";44;5;9;58
2015;"LEME DO PRADO (MG)";"MG";"LEME DO PRADO";34;6;17;57
2015;"LEOPOLDINA (MG)";"MG";"LEOPOLDINA";746;80;84;910
2015;"LIBERDADE (MG)";"MG";"LIBERDADE";115;20;12;147
2015;"LIMA DUARTE (MG)";"MG";"LIMA DUARTE";219;32;39;290
2015;"LIMEIRA DO OESTE (MG)";"MG";"LIMEIRA DO OESTE";186;33;60;279
2015;"LONTRA (MG)";"MG";"LONTRA";33;6;17;56
2015;"LUISBURGO (MG)";"MG";"LUISBURGO";46;10;24;80
2015;"LUISLANDIA (MG)";"MG";"LUISLANDIA";30;6;15;51
2015;"LUMINARIAS (MG)";"MG";"LUMINARIAS";122;10;45;177
2015;"LUZ (MG)";"MG";"LUZ";376;64;36;476
2015;"MACHACALIS (MG)";"MG";"MACHACALIS";37;5;11;53
2015;"MACHADO (MG)";"MG";"MACHADO";812;159;132;1103
2015;"MADRE DE DEUS DE MINAS (MG)";"MG";"MADRE DE DEUS DE MINAS";114;18;15;147
2015;"MALACACHETA (MG)";"MG";"MALACACHETA";128;15;53;196
2015;"MAMONAS (MG)";"MG";"MAMONAS";112;10;28;150
2015;"MANGA (MG)";"MG";"MANGA";153;13;59;225
2015;"MANHUACU (MG)";"MG";"MANHUACU";1734;152;196;2082
2015;"MANHUMIRIM (MG)";"MG";"MANHUMIRIM";351;47;48;446
2015;"MANTENA (MG)";"MG";"MANTENA";578;42;83;703
2015;"MAR DE ESPANHA (MG)";"MG";"MAR DE ESPANHA";231;27;19;277
2015;"MARAVILHAS (MG)";"MG";"MARAVILHAS";171;20;13;204
2015;"MARIA DA FE (MG)";"MG";"MARIA DA FE";265;19;35;319
2015;"MARIANA (MG)";"MG";"MARIANA";726;210;320;1256
2015;"MARILAC (MG)";"MG";"MARILAC";25;5;13;43
2015;"MARIO CAMPOS (MG)";"MG";"MARIO CAMPOS";279;31;23;333
2015;"MARIPA DE MINAS (MG)";"MG";"MARIPA DE MINAS";49;5;6;60
2015;"MARLIERIA (MG)";"MG";"MARLIERIA";42;7;11;60
2015;"MARMELOPOLIS (MG)";"MG";"MARMELOPOLIS";40;6;11;57
2015;"MARTINHO CAMPOS (MG)";"MG";"MARTINHO CAMPOS";409;40;79;528
2015;"MARTINS SOARES (MG)";"MG";"MARTINS SOARES";133;9;17;159
2015;"MATA VERDE (MG)";"MG";"MATA VERDE";57;36;8;101
2015;"MATERLANDIA (MG)";"MG";"MATERLANDIA";16;4;3;23
2015;"MATEUS LEME (MG)";"MG";"MATEUS LEME";607;97;134;838
2015;"MATHIAS LOBATO (MG)";"MG";"MATHIAS LOBATO";34;3;9;46
2015;"MATIAS BARBOSA (MG)";"MG";"MATIAS BARBOSA";700;52;43;795
2015;"MATIAS CARDOSO (MG)";"MG";"MATIAS CARDOSO";45;3;31;79
2015;"MATIPO (MG)";"MG";"MATIPO";297;29;52;378
2015;"MATO VERDE (MG)";"MG";"MATO VERDE";191;8;42;241
2015;"MATOZINHOS (MG)";"MG";"MATOZINHOS";416;110;169;695
2015;"MATUTINA (MG)";"MG";"MATUTINA";83;21;6;110
2015;"MEDEIROS (MG)";"MG";"MEDEIROS";68;22;8;98
2015;"MEDINA (MG)";"MG";"MEDINA";169;60;42;271
2015;"MENDES PIMENTEL (MG)";"MG";"MENDES PIMENTEL";44;9;14;67
2015;"MERCES (MG)";"MG";"MERCES";188;30;19;237
2015;"MESQUITA (MG)";"MG";"MESQUITA";28;19;13;60
2015;"MINAS NOVAS (MG)";"MG";"MINAS NOVAS";181;38;114;333
2015;"MINDURI (MG)";"MG";"MINDURI";80;11;3;94
2015;"MIRABELA (MG)";"MG";"MIRABELA";126;21;34;181
2015;"MIRADOURO (MG)";"MG";"MIRADOURO";114;18;36;168
2015;"MIRAI (MG)";"MG";"MIRAI";179;14;24;217
2015;"MIRAVANIA (MG)";"MG";"MIRAVANIA";16;4;17;37
2015;"MOEDA (MG)";"MG";"MOEDA";138;12;52;202
2015;"MOEMA (MG)";"MG";"MOEMA";179;15;120;314
2015;"MONJOLOS (MG)";"MG";"MONJOLOS";8;3;8;19
2015;"MONSENHOR PAULO (MG)";"MG";"MONSENHOR PAULO";208;29;13;250
2015;"MONTALVANIA (MG)";"MG";"MONTALVANIA";136;10;78;224
2015;"MONTE ALEGRE DE MINAS (MG)";"MG";"MONTE ALEGRE DE MINAS";611;75;67;753
2015;"MONTE AZUL (MG)";"MG";"MONTE AZUL";188;11;77;276
2015;"MONTE BELO (MG)";"MG";"MONTE BELO";286;44;54;384
2015;"MONTE CARMELO (MG)";"MG";"MONTE CARMELO";1470;136;171;1777
2015;"MONTE FORMOSO (MG)";"MG";"MONTE FORMOSO";24;17;42;83
2015;"MONTE SANTO DE MINAS (MG)";"MG";"MONTE SANTO DE MINAS";522;69;131;722
2015;"MONTE SIAO (MG)";"MG";"MONTE SIAO";308;55;40;403
2015;"MONTES CLAROS (MG)";"MG";"MONTES CLAROS";4849;397;1216;6462
2015;"MONTEZUMA (MG)";"MG";"MONTEZUMA";45;11;28;84
2015;"MORADA NOVA DE MINAS (MG)";"MG";"MORADA NOVA DE MINAS";127;23;26;176
2015;"MORRO DA GARCA (MG)";"MG";"MORRO DA GARCA";46;10;20;76
2015;"MORRO DO PILAR (MG)";"MG";"MORRO DO PILAR";31;8;3;42
2015;"MUNHOZ (MG)";"MG";"MUNHOZ";159;20;12;191
2015;"MURIAE (MG)";"MG";"MURIAE";1496;133;218;1847
2015;"MUTUM (MG)";"MG";"MUTUM";253;33;87;373
2015;"MUZAMBINHO (MG)";"MG";"MUZAMBINHO";487;106;52;645
2015;"NACIP RAYDAN (MG)";"MG";"NACIP RAYDAN";11;1;4;16
2015;"NANUQUE (MG)";"MG";"NANUQUE";599;72;221;892
2015;"NAQUE (MG)";"MG";"NAQUE";42;4;29;75
2015;"NATALANDIA (MG)";"MG";"NATALANDIA";34;2;19;55
2015;"NATERCIA (MG)";"MG";"NATERCIA";101;15;22;138
2015;"NAZARENO (MG)";"MG";"NAZARENO";183;18;36;237
2015;"NEPOMUCENO (MG)";"MG";"NEPOMUCENO";477;57;121;655
2015;"NINHEIRA (MG)";"MG";"NINHEIRA";55;10;37;102
2015;"NOVA BELEM (MG)";"MG";"NOVA BELEM";41;2;14;57
2015;"NOVA ERA (MG)";"MG";"NOVA ERA";262;38;80;380
2015;"NOVA LIMA (MG)";"MG";"NOVA LIMA";1665;405;235;2305
2015;"NOVA MODICA (MG)";"MG";"NOVA MODICA";23;4;15;42
2015;"NOVA PONTE (MG)";"MG";"NOVA PONTE";249;57;73;379
2015;"NOVA PORTEIRINHA (MG)";"MG";"NOVA PORTEIRINHA";51;5;23;79
2015;"NOVA RESENDE (MG)";"MG";"NOVA RESENDE";391;34;78;503
2015;"NOVA SERRANA (MG)";"MG";"NOVA SERRANA";607;66;127;800
2015;"NOVA UNIAO (MG)";"MG";"NOVA UNIAO";190;10;23;223
2015;"NOVO CRUZEIRO (MG)";"MG";"NOVO CRUZEIRO";218;47;149;414
2015;"NOVO ORIENTE DE MINAS (MG)";"MG";"NOVO ORIENTE DE MINAS";46;36;21;103
2015;"NOVORIZONTE (MG)";"MG";"NOVORIZONTE";71;1;23;95
2015;"OLARIA (MG)";"MG";"OLARIA";22;9;8;39
2015;"OLHOS D AGUA (MG)";"MG";"OLHOS D AGUA";82;15;44;141
2015;"OLIMPIO NORONHA (MG)";"MG";"OLIMPIO NORONHA";29;13;9;51
2015;"OLIVEIRA (MG)";"MG";"OLIVEIRA";781;110;130;1021
2015;"OLIVEIRA FORTES (MG)";"MG";"OLIVEIRA FORTES";29;3;3;35
2015;"ONCA DE PITANGUI (MG)";"MG";"ONCA DE PITANGUI";30;13;13;56
2015;"ORATORIOS (MG)";"MG";"ORATORIOS";89;5;20;114
2015;"ORIZANIA (MG)";"MG";"ORIZANIA";83;15;16;114
2015;"OURO BRANCO (MG)";"MG";"OURO BRANCO";570;150;214;934
2015;"OURO FINO (MG)";"MG";"OURO FINO";657;107;102;866
2015;"OURO PRETO (MG)";"MG";"OURO PRETO";1040;279;288;1607
2015;"OURO VERDE DE MINAS (MG)";"MG";"OURO VERDE DE MINAS";29;7;10;46
2015;"PADRE CARVALHO (MG)";"MG";"PADRE CARVALHO";29;10;29;68
2015;"PADRE PARAISO (MG)";"MG";"PADRE PARAISO";162;80;71;313
2015;"PAI PEDRO (MG)";"MG";"PAI PEDRO";22;4;27;53
2015;"PAINEIRAS (MG)";"MG";"PAINEIRAS";91;21;11;123
2015;"PAINS (MG)";"MG";"PAINS";262;22;28;312
2015;"PAIVA (MG)";"MG";"PAIVA";11;5;2;18
2015;"PALMA (MG)";"MG";"PALMA";118;10;7;135
2015;"PALMOPOLIS (MG)";"MG";"PALMOPOLIS";23;11;14;48
2015;"PAPAGAIOS (MG)";"MG";"PAPAGAIOS";566;14;69;649
2015;"PARA DE MINAS (MG)";"MG";"PARA DE MINAS";2423;197;228;2848
2015;"PARACATU (MG)";"MG";"PARACATU";1600;174;384;2158
2015;"PARAGUACU (MG)";"MG";"PARAGUACU";329;67;43;439
2015;"PARAISOPOLIS (MG)";"MG";"PARAISOPOLIS";368;61;61;490
2015;"PARAOPEBA (MG)";"MG";"PARAOPEBA";475;31;57;563
2015;"PASSA QUATRO (MG)";"MG";"PASSA QUATRO";396;41;27;464
2015;"PASSA TEMPO (MG)";"MG";"PASSA TEMPO";215;40;25;280
2015;"PASSA VINTE (MG)";"MG";"PASSA VINTE";232;24;13;269
2015;"PASSABEM (MG)";"MG";"PASSABEM";14;5;4;23
2015;"PASSOS (MG)";"MG";"PASSOS";2096;190;400;2686
2015;"PATIS (MG)";"MG";"PATIS";17;7;15;39
2015;"PATOS DE MINAS (MG)";"MG";"PATOS DE MINAS";3375;188;396;3959
2015;"PATROCINIO (MG)";"MG";"PATROCINIO";1883;187;592;2662
2015;"PATROCINIO DO MURIAE (MG)";"MG";"PATROCINIO DO MURIAE";109;12;7;128
2015;"PAULA CANDIDO (MG)";"MG";"PAULA CANDIDO";95;12;16;123
2015;"PAULISTAS (MG)";"MG";"PAULISTAS";46;3;11;60
2015;"PAVAO (MG)";"MG";"PAVAO";45;24;13;82
2015;"PECANHA (MG)";"MG";"PECANHA";147;14;62;223
2015;"PEDRA AZUL (MG)";"MG";"PEDRA AZUL";170;24;58;252
2015;"PEDRA BONITA (MG)";"MG";"PEDRA BONITA";87;13;22;122
2015;"PEDRA DO ANTA (MG)";"MG";"PEDRA DO ANTA";37;3;18;58
2015;"PEDRA DO INDAIA (MG)";"MG";"PEDRA DO INDAIA";95;12;7;114
2015;"PEDRA DOURADA (MG)";"MG";"PEDRA DOURADA";20;7;17;44
2015;"PEDRALVA (MG)";"MG";"PEDRALVA";175;33;28;236
2015;"PEDRAS DE MARIA DA CRUZ (MG)";"MG";"PEDRAS DE MARIA DA CRUZ";33;7;41;81
2015;"PEDRINOPOLIS (MG)";"MG";"PEDRINOPOLIS";62;18;8;88
2015;"PEDRO LEOPOLDO (MG)";"MG";"PEDRO LEOPOLDO";1258;211;200;1669
2015;"PEDRO TEIXEIRA (MG)";"MG";"PEDRO TEIXEIRA";19;9;5;33
2015;"PEQUERI (MG)";"MG";"PEQUERI";84;8;5;97
2015;"PEQUI (MG)";"MG";"PEQUI";68;20;8;96
2015;"PERDIGAO (MG)";"MG";"PERDIGAO";163;14;12;189
2015;"PERDIZES (MG)";"MG";"PERDIZES";301;61;65;427
2015;"PERDOES (MG)";"MG";"PERDOES";533;42;82;657
2015;"PERIQUITO (MG)";"MG";"PERIQUITO";64;5;22;91
2015;"PESCADOR (MG)";"MG";"PESCADOR";18;8;10;36
2015;"PIAU (MG)";"MG";"PIAU";54;12;8;74
2015;"PIEDADE DE CARATINGA (MG)";"MG";"PIEDADE DE CARATINGA";167;13;20;200
2015;"PIEDADE DE PONTE NOVA (MG)";"MG";"PIEDADE DE PONTE NOVA";41;4;18;63
2015;"PIEDADE DO RIO GRANDE (MG)";"MG";"PIEDADE DO RIO GRANDE";70;10;7;87
2015;"PIEDADE DOS GERAIS (MG)";"MG";"PIEDADE DOS GERAIS";102;10;20;132
2015;"PIMENTA (MG)";"MG";"PIMENTA";246;15;33;294
2015;"PINGO D AGUA (MG)";"MG";"PINGO D AGUA";36;3;9;48
2015;"PINTOPOLIS (MG)";"MG";"PINTOPOLIS";20;2;10;32
2015;"PIRACEMA (MG)";"MG";"PIRACEMA";125;12;23;160
2015;"PIRAJUBA (MG)";"MG";"PIRAJUBA";165;23;9;197
2015;"PIRANGA (MG)";"MG";"PIRANGA";160;24;73;257
2015;"PIRANGUCU (MG)";"MG";"PIRANGUCU";63;28;32;123
2015;"PIRANGUINHO (MG)";"MG";"PIRANGUINHO";240;28;28;296
2015;"PIRAPETINGA (MG)";"MG";"PIRAPETINGA";433;30;40;503
2015;"PIRAPORA (MG)";"MG";"PIRAPORA";609;55;181;845
2015;"PIRAUBA (MG)";"MG";"PIRAUBA";144;21;14;179
2015;"PITANGUI (MG)";"MG";"PITANGUI";567;86;95;748
2015;"PIUMHI (MG)";"MG";"PIUMHI";841;83;94;1018
2015;"PLANURA (MG)";"MG";"PLANURA";167;21;61;249
2015;"POCO FUNDO (MG)";"MG";"POCO FUNDO";327;57;32;416
2015;"POCOS DE CALDAS (MG)";"MG";"POCOS DE CALDAS";2853;617;465;3935
2015;"POCRANE (MG)";"MG";"POCRANE";96;7;13;116
2015;"POMPEU (MG)";"MG";"POMPEU";493;30;148;671
2015;"PONTE NOVA (MG)";"MG";"PONTE NOVA";1161;114;163;1438
2015;"PONTO CHIQUE (MG)";"MG";"PONTO CHIQUE";11;2;13;26
2015;"PONTO DOS VOLANTES (MG)";"MG";"PONTO DOS VOLANTES";50;14;37;101
2015;"PORTEIRINHA (MG)";"MG";"PORTEIRINHA";445;27;256;728
2015;"PORTO FIRME (MG)";"MG";"PORTO FIRME";77;9;21;107
2015;"POTE (MG)";"MG";"POTE";94;21;36;151
2015;"POUSO ALEGRE (MG)";"MG";"POUSO ALEGRE";2814;331;513;3658
2015;"POUSO ALTO (MG)";"MG";"POUSO ALTO";115;14;13;142
2015;"PRADOS (MG)";"MG";"PRADOS";123;23;16;162
2015;"PRATA (MG)";"MG";"PRATA";461;132;111;704
2015;"PRATAPOLIS (MG)";"MG";"PRATAPOLIS";232;26;27;285
2015;"PRATINHA (MG)";"MG";"PRATINHA";70;9;7;86
2015;"PRESIDENTE BERNARDES (MG)";"MG";"PRESIDENTE BERNARDES";30;9;11;50
2015;"PRESIDENTE JUSCELINO (MG)";"MG";"PRESIDENTE JUSCELINO";46;5;19;70
2015;"PRESIDENTE KUBITSCHEK (MG)";"MG";"PRESIDENTE KUBITSCHEK";29;12;8;49
2015;"PRESIDENTE OLEGARIO (MG)";"MG";"PRESIDENTE OLEGARIO";269;22;116;407
2015;"PRUDENTE DE MORAIS (MG)";"MG";"PRUDENTE DE MORAIS";124;14;15;153
2015;"QUARTEL GERAL (MG)";"MG";"QUARTEL GERAL";45;5;7;57
2015;"QUELUZITA (MG)";"MG";"QUELUZITA";24;10;5;39
2015;"RAPOSOS (MG)";"MG";"RAPOSOS";82;49;36;167
2015;"RAUL SOARES (MG)";"MG";"RAUL SOARES";272;49;69;390
2015;"RECREIO (MG)";"MG";"RECREIO";203;32;26;261
2015;"REDUTO (MG)";"MG";"REDUTO";117;13;9;139
2015;"RESENDE COSTA (MG)";"MG";"RESENDE COSTA";241;22;28;291
2015;"RESPLENDOR (MG)";"MG";"RESPLENDOR";205;43;42;290
2015;"RESSAQUINHA (MG)";"MG";"RESSAQUINHA";179;14;30;223
2015;"RIACHINHO (MG)";"MG";"RIACHINHO";122;5;24;151
2015;"RIACHO DOS MACHADOS (MG)";"MG";"RIACHO DOS MACHADOS";60;5;40;105
2015;"RIBEIRAO DAS NEVES (MG)";"MG";"RIBEIRAO DAS NEVES";2795;545;719;4059
2015;"RIBEIRAO VERMELHO (MG)";"MG";"RIBEIRAO VERMELHO";47;13;5;65
2015;"RIO ACIMA (MG)";"MG";"RIO ACIMA";127;23;16;166
2015;"RIO CASCA (MG)";"MG";"RIO CASCA";236;10;52;298
2015;"RIO DO PRADO (MG)";"MG";"RIO DO PRADO";18;9;10;37
2015;"RIO DOCE (MG)";"MG";"RIO DOCE";18;10;6;34
2015;"RIO ESPERA (MG)";"MG";"RIO ESPERA";43;1;13;57
2015;"RIO MANSO (MG)";"MG";"RIO MANSO";187;7;17;211
2015;"RIO NOVO (MG)";"MG";"RIO NOVO";189;25;33;247
2015;"RIO PARANAIBA (MG)";"MG";"RIO PARANAIBA";275;17;77;369
2015;"RIO PARDO DE MINAS (MG)";"MG";"RIO PARDO DE MINAS";246;28;177;451
2015;"RIO PIRACICABA (MG)";"MG";"RIO PIRACICABA";207;22;31;260
2015;"RIO POMBA (MG)";"MG";"RIO POMBA";297;34;41;372
2015;"RIO PRETO (MG)";"MG";"RIO PRETO";586;54;62;702
2015;"RIO VERMELHO (MG)";"MG";"RIO VERMELHO";91;33;47;171
2015;"RITAPOLIS (MG)";"MG";"RITAPOLIS";44;13;8;65
2015;"ROCHEDO DE MINAS (MG)";"MG";"ROCHEDO DE MINAS";31;4;3;38
2015;"RODEIRO (MG)";"MG";"RODEIRO";296;9;24;329
2015;"ROMARIA (MG)";"MG";"ROMARIA";52;25;10;87
2015;"ROSARIO DA LIMEIRA (MG)";"MG";"ROSARIO DA LIMEIRA";87;5;38;130
2015;"RUBELITA (MG)";"MG";"RUBELITA";21;8;13;42
2015;"RUBIM (MG)";"MG";"RUBIM";31;1;28;60
2015;"SABARA (MG)";"MG";"SABARA";837;214;395;1446
2015;"SABINOPOLIS (MG)";"MG";"SABINOPOLIS";152;41;71;264
2015;"SACRAMENTO (MG)";"MG";"SACRAMENTO";554;94;86;734
2015;"SALINAS (MG)";"MG";"SALINAS";492;49;146;687
2015;"SALTO DA DIVISA (MG)";"MG";"SALTO DA DIVISA";16;9;13;38
2015;"SANTA BARBARA (MG)";"MG";"SANTA BARBARA";442;89;116;647
2015;"SANTA BARBARA DO LESTE (MG)";"MG";"SANTA BARBARA DO LESTE";189;10;10;209
2015;"SANTA BARBARA DO MONTE VERDE (MG)";"MG";"SANTA BARBARA DO MONTE VERDE";696;62;137;895
2015;"SANTA BARBARA DO TUGURIO (MG)";"MG";"SANTA BARBARA DO TUGURIO";71;34;56;161
2015;"SANTA CRUZ DE MINAS (MG)";"MG";"SANTA CRUZ DE MINAS";86;12;4;102
2015;"SANTA CRUZ DE SALINAS (MG)";"MG";"SANTA CRUZ DE SALINAS";31;6;29;66
2015;"SANTA CRUZ DO ESCALVADO (MG)";"MG";"SANTA CRUZ DO ESCALVADO";44;11;17;72
2015;"SANTA EFIGENIA DE MINAS (MG)";"MG";"SANTA EFIGENIA DE MINAS";28;8;7;43
2015;"SANTA FE DE MINAS (MG)";"MG";"SANTA FE DE MINAS";8;2;6;16
2015;"SANTA HELENA DE MINAS (MG)";"MG";"SANTA HELENA DE MINAS";12;9;8;29
2015;"SANTA JULIANA (MG)";"MG";"SANTA JULIANA";480;47;59;586
2015;"SANTA LUZIA (MG)";"MG";"SANTA LUZIA";2072;366;727;3165
2015;"SANTA MARGARIDA (MG)";"MG";"SANTA MARGARIDA";241;34;42;317
2015;"SANTA MARIA DE ITABIRA (MG)";"MG";"SANTA MARIA DE ITABIRA";145;25;59;229
2015;"SANTA MARIA DO SALTO (MG)";"MG";"SANTA MARIA DO SALTO";11;8;8;27
2015;"SANTA MARIA DO SUACUI (MG)";"MG";"SANTA MARIA DO SUACUI";101;8;55;164
2015;"SANTA RITA DE CALDAS (MG)";"MG";"SANTA RITA DE CALDAS";351;31;19;401
2015;"SANTA RITA DE IBITIPOCA (MG)";"MG";"SANTA RITA DE IBITIPOCA";53;10;4;67
2015;"SANTA RITA DE JACUTINGA (MG)";"MG";"SANTA RITA DE JACUTINGA";103;9;8;120
2015;"SANTA RITA DE MINAS (MG)";"MG";"SANTA RITA DE MINAS";129;18;19;166
2015;"SANTA RITA DO ITUETO (MG)";"MG";"SANTA RITA DO ITUETO";86;11;21;118
2015;"SANTA RITA DO SAPUCAI (MG)";"MG";"SANTA RITA DO SAPUCAI";436;92;102;630
2015;"SANTA ROSA DA SERRA (MG)";"MG";"SANTA ROSA DA SERRA";60;11;13;84
2015;"SANTA VITORIA (MG)";"MG";"SANTA VITORIA";476;56;49;581
2015;"SANTANA DA VARGEM (MG)";"MG";"SANTANA DA VARGEM";114;15;30;159
2015;"SANTANA DE CATAGUASES (MG)";"MG";"SANTANA DE CATAGUASES";37;11;6;54
2015;"SANTANA DE PIRAPAMA (MG)";"MG";"SANTANA DE PIRAPAMA";78;7;34;119
2015;"SANTANA DO DESERTO (MG)";"MG";"SANTANA DO DESERTO";65;15;13;93
2015;"SANTANA DO GARAMBEU (MG)";"MG";"SANTANA DO GARAMBEU";19;5;8;32
2015;"SANTANA DO JACARE (MG)";"MG";"SANTANA DO JACARE";54;7;18;79
2015;"SANTANA DO MANHUACU (MG)";"MG";"SANTANA DO MANHUACU";235;9;23;267
2015;"SANTANA DO PARAISO (MG)";"MG";"SANTANA DO PARAISO";165;25;33;223
2015;"SANTANA DO RIACHO (MG)";"MG";"SANTANA DO RIACHO";53;10;7;70
2015;"SANTANA DOS MONTES (MG)";"MG";"SANTANA DOS MONTES";42;8;9;59
2015;"SANTO ANTONIO DO AMPARO (MG)";"MG";"SANTO ANTONIO DO AMPARO";288;52;104;444
2015;"SANTO ANTONIO DO AVENTUREIRO (MG)";"MG";"SANTO ANTONIO DO AVENTUREIRO";72;2;10;84
2015;"SANTO ANTONIO DO GRAMA (MG)";"MG";"SANTO ANTONIO DO GRAMA";53;10;13;76
2015;"SANTO ANTONIO DO ITAMBE (MG)";"MG";"SANTO ANTONIO DO ITAMBE";17;7;10;34
2015;"SANTO ANTONIO DO JACINTO (MG)";"MG";"SANTO ANTONIO DO JACINTO";47;6;43;96
2015;"SANTO ANTONIO DO MONTE (MG)";"MG";"SANTO ANTONIO DO MONTE";567;69;107;743
2015;"SANTO ANTONIO DO RETIRO (MG)";"MG";"SANTO ANTONIO DO RETIRO";62;6;34;102
2015;"SANTO ANTONIO DO RIO ABAIXO (MG)";"MG";"SANTO ANTONIO DO RIO ABAIXO";15;7;9;31
2015;"SANTO HIPOLITO (MG)";"MG";"SANTO HIPOLITO";27;7;4;38
2015;"SANTOS DUMONT (MG)";"MG";"SANTOS DUMONT";435;107;160;702
2015;"SAO BENTO ABADE (MG)";"MG";"SAO BENTO ABADE";48;22;24;94
2015;"SAO BRAS DO SUACUI (MG)";"MG";"SAO BRAS DO SUACUI";59;7;10;76
2015;"SAO DOMINGOS DAS DORES (MG)";"MG";"SAO DOMINGOS DAS DORES";111;9;14;134
2015;"SAO DOMINGOS DO PRATA (MG)";"MG";"SAO DOMINGOS DO PRATA";302;20;65;387
2015;"SAO FELIX DE MINAS (MG)";"MG";"SAO FELIX DE MINAS";25;3;15;43
2015;"SAO FRANCISCO (MG)";"MG";"SAO FRANCISCO";291;31;151;473
2015;"SAO FRANCISCO DE PAULA (MG)";"MG";"SAO FRANCISCO DE PAULA";77;27;30;134
2015;"SAO FRANCISCO DE SALES (MG)";"MG";"SAO FRANCISCO DE SALES";84;12;27;123
2015;"SAO FRANCISCO DO GLORIA (MG)";"MG";"SAO FRANCISCO DO GLORIA";66;9;13;88
2015;"SAO GERALDO (MG)";"MG";"SAO GERALDO";188;12;18;218
2015;"SAO GERALDO DA PIEDADE (MG)";"MG";"SAO GERALDO DA PIEDADE";19;5;10;34
2015;"SAO GERALDO DO BAIXIO (MG)";"MG";"SAO GERALDO DO BAIXIO";18;6;9;33
2015;"SAO GONCALO DO ABAETE (MG)";"MG";"SAO GONCALO DO ABAETE";100;16;20;136
2015;"SAO GONCALO DO PARA (MG)";"MG";"SAO GONCALO DO PARA";251;21;27;299
2015;"SAO GONCALO DO RIO ABAIXO (MG)";"MG";"SAO GONCALO DO RIO ABAIXO";230;57;43;330
2015;"SAO GONCALO DO RIO PRETO (MG)";"MG";"SAO GONCALO DO RIO PRETO";36;10;9;55
2015;"SAO GONCALO DO SAPUCAI (MG)";"MG";"SAO GONCALO DO SAPUCAI";493;58;84;635
2015;"SAO GOTARDO (MG)";"MG";"SAO GOTARDO";999;107;271;1377
2015;"SAO JOAO BATISTA DO GLORIA (MG)";"MG";"SAO JOAO BATISTA DO GLORIA";149;14;15;178
2015;"SAO JOAO DA LAGOA (MG)";"MG";"SAO JOAO DA LAGOA";39;14;16;69
2015;"SAO JOAO DA MATA (MG)";"MG";"SAO JOAO DA MATA";63;20;4;87
2015;"SAO JOAO DA PONTE (MG)";"MG";"SAO JOAO DA PONTE";85;15;66;166
2015;"SAO JOAO DAS MISSOES (MG)";"MG";"SAO JOAO DAS MISSOES";38;4;22;64
2015;"SAO JOAO DEL REI (MG)";"MG";"SAO JOAO DEL REI";1244;240;239;1723
2015;"SAO JOAO DO MANHUACU (MG)";"MG";"SAO JOAO DO MANHUACU";164;17;34;215
2015;"SAO JOAO DO MANTENINHA (MG)";"MG";"SAO JOAO DO MANTENINHA";86;15;6;107
2015;"SAO JOAO DO ORIENTE (MG)";"MG";"SAO JOAO DO ORIENTE";117;11;11;139
2015;"SAO JOAO DO PACUI (MG)";"MG";"SAO JOAO DO PACUI";16;5;8;29
2015;"SAO JOAO DO PARAISO (MG)";"MG";"SAO JOAO DO PARAISO";241;29;98;368
2015;"SAO JOAO EVANGELISTA (MG)";"MG";"SAO JOAO EVANGELISTA";146;15;51;212
2015;"SAO JOAO NEPOMUCENO (MG)";"MG";"SAO JOAO NEPOMUCENO";313;48;27;388
2015;"SAO JOAQUIM DE BICAS (MG)";"MG";"SAO JOAQUIM DE BICAS";644;76;46;766
2015;"SAO JOSE DA BARRA (MG)";"MG";"SAO JOSE DA BARRA";129;14;26;169
2015;"SAO JOSE DA LAPA (MG)";"MG";"SAO JOSE DA LAPA";362;65;99;526
2015;"SAO JOSE DA SAFIRA (MG)";"MG";"SAO JOSE DA SAFIRA";9;2;6;17
2015;"SAO JOSE DA VARGINHA (MG)";"MG";"SAO JOSE DA VARGINHA";57;5;21;83
2015;"SAO JOSE DO ALEGRE (MG)";"MG";"SAO JOSE DO ALEGRE";45;6;7;58
2015;"SAO JOSE DO DIVINO (MG)";"MG";"SAO JOSE DO DIVINO";18;6;14;38
2015;"SAO JOSE DO GOIABAL (MG)";"MG";"SAO JOSE DO GOIABAL";44;11;42;97
2015;"SAO JOSE DO JACURI (MG)";"MG";"SAO JOSE DO JACURI";32;4;9;45
2015;"SAO JOSE DO MANTIMENTO (MG)";"MG";"SAO JOSE DO MANTIMENTO";39;2;5;46
2015;"SAO LOURENCO (MG)";"MG";"SAO LOURENCO";575;81;59;715
2015;"SAO MIGUEL DO ANTA (MG)";"MG";"SAO MIGUEL DO ANTA";92;11;13;116
2015;"SAO PEDRO DA UNIAO (MG)";"MG";"SAO PEDRO DA UNIAO";118;18;17;153
2015;"SAO PEDRO DO SUACUI (MG)";"MG";"SAO PEDRO DO SUACUI";37;4;9;50
2015;"SAO PEDRO DOS FERROS (MG)";"MG";"SAO PEDRO DOS FERROS";108;9;40;157
2015;"SAO ROMAO (MG)";"MG";"SAO ROMAO";47;6;13;66
2015;"SAO ROQUE DE MINAS (MG)";"MG";"SAO ROQUE DE MINAS";201;14;30;245
2015;"SAO SEBASTIAO DA BELA VISTA (MG)";"MG";"SAO SEBASTIAO DA BELA VISTA";96;13;15;124
2015;"SAO SEBASTIAO DA VARGEM ALEGRE (MG)";"MG";"SAO SEBASTIAO DA VARGEM ALEGRE";41;6;7;54
2015;"SAO SEBASTIAO DO ANTA (MG)";"MG";"SAO SEBASTIAO DO ANTA";64;9;7;80
2015;"SAO SEBASTIAO DO MARANHAO (MG)";"MG";"SAO SEBASTIAO DO MARANHAO";27;10;19;56
2015;"SAO SEBASTIAO DO OESTE (MG)";"MG";"SAO SEBASTIAO DO OESTE";176;8;27;211
2015;"SAO SEBASTIAO DO PARAISO (MG)";"MG";"SAO SEBASTIAO DO PARAISO";1753;133;232;2118
2015;"SAO SEBASTIAO DO RIO PRETO (MG)";"MG";"SAO SEBASTIAO DO RIO PRETO";11;6;7;24
2015;"SAO SEBASTIAO DO RIO VERDE (MG)";"MG";"SAO SEBASTIAO DO RIO VERDE";16;4;7;27
2015;"SAO TIAGO (MG)";"MG";"SAO TIAGO";223;20;24;267
2015;"SAO TOMAS DE AQUINO (MG)";"MG";"SAO TOMAS DE AQUINO";99;24;15;138
2015;"SAO TOME DAS LETRAS (MG)";"MG";"SAO TOME DAS LETRAS";99;15;20;134
2015;"SAO VICENTE DE MINAS (MG)";"MG";"SAO VICENTE DE MINAS";126;28;5;159
2015;"SAPUCAI MIRIM (MG)";"MG";"SAPUCAI MIRIM";230;40;15;285
2015;"SARDOA (MG)";"MG";"SARDOA";61;11;11;83
2015;"SARZEDO (MG)";"MG";"SARZEDO";770;75;112;957
2015;"SEM PEIXE (MG)";"MG";"SEM PEIXE";16;4;14;34
2015;"SENADOR AMARAL (MG)";"MG";"SENADOR AMARAL";118;8;12;138
2015;"SENADOR CORTES (MG)";"MG";"SENADOR CORTES";21;4;3;28
2015;"SENADOR FIRMINO (MG)";"MG";"SENADOR FIRMINO";120;9;31;160
2015;"SENADOR JOSE BENTO (MG)";"MG";"SENADOR JOSE BENTO";15;2;8;25
2015;"SENADOR MODESTINO GONCALVES (MG)";"MG";"SENADOR MODESTINO GONCALVES";32;6;13;51
2015;"SENHORA DE OLIVEIRA (MG)";"MG";"SENHORA DE OLIVEIRA";79;5;15;99
2015;"SENHORA DO PORTO (MG)";"MG";"SENHORA DO PORTO";28;8;13;49
2015;"SENHORA DOS REMEDIOS (MG)";"MG";"SENHORA DOS REMEDIOS";122;38;26;186
2015;"SERICITA (MG)";"MG";"SERICITA";110;4;13;127
2015;"SERITINGA (MG)";"MG";"SERITINGA";26;2;4;32
2015;"SERRA AZUL DE MINAS (MG)";"MG";"SERRA AZUL DE MINAS";20;7;11;38
2015;"SERRA DA SAUDADE (MG)";"MG";"SERRA DA SAUDADE";8;5;2;15
2015;"SERRA DO SALITRE (MG)";"MG";"SERRA DO SALITRE";265;15;95;375
2015;"SERRA DOS AIMORES (MG)";"MG";"SERRA DOS AIMORES";76;5;29;110
2015;"SERRANIA (MG)";"MG";"SERRANIA";132;21;22;175
2015;"SERRANOPOLIS DE MINAS (MG)";"MG";"SERRANOPOLIS DE MINAS";20;1;19;40
2015;"SERRANOS (MG)";"MG";"SERRANOS";25;8;4;37
2015;"SERRO (MG)";"MG";"SERRO";190;30;75;295
2015;"SETE LAGOAS (MG)";"MG";"SETE LAGOAS";3518;466;797;4781
2015;"SETUBINHA (MG)";"MG";"SETUBINHA";31;8;29;68
2015;"SILVEIRANIA (MG)";"MG";"SILVEIRANIA";17;4;6;27
2015;"SILVIANOPOLIS (MG)";"MG";"SILVIANOPOLIS";99;9;18;126
2015;"SIMAO PEREIRA (MG)";"MG";"SIMAO PEREIRA";56;14;6;76
2015;"SIMONESIA (MG)";"MG";"SIMONESIA";279;19;47;345
2015;"SOBRALIA (MG)";"MG";"SOBRALIA";42;5;10;57
2015;"SOLEDADE DE MINAS (MG)";"MG";"SOLEDADE DE MINAS";55;15;4;74
2015;"TABULEIRO (MG)";"MG";"TABULEIRO";84;7;12;103
2015;"TAIOBEIRAS (MG)";"MG";"TAIOBEIRAS";769;48;197;1014
2015;"TAPARUBA (MG)";"MG";"TAPARUBA";31;3;11;45
2015;"TAPIRA (MG)";"MG";"TAPIRA";148;7;29;184
2015;"TAPIRAI (MG)";"MG";"TAPIRAI";19;10;5;34
2015;"TAQUARACU DE MINAS (MG)";"MG";"TAQUARACU DE MINAS";111;11;17;139
2015;"TARUMIRIM (MG)";"MG";"TARUMIRIM";149;21;28;198
2015;"TEIXEIRAS (MG)";"MG";"TEIXEIRAS";166;15;19;200
2015;"TEOFILO OTONI (MG)";"MG";"TEOFILO OTONI";1582;209;178;1969
2015;"TIMOTEO (MG)";"MG";"TIMOTEO";997;213;148;1358
2015;"TIRADENTES (MG)";"MG";"TIRADENTES";104;24;12;140
2015;"TIROS (MG)";"MG";"TIROS";182;21;16;219
2015;"TOCANTINS (MG)";"MG";"TOCANTINS";269;14;22;305
2015;"TOCOS DO MOJI (MG)";"MG";"TOCOS DO MOJI";56;13;14;83
2015;"TOLEDO (MG)";"MG";"TOLEDO";129;9;20;158
2015;"TOMBOS (MG)";"MG";"TOMBOS";126;35;32;193
2015;"TRES CORACOES (MG)";"MG";"TRES CORACOES";1054;104;212;1370
2015;"TRES MARIAS (MG)";"MG";"TRES MARIAS";443;52;100;595
2015;"TRES PONTAS (MG)";"MG";"TRES PONTAS";1098;134;216;1448
2015;"TUMIRITINGA (MG)";"MG";"TUMIRITINGA";36;6;10;52
2015;"TUPACIGUARA (MG)";"MG";"TUPACIGUARA";581;88;85;754
2015;"TURMALINA (MG)";"MG";"TURMALINA";367;43;85;495
2015;"TURVOLANDIA (MG)";"MG";"TURVOLANDIA";116;34;9;159
2015;"UBA (MG)";"MG";"UBA";2106;114;192;2412
2015;"UBAI (MG)";"MG";"UBAI";46;13;33;92
2015;"UBAPORANGA (MG)";"MG";"UBAPORANGA";186;12;26;224
2015;"UBERABA (MG)";"MG";"UBERABA";5131;1083;1122;7336
2015;"UBERLANDIA (MG)";"MG";"UBERLANDIA";11991;1332;1556;14879
2015;"UMBURATIBA (MG)";"MG";"UMBURATIBA";8;4;4;16
2015;"UNAI (MG)";"MG";"UNAI";1660;100;423;2183
2015;"UNIAO DE MINAS (MG)";"MG";"UNIAO DE MINAS";53;8;39;100
2015;"URUANA DE MINAS (MG)";"MG";"URUANA DE MINAS";26;4;13;43
2015;"URUCANIA (MG)";"MG";"URUCANIA";185;11;56;252
2015;"URUCUIA (MG)";"MG";"URUCUIA";109;8;39;156
2015;"VARGEM ALEGRE (MG)";"MG";"VARGEM ALEGRE";73;5;10;88
2015;"VARGEM BONITA (MG)";"MG";"VARGEM BONITA";35;3;8;46
2015;"VARGEM GRANDE DO RIO PARDO (MG)";"MG";"VARGEM GRANDE DO RIO PARDO";66;9;17;92
2015;"VARGINHA (MG)";"MG";"VARGINHA";2247;201;323;2771
2015;"VARJAO DE MINAS (MG)";"MG";"VARJAO DE MINAS";100;14;53;167
2015;"VARZEA DA PALMA (MG)";"MG";"VARZEA DA PALMA";499;23;101;623
2015;"VARZELANDIA (MG)";"MG";"VARZELANDIA";75;10;46;131
2015;"VAZANTE (MG)";"MG";"VAZANTE";355;44;95;494
2015;"VERDELANDIA (MG)";"MG";"VERDELANDIA";19;4;10;33
2015;"VEREDINHA (MG)";"MG";"VEREDINHA";56;17;21;94
2015;"VERISSIMO (MG)";"MG";"VERISSIMO";42;32;6;80
2015;"VERMELHO NOVO (MG)";"MG";"VERMELHO NOVO";112;12;26;150
2015;"VESPASIANO (MG)";"MG";"VESPASIANO";1296;273;215;1784
2015;"VICOSA (MG)";"MG";"VICOSA";764;173;210;1147
2015;"VIEIRAS (MG)";"MG";"VIEIRAS";43;13;10;66
2015;"VIRGEM DA LAPA (MG)";"MG";"VIRGEM DA LAPA";77;11;29;117
2015;"VIRGINIA (MG)";"MG";"VIRGINIA";181;19;9;209
2015;"VIRGINOPOLIS (MG)";"MG";"VIRGINOPOLIS";126;6;30;162
2015;"VIRGOLANDIA (MG)";"MG";"VIRGOLANDIA";25;6;13;44
2015;"VISCONDE DO RIO BRANCO (MG)";"MG";"VISCONDE DO RIO BRANCO";1103;58;75;1236
2015;"VOLTA GRANDE (MG)";"MG";"VOLTA GRANDE";59;15;9;83
2015;"WENCESLAU BRAZ (MG)";"MG";"WENCESLAU BRAZ";38;9;10;57
2015;"AGUA CLARA (MS)";"MS";"AGUA CLARA";414;29;102;545
2015;"ALCINOPOLIS (MS)";"MS";"ALCINOPOLIS";97;19;17;133
2015;"AMAMBAI (MS)";"MS";"AMAMBAI";763;25;70;858
2015;"ANASTACIO (MS)";"MS";"ANASTACIO";420;25;32;477
2015;"ANAURILANDIA (MS)";"MS";"ANAURILANDIA";122;19;60;201
2015;"ANGELICA (MS)";"MS";"ANGELICA";316;63;68;447
2015;"ANTONIO JOAO (MS)";"MS";"ANTONIO JOAO";121;8;26;155
2015;"APARECIDA DO TABOADO (MS)";"MS";"APARECIDA DO TABOADO";451;44;59;554
2015;"AQUIDAUANA (MS)";"MS";"AQUIDAUANA";401;26;79;506
2015;"ARAL MOREIRA (MS)";"MS";"ARAL MOREIRA";231;14;29;274
2015;"BANDEIRANTES (MS)";"MS";"BANDEIRANTES";211;16;54;281
2015;"BATAGUASSU (MS)";"MS";"BATAGUASSU";458;48;216;722
2015;"BATAYPORA (MS)";"MS";"BATAYPORA";188;18;33;239
2015;"BELA VISTA (MS)";"MS";"BELA VISTA";307;47;59;413
2015;"BODOQUENA (MS)";"MS";"BODOQUENA";109;27;43;179
2015;"BONITO (MS)";"MS";"BONITO";336;81;73;490
2015;"BRASILANDIA (MS)";"MS";"BRASILANDIA";253;40;86;379
2015;"CAARAPO (MS)";"MS";"CAARAPO";619;17;151;787
2015;"CAMAPUA (MS)";"MS";"CAMAPUA";351;48;43;442
2015;"CAMPO GRANDE (MS)";"MS";"CAMPO GRANDE";14661;994;2222;17877
2015;"CARACOL (MS)";"MS";"CARACOL";67;17;15;99
2015;"CASSILANDIA (MS)";"MS";"CASSILANDIA";499;28;56;583
2015;"CHAPADAO DO SUL (MS)";"MS";"CHAPADAO DO SUL";908;31;131;1070
2015;"CORGUINHO (MS)";"MS";"CORGUINHO";71;15;25;111
2015;"CORONEL SAPUCAIA (MS)";"MS";"CORONEL SAPUCAIA";349;11;37;397
2015;"CORUMBA (MS)";"MS";"CORUMBA";903;83;254;1240
2015;"COSTA RICA (MS)";"MS";"COSTA RICA";530;19;139;688
2015;"COXIM (MS)";"MS";"COXIM";646;23;81;750
2015;"DEODAPOLIS (MS)";"MS";"DEODAPOLIS";272;23;102;397
2015;"DOIS IRMAOS DO BURITI (MS)";"MS";"DOIS IRMAOS DO BURITI";153;24;37;214
2015;"DOURADINA (MS)";"MS";"DOURADINA";309;14;24;347
2015;"DOURADOS (MS)";"MS";"DOURADOS";4189;244;564;4997
2015;"ELDORADO (MS)";"MS";"ELDORADO";269;16;37;322
2015;"FATIMA DO SUL (MS)";"MS";"FATIMA DO SUL";440;16;37;493
2015;"FIGUEIRAO (MS)";"MS";"FIGUEIRAO";60;22;5;87
2015;"GLORIA DE DOURADOS (MS)";"MS";"GLORIA DE DOURADOS";221;13;28;262
2015;"GUIA LOPES DA LAGUNA (MS)";"MS";"GUIA LOPES DA LAGUNA";209;21;31;261
2015;"IGUATEMI (MS)";"MS";"IGUATEMI";258;9;72;339
2015;"INOCENCIA (MS)";"MS";"INOCENCIA";200;10;44;254
2015;"ITAPORA (MS)";"MS";"ITAPORA";456;31;49;536
2015;"ITAQUIRAI (MS)";"MS";"ITAQUIRAI";257;11;120;388
2015;"IVINHEMA (MS)";"MS";"IVINHEMA";692;50;275;1017
2015;"JAPORA (MS)";"MS";"JAPORA";41;5;19;65
2015;"JARAGUARI (MS)";"MS";"JARAGUARI";81;7;20;108
2015;"JARDIM (MS)";"MS";"JARDIM";478;32;55;565
2015;"JATEI (MS)";"MS";"JATEI";59;23;87;169
2015;"JUTI (MS)";"MS";"JUTI";115;9;22;146
2015;"LADARIO (MS)";"MS";"LADARIO";163;25;64;252
2015;"LAGUNA CARAPA (MS)";"MS";"LAGUNA CARAPA";211;4;31;246
2015;"MARACAJU (MS)";"MS";"MARACAJU";1078;37;130;1245
2015;"MIRANDA (MS)";"MS";"MIRANDA";374;27;103;504
2015;"MUNDO NOVO (MS)";"MS";"MUNDO NOVO";323;42;28;393
2015;"NAVIRAI (MS)";"MS";"NAVIRAI";969;46;175;1190
2015;"NIOAQUE (MS)";"MS";"NIOAQUE";182;24;58;264
2015;"NOVA ALVORADA DO SUL (MS)";"MS";"NOVA ALVORADA DO SUL";394;27;81;502
2015;"NOVA ANDRADINA (MS)";"MS";"NOVA ANDRADINA";1121;39;261;1421
2015;"NOVO HORIZONTE DO SUL (MS)";"MS";"NOVO HORIZONTE DO SUL";85;8;23;116
2015;"PARAISO DAS AGUAS (MS)";"MS";"PARAISO DAS AGUAS";65;16;12;93
2015;"PARANAIBA (MS)";"MS";"PARANAIBA";887;42;113;1042
2015;"PARANHOS (MS)";"MS";"PARANHOS";117;5;32;154
2015;"PEDRO GOMES (MS)";"MS";"PEDRO GOMES";106;6;17;129
2015;"PONTA PORA (MS)";"MS";"PONTA PORA";1980;114;344;2438
2015;"PORTO MURTINHO (MS)";"MS";"PORTO MURTINHO";89;12;28;129
2015;"RIBAS DO RIO PARDO (MS)";"MS";"RIBAS DO RIO PARDO";632;52;84;768
2015;"RIO BRILHANTE (MS)";"MS";"RIO BRILHANTE";722;61;136;919
2015;"RIO NEGRO (MS)";"MS";"RIO NEGRO";90;12;11;113
2015;"RIO VERDE DE MATO GROSSO (MS)";"MS";"RIO VERDE DE MATO GROSSO";384;23;31;438
2015;"ROCHEDO (MS)";"MS";"ROCHEDO";74;4;11;89
2015;"SANTA RITA DO PARDO (MS)";"MS";"SANTA RITA DO PARDO";136;8;35;179
2015;"SAO GABRIEL DO OESTE (MS)";"MS";"SAO GABRIEL DO OESTE";1026;31;94;1151
2015;"SELVIRIA (MS)";"MS";"SELVIRIA";100;16;26;142
2015;"SETE QUEDAS (MS)";"MS";"SETE QUEDAS";241;10;21;272
2015;"SIDROLANDIA (MS)";"MS";"SIDROLANDIA";698;123;289;1110
2015;"SONORA (MS)";"MS";"SONORA";231;23;105;359
2015;"TACURU (MS)";"MS";"TACURU";136;7;22;165
2015;"TAQUARUSSU (MS)";"MS";"TAQUARUSSU";57;6;15;78
2015;"TERENOS (MS)";"MS";"TERENOS";364;16;58;438
2015;"TRES LAGOAS (MS)";"MS";"TRES LAGOAS";1908;209;430;2547
2015;"VICENTINA (MS)";"MS";"VICENTINA";143;8;111;262
2015;"ACORIZAL (MT)";"MT";"ACORIZAL";23;5;3;31
2015;"AGUA BOA (MT)";"MT";"AGUA BOA";677;19;50;746
2015;"ALTA FLORESTA (MT)";"MT";"ALTA FLORESTA";1402;31;151;1584
2015;"ALTO ARAGUAIA (MT)";"MT";"ALTO ARAGUAIA";204;24;45;273
2015;"ALTO BOA VISTA (MT)";"MT";"ALTO BOA VISTA";55;0;6;61
2015;"ALTO GARCAS (MT)";"MT";"ALTO GARCAS";302;17;56;375
2015;"ALTO PARAGUAI (MT)";"MT";"ALTO PARAGUAI";49;7;8;64
2015;"ALTO TAQUARI (MT)";"MT";"ALTO TAQUARI";247;29;26;302
2015;"APIACAS (MT)";"MT";"APIACAS";147;9;10;166
2015;"ARAGUAIANA (MT)";"MT";"ARAGUAIANA";13;0;3;16
2015;"ARAGUAINHA (MT)";"MT";"ARAGUAINHA";10;2;1;13
2015;"ARAPUTANGA (MT)";"MT";"ARAPUTANGA";278;11;25;314
2015;"ARENAPOLIS (MT)";"MT";"ARENAPOLIS";211;11;63;285
2015;"ARIPUANA (MT)";"MT";"ARIPUANA";437;9;53;499
2015;"BARAO DE MELGACO (MT)";"MT";"BARAO DE MELGACO";14;5;7;26
2015;"BARRA DO BUGRES (MT)";"MT";"BARRA DO BUGRES";595;20;160;775
2015;"BARRA DO GARCAS (MT)";"MT";"BARRA DO GARCAS";892;34;201;1127
2015;"BOM JESUS DO ARAGUAIA (MT)";"MT";"BOM JESUS DO ARAGUAIA";70;1;17;88
2015;"BRASNORTE (MT)";"MT";"BRASNORTE";352;10;64;426
2015;"CACERES (MT)";"MT";"CACERES";974;58;313;1345
2015;"CAMPINAPOLIS (MT)";"MT";"CAMPINAPOLIS";96;5;17;118
2015;"CAMPO NOVO DO PARECIS (MT)";"MT";"CAMPO NOVO DO PARECIS";783;53;141;977
2015;"CAMPO VERDE (MT)";"MT";"CAMPO VERDE";970;56;149;1175
2015;"CAMPOS DE JULIO (MT)";"MT";"CAMPOS DE JULIO";198;14;41;253
2015;"CANABRAVA DO NORTE (MT)";"MT";"CANABRAVA DO NORTE";38;0;9;47
2015;"CANARANA (MT)";"MT";"CANARANA";601;16;31;648
2015;"CARLINDA (MT)";"MT";"CARLINDA";158;2;25;185
2015;"CASTANHEIRA (MT)";"MT";"CASTANHEIRA";150;2;21;173
2015;"CHAPADA DOS GUIMARAES (MT)";"MT";"CHAPADA DOS GUIMARAES";218;34;52;304
2015;"CLAUDIA (MT)";"MT";"CLAUDIA";428;6;29;463
2015;"COCALINHO (MT)";"MT";"COCALINHO";34;1;9;44
2015;"COLIDER (MT)";"MT";"COLIDER";904;22;130;1056
2015;"COLNIZA (MT)";"MT";"COLNIZA";417;0;25;442
2015;"COMODORO (MT)";"MT";"COMODORO";534;11;92;637
2015;"CONFRESA (MT)";"MT";"CONFRESA";316;5;66;387
2015;"CONQUISTA D OESTE (MT)";"MT";"CONQUISTA D OESTE";48;4;13;65
2015;"COTRIGUACU (MT)";"MT";"COTRIGUACU";164;5;40;209
2015;"CUIABA (MT)";"MT";"CUIABA";10386;913;3275;14574
2015;"CURVELANDIA (MT)";"MT";"CURVELANDIA";95;0;20;115
2015;"DENISE (MT)";"MT";"DENISE";78;6;34;118
2015;"DIAMANTINO (MT)";"MT";"DIAMANTINO";515;24;92;631
2015;"DOM AQUINO (MT)";"MT";"DOM AQUINO";138;10;25;173
2015;"FELIZ NATAL (MT)";"MT";"FELIZ NATAL";266;3;28;297
2015;"FIGUEIROPOLIS D OESTE (MT)";"MT";"FIGUEIROPOLIS D OESTE";76;4;10;90
2015;"GAUCHA DO NORTE (MT)";"MT";"GAUCHA DO NORTE";137;4;23;164
2015;"GENERAL CARNEIRO (MT)";"MT";"GENERAL CARNEIRO";26;5;6;37
2015;"GLORIA D OESTE (MT)";"MT";"GLORIA D OESTE";65;3;17;85
2015;"GUARANTA DO NORTE (MT)";"MT";"GUARANTA DO NORTE";981;15;74;1070
2015;"GUIRATINGA (MT)";"MT";"GUIRATINGA";198;10;14;222
2015;"INDIAVAI (MT)";"MT";"INDIAVAI";21;3;7;31
2015;"IPIRANGA DO NORTE (MT)";"MT";"IPIRANGA DO NORTE";156;5;11;172
2015;"ITANHANGA (MT)";"MT";"ITANHANGA";190;4;17;211
2015;"ITAUBA (MT)";"MT";"ITAUBA";137;11;13;161
2015;"ITIQUIRA (MT)";"MT";"ITIQUIRA";147;23;82;252
2015;"JACIARA (MT)";"MT";"JACIARA";642;50;155;847
2015;"JANGADA (MT)";"MT";"JANGADA";52;7;22;81
2015;"JAURU (MT)";"MT";"JAURU";167;9;41;217
2015;"JUARA (MT)";"MT";"JUARA";885;19;73;977
2015;"JUINA (MT)";"MT";"JUINA";1047;21;97;1165
2015;"JURUENA (MT)";"MT";"JURUENA";200;2;19;221
2015;"JUSCIMEIRA (MT)";"MT";"JUSCIMEIRA";153;7;68;228
2015;"LAMBARI D OESTE (MT)";"MT";"LAMBARI D OESTE";91;2;28;121
2015;"LUCAS DO RIO VERDE (MT)";"MT";"LUCAS DO RIO VERDE";1745;63;158;1966
2015;"LUCIARA (MT)";"MT";"LUCIARA";13;0;3;16
2015;"MARCELANDIA (MT)";"MT";"MARCELANDIA";419;7;22;448
2015;"MATUPA (MT)";"MT";"MATUPA";429;10;52;491
2015;"MIRASSOL D OESTE (MT)";"MT";"MIRASSOL D OESTE";815;12;89;916
2015;"NOBRES (MT)";"MT";"NOBRES";337;30;63;430
2015;"NORTELANDIA (MT)";"MT";"NORTELANDIA";88;8;18;114
2015;"NOSSA SENHORA DO LIVRAMENTO (MT)";"MT";"NOSSA SENHORA DO LIVRAMENTO";99;8;34;141
2015;"NOVA BANDEIRANTES (MT)";"MT";"NOVA BANDEIRANTES";213;3;32;248
2015;"NOVA BRASILANDIA (MT)";"MT";"NOVA BRASILANDIA";62;2;13;77
2015;"NOVA CANAA DO NORTE (MT)";"MT";"NOVA CANAA DO NORTE";229;6;71;306
2015;"NOVA GUARITA (MT)";"MT";"NOVA GUARITA";113;1;18;132
2015;"NOVA LACERDA (MT)";"MT";"NOVA LACERDA";117;2;30;149
2015;"NOVA MARILANDIA (MT)";"MT";"NOVA MARILANDIA";50;6;11;67
2015;"NOVA MARINGA (MT)";"MT";"NOVA MARINGA";139;1;11;151
2015;"NOVA MONTE VERDE (MT)";"MT";"NOVA MONTE VERDE";168;4;13;185
2015;"NOVA MUTUM (MT)";"MT";"NOVA MUTUM";1154;25;121;1300
2015;"NOVA NAZARE (MT)";"MT";"NOVA NAZARE";7;6;4;17
2015;"NOVA OLIMPIA (MT)";"MT";"NOVA OLIMPIA";359;13;147;519
2015;"NOVA SANTA HELENA (MT)";"MT";"NOVA SANTA HELENA";71;5;12;88
2015;"NOVA UBIRATA (MT)";"MT";"NOVA UBIRATA";206;20;36;262
2015;"NOVA XAVANTINA (MT)";"MT";"NOVA XAVANTINA";471;30;49;550
2015;"NOVO HORIZONTE DO NORTE (MT)";"MT";"NOVO HORIZONTE DO NORTE";46;1;15;62
2015;"NOVO MUNDO (MT)";"MT";"NOVO MUNDO";120;2;21;143
2015;"NOVO SANTO ANTONIO (MT)";"MT";"NOVO SANTO ANTONIO";2;0;2;4
2015;"NOVO SAO JOAQUIM (MT)";"MT";"NOVO SAO JOAQUIM";113;1;18;132
2015;"PARANAITA (MT)";"MT";"PARANAITA";239;13;74;326
2015;"PARANATINGA (MT)";"MT";"PARANATINGA";489;22;75;586
2015;"PEDRA PRETA (MT)";"MT";"PEDRA PRETA";359;10;55;424
2015;"PEIXOTO DE AZEVEDO (MT)";"MT";"PEIXOTO DE AZEVEDO";432;15;75;522
2015;"PLANALTO DA SERRA (MT)";"MT";"PLANALTO DA SERRA";26;1;9;36
2015;"POCONE (MT)";"MT";"POCONE";505;27;41;573
2015;"PONTAL DO ARAGUAIA (MT)";"MT";"PONTAL DO ARAGUAIA";32;2;2;36
2015;"PONTE BRANCA (MT)";"MT";"PONTE BRANCA";5;1;1;7
2015;"PONTES E LACERDA (MT)";"MT";"PONTES E LACERDA";1005;25;114;1144
2015;"PORTO ALEGRE DO NORTE (MT)";"MT";"PORTO ALEGRE DO NORTE";86;6;35;127
2015;"PORTO DOS GAUCHOS (MT)";"MT";"PORTO DOS GAUCHOS";133;12;10;155
2015;"PORTO ESPERIDIAO (MT)";"MT";"PORTO ESPERIDIAO";156;8;52;216
2015;"PORTO ESTRELA (MT)";"MT";"PORTO ESTRELA";33;4;9;46
2015;"POXOREO (MT)";"MT";"POXOREO";138;22;50;210
2015;"PRIMAVERA DO LESTE (MT)";"MT";"PRIMAVERA DO LESTE";2119;100;184;2403
2015;"QUERENCIA (MT)";"MT";"QUERENCIA";378;28;40;446
2015;"RESERVA DO CABACAL (MT)";"MT";"RESERVA DO CABACAL";19;1;8;28
2015;"RIBEIRAO CASCALHEIRA (MT)";"MT";"RIBEIRAO CASCALHEIRA";133;14;18;165
2015;"RIBEIRAOZINHO (MT)";"MT";"RIBEIRAOZINHO";10;1;7;18
2015;"RIO BRANCO (MT)";"MT";"RIO BRANCO";91;4;34;129
2015;"RONDOLANDIA (MT)";"MT";"RONDOLANDIA";31;0;16;47
2015;"RONDONOPOLIS (MT)";"MT";"RONDONOPOLIS";4732;203;536;5471
2015;"ROSARIO OESTE (MT)";"MT";"ROSARIO OESTE";169;16;37;222
2015;"SALTO DO CEU (MT)";"MT";"SALTO DO CEU";57;7;24;88
2015;"SANTA CARMEM (MT)";"MT";"SANTA CARMEM";159;4;15;178
2015;"SANTA CRUZ DO XINGU (MT)";"MT";"SANTA CRUZ DO XINGU";12;1;6;19
2015;"SANTA RITA DO TRIVELATO (MT)";"MT";"SANTA RITA DO TRIVELATO";79;4;12;95
2015;"SANTA TEREZINHA (MT)";"MT";"SANTA TEREZINHA";11;2;16;29
2015;"SANTO AFONSO (MT)";"MT";"SANTO AFONSO";27;3;12;42
2015;"SANTO ANTONIO DO LESTE (MT)";"MT";"SANTO ANTONIO DO LESTE";69;5;20;94
2015;"SANTO ANTONIO DO LEVERGER (MT)";"MT";"SANTO ANTONIO DO LEVERGER";131;9;16;156
2015;"SAO FELIX DO ARAGUAIA (MT)";"MT";"SAO FELIX DO ARAGUAIA";53;15;25;93
2015;"SAO JOSE DO POVO (MT)";"MT";"SAO JOSE DO POVO";18;3;5;26
2015;"SAO JOSE DO RIO CLARO (MT)";"MT";"SAO JOSE DO RIO CLARO";354;16;54;424
2015;"SAO JOSE DO XINGU (MT)";"MT";"SAO JOSE DO XINGU";26;2;13;41
2015;"SAO JOSE DOS QUATRO MARCOS (MT)";"MT";"SAO JOSE DOS QUATRO MARCOS";492;11;73;576
2015;"SAO PEDRO DA CIPA (MT)";"MT";"SAO PEDRO DA CIPA";24;6;24;54
2015;"SAPEZAL (MT)";"MT";"SAPEZAL";587;47;108;742
2015;"SERRA NOVA DOURADA (MT)";"MT";"SERRA NOVA DOURADA";7;1;2;10
2015;"SINOP (MT)";"MT";"SINOP";3682;132;212;4026
2015;"SORRISO (MT)";"MT";"SORRISO";2424;82;188;2694
2015;"TABAPORA (MT)";"MT";"TABAPORA";167;5;27;199
2015;"TANGARA DA SERRA (MT)";"MT";"TANGARA DA SERRA";2104;91;214;2409
2015;"TAPURAH (MT)";"MT";"TAPURAH";360;6;38;404
2015;"TERRA NOVA DO NORTE (MT)";"MT";"TERRA NOVA DO NORTE";300;11;33;344
2015;"TESOURO (MT)";"MT";"TESOURO";17;4;3;24
2015;"TORIXOREU (MT)";"MT";"TORIXOREU";37;3;5;45
2015;"UNIAO DO SUL (MT)";"MT";"UNIAO DO SUL";107;0;12;119
2015;"VALE DE SAO DOMINGOS (MT)";"MT";"VALE DE SAO DOMINGOS";26;0;16;42
2015;"VARZEA GRANDE (MT)";"MT";"VARZEA GRANDE";5171;331;611;6113
2015;"VERA (MT)";"MT";"VERA";272;4;28;304
2015;"VILA BELA DA SANTISSIMA TRINDA (MT)";"MT";"VILA BELA DA SANTISSIMA TRINDA";138;5;40;183
2015;"VILA RICA (MT)";"MT";"VILA RICA";310;2;38;350
2015;"ABAETETUBA (PA)";"PA";"ABAETETUBA";369;26;275;670
2015;"ABEL FIGUEIREDO (PA)";"PA";"ABEL FIGUEIREDO";69;5;4;78
2015;"ACARA (PA)";"PA";"ACARA";98;12;84;194
2015;"AFUA (PA)";"PA";"AFUA";2;0;0;2
2015;"AGUA AZUL DO NORTE (PA)";"PA";"AGUA AZUL DO NORTE";84;9;28;121
2015;"ALENQUER (PA)";"PA";"ALENQUER";208;6;64;278
2015;"ALMEIRIM (PA)";"PA";"ALMEIRIM";254;25;104;383
2015;"ALTAMIRA (PA)";"PA";"ALTAMIRA";2077;183;611;2871
2015;"ANAJAS (PA)";"PA";"ANAJAS";2;0;1;3
2015;"ANANINDEUA (PA)";"PA";"ANANINDEUA";4571;370;1592;6533
2015;"ANAPU (PA)";"PA";"ANAPU";119;16;14;149
2015;"AUGUSTO CORREA (PA)";"PA";"AUGUSTO CORREA";46;1;55;102
2015;"AURORA DO PARA (PA)";"PA";"AURORA DO PARA";92;12;75;179
2015;"AVEIRO (PA)";"PA";"AVEIRO";6;0;5;11
2015;"BAGRE (PA)";"PA";"BAGRE";1;0;2;3
2015;"BAIAO (PA)";"PA";"BAIAO";55;5;24;84
2015;"BANNACH (PA)";"PA";"BANNACH";20;0;3;23
2015;"BARCARENA (PA)";"PA";"BARCARENA";1006;165;703;1874
2015;"BELEM (PA)";"PA";"BELEM";9033;2086;3806;14925
2015;"BELTERRA (PA)";"PA";"BELTERRA";49;9;54;112
2015;"BENEVIDES (PA)";"PA";"BENEVIDES";988;57;133;1178
2015;"BOM JESUS DO TOCANTINS (PA)";"PA";"BOM JESUS DO TOCANTINS";83;9;9;101
2015;"BONITO (PA)";"PA";"BONITO";50;4;55;109
2015;"BRAGANCA (PA)";"PA";"BRAGANCA";462;31;190;683
2015;"BRASIL NOVO (PA)";"PA";"BRASIL NOVO";190;16;21;227
2015;"BREJO GRANDE DO ARAGUAIA (PA)";"PA";"BREJO GRANDE DO ARAGUAIA";27;3;9;39
2015;"BREU BRANCO (PA)";"PA";"BREU BRANCO";308;10;104;422
2015;"BREVES (PA)";"PA";"BREVES";69;4;10;83
2015;"BUJARU (PA)";"PA";"BUJARU";54;9;33;96
2015;"CACHOEIRA DO ARARI (PA)";"PA";"CACHOEIRA DO ARARI";14;5;17;36
2015;"CACHOEIRA DO PIRIA (PA)";"PA";"CACHOEIRA DO PIRIA";35;4;32;71
2015;"CAMETA (PA)";"PA";"CAMETA";156;13;68;237
2015;"CANAA DOS CARAJAS (PA)";"PA";"CANAA DOS CARAJAS";406;77;276;759
2015;"CAPANEMA (PA)";"PA";"CAPANEMA";746;28;115;889
2015;"CAPITAO POCO (PA)";"PA";"CAPITAO POCO";425;20;105;550
2015;"CASTANHAL (PA)";"PA";"CASTANHAL";2807;183;427;3417
2015;"CHAVES (PA)";"PA";"CHAVES";1;0;0;1
2015;"COLARES (PA)";"PA";"COLARES";9;0;5;14
2015;"CONCEICAO DO ARAGUAIA (PA)";"PA";"CONCEICAO DO ARAGUAIA";416;47;88;551
2015;"CONCORDIA DO PARA (PA)";"PA";"CONCORDIA DO PARA";169;12;78;259
2015;"CUMARU DO NORTE (PA)";"PA";"CUMARU DO NORTE";29;1;9;39
2015;"CURIONOPOLIS (PA)";"PA";"CURIONOPOLIS";145;99;15;259
2015;"CURRALINHO (PA)";"PA";"CURRALINHO";1;0;2;3
2015;"CURUA (PA)";"PA";"CURUA";7;1;3;11
2015;"CURUCA (PA)";"PA";"CURUCA";53;14;18;85
2015;"DOM ELISEU (PA)";"PA";"DOM ELISEU";573;62;54;689
2015;"ELDORADO DOS CARAJAS (PA)";"PA";"ELDORADO DOS CARAJAS";197;51;21;269
2015;"FARO (PA)";"PA";"FARO";3;1;1;5
2015;"FLORESTA DO ARAGUAIA (PA)";"PA";"FLORESTA DO ARAGUAIA";144;1;26;171
2015;"GARRAFAO DO NORTE (PA)";"PA";"GARRAFAO DO NORTE";115;6;20;141
2015;"GOIANESIA DO PARA (PA)";"PA";"GOIANESIA DO PARA";307;21;45;373
2015;"GURUPA (PA)";"PA";"GURUPA";9;0;3;12
2015;"IGARAPE ACU (PA)";"PA";"IGARAPE ACU";190;76;92;358
2015;"IGARAPE MIRI (PA)";"PA";"IGARAPE MIRI";87;24;40;151
2015;"INHANGAPI (PA)";"PA";"INHANGAPI";41;1;37;79
2015;"IPIXUNA DO PARA (PA)";"PA";"IPIXUNA DO PARA";78;12;49;139
2015;"IRITUIA (PA)";"PA";"IRITUIA";91;5;55;151
2015;"ITAITUBA (PA)";"PA";"ITAITUBA";1075;41;134;1250
2015;"ITUPIRANGA (PA)";"PA";"ITUPIRANGA";233;93;45;371
2015;"JACAREACANGA (PA)";"PA";"JACAREACANGA";26;1;1;28
2015;"JACUNDA (PA)";"PA";"JACUNDA";630;24;57;711
2015;"JURUTI (PA)";"PA";"JURUTI";96;11;14;121
2015;"LIMOEIRO DO AJURU (PA)";"PA";"LIMOEIRO DO AJURU";2;0;4;6
2015;"MAE DO RIO (PA)";"PA";"MAE DO RIO";350;31;65;446
2015;"MAGALHAES BARATA (PA)";"PA";"MAGALHAES BARATA";13;11;10;34
2015;"MARABA (PA)";"PA";"MARABA";3704;323;712;4739
2015;"MARACANA (PA)";"PA";"MARACANA";39;13;31;83
2015;"MARAPANIM (PA)";"PA";"MARAPANIM";44;13;33;90
2015;"MARITUBA (PA)";"PA";"MARITUBA";914;99;568;1581
2015;"MEDICILANDIA (PA)";"PA";"MEDICILANDIA";235;14;36;285
2015;"MELGACO (PA)";"PA";"MELGACO";7;0;4;11
2015;"MOCAJUBA (PA)";"PA";"MOCAJUBA";23;3;12;38
2015;"MOJU (PA)";"PA";"MOJU";227;23;229;479
2015;"MOJUI DOS CAMPOS (PA)";"PA";"MOJUI DOS CAMPOS";30;1;30;61
2015;"MONTE ALEGRE (PA)";"PA";"MONTE ALEGRE";303;14;160;477
2015;"MUANA (PA)";"PA";"MUANA";6;3;12;21
2015;"NOVA ESPERANCA DO PIRIA (PA)";"PA";"NOVA ESPERANCA DO PIRIA";93;5;23;121
2015;"NOVA IPIXUNA (PA)";"PA";"NOVA IPIXUNA";151;2;27;180
2015;"NOVA TIMBOTEUA (PA)";"PA";"NOVA TIMBOTEUA";73;3;24;100
2015;"NOVO PROGRESSO (PA)";"PA";"NOVO PROGRESSO";727;10;41;778
2015;"NOVO REPARTIMENTO (PA)";"PA";"NOVO REPARTIMENTO";486;36;59;581
2015;"OBIDOS (PA)";"PA";"OBIDOS";209;3;60;272
2015;"OEIRAS DO PARA (PA)";"PA";"OEIRAS DO PARA";10;1;13;24
2015;"ORIXIMINA (PA)";"PA";"ORIXIMINA";372;15;36;423
2015;"OUREM (PA)";"PA";"OUREM";170;4;19;193
2015;"OURILANDIA DO NORTE (PA)";"PA";"OURILANDIA DO NORTE";287;14;42;343
2015;"PACAJA (PA)";"PA";"PACAJA";144;27;13;184
2015;"PALESTINA DO PARA (PA)";"PA";"PALESTINA DO PARA";31;6;6;43
2015;"PARAGOMINAS (PA)";"PA";"PARAGOMINAS";1433;52;173;1658
2015;"PARAUAPEBAS (PA)";"PA";"PARAUAPEBAS";2372;643;1310;4325
2015;"PAU D ARCO (PA)";"PA";"PAU D ARCO";17;11;7;35
2015;"PEIXE BOI (PA)";"PA";"PEIXE BOI";21;6;14;41
2015;"PICARRA (PA)";"PA";"PICARRA";37;1;8;46
2015;"PLACAS (PA)";"PA";"PLACAS";102;6;4;112
2015;"PONTA DE PEDRAS (PA)";"PA";"PONTA DE PEDRAS";15;2;6;23
2015;"PORTEL (PA)";"PA";"PORTEL";27;2;11;40
2015;"PORTO DE MOZ (PA)";"PA";"PORTO DE MOZ";25;1;7;33
2015;"PRAINHA (PA)";"PA";"PRAINHA";34;0;5;39
2015;"PRIMAVERA (PA)";"PA";"PRIMAVERA";33;2;21;56
2015;"QUATIPURU (PA)";"PA";"QUATIPURU";12;4;17;33
2015;"REDENCAO (PA)";"PA";"REDENCAO";1701;87;170;1958
2015;"RIO MARIA (PA)";"PA";"RIO MARIA";313;31;56;400
2015;"RONDON DO PARA (PA)";"PA";"RONDON DO PARA";512;49;25;586
2015;"RUROPOLIS (PA)";"PA";"RUROPOLIS";227;10;21;258
2015;"SALINOPOLIS (PA)";"PA";"SALINOPOLIS";164;35;80;279
2015;"SALVATERRA (PA)";"PA";"SALVATERRA";42;36;27;105
2015;"SANTA BARBARA DO PARA (PA)";"PA";"SANTA BARBARA DO PARA";72;23;105;200
2015;"SANTA CRUZ DO ARARI (PA)";"PA";"SANTA CRUZ DO ARARI";5;0;1;6
2015;"SANTA ISABEL DO PARA (PA)";"PA";"SANTA ISABEL DO PARA";696;52;155;903
2015;"SANTA LUZIA DO PARA (PA)";"PA";"SANTA LUZIA DO PARA";125;11;34;170
2015;"SANTA MARIA DAS BARREIRAS (PA)";"PA";"SANTA MARIA DAS BARREIRAS";86;5;35;126
2015;"SANTA MARIA DO PARA (PA)";"PA";"SANTA MARIA DO PARA";340;23;48;411
2015;"SANTANA DO ARAGUAIA (PA)";"PA";"SANTANA DO ARAGUAIA";275;12;33;320
2015;"SANTAREM (PA)";"PA";"SANTAREM";2950;148;734;3832
2015;"SANTAREM NOVO (PA)";"PA";"SANTAREM NOVO";9;2;18;29
2015;"SANTO ANTONIO DO TAUA (PA)";"PA";"SANTO ANTONIO DO TAUA";152;25;99;276
2015;"SAO CAETANO DE ODIVELAS (PA)";"PA";"SAO CAETANO DE ODIVELAS";22;2;9;33
2015;"SAO DOMINGOS DO ARAGUAIA (PA)";"PA";"SAO DOMINGOS DO ARAGUAIA";177;26;29;232
2015;"SAO DOMINGOS DO CAPIM (PA)";"PA";"SAO DOMINGOS DO CAPIM";41;0;35;76
2015;"SAO FELIX DO XINGU (PA)";"PA";"SAO FELIX DO XINGU";362;9;38;409
2015;"SAO FRANCISCO DO PARA (PA)";"PA";"SAO FRANCISCO DO PARA";53;35;29;117
2015;"SAO GERALDO DO ARAGUAIA (PA)";"PA";"SAO GERALDO DO ARAGUAIA";132;6;20;158
2015;"SAO JOAO DA PONTA (PA)";"PA";"SAO JOAO DA PONTA";4;3;8;15
2015;"SAO JOAO DE PIRABAS (PA)";"PA";"SAO JOAO DE PIRABAS";35;8;22;65
2015;"SAO JOAO DO ARAGUAIA (PA)";"PA";"SAO JOAO DO ARAGUAIA";27;15;11;53
2015;"SAO MIGUEL DO GUAMA (PA)";"PA";"SAO MIGUEL DO GUAMA";443;25;128;596
2015;"SAO SEBASTIAO DA BOA VISTA (PA)";"PA";"SAO SEBASTIAO DA BOA VISTA";5;0;1;6
2015;"SAPUCAIA (PA)";"PA";"SAPUCAIA";35;4;11;50
2015;"SENADOR JOSE PORFIRIO (PA)";"PA";"SENADOR JOSE PORFIRIO";34;2;10;46
2015;"SOURE (PA)";"PA";"SOURE";33;2;18;53
2015;"TAILANDIA (PA)";"PA";"TAILANDIA";772;38;197;1007
2015;"TERRA ALTA (PA)";"PA";"TERRA ALTA";25;17;18;60
2015;"TERRA SANTA (PA)";"PA";"TERRA SANTA";26;0;2;28
2015;"TOME ACU (PA)";"PA";"TOME ACU";550;20;167;737
2015;"TRACUATEUA (PA)";"PA";"TRACUATEUA";41;7;45;93
2015;"TRAIRAO (PA)";"PA";"TRAIRAO";145;2;12;159
2015;"TUCUMA (PA)";"PA";"TUCUMA";647;23;93;763
2015;"TUCURUI (PA)";"PA";"TUCURUI";883;89;221;1193
2015;"ULIANOPOLIS (PA)";"PA";"ULIANOPOLIS";215;23;40;278
2015;"URUARA (PA)";"PA";"URUARA";558;19;38;615
2015;"VIGIA (PA)";"PA";"VIGIA";157;18;89;264
2015;"VISEU (PA)";"PA";"VISEU";80;6;49;135
2015;"VITORIA DO XINGU (PA)";"PA";"VITORIA DO XINGU";43;17;22;82
2015;"XINGUARA (PA)";"PA";"XINGUARA";973;28;105;1106
2015;"AGUA BRANCA (PB)";"PB";"AGUA BRANCA";16;8;7;31
2015;"AGUIAR (PB)";"PB";"AGUIAR";10;7;3;20
2015;"ALAGOA GRANDE (PB)";"PB";"ALAGOA GRANDE";118;38;43;199
2015;"ALAGOA NOVA (PB)";"PB";"ALAGOA NOVA";157;36;13;206
2015;"ALAGOINHA (PB)";"PB";"ALAGOINHA";42;18;30;90
2015;"ALCANTIL (PB)";"PB";"ALCANTIL";53;14;17;84
2015;"ALGODAO DE JANDAIRA (PB)";"PB";"ALGODAO DE JANDAIRA";31;0;4;35
2015;"ALHANDRA (PB)";"PB";"ALHANDRA";179;24;30;233
2015;"AMPARO (PB)";"PB";"AMPARO";10;8;6;24
2015;"APARECIDA (PB)";"PB";"APARECIDA";44;6;18;68
2015;"ARACAGI (PB)";"PB";"ARACAGI";72;2;53;127
2015;"ARARA (PB)";"PB";"ARARA";79;9;20;108
2015;"ARARUNA (PB)";"PB";"ARARUNA";92;43;17;152
2015;"AREIA (PB)";"PB";"AREIA";119;43;28;190
2015;"AREIA DE BARAUNAS (PB)";"PB";"AREIA DE BARAUNAS";6;3;2;11
2015;"AREIAL (PB)";"PB";"AREIAL";42;10;9;61
2015;"AROEIRAS (PB)";"PB";"AROEIRAS";86;61;17;164
2015;"ASSUNCAO (PB)";"PB";"ASSUNCAO";34;6;5;45
2015;"BAIA DA TRAICAO (PB)";"PB";"BAIA DA TRAICAO";15;7;14;36
2015;"BANANEIRAS (PB)";"PB";"BANANEIRAS";106;34;29;169
2015;"BARAUNA (PB)";"PB";"BARAUNA";32;2;6;40
2015;"BARRA DE SANTA ROSA (PB)";"PB";"BARRA DE SANTA ROSA";102;7;20;129
2015;"BARRA DE SANTANA (PB)";"PB";"BARRA DE SANTANA";79;7;17;103
2015;"BARRA DE SAO MIGUEL (PB)";"PB";"BARRA DE SAO MIGUEL";13;3;5;21
2015;"BAYEUX (PB)";"PB";"BAYEUX";748;41;180;969
2015;"BELEM (PB)";"PB";"BELEM";130;11;13;154
2015;"BELEM DO BREJO DO CRUZ (PB)";"PB";"BELEM DO BREJO DO CRUZ";16;11;4;31
2015;"BERNARDINO BATISTA (PB)";"PB";"BERNARDINO BATISTA";4;0;5;9
2015;"BOA VENTURA (PB)";"PB";"BOA VENTURA";15;4;2;21
2015;"BOA VISTA (PB)";"PB";"BOA VISTA";108;9;21;138
2015;"BOM JESUS (PB)";"PB";"BOM JESUS";12;0;3;15
2015;"BOM SUCESSO (PB)";"PB";"BOM SUCESSO";14;4;8;26
2015;"BONITO DE SANTA FE (PB)";"PB";"BONITO DE SANTA FE";29;13;3;45
2015;"BOQUEIRAO (PB)";"PB";"BOQUEIRAO";223;13;26;262
2015;"BORBOREMA (PB)";"PB";"BORBOREMA";45;10;3;58
2015;"BREJO DO CRUZ (PB)";"PB";"BREJO DO CRUZ";78;12;7;97
2015;"BREJO DOS SANTOS (PB)";"PB";"BREJO DOS SANTOS";28;3;3;34
2015;"CAAPORA (PB)";"PB";"CAAPORA";54;11;12;77
2015;"CABACEIRAS (PB)";"PB";"CABACEIRAS";28;4;18;50
2015;"CABEDELO (PB)";"PB";"CABEDELO";532;48;31;611
2015;"CACHOEIRA DOS INDIOS (PB)";"PB";"CACHOEIRA DOS INDIOS";20;5;8;33
2015;"CACIMBA DE AREIA (PB)";"PB";"CACIMBA DE AREIA";6;2;5;13
2015;"CACIMBA DE DENTRO (PB)";"PB";"CACIMBA DE DENTRO";76;13;36;125
2015;"CACIMBAS (PB)";"PB";"CACIMBAS";6;11;4;21
2015;"CAICARA (PB)";"PB";"CAICARA";15;4;6;25
2015;"CAJAZEIRAS (PB)";"PB";"CAJAZEIRAS";490;54;64;608
2015;"CAJAZEIRINHAS (PB)";"PB";"CAJAZEIRINHAS";5;0;3;8
2015;"CALDAS BRANDAO (PB)";"PB";"CALDAS BRANDAO";43;5;9;57
2015;"CAMALAU (PB)";"PB";"CAMALAU";31;8;16;55
2015;"CAMPINA GRANDE (PB)";"PB";"CAMPINA GRANDE";4373;343;827;5543
2015;"CAMPO DE SANTANA (PB)";"PB";"CAMPO DE SANTANA";35;8;19;62
2015;"CAPIM (PB)";"PB";"CAPIM";32;11;16;59
2015;"CARAUBAS (PB)";"PB";"CARAUBAS";12;7;4;23
2015;"CARRAPATEIRA (PB)";"PB";"CARRAPATEIRA";4;0;3;7
2015;"CASSERENGUE (PB)";"PB";"CASSERENGUE";43;10;17;70
2015;"CATINGUEIRA (PB)";"PB";"CATINGUEIRA";13;4;2;19
2015;"CATOLE DO ROCHA (PB)";"PB";"CATOLE DO ROCHA";270;55;15;340
2015;"CATURITE (PB)";"PB";"CATURITE";116;13;13;142
2015;"CONCEICAO (PB)";"PB";"CONCEICAO";98;35;9;142
2015;"CONDADO (PB)";"PB";"CONDADO";41;7;9;57
2015;"CONDE (PB)";"PB";"CONDE";105;26;18;149
2015;"CONGO (PB)";"PB";"CONGO";23;8;7;38
2015;"COREMAS (PB)";"PB";"COREMAS";63;25;10;98
2015;"COXIXOLA (PB)";"PB";"COXIXOLA";5;7;0;12
2015;"CRUZ DO ESPIRITO SANTO (PB)";"PB";"CRUZ DO ESPIRITO SANTO";30;9;27;66
2015;"CUBATI (PB)";"PB";"CUBATI";45;5;5;55
2015;"CUITE (PB)";"PB";"CUITE";111;8;20;139
2015;"CUITE DE MAMANGUAPE (PB)";"PB";"CUITE DE MAMANGUAPE";18;9;29;56
2015;"CUITEGI (PB)";"PB";"CUITEGI";26;6;3;35
2015;"CURRAL DE CIMA (PB)";"PB";"CURRAL DE CIMA";15;4;21;40
2015;"CURRAL VELHO (PB)";"PB";"CURRAL VELHO";6;4;2;12
2015;"DAMIAO (PB)";"PB";"DAMIAO";34;7;9;50
2015;"DESTERRO (PB)";"PB";"DESTERRO";29;11;6;46
2015;"DIAMANTE (PB)";"PB";"DIAMANTE";18;4;4;26
2015;"DONA INES (PB)";"PB";"DONA INES";49;11;19;79
2015;"DUAS ESTRADAS (PB)";"PB";"DUAS ESTRADAS";12;5;5;22
2015;"EMAS (PB)";"PB";"EMAS";9;6;3;18
2015;"ESPERANCA (PB)";"PB";"ESPERANCA";567;29;100;696
2015;"FAGUNDES (PB)";"PB";"FAGUNDES";43;11;29;83
2015;"FREI MARTINHO (PB)";"PB";"FREI MARTINHO";10;1;6;17
2015;"GADO BRAVO (PB)";"PB";"GADO BRAVO";41;26;20;87
2015;"GUARABIRA (PB)";"PB";"GUARABIRA";561;69;178;808
2015;"GURINHEM (PB)";"PB";"GURINHEM";44;10;24;78
2015;"GURJAO (PB)";"PB";"GURJAO";19;2;5;26
2015;"IBIARA (PB)";"PB";"IBIARA";10;5;4;19
2015;"IGARACY (PB)";"PB";"IGARACY";15;10;5;30
2015;"IMACULADA (PB)";"PB";"IMACULADA";14;10;5;29
2015;"INGA (PB)";"PB";"INGA";121;14;32;167
2015;"ITABAIANA (PB)";"PB";"ITABAIANA";153;12;39;204
2015;"ITAPORANGA (PB)";"PB";"ITAPORANGA";154;41;24;219
2015;"ITAPOROROCA (PB)";"PB";"ITAPOROROCA";108;4;28;140
2015;"ITATUBA (PB)";"PB";"ITATUBA";36;4;14;54
2015;"JACARAU (PB)";"PB";"JACARAU";64;4;19;87
2015;"JERICO (PB)";"PB";"JERICO";30;6;2;38
2015;"JOAO PESSOA (PB)";"PB";"JOAO PESSOA";6169;1143;2404;9716
2015;"JUAREZ TAVORA (PB)";"PB";"JUAREZ TAVORA";32;4;13;49
2015;"JUAZEIRINHO (PB)";"PB";"JUAZEIRINHO";93;19;14;126
2015;"JUNCO DO SERIDO (PB)";"PB";"JUNCO DO SERIDO";60;4;4;68
2015;"JURIPIRANGA (PB)";"PB";"JURIPIRANGA";50;4;20;74
2015;"JURU (PB)";"PB";"JURU";13;6;4;23
2015;"LAGOA (PB)";"PB";"LAGOA";12;4;5;21
2015;"LAGOA DE DENTRO (PB)";"PB";"LAGOA DE DENTRO";43;5;15;63
2015;"LAGOA SECA (PB)";"PB";"LAGOA SECA";210;54;16;280
2015;"LASTRO (PB)";"PB";"LASTRO";4;3;4;11
2015;"LIVRAMENTO (PB)";"PB";"LIVRAMENTO";38;3;5;46
2015;"LOGRADOURO (PB)";"PB";"LOGRADOURO";6;3;12;21
2015;"LUCENA (PB)";"PB";"LUCENA";28;4;13;45
2015;"MAE D AGUA (PB)";"PB";"MAE D AGUA";8;1;4;13
2015;"MALTA (PB)";"PB";"MALTA";15;7;3;25
2015;"MAMANGUAPE (PB)";"PB";"MAMANGUAPE";452;17;97;566
2015;"MANAIRA (PB)";"PB";"MANAIRA";20;10;2;32
2015;"MARCACAO (PB)";"PB";"MARCACAO";4;5;17;26
2015;"MARI (PB)";"PB";"MARI";115;11;54;180
2015;"MARIZOPOLIS (PB)";"PB";"MARIZOPOLIS";40;4;2;46
2015;"MASSARANDUBA (PB)";"PB";"MASSARANDUBA";37;17;12;66
2015;"MATARACA (PB)";"PB";"MATARACA";42;5;17;64
2015;"MATINHAS (PB)";"PB";"MATINHAS";12;2;4;18
2015;"MATO GROSSO (PB)";"PB";"MATO GROSSO";13;3;3;19
2015;"MATUREIA (PB)";"PB";"MATUREIA";18;24;7;49
2015;"MOGEIRO (PB)";"PB";"MOGEIRO";35;5;6;46
2015;"MONTADAS (PB)";"PB";"MONTADAS";34;4;9;47
2015;"MONTE HOREBE (PB)";"PB";"MONTE HOREBE";8;4;5;17
2015;"MONTEIRO (PB)";"PB";"MONTEIRO";274;81;52;407
2015;"MULUNGU (PB)";"PB";"MULUNGU";52;10;18;80
2015;"NATUBA (PB)";"PB";"NATUBA";28;4;6;38
2015;"NAZAREZINHO (PB)";"PB";"NAZAREZINHO";32;8;4;44
2015;"NOVA FLORESTA (PB)";"PB";"NOVA FLORESTA";41;15;11;67
2015;"NOVA OLINDA (PB)";"PB";"NOVA OLINDA";23;8;6;37
2015;"NOVA PALMEIRA (PB)";"PB";"NOVA PALMEIRA";31;1;4;36
2015;"OLHO D AGUA (PB)";"PB";"OLHO D AGUA";9;9;3;21
2015;"OLIVEDOS (PB)";"PB";"OLIVEDOS";29;5;9;43
2015;"OURO VELHO (PB)";"PB";"OURO VELHO";16;3;5;24
2015;"PARARI (PB)";"PB";"PARARI";7;2;2;11
2015;"PASSAGEM (PB)";"PB";"PASSAGEM";16;0;2;18
2015;"PATOS (PB)";"PB";"PATOS";759;164;57;980
2015;"PAULISTA (PB)";"PB";"PAULISTA";64;9;13;86
2015;"PEDRA BRANCA (PB)";"PB";"PEDRA BRANCA";12;9;2;23
2015;"PEDRA LAVRADA (PB)";"PB";"PEDRA LAVRADA";49;4;11;64
2015;"PEDRAS DE FOGO (PB)";"PB";"PEDRAS DE FOGO";255;32;93;380
2015;"PEDRO REGIS (PB)";"PB";"PEDRO REGIS";21;1;4;26
2015;"PIANCO (PB)";"PB";"PIANCO";93;18;7;118
2015;"PICUI (PB)";"PB";"PICUI";140;12;43;195
2015;"PILAR (PB)";"PB";"PILAR";33;3;13;49
2015;"PILOES (PB)";"PB";"PILOES";32;3;9;44
2015;"PILOEZINHOS (PB)";"PB";"PILOEZINHOS";15;4;6;25
2015;"PIRPIRITUBA (PB)";"PB";"PIRPIRITUBA";42;0;13;55
2015;"PITIMBU (PB)";"PB";"PITIMBU";35;22;10;67
2015;"POCINHOS (PB)";"PB";"POCINHOS";146;22;29;197
2015;"POCO DANTAS (PB)";"PB";"POCO DANTAS";8;0;5;13
2015;"POCO DE JOSE DE MOURA (PB)";"PB";"POCO DE JOSE DE MOURA";6;6;6;18
2015;"POMBAL (PB)";"PB";"POMBAL";339;56;18;413
2015;"PRATA (PB)";"PB";"PRATA";29;10;5;44
2015;"PRINCESA ISABEL (PB)";"PB";"PRINCESA ISABEL";104;87;17;208
2015;"PUXINANA (PB)";"PB";"PUXINANA";81;28;15;124
2015;"QUEIMADAS (PB)";"PB";"QUEIMADAS";485;103;89;677
2015;"QUIXABA (PB)";"PB";"QUIXABA";11;2;4;17
2015;"REMIGIO (PB)";"PB";"REMIGIO";312;7;24;343
2015;"RIACHAO (PB)";"PB";"RIACHAO";8;2;6;16
2015;"RIACHAO DO BACAMARTE (PB)";"PB";"RIACHAO DO BACAMARTE";22;2;4;28
2015;"RIACHAO DO POCO (PB)";"PB";"RIACHAO DO POCO";19;1;12;32
2015;"RIACHO DE SANTO ANTONIO (PB)";"PB";"RIACHO DE SANTO ANTONIO";14;4;3;21
2015;"RIACHO DOS CAVALOS (PB)";"PB";"RIACHO DOS CAVALOS";30;3;6;39
2015;"RIO TINTO (PB)";"PB";"RIO TINTO";98;7;44;149
2015;"SALGADINHO (PB)";"PB";"SALGADINHO";5;5;3;13
2015;"SALGADO DE SAO FELIX (PB)";"PB";"SALGADO DE SAO FELIX";20;6;9;35
2015;"SANTA CECILIA (PB)";"PB";"SANTA CECILIA";32;9;11;52
2015;"SANTA CRUZ (PB)";"PB";"SANTA CRUZ";14;3;13;30
2015;"SANTA HELENA (PB)";"PB";"SANTA HELENA";11;4;12;27
2015;"SANTA INES (PB)";"PB";"SANTA INES";11;2;3;16
2015;"SANTA LUZIA (PB)";"PB";"SANTA LUZIA";158;17;18;193
2015;"SANTA RITA (PB)";"PB";"SANTA RITA";892;90;289;1271
2015;"SANTA TERESINHA (PB)";"PB";"SANTA TERESINHA";27;4;6;37
2015;"SANTANA DE MANGUEIRA (PB)";"PB";"SANTANA DE MANGUEIRA";4;1;3;8
2015;"SANTANA DOS GARROTES (PB)";"PB";"SANTANA DOS GARROTES";22;12;2;36
2015;"SANTAREM (PB)";"PB";"SANTAREM";6;2;4;12
2015;"SANTO ANDRE (PB)";"PB";"SANTO ANDRE";18;5;24;47
2015;"SAO BENTINHO (PB)";"PB";"SAO BENTINHO";18;3;3;24
2015;"SAO BENTO (PB)";"PB";"SAO BENTO";265;31;20;316
2015;"SAO DOMINGOS DE POMBAL (PB)";"PB";"SAO DOMINGOS DE POMBAL";7;3;6;16
2015;"SAO DOMINGOS DO CARIRI (PB)";"PB";"SAO DOMINGOS DO CARIRI";10;3;4;17
2015;"SAO FRANCISCO (PB)";"PB";"SAO FRANCISCO";12;2;5;19
2015;"SAO JOAO DO CARIRI (PB)";"PB";"SAO JOAO DO CARIRI";30;4;10;44
2015;"SAO JOAO DO RIO DO PEIXE (PB)";"PB";"SAO JOAO DO RIO DO PEIXE";75;10;22;107
2015;"SAO JOAO DO TIGRE (PB)";"PB";"SAO JOAO DO TIGRE";13;4;5;22
2015;"SAO JOSE DA LAGOA TAPADA (PB)";"PB";"SAO JOSE DA LAGOA TAPADA";27;5;7;39
2015;"SAO JOSE DE CAIANA (PB)";"PB";"SAO JOSE DE CAIANA";8;7;7;22
2015;"SAO JOSE DE ESPINHARAS (PB)";"PB";"SAO JOSE DE ESPINHARAS";21;5;6;32
2015;"SAO JOSE DE PIRANHAS (PB)";"PB";"SAO JOSE DE PIRANHAS";45;15;10;70
2015;"SAO JOSE DE PRINCESA (PB)";"PB";"SAO JOSE DE PRINCESA";6;5;3;14
2015;"SAO JOSE DO BONFIM (PB)";"PB";"SAO JOSE DO BONFIM";10;3;3;16
2015;"SAO JOSE DO BREJO DO CRUZ (PB)";"PB";"SAO JOSE DO BREJO DO CRUZ";4;1;2;7
2015;"SAO JOSE DO SABUGI (PB)";"PB";"SAO JOSE DO SABUGI";23;1;5;29
2015;"SAO JOSE DOS CORDEIROS (PB)";"PB";"SAO JOSE DOS CORDEIROS";13;8;3;24
2015;"SAO JOSE DOS RAMOS (PB)";"PB";"SAO JOSE DOS RAMOS";23;1;10;34
2015;"SAO MAMEDE (PB)";"PB";"SAO MAMEDE";27;4;5;36
2015;"SAO MIGUEL DE TAIPU (PB)";"PB";"SAO MIGUEL DE TAIPU";28;0;9;37
2015;"SAO SEBASTIAO DE LAGOA DE ROCA (PB)";"PB";"SAO SEBASTIAO DE LAGOA DE ROCA";78;24;14;116
2015;"SAO SEBASTIAO DO UMBUZEIRO (PB)";"PB";"SAO SEBASTIAO DO UMBUZEIRO";13;2;5;20
2015;"SAO VICENTE DO SERIDO (PB)";"PB";"SAO VICENTE DO SERIDO";31;8;12;51
2015;"SAPE (PB)";"PB";"SAPE";369;32;103;504
2015;"SERRA BRANCA (PB)";"PB";"SERRA BRANCA";101;21;9;131
2015;"SERRA DA RAIZ (PB)";"PB";"SERRA DA RAIZ";13;1;5;19
2015;"SERRA GRANDE (PB)";"PB";"SERRA GRANDE";6;1;4;11
2015;"SERRA REDONDA (PB)";"PB";"SERRA REDONDA";24;11;4;39
2015;"SERRARIA (PB)";"PB";"SERRARIA";15;10;7;32
2015;"SERTAOZINHO (PB)";"PB";"SERTAOZINHO";12;3;11;26
2015;"SOBRADO (PB)";"PB";"SOBRADO";68;4;5;77
2015;"SOLANEA (PB)";"PB";"SOLANEA";244;35;40;319
2015;"SOLEDADE (PB)";"PB";"SOLEDADE";182;25;22;229
2015;"SOSSEGO (PB)";"PB";"SOSSEGO";33;4;6;43
2015;"SOUSA (PB)";"PB";"SOUSA";848;54;67;969
2015;"SUME (PB)";"PB";"SUME";108;31;20;159
2015;"TAPEROA (PB)";"PB";"TAPEROA";94;20;7;121
2015;"TAVARES (PB)";"PB";"TAVARES";27;13;12;52
2015;"TEIXEIRA (PB)";"PB";"TEIXEIRA";108;20;22;150
2015;"TENORIO (PB)";"PB";"TENORIO";17;0;4;21
2015;"TRIUNFO (PB)";"PB";"TRIUNFO";20;4;5;29
2015;"UIRAUNA (PB)";"PB";"UIRAUNA";82;15;6;103
2015;"UMBUZEIRO (PB)";"PB";"UMBUZEIRO";62;22;24;108
2015;"VARZEA (PB)";"PB";"VARZEA";20;5;4;29
2015;"VIEIROPOLIS (PB)";"PB";"VIEIROPOLIS";11;5;9;25
2015;"VISTA SERRANA (PB)";"PB";"VISTA SERRANA";22;0;5;27
2015;"ZABELE (PB)";"PB";"ZABELE";16;6;8;30
2015;"ABREU E LIMA (PE)";"PE";"ABREU E LIMA";580;86;424;1090
2015;"AFOGADOS DA INGAZEIRA (PE)";"PE";"AFOGADOS DA INGAZEIRA";493;84;78;655
2015;"AFRANIO (PE)";"PE";"AFRANIO";223;28;26;277
2015;"AGRESTINA (PE)";"PE";"AGRESTINA";192;45;26;263
2015;"AGUA PRETA (PE)";"PE";"AGUA PRETA";157;60;68;285
2015;"AGUAS BELAS (PE)";"PE";"AGUAS BELAS";366;75;45;486
2015;"ALAGOINHA (PE)";"PE";"ALAGOINHA";148;46;20;214
2015;"ALIANCA (PE)";"PE";"ALIANCA";182;27;132;341
2015;"ALTINHO (PE)";"PE";"ALTINHO";96;67;33;196
2015;"AMARAJI (PE)";"PE";"AMARAJI";109;25;43;177
2015;"ANGELIM (PE)";"PE";"ANGELIM";51;26;7;84
2015;"ARACOIABA (PE)";"PE";"ARACOIABA";74;12;92;178
2015;"ARARIPINA (PE)";"PE";"ARARIPINA";1160;64;67;1291
2015;"ARCOVERDE (PE)";"PE";"ARCOVERDE";1223;204;124;1551
2015;"BARRA DE GUABIRABA (PE)";"PE";"BARRA DE GUABIRABA";75;21;13;109
2015;"BARREIROS (PE)";"PE";"BARREIROS";272;36;69;377
2015;"BELEM DE MARIA (PE)";"PE";"BELEM DE MARIA";80;43;16;139
2015;"BELEM DE SAO FRANCISCO (PE)";"PE";"BELEM DE SAO FRANCISCO";114;37;21;172
2015;"BELO JARDIM (PE)";"PE";"BELO JARDIM";821;405;91;1317
2015;"BETANIA (PE)";"PE";"BETANIA";50;5;10;65
2015;"BEZERROS (PE)";"PE";"BEZERROS";859;138;86;1083
2015;"BODOCO (PE)";"PE";"BODOCO";244;4;20;268
2015;"BOM CONSELHO (PE)";"PE";"BOM CONSELHO";312;61;40;413
2015;"BOM JARDIM (PE)";"PE";"BOM JARDIM";260;335;51;646
2015;"BONITO (PE)";"PE";"BONITO";397;84;44;525
2015;"BREJAO (PE)";"PE";"BREJAO";66;21;13;100
2015;"BREJINHO (PE)";"PE";"BREJINHO";58;13;9;80
2015;"BREJO DA MADRE DE DEUS (PE)";"PE";"BREJO DA MADRE DE DEUS";343;483;19;845
2015;"BUENOS AIRES (PE)";"PE";"BUENOS AIRES";59;10;19;88
2015;"BUIQUE (PE)";"PE";"BUIQUE";275;97;48;420
2015;"CABO DE SANTO AGOSTINHO (PE)";"PE";"CABO DE SANTO AGOSTINHO";1442;278;562;2282
2015;"CABROBO (PE)";"PE";"CABROBO";250;14;31;295
2015;"CACHOEIRINHA (PE)";"PE";"CACHOEIRINHA";188;69;15;272
2015;"CAETES (PE)";"PE";"CAETES";301;70;36;407
2015;"CALCADO (PE)";"PE";"CALCADO";67;15;26;108
2015;"CALUMBI (PE)";"PE";"CALUMBI";51;9;7;67
2015;"CAMARAGIBE (PE)";"PE";"CAMARAGIBE";776;257;176;1209
2015;"CAMOCIM DE SAO FELIX (PE)";"PE";"CAMOCIM DE SAO FELIX";137;53;8;198
2015;"CAMUTANGA (PE)";"PE";"CAMUTANGA";90;1;16;107
2015;"CANHOTINHO (PE)";"PE";"CANHOTINHO";221;92;15;328
2015;"CAPOEIRAS (PE)";"PE";"CAPOEIRAS";259;49;21;329
2015;"CARNAIBA (PE)";"PE";"CARNAIBA";182;55;26;263
2015;"CARNAUBEIRA DA PENHA (PE)";"PE";"CARNAUBEIRA DA PENHA";46;12;5;63
2015;"CARPINA (PE)";"PE";"CARPINA";946;124;151;1221
2015;"CARUARU (PE)";"PE";"CARUARU";4596;860;644;6100
2015;"CASINHAS (PE)";"PE";"CASINHAS";68;143;20;231
2015;"CATENDE (PE)";"PE";"CATENDE";197;74;72;343
2015;"CEDRO (PE)";"PE";"CEDRO";47;7;11;65
2015;"CHA DE ALEGRIA (PE)";"PE";"CHA DE ALEGRIA";62;21;36;119
2015;"CHA GRANDE (PE)";"PE";"CHA GRANDE";286;67;27;380
2015;"CONDADO (PE)";"PE";"CONDADO";129;11;65;205
2015;"CORRENTES (PE)";"PE";"CORRENTES";91;32;13;136
2015;"CORTES (PE)";"PE";"CORTES";176;55;37;268
2015;"CUMARU (PE)";"PE";"CUMARU";153;95;19;267
2015;"CUPIRA (PE)";"PE";"CUPIRA";285;85;19;389
2015;"CUSTODIA (PE)";"PE";"CUSTODIA";373;77;35;485
2015;"DORMENTES (PE)";"PE";"DORMENTES";319;13;32;364
2015;"ESCADA (PE)";"PE";"ESCADA";378;103;149;630
2015;"EXU (PE)";"PE";"EXU";312;12;30;354
2015;"FEIRA NOVA (PE)";"PE";"FEIRA NOVA";253;43;15;311
2015;"FERNANDO DE NORONHA (PE)";"PE";"FERNANDO DE NORONHA";16;25;7;48
2015;"FERREIROS (PE)";"PE";"FERREIROS";87;1;47;135
2015;"FLORES (PE)";"PE";"FLORES";119;40;14;173
2015;"FLORESTA (PE)";"PE";"FLORESTA";505;22;23;550
2015;"FREI MIGUELINHO (PE)";"PE";"FREI MIGUELINHO";191;136;22;349
2015;"GAMELEIRA (PE)";"PE";"GAMELEIRA";93;16;61;170
2015;"GARANHUNS (PE)";"PE";"GARANHUNS";1763;309;157;2229
2015;"GLORIA DO GOITA (PE)";"PE";"GLORIA DO GOITA";190;57;43;290
2015;"GOIANA (PE)";"PE";"GOIANA";783;206;140;1129
2015;"GRANITO (PE)";"PE";"GRANITO";36;1;14;51
2015;"GRAVATA (PE)";"PE";"GRAVATA";976;132;92;1200
2015;"IATI (PE)";"PE";"IATI";84;38;27;149
2015;"IBIMIRIM (PE)";"PE";"IBIMIRIM";225;53;17;295
2015;"IBIRAJUBA (PE)";"PE";"IBIRAJUBA";52;13;6;71
2015;"IGARASSU (PE)";"PE";"IGARASSU";908;123;712;1743
2015;"IGUARACI (PE)";"PE";"IGUARACI";127;28;27;182
2015;"ILHA DE ITAMARACA (PE)";"PE";"ILHA DE ITAMARACA";98;18;15;131
2015;"INAJA (PE)";"PE";"INAJA";71;14;11;96
2015;"INGAZEIRA (PE)";"PE";"INGAZEIRA";31;13;6;50
2015;"IPOJUCA (PE)";"PE";"IPOJUCA";696;313;226;1235
2015;"IPUBI (PE)";"PE";"IPUBI";257;16;36;309
2015;"ITACURUBA (PE)";"PE";"ITACURUBA";29;2;7;38
2015;"ITAIBA (PE)";"PE";"ITAIBA";142;36;16;194
2015;"ITAMBE (PE)";"PE";"ITAMBE";424;40;137;601
2015;"ITAPETIM (PE)";"PE";"ITAPETIM";86;5;10;101
2015;"ITAPISSUMA (PE)";"PE";"ITAPISSUMA";115;35;31;181
2015;"ITAQUITINGA (PE)";"PE";"ITAQUITINGA";42;10;41;93
2015;"JABOATAO DOS GUARARAPES (PE)";"PE";"JABOATAO DOS GUARARAPES";5656;789;2203;8648
2015;"JAQUEIRA (PE)";"PE";"JAQUEIRA";60;6;30;96
2015;"JATAUBA (PE)";"PE";"JATAUBA";137;203;14;354
2015;"JATOBA (PE)";"PE";"JATOBA";49;23;13;85
2015;"JOAO ALFREDO (PE)";"PE";"JOAO ALFREDO";230;627;17;874
2015;"JOAQUIM NABUCO (PE)";"PE";"JOAQUIM NABUCO";86;19;51;156
2015;"JUCATI (PE)";"PE";"JUCATI";140;28;24;192
2015;"JUPI (PE)";"PE";"JUPI";216;40;38;294
2015;"JUREMA (PE)";"PE";"JUREMA";81;38;15;134
2015;"LAGOA DO CARRO (PE)";"PE";"LAGOA DO CARRO";101;14;15;130
2015;"LAGOA DO ITAENGA (PE)";"PE";"LAGOA DO ITAENGA";454;39;63;556
2015;"LAGOA DO OURO (PE)";"PE";"LAGOA DO OURO";50;31;16;97
2015;"LAGOA DOS GATOS (PE)";"PE";"LAGOA DOS GATOS";100;31;7;138
2015;"LAGOA GRANDE (PE)";"PE";"LAGOA GRANDE";160;9;18;187
2015;"LAJEDO (PE)";"PE";"LAJEDO";565;106;55;726
2015;"LIMOEIRO (PE)";"PE";"LIMOEIRO";527;140;71;738
2015;"MACAPARANA (PE)";"PE";"MACAPARANA";186;19;45;250
2015;"MACHADOS (PE)";"PE";"MACHADOS";149;36;17;202
2015;"MANARI (PE)";"PE";"MANARI";63;20;10;93
2015;"MARAIAL (PE)";"PE";"MARAIAL";127;18;23;168
2015;"MIRANDIBA (PE)";"PE";"MIRANDIBA";130;8;7;145
2015;"MOREILANDIA (PE)";"PE";"MOREILANDIA";75;5;10;90
2015;"MORENO (PE)";"PE";"MORENO";683;173;185;1041
2015;"NAZARE DA MATA (PE)";"PE";"NAZARE DA MATA";243;26;57;326
2015;"OLINDA (PE)";"PE";"OLINDA";3183;454;1426;5063
2015;"OROBO (PE)";"PE";"OROBO";205;226;68;499
2015;"OROCO (PE)";"PE";"OROCO";86;2;14;102
2015;"OURICURI (PE)";"PE";"OURICURI";703;35;106;844
2015;"PALMARES (PE)";"PE";"PALMARES";512;95;208;815
2015;"PALMEIRINA (PE)";"PE";"PALMEIRINA";23;17;7;47
2015;"PANELAS (PE)";"PE";"PANELAS";94;64;21;179
2015;"PARANATAMA (PE)";"PE";"PARANATAMA";106;33;22;161
2015;"PARNAMIRIM (PE)";"PE";"PARNAMIRIM";238;8;21;267
2015;"PASSIRA (PE)";"PE";"PASSIRA";249;119;28;396
2015;"PAUDALHO (PE)";"PE";"PAUDALHO";615;35;75;725
2015;"PAULISTA (PE)";"PE";"PAULISTA";1589;342;315;2246
2015;"PEDRA (PE)";"PE";"PEDRA";173;53;21;247
2015;"PESQUEIRA (PE)";"PE";"PESQUEIRA";784;110;135;1029
2015;"PETROLANDIA (PE)";"PE";"PETROLANDIA";318;12;70;400
2015;"PETROLINA (PE)";"PE";"PETROLINA";4189;289;484;4962
2015;"POCAO (PE)";"PE";"POCAO";64;32;13;109
2015;"POMBOS (PE)";"PE";"POMBOS";563;49;47;659
2015;"PRIMAVERA (PE)";"PE";"PRIMAVERA";81;13;36;130
2015;"QUIPAPA (PE)";"PE";"QUIPAPA";95;36;42;173
2015;"QUIXABA (PE)";"PE";"QUIXABA";49;35;11;95
2015;"RECIFE (PE)";"PE";"RECIFE";20220;2607;4173;27000
2015;"RIACHO DAS ALMAS (PE)";"PE";"RIACHO DAS ALMAS";317;88;27;432
2015;"RIBEIRAO (PE)";"PE";"RIBEIRAO";260;46;103;409
2015;"RIO FORMOSO (PE)";"PE";"RIO FORMOSO";119;35;82;236
2015;"SAIRE (PE)";"PE";"SAIRE";104;12;24;140
2015;"SALGADINHO (PE)";"PE";"SALGADINHO";19;57;5;81
2015;"SALGUEIRO (PE)";"PE";"SALGUEIRO";549;51;65;665
2015;"SALOA (PE)";"PE";"SALOA";66;37;12;115
2015;"SANHARO (PE)";"PE";"SANHARO";137;30;37;204
2015;"SANTA CRUZ (PE)";"PE";"SANTA CRUZ";183;8;26;217
2015;"SANTA CRUZ DA BAIXA VERDE (PE)";"PE";"SANTA CRUZ DA BAIXA VERDE";210;17;11;238
2015;"SANTA CRUZ DO CAPIBARIBE (PE)";"PE";"SANTA CRUZ DO CAPIBARIBE";980;423;64;1467
2015;"SANTA FILOMENA (PE)";"PE";"SANTA FILOMENA";105;2;26;133
2015;"SANTA MARIA DA BOA VISTA (PE)";"PE";"SANTA MARIA DA BOA VISTA";262;17;68;347
2015;"SANTA MARIA DO CAMBUCA (PE)";"PE";"SANTA MARIA DO CAMBUCA";196;119;29;344
2015;"SANTA TEREZINHA (PE)";"PE";"SANTA TEREZINHA";75;14;8;97
2015;"SAO BENEDITO DO SUL (PE)";"PE";"SAO BENEDITO DO SUL";31;14;16;61
2015;"SAO BENTO DO UNA (PE)";"PE";"SAO BENTO DO UNA";946;90;97;1133
2015;"SAO CAITANO (PE)";"PE";"SAO CAITANO";345;224;40;609
2015;"SAO JOAO (PE)";"PE";"SAO JOAO";113;47;21;181
2015;"SAO JOAQUIM DO MONTE (PE)";"PE";"SAO JOAQUIM DO MONTE";84;38;23;145
2015;"SAO JOSE DA COROA GRANDE (PE)";"PE";"SAO JOSE DA COROA GRANDE";72;18;31;121
2015;"SAO JOSE DO BELMONTE (PE)";"PE";"SAO JOSE DO BELMONTE";327;36;35;398
2015;"SAO JOSE DO EGITO (PE)";"PE";"SAO JOSE DO EGITO";540;62;68;670
2015;"SAO LOURENCO DA MATA (PE)";"PE";"SAO LOURENCO DA MATA";434;81;450;965
2015;"SAO VICENTE FERRER (PE)";"PE";"SAO VICENTE FERRER";183;14;20;217
2015;"SERRA TALHADA (PE)";"PE";"SERRA TALHADA";1597;112;86;1795
2015;"SERRITA (PE)";"PE";"SERRITA";128;7;17;152
2015;"SERTANIA (PE)";"PE";"SERTANIA";476;67;55;598
2015;"SIRINHAEM (PE)";"PE";"SIRINHAEM";205;26;80;311
2015;"SOLIDAO (PE)";"PE";"SOLIDAO";27;7;5;39
2015;"SURUBIM (PE)";"PE";"SURUBIM";828;727;88;1643
2015;"TABIRA (PE)";"PE";"TABIRA";281;49;38;368
2015;"TACAIMBO (PE)";"PE";"TACAIMBO";94;34;22;150
2015;"TACARATU (PE)";"PE";"TACARATU";68;40;13;121
2015;"TAMANDARE (PE)";"PE";"TAMANDARE";74;31;23;128
2015;"TAQUARITINGA DO NORTE (PE)";"PE";"TAQUARITINGA DO NORTE";299;97;33;429
2015;"TEREZINHA (PE)";"PE";"TEREZINHA";24;8;8;40
2015;"TERRA NOVA (PE)";"PE";"TERRA NOVA";89;2;12;103
2015;"TIMBAUBA (PE)";"PE";"TIMBAUBA";721;36;116;873
2015;"TORITAMA (PE)";"PE";"TORITAMA";303;89;27;419
2015;"TRACUNHAEM (PE)";"PE";"TRACUNHAEM";50;27;16;93
2015;"TRINDADE (PE)";"PE";"TRINDADE";397;44;20;461
2015;"TRIUNFO (PE)";"PE";"TRIUNFO";244;22;12;278
2015;"TUPANATINGA (PE)";"PE";"TUPANATINGA";147;50;21;218
2015;"TUPARETAMA (PE)";"PE";"TUPARETAMA";133;34;17;184
2015;"VENTUROSA (PE)";"PE";"VENTUROSA";199;44;17;260
2015;"VERDEJANTE (PE)";"PE";"VERDEJANTE";84;9;15;108
2015;"VERTENTE DO LERIO (PE)";"PE";"VERTENTE DO LERIO";88;116;17;221
2015;"VERTENTES (PE)";"PE";"VERTENTES";201;97;25;323
2015;"VICENCIA (PE)";"PE";"VICENCIA";271;15;78;364
2015;"VITORIA DE SANTO ANTAO (PE)";"PE";"VITORIA DE SANTO ANTAO";2369;160;354;2883
2015;"XEXEU (PE)";"PE";"XEXEU";75;8;41;124
2015;"ACAUA (PI)";"PI";"ACAUA";77;7;12;96
2015;"AGRICOLANDIA (PI)";"PI";"AGRICOLANDIA";16;2;7;25
2015;"AGUA BRANCA (PI)";"PI";"AGUA BRANCA";186;19;22;227
2015;"ALAGOINHA DO PIAUI (PI)";"PI";"ALAGOINHA DO PIAUI";63;5;5;73
2015;"ALEGRETE DO PIAUI (PI)";"PI";"ALEGRETE DO PIAUI";59;5;4;68
2015;"ALTO LONGA (PI)";"PI";"ALTO LONGA";52;9;23;84
2015;"ALTOS (PI)";"PI";"ALTOS";291;11;47;349
2015;"ALVORADA DO GURGUEIA (PI)";"PI";"ALVORADA DO GURGUEIA";19;3;9;31
2015;"AMARANTE (PI)";"PI";"AMARANTE";96;15;23;134
2015;"ANGICAL DO PIAUI (PI)";"PI";"ANGICAL DO PIAUI";24;3;7;34
2015;"ANISIO DE ABREU (PI)";"PI";"ANISIO DE ABREU";47;11;12;70
2015;"ANTONIO ALMEIDA (PI)";"PI";"ANTONIO ALMEIDA";29;4;6;39
2015;"AROAZES (PI)";"PI";"AROAZES";21;4;10;35
2015;"AROEIRAS DO ITAIM (PI)";"PI";"AROEIRAS DO ITAIM";12;0;12;24
2015;"ARRAIAL (PI)";"PI";"ARRAIAL";14;2;4;20
2015;"ASSUNCAO DO PIAUI (PI)";"PI";"ASSUNCAO DO PIAUI";11;0;3;14
2015;"AVELINO LOPES (PI)";"PI";"AVELINO LOPES";22;6;5;33
2015;"BAIXA GRANDE DO RIBEIRO (PI)";"PI";"BAIXA GRANDE DO RIBEIRO";99;3;19;121
2015;"BARRA D ALCANTARA (PI)";"PI";"BARRA D ALCANTARA";20;2;3;25
2015;"BARRAS (PI)";"PI";"BARRAS";156;11;72;239
2015;"BARREIRAS DO PIAUI (PI)";"PI";"BARREIRAS DO PIAUI";5;1;2;8
2015;"BARRO DURO (PI)";"PI";"BARRO DURO";44;5;5;54
2015;"BATALHA (PI)";"PI";"BATALHA";85;4;19;108
2015;"BELA VISTA DO PIAUI (PI)";"PI";"BELA VISTA DO PIAUI";14;1;6;21
2015;"BELEM DO PIAUI (PI)";"PI";"BELEM DO PIAUI";29;1;3;33
2015;"BENEDITINOS (PI)";"PI";"BENEDITINOS";36;3;14;53
2015;"BERTOLINIA (PI)";"PI";"BERTOLINIA";23;10;11;44
2015;"BETANIA DO PIAUI (PI)";"PI";"BETANIA DO PIAUI";47;9;4;60
2015;"BOA HORA (PI)";"PI";"BOA HORA";24;1;9;34
2015;"BOCAINA (PI)";"PI";"BOCAINA";11;8;4;23
2015;"BOM JESUS (PI)";"PI";"BOM JESUS";282;9;20;311
2015;"BOM PRINCIPIO DO PIAUI (PI)";"PI";"BOM PRINCIPIO DO PIAUI";11;4;10;25
2015;"BONFIM DO PIAUI (PI)";"PI";"BONFIM DO PIAUI";42;4;10;56
2015;"BOQUEIRAO DO PIAUI (PI)";"PI";"BOQUEIRAO DO PIAUI";16;1;4;21
2015;"BRASILEIRA (PI)";"PI";"BRASILEIRA";29;4;10;43
2015;"BREJO DO PIAUI (PI)";"PI";"BREJO DO PIAUI";9;5;3;17
2015;"BURITI DOS LOPES (PI)";"PI";"BURITI DOS LOPES";43;12;22;77
2015;"BURITI DOS MONTES (PI)";"PI";"BURITI DOS MONTES";15;8;6;29
2015;"CABECEIRAS DO PIAUI (PI)";"PI";"CABECEIRAS DO PIAUI";22;2;23;47
2015;"CAJAZEIRAS DO PIAUI (PI)";"PI";"CAJAZEIRAS DO PIAUI";7;0;3;10
2015;"CAJUEIRO DA PRAIA (PI)";"PI";"CAJUEIRO DA PRAIA";13;3;11;27
2015;"CALDEIRAO GRANDE DO PIAUI (PI)";"PI";"CALDEIRAO GRANDE DO PIAUI";29;9;8;46
2015;"CAMPINAS DO PIAUI (PI)";"PI";"CAMPINAS DO PIAUI";5;2;2;9
2015;"CAMPO ALEGRE DO FIDALGO (PI)";"PI";"CAMPO ALEGRE DO FIDALGO";33;4;2;39
2015;"CAMPO GRANDE DO PIAUI (PI)";"PI";"CAMPO GRANDE DO PIAUI";55;9;4;68
2015;"CAMPO LARGO DO PIAUI (PI)";"PI";"CAMPO LARGO DO PIAUI";9;1;4;14
2015;"CAMPO MAIOR (PI)";"PI";"CAMPO MAIOR";455;37;80;572
2015;"CANAVIEIRA (PI)";"PI";"CANAVIEIRA";2;1;1;4
2015;"CANTO DO BURITI (PI)";"PI";"CANTO DO BURITI";127;34;22;183
2015;"CAPITAO DE CAMPOS (PI)";"PI";"CAPITAO DE CAMPOS";39;6;13;58
2015;"CAPITAO GERVASIO OLIVEIRA (PI)";"PI";"CAPITAO GERVASIO OLIVEIRA";22;0;8;30
2015;"CARACOL (PI)";"PI";"CARACOL";58;5;6;69
2015;"CARAUBAS DO PIAUI (PI)";"PI";"CARAUBAS DO PIAUI";19;3;7;29
2015;"CARIDADE DO PIAUI (PI)";"PI";"CARIDADE DO PIAUI";18;2;5;25
2015;"CASTELO DO PIAUI (PI)";"PI";"CASTELO DO PIAUI";79;13;18;110
2015;"CAXINGO (PI)";"PI";"CAXINGO";13;1;7;21
2015;"COCAL (PI)";"PI";"COCAL";129;11;18;158
2015;"COCAL DE TELHA (PI)";"PI";"COCAL DE TELHA";11;2;4;17
2015;"COCAL DOS ALVES (PI)";"PI";"COCAL DOS ALVES";7;5;4;16
2015;"COIVARAS (PI)";"PI";"COIVARAS";12;1;8;21
2015;"COLONIA DO GURGUEIA (PI)";"PI";"COLONIA DO GURGUEIA";15;11;3;29
2015;"COLONIA DO PIAUI (PI)";"PI";"COLONIA DO PIAUI";14;7;7;28
2015;"CONCEICAO DO CANINDE (PI)";"PI";"CONCEICAO DO CANINDE";14;1;5;20
2015;"CORONEL JOSE DIAS (PI)";"PI";"CORONEL JOSE DIAS";15;6;6;27
2015;"CORRENTE (PI)";"PI";"CORRENTE";184;9;24;217
2015;"CRISTALANDIA DO PIAUI (PI)";"PI";"CRISTALANDIA DO PIAUI";10;4;4;18
2015;"CRISTINO CASTRO (PI)";"PI";"CRISTINO CASTRO";43;5;7;55
2015;"CURIMATA (PI)";"PI";"CURIMATA";41;2;6;49
2015;"CURRAIS (PI)";"PI";"CURRAIS";3;2;2;7
2015;"CURRAL NOVO DO PIAUI (PI)";"PI";"CURRAL NOVO DO PIAUI";11;5;3;19
2015;"CURRALINHOS (PI)";"PI";"CURRALINHOS";6;0;2;8
2015;"DEMERVAL LOBAO (PI)";"PI";"DEMERVAL LOBAO";69;2;25;96
2015;"DIRCEU ARCOVERDE (PI)";"PI";"DIRCEU ARCOVERDE";66;8;4;78
2015;"DOM EXPEDITO LOPES (PI)";"PI";"DOM EXPEDITO LOPES";69;9;6;84
2015;"DOM INOCENCIO (PI)";"PI";"DOM INOCENCIO";62;14;10;86
2015;"DOMINGOS MOURAO (PI)";"PI";"DOMINGOS MOURAO";4;0;5;9
2015;"ELESBAO VELOSO (PI)";"PI";"ELESBAO VELOSO";72;5;10;87
2015;"ELISEU MARTINS (PI)";"PI";"ELISEU MARTINS";14;4;3;21
2015;"ESPERANTINA (PI)";"PI";"ESPERANTINA";221;16;55;292
2015;"FARTURA DO PIAUI (PI)";"PI";"FARTURA DO PIAUI";12;9;4;25
2015;"FLORES DO PIAUI (PI)";"PI";"FLORES DO PIAUI";15;4;3;22
2015;"FLORESTA DO PIAUI (PI)";"PI";"FLORESTA DO PIAUI";10;5;4;19
2015;"FLORIANO (PI)";"PI";"FLORIANO";1151;102;79;1332
2015;"FRANCINOPOLIS (PI)";"PI";"FRANCINOPOLIS";18;8;2;28
2015;"FRANCISCO AYRES (PI)";"PI";"FRANCISCO AYRES";9;11;6;26
2015;"FRANCISCO MACEDO (PI)";"PI";"FRANCISCO MACEDO";37;10;6;53
2015;"FRANCISCO SANTOS (PI)";"PI";"FRANCISCO SANTOS";73;10;8;91
2015;"FRONTEIRAS (PI)";"PI";"FRONTEIRAS";94;18;10;122
2015;"GEMINIANO (PI)";"PI";"GEMINIANO";37;11;10;58
2015;"GILBUES (PI)";"PI";"GILBUES";9;3;9;21
2015;"GUADALUPE (PI)";"PI";"GUADALUPE";88;15;9;112
2015;"GUARIBAS (PI)";"PI";"GUARIBAS";8;0;5;13
2015;"HUGO NAPOLEAO (PI)";"PI";"HUGO NAPOLEAO";9;0;2;11
2015;"ILHA GRANDE (PI)";"PI";"ILHA GRANDE";15;7;6;28
2015;"INHUMA (PI)";"PI";"INHUMA";109;7;16;132
2015;"IPIRANGA DO PIAUI (PI)";"PI";"IPIRANGA DO PIAUI";64;11;9;84
2015;"ISAIAS COELHO (PI)";"PI";"ISAIAS COELHO";17;1;6;24
2015;"ITAINOPOLIS (PI)";"PI";"ITAINOPOLIS";53;26;21;100
2015;"ITAUEIRA (PI)";"PI";"ITAUEIRA";71;11;5;87
2015;"JACOBINA DO PIAUI (PI)";"PI";"JACOBINA DO PIAUI";68;4;1;73
2015;"JAICOS (PI)";"PI";"JAICOS";131;10;12;153
2015;"JARDIM DO MULATO (PI)";"PI";"JARDIM DO MULATO";10;2;2;14
2015;"JATOBA DO PIAUI (PI)";"PI";"JATOBA DO PIAUI";34;1;12;47
2015;"JERUMENHA (PI)";"PI";"JERUMENHA";21;1;1;23
2015;"JOAO COSTA (PI)";"PI";"JOAO COSTA";6;0;3;9
2015;"JOAQUIM PIRES (PI)";"PI";"JOAQUIM PIRES";44;2;11;57
2015;"JOCA MARQUES (PI)";"PI";"JOCA MARQUES";6;0;5;11
2015;"JOSE DE FREITAS (PI)";"PI";"JOSE DE FREITAS";120;12;46;178
2015;"JUAZEIRO DO PIAUI (PI)";"PI";"JUAZEIRO DO PIAUI";22;1;5;28
2015;"JULIO BORGES (PI)";"PI";"JULIO BORGES";4;3;5;12
2015;"JUREMA (PI)";"PI";"JUREMA";18;4;10;32
2015;"LAGOA ALEGRE (PI)";"PI";"LAGOA ALEGRE";12;2;21;35
2015;"LAGOA DE SAO FRANCISCO (PI)";"PI";"LAGOA DE SAO FRANCISCO";12;4;4;20
2015;"LAGOA DO BARRO DO PIAUI (PI)";"PI";"LAGOA DO BARRO DO PIAUI";22;6;9;37
2015;"LAGOA DO PIAUI (PI)";"PI";"LAGOA DO PIAUI";16;0;3;19
2015;"LAGOA DO SITIO (PI)";"PI";"LAGOA DO SITIO";14;1;4;19
2015;"LAGOINHA DO PIAUI (PI)";"PI";"LAGOINHA DO PIAUI";6;0;4;10
2015;"LANDRI SALES (PI)";"PI";"LANDRI SALES";17;5;1;23
2015;"LUIS CORREIA (PI)";"PI";"LUIS CORREIA";71;13;44;128
2015;"LUZILANDIA (PI)";"PI";"LUZILANDIA";83;11;22;116
2015;"MADEIRO (PI)";"PI";"MADEIRO";11;4;3;18
2015;"MANOEL EMIDIO (PI)";"PI";"MANOEL EMIDIO";16;4;6;26
2015;"MARCOLANDIA (PI)";"PI";"MARCOLANDIA";443;52;16;511
2015;"MARCOS PARENTE (PI)";"PI";"MARCOS PARENTE";11;3;2;16
2015;"MASSAPE DO PIAUI (PI)";"PI";"MASSAPE DO PIAUI";24;1;4;29
2015;"MATIAS OLIMPIO (PI)";"PI";"MATIAS OLIMPIO";34;7;8;49
2015;"MIGUEL ALVES (PI)";"PI";"MIGUEL ALVES";54;7;31;92
2015;"MIGUEL LEAO (PI)";"PI";"MIGUEL LEAO";4;0;1;5
2015;"MILTON BRANDAO (PI)";"PI";"MILTON BRANDAO";14;1;2;17
2015;"MONSENHOR GIL (PI)";"PI";"MONSENHOR GIL";35;4;8;47
2015;"MONSENHOR HIPOLITO (PI)";"PI";"MONSENHOR HIPOLITO";46;10;7;63
2015;"MONTE ALEGRE DO PIAUI (PI)";"PI";"MONTE ALEGRE DO PIAUI";18;1;4;23
2015;"MORRO CABECA NO TEMPO (PI)";"PI";"MORRO CABECA NO TEMPO";5;0;4;9
2015;"MORRO DO CHAPEU DO PIAUI (PI)";"PI";"MORRO DO CHAPEU DO PIAUI";10;1;11;22
2015;"MURICI DOS PORTELAS (PI)";"PI";"MURICI DOS PORTELAS";11;0;8;19
2015;"NAZARE DO PIAUI (PI)";"PI";"NAZARE DO PIAUI";26;17;4;47
2015;"NAZARIA (PI)";"PI";"NAZARIA";17;0;9;26
2015;"NOSSA SENHORA DE NAZARE (PI)";"PI";"NOSSA SENHORA DE NAZARE";17;4;12;33
2015;"NOSSA SENHORA DOS REMEDIOS (PI)";"PI";"NOSSA SENHORA DOS REMEDIOS";12;4;5;21
2015;"NOVA SANTA RITA (PI)";"PI";"NOVA SANTA RITA";3;7;4;14
2015;"NOVO ORIENTE DO PIAUI (PI)";"PI";"NOVO ORIENTE DO PIAUI";19;4;14;37
2015;"NOVO SANTO ANTONIO (PI)";"PI";"NOVO SANTO ANTONIO";15;1;5;21
2015;"OEIRAS (PI)";"PI";"OEIRAS";352;62;45;459
2015;"OLHO D AGUA DO PIAUI (PI)";"PI";"OLHO D AGUA DO PIAUI";6;1;3;10
2015;"PADRE MARCOS (PI)";"PI";"PADRE MARCOS";76;10;6;92
2015;"PAES LANDIM (PI)";"PI";"PAES LANDIM";7;3;2;12
2015;"PAJEU DO PIAUI (PI)";"PI";"PAJEU DO PIAUI";10;4;4;18
2015;"PALMEIRA DO PIAUI (PI)";"PI";"PALMEIRA DO PIAUI";36;3;5;44
2015;"PALMEIRAIS (PI)";"PI";"PALMEIRAIS";20;3;9;32
2015;"PAQUETA (PI)";"PI";"PAQUETA";20;7;6;33
2015;"PARNAGUA (PI)";"PI";"PARNAGUA";17;4;5;26
2015;"PARNAIBA (PI)";"PI";"PARNAIBA";1242;109;290;1641
2015;"PASSAGEM FRANCA DO PIAUI (PI)";"PI";"PASSAGEM FRANCA DO PIAUI";12;1;5;18
2015;"PATOS DO PIAUI (PI)";"PI";"PATOS DO PIAUI";27;3;9;39
2015;"PAU D ARCO DO PIAUI (PI)";"PI";"PAU D ARCO DO PIAUI";7;0;6;13
2015;"PAULISTANA (PI)";"PI";"PAULISTANA";276;37;61;374
2015;"PAVUSSU (PI)";"PI";"PAVUSSU";11;4;2;17
2015;"PEDRO II (PI)";"PI";"PEDRO II";134;35;25;194
2015;"PEDRO LAURENTINO (PI)";"PI";"PEDRO LAURENTINO";5;0;2;7
2015;"PICOS (PI)";"PI";"PICOS";1761;156;100;2017
2015;"PIMENTEIRAS (PI)";"PI";"PIMENTEIRAS";48;9;7;64
2015;"PIO IX (PI)";"PI";"PIO IX";95;11;17;123
2015;"PIRACURUCA (PI)";"PI";"PIRACURUCA";284;22;54;360
2015;"PIRIPIRI (PI)";"PI";"PIRIPIRI";403;59;162;624
2015;"PORTO (PI)";"PI";"PORTO";11;3;5;19
2015;"PORTO ALEGRE DO PIAUI (PI)";"PI";"PORTO ALEGRE DO PIAUI";10;4;2;16
2015;"PRATA DO PIAUI (PI)";"PI";"PRATA DO PIAUI";13;1;2;16
2015;"QUEIMADA NOVA (PI)";"PI";"QUEIMADA NOVA";85;6;30;121
2015;"REDENCAO DO GURGUEIA (PI)";"PI";"REDENCAO DO GURGUEIA";18;1;17;36
2015;"REGENERACAO (PI)";"PI";"REGENERACAO";90;9;16;115
2015;"RIACHO FRIO (PI)";"PI";"RIACHO FRIO";6;2;5;13
2015;"RIBEIRA DO PIAUI (PI)";"PI";"RIBEIRA DO PIAUI";7;3;2;12
2015;"RIBEIRO GONCALVES (PI)";"PI";"RIBEIRO GONCALVES";27;1;1;29
2015;"RIO GRANDE DO PIAUI (PI)";"PI";"RIO GRANDE DO PIAUI";23;10;5;38
2015;"SANTA CRUZ DO PIAUI (PI)";"PI";"SANTA CRUZ DO PIAUI";26;20;5;51
2015;"SANTA CRUZ DOS MILAGRES (PI)";"PI";"SANTA CRUZ DOS MILAGRES";6;2;3;11
2015;"SANTA FILOMENA (PI)";"PI";"SANTA FILOMENA";25;1;4;30
2015;"SANTA LUZ (PI)";"PI";"SANTA LUZ";11;1;4;16
2015;"SANTA ROSA DO PIAUI (PI)";"PI";"SANTA ROSA DO PIAUI";13;8;11;32
2015;"SANTANA DO PIAUI (PI)";"PI";"SANTANA DO PIAUI";30;13;13;56
2015;"SANTO ANTONIO DE LISBOA (PI)";"PI";"SANTO ANTONIO DE LISBOA";53;12;6;71
2015;"SANTO ANTONIO DOS MILAGRES (PI)";"PI";"SANTO ANTONIO DOS MILAGRES";3;3;2;8
2015;"SANTO INACIO DO PIAUI (PI)";"PI";"SANTO INACIO DO PIAUI";13;6;2;21
2015;"SAO BRAZ DO PIAUI (PI)";"PI";"SAO BRAZ DO PIAUI";32;3;5;40
2015;"SAO FELIX DO PIAUI (PI)";"PI";"SAO FELIX DO PIAUI";7;2;3;12
2015;"SAO FRANCISCO DE ASSIS DO PIAU (PI)";"PI";"SAO FRANCISCO DE ASSIS DO PIAU";19;8;4;31
2015;"SAO FRANCISCO DO PIAUI (PI)";"PI";"SAO FRANCISCO DO PIAUI";12;11;8;31
2015;"SAO GONCALO DO GURGUEIA (PI)";"PI";"SAO GONCALO DO GURGUEIA";3;1;1;5
2015;"SAO GONCALO DO PIAUI (PI)";"PI";"SAO GONCALO DO PIAUI";16;3;5;24
2015;"SAO JOAO DA CANABRAVA (PI)";"PI";"SAO JOAO DA CANABRAVA";21;11;5;37
2015;"SAO JOAO DA FRONTEIRA (PI)";"PI";"SAO JOAO DA FRONTEIRA";5;2;7;14
2015;"SAO JOAO DA SERRA (PI)";"PI";"SAO JOAO DA SERRA";19;0;2;21
2015;"SAO JOAO DA VARJOTA (PI)";"PI";"SAO JOAO DA VARJOTA";5;7;5;17
2015;"SAO JOAO DO ARRAIAL (PI)";"PI";"SAO JOAO DO ARRAIAL";13;4;7;24
2015;"SAO JOAO DO PIAUI (PI)";"PI";"SAO JOAO DO PIAUI";124;23;19;166
2015;"SAO JOSE DO DIVINO (PI)";"PI";"SAO JOSE DO DIVINO";23;4;4;31
2015;"SAO JOSE DO PEIXE (PI)";"PI";"SAO JOSE DO PEIXE";9;0;4;13
2015;"SAO JOSE DO PIAUI (PI)";"PI";"SAO JOSE DO PIAUI";37;9;9;55
2015;"SAO JULIAO (PI)";"PI";"SAO JULIAO";38;8;5;51
2015;"SAO LOURENCO DO PIAUI (PI)";"PI";"SAO LOURENCO DO PIAUI";9;6;6;21
2015;"SAO LUIS DO PIAUI (PI)";"PI";"SAO LUIS DO PIAUI";13;3;2;18
2015;"SAO MIGUEL DA BAIXA GRANDE (PI)";"PI";"SAO MIGUEL DA BAIXA GRANDE";10;3;4;17
2015;"SAO MIGUEL DO FIDALGO (PI)";"PI";"SAO MIGUEL DO FIDALGO";6;2;3;11
2015;"SAO MIGUEL DO TAPUIO (PI)";"PI";"SAO MIGUEL DO TAPUIO";39;5;19;63
2015;"SAO PEDRO DO PIAUI (PI)";"PI";"SAO PEDRO DO PIAUI";52;5;9;66
2015;"SAO RAIMUNDO NONATO (PI)";"PI";"SAO RAIMUNDO NONATO";426;89;53;568
2015;"SEBASTIAO BARROS (PI)";"PI";"SEBASTIAO BARROS";4;2;2;8
2015;"SEBASTIAO LEAL (PI)";"PI";"SEBASTIAO LEAL";32;2;3;37
2015;"SIGEFREDO PACHECO (PI)";"PI";"SIGEFREDO PACHECO";37;6;9;52
2015;"SIMOES (PI)";"PI";"SIMOES";91;13;13;117
2015;"SIMPLICIO MENDES (PI)";"PI";"SIMPLICIO MENDES";78;15;11;104
2015;"SOCORRO DO PIAUI (PI)";"PI";"SOCORRO DO PIAUI";8;2;3;13
2015;"SUSSUAPARA (PI)";"PI";"SUSSUAPARA";55;19;6;80
2015;"TAMBORIL DO PIAUI (PI)";"PI";"TAMBORIL DO PIAUI";6;2;1;9
2015;"TANQUE DO PIAUI (PI)";"PI";"TANQUE DO PIAUI";15;4;4;23
2015;"TERESINA (PI)";"PI";"TERESINA";11334;1149;3277;15760
2015;"UNIAO (PI)";"PI";"UNIAO";164;41;58;263
2015;"URUCUI (PI)";"PI";"URUCUI";177;11;24;212
2015;"VALENCA DO PIAUI (PI)";"PI";"VALENCA DO PIAUI";160;35;34;229
2015;"VARZEA BRANCA (PI)";"PI";"VARZEA BRANCA";30;5;13;48
2015;"VARZEA GRANDE (PI)";"PI";"VARZEA GRANDE";12;5;3;20
2015;"VERA MENDES (PI)";"PI";"VERA MENDES";17;6;4;27
2015;"VILA NOVA DO PIAUI (PI)";"PI";"VILA NOVA DO PIAUI";21;8;5;34
2015;"WALL FERRAZ (PI)";"PI";"WALL FERRAZ";14;13;8;35
2015;"ABATIA (PR)";"PR";"ABATIA";157;6;49;212
2015;"ADRIANOPOLIS (PR)";"PR";"ADRIANOPOLIS";130;10;23;163
2015;"AGUDOS DO SUL (PR)";"PR";"AGUDOS DO SUL";399;12;30;441
2015;"ALMIRANTE TAMANDARE (PR)";"PR";"ALMIRANTE TAMANDARE";1608;100;239;1947
2015;"ALTAMIRA DO PARANA (PR)";"PR";"ALTAMIRA DO PARANA";51;3;15;69
2015;"ALTO PARAISO (PR)";"PR";"ALTO PARAISO";60;10;14;84
2015;"ALTO PARANA (PR)";"PR";"ALTO PARANA";301;19;88;408
2015;"ALTO PIQUIRI (PR)";"PR";"ALTO PIQUIRI";197;9;46;252
2015;"ALTONIA (PR)";"PR";"ALTONIA";482;30;53;565
2015;"ALVORADA DO SUL (PR)";"PR";"ALVORADA DO SUL";329;11;58;398
2015;"AMAPORA (PR)";"PR";"AMAPORA";73;4;53;130
2015;"AMPERE (PR)";"PR";"AMPERE";524;19;41;584
2015;"ANAHY (PR)";"PR";"ANAHY";95;2;6;103
2015;"ANDIRA (PR)";"PR";"ANDIRA";613;18;86;717
2015;"ANGULO (PR)";"PR";"ANGULO";79;3;12;94
2015;"ANTONINA (PR)";"PR";"ANTONINA";111;16;48;175
2015;"ANTONIO OLINTO (PR)";"PR";"ANTONIO OLINTO";205;8;37;250
2015;"APUCARANA (PR)";"PR";"APUCARANA";2629;381;332;3342
2015;"ARAPONGAS (PR)";"PR";"ARAPONGAS";3459;258;188;3905
2015;"ARAPOTI (PR)";"PR";"ARAPOTI";661;36;78;775
2015;"ARAPUA (PR)";"PR";"ARAPUA";118;7;29;154
2015;"ARARUNA (PR)";"PR";"ARARUNA";426;25;35;486
2015;"ARAUCARIA (PR)";"PR";"ARAUCARIA";2938;368;639;3945
2015;"ARIRANHA DO IVAI (PR)";"PR";"ARIRANHA DO IVAI";67;2;19;88
2015;"ASSAI (PR)";"PR";"ASSAI";503;26;46;575
2015;"ASSIS CHATEAUBRIAND (PR)";"PR";"ASSIS CHATEAUBRIAND";1270;58;72;1400
2015;"ASTORGA (PR)";"PR";"ASTORGA";732;45;108;885
2015;"ATALAIA (PR)";"PR";"ATALAIA";121;10;32;163
2015;"BALSA NOVA (PR)";"PR";"BALSA NOVA";432;22;97;551
2015;"BANDEIRANTES (PR)";"PR";"BANDEIRANTES";863;65;116;1044
2015;"BARBOSA FERRAZ (PR)";"PR";"BARBOSA FERRAZ";222;6;41;269
2015;"BARRA DO JACARE (PR)";"PR";"BARRA DO JACARE";57;7;11;75
2015;"BARRACAO (PR)";"PR";"BARRACAO";271;26;42;339
2015;"BELA VISTA DO CAROBA (PR)";"PR";"BELA VISTA DO CAROBA";66;4;20;90
2015;"BELA VISTA DO PARAISO (PR)";"PR";"BELA VISTA DO PARAISO";450;31;62;543
2015;"BITURUNA (PR)";"PR";"BITURUNA";494;27;174;695
2015;"BOA ESPERANCA (PR)";"PR";"BOA ESPERANCA";202;8;16;226
2015;"BOA ESPERANCA DO IGUACU (PR)";"PR";"BOA ESPERANCA DO IGUACU";74;4;15;93
2015;"BOA VENTURA DE SAO ROQUE (PR)";"PR";"BOA VENTURA DE SAO ROQUE";210;14;41;265
2015;"BOA VISTA DA APARECIDA (PR)";"PR";"BOA VISTA DA APARECIDA";187;17;26;230
2015;"BOCAIUVA DO SUL (PR)";"PR";"BOCAIUVA DO SUL";337;17;24;378
2015;"BOM JESUS DO SUL (PR)";"PR";"BOM JESUS DO SUL";52;7;15;74
2015;"BOM SUCESSO (PR)";"PR";"BOM SUCESSO";131;12;68;211
2015;"BOM SUCESSO DO SUL (PR)";"PR";"BOM SUCESSO DO SUL";126;10;13;149
2015;"BORRAZOPOLIS (PR)";"PR";"BORRAZOPOLIS";308;6;16;330
2015;"BRAGANEY (PR)";"PR";"BRAGANEY";198;6;24;228
2015;"BRASILANDIA DO SUL (PR)";"PR";"BRASILANDIA DO SUL";90;6;10;106
2015;"CAFEARA (PR)";"PR";"CAFEARA";48;7;18;73
2015;"CAFELANDIA (PR)";"PR";"CAFELANDIA";679;54;77;810
2015;"CAFEZAL DO SUL (PR)";"PR";"CAFEZAL DO SUL";97;4;28;129
2015;"CALIFORNIA (PR)";"PR";"CALIFORNIA";295;12;23;330
2015;"CAMBARA (PR)";"PR";"CAMBARA";832;43;100;975
2015;"CAMBE (PR)";"PR";"CAMBE";2065;293;158;2516
2015;"CAMBIRA (PR)";"PR";"CAMBIRA";299;5;25;329
2015;"CAMPINA DA LAGOA (PR)";"PR";"CAMPINA DA LAGOA";454;27;47;528
2015;"CAMPINA DO SIMAO (PR)";"PR";"CAMPINA DO SIMAO";101;3;32;136
2015;"CAMPINA GRANDE DO SUL (PR)";"PR";"CAMPINA GRANDE DO SUL";955;104;87;1146
2015;"CAMPO BONITO (PR)";"PR";"CAMPO BONITO";113;12;18;143
2015;"CAMPO DO TENENTE (PR)";"PR";"CAMPO DO TENENTE";173;13;49;235
2015;"CAMPO LARGO (PR)";"PR";"CAMPO LARGO";2501;341;476;3318
2015;"CAMPO MAGRO (PR)";"PR";"CAMPO MAGRO";565;88;31;684
2015;"CAMPO MOURAO (PR)";"PR";"CAMPO MOURAO";2515;142;609;3266
2015;"CANDIDO DE ABREU (PR)";"PR";"CANDIDO DE ABREU";279;11;57;347
2015;"CANDOI (PR)";"PR";"CANDOI";450;11;123;584
2015;"CANTAGALO (PR)";"PR";"CANTAGALO";287;10;51;348
2015;"CAPANEMA (PR)";"PR";"CAPANEMA";497;16;70;583
2015;"CAPITAO LEONIDAS MARQUES (PR)";"PR";"CAPITAO LEONIDAS MARQUES";619;26;61;706
2015;"CARAMBEI (PR)";"PR";"CARAMBEI";695;70;72;837
2015;"CARLOPOLIS (PR)";"PR";"CARLOPOLIS";310;25;69;404
2015;"CASCAVEL (PR)";"PR";"CASCAVEL";8300;459;1044;9803
2015;"CASTRO (PR)";"PR";"CASTRO";2029;249;333;2611
2015;"CATANDUVAS (PR)";"PR";"CATANDUVAS";227;14;38;279
2015;"CENTENARIO DO SUL (PR)";"PR";"CENTENARIO DO SUL";153;31;75;259
2015;"CERRO AZUL (PR)";"PR";"CERRO AZUL";501;18;70;589
2015;"CEU AZUL (PR)";"PR";"CEU AZUL";361;15;50;426
2015;"CHOPINZINHO (PR)";"PR";"CHOPINZINHO";653;30;94;777
2015;"CIANORTE (PR)";"PR";"CIANORTE";1721;98;254;2073
2015;"CIDADE GAUCHA (PR)";"PR";"CIDADE GAUCHA";314;23;86;423
2015;"CLEVELANDIA (PR)";"PR";"CLEVELANDIA";590;45;53;688
2015;"COLOMBO (PR)";"PR";"COLOMBO";4432;350;555;5337
2015;"COLORADO (PR)";"PR";"COLORADO";614;41;185;840
2015;"CONGONHINHAS (PR)";"PR";"CONGONHINHAS";140;6;42;188
2015;"CONSELHEIRO MAIRINCK (PR)";"PR";"CONSELHEIRO MAIRINCK";56;4;9;69
2015;"CONTENDA (PR)";"PR";"CONTENDA";782;20;56;858
2015;"CORBELIA (PR)";"PR";"CORBELIA";792;26;67;885
2015;"CORNELIO PROCOPIO (PR)";"PR";"CORNELIO PROCOPIO";1109;125;156;1390
2015;"CORONEL DOMINGOS SOARES (PR)";"PR";"CORONEL DOMINGOS SOARES";173;9;31;213
2015;"CORONEL VIVIDA (PR)";"PR";"CORONEL VIVIDA";757;32;114;903
2015;"CORUMBATAI DO SUL (PR)";"PR";"CORUMBATAI DO SUL";72;2;29;103
2015;"CRUZ MACHADO (PR)";"PR";"CRUZ MACHADO";655;16;105;776
2015;"CRUZEIRO DO IGUACU (PR)";"PR";"CRUZEIRO DO IGUACU";92;5;22;119
2015;"CRUZEIRO DO OESTE (PR)";"PR";"CRUZEIRO DO OESTE";532;21;83;636
2015;"CRUZEIRO DO SUL (PR)";"PR";"CRUZEIRO DO SUL";91;7;26;124
2015;"CRUZMALTINA (PR)";"PR";"CRUZMALTINA";94;4;12;110
2015;"CURITIBA (PR)";"PR";"CURITIBA";40019;4213;7283;51515
2015;"CURIUVA (PR)";"PR";"CURIUVA";275;18;84;377
2015;"DIAMANTE D OESTE (PR)";"PR";"DIAMANTE D OESTE";87;9;30;126
2015;"DIAMANTE DO NORTE (PR)";"PR";"DIAMANTE DO NORTE";76;7;31;114
2015;"DIAMANTE DO SUL (PR)";"PR";"DIAMANTE DO SUL";45;4;10;59
2015;"DOIS VIZINHOS (PR)";"PR";"DOIS VIZINHOS";1214;101;120;1435
2015;"DOURADINA (PR)";"PR";"DOURADINA";423;11;22;456
2015;"DOUTOR CAMARGO (PR)";"PR";"DOUTOR CAMARGO";183;3;64;250
2015;"DOUTOR ULYSSES (PR)";"PR";"DOUTOR ULYSSES";72;4;24;100
2015;"ENEAS MARQUES (PR)";"PR";"ENEAS MARQUES";198;7;29;234
2015;"ENGENHEIRO BELTRAO (PR)";"PR";"ENGENHEIRO BELTRAO";524;21;97;642
2015;"ENTRE RIOS DO OESTE (PR)";"PR";"ENTRE RIOS DO OESTE";144;6;12;162
2015;"ESPERANCA NOVA (PR)";"PR";"ESPERANCA NOVA";38;4;7;49
2015;"ESPIGAO ALTO DO IGUACU (PR)";"PR";"ESPIGAO ALTO DO IGUACU";84;10;12;106
2015;"FAROL (PR)";"PR";"FAROL";105;1;14;120
2015;"FAXINAL (PR)";"PR";"FAXINAL";466;18;42;526
2015;"FAZENDA RIO GRANDE (PR)";"PR";"FAZENDA RIO GRANDE";1314;72;261;1647
2015;"FENIX (PR)";"PR";"FENIX";127;3;19;149
2015;"FERNANDES PINHEIRO (PR)";"PR";"FERNANDES PINHEIRO";117;8;29;154
2015;"FIGUEIRA (PR)";"PR";"FIGUEIRA";151;14;37;202
2015;"FLOR DA SERRA DO SUL (PR)";"PR";"FLOR DA SERRA DO SUL";118;4;29;151
2015;"FLORAI (PR)";"PR";"FLORAI";171;7;25;203
2015;"FLORESTA (PR)";"PR";"FLORESTA";284;22;29;335
2015;"FLORESTOPOLIS (PR)";"PR";"FLORESTOPOLIS";194;29;111;334
2015;"FLORIDA (PR)";"PR";"FLORIDA";72;6;26;104
2015;"FORMOSA DO OESTE (PR)";"PR";"FORMOSA DO OESTE";272;12;24;308
2015;"FOZ DO IGUACU (PR)";"PR";"FOZ DO IGUACU";3595;1178;1289;6062
2015;"FOZ DO JORDAO (PR)";"PR";"FOZ DO JORDAO";82;6;21;109
2015;"FRANCISCO ALVES (PR)";"PR";"FRANCISCO ALVES";185;6;28;219
2015;"FRANCISCO BELTRAO (PR)";"PR";"FRANCISCO BELTRAO";2257;172;239;2668
2015;"GENERAL CARNEIRO (PR)";"PR";"GENERAL CARNEIRO";441;27;82;550
2015;"GODOY MOREIRA (PR)";"PR";"GODOY MOREIRA";62;4;12;78
2015;"GOIOERE (PR)";"PR";"GOIOERE";673;50;56;779
2015;"GOIOXIM (PR)";"PR";"GOIOXIM";131;13;38;182
2015;"GRANDES RIOS (PR)";"PR";"GRANDES RIOS";116;11;17;144
2015;"GUAIRA (PR)";"PR";"GUAIRA";1142;39;371;1552
2015;"GUAIRACA (PR)";"PR";"GUAIRACA";142;12;40;194
2015;"GUAMIRANGA (PR)";"PR";"GUAMIRANGA";189;13;41;243
2015;"GUAPIRAMA (PR)";"PR";"GUAPIRAMA";123;5;20;148
2015;"GUAPOREMA (PR)";"PR";"GUAPOREMA";51;3;9;63
2015;"GUARACI (PR)";"PR";"GUARACI";123;6;39;168
2015;"GUARANIACU (PR)";"PR";"GUARANIACU";461;35;52;548
2015;"GUARAPUAVA (PR)";"PR";"GUARAPUAVA";4854;551;499;5904
2015;"GUARAQUECABA (PR)";"PR";"GUARAQUECABA";34;3;14;51
2015;"GUARATUBA (PR)";"PR";"GUARATUBA";451;35;59;545
2015;"HONORIO SERPA (PR)";"PR";"HONORIO SERPA";130;6;39;175
2015;"IBAITI (PR)";"PR";"IBAITI";611;49;166;826
2015;"IBEMA (PR)";"PR";"IBEMA";169;14;16;199
2015;"IBIPORA (PR)";"PR";"IBIPORA";1145;74;171;1390
2015;"ICARAIMA (PR)";"PR";"ICARAIMA";174;16;40;230
2015;"IGUARACU (PR)";"PR";"IGUARACU";103;9;12;124
2015;"IGUATU (PR)";"PR";"IGUATU";57;3;7;67
2015;"IMBAU (PR)";"PR";"IMBAU";248;21;34;303
2015;"IMBITUVA (PR)";"PR";"IMBITUVA";852;46;68;966
2015;"INACIO MARTINS (PR)";"PR";"INACIO MARTINS";286;32;45;363
2015;"INAJA (PR)";"PR";"INAJA";34;5;19;58
2015;"INDIANOPOLIS (PR)";"PR";"INDIANOPOLIS";224;3;13;240
2015;"IPIRANGA (PR)";"PR";"IPIRANGA";366;29;75;470
2015;"IPORA (PR)";"PR";"IPORA";414;11;44;469
2015;"IRACEMA DO OESTE (PR)";"PR";"IRACEMA DO OESTE";75;5;9;89
2015;"IRATI (PR)";"PR";"IRATI";1682;112;155;1949
2015;"IRETAMA (PR)";"PR";"IRETAMA";230;4;44;278
2015;"ITAGUAJE (PR)";"PR";"ITAGUAJE";77;12;31;120
2015;"ITAIPULANDIA (PR)";"PR";"ITAIPULANDIA";239;30;44;313
2015;"ITAMBARACA (PR)";"PR";"ITAMBARACA";171;12;29;212
2015;"ITAMBE (PR)";"PR";"ITAMBE";192;8;34;234
2015;"ITAPEJARA D OESTE (PR)";"PR";"ITAPEJARA D OESTE";357;12;42;411
2015;"ITAPERUCU (PR)";"PR";"ITAPERUCU";639;79;91;809
2015;"ITAUNA DO SUL (PR)";"PR";"ITAUNA DO SUL";53;4;11;68
2015;"IVAI (PR)";"PR";"IVAI";354;13;42;409
2015;"IVAIPORA (PR)";"PR";"IVAIPORA";942;40;100;1082
2015;"IVATE (PR)";"PR";"IVATE";222;11;70;303
2015;"IVATUBA (PR)";"PR";"IVATUBA";62;4;10;76
2015;"JABOTI (PR)";"PR";"JABOTI";87;9;18;114
2015;"JACAREZINHO (PR)";"PR";"JACAREZINHO";612;119;157;888
2015;"JAGUAPITA (PR)";"PR";"JAGUAPITA";392;36;80;508
2015;"JAGUARIAIVA (PR)";"PR";"JAGUARIAIVA";841;69;136;1046
2015;"JANDAIA DO SUL (PR)";"PR";"JANDAIA DO SUL";674;43;81;798
2015;"JANIOPOLIS (PR)";"PR";"JANIOPOLIS";161;7;30;198
2015;"JAPIRA (PR)";"PR";"JAPIRA";62;5;23;90
2015;"JAPURA (PR)";"PR";"JAPURA";321;9;27;357
2015;"JARDIM ALEGRE (PR)";"PR";"JARDIM ALEGRE";267;8;39;314
2015;"JARDIM OLINDA (PR)";"PR";"JARDIM OLINDA";38;3;9;50
2015;"JATAIZINHO (PR)";"PR";"JATAIZINHO";383;27;28;438
2015;"JESUITAS (PR)";"PR";"JESUITAS";317;21;34;372
2015;"JOAQUIM TAVORA (PR)";"PR";"JOAQUIM TAVORA";280;19;38;337
2015;"JUNDIAI DO SUL (PR)";"PR";"JUNDIAI DO SUL";37;4;24;65
2015;"JURANDA (PR)";"PR";"JURANDA";322;4;13;339
2015;"JUSSARA (PR)";"PR";"JUSSARA";181;7;40;228
2015;"KALORE (PR)";"PR";"KALORE";166;18;23;207
2015;"LAPA (PR)";"PR";"LAPA";1309;134;202;1645
2015;"LARANJAL (PR)";"PR";"LARANJAL";68;7;21;96
2015;"LARANJEIRAS DO SUL (PR)";"PR";"LARANJEIRAS DO SUL";851;47;94;992
2015;"LEOPOLIS (PR)";"PR";"LEOPOLIS";91;6;9;106
2015;"LIDIANOPOLIS (PR)";"PR";"LIDIANOPOLIS";112;7;24;143
2015;"LINDOESTE (PR)";"PR";"LINDOESTE";117;9;34;160
2015;"LOANDA (PR)";"PR";"LOANDA";447;22;60;529
2015;"LOBATO (PR)";"PR";"LOBATO";159;6;32;197
2015;"LONDRINA (PR)";"PR";"LONDRINA";9442;845;2089;12376
2015;"LUIZIANA (PR)";"PR";"LUIZIANA";190;8;22;220
2015;"LUNARDELLI (PR)";"PR";"LUNARDELLI";102;11;12;125
2015;"LUPIONOPOLIS (PR)";"PR";"LUPIONOPOLIS";113;27;81;221
2015;"MALLET (PR)";"PR";"MALLET";429;18;60;507
2015;"MAMBORE (PR)";"PR";"MAMBORE";621;9;49;679
2015;"MANDAGUACU (PR)";"PR";"MANDAGUACU";512;29;59;600
2015;"MANDAGUARI (PR)";"PR";"MANDAGUARI";855;52;79;986
2015;"MANDIRITUBA (PR)";"PR";"MANDIRITUBA";1119;47;80;1246
2015;"MANFRINOPOLIS (PR)";"PR";"MANFRINOPOLIS";45;5;22;72
2015;"MANGUEIRINHA (PR)";"PR";"MANGUEIRINHA";541;33;74;648
2015;"MANOEL RIBAS (PR)";"PR";"MANOEL RIBAS";399;16;36;451
2015;"MARECHAL CANDIDO RONDON (PR)";"PR";"MARECHAL CANDIDO RONDON";1587;92;202;1881
2015;"MARIA HELENA (PR)";"PR";"MARIA HELENA";130;9;30;169
2015;"MARIALVA (PR)";"PR";"MARIALVA";962;62;98;1122
2015;"MARILANDIA DO SUL (PR)";"PR";"MARILANDIA DO SUL";274;16;27;317
2015;"MARILENA (PR)";"PR";"MARILENA";123;7;31;161
2015;"MARILUZ (PR)";"PR";"MARILUZ";203;16;77;296
2015;"MARINGA (PR)";"PR";"MARINGA";10045;568;948;11561
2015;"MARIOPOLIS (PR)";"PR";"MARIOPOLIS";258;20;39;317
2015;"MARIPA (PR)";"PR";"MARIPA";334;11;14;359
2015;"MARMELEIRO (PR)";"PR";"MARMELEIRO";397;31;55;483
2015;"MARQUINHO (PR)";"PR";"MARQUINHO";70;4;19;93
2015;"MARUMBI (PR)";"PR";"MARUMBI";107;10;24;141
2015;"MATELANDIA (PR)";"PR";"MATELANDIA";673;15;75;763
2015;"MATINHOS (PR)";"PR";"MATINHOS";382;41;35;458
2015;"MATO RICO (PR)";"PR";"MATO RICO";71;4;10;85
2015;"MAUA DA SERRA (PR)";"PR";"MAUA DA SERRA";244;7;25;276
2015;"MEDIANEIRA (PR)";"PR";"MEDIANEIRA";1406;65;120;1591
2015;"MERCEDES (PR)";"PR";"MERCEDES";257;7;31;295
2015;"MIRADOR (PR)";"PR";"MIRADOR";19;2;9;30
2015;"MIRASELVA (PR)";"PR";"MIRASELVA";38;6;30;74
2015;"MISSAL (PR)";"PR";"MISSAL";381;29;41;451
2015;"MOREIRA SALES (PR)";"PR";"MOREIRA SALES";308;16;98;422
2015;"MORRETES (PR)";"PR";"MORRETES";235;26;41;302
2015;"MUNHOZ DE MELLO (PR)";"PR";"MUNHOZ DE MELLO";77;5;7;89
2015;"NOSSA SENHORA DAS GRACAS (PR)";"PR";"NOSSA SENHORA DAS GRACAS";44;12;38;94
2015;"NOVA ALIANCA DO IVAI (PR)";"PR";"NOVA ALIANCA DO IVAI";28;5;8;41
2015;"NOVA AMERICA DA COLINA (PR)";"PR";"NOVA AMERICA DA COLINA";115;6;21;142
2015;"NOVA AURORA (PR)";"PR";"NOVA AURORA";476;12;49;537
2015;"NOVA CANTU (PR)";"PR";"NOVA CANTU";149;1;28;178
2015;"NOVA ESPERANCA (PR)";"PR";"NOVA ESPERANCA";865;46;78;989
2015;"NOVA ESPERANCA DO SUDOESTE (PR)";"PR";"NOVA ESPERANCA DO SUDOESTE";162;14;32;208
2015;"NOVA FATIMA (PR)";"PR";"NOVA FATIMA";302;4;47;353
2015;"NOVA LARANJEIRAS (PR)";"PR";"NOVA LARANJEIRAS";197;11;33;241
2015;"NOVA LONDRINA (PR)";"PR";"NOVA LONDRINA";404;18;56;478
2015;"NOVA OLIMPIA (PR)";"PR";"NOVA OLIMPIA";125;11;22;158
2015;"NOVA PRATA DO IGUACU (PR)";"PR";"NOVA PRATA DO IGUACU";354;14;33;401
2015;"NOVA SANTA BARBARA (PR)";"PR";"NOVA SANTA BARBARA";139;12;9;160
2015;"NOVA SANTA ROSA (PR)";"PR";"NOVA SANTA ROSA";417;13;19;449
2015;"NOVA TEBAS (PR)";"PR";"NOVA TEBAS";150;8;30;188
2015;"NOVO ITACOLOMI (PR)";"PR";"NOVO ITACOLOMI";102;3;10;115
2015;"ORTIGUEIRA (PR)";"PR";"ORTIGUEIRA";465;39;91;595
2015;"OURIZONA (PR)";"PR";"OURIZONA";98;4;20;122
2015;"OURO VERDE DO OESTE (PR)";"PR";"OURO VERDE DO OESTE";166;6;13;185
2015;"PAICANDU (PR)";"PR";"PAICANDU";576;36;60;672
2015;"PALMAS (PR)";"PR";"PALMAS";1001;82;112;1195
2015;"PALMEIRA (PR)";"PR";"PALMEIRA";1045;60;96;1201
2015;"PALMITAL (PR)";"PR";"PALMITAL";308;17;59;384
2015;"PALOTINA (PR)";"PR";"PALOTINA";1334;59;166;1559
2015;"PARAISO DO NORTE (PR)";"PR";"PARAISO DO NORTE";292;17;69;378
2015;"PARANACITY (PR)";"PR";"PARANACITY";298;24;54;376
2015;"PARANAGUA (PR)";"PR";"PARANAGUA";1968;183;198;2349
2015;"PARANAPOEMA (PR)";"PR";"PARANAPOEMA";67;8;20;95
2015;"PARANAVAI (PR)";"PR";"PARANAVAI";2137;134;268;2539
2015;"PATO BRAGADO (PR)";"PR";"PATO BRAGADO";175;7;18;200
2015;"PATO BRANCO (PR)";"PR";"PATO BRANCO";2365;169;442;2976
2015;"PAULA FREITAS (PR)";"PR";"PAULA FREITAS";164;8;25;197
2015;"PAULO FRONTIN (PR)";"PR";"PAULO FRONTIN";273;6;27;306
2015;"PEABIRU (PR)";"PR";"PEABIRU";346;18;29;393
2015;"PEROBAL (PR)";"PR";"PEROBAL";116;6;34;156
2015;"PEROLA (PR)";"PR";"PEROLA";235;15;19;269
2015;"PEROLA D OESTE (PR)";"PR";"PEROLA D OESTE";229;6;28;263
2015;"PIEN (PR)";"PR";"PIEN";433;26;31;490
2015;"PINHAIS (PR)";"PR";"PINHAIS";2383;265;466;3114
2015;"PINHAL DO SAO BENTO (PR)";"PR";"PINHAL DO SAO BENTO";51;4;20;75
2015;"PINHALAO (PR)";"PR";"PINHALAO";121;10;20;151
2015;"PINHAO (PR)";"PR";"PINHAO";622;52;122;796
2015;"PIRAI DO SUL (PR)";"PR";"PIRAI DO SUL";522;53;112;687
2015;"PIRAQUARA (PR)";"PR";"PIRAQUARA";698;111;220;1029
2015;"PITANGA (PR)";"PR";"PITANGA";979;40;132;1151
2015;"PITANGUEIRAS (PR)";"PR";"PITANGUEIRAS";64;4;30;98
2015;"PLANALTINA DO PARANA (PR)";"PR";"PLANALTINA DO PARANA";114;5;25;144
2015;"PLANALTO (PR)";"PR";"PLANALTO";383;18;40;441
2015;"PONTA GROSSA (PR)";"PR";"PONTA GROSSA";6559;731;1180;8470
2015;"PONTAL DO PARANA (PR)";"PR";"PONTAL DO PARANA";318;28;53;399
2015;"PORECATU (PR)";"PR";"PORECATU";300;39;162;501
2015;"PORTO AMAZONAS (PR)";"PR";"PORTO AMAZONAS";85;12;14;111
2015;"PORTO BARREIRO (PR)";"PR";"PORTO BARREIRO";84;7;29;120
2015;"PORTO RICO (PR)";"PR";"PORTO RICO";36;1;8;45
2015;"PORTO VITORIA (PR)";"PR";"PORTO VITORIA";175;4;13;192
2015;"PRADO FERREIRA (PR)";"PR";"PRADO FERREIRA";102;3;13;118
2015;"PRANCHITA (PR)";"PR";"PRANCHITA";272;11;18;301
2015;"PRESIDENTE CASTELO BRANCO (PR)";"PR";"PRESIDENTE CASTELO BRANCO";127;9;26;162
2015;"PRIMEIRO DE MAIO (PR)";"PR";"PRIMEIRO DE MAIO";340;17;31;388
2015;"PRUDENTOPOLIS (PR)";"PR";"PRUDENTOPOLIS";1427;69;145;1641
2015;"QUARTO CENTENARIO (PR)";"PR";"QUARTO CENTENARIO";131;5;8;144
2015;"QUATIGUA (PR)";"PR";"QUATIGUA";379;12;21;412
2015;"QUATRO BARRAS (PR)";"PR";"QUATRO BARRAS";666;48;125;839
2015;"QUATRO PONTES (PR)";"PR";"QUATRO PONTES";197;5;9;211
2015;"QUEDAS DO IGUACU (PR)";"PR";"QUEDAS DO IGUACU";798;38;166;1002
2015;"QUERENCIA DO NORTE (PR)";"PR";"QUERENCIA DO NORTE";245;7;38;290
2015;"QUINTA DO SOL (PR)";"PR";"QUINTA DO SOL";129;3;22;154
2015;"QUITANDINHA (PR)";"PR";"QUITANDINHA";517;9;85;611
2015;"RAMILANDIA (PR)";"PR";"RAMILANDIA";61;4;16;81
2015;"RANCHO ALEGRE (PR)";"PR";"RANCHO ALEGRE";118;7;17;142
2015;"RANCHO ALEGRE D OESTE (PR)";"PR";"RANCHO ALEGRE D OESTE";89;3;12;104
2015;"REALEZA (PR)";"PR";"REALEZA";654;25;47;726
2015;"REBOUCAS (PR)";"PR";"REBOUCAS";304;23;57;384
2015;"RENASCENCA (PR)";"PR";"RENASCENCA";277;12;36;325
2015;"RESERVA (PR)";"PR";"RESERVA";667;35;102;804
2015;"RESERVA DO IGUACU (PR)";"PR";"RESERVA DO IGUACU";93;11;19;123
2015;"RIBEIRAO CLARO (PR)";"PR";"RIBEIRAO CLARO";227;39;37;303
2015;"RIBEIRAO DO PINHAL (PR)";"PR";"RIBEIRAO DO PINHAL";211;34;57;302
2015;"RIO AZUL (PR)";"PR";"RIO AZUL";331;12;43;386
2015;"RIO BOM (PR)";"PR";"RIO BOM";103;6;11;120
2015;"RIO BONITO DO IGUACU (PR)";"PR";"RIO BONITO DO IGUACU";289;10;83;382
2015;"RIO BRANCO DO IVAI (PR)";"PR";"RIO BRANCO DO IVAI";49;4;13;66
2015;"RIO BRANCO DO SUL (PR)";"PR";"RIO BRANCO DO SUL";760;125;175;1060
2015;"RIO NEGRO (PR)";"PR";"RIO NEGRO";1045;92;81;1218
2015;"ROLANDIA (PR)";"PR";"ROLANDIA";1745;130;123;1998
2015;"RONCADOR (PR)";"PR";"RONCADOR";387;4;41;432
2015;"RONDON (PR)";"PR";"RONDON";293;16;76;385
2015;"ROSARIO DO IVAI (PR)";"PR";"ROSARIO DO IVAI";96;11;26;133
2015;"SABAUDIA (PR)";"PR";"SABAUDIA";233;13;24;270
2015;"SALGADO FILHO (PR)";"PR";"SALGADO FILHO";89;4;29;122
2015;"SALTO DO ITARARE (PR)";"PR";"SALTO DO ITARARE";122;5;18;145
2015;"SALTO DO LONTRA (PR)";"PR";"SALTO DO LONTRA";313;14;40;367
2015;"SANTA AMELIA (PR)";"PR";"SANTA AMELIA";81;6;22;109
2015;"SANTA CECILIA DO PAVAO (PR)";"PR";"SANTA CECILIA DO PAVAO";96;9;14;119
2015;"SANTA CRUZ DO MONTE CASTELO (PR)";"PR";"SANTA CRUZ DO MONTE CASTELO";229;11;50;290
2015;"SANTA FE (PR)";"PR";"SANTA FE";284;18;36;338
2015;"SANTA HELENA (PR)";"PR";"SANTA HELENA";677;66;127;870
2015;"SANTA INES (PR)";"PR";"SANTA INES";21;11;10;42
2015;"SANTA ISABEL DO IVAI (PR)";"PR";"SANTA ISABEL DO IVAI";214;19;37;270
2015;"SANTA IZABEL DO OESTE (PR)";"PR";"SANTA IZABEL DO OESTE";237;28;36;301
2015;"SANTA LUCIA (PR)";"PR";"SANTA LUCIA";126;5;12;143
2015;"SANTA MARIA DO OESTE (PR)";"PR";"SANTA MARIA DO OESTE";261;15;26;302
2015;"SANTA MARIANA (PR)";"PR";"SANTA MARIANA";323;24;54;401
2015;"SANTA MONICA (PR)";"PR";"SANTA MONICA";52;5;16;73
2015;"SANTA TEREZA DO OESTE (PR)";"PR";"SANTA TEREZA DO OESTE";259;12;13;284
2015;"SANTA TEREZINHA DE ITAIPU (PR)";"PR";"SANTA TEREZINHA DE ITAIPU";517;57;60;634
2015;"SANTANA DO ITARARE (PR)";"PR";"SANTANA DO ITARARE";99;6;25;130
2015;"SANTO ANTONIO DA PLATINA (PR)";"PR";"SANTO ANTONIO DA PLATINA";754;78;253;1085
2015;"SANTO ANTONIO DO CAIUA (PR)";"PR";"SANTO ANTONIO DO CAIUA";25;3;14;42
2015;"SANTO ANTONIO DO PARAISO (PR)";"PR";"SANTO ANTONIO DO PARAISO";77;6;12;95
2015;"SANTO ANTONIO DO SUDOESTE (PR)";"PR";"SANTO ANTONIO DO SUDOESTE";451;18;46;515
2015;"SANTO INACIO (PR)";"PR";"SANTO INACIO";123;7;25;155
2015;"SAO CARLOS DO IVAI (PR)";"PR";"SAO CARLOS DO IVAI";250;8;32;290
2015;"SAO JERONIMO DA SERRA (PR)";"PR";"SAO JERONIMO DA SERRA";189;13;27;229
2015;"SAO JOAO (PR)";"PR";"SAO JOAO";407;15;51;473
2015;"SAO JOAO DO CAIUA (PR)";"PR";"SAO JOAO DO CAIUA";76;8;35;119
2015;"SAO JOAO DO IVAI (PR)";"PR";"SAO JOAO DO IVAI";365;9;36;410
2015;"SAO JOAO DO TRIUNFO (PR)";"PR";"SAO JOAO DO TRIUNFO";280;11;45;336
2015;"SAO JORGE D OESTE (PR)";"PR";"SAO JORGE D OESTE";251;15;51;317
2015;"SAO JORGE DO IVAI (PR)";"PR";"SAO JORGE DO IVAI";283;7;21;311
2015;"SAO JORGE DO PATROCINIO (PR)";"PR";"SAO JORGE DO PATROCINIO";136;8;25;169
2015;"SAO JOSE DA BOA VISTA (PR)";"PR";"SAO JOSE DA BOA VISTA";119;6;25;150
2015;"SAO JOSE DAS PALMEIRAS (PR)";"PR";"SAO JOSE DAS PALMEIRAS";87;12;30;129
2015;"SAO JOSE DOS PINHAIS (PR)";"PR";"SAO JOSE DOS PINHAIS";7825;711;846;9382
2015;"SAO MANOEL DO PARANA (PR)";"PR";"SAO MANOEL DO PARANA";48;1;11;60
2015;"SAO MATEUS DO SUL (PR)";"PR";"SAO MATEUS DO SUL";1091;104;165;1360
2015;"SAO MIGUEL DO IGUACU (PR)";"PR";"SAO MIGUEL DO IGUACU";944;57;75;1076
2015;"SAO PEDRO DO IGUACU (PR)";"PR";"SAO PEDRO DO IGUACU";191;7;45;243
2015;"SAO PEDRO DO IVAI (PR)";"PR";"SAO PEDRO DO IVAI";361;11;48;420
2015;"SAO PEDRO DO PARANA (PR)";"PR";"SAO PEDRO DO PARANA";48;6;7;61
2015;"SAO SEBASTIAO DA AMOREIRA (PR)";"PR";"SAO SEBASTIAO DA AMOREIRA";206;7;53;266
2015;"SAO TOME (PR)";"PR";"SAO TOME";163;11;41;215
2015;"SAPOPEMA (PR)";"PR";"SAPOPEMA";143;5;18;166
2015;"SARANDI (PR)";"PR";"SARANDI";1149;102;199;1450
2015;"SAUDADE DO IGUACU (PR)";"PR";"SAUDADE DO IGUACU";84;21;24;129
2015;"SENGES (PR)";"PR";"SENGES";573;35;73;681
2015;"SERRANOPOLIS DO IGUACU (PR)";"PR";"SERRANOPOLIS DO IGUACU";157;13;14;184
2015;"SERTANEJA (PR)";"PR";"SERTANEJA";208;14;33;255
2015;"SERTANOPOLIS (PR)";"PR";"SERTANOPOLIS";638;27;66;731
2015;"SIQUEIRA CAMPOS (PR)";"PR";"SIQUEIRA CAMPOS";439;19;64;522
2015;"SULINA (PR)";"PR";"SULINA";90;2;13;105
2015;"TAMARANA (PR)";"PR";"TAMARANA";320;18;54;392
2015;"TAMBOARA (PR)";"PR";"TAMBOARA";102;11;14;127
2015;"TAPEJARA (PR)";"PR";"TAPEJARA";440;12;104;556
2015;"TAPIRA (PR)";"PR";"TAPIRA";166;6;36;208
2015;"TEIXEIRA SOARES (PR)";"PR";"TEIXEIRA SOARES";219;12;87;318
2015;"TELEMACO BORBA (PR)";"PR";"TELEMACO BORBA";1103;233;227;1563
2015;"TERRA BOA (PR)";"PR";"TERRA BOA";361;20;103;484
2015;"TERRA RICA (PR)";"PR";"TERRA RICA";421;23;82;526
2015;"TERRA ROXA (PR)";"PR";"TERRA ROXA";591;22;59;672
2015;"TIBAGI (PR)";"PR";"TIBAGI";364;49;63;476
2015;"TIJUCAS DO SUL (PR)";"PR";"TIJUCAS DO SUL";481;20;44;545
2015;"TOLEDO (PR)";"PR";"TOLEDO";3377;249;248;3874
2015;"TOMAZINA (PR)";"PR";"TOMAZINA";127;11;23;161
2015;"TRES BARRAS DO PARANA (PR)";"PR";"TRES BARRAS DO PARANA";368;9;36;413
2015;"TUNAS DO PARANA (PR)";"PR";"TUNAS DO PARANA";124;12;50;186
2015;"TUNEIRAS DO OESTE (PR)";"PR";"TUNEIRAS DO OESTE";165;10;57;232
2015;"TUPASSI (PR)";"PR";"TUPASSI";365;12;40;417
2015;"TURVO (PR)";"PR";"TURVO";433;28;72;533
2015;"UBIRATA (PR)";"PR";"UBIRATA";778;41;71;890
2015;"UMUARAMA (PR)";"PR";"UMUARAMA";2907;92;299;3298
2015;"UNIAO DA VITORIA (PR)";"PR";"UNIAO DA VITORIA";1549;67;87;1703
2015;"UNIFLOR (PR)";"PR";"UNIFLOR";53;9;14;76
2015;"URAI (PR)";"PR";"URAI";361;24;25;410
2015;"VENTANIA (PR)";"PR";"VENTANIA";180;20;32;232
2015;"VERA CRUZ DO OESTE (PR)";"PR";"VERA CRUZ DO OESTE";292;10;18;320
2015;"VERE (PR)";"PR";"VERE";247;5;25;277
2015;"VIRMOND (PR)";"PR";"VIRMOND";130;2;19;151
2015;"VITORINO (PR)";"PR";"VITORINO";258;8;30;296
2015;"WENCESLAU BRAZ (PR)";"PR";"WENCESLAU BRAZ";487;24;81;592
2015;"XAMBRE (PR)";"PR";"XAMBRE";166;9;16;191
2015;"ANGRA DOS REIS (RJ)";"RJ";"ANGRA DOS REIS";1204;222;378;1804
2015;"APERIBE (RJ)";"RJ";"APERIBE";144;19;14;177
2015;"ARARUAMA (RJ)";"RJ";"ARARUAMA";1897;313;172;2382
2015;"AREAL (RJ)";"RJ";"AREAL";181;39;44;264
2015;"ARMACAO DE BUZIOS (RJ)";"RJ";"ARMACAO DE BUZIOS";344;333;59;736
2015;"ARRAIAL DO CABO (RJ)";"RJ";"ARRAIAL DO CABO";164;62;17;243
2015;"BARRA DO PIRAI (RJ)";"RJ";"BARRA DO PIRAI";1475;218;283;1976
2015;"BARRA MANSA (RJ)";"RJ";"BARRA MANSA";2028;263;684;2975
2015;"BELFORD ROXO (RJ)";"RJ";"BELFORD ROXO";1923;464;936;3323
2015;"BOM JARDIM (RJ)";"RJ";"BOM JARDIM";660;55;53;768
2015;"BOM JESUS DO ITABAPOANA (RJ)";"RJ";"BOM JESUS DO ITABAPOANA";312;57;66;435
2015;"CABO FRIO (RJ)";"RJ";"CABO FRIO";3136;364;488;3988
2015;"CACHOEIRAS DE MACACU (RJ)";"RJ";"CACHOEIRAS DE MACACU";894;176;47;1117
2015;"CAMBUCI (RJ)";"RJ";"CAMBUCI";119;28;27;174
2015;"CAMPOS DOS GOYTACAZES (RJ)";"RJ";"CAMPOS DOS GOYTACAZES";7029;1114;1459;9602
2015;"CANTAGALO (RJ)";"RJ";"CANTAGALO";208;48;44;300
2015;"CARAPEBUS (RJ)";"RJ";"CARAPEBUS";121;25;13;159
2015;"CARDOSO MOREIRA (RJ)";"RJ";"CARDOSO MOREIRA";177;32;46;255
2015;"CARMO (RJ)";"RJ";"CARMO";141;33;29;203
2015;"CASIMIRO DE ABREU (RJ)";"RJ";"CASIMIRO DE ABREU";598;101;27;726
2015;"COMENDADOR LEVY GASPARIAN (RJ)";"RJ";"COMENDADOR LEVY GASPARIAN";197;36;18;251
2015;"CONCEICAO DE MACABU (RJ)";"RJ";"CONCEICAO DE MACABU";184;44;61;289
2015;"CORDEIRO (RJ)";"RJ";"CORDEIRO";285;53;56;394
2015;"DUAS BARRAS (RJ)";"RJ";"DUAS BARRAS";151;41;10;202
2015;"DUQUE DE CAXIAS (RJ)";"RJ";"DUQUE DE CAXIAS";9473;984;4011;14468
2015;"ENGENHEIRO PAULO DE FRONTIN (RJ)";"RJ";"ENGENHEIRO PAULO DE FRONTIN";139;33;16;188
2015;"GUAPIMIRIM (RJ)";"RJ";"GUAPIMIRIM";418;78;55;551
2015;"IGUABA GRANDE (RJ)";"RJ";"IGUABA GRANDE";187;80;25;292
2015;"ITABORAI (RJ)";"RJ";"ITABORAI";3163;751;531;4445
2015;"ITAGUAI (RJ)";"RJ";"ITAGUAI";1745;295;320;2360
2015;"ITALVA (RJ)";"RJ";"ITALVA";207;31;37;275
2015;"ITAOCARA (RJ)";"RJ";"ITAOCARA";383;51;36;470
2015;"ITAPERUNA (RJ)";"RJ";"ITAPERUNA";1162;137;124;1423
2015;"ITATIAIA (RJ)";"RJ";"ITATIAIA";161;77;47;285
2015;"JAPERI (RJ)";"RJ";"JAPERI";554;66;42;662
2015;"LAJE DO MURIAE (RJ)";"RJ";"LAJE DO MURIAE";44;8;15;67
2015;"MACAE (RJ)";"RJ";"MACAE";3200;1112;1088;5400
2015;"MACUCO (RJ)";"RJ";"MACUCO";177;14;11;202
2015;"MAGE (RJ)";"RJ";"MAGE";1850;432;197;2479
2015;"MANGARATIBA (RJ)";"RJ";"MANGARATIBA";199;154;178;531
2015;"MARICA (RJ)";"RJ";"MARICA";1137;372;437;1946
2015;"MENDES (RJ)";"RJ";"MENDES";224;48;52;324
2015;"MESQUITA (RJ)";"RJ";"MESQUITA";864;117;683;1664
2015;"MIGUEL PEREIRA (RJ)";"RJ";"MIGUEL PEREIRA";368;83;39;490
2015;"MIRACEMA (RJ)";"RJ";"MIRACEMA";274;41;36;351
2015;"NATIVIDADE (RJ)";"RJ";"NATIVIDADE";89;21;46;156
2015;"NILOPOLIS (RJ)";"RJ";"NILOPOLIS";674;155;340;1169
2015;"NITEROI (RJ)";"RJ";"NITEROI";2733;1317;2940;6990
2015;"NOVA FRIBURGO (RJ)";"RJ";"NOVA FRIBURGO";3693;298;350;4341
2015;"NOVA IGUACU (RJ)";"RJ";"NOVA IGUACU";6458;1496;1780;9734
2015;"PARACAMBI (RJ)";"RJ";"PARACAMBI";677;106;107;890
2015;"PARAIBA DO SUL (RJ)";"RJ";"PARAIBA DO SUL";620;135;126;881
2015;"PARATI (RJ)";"RJ";"PARATI";224;81;53;358
2015;"PATY DO ALFERES (RJ)";"RJ";"PATY DO ALFERES";495;58;40;593
2015;"PETROPOLIS (RJ)";"RJ";"PETROPOLIS";3128;711;955;4794
2015;"PINHEIRAL (RJ)";"RJ";"PINHEIRAL";206;60;124;390
2015;"PIRAI (RJ)";"RJ";"PIRAI";438;81;75;594
2015;"PORCIUNCULA (RJ)";"RJ";"PORCIUNCULA";73;23;24;120
2015;"PORTO REAL (RJ)";"RJ";"PORTO REAL";375;55;19;449
2015;"QUATIS (RJ)";"RJ";"QUATIS";169;77;34;280
2015;"QUEIMADOS (RJ)";"RJ";"QUEIMADOS";656;224;261;1141
2015;"QUISSAMA (RJ)";"RJ";"QUISSAMA";224;39;123;386
2015;"RESENDE (RJ)";"RJ";"RESENDE";1440;307;792;2539
2015;"RIO BONITO (RJ)";"RJ";"RIO BONITO";3470;336;157;3963
2015;"RIO CLARO (RJ)";"RJ";"RIO CLARO";118;21;24;163
2015;"RIO DAS FLORES (RJ)";"RJ";"RIO DAS FLORES";52;31;17;100
2015;"RIO DAS OSTRAS (RJ)";"RJ";"RIO DAS OSTRAS";1097;820;138;2055
2015;"RIO DE JANEIRO (RJ)";"RJ";"RIO DE JANEIRO";42917;18199;18205;79321
2015;"SANTA MARIA MADALENA (RJ)";"RJ";"SANTA MARIA MADALENA";83;25;25;133
2015;"SANTO ANTONIO DE PADUA (RJ)";"RJ";"SANTO ANTONIO DE PADUA";631;102;37;770
2015;"SAO FIDELIS (RJ)";"RJ";"SAO FIDELIS";451;48;69;568
2015;"SAO FRANCISCO DE ITABAPOANA (RJ)";"RJ";"SAO FRANCISCO DE ITABAPOANA";417;116;97;630
2015;"SAO GONCALO (RJ)";"RJ";"SAO GONCALO";4942;1988;3399;10329
2015;"SAO JOAO DA BARRA (RJ)";"RJ";"SAO JOAO DA BARRA";640;106;68;814
2015;"SAO JOAO DE MERITI (RJ)";"RJ";"SAO JOAO DE MERITI";3695;575;1304;5574
2015;"SAO JOSE DE UBA (RJ)";"RJ";"SAO JOSE DE UBA";51;12;10;73
2015;"SAO JOSE DO VALE DO RIO PRETO (RJ)";"RJ";"SAO JOSE DO VALE DO RIO PRETO";719;36;38;793
2015;"SAO PEDRO DA ALDEIA (RJ)";"RJ";"SAO PEDRO DA ALDEIA";946;109;75;1130
2015;"SAO SEBASTIAO DO ALTO (RJ)";"RJ";"SAO SEBASTIAO DO ALTO";108;28;8;144
2015;"SAPUCAIA (RJ)";"RJ";"SAPUCAIA";127;21;9;157
2015;"SAQUAREMA (RJ)";"RJ";"SAQUAREMA";819;147;155;1121
2015;"SEROPEDICA (RJ)";"RJ";"SEROPEDICA";1282;76;284;1642
2015;"SILVA JARDIM (RJ)";"RJ";"SILVA JARDIM";306;60;45;411
2015;"SUMIDOURO (RJ)";"RJ";"SUMIDOURO";347;18;22;387
2015;"TANGUA (RJ)";"RJ";"TANGUA";324;62;84;470
2015;"TERESOPOLIS (RJ)";"RJ";"TERESOPOLIS";2257;317;298;2872
2015;"TRAJANO DE MORAIS (RJ)";"RJ";"TRAJANO DE MORAIS";114;28;19;161
2015;"TRES RIOS (RJ)";"RJ";"TRES RIOS";1054;124;217;1395
2015;"VALENCA (RJ)";"RJ";"VALENCA";395;133;97;625
2015;"VARRE SAI (RJ)";"RJ";"VARRE SAI";73;17;7;97
2015;"VASSOURAS (RJ)";"RJ";"VASSOURAS";561;89;96;746
2015;"VOLTA REDONDA (RJ)";"RJ";"VOLTA REDONDA";2353;436;629;3418
2015;"ACARI (RN)";"RN";"ACARI";110;9;12;131
2015;"AFONSO BEZERRA (RN)";"RN";"AFONSO BEZERRA";31;5;12;48
2015;"AGUA NOVA (RN)";"RN";"AGUA NOVA";9;12;2;23
2015;"ALEXANDRIA (RN)";"RN";"ALEXANDRIA";82;31;15;128
2015;"ALMINO AFONSO (RN)";"RN";"ALMINO AFONSO";23;10;1;34
2015;"ALTO DO RODRIGUES (RN)";"RN";"ALTO DO RODRIGUES";181;18;26;225
2015;"ANGICOS (RN)";"RN";"ANGICOS";124;19;11;154
2015;"ANTONIO MARTINS (RN)";"RN";"ANTONIO MARTINS";31;11;3;45
2015;"APODI (RN)";"RN";"APODI";320;35;43;398
2015;"AREIA BRANCA (RN)";"RN";"AREIA BRANCA";129;52;73;254
2015;"ARES (RN)";"RN";"ARES";57;8;41;106
2015;"ASSU (RN)";"RN";"ASSU";668;65;94;827
2015;"BAIA FORMOSA (RN)";"RN";"BAIA FORMOSA";52;2;22;76
2015;"BARAUNA (RN)";"RN";"BARAUNA";621;32;38;691
2015;"BARCELONA (RN)";"RN";"BARCELONA";26;3;4;33
2015;"BENTO FERNANDES (RN)";"RN";"BENTO FERNANDES";15;5;12;32
2015;"BOA SAUDE (RN)";"RN";"BOA SAUDE";77;4;12;93
2015;"BODO (RN)";"RN";"BODO";6;5;2;13
2015;"BOM JESUS (RN)";"RN";"BOM JESUS";60;2;8;70
2015;"BREJINHO (RN)";"RN";"BREJINHO";112;12;19;143
2015;"CAICARA DO NORTE (RN)";"RN";"CAICARA DO NORTE";16;2;6;24
2015;"CAICARA DO RIO DO VENTO (RN)";"RN";"CAICARA DO RIO DO VENTO";20;4;2;26
2015;"CAICO (RN)";"RN";"CAICO";1918;131;58;2107
2015;"CAMPO GRANDE (RN)";"RN";"CAMPO GRANDE";47;11;8;66
2015;"CAMPO REDONDO (RN)";"RN";"CAMPO REDONDO";61;10;13;84
2015;"CANGUARETAMA (RN)";"RN";"CANGUARETAMA";171;29;76;276
2015;"CARAUBAS (RN)";"RN";"CARAUBAS";171;38;16;225
2015;"CARNAUBA DOS DANTAS (RN)";"RN";"CARNAUBA DOS DANTAS";221;11;10;242
2015;"CARNAUBAIS (RN)";"RN";"CARNAUBAIS";51;20;14;85
2015;"CEARA MIRIM (RN)";"RN";"CEARA MIRIM";343;47;137;527
2015;"CERRO CORA (RN)";"RN";"CERRO CORA";101;15;13;129
2015;"CORONEL EZEQUIEL (RN)";"RN";"CORONEL EZEQUIEL";64;7;4;75
2015;"CORONEL JOAO PESSOA (RN)";"RN";"CORONEL JOAO PESSOA";14;3;3;20
2015;"CRUZETA (RN)";"RN";"CRUZETA";79;18;11;108
2015;"CURRAIS NOVOS (RN)";"RN";"CURRAIS NOVOS";759;60;63;882
2015;"DOUTOR SEVERIANO (RN)";"RN";"DOUTOR SEVERIANO";33;5;10;48
2015;"ENCANTO (RN)";"RN";"ENCANTO";15;8;9;32
2015;"EQUADOR (RN)";"RN";"EQUADOR";134;6;3;143
2015;"ESPIRITO SANTO (RN)";"RN";"ESPIRITO SANTO";28;3;16;47
2015;"EXTREMOZ (RN)";"RN";"EXTREMOZ";81;22;42;145
2015;"FELIPE GUERRA (RN)";"RN";"FELIPE GUERRA";24;10;10;44
2015;"FERNANDO PEDROZA (RN)";"RN";"FERNANDO PEDROZA";26;4;2;32
2015;"FLORANIA (RN)";"RN";"FLORANIA";75;12;8;95
2015;"FRANCISCO DANTAS (RN)";"RN";"FRANCISCO DANTAS";21;4;3;28
2015;"FRUTUOSO GOMES (RN)";"RN";"FRUTUOSO GOMES";30;13;2;45
2015;"GALINHOS (RN)";"RN";"GALINHOS";13;4;4;21
2015;"GOIANINHA (RN)";"RN";"GOIANINHA";189;54;91;334
2015;"GOVERNADOR DIX SEPT ROSADO (RN)";"RN";"GOVERNADOR DIX SEPT ROSADO";159;26;17;202
2015;"GROSSOS (RN)";"RN";"GROSSOS";55;3;19;77
2015;"GUAMARE (RN)";"RN";"GUAMARE";125;22;43;190
2015;"IELMO MARINHO (RN)";"RN";"IELMO MARINHO";50;4;24;78
2015;"IPANGUACU (RN)";"RN";"IPANGUACU";103;33;54;190
2015;"IPUEIRA (RN)";"RN";"IPUEIRA";16;8;6;30
2015;"ITAJA (RN)";"RN";"ITAJA";109;4;7;120
2015;"ITAU (RN)";"RN";"ITAU";36;11;1;48
2015;"JACANA (RN)";"RN";"JACANA";269;61;22;352
2015;"JANDAIRA (RN)";"RN";"JANDAIRA";52;0;12;64
2015;"JANDUIS (RN)";"RN";"JANDUIS";19;3;3;25
2015;"JAPI (RN)";"RN";"JAPI";55;12;9;76
2015;"JARDIM DE ANGICOS (RN)";"RN";"JARDIM DE ANGICOS";14;0;4;18
2015;"JARDIM DE PIRANHAS (RN)";"RN";"JARDIM DE PIRANHAS";87;28;11;126
2015;"JARDIM DO SERIDO (RN)";"RN";"JARDIM DO SERIDO";149;18;51;218
2015;"JOAO CAMARA (RN)";"RN";"JOAO CAMARA";373;24;42;439
2015;"JOAO DIAS (RN)";"RN";"JOAO DIAS";11;1;1;13
2015;"JOSE DA PENHA (RN)";"RN";"JOSE DA PENHA";36;14;2;52
2015;"JUCURUTU (RN)";"RN";"JUCURUTU";142;43;13;198
2015;"JUNDIA (RN)";"RN";"JUNDIA";12;5;10;27
2015;"LAGOA DANTA (RN)";"RN";"LAGOA DANTA";50;11;15;76
2015;"LAGOA DE PEDRAS (RN)";"RN";"LAGOA DE PEDRAS";35;5;16;56
2015;"LAGOA DE VELHOS (RN)";"RN";"LAGOA DE VELHOS";22;2;2;26
2015;"LAGOA NOVA (RN)";"RN";"LAGOA NOVA";99;13;13;125
2015;"LAGOA SALGADA (RN)";"RN";"LAGOA SALGADA";95;6;9;110
2015;"LAJES (RN)";"RN";"LAJES";76;7;11;94
2015;"LAJES PINTADAS (RN)";"RN";"LAJES PINTADAS";28;12;7;47
2015;"LUCRECIA (RN)";"RN";"LUCRECIA";29;7;4;40
2015;"LUIS GOMES (RN)";"RN";"LUIS GOMES";45;36;8;89
2015;"MACAIBA (RN)";"RN";"MACAIBA";848;126;81;1055
2015;"MACAU (RN)";"RN";"MACAU";218;33;62;313
2015;"MAJOR SALES (RN)";"RN";"MAJOR SALES";16;12;2;30
2015;"MARCELINO VIEIRA (RN)";"RN";"MARCELINO VIEIRA";22;16;4;42
2015;"MARTINS (RN)";"RN";"MARTINS";49;13;7;69
2015;"MAXARANGUAPE (RN)";"RN";"MAXARANGUAPE";24;11;9;44
2015;"MESSIAS TARGINO (RN)";"RN";"MESSIAS TARGINO";44;11;4;59
2015;"MONTANHAS (RN)";"RN";"MONTANHAS";51;9;18;78
2015;"MONTE ALEGRE (RN)";"RN";"MONTE ALEGRE";116;19;29;164
2015;"MONTE DAS GAMELEIRAS (RN)";"RN";"MONTE DAS GAMELEIRAS";13;3;8;24
2015;"MOSSORO (RN)";"RN";"MOSSORO";3918;309;308;4535
2015;"NATAL (RN)";"RN";"NATAL";6979;1293;2550;10822
2015;"NISIA FLORESTA (RN)";"RN";"NISIA FLORESTA";89;41;50;180
2015;"NOVA CRUZ (RN)";"RN";"NOVA CRUZ";437;48;75;560
2015;"OLHO D AGUA DO BORGES (RN)";"RN";"OLHO D AGUA DO BORGES";26;3;1;30
2015;"OURO BRANCO (RN)";"RN";"OURO BRANCO";42;13;5;60
2015;"PARANA (RN)";"RN";"PARANA";17;12;4;33
2015;"PARAU (RN)";"RN";"PARAU";19;12;2;33
2015;"PARAZINHO (RN)";"RN";"PARAZINHO";31;5;15;51
2015;"PARELHAS (RN)";"RN";"PARELHAS";442;34;45;521
2015;"PARNAMIRIM (RN)";"RN";"PARNAMIRIM";2078;390;423;2891
2015;"PASSA E FICA (RN)";"RN";"PASSA E FICA";170;53;42;265
2015;"PASSAGEM (RN)";"RN";"PASSAGEM";16;9;2;27
2015;"PATU (RN)";"RN";"PATU";107;21;4;132
2015;"PAU DOS FERROS (RN)";"RN";"PAU DOS FERROS";567;57;31;655
2015;"PEDRA GRANDE (RN)";"RN";"PEDRA GRANDE";12;1;7;20
2015;"PEDRA PRETA (RN)";"RN";"PEDRA PRETA";34;3;10;47
2015;"PEDRO AVELINO (RN)";"RN";"PEDRO AVELINO";34;4;6;44
2015;"PEDRO VELHO (RN)";"RN";"PEDRO VELHO";48;7;13;68
2015;"PENDENCIAS (RN)";"RN";"PENDENCIAS";72;13;16;101
2015;"PILOES (RN)";"RN";"PILOES";20;5;2;27
2015;"POCO BRANCO (RN)";"RN";"POCO BRANCO";33;5;13;51
2015;"PORTALEGRE (RN)";"RN";"PORTALEGRE";44;13;6;63
2015;"PORTO DO MANGUE (RN)";"RN";"PORTO DO MANGUE";29;15;8;52
2015;"PUREZA (RN)";"RN";"PUREZA";85;7;20;112
2015;"RAFAEL FERNANDES (RN)";"RN";"RAFAEL FERNANDES";33;6;1;40
2015;"RAFAEL GODEIRO (RN)";"RN";"RAFAEL GODEIRO";8;1;2;11
2015;"RIACHO DA CRUZ (RN)";"RN";"RIACHO DA CRUZ";10;3;1;14
2015;"RIACHO DE SANTANA (RN)";"RN";"RIACHO DE SANTANA";9;8;4;21
2015;"RIACHUELO (RN)";"RN";"RIACHUELO";34;4;7;45
2015;"RIO DO FOGO (RN)";"RN";"RIO DO FOGO";43;5;9;57
2015;"RODOLFO FERNANDES (RN)";"RN";"RODOLFO FERNANDES";30;6;3;39
2015;"RUY BARBOSA (RN)";"RN";"RUY BARBOSA";18;1;5;24
2015;"SANTA CRUZ (RN)";"RN";"SANTA CRUZ";508;35;41;584
2015;"SANTA MARIA (RN)";"RN";"SANTA MARIA";70;4;6;80
2015;"SANTANA DO MATOS (RN)";"RN";"SANTANA DO MATOS";81;13;11;105
2015;"SANTANA DO SERIDO (RN)";"RN";"SANTANA DO SERIDO";25;3;2;30
2015;"SANTO ANTONIO (RN)";"RN";"SANTO ANTONIO";135;59;36;230
2015;"SAO BENTO DO NORTE (RN)";"RN";"SAO BENTO DO NORTE";7;0;9;16
2015;"SAO BENTO DO TRAIRI (RN)";"RN";"SAO BENTO DO TRAIRI";16;2;5;23
2015;"SAO FERNANDO (RN)";"RN";"SAO FERNANDO";17;12;2;31
2015;"SAO FRANCISCO DO OESTE (RN)";"RN";"SAO FRANCISCO DO OESTE";32;4;3;39
2015;"SAO GONCALO DO AMARANTE (RN)";"RN";"SAO GONCALO DO AMARANTE";487;190;301;978
2015;"SAO JOAO DO SABUGI (RN)";"RN";"SAO JOAO DO SABUGI";49;20;5;74
2015;"SAO JOSE DE MIPIBU (RN)";"RN";"SAO JOSE DE MIPIBU";337;43;63;443
2015;"SAO JOSE DO CAMPESTRE (RN)";"RN";"SAO JOSE DO CAMPESTRE";80;5;21;106
2015;"SAO JOSE DO SERIDO (RN)";"RN";"SAO JOSE DO SERIDO";34;11;4;49
2015;"SAO MIGUEL (RN)";"RN";"SAO MIGUEL";232;48;27;307
2015;"SAO MIGUEL DO GOSTOSO (RN)";"RN";"SAO MIGUEL DO GOSTOSO";30;11;16;57
2015;"SAO PAULO DO POTENGI (RN)";"RN";"SAO PAULO DO POTENGI";126;9;24;159
2015;"SAO PEDRO (RN)";"RN";"SAO PEDRO";37;5;9;51
2015;"SAO RAFAEL (RN)";"RN";"SAO RAFAEL";37;16;5;58
2015;"SAO TOME (RN)";"RN";"SAO TOME";64;5;25;94
2015;"SAO VICENTE (RN)";"RN";"SAO VICENTE";52;4;5;61
2015;"SENADOR ELOI DE SOUZA (RN)";"RN";"SENADOR ELOI DE SOUZA";24;4;13;41
2015;"SENADOR GEORGINO AVELINO (RN)";"RN";"SENADOR GEORGINO AVELINO";13;1;2;16
2015;"SERRA CAIADA (RN)";"RN";"SERRA CAIADA";39;7;16;62
2015;"SERRA DE SAO BENTO (RN)";"RN";"SERRA DE SAO BENTO";42;7;5;54
2015;"SERRA DO MEL (RN)";"RN";"SERRA DO MEL";106;13;16;135
2015;"SERRA NEGRA DO NORTE (RN)";"RN";"SERRA NEGRA DO NORTE";73;19;10;102
2015;"SERRINHA (RN)";"RN";"SERRINHA";28;16;8;52
2015;"SERRINHA DOS PINTOS (RN)";"RN";"SERRINHA DOS PINTOS";35;4;2;41
2015;"SEVERIANO MELO (RN)";"RN";"SEVERIANO MELO";37;9;6;52
2015;"SITIO NOVO (RN)";"RN";"SITIO NOVO";16;5;4;25
2015;"TABOLEIRO GRANDE (RN)";"RN";"TABOLEIRO GRANDE";8;7;3;18
2015;"TAIPU (RN)";"RN";"TAIPU";65;5;20;90
2015;"TANGARA (RN)";"RN";"TANGARA";151;9;36;196
2015;"TENENTE ANANIAS (RN)";"RN";"TENENTE ANANIAS";62;20;4;86
2015;"TENENTE LAURENTINO CRUZ (RN)";"RN";"TENENTE LAURENTINO CRUZ";56;8;5;69
2015;"TIBAU (RN)";"RN";"TIBAU";33;9;18;60
2015;"TIBAU DO SUL (RN)";"RN";"TIBAU DO SUL";52;43;17;112
2015;"TIMBAUBA DOS BATISTAS (RN)";"RN";"TIMBAUBA DOS BATISTAS";18;8;3;29
2015;"TOUROS (RN)";"RN";"TOUROS";177;33;48;258
2015;"TRIUNFO POTIGUAR (RN)";"RN";"TRIUNFO POTIGUAR";15;6;3;24
2015;"UMARIZAL (RN)";"RN";"UMARIZAL";67;30;5;102
2015;"UPANEMA (RN)";"RN";"UPANEMA";80;12;13;105
2015;"VARZEA (RN)";"RN";"VARZEA";16;4;7;27
2015;"VENHA VER (RN)";"RN";"VENHA VER";18;10;5;33
2015;"VERA CRUZ (RN)";"RN";"VERA CRUZ";146;8;22;176
2015;"VICOSA (RN)";"RN";"VICOSA";7;2;1;10
2015;"VILA FLOR (RN)";"RN";"VILA FLOR";11;2;3;16
2015;"ALTA FLORESTA D OESTE (RO)";"RO";"ALTA FLORESTA D OESTE";557;15;73;645
2015;"ALTO ALEGRE DOS PARECIS (RO)";"RO";"ALTO ALEGRE DOS PARECIS";164;13;34;211
2015;"ALTO PARAISO (RO)";"RO";"ALTO PARAISO";321;9;69;399
2015;"ALVORADA D OESTE (RO)";"RO";"ALVORADA D OESTE";269;7;66;342
2015;"ARIQUEMES (RO)";"RO";"ARIQUEMES";2110;34;216;2360
2015;"BURITIS (RO)";"RO";"BURITIS";501;8;35;544
2015;"CABIXI (RO)";"RO";"CABIXI";89;4;25;118
2015;"CACAULANDIA (RO)";"RO";"CACAULANDIA";85;4;27;116
2015;"CACOAL (RO)";"RO";"CACOAL";1824;72;295;2191
2015;"CAMPO NOVO DE RONDONIA (RO)";"RO";"CAMPO NOVO DE RONDONIA";80;7;44;131
2015;"CANDEIAS DO JAMARI (RO)";"RO";"CANDEIAS DO JAMARI";211;8;35;254
2015;"CASTANHEIRAS (RO)";"RO";"CASTANHEIRAS";33;2;17;52
2015;"CEREJEIRAS (RO)";"RO";"CEREJEIRAS";387;3;62;452
2015;"CHUPINGUAIA (RO)";"RO";"CHUPINGUAIA";149;5;56;210
2015;"COLORADO DO OESTE (RO)";"RO";"COLORADO DO OESTE";395;13;53;461
2015;"CORUMBIARA (RO)";"RO";"CORUMBIARA";84;8;18;110
2015;"COSTA MARQUES (RO)";"RO";"COSTA MARQUES";149;7;26;182
2015;"CUJUBIM (RO)";"RO";"CUJUBIM";284;7;23;314
2015;"ESPIGAO D OESTE (RO)";"RO";"ESPIGAO D OESTE";667;5;123;795
2015;"GOVERNADOR JORGE TEIXEIRA (RO)";"RO";"GOVERNADOR JORGE TEIXEIRA";74;3;25;102
2015;"GUAJARA MIRIM (RO)";"RO";"GUAJARA MIRIM";872;13;42;927
2015;"ITAPUA DO OESTE (RO)";"RO";"ITAPUA DO OESTE";165;4;57;226
2015;"JARU (RO)";"RO";"JARU";1000;27;202;1229
2015;"JI PARANA (RO)";"RO";"JI PARANA";2977;80;662;3719
2015;"MACHADINHO D OESTE (RO)";"RO";"MACHADINHO D OESTE";396;15;76;487
2015;"MINISTRO ANDREAZZA (RO)";"RO";"MINISTRO ANDREAZZA";216;3;21;240
2015;"MIRANTE DA SERRA (RO)";"RO";"MIRANTE DA SERRA";207;5;28;240
2015;"MONTE NEGRO (RO)";"RO";"MONTE NEGRO";311;15;82;408
2015;"NOVA BRASILANDIA D OESTE (RO)";"RO";"NOVA BRASILANDIA D OESTE";261;9;75;345
2015;"NOVA DO MAMORE (RO)";"RO";"NOVA DO MAMORE";322;2;27;351
2015;"NOVA UNIAO (RO)";"RO";"NOVA UNIAO";84;2;34;120
2015;"NOVO HORIZONTE DO OESTE (RO)";"RO";"NOVO HORIZONTE DO OESTE";123;1;19;143
2015;"OURO PRETO DO OESTE (RO)";"RO";"OURO PRETO DO OESTE";803;26;117;946
2015;"PARECIS (RO)";"RO";"PARECIS";47;3;21;71
2015;"PIMENTA BUENO (RO)";"RO";"PIMENTA BUENO";1123;41;85;1249
2015;"PIMENTEIRAS DO OESTE (RO)";"RO";"PIMENTEIRAS DO OESTE";30;1;13;44
2015;"PORTO VELHO (RO)";"RO";"PORTO VELHO";7016;519;1692;9227
2015;"PRESIDENTE MEDICI (RO)";"RO";"PRESIDENTE MEDICI";348;8;65;421
2015;"PRIMAVERA DE RONDONIA (RO)";"RO";"PRIMAVERA DE RONDONIA";45;3;15;63
2015;"RIO CRESPO (RO)";"RO";"RIO CRESPO";51;2;19;72
2015;"ROLIM DE MOURA (RO)";"RO";"ROLIM DE MOURA";1216;37;135;1388
2015;"SANTA LUZIA D OESTE (RO)";"RO";"SANTA LUZIA D OESTE";177;4;49;230
2015;"SAO FELIPE D OESTE (RO)";"RO";"SAO FELIPE D OESTE";89;4;27;120
2015;"SAO FRANCISCO DO GUAPORE (RO)";"RO";"SAO FRANCISCO DO GUAPORE";309;7;77;393
2015;"SAO MIGUEL DO GUAPORE (RO)";"RO";"SAO MIGUEL DO GUAPORE";300;11;69;380
2015;"SERINGUEIRAS (RO)";"RO";"SERINGUEIRAS";211;3;45;259
2015;"TEIXEIROPOLIS (RO)";"RO";"TEIXEIROPOLIS";48;1;14;63
2015;"THEOBROMA (RO)";"RO";"THEOBROMA";122;1;22;145
2015;"URUPA (RO)";"RO";"URUPA";114;5;81;200
2015;"VALE DO ANARI (RO)";"RO";"VALE DO ANARI";92;8;26;126
2015;"VALE DO PARAISO (RO)";"RO";"VALE DO PARAISO";77;0;22;99
2015;"VILHENA (RO)";"RO";"VILHENA";1714;71;181;1966
2015;"ALTO ALEGRE (RR)";"RR";"ALTO ALEGRE";63;10;12;85
2015;"AMAJARI (RR)";"RR";"AMAJARI";26;6;4;36
2015;"BOA VISTA (RR)";"RR";"BOA VISTA";3537;492;822;4851
2015;"BONFIM (RR)";"RR";"BONFIM";14;3;10;27
2015;"CANTA (RR)";"RR";"CANTA";57;8;12;77
2015;"CARACARAI (RR)";"RR";"CARACARAI";119;9;10;138
2015;"CAROEBE (RR)";"RR";"CAROEBE";46;8;31;85
2015;"IRACEMA (RR)";"RR";"IRACEMA";29;16;1;46
2015;"MUCAJAI (RR)";"RR";"MUCAJAI";115;45;46;206
2015;"NORMANDIA (RR)";"RR";"NORMANDIA";11;0;2;13
2015;"PACARAIMA (RR)";"RR";"PACARAIMA";144;3;8;155
2015;"RORAINOPOLIS (RR)";"RR";"RORAINOPOLIS";178;27;27;232
2015;"SAO JOAO DA BALIZA (RR)";"RR";"SAO JOAO DA BALIZA";48;5;4;57
2015;"SAO LUIZ (RR)";"RR";"SAO LUIZ";41;4;5;50
2015;"UIRAMUTA (RR)";"RR";"UIRAMUTA";2;0;0;2
2015;"ACEGUA (RS)";"RS";"ACEGUA";74;20;21;115
2015;"AGUA SANTA (RS)";"RS";"AGUA SANTA";193;13;18;224
2015;"AGUDO (RS)";"RS";"AGUDO";324;18;58;400
2015;"AJURICABA (RS)";"RS";"AJURICABA";431;20;30;481
2015;"ALECRIM (RS)";"RS";"ALECRIM";92;7;32;131
2015;"ALEGRETE (RS)";"RS";"ALEGRETE";1006;52;262;1320
2015;"ALEGRIA (RS)";"RS";"ALEGRIA";99;5;28;132
2015;"ALMIRANTE TAMANDARE DO SUL (RS)";"RS";"ALMIRANTE TAMANDARE DO SUL";104;11;5;120
2015;"ALPESTRE (RS)";"RS";"ALPESTRE";159;19;55;233
2015;"ALTO ALEGRE (RS)";"RS";"ALTO ALEGRE";113;7;9;129
2015;"ALTO FELIZ (RS)";"RS";"ALTO FELIZ";119;10;16;145
2015;"ALVORADA (RS)";"RS";"ALVORADA";1795;226;600;2621
2015;"AMARAL FERRADOR (RS)";"RS";"AMARAL FERRADOR";138;14;24;176
2015;"AMETISTA DO SUL (RS)";"RS";"AMETISTA DO SUL";83;5;61;149
2015;"ANDRE DA ROCHA (RS)";"RS";"ANDRE DA ROCHA";57;9;6;72
2015;"ANTA GORDA (RS)";"RS";"ANTA GORDA";264;23;24;311
2015;"ANTONIO PRADO (RS)";"RS";"ANTONIO PRADO";688;20;43;751
2015;"ARAMBARE (RS)";"RS";"ARAMBARE";93;6;16;115
2015;"ARARICA (RS)";"RS";"ARARICA";104;11;15;130
2015;"ARATIBA (RS)";"RS";"ARATIBA";190;32;37;259
2015;"ARROIO DO MEIO (RS)";"RS";"ARROIO DO MEIO";605;46;54;705
2015;"ARROIO DO PADRE (RS)";"RS";"ARROIO DO PADRE";108;4;14;126
2015;"ARROIO DO SAL (RS)";"RS";"ARROIO DO SAL";131;11;13;155
2015;"ARROIO DO TIGRE (RS)";"RS";"ARROIO DO TIGRE";317;27;42;386
2015;"ARROIO DOS RATOS (RS)";"RS";"ARROIO DOS RATOS";243;20;76;339
2015;"ARROIO GRANDE (RS)";"RS";"ARROIO GRANDE";286;23;66;375
2015;"ARVOREZINHA (RS)";"RS";"ARVOREZINHA";517;39;51;607
2015;"AUGUSTO PESTANA (RS)";"RS";"AUGUSTO PESTANA";485;16;37;538
2015;"AUREA (RS)";"RS";"AUREA";182;5;10;197
2015;"BAGE (RS)";"RS";"BAGE";1306;226;343;1875
2015;"BALNEARIO PINHAL (RS)";"RS";"BALNEARIO PINHAL";123;10;23;156
2015;"BARAO (RS)";"RS";"BARAO";200;27;52;279
2015;"BARAO DE COTEGIPE (RS)";"RS";"BARAO DE COTEGIPE";276;14;17;307
2015;"BARAO DO TRIUNFO (RS)";"RS";"BARAO DO TRIUNFO";133;20;50;203
2015;"BARRA DO GUARITA (RS)";"RS";"BARRA DO GUARITA";37;5;9;51
2015;"BARRA DO QUARAI (RS)";"RS";"BARRA DO QUARAI";31;4;15;50
2015;"BARRA DO RIBEIRO (RS)";"RS";"BARRA DO RIBEIRO";222;16;61;299
2015;"BARRA DO RIO AZUL (RS)";"RS";"BARRA DO RIO AZUL";39;13;13;65
2015;"BARRA FUNDA (RS)";"RS";"BARRA FUNDA";184;4;24;212
2015;"BARRACAO (RS)";"RS";"BARRACAO";164;8;22;194
2015;"BARROS CASSAL (RS)";"RS";"BARROS CASSAL";185;29;60;274
2015;"BENJAMIN CONSTANT DO SUL (RS)";"RS";"BENJAMIN CONSTANT DO SUL";27;5;19;51
2015;"BENTO GONCALVES (RS)";"RS";"BENTO GONCALVES";3416;290;368;4074
2015;"BOA VISTA DAS MISSOES (RS)";"RS";"BOA VISTA DAS MISSOES";109;4;13;126
2015;"BOA VISTA DO BURICA (RS)";"RS";"BOA VISTA DO BURICA";239;11;31;281
2015;"BOA VISTA DO CADEADO (RS)";"RS";"BOA VISTA DO CADEADO";135;2;21;158
2015;"BOA VISTA DO INCRA (RS)";"RS";"BOA VISTA DO INCRA";81;3;12;96
2015;"BOA VISTA DO SUL (RS)";"RS";"BOA VISTA DO SUL";333;7;14;354
2015;"BOM JESUS (RS)";"RS";"BOM JESUS";290;44;63;397
2015;"BOM PRINCIPIO (RS)";"RS";"BOM PRINCIPIO";498;36;37;571
2015;"BOM PROGRESSO (RS)";"RS";"BOM PROGRESSO";52;10;8;70
2015;"BOM RETIRO DO SUL (RS)";"RS";"BOM RETIRO DO SUL";204;14;38;256
2015;"BOQUEIRAO DO LEAO (RS)";"RS";"BOQUEIRAO DO LEAO";187;10;18;215
2015;"BOSSOROCA (RS)";"RS";"BOSSOROCA";204;6;23;233
2015;"BOZANO (RS)";"RS";"BOZANO";160;4;7;171
2015;"BRAGA (RS)";"RS";"BRAGA";88;5;19;112
2015;"BROCHIER (RS)";"RS";"BROCHIER";302;12;29;343
2015;"BUTIA (RS)";"RS";"BUTIA";477;44;141;662
2015;"CACAPAVA DO SUL (RS)";"RS";"CACAPAVA DO SUL";713;64;137;914
2015;"CACEQUI (RS)";"RS";"CACEQUI";160;19;25;204
2015;"CACHOEIRA DO SUL (RS)";"RS";"CACHOEIRA DO SUL";1329;113;244;1686
2015;"CACHOEIRINHA (RS)";"RS";"CACHOEIRINHA";2388;231;534;3153
2015;"CACIQUE DOBLE (RS)";"RS";"CACIQUE DOBLE";135;4;14;153
2015;"CAIBATE (RS)";"RS";"CAIBATE";151;8;6;165
2015;"CAICARA (RS)";"RS";"CAICARA";89;8;24;121
2015;"CAMAQUA (RS)";"RS";"CAMAQUA";1429;71;275;1775
2015;"CAMARGO (RS)";"RS";"CAMARGO";217;5;20;242
2015;"CAMBARA DO SUL (RS)";"RS";"CAMBARA DO SUL";260;15;39;314
2015;"CAMPESTRE DA SERRA (RS)";"RS";"CAMPESTRE DA SERRA";175;4;16;195
2015;"CAMPINA DAS MISSOES (RS)";"RS";"CAMPINA DAS MISSOES";164;10;34;208
2015;"CAMPINAS DO SUL (RS)";"RS";"CAMPINAS DO SUL";197;11;26;234
2015;"CAMPO BOM (RS)";"RS";"CAMPO BOM";868;112;98;1078
2015;"CAMPO NOVO (RS)";"RS";"CAMPO NOVO";186;17;31;234
2015;"CAMPOS BORGES (RS)";"RS";"CAMPOS BORGES";168;13;17;198
2015;"CANDELARIA (RS)";"RS";"CANDELARIA";477;31;105;613
2015;"CANDIDO GODOI (RS)";"RS";"CANDIDO GODOI";267;15;21;303
2015;"CANDIOTA (RS)";"RS";"CANDIOTA";155;36;55;246
2015;"CANELA (RS)";"RS";"CANELA";592;105;120;817
2015;"CANGUCU (RS)";"RS";"CANGUCU";1214;121;214;1549
2015;"CANOAS (RS)";"RS";"CANOAS";4816;539;1044;6399
2015;"CANUDOS DO VALE (RS)";"RS";"CANUDOS DO VALE";26;18;5;49
2015;"CAPAO BONITO DO SUL (RS)";"RS";"CAPAO BONITO DO SUL";55;1;5;61
2015;"CAPAO DA CANOA (RS)";"RS";"CAPAO DA CANOA";548;73;114;735
2015;"CAPAO DO CIPO (RS)";"RS";"CAPAO DO CIPO";123;5;13;141
2015;"CAPAO DO LEAO (RS)";"RS";"CAPAO DO LEAO";509;25;34;568
2015;"CAPELA DE SANTANA (RS)";"RS";"CAPELA DE SANTANA";225;13;21;259
2015;"CAPITAO (RS)";"RS";"CAPITAO";74;5;9;88
2015;"CAPIVARI DO SUL (RS)";"RS";"CAPIVARI DO SUL";167;15;8;190
2015;"CARAA (RS)";"RS";"CARAA";114;9;23;146
2015;"CARAZINHO (RS)";"RS";"CARAZINHO";1403;86;210;1699
2015;"CARLOS BARBOSA (RS)";"RS";"CARLOS BARBOSA";892;50;144;1086
2015;"CARLOS GOMES (RS)";"RS";"CARLOS GOMES";41;2;10;53
2015;"CASCA (RS)";"RS";"CASCA";427;20;39;486
2015;"CASEIROS (RS)";"RS";"CASEIROS";176;8;18;202
2015;"CATUIPE (RS)";"RS";"CATUIPE";388;10;35;433
2015;"CAXIAS DO SUL (RS)";"RS";"CAXIAS DO SUL";9381;1529;1779;12689
2015;"CENTENARIO (RS)";"RS";"CENTENARIO";112;7;12;131
2015;"CERRITO (RS)";"RS";"CERRITO";235;15;13;263
2015;"CERRO BRANCO (RS)";"RS";"CERRO BRANCO";70;10;20;100
2015;"CERRO GRANDE (RS)";"RS";"CERRO GRANDE";55;1;15;71
2015;"CERRO GRANDE DO SUL (RS)";"RS";"CERRO GRANDE DO SUL";301;20;27;348
2015;"CERRO LARGO (RS)";"RS";"CERRO LARGO";381;11;41;433
2015;"CHAPADA (RS)";"RS";"CHAPADA";392;44;32;468
2015;"CHARQUEADAS (RS)";"RS";"CHARQUEADAS";404;85;134;623
2015;"CHARRUA (RS)";"RS";"CHARRUA";102;5;12;119
2015;"CHIAPETTA (RS)";"RS";"CHIAPETTA";160;9;15;184
2015;"CHUI (RS)";"RS";"CHUI";121;13;8;142
2015;"CHUVISCA (RS)";"RS";"CHUVISCA";142;8;36;186
2015;"CIDREIRA (RS)";"RS";"CIDREIRA";111;15;37;163
2015;"CIRIACO (RS)";"RS";"CIRIACO";167;17;21;205
2015;"COLINAS (RS)";"RS";"COLINAS";68;10;9;87
2015;"COLORADO (RS)";"RS";"COLORADO";241;16;13;270
2015;"CONDOR (RS)";"RS";"CONDOR";281;15;33;329
2015;"CONSTANTINA (RS)";"RS";"CONSTANTINA";408;19;94;521
2015;"COQUEIRO BAIXO (RS)";"RS";"COQUEIRO BAIXO";20;4;5;29
2015;"COQUEIROS DO SUL (RS)";"RS";"COQUEIROS DO SUL";142;5;10;157
2015;"CORONEL BARROS (RS)";"RS";"CORONEL BARROS";118;0;9;127
2015;"CORONEL BICACO (RS)";"RS";"CORONEL BICACO";246;18;26;290
2015;"CORONEL PILAR (RS)";"RS";"CORONEL PILAR";223;8;7;238
2015;"COTIPORA (RS)";"RS";"COTIPORA";250;8;16;274
2015;"COXILHA (RS)";"RS";"COXILHA";124;7;15;146
2015;"CRISSIUMAL (RS)";"RS";"CRISSIUMAL";354;17;55;426
2015;"CRISTAL (RS)";"RS";"CRISTAL";240;12;58;310
2015;"CRISTAL DO SUL (RS)";"RS";"CRISTAL DO SUL";48;11;20;79
2015;"CRUZ ALTA (RS)";"RS";"CRUZ ALTA";1248;104;131;1483
2015;"CRUZALTENSE (RS)";"RS";"CRUZALTENSE";74;8;10;92
2015;"CRUZEIRO DO SUL (RS)";"RS";"CRUZEIRO DO SUL";473;13;21;507
2015;"DAVID CANABARRO (RS)";"RS";"DAVID CANABARRO";173;10;26;209
2015;"DERRUBADAS (RS)";"RS";"DERRUBADAS";107;10;15;132
2015;"DEZESSEIS DE NOVEMBRO (RS)";"RS";"DEZESSEIS DE NOVEMBRO";61;5;8;74
2015;"DILERMANDO DE AGUIAR (RS)";"RS";"DILERMANDO DE AGUIAR";51;2;29;82
2015;"DOIS IRMAOS (RS)";"RS";"DOIS IRMAOS";496;23;118;637
2015;"DOIS IRMAOS DAS MISSOES (RS)";"RS";"DOIS IRMAOS DAS MISSOES";66;7;7;80
2015;"DOIS LAJEADOS (RS)";"RS";"DOIS LAJEADOS";154;5;18;177
2015;"DOM FELICIANO (RS)";"RS";"DOM FELICIANO";256;13;79;348
2015;"DOM PEDRITO (RS)";"RS";"DOM PEDRITO";628;41;50;719
2015;"DOM PEDRO DE ALCANTARA (RS)";"RS";"DOM PEDRO DE ALCANTARA";117;4;7;128
2015;"DONA FRANCISCA (RS)";"RS";"DONA FRANCISCA";56;3;10;69
2015;"DOUTOR MAURICIO CARDOSO (RS)";"RS";"DOUTOR MAURICIO CARDOSO";216;14;21;251
2015;"DOUTOR RICARDO (RS)";"RS";"DOUTOR RICARDO";76;7;7;90
2015;"ELDORADO DO SUL (RS)";"RS";"ELDORADO DO SUL";780;47;66;893
2015;"ENCANTADO (RS)";"RS";"ENCANTADO";774;59;119;952
2015;"ENCRUZILHADA DO SUL (RS)";"RS";"ENCRUZILHADA DO SUL";431;28;199;658
2015;"ENGENHO VELHO (RS)";"RS";"ENGENHO VELHO";35;2;14;51
2015;"ENTRE IJUIS (RS)";"RS";"ENTRE IJUIS";394;10;27;431
2015;"ENTRE RIOS DO SUL (RS)";"RS";"ENTRE RIOS DO SUL";65;14;19;98
2015;"EREBANGO (RS)";"RS";"EREBANGO";127;3;7;137
2015;"ERECHIM (RS)";"RS";"ERECHIM";2216;336;538;3090
2015;"ERNESTINA (RS)";"RS";"ERNESTINA";174;25;19;218
2015;"ERVAL GRANDE (RS)";"RS";"ERVAL GRANDE";132;28;26;186
2015;"ERVAL SECO (RS)";"RS";"ERVAL SECO";162;7;38;207
2015;"ESMERALDA (RS)";"RS";"ESMERALDA";97;3;14;114
2015;"ESPERANCA DO SUL (RS)";"RS";"ESPERANCA DO SUL";60;3;13;76
2015;"ESPUMOSO (RS)";"RS";"ESPUMOSO";803;38;86;927
2015;"ESTACAO (RS)";"RS";"ESTACAO";244;14;19;277
2015;"ESTANCIA VELHA (RS)";"RS";"ESTANCIA VELHA";866;77;128;1071
2015;"ESTEIO (RS)";"RS";"ESTEIO";1124;135;325;1584
2015;"ESTRELA (RS)";"RS";"ESTRELA";1132;45;74;1251
2015;"ESTRELA VELHA (RS)";"RS";"ESTRELA VELHA";147;7;20;174
2015;"EUGENIO DE CASTRO (RS)";"RS";"EUGENIO DE CASTRO";102;10;13;125
2015;"FAGUNDES VARELA (RS)";"RS";"FAGUNDES VARELA";125;3;22;150
2015;"FARROUPILHA (RS)";"RS";"FARROUPILHA";2305;269;219;2793
2015;"FAXINAL DO SOTURNO (RS)";"RS";"FAXINAL DO SOTURNO";156;5;16;177
2015;"FAXINALZINHO (RS)";"RS";"FAXINALZINHO";60;8;14;82
2015;"FAZENDA VILANOVA (RS)";"RS";"FAZENDA VILANOVA";150;11;22;183
2015;"FELIZ (RS)";"RS";"FELIZ";473;34;87;594
2015;"FLORES DA CUNHA (RS)";"RS";"FLORES DA CUNHA";1573;78;136;1787
2015;"FLORIANO PEIXOTO (RS)";"RS";"FLORIANO PEIXOTO";74;14;19;107
2015;"FONTOURA XAVIER (RS)";"RS";"FONTOURA XAVIER";236;27;48;311
2015;"FORMIGUEIRO (RS)";"RS";"FORMIGUEIRO";183;2;25;210
2015;"FORQUETINHA (RS)";"RS";"FORQUETINHA";76;5;3;84
2015;"FORTALEZA DOS VALOS (RS)";"RS";"FORTALEZA DOS VALOS";279;5;23;307
2015;"FREDERICO WESTPHALEN (RS)";"RS";"FREDERICO WESTPHALEN";834;38;99;971
2015;"GARIBALDI (RS)";"RS";"GARIBALDI";1457;94;138;1689
2015;"GARRUCHOS (RS)";"RS";"GARRUCHOS";50;9;17;76
2015;"GAURAMA (RS)";"RS";"GAURAMA";237;24;25;286
2015;"GENERAL CAMARA (RS)";"RS";"GENERAL CAMARA";98;11;36;145
2015;"GENTIL (RS)";"RS";"GENTIL";107;9;17;133
2015;"GETULIO VARGAS (RS)";"RS";"GETULIO VARGAS";532;38;45;615
2015;"GIRUA (RS)";"RS";"GIRUA";590;49;52;691
2015;"GLORINHA (RS)";"RS";"GLORINHA";224;30;17;271
2015;"GRAMADO (RS)";"RS";"GRAMADO";724;176;149;1049
2015;"GRAMADO DOS LOUREIROS (RS)";"RS";"GRAMADO DOS LOUREIROS";45;4;12;61
2015;"GRAMADO XAVIER (RS)";"RS";"GRAMADO XAVIER";57;5;9;71
2015;"GRAVATAI (RS)";"RS";"GRAVATAI";3646;563;694;4903
2015;"GUABIJU (RS)";"RS";"GUABIJU";49;6;7;62
2015;"GUAIBA (RS)";"RS";"GUAIBA";1111;222;489;1822
2015;"GUAPORE (RS)";"RS";"GUAPORE";504;43;79;626
2015;"GUARANI DAS MISSOES (RS)";"RS";"GUARANI DAS MISSOES";280;8;32;320
2015;"HARMONIA (RS)";"RS";"HARMONIA";246;9;10;265
2015;"HERVAL (RS)";"RS";"HERVAL";135;15;12;162
2015;"HERVEIRAS (RS)";"RS";"HERVEIRAS";65;3;3;71
2015;"HORIZONTINA (RS)";"RS";"HORIZONTINA";413;34;62;509
2015;"HULHA NEGRA (RS)";"RS";"HULHA NEGRA";97;7;29;133
2015;"HUMAITA (RS)";"RS";"HUMAITA";167;11;9;187
2015;"IBARAMA (RS)";"RS";"IBARAMA";100;6;19;125
2015;"IBIACA (RS)";"RS";"IBIACA";288;9;28;325
2015;"IBIRAIARAS (RS)";"RS";"IBIRAIARAS";494;10;31;535
2015;"IBIRAPUITA (RS)";"RS";"IBIRAPUITA";151;15;56;222
2015;"IBIRUBA (RS)";"RS";"IBIRUBA";1031;56;100;1187
2015;"IGREJINHA (RS)";"RS";"IGREJINHA";481;36;106;623
2015;"IJUI (RS)";"RS";"IJUI";2016;149;137;2302
2015;"ILOPOLIS (RS)";"RS";"ILOPOLIS";231;7;13;251
2015;"IMBE (RS)";"RS";"IMBE";316;25;63;404
2015;"IMIGRANTE (RS)";"RS";"IMIGRANTE";104;21;19;144
2015;"INDEPENDENCIA (RS)";"RS";"INDEPENDENCIA";267;16;47;330
2015;"INHACORA (RS)";"RS";"INHACORA";72;7;8;87
2015;"IPE (RS)";"RS";"IPE";307;33;30;370
2015;"IPIRANGA DO SUL (RS)";"RS";"IPIRANGA DO SUL";135;10;16;161
2015;"IRAI (RS)";"RS";"IRAI";146;8;27;181
2015;"ITAARA (RS)";"RS";"ITAARA";128;6;22;156
2015;"ITACURUBI (RS)";"RS";"ITACURUBI";50;9;13;72
2015;"ITAPUCA (RS)";"RS";"ITAPUCA";67;5;10;82
2015;"ITAQUI (RS)";"RS";"ITAQUI";700;28;91;819
2015;"ITATI (RS)";"RS";"ITATI";78;5;11;94
2015;"ITATIBA DO SUL (RS)";"RS";"ITATIBA DO SUL";85;14;10;109
2015;"IVORA (RS)";"RS";"IVORA";79;5;7;91
2015;"IVOTI (RS)";"RS";"IVOTI";579;47;122;748
2015;"JABOTICABA (RS)";"RS";"JABOTICABA";90;7;26;123
2015;"JACUIZINHO (RS)";"RS";"JACUIZINHO";75;4;18;97
2015;"JACUTINGA (RS)";"RS";"JACUTINGA";125;11;10;146
2015;"JAGUARAO (RS)";"RS";"JAGUARAO";331;19;56;406
2015;"JAGUARI (RS)";"RS";"JAGUARI";314;19;63;396
2015;"JAQUIRANA (RS)";"RS";"JAQUIRANA";141;9;14;164
2015;"JARI (RS)";"RS";"JARI";89;7;15;111
2015;"JOIA (RS)";"RS";"JOIA";356;17;47;420
2015;"JULIO DE CASTILHOS (RS)";"RS";"JULIO DE CASTILHOS";673;26;65;764
2015;"LAGOA BONITA DO SUL (RS)";"RS";"LAGOA BONITA DO SUL";59;7;15;81
2015;"LAGOA DOS TRES CANTOS (RS)";"RS";"LAGOA DOS TRES CANTOS";113;6;5;124
2015;"LAGOA VERMELHA (RS)";"RS";"LAGOA VERMELHA";724;71;86;881
2015;"LAGOAO (RS)";"RS";"LAGOAO";99;8;43;150
2015;"LAJEADO (RS)";"RS";"LAJEADO";2262;177;282;2721
2015;"LAJEADO DO BUGRE (RS)";"RS";"LAJEADO DO BUGRE";32;4;12;48
2015;"LAVRAS DO SUL (RS)";"RS";"LAVRAS DO SUL";108;10;26;144
2015;"LIBERATO SALZANO (RS)";"RS";"LIBERATO SALZANO";132;10;31;173
2015;"LINDOLFO COLLOR (RS)";"RS";"LINDOLFO COLLOR";140;11;17;168
2015;"LINHA NOVA (RS)";"RS";"LINHA NOVA";84;9;5;98
2015;"MACAMBARA (RS)";"RS";"MACAMBARA";44;3;37;84
2015;"MACHADINHO (RS)";"RS";"MACHADINHO";133;12;26;171
2015;"MAMPITUBA (RS)";"RS";"MAMPITUBA";32;2;13;47
2015;"MANOEL VIANA (RS)";"RS";"MANOEL VIANA";178;8;17;203
2015;"MAQUINE (RS)";"RS";"MAQUINE";261;14;22;297
2015;"MARATA (RS)";"RS";"MARATA";126;11;23;160
2015;"MARAU (RS)";"RS";"MARAU";1220;110;186;1516
2015;"MARCELINO RAMOS (RS)";"RS";"MARCELINO RAMOS";134;22;31;187
2015;"MARIANA PIMENTEL (RS)";"RS";"MARIANA PIMENTEL";147;11;31;189
2015;"MARIANO MORO (RS)";"RS";"MARIANO MORO";74;16;11;101
2015;"MARQUES DE SOUZA (RS)";"RS";"MARQUES DE SOUZA";142;14;41;197
2015;"MATA (RS)";"RS";"MATA";114;8;23;145
2015;"MATO CASTELHANO (RS)";"RS";"MATO CASTELHANO";143;14;22;179
2015;"MATO LEITAO (RS)";"RS";"MATO LEITAO";149;12;11;172
2015;"MATO QUEIMADO (RS)";"RS";"MATO QUEIMADO";92;7;7;106
2015;"MAXIMILIANO DE ALMEIDA (RS)";"RS";"MAXIMILIANO DE ALMEIDA";146;16;79;241
2015;"MINAS DO LEAO (RS)";"RS";"MINAS DO LEAO";109;12;33;154
2015;"MIRAGUAI (RS)";"RS";"MIRAGUAI";124;3;29;156
2015;"MONTAURI (RS)";"RS";"MONTAURI";70;4;6;80
2015;"MONTE ALEGRE DOS CAMPOS (RS)";"RS";"MONTE ALEGRE DOS CAMPOS";94;3;27;124
2015;"MONTE BELO DO SUL (RS)";"RS";"MONTE BELO DO SUL";246;6;22;274
2015;"MONTENEGRO (RS)";"RS";"MONTENEGRO";1421;171;188;1780
2015;"MORMACO (RS)";"RS";"MORMACO";106;5;12;123
2015;"MORRINHOS DO SUL (RS)";"RS";"MORRINHOS DO SUL";160;2;7;169
2015;"MORRO REDONDO (RS)";"RS";"MORRO REDONDO";250;5;20;275
2015;"MORRO REUTER (RS)";"RS";"MORRO REUTER";197;12;22;231
2015;"MOSTARDAS (RS)";"RS";"MOSTARDAS";344;16;61;421
2015;"MUCUM (RS)";"RS";"MUCUM";90;12;18;120
2015;"MUITOS CAPOES (RS)";"RS";"MUITOS CAPOES";90;5;6;101
2015;"MULITERNO (RS)";"RS";"MULITERNO";113;3;10;126
2015;"NAO ME TOQUE (RS)";"RS";"NAO ME TOQUE";621;48;72;741
2015;"NICOLAU VERGUEIRO (RS)";"RS";"NICOLAU VERGUEIRO";108;8;15;131
2015;"NONOAI (RS)";"RS";"NONOAI";250;19;57;326
2015;"NOVA ALVORADA (RS)";"RS";"NOVA ALVORADA";188;7;19;214
2015;"NOVA ARACA (RS)";"RS";"NOVA ARACA";164;17;43;224
2015;"NOVA BASSANO (RS)";"RS";"NOVA BASSANO";556;40;79;675
2015;"NOVA BOA VISTA (RS)";"RS";"NOVA BOA VISTA";86;9;11;106
2015;"NOVA BRESCIA (RS)";"RS";"NOVA BRESCIA";142;12;13;167
2015;"NOVA CANDELARIA (RS)";"RS";"NOVA CANDELARIA";84;7;6;97
2015;"NOVA ESPERANCA DO SUL (RS)";"RS";"NOVA ESPERANCA DO SUL";97;9;35;141
2015;"NOVA HARTZ (RS)";"RS";"NOVA HARTZ";195;23;98;316
2015;"NOVA PADUA (RS)";"RS";"NOVA PADUA";345;3;6;354
2015;"NOVA PALMA (RS)";"RS";"NOVA PALMA";289;14;37;340
2015;"NOVA PETROPOLIS (RS)";"RS";"NOVA PETROPOLIS";588;46;70;704
2015;"NOVA PRATA (RS)";"RS";"NOVA PRATA";678;25;79;782
2015;"NOVA RAMADA (RS)";"RS";"NOVA RAMADA";127;10;13;150
2015;"NOVA ROMA DO SUL (RS)";"RS";"NOVA ROMA DO SUL";321;7;26;354
2015;"NOVA SANTA RITA (RS)";"RS";"NOVA SANTA RITA";1052;58;59;1169
2015;"NOVO BARREIRO (RS)";"RS";"NOVO BARREIRO";163;9;14;186
2015;"NOVO CABRAIS (RS)";"RS";"NOVO CABRAIS";108;4;12;124
2015;"NOVO HAMBURGO (RS)";"RS";"NOVO HAMBURGO";3300;333;533;4166
2015;"NOVO MACHADO (RS)";"RS";"NOVO MACHADO";191;20;16;227
2015;"NOVO TIRADENTES (RS)";"RS";"NOVO TIRADENTES";43;3;8;54
2015;"NOVO XINGU (RS)";"RS";"NOVO XINGU";50;10;10;70
2015;"OSORIO (RS)";"RS";"OSORIO";1002;66;114;1182
2015;"PAIM FILHO (RS)";"RS";"PAIM FILHO";131;3;27;161
2015;"PALMARES DO SUL (RS)";"RS";"PALMARES DO SUL";199;20;47;266
2015;"PALMEIRA DAS MISSOES (RS)";"RS";"PALMEIRA DAS MISSOES";1040;31;104;1175
2015;"PALMITINHO (RS)";"RS";"PALMITINHO";211;18;55;284
2015;"PANAMBI (RS)";"RS";"PANAMBI";1085;71;131;1287
2015;"PANTANO GRANDE (RS)";"RS";"PANTANO GRANDE";341;10;33;384
2015;"PARAI (RS)";"RS";"PARAI";590;9;17;616
2015;"PARAISO DO SUL (RS)";"RS";"PARAISO DO SUL";103;7;21;131
2015;"PARECI NOVO (RS)";"RS";"PARECI NOVO";456;8;18;482
2015;"PAROBE (RS)";"RS";"PAROBE";621;81;176;878
2015;"PASSA SETE (RS)";"RS";"PASSA SETE";100;5;33;138
2015;"PASSO DO SOBRADO (RS)";"RS";"PASSO DO SOBRADO";153;7;47;207
2015;"PASSO FUNDO (RS)";"RS";"PASSO FUNDO";3687;249;388;4324
2015;"PAULO BENTO (RS)";"RS";"PAULO BENTO";87;16;10;113
2015;"PAVERAMA (RS)";"RS";"PAVERAMA";210;41;44;295
2015;"PEDRAS ALTAS (RS)";"RS";"PEDRAS ALTAS";23;15;8;46
2015;"PEDRO OSORIO (RS)";"RS";"PEDRO OSORIO";114;10;33;157
2015;"PEJUCARA (RS)";"RS";"PEJUCARA";244;4;18;266
2015;"PELOTAS (RS)";"RS";"PELOTAS";5752;432;1183;7367
2015;"PICADA CAFE (RS)";"RS";"PICADA CAFE";116;22;60;198
2015;"PINHAL (RS)";"RS";"PINHAL";104;2;10;116
2015;"PINHAL DA SERRA (RS)";"RS";"PINHAL DA SERRA";58;11;21;90
2015;"PINHAL GRANDE (RS)";"RS";"PINHAL GRANDE";128;13;28;169
2015;"PINHEIRINHO DO VALE (RS)";"RS";"PINHEIRINHO DO VALE";60;5;22;87
2015;"PINHEIRO MACHADO (RS)";"RS";"PINHEIRO MACHADO";162;10;57;229
2015;"PINTO BANDEIRA (RS)";"RS";"PINTO BANDEIRA";83;11;5;99
2015;"PIRAPO (RS)";"RS";"PIRAPO";46;8;13;67
2015;"PIRATINI (RS)";"RS";"PIRATINI";293;51;129;473
2015;"PLANALTO (RS)";"RS";"PLANALTO";238;10;40;288
2015;"POCO DAS ANTAS (RS)";"RS";"POCO DAS ANTAS";115;10;16;141
2015;"PONTAO (RS)";"RS";"PONTAO";158;4;16;178
2015;"PONTE PRETA (RS)";"RS";"PONTE PRETA";78;4;14;96
2015;"PORTAO (RS)";"RS";"PORTAO";1565;114;113;1792
2015;"PORTO ALEGRE (RS)";"RS";"PORTO ALEGRE";16321;2413;5210;23944
2015;"PORTO LUCENA (RS)";"RS";"PORTO LUCENA";108;15;17;140
2015;"PORTO MAUA (RS)";"RS";"PORTO MAUA";60;7;8;75
2015;"PORTO VERA CRUZ (RS)";"RS";"PORTO VERA CRUZ";17;4;10;31
2015;"PORTO XAVIER (RS)";"RS";"PORTO XAVIER";200;22;42;264
2015;"POUSO NOVO (RS)";"RS";"POUSO NOVO";49;5;9;63
2015;"PRESIDENTE LUCENA (RS)";"RS";"PRESIDENTE LUCENA";182;7;17;206
2015;"PROGRESSO (RS)";"RS";"PROGRESSO";135;13;30;178
2015;"PROTASIO ALVES (RS)";"RS";"PROTASIO ALVES";54;7;8;69
2015;"PUTINGA (RS)";"RS";"PUTINGA";129;10;9;148
2015;"QUARAI (RS)";"RS";"QUARAI";223;27;55;305
2015;"QUATRO IRMAOS (RS)";"RS";"QUATRO IRMAOS";63;12;7;82
2015;"QUEVEDOS (RS)";"RS";"QUEVEDOS";50;7;10;67
2015;"QUINZE DE NOVEMBRO (RS)";"RS";"QUINZE DE NOVEMBRO";223;25;29;277
2015;"REDENTORA (RS)";"RS";"REDENTORA";123;20;22;165
2015;"RELVADO (RS)";"RS";"RELVADO";49;10;4;63
2015;"RESTINGA SECA (RS)";"RS";"RESTINGA SECA";345;14;63;422
2015;"RIO DOS INDIOS (RS)";"RS";"RIO DOS INDIOS";87;6;30;123
2015;"RIO GRANDE (RS)";"RS";"RIO GRANDE";2446;266;839;3551
2015;"RIO PARDO (RS)";"RS";"RIO PARDO";538;60;102;700
2015;"RIOZINHO (RS)";"RS";"RIOZINHO";55;13;27;95
2015;"ROCA SALES (RS)";"RS";"ROCA SALES";178;23;43;244
2015;"RODEIO BONITO (RS)";"RS";"RODEIO BONITO";181;6;30;217
2015;"ROLADOR (RS)";"RS";"ROLADOR";65;4;6;75
2015;"ROLANTE (RS)";"RS";"ROLANTE";301;34;104;439
2015;"RONDA ALTA (RS)";"RS";"RONDA ALTA";315;18;44;377
2015;"RONDINHA (RS)";"RS";"RONDINHA";206;12;22;240
2015;"ROQUE GONZALES (RS)";"RS";"ROQUE GONZALES";153;7;27;187
2015;"ROSARIO DO SUL (RS)";"RS";"ROSARIO DO SUL";558;57;98;713
2015;"SAGRADA FAMILIA (RS)";"RS";"SAGRADA FAMILIA";49;4;7;60
2015;"SALDANHA MARINHO (RS)";"RS";"SALDANHA MARINHO";169;11;7;187
2015;"SALTO DO JACUI (RS)";"RS";"SALTO DO JACUI";247;23;34;304
2015;"SALVADOR DAS MISSOES (RS)";"RS";"SALVADOR DAS MISSOES";128;4;8;140
2015;"SALVADOR DO SUL (RS)";"RS";"SALVADOR DO SUL";319;24;32;375
2015;"SANANDUVA (RS)";"RS";"SANANDUVA";731;31;75;837
2015;"SANTA BARBARA DO SUL (RS)";"RS";"SANTA BARBARA DO SUL";390;16;37;443
2015;"SANTA CECILIA DO SUL (RS)";"RS";"SANTA CECILIA DO SUL";70;5;17;92
2015;"SANTA CLARA DO SUL (RS)";"RS";"SANTA CLARA DO SUL";138;29;15;182
2015;"SANTA CRUZ DO SUL (RS)";"RS";"SANTA CRUZ DO SUL";2337;176;621;3134
2015;"SANTA MARGARIDA DO SUL (RS)";"RS";"SANTA MARGARIDA DO SUL";57;3;6;66
2015;"SANTA MARIA (RS)";"RS";"SANTA MARIA";3749;401;1085;5235
2015;"SANTA MARIA DO HERVAL (RS)";"RS";"SANTA MARIA DO HERVAL";249;28;54;331
2015;"SANTA ROSA (RS)";"RS";"SANTA ROSA";1741;103;210;2054
2015;"SANTA TEREZA (RS)";"RS";"SANTA TEREZA";101;6;5;112
2015;"SANTA VITORIA DO PALMAR (RS)";"RS";"SANTA VITORIA DO PALMAR";637;22;73;732
2015;"SANTANA DA BOA VISTA (RS)";"RS";"SANTANA DA BOA VISTA";91;18;48;157
2015;"SANTANA DO LIVRAMENTO (RS)";"RS";"SANTANA DO LIVRAMENTO";876;92;233;1201
2015;"SANTIAGO (RS)";"RS";"SANTIAGO";961;108;103;1172
2015;"SANTO ANGELO (RS)";"RS";"SANTO ANGELO";1416;94;129;1639
2015;"SANTO ANTONIO DA PATRULHA (RS)";"RS";"SANTO ANTONIO DA PATRULHA";1022;60;204;1286
2015;"SANTO ANTONIO DAS MISSOES (RS)";"RS";"SANTO ANTONIO DAS MISSOES";260;54;53;367
2015;"SANTO ANTONIO DO PALMA (RS)";"RS";"SANTO ANTONIO DO PALMA";71;5;13;89
2015;"SANTO ANTONIO DO PLANALTO (RS)";"RS";"SANTO ANTONIO DO PLANALTO";97;4;9;110
2015;"SANTO AUGUSTO (RS)";"RS";"SANTO AUGUSTO";568;46;33;647
2015;"SANTO CRISTO (RS)";"RS";"SANTO CRISTO";535;26;52;613
2015;"SANTO EXPEDITO DO SUL (RS)";"RS";"SANTO EXPEDITO DO SUL";118;2;13;133
2015;"SAO BORJA (RS)";"RS";"SAO BORJA";1181;67;121;1369
2015;"SAO DOMINGOS DO SUL (RS)";"RS";"SAO DOMINGOS DO SUL";118;9;16;143
2015;"SAO FRANCISCO DE ASSIS (RS)";"RS";"SAO FRANCISCO DE ASSIS";361;40;122;523
2015;"SAO FRANCISCO DE PAULA (RS)";"RS";"SAO FRANCISCO DE PAULA";556;41;81;678
2015;"SAO GABRIEL (RS)";"RS";"SAO GABRIEL";952;44;131;1127
2015;"SAO JERONIMO (RS)";"RS";"SAO JERONIMO";304;32;115;451
2015;"SAO JOAO DA URTIGA (RS)";"RS";"SAO JOAO DA URTIGA";161;7;21;189
2015;"SAO JOAO DO POLESINE (RS)";"RS";"SAO JOAO DO POLESINE";88;1;7;96
2015;"SAO JORGE (RS)";"RS";"SAO JORGE";149;9;19;177
2015;"SAO JOSE DAS MISSOES (RS)";"RS";"SAO JOSE DAS MISSOES";45;5;10;60
2015;"SAO JOSE DO HERVAL (RS)";"RS";"SAO JOSE DO HERVAL";83;3;13;99
2015;"SAO JOSE DO HORTENCIO (RS)";"RS";"SAO JOSE DO HORTENCIO";202;12;32;246
2015;"SAO JOSE DO INHACORA (RS)";"RS";"SAO JOSE DO INHACORA";55;5;9;69
2015;"SAO JOSE DO NORTE (RS)";"RS";"SAO JOSE DO NORTE";402;15;114;531
2015;"SAO JOSE DO OURO (RS)";"RS";"SAO JOSE DO OURO";348;7;46;401
2015;"SAO JOSE DO SUL (RS)";"RS";"SAO JOSE DO SUL";148;7;15;170
2015;"SAO JOSE DOS AUSENTES (RS)";"RS";"SAO JOSE DOS AUSENTES";126;8;23;157
2015;"SAO LEOPOLDO (RS)";"RS";"SAO LEOPOLDO";2329;292;389;3010
2015;"SAO LOURENCO DO SUL (RS)";"RS";"SAO LOURENCO DO SUL";1027;55;160;1242
2015;"SAO LUIZ GONZAGA (RS)";"RS";"SAO LUIZ GONZAGA";691;71;95;857
2015;"SAO MARCOS (RS)";"RS";"SAO MARCOS";796;29;129;954
2015;"SAO MARTINHO (RS)";"RS";"SAO MARTINHO";235;8;22;265
2015;"SAO MARTINHO DA SERRA (RS)";"RS";"SAO MARTINHO DA SERRA";58;4;7;69
2015;"SAO MIGUEL DAS MISSOES (RS)";"RS";"SAO MIGUEL DAS MISSOES";265;26;40;331
2015;"SAO NICOLAU (RS)";"RS";"SAO NICOLAU";87;11;13;111
2015;"SAO PAULO DAS MISSOES (RS)";"RS";"SAO PAULO DAS MISSOES";123;8;32;163
2015;"SAO PEDRO DA SERRA (RS)";"RS";"SAO PEDRO DA SERRA";111;12;16;139
2015;"SAO PEDRO DAS MISSOES (RS)";"RS";"SAO PEDRO DAS MISSOES";44;8;6;58
2015;"SAO PEDRO DO BUTIA (RS)";"RS";"SAO PEDRO DO BUTIA";140;2;16;158
2015;"SAO PEDRO DO SUL (RS)";"RS";"SAO PEDRO DO SUL";316;50;47;413
2015;"SAO SEBASTIAO DO CAI (RS)";"RS";"SAO SEBASTIAO DO CAI";794;33;68;895
2015;"SAO SEPE (RS)";"RS";"SAO SEPE";494;54;118;666
2015;"SAO VALENTIM (RS)";"RS";"SAO VALENTIM";66;15;14;95
2015;"SAO VALENTIM DO SUL (RS)";"RS";"SAO VALENTIM DO SUL";83;6;9;98
2015;"SAO VALERIO DO SUL (RS)";"RS";"SAO VALERIO DO SUL";47;3;9;59
2015;"SAO VENDELINO (RS)";"RS";"SAO VENDELINO";91;11;11;113
2015;"SAO VICENTE DO SUL (RS)";"RS";"SAO VICENTE DO SUL";153;9;53;215
2015;"SAPIRANGA (RS)";"RS";"SAPIRANGA";958;106;181;1245
2015;"SAPUCAIA DO SUL (RS)";"RS";"SAPUCAIA DO SUL";1749;146;138;2033
2015;"SARANDI (RS)";"RS";"SARANDI";636;33;75;744
2015;"SEBERI (RS)";"RS";"SEBERI";344;13;52;409
2015;"SEDE NOVA (RS)";"RS";"SEDE NOVA";106;11;14;131
2015;"SEGREDO (RS)";"RS";"SEGREDO";200;6;51;257
2015;"SELBACH (RS)";"RS";"SELBACH";362;16;23;401
2015;"SENADOR SALGADO FILHO (RS)";"RS";"SENADOR SALGADO FILHO";148;10;12;170
2015;"SENTINELA DO SUL (RS)";"RS";"SENTINELA DO SUL";168;3;17;188
2015;"SERAFINA CORREA (RS)";"RS";"SERAFINA CORREA";383;51;74;508
2015;"SERIO (RS)";"RS";"SERIO";59;7;6;72
2015;"SERTAO (RS)";"RS";"SERTAO";277;17;42;336
2015;"SERTAO SANTANA (RS)";"RS";"SERTAO SANTANA";170;3;26;199
2015;"SETE DE SETEMBRO (RS)";"RS";"SETE DE SETEMBRO";84;4;12;100
2015;"SEVERIANO DE ALMEIDA (RS)";"RS";"SEVERIANO DE ALMEIDA";115;15;13;143
2015;"SILVEIRA MARTINS (RS)";"RS";"SILVEIRA MARTINS";135;3;9;147
2015;"SINIMBU (RS)";"RS";"SINIMBU";145;4;6;155
2015;"SOBRADINHO (RS)";"RS";"SOBRADINHO";339;18;54;411
2015;"SOLEDADE (RS)";"RS";"SOLEDADE";658;44;134;836
2015;"TABAI (RS)";"RS";"TABAI";232;21;18;271
2015;"TAPEJARA (RS)";"RS";"TAPEJARA";853;35;115;1003
2015;"TAPERA (RS)";"RS";"TAPERA";437;29;31;497
2015;"TAPES (RS)";"RS";"TAPES";305;22;36;363
2015;"TAQUARA (RS)";"RS";"TAQUARA";867;58;277;1202
2015;"TAQUARI (RS)";"RS";"TAQUARI";472;43;166;681
2015;"TAQUARUCU DO SUL (RS)";"RS";"TAQUARUCU DO SUL";82;2;14;98
2015;"TAVARES (RS)";"RS";"TAVARES";158;16;23;197
2015;"TENENTE PORTELA (RS)";"RS";"TENENTE PORTELA";311;18;55;384
2015;"TERRA DE AREIA (RS)";"RS";"TERRA DE AREIA";340;12;31;383
2015;"TEUTONIA (RS)";"RS";"TEUTONIA";764;39;108;911
2015;"TIO HUGO (RS)";"RS";"TIO HUGO";136;7;15;158
2015;"TIRADENTES DO SUL (RS)";"RS";"TIRADENTES DO SUL";121;7;14;142
2015;"TOROPI (RS)";"RS";"TOROPI";66;11;17;94
2015;"TORRES (RS)";"RS";"TORRES";485;29;92;606
2015;"TRAMANDAI (RS)";"RS";"TRAMANDAI";708;76;145;929
2015;"TRAVESSEIRO (RS)";"RS";"TRAVESSEIRO";44;9;14;67
2015;"TRES ARROIOS (RS)";"RS";"TRES ARROIOS";112;12;5;129
2015;"TRES CACHOEIRAS (RS)";"RS";"TRES CACHOEIRAS";642;15;28;685
2015;"TRES COROAS (RS)";"RS";"TRES COROAS";298;39;78;415
2015;"TRES DE MAIO (RS)";"RS";"TRES DE MAIO";790;46;84;920
2015;"TRES FORQUILHAS (RS)";"RS";"TRES FORQUILHAS";104;3;7;114
2015;"TRES PALMEIRAS (RS)";"RS";"TRES PALMEIRAS";85;7;37;129
2015;"TRES PASSOS (RS)";"RS";"TRES PASSOS";515;28;139;682
2015;"TRINDADE DO SUL (RS)";"RS";"TRINDADE DO SUL";136;16;21;173
2015;"TRIUNFO (RS)";"RS";"TRIUNFO";594;141;269;1004
2015;"TUCUNDUVA (RS)";"RS";"TUCUNDUVA";265;14;15;294
2015;"TUNAS (RS)";"RS";"TUNAS";59;7;20;86
2015;"TUPANCI DO SUL (RS)";"RS";"TUPANCI DO SUL";65;4;15;84
2015;"TUPANCIRETA (RS)";"RS";"TUPANCIRETA";639;75;72;786
2015;"TUPANDI (RS)";"RS";"TUPANDI";117;32;42;191
2015;"TUPARENDI (RS)";"RS";"TUPARENDI";317;15;28;360
2015;"TURUCU (RS)";"RS";"TURUCU";112;7;13;132
2015;"UBIRETAMA (RS)";"RS";"UBIRETAMA";96;11;5;112
2015;"UNIAO DA SERRA (RS)";"RS";"UNIAO DA SERRA";62;3;9;74
2015;"UNISTALDA (RS)";"RS";"UNISTALDA";52;13;19;84
2015;"URUGUAIANA (RS)";"RS";"URUGUAIANA";1866;92;188;2146
2015;"VACARIA (RS)";"RS";"VACARIA";1803;176;537;2516
2015;"VALE DO SOL (RS)";"RS";"VALE DO SOL";210;12;53;275
2015;"VALE REAL (RS)";"RS";"VALE REAL";232;14;11;257
2015;"VALE VERDE (RS)";"RS";"VALE VERDE";64;5;10;79
2015;"VANINI (RS)";"RS";"VANINI";108;10;14;132
2015;"VENANCIO AIRES (RS)";"RS";"VENANCIO AIRES";1251;111;201;1563
2015;"VERA CRUZ (RS)";"RS";"VERA CRUZ";456;41;128;625
2015;"VERANOPOLIS (RS)";"RS";"VERANOPOLIS";966;42;74;1082
2015;"VESPASIANO CORREA (RS)";"RS";"VESPASIANO CORREA";119;9;11;139
2015;"VIADUTOS (RS)";"RS";"VIADUTOS";152;12;27;191
2015;"VIAMAO (RS)";"RS";"VIAMAO";2363;361;677;3401
2015;"VICENTE DUTRA (RS)";"RS";"VICENTE DUTRA";61;2;18;81
2015;"VICTOR GRAEFF (RS)";"RS";"VICTOR GRAEFF";184;15;8;207
2015;"VILA FLORES (RS)";"RS";"VILA FLORES";193;16;18;227
2015;"VILA LANGARO (RS)";"RS";"VILA LANGARO";119;7;15;141
2015;"VILA MARIA (RS)";"RS";"VILA MARIA";278;8;44;330
2015;"VILA NOVA DO SUL (RS)";"RS";"VILA NOVA DO SUL";108;10;13;131
2015;"VISTA ALEGRE (RS)";"RS";"VISTA ALEGRE";82;6;11;99
2015;"VISTA ALEGRE DO PRATA (RS)";"RS";"VISTA ALEGRE DO PRATA";46;10;5;61
2015;"VISTA GAUCHA (RS)";"RS";"VISTA GAUCHA";67;1;14;82
2015;"VITORIA DAS MISSOES (RS)";"RS";"VITORIA DAS MISSOES";132;1;18;151
2015;"WESTFALIA (RS)";"RS";"WESTFALIA";157;17;19;193
2015;"XANGRI LA (RS)";"RS";"XANGRI LA";220;17;16;253
2015;"ABDON BATISTA (SC)";"SC";"ABDON BATISTA";82;6;12;100
2015;"ABELARDO LUZ (SC)";"SC";"ABELARDO LUZ";429;21;106;556
2015;"AGROLANDIA (SC)";"SC";"AGROLANDIA";262;18;19;299
2015;"AGRONOMICA (SC)";"SC";"AGRONOMICA";176;6;12;194
2015;"AGUA DOCE (SC)";"SC";"AGUA DOCE";233;28;29;290
2015;"AGUAS DE CHAPECO (SC)";"SC";"AGUAS DE CHAPECO";90;9;33;132
2015;"AGUAS FRIAS (SC)";"SC";"AGUAS FRIAS";64;5;5;74
2015;"AGUAS MORNAS (SC)";"SC";"AGUAS MORNAS";298;5;17;320
2015;"ALFREDO WAGNER (SC)";"SC";"ALFREDO WAGNER";308;23;19;350
2015;"ALTO BELA VISTA (SC)";"SC";"ALTO BELA VISTA";65;10;9;84
2015;"ANCHIETA (SC)";"SC";"ANCHIETA";247;14;23;284
2015;"ANGELINA (SC)";"SC";"ANGELINA";246;19;16;281
2015;"ANITA GARIBALDI (SC)";"SC";"ANITA GARIBALDI";142;14;31;187
2015;"ANITAPOLIS (SC)";"SC";"ANITAPOLIS";118;5;14;137
2015;"ANTONIO CARLOS (SC)";"SC";"ANTONIO CARLOS";671;6;12;689
2015;"APIUNA (SC)";"SC";"APIUNA";200;27;22;249
2015;"ARABUTA (SC)";"SC";"ARABUTA";138;13;34;185
2015;"ARAQUARI (SC)";"SC";"ARAQUARI";812;74;63;949
2015;"ARARANGUA (SC)";"SC";"ARARANGUA";1375;79;174;1628
2015;"ARMAZEM (SC)";"SC";"ARMAZEM";286;15;19;320
2015;"ARROIO TRINTA (SC)";"SC";"ARROIO TRINTA";174;15;18;207
2015;"ARVOREDO (SC)";"SC";"ARVOREDO";48;17;6;71
2015;"ASCURRA (SC)";"SC";"ASCURRA";258;22;36;316
2015;"ATALANTA (SC)";"SC";"ATALANTA";98;1;6;105
2015;"AURORA (SC)";"SC";"AURORA";199;7;20;226
2015;"BALNEARIO ARROIO DO SILVA (SC)";"SC";"BALNEARIO ARROIO DO SILVA";142;7;16;165
2015;"BALNEARIO BARRA DO SUL (SC)";"SC";"BALNEARIO BARRA DO SUL";163;13;10;186
2015;"BALNEARIO CAMBORIU (SC)";"SC";"BALNEARIO CAMBORIU";962;262;306;1530
2015;"BALNEARIO DE PICARRAS (SC)";"SC";"BALNEARIO DE PICARRAS";342;50;50;442
2015;"BALNEARIO GAIVOTA (SC)";"SC";"BALNEARIO GAIVOTA";200;7;24;231
2015;"BALNEARIO RINCAO (SC)";"SC";"BALNEARIO RINCAO";91;10;6;107
2015;"BANDEIRANTE (SC)";"SC";"BANDEIRANTE";56;7;16;79
2015;"BARRA BONITA (SC)";"SC";"BARRA BONITA";37;7;10;54
2015;"BARRA VELHA (SC)";"SC";"BARRA VELHA";490;40;49;579
2015;"BELA VISTA DO TOLDO (SC)";"SC";"BELA VISTA DO TOLDO";98;7;43;148
2015;"BELMONTE (SC)";"SC";"BELMONTE";74;10;7;91
2015;"BENEDITO NOVO (SC)";"SC";"BENEDITO NOVO";308;48;28;384
2015;"BIGUACU (SC)";"SC";"BIGUACU";1348;86;126;1560
2015;"BLUMENAU (SC)";"SC";"BLUMENAU";5524;447;779;6750
2015;"BOCAINA DO SUL (SC)";"SC";"BOCAINA DO SUL";57;3;15;75
2015;"BOM JARDIM DA SERRA (SC)";"SC";"BOM JARDIM DA SERRA";145;13;27;185
2015;"BOM JESUS (SC)";"SC";"BOM JESUS";67;4;7;78
2015;"BOM JESUS DO OESTE (SC)";"SC";"BOM JESUS DO OESTE";73;6;9;88
2015;"BOM RETIRO (SC)";"SC";"BOM RETIRO";214;15;36;265
2015;"BOMBINHAS (SC)";"SC";"BOMBINHAS";179;53;27;259
2015;"BOTUVERA (SC)";"SC";"BOTUVERA";215;7;14;236
2015;"BRACO DO NORTE (SC)";"SC";"BRACO DO NORTE";1224;63;71;1358
2015;"BRACO DO TROMBUDO (SC)";"SC";"BRACO DO TROMBUDO";142;6;6;154
2015;"BRUNOPOLIS (SC)";"SC";"BRUNOPOLIS";106;7;11;124
2015;"BRUSQUE (SC)";"SC";"BRUSQUE";2533;173;178;2884
2015;"CACADOR (SC)";"SC";"CACADOR";2145;132;787;3064
2015;"CAIBI (SC)";"SC";"CAIBI";182;7;24;213
2015;"CALMON (SC)";"SC";"CALMON";40;14;26;80
2015;"CAMBORIU (SC)";"SC";"CAMBORIU";1155;60;42;1257
2015;"CAMPO ALEGRE (SC)";"SC";"CAMPO ALEGRE";453;16;15;484
2015;"CAMPO BELO DO SUL (SC)";"SC";"CAMPO BELO DO SUL";209;13;44;266
2015;"CAMPO ERE (SC)";"SC";"CAMPO ERE";309;12;33;354
2015;"CAMPOS NOVOS (SC)";"SC";"CAMPOS NOVOS";1093;101;118;1312
2015;"CANELINHA (SC)";"SC";"CANELINHA";528;15;11;554
2015;"CANOINHAS (SC)";"SC";"CANOINHAS";1370;74;154;1598
2015;"CAPAO ALTO (SC)";"SC";"CAPAO ALTO";72;10;16;98
2015;"CAPINZAL (SC)";"SC";"CAPINZAL";481;43;56;580
2015;"CAPIVARI DE BAIXO (SC)";"SC";"CAPIVARI DE BAIXO";369;18;26;413
2015;"CATANDUVAS (SC)";"SC";"CATANDUVAS";383;24;53;460
2015;"CAXAMBU DO SUL (SC)";"SC";"CAXAMBU DO SUL";110;3;16;129
2015;"CELSO RAMOS (SC)";"SC";"CELSO RAMOS";84;7;6;97
2015;"CERRO NEGRO (SC)";"SC";"CERRO NEGRO";74;7;19;100
2015;"CHAPADAO DO LAGEADO (SC)";"SC";"CHAPADAO DO LAGEADO";47;5;11;63
2015;"CHAPECO (SC)";"SC";"CHAPECO";4553;326;442;5321
2015;"COCAL DO SUL (SC)";"SC";"COCAL DO SUL";332;21;26;379
2015;"CONCORDIA (SC)";"SC";"CONCORDIA";2633;143;272;3048
2015;"CORDILHEIRA ALTA (SC)";"SC";"CORDILHEIRA ALTA";324;23;16;363
2015;"CORONEL FREITAS (SC)";"SC";"CORONEL FREITAS";276;13;25;314
2015;"CORONEL MARTINS (SC)";"SC";"CORONEL MARTINS";55;9;18;82
2015;"CORREIA PINTO (SC)";"SC";"CORREIA PINTO";412;48;68;528
2015;"CORUPA (SC)";"SC";"CORUPA";434;4;40;478
2015;"CRICIUMA (SC)";"SC";"CRICIUMA";3590;336;445;4371
2015;"CUNHA PORA (SC)";"SC";"CUNHA PORA";439;16;58;513
2015;"CUNHATAI (SC)";"SC";"CUNHATAI";41;3;9;53
2015;"CURITIBANOS (SC)";"SC";"CURITIBANOS";1001;85;133;1219
2015;"DESCANSO (SC)";"SC";"DESCANSO";239;15;26;280
2015;"DIONISIO CERQUEIRA (SC)";"SC";"DIONISIO CERQUEIRA";186;24;20;230
2015;"DONA EMMA (SC)";"SC";"DONA EMMA";130;16;11;157
2015;"DOUTOR PEDRINHO (SC)";"SC";"DOUTOR PEDRINHO";135;6;4;145
2015;"ENTRE RIOS (SC)";"SC";"ENTRE RIOS";42;4;30;76
2015;"ERMO (SC)";"SC";"ERMO";81;3;8;92
2015;"ERVAL VELHO (SC)";"SC";"ERVAL VELHO";122;6;24;152
2015;"FAXINAL DOS GUEDES (SC)";"SC";"FAXINAL DOS GUEDES";419;21;37;477
2015;"FLOR DO SERTAO (SC)";"SC";"FLOR DO SERTAO";32;9;19;60
2015;"FLORIANOPOLIS (SC)";"SC";"FLORIANOPOLIS";3795;952;2076;6823
2015;"FORMOSA DO SUL (SC)";"SC";"FORMOSA DO SUL";71;6;13;90
2015;"FORQUILHINHA (SC)";"SC";"FORQUILHINHA";581;23;42;646
2015;"FRAIBURGO (SC)";"SC";"FRAIBURGO";873;54;216;1143
2015;"FREI ROGERIO (SC)";"SC";"FREI ROGERIO";88;11;15;114
2015;"GALVAO (SC)";"SC";"GALVAO";98;7;14;119
2015;"GAROPABA (SC)";"SC";"GAROPABA";286;29;39;354
2015;"GARUVA (SC)";"SC";"GARUVA";584;37;34;655
2015;"GASPAR (SC)";"SC";"GASPAR";1376;79;79;1534
2015;"GOVERNADOR CELSO RAMOS (SC)";"SC";"GOVERNADOR CELSO RAMOS";174;25;14;213
2015;"GRAO PARA (SC)";"SC";"GRAO PARA";265;7;12;284
2015;"GRAVATAL (SC)";"SC";"GRAVATAL";309;19;19;347
2015;"GUABIRUBA (SC)";"SC";"GUABIRUBA";320;17;22;359
2015;"GUARACIABA (SC)";"SC";"GUARACIABA";246;17;43;306
2015;"GUARAMIRIM (SC)";"SC";"GUARAMIRIM";1075;37;25;1137
2015;"GUARUJA DO SUL (SC)";"SC";"GUARUJA DO SUL";175;11;22;208
2015;"GUATAMBU (SC)";"SC";"GUATAMBU";123;13;23;159
2015;"HERVAL D OESTE (SC)";"SC";"HERVAL D OESTE";366;37;66;469
2015;"IBIAM (SC)";"SC";"IBIAM";76;7;14;97
2015;"IBICARE (SC)";"SC";"IBICARE";153;12;9;174
2015;"IBIRAMA (SC)";"SC";"IBIRAMA";543;62;84;689
2015;"ICARA (SC)";"SC";"ICARA";1864;94;138;2096
2015;"ILHOTA (SC)";"SC";"ILHOTA";371;26;23;420
2015;"IMARUI (SC)";"SC";"IMARUI";182;26;35;243
2015;"IMBITUBA (SC)";"SC";"IMBITUBA";680;82;102;864
2015;"IMBUIA (SC)";"SC";"IMBUIA";184;10;21;215
2015;"INDAIAL (SC)";"SC";"INDAIAL";1564;93;138;1795
2015;"IOMERE (SC)";"SC";"IOMERE";161;6;9;176
2015;"IPIRA (SC)";"SC";"IPIRA";131;10;25;166
2015;"IPORA DO OESTE (SC)";"SC";"IPORA DO OESTE";263;22;56;341
2015;"IPUACU (SC)";"SC";"IPUACU";114;11;34;159
2015;"IPUMIRIM (SC)";"SC";"IPUMIRIM";276;42;31;349
2015;"IRACEMINHA (SC)";"SC";"IRACEMINHA";103;6;25;134
2015;"IRANI (SC)";"SC";"IRANI";349;32;59;440
2015;"IRATI (SC)";"SC";"IRATI";34;5;8;47
2015;"IRINEOPOLIS (SC)";"SC";"IRINEOPOLIS";287;16;19;322
2015;"ITA (SC)";"SC";"ITA";112;14;39;165
2015;"ITAIOPOLIS (SC)";"SC";"ITAIOPOLIS";648;31;97;776
2015;"ITAJAI (SC)";"SC";"ITAJAI";4526;311;394;5231
2015;"ITAPEMA (SC)";"SC";"ITAPEMA";625;65;46;736
2015;"ITAPIRANGA (SC)";"SC";"ITAPIRANGA";365;26;69;460
2015;"ITAPOA (SC)";"SC";"ITAPOA";243;16;16;275
2015;"ITUPORANGA (SC)";"SC";"ITUPORANGA";687;38;64;789
2015;"JABORA (SC)";"SC";"JABORA";145;15;25;185
2015;"JACINTO MACHADO (SC)";"SC";"JACINTO MACHADO";440;16;40;496
2015;"JAGUARUNA (SC)";"SC";"JAGUARUNA";482;26;59;567
2015;"JARAGUA DO SUL (SC)";"SC";"JARAGUA DO SUL";2622;245;387;3254
2015;"JARDINOPOLIS (SC)";"SC";"JARDINOPOLIS";20;6;4;30
2015;"JOACABA (SC)";"SC";"JOACABA";867;76;46;989
2015;"JOINVILLE (SC)";"SC";"JOINVILLE";8435;750;872;10057
2015;"JOSE BOITEUX (SC)";"SC";"JOSE BOITEUX";127;23;9;159
2015;"JUPIA (SC)";"SC";"JUPIA";47;3;8;58
2015;"LACERDOPOLIS (SC)";"SC";"LACERDOPOLIS";110;5;7;122
2015;"LAGEADO GRANDE (SC)";"SC";"LAGEADO GRANDE";42;1;6;49
2015;"LAGES (SC)";"SC";"LAGES";3447;283;385;4115
2015;"LAGUNA (SC)";"SC";"LAGUNA";607;122;105;834
2015;"LAURENTINO (SC)";"SC";"LAURENTINO";326;6;8;340
2015;"LAURO MULLER (SC)";"SC";"LAURO MULLER";478;28;52;558
2015;"LEBON REGIS (SC)";"SC";"LEBON REGIS";260;28;54;342
2015;"LEOBERTO LEAL (SC)";"SC";"LEOBERTO LEAL";114;12;5;131
2015;"LINDOIA DO SUL (SC)";"SC";"LINDOIA DO SUL";151;11;44;206
2015;"LONTRAS (SC)";"SC";"LONTRAS";343;24;42;409
2015;"LUIZ ALVES (SC)";"SC";"LUIZ ALVES";462;7;24;493
2015;"LUZERNA (SC)";"SC";"LUZERNA";161;11;24;196
2015;"MACIEIRA (SC)";"SC";"MACIEIRA";90;6;16;112
2015;"MAFRA (SC)";"SC";"MAFRA";1502;107;151;1760
2015;"MAJOR GERCINO (SC)";"SC";"MAJOR GERCINO";135;5;12;152
2015;"MAJOR VIEIRA (SC)";"SC";"MAJOR VIEIRA";211;5;16;232
2015;"MARACAJA (SC)";"SC";"MARACAJA";244;2;15;261
2015;"MARAVILHA (SC)";"SC";"MARAVILHA";826;44;75;945
2015;"MAREMA (SC)";"SC";"MAREMA";71;4;7;82
2015;"MASSARANDUBA (SC)";"SC";"MASSARANDUBA";543;31;45;619
2015;"MATOS COSTA (SC)";"SC";"MATOS COSTA";49;6;16;71
2015;"MELEIRO (SC)";"SC";"MELEIRO";295;7;21;323
2015;"MIRIM DOCE (SC)";"SC";"MIRIM DOCE";65;3;10;78
2015;"MODELO (SC)";"SC";"MODELO";135;7;9;151
2015;"MONDAI (SC)";"SC";"MONDAI";196;15;57;268
2015;"MONTE CARLO (SC)";"SC";"MONTE CARLO";166;19;103;288
2015;"MONTE CASTELO (SC)";"SC";"MONTE CASTELO";194;16;24;234
2015;"MORRO DA FUMACA (SC)";"SC";"MORRO DA FUMACA";844;31;34;909
2015;"MORRO GRANDE (SC)";"SC";"MORRO GRANDE";141;3;10;154
2015;"NAVEGANTES (SC)";"SC";"NAVEGANTES";913;105;77;1095
2015;"NOVA ERECHIM (SC)";"SC";"NOVA ERECHIM";130;6;10;146
2015;"NOVA ITABERABA (SC)";"SC";"NOVA ITABERABA";126;5;18;149
2015;"NOVA TRENTO (SC)";"SC";"NOVA TRENTO";294;41;40;375
2015;"NOVA VENEZA (SC)";"SC";"NOVA VENEZA";455;32;41;528
2015;"NOVO HORIZONTE (SC)";"SC";"NOVO HORIZONTE";68;11;19;98
2015;"ORLEANS (SC)";"SC";"ORLEANS";884;29;45;958
2015;"OTACILIO COSTA (SC)";"SC";"OTACILIO COSTA";479;50;63;592
2015;"OURO (SC)";"SC";"OURO";264;32;32;328
2015;"OURO VERDE (SC)";"SC";"OURO VERDE";99;2;10;111
2015;"PAIAL (SC)";"SC";"PAIAL";19;2;15;36
2015;"PAINEL (SC)";"SC";"PAINEL";49;4;11;64
2015;"PALHOCA (SC)";"SC";"PALHOCA";2437;167;368;2972
2015;"PALMA SOLA (SC)";"SC";"PALMA SOLA";208;7;33;248
2015;"PALMEIRA (SC)";"SC";"PALMEIRA";113;7;5;125
2015;"PALMITOS (SC)";"SC";"PALMITOS";413;45;53;511
2015;"PAPANDUVA (SC)";"SC";"PAPANDUVA";570;20;87;677
2015;"PARAISO (SC)";"SC";"PARAISO";92;7;7;106
2015;"PASSO DE TORRES (SC)";"SC";"PASSO DE TORRES";158;7;18;183
2015;"PASSOS MAIA (SC)";"SC";"PASSOS MAIA";123;4;32;159
2015;"PAULO LOPES (SC)";"SC";"PAULO LOPES";261;25;53;339
2015;"PEDRAS GRANDES (SC)";"SC";"PEDRAS GRANDES";243;19;14;276
2015;"PENHA (SC)";"SC";"PENHA";400;43;53;496
2015;"PERITIBA (SC)";"SC";"PERITIBA";93;6;17;116
2015;"PESCARIA BRAVA (SC)";"SC";"PESCARIA BRAVA";60;3;5;68
2015;"PETROLANDIA (SC)";"SC";"PETROLANDIA";172;13;24;209
2015;"PINHALZINHO (SC)";"SC";"PINHALZINHO";530;25;61;616
2015;"PINHEIRO PRETO (SC)";"SC";"PINHEIRO PRETO";268;7;17;292
2015;"PIRATUBA (SC)";"SC";"PIRATUBA";123;11;32;166
2015;"PLANALTO ALEGRE (SC)";"SC";"PLANALTO ALEGRE";66;8;5;79
2015;"POMERODE (SC)";"SC";"POMERODE";687;35;95;817
2015;"PONTE ALTA (SC)";"SC";"PONTE ALTA";143;9;16;168
2015;"PONTE ALTA DO NORTE (SC)";"SC";"PONTE ALTA DO NORTE";90;5;11;106
2015;"PONTE SERRADA (SC)";"SC";"PONTE SERRADA";355;45;110;510
2015;"PORTO BELO (SC)";"SC";"PORTO BELO";273;29;30;332
2015;"PORTO UNIAO (SC)";"SC";"PORTO UNIAO";657;31;42;730
2015;"POUSO REDONDO (SC)";"SC";"POUSO REDONDO";515;23;41;579
2015;"PRAIA GRANDE (SC)";"SC";"PRAIA GRANDE";246;11;25;282
2015;"PRESIDENTE CASTELO BRANCO (SC)";"SC";"PRESIDENTE CASTELO BRANCO";67;7;10;84
2015;"PRESIDENTE GETULIO (SC)";"SC";"PRESIDENTE GETULIO";387;48;70;505
2015;"PRESIDENTE NEREU (SC)";"SC";"PRESIDENTE NEREU";43;9;8;60
2015;"PRINCESA (SC)";"SC";"PRINCESA";63;3;12;78
2015;"QUILOMBO (SC)";"SC";"QUILOMBO";228;34;49;311
2015;"RANCHO QUEIMADO (SC)";"SC";"RANCHO QUEIMADO";154;4;7;165
2015;"RIO DAS ANTAS (SC)";"SC";"RIO DAS ANTAS";210;8;29;247
2015;"RIO DO CAMPO (SC)";"SC";"RIO DO CAMPO";190;11;18;219
2015;"RIO DO OESTE (SC)";"SC";"RIO DO OESTE";224;19;21;264
2015;"RIO DO SUL (SC)";"SC";"RIO DO SUL";1518;84;111;1713
2015;"RIO DOS CEDROS (SC)";"SC";"RIO DOS CEDROS";271;35;31;337
2015;"RIO FORTUNA (SC)";"SC";"RIO FORTUNA";291;5;17;313
2015;"RIO NEGRINHO (SC)";"SC";"RIO NEGRINHO";1110;68;119;1297
2015;"RIO RUFINO (SC)";"SC";"RIO RUFINO";61;8;19;88
2015;"RIQUEZA (SC)";"SC";"RIQUEZA";142;5;28;175
2015;"RODEIO (SC)";"SC";"RODEIO";263;17;25;305
2015;"ROMELANDIA (SC)";"SC";"ROMELANDIA";95;7;32;134
2015;"SALETE (SC)";"SC";"SALETE";199;11;25;235
2015;"SALTINHO (SC)";"SC";"SALTINHO";58;7;21;86
2015;"SALTO VELOSO (SC)";"SC";"SALTO VELOSO";157;5;12;174
2015;"SANGAO (SC)";"SC";"SANGAO";477;17;19;513
2015;"SANTA CECILIA (SC)";"SC";"SANTA CECILIA";479;41;56;576
2015;"SANTA HELENA (SC)";"SC";"SANTA HELENA";61;11;16;88
2015;"SANTA ROSA DE LIMA (SC)";"SC";"SANTA ROSA DE LIMA";119;5;10;134
2015;"SANTA ROSA DO SUL (SC)";"SC";"SANTA ROSA DO SUL";295;14;22;331
2015;"SANTA TEREZINHA (SC)";"SC";"SANTA TEREZINHA";194;17;30;241
2015;"SANTA TEREZINHA DO PROGRESSO (SC)";"SC";"SANTA TEREZINHA DO PROGRESSO";51;7;14;72
2015;"SANTIAGO DO SUL (SC)";"SC";"SANTIAGO DO SUL";66;8;4;78
2015;"SANTO AMARO DA IMPERATRIZ (SC)";"SC";"SANTO AMARO DA IMPERATRIZ";665;31;75;771
2015;"SAO BENTO DO SUL (SC)";"SC";"SAO BENTO DO SUL";1713;149;177;2039
2015;"SAO BERNARDINO (SC)";"SC";"SAO BERNARDINO";53;6;20;79
2015;"SAO BONIFACIO (SC)";"SC";"SAO BONIFACIO";139;8;11;158
2015;"SAO CARLOS (SC)";"SC";"SAO CARLOS";219;22;44;285
2015;"SAO CRISTOVAO DO SUL (SC)";"SC";"SAO CRISTOVAO DO SUL";303;6;14;323
2015;"SAO DOMINGOS (SC)";"SC";"SAO DOMINGOS";332;22;49;403
2015;"SAO FRANCISCO DO SUL (SC)";"SC";"SAO FRANCISCO DO SUL";720;70;80;870
2015;"SAO JOAO BATISTA (SC)";"SC";"SAO JOAO BATISTA";614;38;53;705
2015;"SAO JOAO DO ITAPERIU (SC)";"SC";"SAO JOAO DO ITAPERIU";233;6;11;250
2015;"SAO JOAO DO OESTE (SC)";"SC";"SAO JOAO DO OESTE";182;11;21;214
2015;"SAO JOAO DO SUL (SC)";"SC";"SAO JOAO DO SUL";227;4;16;247
2015;"SAO JOAQUIM (SC)";"SC";"SAO JOAQUIM";1024;95;207;1326
2015;"SAO JOSE (SC)";"SC";"SAO JOSE";3724;261;245;4230
2015;"SAO JOSE DO CEDRO (SC)";"SC";"SAO JOSE DO CEDRO";427;20;71;518
2015;"SAO JOSE DO CERRITO (SC)";"SC";"SAO JOSE DO CERRITO";213;13;58;284
2015;"SAO LOURENCO D OESTE (SC)";"SC";"SAO LOURENCO D OESTE";834;50;82;966
2015;"SAO LUDGERO (SC)";"SC";"SAO LUDGERO";583;13;32;628
2015;"SAO MARTINHO (SC)";"SC";"SAO MARTINHO";165;8;5;178
2015;"SAO MIGUEL D OESTE (SC)";"SC";"SAO MIGUEL D OESTE";1118;75;113;1306
2015;"SAO MIGUEL DA BOA VISTA (SC)";"SC";"SAO MIGUEL DA BOA VISTA";32;3;15;50
2015;"SAO PEDRO DE ALCANTARA (SC)";"SC";"SAO PEDRO DE ALCANTARA";149;7;5;161
2015;"SAUDADES (SC)";"SC";"SAUDADES";233;11;37;281
2015;"SCHROEDER (SC)";"SC";"SCHROEDER";236;11;22;269
2015;"SEARA (SC)";"SC";"SEARA";397;57;85;539
2015;"SERRA ALTA (SC)";"SC";"SERRA ALTA";73;9;14;96
2015;"SIDEROPOLIS (SC)";"SC";"SIDEROPOLIS";449;33;71;553
2015;"SOMBRIO (SC)";"SC";"SOMBRIO";726;63;73;862
2015;"SUL BRASIL (SC)";"SC";"SUL BRASIL";64;4;16;84
2015;"TAIO (SC)";"SC";"TAIO";579;23;55;657
2015;"TANGARA (SC)";"SC";"TANGARA";446;14;46;506
2015;"TIGRINHOS (SC)";"SC";"TIGRINHOS";33;4;13;50
2015;"TIJUCAS (SC)";"SC";"TIJUCAS";1047;56;52;1155
2015;"TIMBE DO SUL (SC)";"SC";"TIMBE DO SUL";152;15;15;182
2015;"TIMBO (SC)";"SC";"TIMBO";704;60;52;816
2015;"TIMBO GRANDE (SC)";"SC";"TIMBO GRANDE";195;9;26;230
2015;"TRES BARRAS (SC)";"SC";"TRES BARRAS";320;33;69;422
2015;"TREVISO (SC)";"SC";"TREVISO";127;8;8;143
2015;"TREZE DE MAIO (SC)";"SC";"TREZE DE MAIO";419;12;22;453
2015;"TREZE TILIAS (SC)";"SC";"TREZE TILIAS";328;19;42;389
2015;"TROMBUDO CENTRAL (SC)";"SC";"TROMBUDO CENTRAL";236;17;23;276
2015;"TUBARAO (SC)";"SC";"TUBARAO";2394;113;318;2825
2015;"TUNAPOLIS (SC)";"SC";"TUNAPOLIS";105;14;20;139
2015;"TURVO (SC)";"SC";"TURVO";502;16;50;568
2015;"UNIAO DO OESTE (SC)";"SC";"UNIAO DO OESTE";52;3;20;75
2015;"URUBICI (SC)";"SC";"URUBICI";292;21;60;373
2015;"URUPEMA (SC)";"SC";"URUPEMA";80;14;11;105
2015;"URUSSANGA (SC)";"SC";"URUSSANGA";508;45;92;645
2015;"VARGEAO (SC)";"SC";"VARGEAO";150;5;12;167
2015;"VARGEM (SC)";"SC";"VARGEM";72;2;14;88
2015;"VARGEM BONITA (SC)";"SC";"VARGEM BONITA";168;11;20;199
2015;"VIDAL RAMOS (SC)";"SC";"VIDAL RAMOS";177;18;18;213
2015;"VIDEIRA (SC)";"SC";"VIDEIRA";1699;129;161;1989
2015;"VITOR MEIRELES (SC)";"SC";"VITOR MEIRELES";99;20;19;138
2015;"WITMARSUM (SC)";"SC";"WITMARSUM";123;11;16;150
2015;"XANXERE (SC)";"SC";"XANXERE";1353;136;132;1621
2015;"XAVANTINA (SC)";"SC";"XAVANTINA";136;17;5;158
2015;"XAXIM (SC)";"SC";"XAXIM";753;60;144;957
2015;"ZORTEA (SC)";"SC";"ZORTEA";46;10;5;61
2015;"AMPARO DE SAO FRANCISCO (SE)";"SE";"AMPARO DE SAO FRANCISCO";10;12;4;26
2015;"AQUIDABA (SE)";"SE";"AQUIDABA";130;17;52;199
2015;"ARACAJU (SE)";"SE";"ARACAJU";5951;1086;2492;9529
2015;"ARAUA (SE)";"SE";"ARAUA";60;22;18;100
2015;"AREIA BRANCA (SE)";"SE";"AREIA BRANCA";169;18;20;207
2015;"BARRA DOS COQUEIROS (SE)";"SE";"BARRA DOS COQUEIROS";95;38;34;167
2015;"BOQUIM (SE)";"SE";"BOQUIM";222;23;38;283
2015;"BREJO GRANDE (SE)";"SE";"BREJO GRANDE";8;5;8;21
2015;"CAMPO DO BRITO (SE)";"SE";"CAMPO DO BRITO";407;16;68;491
2015;"CANHOBA (SE)";"SE";"CANHOBA";6;3;6;15
2015;"CANINDE DE SAO FRANCISCO (SE)";"SE";"CANINDE DE SAO FRANCISCO";208;72;25;305
2015;"CAPELA (SE)";"SE";"CAPELA";140;36;71;247
2015;"CARIRA (SE)";"SE";"CARIRA";299;39;106;444
2015;"CARMOPOLIS (SE)";"SE";"CARMOPOLIS";101;41;55;197
2015;"CEDRO DE SAO JOAO (SE)";"SE";"CEDRO DE SAO JOAO";25;5;5;35
2015;"CRISTINAPOLIS (SE)";"SE";"CRISTINAPOLIS";78;20;36;134
2015;"CUMBE (SE)";"SE";"CUMBE";33;8;16;57
2015;"DIVINA PASTORA (SE)";"SE";"DIVINA PASTORA";8;8;8;24
2015;"ESTANCIA (SE)";"SE";"ESTANCIA";542;194;272;1008
2015;"FEIRA NOVA (SE)";"SE";"FEIRA NOVA";17;10;7;34
2015;"FREI PAULO (SE)";"SE";"FREI PAULO";132;20;39;191
2015;"GARARU (SE)";"SE";"GARARU";52;15;31;98
2015;"GENERAL MAYNARD (SE)";"SE";"GENERAL MAYNARD";12;10;12;34
2015;"GRACCHO CARDOSO (SE)";"SE";"GRACCHO CARDOSO";23;9;9;41
2015;"ILHA DAS FLORES (SE)";"SE";"ILHA DAS FLORES";18;8;9;35
2015;"INDIAROBA (SE)";"SE";"INDIAROBA";45;17;19;81
2015;"ITABAIANA (SE)";"SE";"ITABAIANA";3282;140;193;3615
2015;"ITABAIANINHA (SE)";"SE";"ITABAIANINHA";598;65;68;731
2015;"ITABI (SE)";"SE";"ITABI";21;5;8;34
2015;"ITAPORANGA D AJUDA (SE)";"SE";"ITAPORANGA D AJUDA";308;42;80;430
2015;"JAPARATUBA (SE)";"SE";"JAPARATUBA";50;32;67;149
2015;"JAPOATA (SE)";"SE";"JAPOATA";58;10;35;103
2015;"LAGARTO (SE)";"SE";"LAGARTO";1100;154;224;1478
2015;"LARANJEIRAS (SE)";"SE";"LARANJEIRAS";135;64;44;243
2015;"MACAMBIRA (SE)";"SE";"MACAMBIRA";50;7;20;77
2015;"MALHADA DOS BOIS (SE)";"SE";"MALHADA DOS BOIS";13;5;10;28
2015;"MALHADOR (SE)";"SE";"MALHADOR";215;26;55;296
2015;"MARUIM (SE)";"SE";"MARUIM";50;31;34;115
2015;"MOITA BONITA (SE)";"SE";"MOITA BONITA";467;17;20;504
2015;"MONTE ALEGRE DE SERGIPE (SE)";"SE";"MONTE ALEGRE DE SERGIPE";156;33;28;217
2015;"MURIBECA (SE)";"SE";"MURIBECA";72;7;30;109
2015;"NEOPOLIS (SE)";"SE";"NEOPOLIS";53;17;32;102
2015;"NOSSA SENHORA APARECIDA (SE)";"SE";"NOSSA SENHORA APARECIDA";140;19;14;173
2015;"NOSSA SENHORA DA GLORIA (SE)";"SE";"NOSSA SENHORA DA GLORIA";466;59;143;668
2015;"NOSSA SENHORA DAS DORES (SE)";"SE";"NOSSA SENHORA DAS DORES";266;27;88;381
2015;"NOSSA SENHORA DE LOURDES (SE)";"SE";"NOSSA SENHORA DE LOURDES";31;3;8;42
2015;"NOSSA SENHORA DO SOCORRO (SE)";"SE";"NOSSA SENHORA DO SOCORRO";916;134;184;1234
2015;"PACATUBA (SE)";"SE";"PACATUBA";425;11;56;492
2015;"PEDRA MOLE (SE)";"SE";"PEDRA MOLE";7;3;4;14
2015;"PEDRINHAS (SE)";"SE";"PEDRINHAS";63;5;9;77
2015;"PINHAO (SE)";"SE";"PINHAO";25;19;7;51
2015;"PIRAMBU (SE)";"SE";"PIRAMBU";31;9;21;61
2015;"POCO REDONDO (SE)";"SE";"POCO REDONDO";179;64;77;320
2015;"POCO VERDE (SE)";"SE";"POCO VERDE";138;72;169;379
2015;"PORTO DA FOLHA (SE)";"SE";"PORTO DA FOLHA";137;35;34;206
2015;"PROPRIA (SE)";"SE";"PROPRIA";241;29;55;325
2015;"RIACHAO DO DANTAS (SE)";"SE";"RIACHAO DO DANTAS";38;6;18;62
2015;"RIACHUELO (SE)";"SE";"RIACHUELO";40;15;10;65
2015;"RIBEIROPOLIS (SE)";"SE";"RIBEIROPOLIS";280;40;72;392
2015;"ROSARIO DO CATETE (SE)";"SE";"ROSARIO DO CATETE";32;22;18;72
2015;"SALGADO (SE)";"SE";"SALGADO";135;18;137;290
2015;"SANTA LUZIA DO ITANHY (SE)";"SE";"SANTA LUZIA DO ITANHY";22;13;33;68
2015;"SANTA ROSA DE LIMA (SE)";"SE";"SANTA ROSA DE LIMA";29;4;8;41
2015;"SANTANA DO SAO FRANCISCO (SE)";"SE";"SANTANA DO SAO FRANCISCO";13;3;9;25
2015;"SANTO AMARO DAS BROTAS (SE)";"SE";"SANTO AMARO DAS BROTAS";19;7;20;46
2015;"SAO CRISTOVAO (SE)";"SE";"SAO CRISTOVAO";425;114;201;740
2015;"SAO DOMINGOS (SE)";"SE";"SAO DOMINGOS";134;12;30;176
2015;"SAO FRANCISCO (SE)";"SE";"SAO FRANCISCO";18;3;24;45
2015;"SAO MIGUEL DO ALEIXO (SE)";"SE";"SAO MIGUEL DO ALEIXO";48;3;5;56
2015;"SIMAO DIAS (SE)";"SE";"SIMAO DIAS";258;54;264;576
2015;"SIRIRI (SE)";"SE";"SIRIRI";38;10;39;87
2015;"TELHA (SE)";"SE";"TELHA";16;12;5;33
2015;"TOBIAS BARRETO (SE)";"SE";"TOBIAS BARRETO";322;90;207;619
2015;"TOMAR DO GERU (SE)";"SE";"TOMAR DO GERU";56;7;25;88
2015;"UMBAUBA (SE)";"SE";"UMBAUBA";302;42;41;385
2015;"ADAMANTINA (SP)";"SP";"ADAMANTINA";738;59;73;870
2015;"ADOLFO (SP)";"SP";"ADOLFO";76;2;26;104
2015;"AGUAI (SP)";"SP";"AGUAI";873;82;183;1138
2015;"AGUAS DA PRATA (SP)";"SP";"AGUAS DA PRATA";121;15;13;149
2015;"AGUAS DE LINDOIA (SP)";"SP";"AGUAS DE LINDOIA";195;85;72;352
2015;"AGUAS DE SANTA BARBARA (SP)";"SP";"AGUAS DE SANTA BARBARA";115;32;33;180
2015;"AGUAS DE SAO PEDRO (SP)";"SP";"AGUAS DE SAO PEDRO";39;8;5;52
2015;"AGUDOS (SP)";"SP";"AGUDOS";593;116;102;811
2015;"ALAMBARI (SP)";"SP";"ALAMBARI";95;17;8;120
2015;"ALFREDO MARCONDES (SP)";"SP";"ALFREDO MARCONDES";70;11;8;89
2015;"ALTAIR (SP)";"SP";"ALTAIR";67;7;38;112
2015;"ALTINOPOLIS (SP)";"SP";"ALTINOPOLIS";368;61;125;554
2015;"ALTO ALEGRE (SP)";"SP";"ALTO ALEGRE";101;3;48;152
2015;"ALUMINIO (SP)";"SP";"ALUMINIO";251;42;42;335
2015;"ALVARES FLORENCE (SP)";"SP";"ALVARES FLORENCE";61;4;17;82
2015;"ALVARES MACHADO (SP)";"SP";"ALVARES MACHADO";454;37;33;524
2015;"ALVARO DE CARVALHO (SP)";"SP";"ALVARO DE CARVALHO";28;6;28;62
2015;"ALVINLANDIA (SP)";"SP";"ALVINLANDIA";53;5;20;78
2015;"AMERICANA (SP)";"SP";"AMERICANA";3604;562;625;4791
2015;"AMERICO BRASILIENSE (SP)";"SP";"AMERICO BRASILIENSE";709;72;230;1011
2015;"AMERICO DE CAMPOS (SP)";"SP";"AMERICO DE CAMPOS";120;9;30;159
2015;"AMPARO (SP)";"SP";"AMPARO";1416;251;146;1813
2015;"ANALANDIA (SP)";"SP";"ANALANDIA";96;16;16;128
2015;"ANDRADINA (SP)";"SP";"ANDRADINA";1353;95;140;1588
2015;"ANGATUBA (SP)";"SP";"ANGATUBA";392;58;99;549
2015;"ANHEMBI (SP)";"SP";"ANHEMBI";94;22;22;138
2015;"ANHUMAS (SP)";"SP";"ANHUMAS";83;7;8;98
2015;"APARECIDA (SP)";"SP";"APARECIDA";847;82;518;1447
2015;"APARECIDA D OESTE (SP)";"SP";"APARECIDA D OESTE";99;14;26;139
2015;"APIAI (SP)";"SP";"APIAI";378;55;85;518
2015;"ARACARIGUAMA (SP)";"SP";"ARACARIGUAMA";650;86;53;789
2015;"ARACATUBA (SP)";"SP";"ARACATUBA";3750;323;815;4888
2015;"ARACOIABA DA SERRA (SP)";"SP";"ARACOIABA DA SERRA";560;122;28;710
2015;"ARAMINA (SP)";"SP";"ARAMINA";60;7;26;93
2015;"ARANDU (SP)";"SP";"ARANDU";62;5;23;90
2015;"ARAPEI (SP)";"SP";"ARAPEI";37;10;12;59
2015;"ARARAQUARA (SP)";"SP";"ARARAQUARA";3778;450;1156;5384
2015;"ARARAS (SP)";"SP";"ARARAS";2387;292;350;3029
2015;"ARCO IRIS (SP)";"SP";"ARCO IRIS";75;4;7;86
2015;"AREALVA (SP)";"SP";"AREALVA";187;6;28;221
2015;"AREIAS (SP)";"SP";"AREIAS";57;6;7;70
2015;"AREIOPOLIS (SP)";"SP";"AREIOPOLIS";135;33;114;282
2015;"ARIRANHA (SP)";"SP";"ARIRANHA";293;23;184;500
2015;"ARTUR NOGUEIRA (SP)";"SP";"ARTUR NOGUEIRA";1104;105;163;1372
2015;"ARUJA (SP)";"SP";"ARUJA";3181;391;474;4046
2015;"ASPASIA (SP)";"SP";"ASPASIA";31;7;5;43
2015;"ASSIS (SP)";"SP";"ASSIS";1937;198;379;2514
2015;"ATIBAIA (SP)";"SP";"ATIBAIA";2585;392;350;3327
2015;"AURIFLAMA (SP)";"SP";"AURIFLAMA";341;32;52;425
2015;"AVAI (SP)";"SP";"AVAI";81;12;21;114
2015;"AVANHANDAVA (SP)";"SP";"AVANHANDAVA";163;13;58;234
2015;"AVARE (SP)";"SP";"AVARE";1365;152;295;1812
2015;"BADY BASSITT (SP)";"SP";"BADY BASSITT";423;48;67;538
2015;"BALBINOS (SP)";"SP";"BALBINOS";25;2;8;35
2015;"BALSAMO (SP)";"SP";"BALSAMO";204;8;23;235
2015;"BANANAL (SP)";"SP";"BANANAL";155;22;37;214
2015;"BARAO DE ANTONINA (SP)";"SP";"BARAO DE ANTONINA";27;4;14;45
2015;"BARBOSA (SP)";"SP";"BARBOSA";129;7;42;178
2015;"BARIRI (SP)";"SP";"BARIRI";853;65;92;1010
2015;"BARRA BONITA (SP)";"SP";"BARRA BONITA";1108;94;264;1466
2015;"BARRA DO CHAPEU (SP)";"SP";"BARRA DO CHAPEU";58;6;19;83
2015;"BARRA DO TURVO (SP)";"SP";"BARRA DO TURVO";72;21;44;137
2015;"BARRETOS (SP)";"SP";"BARRETOS";2129;254;531;2914
2015;"BARRINHA (SP)";"SP";"BARRINHA";489;49;201;739
2015;"BARUERI (SP)";"SP";"BARUERI";6346;830;1209;8385
2015;"BASTOS (SP)";"SP";"BASTOS";844;29;92;965
2015;"BATATAIS (SP)";"SP";"BATATAIS";1189;145;175;1509
2015;"BAURU (SP)";"SP";"BAURU";5869;501;1253;7623
2015;"BEBEDOURO (SP)";"SP";"BEBEDOURO";1721;157;312;2190
2015;"BENTO DE ABREU (SP)";"SP";"BENTO DE ABREU";68;11;13;92
2015;"BERNARDINO DE CAMPOS (SP)";"SP";"BERNARDINO DE CAMPOS";347;42;39;428
2015;"BERTIOGA (SP)";"SP";"BERTIOGA";545;66;119;730
2015;"BILAC (SP)";"SP";"BILAC";168;9;22;199
2015;"BIRIGUI (SP)";"SP";"BIRIGUI";1825;117;187;2129
2015;"BIRITIBA MIRIM (SP)";"SP";"BIRITIBA MIRIM";440;59;54;553
2015;"BOA ESPERANCA DO SUL (SP)";"SP";"BOA ESPERANCA DO SUL";348;45;100;493
2015;"BOCAINA (SP)";"SP";"BOCAINA";204;42;38;284
2015;"BOFETE (SP)";"SP";"BOFETE";234;59;48;341
2015;"BOITUVA (SP)";"SP";"BOITUVA";1377;184;146;1707
2015;"BOM JESUS DOS PERDOES (SP)";"SP";"BOM JESUS DOS PERDOES";572;81;78;731
2015;"BOM SUCESSO DE ITARARE (SP)";"SP";"BOM SUCESSO DE ITARARE";76;9;14;99
2015;"BORA (SP)";"SP";"BORA";44;1;5;50
2015;"BORACEIA (SP)";"SP";"BORACEIA";194;11;21;226
2015;"BORBOREMA (SP)";"SP";"BORBOREMA";367;34;84;485
2015;"BOREBI (SP)";"SP";"BOREBI";55;9;5;69
2015;"BOTUCATU (SP)";"SP";"BOTUCATU";1791;336;532;2659
2015;"BRAGANCA PAULISTA (SP)";"SP";"BRAGANCA PAULISTA";2867;405;388;3660
2015;"BRAUNA (SP)";"SP";"BRAUNA";78;9;88;175
2015;"BREJO ALEGRE (SP)";"SP";"BREJO ALEGRE";148;1;19;168
2015;"BRODOWSKI (SP)";"SP";"BRODOWSKI";627;37;43;707
2015;"BROTAS (SP)";"SP";"BROTAS";521;66;190;777
2015;"BURI (SP)";"SP";"BURI";465;42;86;593
2015;"BURITAMA (SP)";"SP";"BURITAMA";348;26;63;437
2015;"BURITIZAL (SP)";"SP";"BURITIZAL";115;17;33;165
2015;"CABRALIA PAULISTA (SP)";"SP";"CABRALIA PAULISTA";137;7;17;161
2015;"CABREUVA (SP)";"SP";"CABREUVA";1016;147;68;1231
2015;"CACAPAVA (SP)";"SP";"CACAPAVA";1177;338;218;1733
2015;"CACHOEIRA PAULISTA (SP)";"SP";"CACHOEIRA PAULISTA";405;133;25;563
2015;"CACONDE (SP)";"SP";"CACONDE";259;60;87;406
2015;"CAFELANDIA (SP)";"SP";"CAFELANDIA";296;21;78;395
2015;"CAIABU (SP)";"SP";"CAIABU";41;7;40;88
2015;"CAIEIRAS (SP)";"SP";"CAIEIRAS";1173;269;530;1972
2015;"CAIUA (SP)";"SP";"CAIUA";54;9;23;86
2015;"CAJAMAR (SP)";"SP";"CAJAMAR";1642;246;326;2214
2015;"CAJATI (SP)";"SP";"CAJATI";622;77;89;788
2015;"CAJOBI (SP)";"SP";"CAJOBI";245;11;89;345
2015;"CAJURU (SP)";"SP";"CAJURU";509;33;102;644
2015;"CAMPINA DO MONTE ALEGRE (SP)";"SP";"CAMPINA DO MONTE ALEGRE";79;22;28;129
2015;"CAMPINAS (SP)";"SP";"CAMPINAS";20744;3766;5414;29924
2015;"CAMPO LIMPO PAULISTA (SP)";"SP";"CAMPO LIMPO PAULISTA";665;117;34;816
2015;"CAMPOS DO JORDAO (SP)";"SP";"CAMPOS DO JORDAO";626;166;63;855
2015;"CAMPOS NOVOS PAULISTA (SP)";"SP";"CAMPOS NOVOS PAULISTA";100;8;30;138
2015;"CANANEIA (SP)";"SP";"CANANEIA";106;11;14;131
2015;"CANAS (SP)";"SP";"CANAS";139;11;11;161
2015;"CANDIDO MOTA (SP)";"SP";"CANDIDO MOTA";939;63;63;1065
2015;"CANDIDO RODRIGUES (SP)";"SP";"CANDIDO RODRIGUES";115;9;10;134
2015;"CANITAR (SP)";"SP";"CANITAR";55;17;21;93
2015;"CAPAO BONITO (SP)";"SP";"CAPAO BONITO";953;151;191;1295
2015;"CAPELA DO ALTO (SP)";"SP";"CAPELA DO ALTO";538;60;36;634
2015;"CAPIVARI (SP)";"SP";"CAPIVARI";1188;116;228;1532
2015;"CARAGUATATUBA (SP)";"SP";"CARAGUATATUBA";1708;177;111;1996
2015;"CARAPICUIBA (SP)";"SP";"CARAPICUIBA";3914;870;956;5740
2015;"CARDOSO (SP)";"SP";"CARDOSO";183;20;52;255
2015;"CASA BRANCA (SP)";"SP";"CASA BRANCA";584;70;92;746
2015;"CASSIA DOS COQUEIROS (SP)";"SP";"CASSIA DOS COQUEIROS";24;5;16;45
2015;"CASTILHO (SP)";"SP";"CASTILHO";256;38;110;404
2015;"CATANDUVA (SP)";"SP";"CATANDUVA";2969;264;494;3727
2015;"CATIGUA (SP)";"SP";"CATIGUA";90;11;30;131
2015;"CEDRAL (SP)";"SP";"CEDRAL";230;21;18;269
2015;"CERQUEIRA CESAR (SP)";"SP";"CERQUEIRA CESAR";377;44;133;554
2015;"CERQUILHO (SP)";"SP";"CERQUILHO";900;126;106;1132
2015;"CESARIO LANGE (SP)";"SP";"CESARIO LANGE";364;60;52;476
2015;"CHARQUEADA (SP)";"SP";"CHARQUEADA";443;40;101;584
2015;"CHAVANTES (SP)";"SP";"CHAVANTES";145;41;53;239
2015;"CLEMENTINA (SP)";"SP";"CLEMENTINA";292;13;67;372
2015;"COLINA (SP)";"SP";"COLINA";385;32;87;504
2015;"COLOMBIA (SP)";"SP";"COLOMBIA";128;36;67;231
2015;"CONCHAL (SP)";"SP";"CONCHAL";826;67;266;1159
2015;"CONCHAS (SP)";"SP";"CONCHAS";361;50;45;456
2015;"CORDEIROPOLIS (SP)";"SP";"CORDEIROPOLIS";763;78;47;888
2015;"COROADOS (SP)";"SP";"COROADOS";93;6;20;119
2015;"CORONEL MACEDO (SP)";"SP";"CORONEL MACEDO";60;16;23;99
2015;"CORUMBATAI (SP)";"SP";"CORUMBATAI";159;14;9;182
2015;"COSMOPOLIS (SP)";"SP";"COSMOPOLIS";908;285;299;1492
2015;"COSMORAMA (SP)";"SP";"COSMORAMA";233;15;50;298
2015;"COTIA (SP)";"SP";"COTIA";3363;903;895;5161
2015;"CRAVINHOS (SP)";"SP";"CRAVINHOS";981;52;177;1210
2015;"CRISTAIS PAULISTA (SP)";"SP";"CRISTAIS PAULISTA";129;9;27;165
2015;"CRUZALIA (SP)";"SP";"CRUZALIA";82;7;5;94
2015;"CRUZEIRO (SP)";"SP";"CRUZEIRO";764;165;48;977
2015;"CUBATAO (SP)";"SP";"CUBATAO";2836;432;446;3714
2015;"CUNHA (SP)";"SP";"CUNHA";313;63;50;426
2015;"DESCALVADO (SP)";"SP";"DESCALVADO";1002;109;199;1310
2015;"DIADEMA (SP)";"SP";"DIADEMA";4495;747;671;5913
2015;"DIRCE REIS (SP)";"SP";"DIRCE REIS";65;5;9;79
2015;"DIVINOLANDIA (SP)";"SP";"DIVINOLANDIA";445;27;53;525
2015;"DOBRADA (SP)";"SP";"DOBRADA";60;11;81;152
2015;"DOIS CORREGOS (SP)";"SP";"DOIS CORREGOS";669;90;147;906
2015;"DOLCINOPOLIS (SP)";"SP";"DOLCINOPOLIS";34;4;7;45
2015;"DOURADO (SP)";"SP";"DOURADO";200;28;58;286
2015;"DRACENA (SP)";"SP";"DRACENA";1089;58;136;1283
2015;"DUARTINA (SP)";"SP";"DUARTINA";264;28;73;365
2015;"DUMONT (SP)";"SP";"DUMONT";316;9;54;379
2015;"ECHAPORA (SP)";"SP";"ECHAPORA";154;3;24;181
2015;"ELDORADO (SP)";"SP";"ELDORADO";270;26;54;350
2015;"ELIAS FAUSTO (SP)";"SP";"ELIAS FAUSTO";367;17;92;476
2015;"ELISIARIO (SP)";"SP";"ELISIARIO";50;8;10;68
2015;"EMBAUBA (SP)";"SP";"EMBAUBA";75;3;27;105
2015;"EMBU (SP)";"SP";"EMBU";2785;701;776;4262
2015;"EMBU GUACU (SP)";"SP";"EMBU GUACU";2570;289;312;3171
2015;"EMILIANOPOLIS (SP)";"SP";"EMILIANOPOLIS";57;3;13;73
2015;"ENGENHEIRO COELHO (SP)";"SP";"ENGENHEIRO COELHO";371;55;163;589
2015;"ESPIRITO SANTO DO PINHAL (SP)";"SP";"ESPIRITO SANTO DO PINHAL";669;128;71;868
2015;"ESPIRITO SANTO DO TURVO (SP)";"SP";"ESPIRITO SANTO DO TURVO";157;25;38;220
2015;"ESTIVA GERBI (SP)";"SP";"ESTIVA GERBI";292;18;28;338
2015;"ESTRELA D OESTE (SP)";"SP";"ESTRELA D OESTE";278;8;35;321
2015;"ESTRELA DO NORTE (SP)";"SP";"ESTRELA DO NORTE";24;3;8;35
2015;"EUCLIDES DA CUNHA PAULISTA (SP)";"SP";"EUCLIDES DA CUNHA PAULISTA";101;5;50;156
2015;"FARTURA (SP)";"SP";"FARTURA";302;35;44;381
2015;"FERNANDO PRESTES (SP)";"SP";"FERNANDO PRESTES";237;9;19;265
2015;"FERNANDOPOLIS (SP)";"SP";"FERNANDOPOLIS";1566;99;206;1871
2015;"FERNAO (SP)";"SP";"FERNAO";34;5;9;48
2015;"FERRAZ DE VASCONCELOS (SP)";"SP";"FERRAZ DE VASCONCELOS";2135;305;366;2806
2015;"FLORA RICA (SP)";"SP";"FLORA RICA";22;1;9;32
2015;"FLOREAL (SP)";"SP";"FLOREAL";64;9;7;80
2015;"FLORIDA PAULISTA (SP)";"SP";"FLORIDA PAULISTA";330;23;117;470
2015;"FLORINEA (SP)";"SP";"FLORINEA";48;7;9;64
2015;"FRANCA (SP)";"SP";"FRANCA";3637;443;640;4720
2015;"FRANCISCO MORATO (SP)";"SP";"FRANCISCO MORATO";610;242;231;1083
2015;"FRANCO DA ROCHA (SP)";"SP";"FRANCO DA ROCHA";977;235;191;1403
2015;"GABRIEL MONTEIRO (SP)";"SP";"GABRIEL MONTEIRO";65;2;12;79
2015;"GALIA (SP)";"SP";"GALIA";154;19;43;216
2015;"GARCA (SP)";"SP";"GARCA";770;88;116;974
2015;"GASTAO VIDIGAL (SP)";"SP";"GASTAO VIDIGAL";64;7;54;125
2015;"GAVIAO PEIXOTO (SP)";"SP";"GAVIAO PEIXOTO";56;15;23;94
2015;"GENERAL SALGADO (SP)";"SP";"GENERAL SALGADO";276;22;101;399
2015;"GETULINA (SP)";"SP";"GETULINA";140;7;70;217
2015;"GLICERIO (SP)";"SP";"GLICERIO";133;8;28;169
2015;"GUAICARA (SP)";"SP";"GUAICARA";127;14;30;171
2015;"GUAIMBE (SP)";"SP";"GUAIMBE";135;3;31;169
2015;"GUAIRA (SP)";"SP";"GUAIRA";1280;94;204;1578
2015;"GUAPIACU (SP)";"SP";"GUAPIACU";468;23;69;560
2015;"GUAPIARA (SP)";"SP";"GUAPIARA";366;44;54;464
2015;"GUARA (SP)";"SP";"GUARA";233;45;178;456
2015;"GUARACAI (SP)";"SP";"GUARACAI";300;26;36;362
2015;"GUARACI (SP)";"SP";"GUARACI";200;22;74;296
2015;"GUARANI D OESTE (SP)";"SP";"GUARANI D OESTE";29;4;6;39
2015;"GUARANTA (SP)";"SP";"GUARANTA";98;7;43;148
2015;"GUARARAPES (SP)";"SP";"GUARARAPES";703;61;151;915
2015;"GUARAREMA (SP)";"SP";"GUARAREMA";576;91;46;713
2015;"GUARATINGUETA (SP)";"SP";"GUARATINGUETA";1248;384;214;1846
2015;"GUAREI (SP)";"SP";"GUAREI";296;30;81;407
2015;"GUARIBA (SP)";"SP";"GUARIBA";865;70;295;1230
2015;"GUARUJA (SP)";"SP";"GUARUJA";2184;419;459;3062
2015;"GUARULHOS (SP)";"SP";"GUARULHOS";21581;4042;4163;29786
2015;"GUATAPARA (SP)";"SP";"GUATAPARA";202;19;53;274
2015;"GUZOLANDIA (SP)";"SP";"GUZOLANDIA";75;5;31;111
2015;"HERCULANDIA (SP)";"SP";"HERCULANDIA";509;7;24;540
2015;"HOLAMBRA (SP)";"SP";"HOLAMBRA";395;49;98;542
2015;"HORTOLANDIA (SP)";"SP";"HORTOLANDIA";2128;496;542;3166
2015;"IACANGA (SP)";"SP";"IACANGA";256;32;40;328
2015;"IACRI (SP)";"SP";"IACRI";141;4;22;167
2015;"IARAS (SP)";"SP";"IARAS";65;19;34;118
2015;"IBATE (SP)";"SP";"IBATE";608;126;202;936
2015;"IBIRA (SP)";"SP";"IBIRA";181;19;50;250
2015;"IBIRAREMA (SP)";"SP";"IBIRAREMA";199;17;29;245
2015;"IBITINGA (SP)";"SP";"IBITINGA";873;97;181;1151
2015;"IBIUNA (SP)";"SP";"IBIUNA";2170;249;103;2522
2015;"ICEM (SP)";"SP";"ICEM";218;8;67;293
2015;"IEPE (SP)";"SP";"IEPE";183;13;30;226
2015;"IGARACU DO TIETE (SP)";"SP";"IGARACU DO TIETE";373;42;95;510
2015;"IGARAPAVA (SP)";"SP";"IGARAPAVA";429;53;117;599
2015;"IGARATA (SP)";"SP";"IGARATA";153;27;17;197
2015;"IGUAPE (SP)";"SP";"IGUAPE";252;51;100;403
2015;"ILHA COMPRIDA (SP)";"SP";"ILHA COMPRIDA";186;31;75;292
2015;"ILHA SOLTEIRA (SP)";"SP";"ILHA SOLTEIRA";264;33;93;390
2015;"ILHABELA (SP)";"SP";"ILHABELA";337;68;55;460
2015;"INDAIATUBA (SP)";"SP";"INDAIATUBA";3457;645;372;4474
2015;"INDIANA (SP)";"SP";"INDIANA";129;10;12;151
2015;"INDIAPORA (SP)";"SP";"INDIAPORA";71;5;19;95
2015;"INUBIA PAULISTA (SP)";"SP";"INUBIA PAULISTA";53;8;13;74
2015;"IPAUSSU (SP)";"SP";"IPAUSSU";200;27;59;286
2015;"IPERO (SP)";"SP";"IPERO";279;47;33;359
2015;"IPEUNA (SP)";"SP";"IPEUNA";194;33;39;266
2015;"IPIGUA (SP)";"SP";"IPIGUA";43;5;10;58
2015;"IPORANGA (SP)";"SP";"IPORANGA";29;22;11;62
2015;"IPUA (SP)";"SP";"IPUA";271;26;88;385
2015;"IRACEMAPOLIS (SP)";"SP";"IRACEMAPOLIS";552;65;111;728
2015;"IRAPUA (SP)";"SP";"IRAPUA";139;8;85;232
2015;"IRAPURU (SP)";"SP";"IRAPURU";105;13;28;146
2015;"ITABERA (SP)";"SP";"ITABERA";277;50;46;373
2015;"ITAI (SP)";"SP";"ITAI";561;74;178;813
2015;"ITAJOBI (SP)";"SP";"ITAJOBI";515;19;53;587
2015;"ITAJU (SP)";"SP";"ITAJU";78;2;20;100
2015;"ITANHAEM (SP)";"SP";"ITANHAEM";940;237;130;1307
2015;"ITAOCA (SP)";"SP";"ITAOCA";28;8;9;45
2015;"ITAPECERICA DA SERRA (SP)";"SP";"ITAPECERICA DA SERRA";2695;697;796;4188
2015;"ITAPETININGA (SP)";"SP";"ITAPETININGA";2939;473;510;3922
2015;"ITAPEVA (SP)";"SP";"ITAPEVA";2030;348;410;2788
2015;"ITAPEVI (SP)";"SP";"ITAPEVI";2169;417;191;2777
2015;"ITAPIRA (SP)";"SP";"ITAPIRA";1761;141;245;2147
2015;"ITAPIRAPUA PAULISTA (SP)";"SP";"ITAPIRAPUA PAULISTA";53;18;15;86
2015;"ITAPOLIS (SP)";"SP";"ITAPOLIS";1265;112;212;1589
2015;"ITAPORANGA (SP)";"SP";"ITAPORANGA";240;23;82;345
2015;"ITAPUI (SP)";"SP";"ITAPUI";386;47;66;499
2015;"ITAPURA (SP)";"SP";"ITAPURA";28;8;19;55
2015;"ITAQUAQUECETUBA (SP)";"SP";"ITAQUAQUECETUBA";3860;488;520;4868
2015;"ITARARE (SP)";"SP";"ITARARE";950;88;271;1309
2015;"ITARIRI (SP)";"SP";"ITARIRI";360;35;22;417
2015;"ITATIBA (SP)";"SP";"ITATIBA";2601;282;339;3222
2015;"ITATINGA (SP)";"SP";"ITATINGA";241;53;113;407
2015;"ITIRAPINA (SP)";"SP";"ITIRAPINA";316;47;62;425
2015;"ITIRAPUA (SP)";"SP";"ITIRAPUA";90;6;21;117
2015;"ITOBI (SP)";"SP";"ITOBI";162;31;82;275
2015;"ITU (SP)";"SP";"ITU";3274;491;679;4444
2015;"ITUPEVA (SP)";"SP";"ITUPEVA";1487;139;109;1735
2015;"ITUVERAVA (SP)";"SP";"ITUVERAVA";648;55;116;819
2015;"JABORANDI (SP)";"SP";"JABORANDI";178;11;40;229
2015;"JABOTICABAL (SP)";"SP";"JABOTICABAL";1973;111;223;2307
2015;"JACAREI (SP)";"SP";"JACAREI";2768;638;343;3749
2015;"JACI (SP)";"SP";"JACI";214;8;15;237
2015;"JACUPIRANGA (SP)";"SP";"JACUPIRANGA";417;60;449;926
2015;"JAGUARIUNA (SP)";"SP";"JAGUARIUNA";1156;95;181;1432
2015;"JALES (SP)";"SP";"JALES";1282;51;82;1415
2015;"JAMBEIRO (SP)";"SP";"JAMBEIRO";115;38;16;169
2015;"JANDIRA (SP)";"SP";"JANDIRA";1178;322;205;1705
2015;"JARDINOPOLIS (SP)";"SP";"JARDINOPOLIS";1010;115;138;1263
2015;"JARINU (SP)";"SP";"JARINU";647;63;50;760
2015;"JAU (SP)";"SP";"JAU";2508;339;452;3299
2015;"JERIQUARA (SP)";"SP";"JERIQUARA";61;5;23;89
2015;"JOANOPOLIS (SP)";"SP";"JOANOPOLIS";415;27;18;460
2015;"JOAO RAMALHO (SP)";"SP";"JOAO RAMALHO";37;9;21;67
2015;"JOSE BONIFACIO (SP)";"SP";"JOSE BONIFACIO";899;67;119;1085
2015;"JULIO MESQUITA (SP)";"SP";"JULIO MESQUITA";42;8;31;81
2015;"JUMIRIM (SP)";"SP";"JUMIRIM";101;12;6;119
2015;"JUNDIAI (SP)";"SP";"JUNDIAI";8241;871;1189;10301
2015;"JUNQUEIROPOLIS (SP)";"SP";"JUNQUEIROPOLIS";506;35;210;751
2015;"JUQUIA (SP)";"SP";"JUQUIA";424;36;24;484
2015;"JUQUITIBA (SP)";"SP";"JUQUITIBA";664;118;107;889
2015;"LAGOINHA (SP)";"SP";"LAGOINHA";154;27;23;204
2015;"LARANJAL PAULISTA (SP)";"SP";"LARANJAL PAULISTA";718;60;200;978
2015;"LAVINIA (SP)";"SP";"LAVINIA";83;5;15;103
2015;"LAVRINHAS (SP)";"SP";"LAVRINHAS";96;19;13;128
2015;"LEME (SP)";"SP";"LEME";2554;208;535;3297
2015;"LENCOIS PAULISTA (SP)";"SP";"LENCOIS PAULISTA";1456;228;360;2044
2015;"LIMEIRA (SP)";"SP";"LIMEIRA";5008;993;684;6685
2015;"LINDOIA (SP)";"SP";"LINDOIA";196;31;33;260
2015;"LINS (SP)";"SP";"LINS";1408;134;177;1719
2015;"LORENA (SP)";"SP";"LORENA";955;207;34;1196
2015;"LOURDES (SP)";"SP";"LOURDES";25;4;18;47
2015;"LOUVEIRA (SP)";"SP";"LOUVEIRA";955;164;66;1185
2015;"LUCELIA (SP)";"SP";"LUCELIA";389;28;199;616
2015;"LUCIANOPOLIS (SP)";"SP";"LUCIANOPOLIS";57;9;19;85
2015;"LUIS ANTONIO (SP)";"SP";"LUIS ANTONIO";271;35;181;487
2015;"LUIZIANIA (SP)";"SP";"LUIZIANIA";68;3;27;98
2015;"LUPERCIO (SP)";"SP";"LUPERCIO";53;5;31;89
2015;"LUTECIA (SP)";"SP";"LUTECIA";45;7;12;64
2015;"MACATUBA (SP)";"SP";"MACATUBA";473;32;89;594
2015;"MACAUBAL (SP)";"SP";"MACAUBAL";139;15;28;182
2015;"MACEDONIA (SP)";"SP";"MACEDONIA";45;2;13;60
2015;"MAGDA (SP)";"SP";"MAGDA";106;13;11;130
2015;"MAIRINQUE (SP)";"SP";"MAIRINQUE";643;126;113;882
2015;"MAIRIPORA (SP)";"SP";"MAIRIPORA";2162;310;167;2639
2015;"MANDURI (SP)";"SP";"MANDURI";254;46;88;388
2015;"MARABA PAULISTA (SP)";"SP";"MARABA PAULISTA";40;8;19;67
2015;"MARACAI (SP)";"SP";"MARACAI";324;67;51;442
2015;"MARAPOAMA (SP)";"SP";"MARAPOAMA";146;9;11;166
2015;"MARIAPOLIS (SP)";"SP";"MARIAPOLIS";49;5;32;86
2015;"MARILIA (SP)";"SP";"MARILIA";3359;349;573;4281
2015;"MARINOPOLIS (SP)";"SP";"MARINOPOLIS";86;7;8;101
2015;"MARTINOPOLIS (SP)";"SP";"MARTINOPOLIS";452;48;120;620
2015;"MATAO (SP)";"SP";"MATAO";1618;113;393;2124
2015;"MAUA (SP)";"SP";"MAUA";3901;1102;1424;6427
2015;"MENDONCA (SP)";"SP";"MENDONCA";110;6;28;144
2015;"MERIDIANO (SP)";"SP";"MERIDIANO";177;12;21;210
2015;"MESOPOLIS (SP)";"SP";"MESOPOLIS";18;4;13;35
2015;"MIGUELOPOLIS (SP)";"SP";"MIGUELOPOLIS";306;15;90;411
2015;"MINEIROS DO TIETE (SP)";"SP";"MINEIROS DO TIETE";260;19;56;335
2015;"MIRA ESTRELA (SP)";"SP";"MIRA ESTRELA";45;8;30;83
2015;"MIRACATU (SP)";"SP";"MIRACATU";678;82;35;795
2015;"MIRANDOPOLIS (SP)";"SP";"MIRANDOPOLIS";547;47;164;758
2015;"MIRANTE DO PARANAPANEMA (SP)";"SP";"MIRANTE DO PARANAPANEMA";288;62;97;447
2015;"MIRASSOL (SP)";"SP";"MIRASSOL";1327;58;90;1475
2015;"MIRASSOLANDIA (SP)";"SP";"MIRASSOLANDIA";50;11;10;71
2015;"MOCOCA (SP)";"SP";"MOCOCA";1234;137;349;1720
2015;"MOGI DAS CRUZES (SP)";"SP";"MOGI DAS CRUZES";6349;910;1579;8838
2015;"MOGI GUACU (SP)";"SP";"MOGI GUACU";2571;506;590;3667
2015;"MOGI MIRIM (SP)";"SP";"MOGI MIRIM";1997;221;433;2651
2015;"MOMBUCA (SP)";"SP";"MOMBUCA";106;7;19;132
2015;"MONCOES (SP)";"SP";"MONCOES";78;14;14;106
2015;"MONGAGUA (SP)";"SP";"MONGAGUA";565;116;80;761
2015;"MONTE ALEGRE DO SUL (SP)";"SP";"MONTE ALEGRE DO SUL";231;48;46;325
2015;"MONTE ALTO (SP)";"SP";"MONTE ALTO";1494;94;109;1697
2015;"MONTE APRAZIVEL (SP)";"SP";"MONTE APRAZIVEL";626;51;231;908
2015;"MONTE AZUL PAULISTA (SP)";"SP";"MONTE AZUL PAULISTA";516;45;170;731
2015;"MONTE CASTELO (SP)";"SP";"MONTE CASTELO";86;6;11;103
2015;"MONTE MOR (SP)";"SP";"MONTE MOR";756;110;135;1001
2015;"MONTEIRO LOBATO (SP)";"SP";"MONTEIRO LOBATO";190;42;16;248
2015;"MORRO AGUDO (SP)";"SP";"MORRO AGUDO";696;51;181;928
2015;"MORUNGABA (SP)";"SP";"MORUNGABA";394;64;33;491
2015;"MOTUCA (SP)";"SP";"MOTUCA";141;10;29;180
2015;"MUNICIPIO NAO INFORMADO (SP)";"SP";"MUNICIPIO NAO INFORMADO";0;0;0;0
2015;"MURUTINGA DO SUL (SP)";"SP";"MURUTINGA DO SUL";89;9;20;118
2015;"NANTES (SP)";"SP";"NANTES";24;13;17;54
2015;"NARANDIBA (SP)";"SP";"NARANDIBA";87;8;19;114
2015;"NATIVIDADE DA SERRA (SP)";"SP";"NATIVIDADE DA SERRA";102;52;9;163
2015;"NAZARE PAULISTA (SP)";"SP";"NAZARE PAULISTA";720;25;30;775
2015;"NEVES PAULISTA (SP)";"SP";"NEVES PAULISTA";188;10;32;230
2015;"NHANDEARA (SP)";"SP";"NHANDEARA";205;22;48;275
2015;"NIPOA (SP)";"SP";"NIPOA";132;12;34;178
2015;"NOVA ALIANCA (SP)";"SP";"NOVA ALIANCA";150;13;18;181
2015;"NOVA CAMPINA (SP)";"SP";"NOVA CAMPINA";85;17;23;125
2015;"NOVA CANAA PAULISTA (SP)";"SP";"NOVA CANAA PAULISTA";39;5;7;51
2015;"NOVA CASTILHO (SP)";"SP";"NOVA CASTILHO";21;3;4;28
2015;"NOVA EUROPA (SP)";"SP";"NOVA EUROPA";179;13;141;333
2015;"NOVA GRANADA (SP)";"SP";"NOVA GRANADA";361;56;109;526
2015;"NOVA GUATAPORANGA (SP)";"SP";"NOVA GUATAPORANGA";35;5;15;55
2015;"NOVA INDEPENDENCIA (SP)";"SP";"NOVA INDEPENDENCIA";59;10;15;84
2015;"NOVA LUZITANIA (SP)";"SP";"NOVA LUZITANIA";39;3;28;70
2015;"NOVA ODESSA (SP)";"SP";"NOVA ODESSA";923;142;137;1202
2015;"NOVAIS (SP)";"SP";"NOVAIS";101;7;32;140
2015;"NOVO HORIZONTE (SP)";"SP";"NOVO HORIZONTE";1187;46;314;1547
2015;"NUPORANGA (SP)";"SP";"NUPORANGA";226;21;53;300
2015;"OCAUCU (SP)";"SP";"OCAUCU";122;10;22;154
2015;"OLEO (SP)";"SP";"OLEO";39;13;8;60
2015;"OLIMPIA (SP)";"SP";"OLIMPIA";975;126;237;1338
2015;"ONDA VERDE (SP)";"SP";"ONDA VERDE";106;10;23;139
2015;"ORIENTE (SP)";"SP";"ORIENTE";104;14;18;136
2015;"ORINDIUVA (SP)";"SP";"ORINDIUVA";224;11;82;317
2015;"ORLANDIA (SP)";"SP";"ORLANDIA";952;61;299;1312
2015;"OSASCO (SP)";"SP";"OSASCO";10525;2172;2768;15465
2015;"OSCAR BRESSANE (SP)";"SP";"OSCAR BRESSANE";63;8;4;75
2015;"OSVALDO CRUZ (SP)";"SP";"OSVALDO CRUZ";546;37;113;696
2015;"OURINHOS (SP)";"SP";"OURINHOS";2232;165;622;3019
2015;"OURO VERDE (SP)";"SP";"OURO VERDE";129;5;65;199
2015;"OUROESTE (SP)";"SP";"OUROESTE";194;12;40;246
2015;"PACAEMBU (SP)";"SP";"PACAEMBU";203;27;42;272
2015;"PALESTINA (SP)";"SP";"PALESTINA";190;19;50;259
2015;"PALMARES PAULISTA (SP)";"SP";"PALMARES PAULISTA";79;17;115;211
2015;"PALMEIRA D OESTE (SP)";"SP";"PALMEIRA D OESTE";261;9;34;304
2015;"PALMITAL (SP)";"SP";"PALMITAL";669;43;56;768
2015;"PANORAMA (SP)";"SP";"PANORAMA";346;10;20;376
2015;"PARAGUACU PAULISTA (SP)";"SP";"PARAGUACU PAULISTA";886;171;117;1174
2015;"PARAIBUNA (SP)";"SP";"PARAIBUNA";257;77;73;407
2015;"PARAISO (SP)";"SP";"PARAISO";192;17;94;303
2015;"PARANAPANEMA (SP)";"SP";"PARANAPANEMA";603;51;78;732
2015;"PARANAPUA (SP)";"SP";"PARANAPUA";98;14;16;128
2015;"PARAPUA (SP)";"SP";"PARAPUA";322;11;59;392
2015;"PARDINHO (SP)";"SP";"PARDINHO";155;26;33;214
2015;"PARIQUERA ACU (SP)";"SP";"PARIQUERA ACU";427;38;21;486
2015;"PARISI (SP)";"SP";"PARISI";33;8;12;53
2015;"PATROCINIO PAULISTA (SP)";"SP";"PATROCINIO PAULISTA";290;19;60;369
2015;"PAULICEIA (SP)";"SP";"PAULICEIA";322;10;31;363
2015;"PAULINIA (SP)";"SP";"PAULINIA";2143;227;378;2748
2015;"PAULISTANIA (SP)";"SP";"PAULISTANIA";27;15;10;52
2015;"PAULO DE FARIA (SP)";"SP";"PAULO DE FARIA";106;16;45;167
2015;"PEDERNEIRAS (SP)";"SP";"PEDERNEIRAS";1118;113;227;1458
2015;"PEDRA BELA (SP)";"SP";"PEDRA BELA";236;13;15;264
2015;"PEDRANOPOLIS (SP)";"SP";"PEDRANOPOLIS";58;3;14;75
2015;"PEDREGULHO (SP)";"SP";"PEDREGULHO";304;39;138;481
2015;"PEDREIRA (SP)";"SP";"PEDREIRA";813;135;78;1026
2015;"PEDRINHAS PAULISTA (SP)";"SP";"PEDRINHAS PAULISTA";163;7;12;182
2015;"PEDRO DE TOLEDO (SP)";"SP";"PEDRO DE TOLEDO";164;41;17;222
2015;"PENAPOLIS (SP)";"SP";"PENAPOLIS";1403;91;303;1797
2015;"PEREIRA BARRETO (SP)";"SP";"PEREIRA BARRETO";389;53;98;540
2015;"PEREIRAS (SP)";"SP";"PEREIRAS";272;14;29;315
2015;"PERUIBE (SP)";"SP";"PERUIBE";683;217;107;1007
2015;"PIACATU (SP)";"SP";"PIACATU";96;3;18;117
2015;"PIEDADE (SP)";"SP";"PIEDADE";1515;156;106;1777
2015;"PILAR DO SUL (SP)";"SP";"PILAR DO SUL";1123;83;97;1303
2015;"PINDAMONHANGABA (SP)";"SP";"PINDAMONHANGABA";2064;433;184;2681
2015;"PINDORAMA (SP)";"SP";"PINDORAMA";320;32;57;409
2015;"PINHALZINHO (SP)";"SP";"PINHALZINHO";448;58;17;523
2015;"PIQUEROBI (SP)";"SP";"PIQUEROBI";40;4;11;55
2015;"PIQUETE (SP)";"SP";"PIQUETE";179;54;19;252
2015;"PIRACAIA (SP)";"SP";"PIRACAIA";552;90;45;687
2015;"PIRACICABA (SP)";"SP";"PIRACICABA";7970;979;1474;10423
2015;"PIRAJU (SP)";"SP";"PIRAJU";485;81;79;645
2015;"PIRAJUI (SP)";"SP";"PIRAJUI";324;25;94;443
2015;"PIRANGI (SP)";"SP";"PIRANGI";389;18;74;481
2015;"PIRAPORA DO BOM JESUS (SP)";"SP";"PIRAPORA DO BOM JESUS";261;47;106;414
2015;"PIRAPOZINHO (SP)";"SP";"PIRAPOZINHO";472;43;96;611
2015;"PIRASSUNUNGA (SP)";"SP";"PIRASSUNUNGA";1129;161;250;1540
2015;"PIRATININGA (SP)";"SP";"PIRATININGA";268;26;46;340
2015;"PITANGUEIRAS (SP)";"SP";"PITANGUEIRAS";961;55;303;1319
2015;"PLANALTO (SP)";"SP";"PLANALTO";136;11;57;204
2015;"PLATINA (SP)";"SP";"PLATINA";62;18;12;92
2015;"POA (SP)";"SP";"POA";1108;231;191;1530
2015;"POLONI (SP)";"SP";"POLONI";180;5;54;239
2015;"POMPEIA (SP)";"SP";"POMPEIA";291;17;53;361
2015;"PONGAI (SP)";"SP";"PONGAI";73;6;21;100
2015;"PONTAL (SP)";"SP";"PONTAL";1045;35;525;1605
2015;"PONTALINDA (SP)";"SP";"PONTALINDA";38;12;30;80
2015;"PONTES GESTAL (SP)";"SP";"PONTES GESTAL";106;5;31;142
2015;"POPULINA (SP)";"SP";"POPULINA";57;8;15;80
2015;"PORANGABA (SP)";"SP";"PORANGABA";155;15;16;186
2015;"PORTO FELIZ (SP)";"SP";"PORTO FELIZ";1415;114;206;1735
2015;"PORTO FERREIRA (SP)";"SP";"PORTO FERREIRA";1208;122;151;1481
2015;"POTIM (SP)";"SP";"POTIM";82;50;19;151
2015;"POTIRENDABA (SP)";"SP";"POTIRENDABA";552;18;79;649
2015;"PRACINHA (SP)";"SP";"PRACINHA";14;2;13;29
2015;"PRADOPOLIS (SP)";"SP";"PRADOPOLIS";406;26;234;666
2015;"PRAIA GRANDE (SP)";"SP";"PRAIA GRANDE";2673;409;286;3368
2015;"PRATANIA (SP)";"SP";"PRATANIA";113;20;58;191
2015;"PRESIDENTE ALVES (SP)";"SP";"PRESIDENTE ALVES";65;4;46;115
2015;"PRESIDENTE BERNARDES (SP)";"SP";"PRESIDENTE BERNARDES";257;36;53;346
2015;"PRESIDENTE EPITACIO (SP)";"SP";"PRESIDENTE EPITACIO";560;82;172;814
2015;"PRESIDENTE PRUDENTE (SP)";"SP";"PRESIDENTE PRUDENTE";4069;398;910;5377
2015;"PRESIDENTE VENCESLAU (SP)";"SP";"PRESIDENTE VENCESLAU";727;60;75;862
2015;"PROMISSAO (SP)";"SP";"PROMISSAO";728;140;181;1049
2015;"QUADRA (SP)";"SP";"QUADRA";72;10;18;100
2015;"QUATA (SP)";"SP";"QUATA";254;26;74;354
2015;"QUEIROZ (SP)";"SP";"QUEIROZ";28;10;10;48
2015;"QUELUZ (SP)";"SP";"QUELUZ";120;41;10;171
2015;"QUINTANA (SP)";"SP";"QUINTANA";179;14;26;219
2015;"RAFARD (SP)";"SP";"RAFARD";285;25;25;335
2015;"RANCHARIA (SP)";"SP";"RANCHARIA";629;84;108;821
2015;"REDENCAO DA SERRA (SP)";"SP";"REDENCAO DA SERRA";101;26;43;170
2015;"REGENTE FEIJO (SP)";"SP";"REGENTE FEIJO";419;44;37;500
2015;"REGINOPOLIS (SP)";"SP";"REGINOPOLIS";85;8;23;116
2015;"REGISTRO (SP)";"SP";"REGISTRO";1331;134;299;1764
2015;"RESTINGA (SP)";"SP";"RESTINGA";119;10;29;158
2015;"RIBEIRA (SP)";"SP";"RIBEIRA";29;11;13;53
2015;"RIBEIRAO BONITO (SP)";"SP";"RIBEIRAO BONITO";293;48;98;439
2015;"RIBEIRAO BRANCO (SP)";"SP";"RIBEIRAO BRANCO";206;39;59;304
2015;"RIBEIRAO CORRENTE (SP)";"SP";"RIBEIRAO CORRENTE";90;7;39;136
2015;"RIBEIRAO DO SUL (SP)";"SP";"RIBEIRAO DO SUL";156;13;17;186
2015;"RIBEIRAO DOS INDIOS (SP)";"SP";"RIBEIRAO DOS INDIOS";28;3;8;39
2015;"RIBEIRAO GRANDE (SP)";"SP";"RIBEIRAO GRANDE";80;34;16;130
2015;"RIBEIRAO PIRES (SP)";"SP";"RIBEIRAO PIRES";3212;541;460;4213
2015;"RIBEIRAO PRETO (SP)";"SP";"RIBEIRAO PRETO";10984;1090;1820;13894
2015;"RIFAINA (SP)";"SP";"RIFAINA";45;15;10;70
2015;"RINCAO (SP)";"SP";"RINCAO";268;19;49;336
2015;"RINOPOLIS (SP)";"SP";"RINOPOLIS";205;8;46;259
2015;"RIO CLARO (SP)";"SP";"RIO CLARO";3403;429;438;4270
2015;"RIO DAS PEDRAS (SP)";"SP";"RIO DAS PEDRAS";705;101;170;976
2015;"RIO GRANDE DA SERRA (SP)";"SP";"RIO GRANDE DA SERRA";598;233;107;938
2015;"RIOLANDIA (SP)";"SP";"RIOLANDIA";92;15;50;157
2015;"RIVERSUL (SP)";"SP";"RIVERSUL";84;29;32;145
2015;"ROSANA (SP)";"SP";"ROSANA";172;33;63;268
2015;"ROSEIRA (SP)";"SP";"ROSEIRA";135;98;24;257
2015;"RUBIACEA (SP)";"SP";"RUBIACEA";32;3;12;47
2015;"RUBINEIA (SP)";"SP";"RUBINEIA";27;9;10;46
2015;"SABINO (SP)";"SP";"SABINO";63;7;16;86
2015;"SAGRES (SP)";"SP";"SAGRES";27;2;6;35
2015;"SALES (SP)";"SP";"SALES";93;2;35;130
2015;"SALES OLIVEIRA (SP)";"SP";"SALES OLIVEIRA";279;17;58;354
2015;"SALESOPOLIS (SP)";"SP";"SALESOPOLIS";883;92;101;1076
2015;"SALMOURAO (SP)";"SP";"SALMOURAO";38;3;36;77
2015;"SALTINHO (SP)";"SP";"SALTINHO";383;14;12;409
2015;"SALTO (SP)";"SP";"SALTO";2432;300;177;2909
2015;"SALTO DE PIRAPORA (SP)";"SP";"SALTO DE PIRAPORA";733;86;70;889
2015;"SALTO GRANDE (SP)";"SP";"SALTO GRANDE";160;15;31;206
2015;"SANDOVALINA (SP)";"SP";"SANDOVALINA";62;7;20;89
2015;"SANTA ADELIA (SP)";"SP";"SANTA ADELIA";619;31;90;740
2015;"SANTA ALBERTINA (SP)";"SP";"SANTA ALBERTINA";138;7;29;174
2015;"SANTA BARBARA D OESTE (SP)";"SP";"SANTA BARBARA D OESTE";2507;484;362;3353
2015;"SANTA BRANCA (SP)";"SP";"SANTA BRANCA";148;46;38;232
2015;"SANTA CLARA D OESTE (SP)";"SP";"SANTA CLARA D OESTE";31;5;6;42
2015;"SANTA CRUZ DA CONCEICAO (SP)";"SP";"SANTA CRUZ DA CONCEICAO";155;17;16;188
2015;"SANTA CRUZ DA ESPERANCA (SP)";"SP";"SANTA CRUZ DA ESPERANCA";44;2;3;49
2015;"SANTA CRUZ DAS PALMEIRAS (SP)";"SP";"SANTA CRUZ DAS PALMEIRAS";594;56;211;861
2015;"SANTA CRUZ DO RIO PARDO (SP)";"SP";"SANTA CRUZ DO RIO PARDO";1475;109;110;1694
2015;"SANTA ERNESTINA (SP)";"SP";"SANTA ERNESTINA";79;18;84;181
2015;"SANTA FE DO SUL (SP)";"SP";"SANTA FE DO SUL";671;36;48;755
2015;"SANTA GERTRUDES (SP)";"SP";"SANTA GERTRUDES";631;58;36;725
2015;"SANTA ISABEL (SP)";"SP";"SANTA ISABEL";1268;108;115;1491
2015;"SANTA LUCIA (SP)";"SP";"SANTA LUCIA";130;26;44;200
2015;"SANTA MARIA DA SERRA (SP)";"SP";"SANTA MARIA DA SERRA";291;32;30;353
2015;"SANTA MERCEDES (SP)";"SP";"SANTA MERCEDES";61;9;9;79
2015;"SANTA RITA D OESTE (SP)";"SP";"SANTA RITA D OESTE";36;2;6;44
2015;"SANTA RITA DO PASSA QUATRO (SP)";"SP";"SANTA RITA DO PASSA QUATRO";578;75;52;705
2015;"SANTA ROSA DE VITERBO (SP)";"SP";"SANTA ROSA DE VITERBO";453;42;106;601
2015;"SANTA SALETE (SP)";"SP";"SANTA SALETE";41;6;9;56
2015;"SANTANA DA PONTE PENSA (SP)";"SP";"SANTANA DA PONTE PENSA";26;4;6;36
2015;"SANTANA DE PARNAIBA (SP)";"SP";"SANTANA DE PARNAIBA";1970;436;201;2607
2015;"SANTO ANASTACIO (SP)";"SP";"SANTO ANASTACIO";503;41;65;609
2015;"SANTO ANDRE (SP)";"SP";"SANTO ANDRE";9448;1781;1735;12964
2015;"SANTO ANTONIO DA ALEGRIA (SP)";"SP";"SANTO ANTONIO DA ALEGRIA";121;12;29;162
2015;"SANTO ANTONIO DE POSSE (SP)";"SP";"SANTO ANTONIO DE POSSE";872;73;160;1105
2015;"SANTO ANTONIO DO ARACANGUA (SP)";"SP";"SANTO ANTONIO DO ARACANGUA";200;33;87;320
2015;"SANTO ANTONIO DO JARDIM (SP)";"SP";"SANTO ANTONIO DO JARDIM";221;16;15;252
2015;"SANTO ANTONIO DO PINHAL (SP)";"SP";"SANTO ANTONIO DO PINHAL";178;27;13;218
2015;"SANTO EXPEDITO (SP)";"SP";"SANTO EXPEDITO";28;3;14;45
2015;"SANTOPOLIS DO AGUAPEI (SP)";"SP";"SANTOPOLIS DO AGUAPEI";72;2;31;105
2015;"SANTOS (SP)";"SP";"SANTOS";5678;986;715;7379
2015;"SAO BENTO DO SAPUCAI (SP)";"SP";"SAO BENTO DO SAPUCAI";171;51;17;239
2015;"SAO BERNARDO DO CAMPO (SP)";"SP";"SAO BERNARDO DO CAMPO";12470;2611;4251;19332
2015;"SAO CAETANO DO SUL (SP)";"SP";"SAO CAETANO DO SUL";2913;519;640;4072
2015;"SAO CARLOS (SP)";"SP";"SAO CARLOS";4022;464;430;4916
2015;"SAO FRANCISCO (SP)";"SP";"SAO FRANCISCO";50;6;23;79
2015;"SAO JOAO DA BOA VISTA (SP)";"SP";"SAO JOAO DA BOA VISTA";2058;290;105;2453
2015;"SAO JOAO DAS DUAS PONTES (SP)";"SP";"SAO JOAO DAS DUAS PONTES";23;8;4;35
2015;"SAO JOAO DE IRACEMA (SP)";"SP";"SAO JOAO DE IRACEMA";39;5;8;52
2015;"SAO JOAO DO PAU D ALHO (SP)";"SP";"SAO JOAO DO PAU D ALHO";35;4;6;45
2015;"SAO JOAQUIM DA BARRA (SP)";"SP";"SAO JOAQUIM DA BARRA";846;86;213;1145
2015;"SAO JOSE DA BELA VISTA (SP)";"SP";"SAO JOSE DA BELA VISTA";75;17;52;144
2015;"SAO JOSE DO BARREIRO (SP)";"SP";"SAO JOSE DO BARREIRO";41;15;5;61
2015;"SAO JOSE DO RIO PARDO (SP)";"SP";"SAO JOSE DO RIO PARDO";1261;102;170;1533
2015;"SAO JOSE DO RIO PRETO (SP)";"SP";"SAO JOSE DO RIO PRETO";8922;668;1718;11308
2015;"SAO JOSE DOS CAMPOS (SP)";"SP";"SAO JOSE DOS CAMPOS";7301;1919;1789;11009
2015;"SAO LOURENCO DA SERRA (SP)";"SP";"SAO LOURENCO DA SERRA";370;32;30;432
2015;"SAO LUIZ DO PARAITINGA (SP)";"SP";"SAO LUIZ DO PARAITINGA";185;35;31;251
2015;"SAO MANUEL (SP)";"SP";"SAO MANUEL";794;136;233;1163
2015;"SAO MIGUEL ARCANJO (SP)";"SP";"SAO MIGUEL ARCANJO";746;118;84;948
2015;"SAO PAULO (SP)";"SP";"SAO PAULO";123943;37416;43332;204691
2015;"SAO PEDRO (SP)";"SP";"SAO PEDRO";631;113;95;839
2015;"SAO PEDRO DO TURVO (SP)";"SP";"SAO PEDRO DO TURVO";187;22;44;253
2015;"SAO ROQUE (SP)";"SP";"SAO ROQUE";1226;260;219;1705
2015;"SAO SEBASTIAO (SP)";"SP";"SAO SEBASTIAO";858;149;179;1186
2015;"SAO SEBASTIAO DA GRAMA (SP)";"SP";"SAO SEBASTIAO DA GRAMA";252;35;39;326
2015;"SAO SIMAO (SP)";"SP";"SAO SIMAO";371;26;52;449
2015;"SAO VICENTE (SP)";"SP";"SAO VICENTE";2047;613;1087;3747
2015;"SARAPUI (SP)";"SP";"SARAPUI";174;33;20;227
2015;"SARUTAIA (SP)";"SP";"SARUTAIA";55;9;32;96
2015;"SEBASTIANOPOLIS DO SUL (SP)";"SP";"SEBASTIANOPOLIS DO SUL";266;4;16;286
2015;"SERRA AZUL (SP)";"SP";"SERRA AZUL";167;16;114;297
2015;"SERRA NEGRA (SP)";"SP";"SERRA NEGRA";460;68;24;552
2015;"SERRANA (SP)";"SP";"SERRANA";624;119;245;988
2015;"SERTAOZINHO (SP)";"SP";"SERTAOZINHO";2716;177;658;3551
2015;"SETE BARRAS (SP)";"SP";"SETE BARRAS";235;18;33;286
2015;"SEVERINIA (SP)";"SP";"SEVERINIA";315;18;232;565
2015;"SILVEIRAS (SP)";"SP";"SILVEIRAS";89;27;7;123
2015;"SOCORRO (SP)";"SP";"SOCORRO";951;148;53;1152
2015;"SOROCABA (SP)";"SP";"SOROCABA";8152;1519;1771;11442
2015;"SUD MENNUCCI (SP)";"SP";"SUD MENNUCCI";145;18;54;217
2015;"SUMARE (SP)";"SP";"SUMARE";2831;663;650;4144
2015;"SUZANAPOLIS (SP)";"SP";"SUZANAPOLIS";87;8;18;113
2015;"SUZANO (SP)";"SP";"SUZANO";3436;916;781;5133
2015;"TABAPUA (SP)";"SP";"TABAPUA";176;14;55;245
2015;"TABATINGA (SP)";"SP";"TABATINGA";344;25;177;546
2015;"TABOAO DA SERRA (SP)";"SP";"TABOAO DA SERRA";2815;1004;639;4458
2015;"TACIBA (SP)";"SP";"TACIBA";92;14;23;129
2015;"TAGUAI (SP)";"SP";"TAGUAI";179;17;33;229
2015;"TAIACU (SP)";"SP";"TAIACU";159;7;24;190
2015;"TAIUVA (SP)";"SP";"TAIUVA";167;10;28;205
2015;"TAMBAU (SP)";"SP";"TAMBAU";579;51;67;697
2015;"TANABI (SP)";"SP";"TANABI";505;59;118;682
2015;"TAPIRAI (SP)";"SP";"TAPIRAI";213;17;12;242
2015;"TAPIRATIBA (SP)";"SP";"TAPIRATIBA";374;28;76;478
2015;"TAQUARAL (SP)";"SP";"TAQUARAL";68;7;22;97
2015;"TAQUARITINGA (SP)";"SP";"TAQUARITINGA";1572;114;347;2033
2015;"TAQUARITUBA (SP)";"SP";"TAQUARITUBA";734;67;104;905
2015;"TAQUARIVAI (SP)";"SP";"TAQUARIVAI";88;13;17;118
2015;"TARABAI (SP)";"SP";"TARABAI";130;7;25;162
2015;"TARUMA (SP)";"SP";"TARUMA";349;31;173;553
2015;"TATUI (SP)";"SP";"TATUI";2315;199;752;3266
2015;"TAUBATE (SP)";"SP";"TAUBATE";3313;895;778;4986
2015;"TEJUPA (SP)";"SP";"TEJUPA";62;25;11;98
2015;"TEODORO SAMPAIO (SP)";"SP";"TEODORO SAMPAIO";312;44;326;682
2015;"TERRA ROXA (SP)";"SP";"TERRA ROXA";170;18;71;259
2015;"TIETE (SP)";"SP";"TIETE";1289;64;204;1557
2015;"TIMBURI (SP)";"SP";"TIMBURI";33;6;5;44
2015;"TORRE DE PEDRA (SP)";"SP";"TORRE DE PEDRA";49;9;9;67
2015;"TORRINHA (SP)";"SP";"TORRINHA";441;23;48;512
2015;"TRABIJU (SP)";"SP";"TRABIJU";50;12;9;71
2015;"TREMEMBE (SP)";"SP";"TREMEMBE";477;76;17;570
2015;"TRES FRONTEIRAS (SP)";"SP";"TRES FRONTEIRAS";70;22;12;104
2015;"TUIUTI (SP)";"SP";"TUIUTI";118;28;17;163
2015;"TUPA (SP)";"SP";"TUPA";1565;68;262;1895
2015;"TUPI PAULISTA (SP)";"SP";"TUPI PAULISTA";335;25;33;393
2015;"TURIUBA (SP)";"SP";"TURIUBA";26;3;11;40
2015;"TURMALINA (SP)";"SP";"TURMALINA";29;2;12;43
2015;"UBARANA (SP)";"SP";"UBARANA";135;2;35;172
2015;"UBATUBA (SP)";"SP";"UBATUBA";745;129;82;956
2015;"UBIRAJARA (SP)";"SP";"UBIRAJARA";108;8;31;147
2015;"UCHOA (SP)";"SP";"UCHOA";170;17;49;236
2015;"UNIAO PAULISTA (SP)";"SP";"UNIAO PAULISTA";59;6;11;76
2015;"URANIA (SP)";"SP";"URANIA";155;18;37;210
2015;"URU (SP)";"SP";"URU";14;10;9;33
2015;"URUPES (SP)";"SP";"URUPES";379;22;51;452
2015;"VALENTIM GENTIL (SP)";"SP";"VALENTIM GENTIL";308;23;32;363
2015;"VALINHOS (SP)";"SP";"VALINHOS";2196;542;2005;4743
2015;"VALPARAISO (SP)";"SP";"VALPARAISO";462;33;160;655
2015;"VARGEM (SP)";"SP";"VARGEM";333;25;23;381
2015;"VARGEM GRANDE DO SUL (SP)";"SP";"VARGEM GRANDE DO SUL";1228;104;228;1560
2015;"VARGEM GRANDE PAULISTA (SP)";"SP";"VARGEM GRANDE PAULISTA";1048;126;84;1258
2015;"VARZEA PAULISTA (SP)";"SP";"VARZEA PAULISTA";1228;424;343;1995
2015;"VERA CRUZ (SP)";"SP";"VERA CRUZ";164;22;35;221
2015;"VINHEDO (SP)";"SP";"VINHEDO";1558;153;155;1866
2015;"VIRADOURO (SP)";"SP";"VIRADOURO";377;27;85;489
2015;"VISTA ALEGRE DO ALTO (SP)";"SP";"VISTA ALEGRE DO ALTO";422;38;142;602
2015;"VITORIA BRASIL (SP)";"SP";"VITORIA BRASIL";29;4;8;41
2015;"VOTORANTIM (SP)";"SP";"VOTORANTIM";1324;303;263;1890
2015;"VOTUPORANGA (SP)";"SP";"VOTUPORANGA";2140;153;266;2559
2015;"ZACARIAS (SP)";"SP";"ZACARIAS";60;7;22;89
2015;"ABREULANDIA (TO)";"TO";"ABREULANDIA";21;1;2;24
2015;"AGUIARNOPOLIS (TO)";"TO";"AGUIARNOPOLIS";64;4;15;83
2015;"ALIANCA DO TOCANTINS (TO)";"TO";"ALIANCA DO TOCANTINS";82;8;13;103
2015;"ALMAS (TO)";"TO";"ALMAS";70;0;9;79
2015;"ALVORADA (TO)";"TO";"ALVORADA";208;1;16;225
2015;"ANANAS (TO)";"TO";"ANANAS";85;1;28;114
2015;"ANGICO (TO)";"TO";"ANGICO";19;5;7;31
2015;"APARECIDA DO RIO NEGRO (TO)";"TO";"APARECIDA DO RIO NEGRO";65;13;5;83
2015;"ARAGOMINAS (TO)";"TO";"ARAGOMINAS";63;2;14;79
2015;"ARAGUACEMA (TO)";"TO";"ARAGUACEMA";29;4;9;42
2015;"ARAGUACU (TO)";"TO";"ARAGUACU";109;13;13;135
2015;"ARAGUAINA (TO)";"TO";"ARAGUAINA";3856;199;742;4797
2015;"ARAGUANA (TO)";"TO";"ARAGUANA";96;3;25;124
2015;"ARAGUATINS (TO)";"TO";"ARAGUATINS";330;50;74;454
2015;"ARAPOEMA (TO)";"TO";"ARAPOEMA";51;5;13;69
2015;"ARRAIAS (TO)";"TO";"ARRAIAS";46;2;7;55
2015;"AUGUSTINOPOLIS (TO)";"TO";"AUGUSTINOPOLIS";210;33;39;282
2015;"AURORA DO TOCANTINS (TO)";"TO";"AURORA DO TOCANTINS";10;0;5;15
2015;"AXIXA DO TOCANTINS (TO)";"TO";"AXIXA DO TOCANTINS";57;17;9;83
2015;"BABACULANDIA (TO)";"TO";"BABACULANDIA";264;13;21;298
2015;"BANDEIRANTES DO TOCANTINS (TO)";"TO";"BANDEIRANTES DO TOCANTINS";26;4;4;34
2015;"BARRA DO OURO (TO)";"TO";"BARRA DO OURO";18;1;4;23
2015;"BARROLANDIA (TO)";"TO";"BARROLANDIA";60;3;7;70
2015;"BERNARDO SAYAO (TO)";"TO";"BERNARDO SAYAO";35;1;7;43
2015;"BOM JESUS DO TOCANTINS (TO)";"TO";"BOM JESUS DO TOCANTINS";10;1;3;14
2015;"BRASILANDIA DO TOCANTINS (TO)";"TO";"BRASILANDIA DO TOCANTINS";20;2;2;24
2015;"BREJINHO DE NAZARE (TO)";"TO";"BREJINHO DE NAZARE";52;1;20;73
2015;"BURITI DO TOCANTINS (TO)";"TO";"BURITI DO TOCANTINS";51;12;6;69
2015;"CACHOEIRINHA (TO)";"TO";"CACHOEIRINHA";9;0;2;11
2015;"CAMPOS LINDOS (TO)";"TO";"CAMPOS LINDOS";73;0;6;79
2015;"CARIRI DO TOCANTINS (TO)";"TO";"CARIRI DO TOCANTINS";43;5;9;57
2015;"CARMOLANDIA (TO)";"TO";"CARMOLANDIA";239;17;102;358
2015;"CARRASCO BONITO (TO)";"TO";"CARRASCO BONITO";8;8;2;18
2015;"CASEARA (TO)";"TO";"CASEARA";30;3;5;38
2015;"CENTENARIO (TO)";"TO";"CENTENARIO";4;0;3;7
2015;"CHAPADA DA NATIVIDADE (TO)";"TO";"CHAPADA DA NATIVIDADE";21;1;9;31
2015;"CHAPADA DE AREIA (TO)";"TO";"CHAPADA DE AREIA";7;2;2;11
2015;"COLINAS DO TOCANTINS (TO)";"TO";"COLINAS DO TOCANTINS";594;15;74;683
2015;"COLMEIA (TO)";"TO";"COLMEIA";134;8;18;160
2015;"COMBINADO (TO)";"TO";"COMBINADO";18;1;11;30
2015;"CONCEICAO DO TOCANTINS (TO)";"TO";"CONCEICAO DO TOCANTINS";18;1;3;22
2015;"COUTO DE MAGALHAES (TO)";"TO";"COUTO DE MAGALHAES";27;6;12;45
2015;"CRISTALANDIA (TO)";"TO";"CRISTALANDIA";106;1;7;114
2015;"CRIXAS DO TOCANTINS (TO)";"TO";"CRIXAS DO TOCANTINS";15;1;3;19
2015;"DARCINOPOLIS (TO)";"TO";"DARCINOPOLIS";90;8;11;109
2015;"DIANOPOLIS (TO)";"TO";"DIANOPOLIS";230;22;64;316
2015;"DIVINOPOLIS DO TOCANTINS (TO)";"TO";"DIVINOPOLIS DO TOCANTINS";93;2;7;102
2015;"DOIS IRMAOS DO TOCANTINS (TO)";"TO";"DOIS IRMAOS DO TOCANTINS";43;6;11;60
2015;"DUERE (TO)";"TO";"DUERE";49;2;4;55
2015;"ESPERANTINA (TO)";"TO";"ESPERANTINA";25;12;10;47
2015;"FATIMA (TO)";"TO";"FATIMA";58;2;9;69
2015;"FIGUEIROPOLIS (TO)";"TO";"FIGUEIROPOLIS";81;5;9;95
2015;"FILADELFIA (TO)";"TO";"FILADELFIA";51;9;9;69
2015;"FORMOSO DO ARAGUAIA (TO)";"TO";"FORMOSO DO ARAGUAIA";257;9;37;303
2015;"FORTALEZA DO TABOCAO (TO)";"TO";"FORTALEZA DO TABOCAO";34;4;4;42
2015;"GOIANORTE (TO)";"TO";"GOIANORTE";48;2;12;62
2015;"GOIATINS (TO)";"TO";"GOIATINS";60;6;9;75
2015;"GUARAI (TO)";"TO";"GUARAI";436;20;39;495
2015;"GURUPI (TO)";"TO";"GURUPI";1690;43;240;1973
2015;"IPUEIRAS (TO)";"TO";"IPUEIRAS";10;0;2;12
2015;"ITACAJA (TO)";"TO";"ITACAJA";50;3;4;57
2015;"ITAGUATINS (TO)";"TO";"ITAGUATINS";36;4;15;55
2015;"ITAPIRATINS (TO)";"TO";"ITAPIRATINS";23;2;8;33
2015;"ITAPORA DO TOCANTINS (TO)";"TO";"ITAPORA DO TOCANTINS";18;3;6;27
2015;"JAU DO TOCANTINS (TO)";"TO";"JAU DO TOCANTINS";22;1;8;31
2015;"JUARINA (TO)";"TO";"JUARINA";11;3;6;20
2015;"LAGOA DA CONFUSAO (TO)";"TO";"LAGOA DA CONFUSAO";171;3;19;193
2015;"LAGOA DO TOCANTINS (TO)";"TO";"LAGOA DO TOCANTINS";9;0;5;14
2015;"LAJEADO (TO)";"TO";"LAJEADO";36;2;9;47
2015;"LAVANDEIRA (TO)";"TO";"LAVANDEIRA";4;0;2;6
2015;"LIZARDA (TO)";"TO";"LIZARDA";18;1;1;20
2015;"LUZINOPOLIS (TO)";"TO";"LUZINOPOLIS";18;2;2;22
2015;"MARIANOPOLIS DO TOCANTINS (TO)";"TO";"MARIANOPOLIS DO TOCANTINS";41;1;8;50
2015;"MATEIROS (TO)";"TO";"MATEIROS";25;0;4;29
2015;"MAURILANDIA DO TOCANTINS (TO)";"TO";"MAURILANDIA DO TOCANTINS";12;7;5;24
2015;"MIRACEMA DO TOCANTINS (TO)";"TO";"MIRACEMA DO TOCANTINS";191;17;36;244
2015;"MIRANORTE (TO)";"TO";"MIRANORTE";246;12;22;280
2015;"MONTE DO CARMO (TO)";"TO";"MONTE DO CARMO";26;4;5;35
2015;"MONTE SANTO DO TOCANTINS (TO)";"TO";"MONTE SANTO DO TOCANTINS";20;3;3;26
2015;"MURICILANDIA (TO)";"TO";"MURICILANDIA";14;1;5;20
2015;"NATIVIDADE (TO)";"TO";"NATIVIDADE";98;4;8;110
2015;"NAZARE (TO)";"TO";"NAZARE";23;3;5;31
2015;"NOVA OLINDA (TO)";"TO";"NOVA OLINDA";108;2;31;141
2015;"NOVA ROSALANDIA (TO)";"TO";"NOVA ROSALANDIA";27;2;2;31
2015;"NOVO ACORDO (TO)";"TO";"NOVO ACORDO";29;1;7;37
2015;"NOVO ALEGRE (TO)";"TO";"NOVO ALEGRE";13;1;4;18
2015;"NOVO JARDIM (TO)";"TO";"NOVO JARDIM";16;0;4;20
2015;"OLIVEIRA DE FATIMA (TO)";"TO";"OLIVEIRA DE FATIMA";11;1;4;16
2015;"PALMAS (TO)";"TO";"PALMAS";4888;327;1832;7047
2015;"PALMEIRANTE (TO)";"TO";"PALMEIRANTE";18;4;4;26
2015;"PALMEIRAS DO TOCANTINS (TO)";"TO";"PALMEIRAS DO TOCANTINS";39;9;10;58
2015;"PALMEIROPOLIS (TO)";"TO";"PALMEIROPOLIS";118;2;19;139
2015;"PARAISO DO TOCANTINS (TO)";"TO";"PARAISO DO TOCANTINS";1311;38;131;1480
2015;"PARANA (TO)";"TO";"PARANA";38;3;1;42
2015;"PAU D ARCO (TO)";"TO";"PAU D ARCO";27;1;8;36
2015;"PEDRO AFONSO (TO)";"TO";"PEDRO AFONSO";229;12;60;301
2015;"PEIXE (TO)";"TO";"PEIXE";81;12;44;137
2015;"PEQUIZEIRO (TO)";"TO";"PEQUIZEIRO";43;1;11;55
2015;"PINDORAMA DO TOCANTINS (TO)";"TO";"PINDORAMA DO TOCANTINS";22;1;7;30
2015;"PIRAQUE (TO)";"TO";"PIRAQUE";11;0;7;18
2015;"PIUM (TO)";"TO";"PIUM";51;3;12;66
2015;"PONTE ALTA DO BOM JESUS (TO)";"TO";"PONTE ALTA DO BOM JESUS";15;3;3;21
2015;"PONTE ALTA DO TOCANTINS (TO)";"TO";"PONTE ALTA DO TOCANTINS";26;2;6;34
2015;"PORTO ALEGRE DO TOCANTINS (TO)";"TO";"PORTO ALEGRE DO TOCANTINS";13;1;5;19
2015;"PORTO NACIONAL (TO)";"TO";"PORTO NACIONAL";786;70;145;1001
2015;"PRAIA NORTE (TO)";"TO";"PRAIA NORTE";11;4;5;20
2015;"PRESIDENTE KENNEDY (TO)";"TO";"PRESIDENTE KENNEDY";37;0;3;40
2015;"PUGMIL (TO)";"TO";"PUGMIL";24;2;2;28
2015;"RECURSOLANDIA (TO)";"TO";"RECURSOLANDIA";12;0;1;13
2015;"RIACHINHO (TO)";"TO";"RIACHINHO";130;13;86;229
2015;"RIO DA CONCEICAO (TO)";"TO";"RIO DA CONCEICAO";8;1;2;11
2015;"RIO DOS BOIS (TO)";"TO";"RIO DOS BOIS";14;3;4;21
2015;"RIO SONO (TO)";"TO";"RIO SONO";21;1;6;28
2015;"SAMPAIO (TO)";"TO";"SAMPAIO";62;2;5;69
2015;"SANDOLANDIA (TO)";"TO";"SANDOLANDIA";21;9;1;31
2015;"SANTA FE DO ARAGUAIA (TO)";"TO";"SANTA FE DO ARAGUAIA";66;9;17;92
2015;"SANTA MARIA DO TOCANTINS (TO)";"TO";"SANTA MARIA DO TOCANTINS";12;3;3;18
2015;"SANTA RITA DO TOCANTINS (TO)";"TO";"SANTA RITA DO TOCANTINS";13;1;4;18
2015;"SANTA ROSA DO TOCANTINS (TO)";"TO";"SANTA ROSA DO TOCANTINS";43;0;4;47
2015;"SANTA TEREZA DO TOCANTINS (TO)";"TO";"SANTA TEREZA DO TOCANTINS";22;1;4;27
2015;"SANTA TEREZINHA DO TOCANTINS (TO)";"TO";"SANTA TEREZINHA DO TOCANTINS";18;3;4;25
2015;"SAO BENTO DO TOCANTINS (TO)";"TO";"SAO BENTO DO TOCANTINS";24;4;12;40
2015;"SAO FELIX DO TOCANTINS (TO)";"TO";"SAO FELIX DO TOCANTINS";7;0;0;7
2015;"SAO MIGUEL DO TOCANTINS (TO)";"TO";"SAO MIGUEL DO TOCANTINS";124;13;48;185
2015;"SAO SALVADOR DO TOCANTINS (TO)";"TO";"SAO SALVADOR DO TOCANTINS";22;4;5;31
2015;"SAO SEBASTIAO DO TOCANTINS (TO)";"TO";"SAO SEBASTIAO DO TOCANTINS";18;2;2;22
2015;"SAO VALERIO DA NATIVIDADE (TO)";"TO";"SAO VALERIO DA NATIVIDADE";53;1;7;61
2015;"SILVANOPOLIS (TO)";"TO";"SILVANOPOLIS";49;1;5;55
2015;"SITIO NOVO DO TOCANTINS (TO)";"TO";"SITIO NOVO DO TOCANTINS";52;9;16;77
2015;"SUCUPIRA (TO)";"TO";"SUCUPIRA";16;0;6;22
2015;"TAGUATINGA (TO)";"TO";"TAGUATINGA";115;11;27;153
2015;"TAIPAS DO TOCANTINS (TO)";"TO";"TAIPAS DO TOCANTINS";6;0;2;8
2015;"TALISMA (TO)";"TO";"TALISMA";23;6;1;30
2015;"TOCANTINIA (TO)";"TO";"TOCANTINIA";26;1;8;35
2015;"TOCANTINOPOLIS (TO)";"TO";"TOCANTINOPOLIS";1316;288;413;2017
2015;"TUPIRAMA (TO)";"TO";"TUPIRAMA";23;4;4;31
2015;"TUPIRATINS (TO)";"TO";"TUPIRATINS";12;1;7;20
2015;"WANDERLANDIA (TO)";"TO";"WANDERLANDIA";73;4;9;86
2015;"XAMBIOA (TO)";"TO";"XAMBIOA";137;8;21;166
