"ano";"chave";"UF";"MUNICIPIO";"CAMINHAO";"MICRO_ONIBUS";"ONIBUS";"total"
2014;"ACRELANDIA (AC)";"AC";"ACRELANDIA";216;7;42;265
2014;"ASSIS BRASIL (AC)";"AC";"ASSIS BRASIL";20;2;3;25
2014;"BRASILEIA (AC)";"AC";"BRASILEIA";199;3;12;214
2014;"BUJARI (AC)";"AC";"BUJARI";93;3;11;107
2014;"CAPIXABA (AC)";"AC";"CAPIXABA";69;1;9;79
2014;"CRUZEIRO DO SUL (AC)";"AC";"CRUZEIRO DO SUL";673;58;63;794
2014;"EPITACIOLANDIA (AC)";"AC";"EPITACIOLANDIA";197;1;14;212
2014;"FEIJO (AC)";"AC";"FEIJO";103;1;6;110
2014;"JORDAO (AC)";"AC";"JORDAO";2;0;0;2
2014;"MANCIO LIMA (AC)";"AC";"MANCIO LIMA";75;3;10;88
2014;"MANOEL URBANO (AC)";"AC";"MANOEL URBANO";26;0;2;28
2014;"MARECHAL THAUMATURGO (AC)";"AC";"MARECHAL THAUMATURGO";9;0;4;13
2014;"PLACIDO DE CASTRO (AC)";"AC";"PLACIDO DE CASTRO";138;3;17;158
2014;"PORTO ACRE (AC)";"AC";"PORTO ACRE";144;2;33;179
2014;"PORTO WALTER (AC)";"AC";"PORTO WALTER";6;0;3;9
2014;"RIO BRANCO (AC)";"AC";"RIO BRANCO";4003;211;718;4932
2014;"RODRIGUES ALVES (AC)";"AC";"RODRIGUES ALVES";14;0;7;21
2014;"SANTA ROSA DO PURUS (AC)";"AC";"SANTA ROSA DO PURUS";3;0;1;4
2014;"SENA MADUREIRA (AC)";"AC";"SENA MADUREIRA";92;3;8;103
2014;"SENADOR GUIOMARD (AC)";"AC";"SENADOR GUIOMARD";327;8;22;357
2014;"TARAUACA (AC)";"AC";"TARAUACA";139;16;22;177
2014;"XAPURI (AC)";"AC";"XAPURI";66;3;3;72
2014;"AGUA BRANCA (AL)";"AL";"AGUA BRANCA";68;67;10;145
2014;"ANADIA (AL)";"AL";"ANADIA";44;45;39;128
2014;"ARAPIRACA (AL)";"AL";"ARAPIRACA";2866;400;330;3596
2014;"ATALAIA (AL)";"AL";"ATALAIA";206;52;128;386
2014;"BARRA DE SANTO ANTONIO (AL)";"AL";"BARRA DE SANTO ANTONIO";31;5;20;56
2014;"BARRA DE SAO MIGUEL (AL)";"AL";"BARRA DE SAO MIGUEL";27;2;7;36
2014;"BATALHA (AL)";"AL";"BATALHA";99;28;4;131
2014;"BELEM (AL)";"AL";"BELEM";14;23;5;42
2014;"BELO MONTE (AL)";"AL";"BELO MONTE";35;8;6;49
2014;"BOCA DA MATA (AL)";"AL";"BOCA DA MATA";224;70;95;389
2014;"BRANQUINHA (AL)";"AL";"BRANQUINHA";32;20;16;68
2014;"CACIMBINHAS (AL)";"AL";"CACIMBINHAS";55;35;9;99
2014;"CAJUEIRO (AL)";"AL";"CAJUEIRO";89;11;46;146
2014;"CAMPESTRE (AL)";"AL";"CAMPESTRE";22;46;8;76
2014;"CAMPO ALEGRE (AL)";"AL";"CAMPO ALEGRE";130;117;118;365
2014;"CAMPO GRANDE (AL)";"AL";"CAMPO GRANDE";45;21;15;81
2014;"CANAPI (AL)";"AL";"CANAPI";40;38;19;97
2014;"CAPELA (AL)";"AL";"CAPELA";66;8;49;123
2014;"CARNEIROS (AL)";"AL";"CARNEIROS";33;10;5;48
2014;"CHA PRETA (AL)";"AL";"CHA PRETA";27;7;6;40
2014;"COITE DO NOIA (AL)";"AL";"COITE DO NOIA";59;7;26;92
2014;"COLONIA LEOPOLDINA (AL)";"AL";"COLONIA LEOPOLDINA";64;24;31;119
2014;"COQUEIRO SECO (AL)";"AL";"COQUEIRO SECO";10;2;9;21
2014;"CORURIPE (AL)";"AL";"CORURIPE";358;71;209;638
2014;"CRAIBAS (AL)";"AL";"CRAIBAS";131;31;28;190
2014;"DELMIRO GOUVEIA (AL)";"AL";"DELMIRO GOUVEIA";477;346;53;876
2014;"DOIS RIACHOS (AL)";"AL";"DOIS RIACHOS";69;13;10;92
2014;"ESTRELA DE ALAGOAS (AL)";"AL";"ESTRELA DE ALAGOAS";48;94;23;165
2014;"FEIRA GRANDE (AL)";"AL";"FEIRA GRANDE";69;2;49;120
2014;"FELIZ DESERTO (AL)";"AL";"FELIZ DESERTO";7;5;9;21
2014;"FLEXEIRAS (AL)";"AL";"FLEXEIRAS";25;19;35;79
2014;"GIRAU DO PONCIANO (AL)";"AL";"GIRAU DO PONCIANO";177;53;58;288
2014;"IBATEGUARA (AL)";"AL";"IBATEGUARA";41;57;15;113
2014;"IGACI (AL)";"AL";"IGACI";105;106;28;239
2014;"IGREJA NOVA (AL)";"AL";"IGREJA NOVA";82;25;82;189
2014;"INHAPI (AL)";"AL";"INHAPI";60;23;8;91
2014;"JACARE DOS HOMENS (AL)";"AL";"JACARE DOS HOMENS";37;7;9;53
2014;"JACUIPE (AL)";"AL";"JACUIPE";9;10;17;36
2014;"JAPARATINGA (AL)";"AL";"JAPARATINGA";12;24;9;45
2014;"JARAMATAIA (AL)";"AL";"JARAMATAIA";24;10;6;40
2014;"JEQUIA DA PRAIA (AL)";"AL";"JEQUIA DA PRAIA";33;10;37;80
2014;"JOAQUIM GOMES (AL)";"AL";"JOAQUIM GOMES";95;26;72;193
2014;"JUNDIA (AL)";"AL";"JUNDIA";16;4;14;34
2014;"JUNQUEIRO (AL)";"AL";"JUNQUEIRO";202;33;105;340
2014;"LAGOA DA CANOA (AL)";"AL";"LAGOA DA CANOA";96;20;29;145
2014;"LIMOEIRO DE ANADIA (AL)";"AL";"LIMOEIRO DE ANADIA";127;26;49;202
2014;"MACEIO (AL)";"AL";"MACEIO";7149;1143;1948;10240
2014;"MAJOR ISIDORO (AL)";"AL";"MAJOR ISIDORO";82;30;24;136
2014;"MAR VERMELHO (AL)";"AL";"MAR VERMELHO";10;2;9;21
2014;"MARAGOGI (AL)";"AL";"MARAGOGI";70;101;39;210
2014;"MARAVILHA (AL)";"AL";"MARAVILHA";40;44;8;92
2014;"MARECHAL DEODORO (AL)";"AL";"MARECHAL DEODORO";279;75;130;484
2014;"MARIBONDO (AL)";"AL";"MARIBONDO";66;18;13;97
2014;"MATA GRANDE (AL)";"AL";"MATA GRANDE";57;32;12;101
2014;"MATRIZ DE CAMARAGIBE (AL)";"AL";"MATRIZ DE CAMARAGIBE";129;28;123;280
2014;"MESSIAS (AL)";"AL";"MESSIAS";66;40;83;189
2014;"MINADOR DO NEGRAO (AL)";"AL";"MINADOR DO NEGRAO";50;14;8;72
2014;"MONTEIROPOLIS (AL)";"AL";"MONTEIROPOLIS";13;2;4;19
2014;"MURICI (AL)";"AL";"MURICI";108;22;103;233
2014;"NOVO LINO (AL)";"AL";"NOVO LINO";49;31;53;133
2014;"OLHO D AGUA DAS FLORES (AL)";"AL";"OLHO D AGUA DAS FLORES";106;94;25;225
2014;"OLHO D AGUA DO CASADO (AL)";"AL";"OLHO D AGUA DO CASADO";33;20;7;60
2014;"OLHO D AGUA GRANDE (AL)";"AL";"OLHO D AGUA GRANDE";13;1;13;27
2014;"OLIVENCA (AL)";"AL";"OLIVENCA";51;22;9;82
2014;"OURO BRANCO (AL)";"AL";"OURO BRANCO";60;34;22;116
2014;"PALESTINA (AL)";"AL";"PALESTINA";11;8;5;24
2014;"PALMEIRA DOS INDIOS (AL)";"AL";"PALMEIRA DOS INDIOS";606;214;69;889
2014;"PAO DE ACUCAR (AL)";"AL";"PAO DE ACUCAR";74;31;12;117
2014;"PARICONHA (AL)";"AL";"PARICONHA";45;24;11;80
2014;"PARIPUEIRA (AL)";"AL";"PARIPUEIRA";55;5;14;74
2014;"PASSO DE CAMARAGIBE (AL)";"AL";"PASSO DE CAMARAGIBE";35;8;30;73
2014;"PAULO JACINTO (AL)";"AL";"PAULO JACINTO";11;12;10;33
2014;"PENEDO (AL)";"AL";"PENEDO";244;72;213;529
2014;"PIACABUCU (AL)";"AL";"PIACABUCU";31;10;15;56
2014;"PILAR (AL)";"AL";"PILAR";161;51;64;276
2014;"PINDOBA (AL)";"AL";"PINDOBA";9;1;2;12
2014;"PIRANHAS (AL)";"AL";"PIRANHAS";77;79;16;172
2014;"POCO DAS TRINCHEIRAS (AL)";"AL";"POCO DAS TRINCHEIRAS";62;54;21;137
2014;"PORTO CALVO (AL)";"AL";"PORTO CALVO";187;121;64;372
2014;"PORTO DE PEDRAS (AL)";"AL";"PORTO DE PEDRAS";12;11;10;33
2014;"PORTO REAL DO COLEGIO (AL)";"AL";"PORTO REAL DO COLEGIO";25;31;18;74
2014;"QUEBRANGULO (AL)";"AL";"QUEBRANGULO";42;6;10;58
2014;"RIO LARGO (AL)";"AL";"RIO LARGO";449;184;190;823
2014;"ROTEIRO (AL)";"AL";"ROTEIRO";11;26;7;44
2014;"SANTA LUZIA DO NORTE (AL)";"AL";"SANTA LUZIA DO NORTE";20;6;71;97
2014;"SANTANA DO IPANEMA (AL)";"AL";"SANTANA DO IPANEMA";408;174;43;625
2014;"SANTANA DO MUNDAU (AL)";"AL";"SANTANA DO MUNDAU";67;36;11;114
2014;"SAO BRAS (AL)";"AL";"SAO BRAS";3;5;6;14
2014;"SAO JOSE DA LAJE (AL)";"AL";"SAO JOSE DA LAJE";103;74;50;227
2014;"SAO JOSE DA TAPERA (AL)";"AL";"SAO JOSE DA TAPERA";125;51;22;198
2014;"SAO LUIS DO QUITUNDE (AL)";"AL";"SAO LUIS DO QUITUNDE";213;27;146;386
2014;"SAO MIGUEL DOS CAMPOS (AL)";"AL";"SAO MIGUEL DOS CAMPOS";451;155;153;759
2014;"SAO MIGUEL DOS MILAGRES (AL)";"AL";"SAO MIGUEL DOS MILAGRES";29;2;8;39
2014;"SAO SEBASTIAO (AL)";"AL";"SAO SEBASTIAO";163;42;123;328
2014;"SATUBA (AL)";"AL";"SATUBA";61;16;22;99
2014;"SENADOR RUI PALMEIRA (AL)";"AL";"SENADOR RUI PALMEIRA";36;19;15;70
2014;"TANQUE D ARCA (AL)";"AL";"TANQUE D ARCA";15;20;7;42
2014;"TAQUARANA (AL)";"AL";"TAQUARANA";94;55;27;176
2014;"TEOTONIO VILELA (AL)";"AL";"TEOTONIO VILELA";193;90;178;461
2014;"TRAIPU (AL)";"AL";"TRAIPU";97;18;20;135
2014;"UNIAO DOS PALMARES (AL)";"AL";"UNIAO DOS PALMARES";494;223;183;900
2014;"VICOSA (AL)";"AL";"VICOSA";135;18;50;203
2014;"ALVARAES (AM)";"AM";"ALVARAES";8;0;3;11
2014;"AMATURA (AM)";"AM";"AMATURA";3;0;1;4
2014;"ANAMA (AM)";"AM";"ANAMA";1;0;6;7
2014;"ANORI (AM)";"AM";"ANORI";6;0;3;9
2014;"APUI (AM)";"AM";"APUI";113;2;26;141
2014;"ATALAIA DO NORTE (AM)";"AM";"ATALAIA DO NORTE";2;0;1;3
2014;"AUTAZES (AM)";"AM";"AUTAZES";29;4;18;51
2014;"BARCELOS (AM)";"AM";"BARCELOS";11;1;0;12
2014;"BARREIRINHA (AM)";"AM";"BARREIRINHA";7;0;6;13
2014;"BENJAMIN CONSTANT (AM)";"AM";"BENJAMIN CONSTANT";12;6;3;21
2014;"BERURI (AM)";"AM";"BERURI";2;0;0;2
2014;"BOA VISTA DO RAMOS (AM)";"AM";"BOA VISTA DO RAMOS";2;0;1;3
2014;"BOCA DO ACRE (AM)";"AM";"BOCA DO ACRE";52;3;7;62
2014;"BORBA (AM)";"AM";"BORBA";17;0;5;22
2014;"CAAPIRANGA (AM)";"AM";"CAAPIRANGA";9;1;8;18
2014;"CANUTAMA (AM)";"AM";"CANUTAMA";5;0;1;6
2014;"CARAUARI (AM)";"AM";"CARAUARI";40;1;1;42
2014;"CAREIRO (AM)";"AM";"CAREIRO";66;41;59;166
2014;"CAREIRO DA VARZEA (AM)";"AM";"CAREIRO DA VARZEA";18;24;40;82
2014;"COARI (AM)";"AM";"COARI";133;5;12;150
2014;"CODAJAS (AM)";"AM";"CODAJAS";9;0;4;13
2014;"EIRUNEPE (AM)";"AM";"EIRUNEPE";32;1;5;38
2014;"ENVIRA (AM)";"AM";"ENVIRA";16;0;4;20
2014;"FONTE BOA (AM)";"AM";"FONTE BOA";13;0;0;13
2014;"GUAJARA (AM)";"AM";"GUAJARA";1;0;6;7
2014;"HUMAITA (AM)";"AM";"HUMAITA";157;5;21;183
2014;"IPIXUNA (AM)";"AM";"IPIXUNA";3;0;3;6
2014;"IRANDUBA (AM)";"AM";"IRANDUBA";270;33;87;390
2014;"ITACOATIARA (AM)";"AM";"ITACOATIARA";403;40;137;580
2014;"ITAMARATI (AM)";"AM";"ITAMARATI";8;0;0;8
2014;"ITAPIRANGA (AM)";"AM";"ITAPIRANGA";17;1;7;25
2014;"JAPURA (AM)";"AM";"JAPURA";4;0;1;5
2014;"JURUA (AM)";"AM";"JURUA";9;0;4;13
2014;"JUTAI (AM)";"AM";"JUTAI";4;0;0;4
2014;"LABREA (AM)";"AM";"LABREA";34;1;4;39
2014;"MANACAPURU (AM)";"AM";"MANACAPURU";354;79;99;532
2014;"MANAQUIRI (AM)";"AM";"MANAQUIRI";11;5;8;24
2014;"MANAUS (AM)";"AM";"MANAUS";16714;3003;7934;27651
2014;"MANICORE (AM)";"AM";"MANICORE";44;1;13;58
2014;"MARAA (AM)";"AM";"MARAA";5;1;0;6
2014;"MAUES (AM)";"AM";"MAUES";40;4;17;61
2014;"NHAMUNDA (AM)";"AM";"NHAMUNDA";8;0;1;9
2014;"NOVA OLINDA DO NORTE (AM)";"AM";"NOVA OLINDA DO NORTE";18;6;9;33
2014;"NOVO AIRAO (AM)";"AM";"NOVO AIRAO";28;8;10;46
2014;"NOVO ARIPUANA (AM)";"AM";"NOVO ARIPUANA";27;2;7;36
2014;"PARINTINS (AM)";"AM";"PARINTINS";152;7;25;184
2014;"PAUINI (AM)";"AM";"PAUINI";3;1;1;5
2014;"PRESIDENTE FIGUEIREDO (AM)";"AM";"PRESIDENTE FIGUEIREDO";272;50;82;404
2014;"RIO PRETO DA EVA (AM)";"AM";"RIO PRETO DA EVA";165;19;72;256
2014;"SANTA ISABEL DO RIO NEGRO (AM)";"AM";"SANTA ISABEL DO RIO NEGRO";8;2;3;13
2014;"SANTO ANTONIO DO ICA (AM)";"AM";"SANTO ANTONIO DO ICA";7;0;0;7
2014;"SAO GABRIEL DA CACHOEIRA (AM)";"AM";"SAO GABRIEL DA CACHOEIRA";77;11;26;114
2014;"SAO PAULO DE OLIVENCA (AM)";"AM";"SAO PAULO DE OLIVENCA";5;0;5;10
2014;"SAO SEBASTIAO DO UATUMA (AM)";"AM";"SAO SEBASTIAO DO UATUMA";6;0;0;6
2014;"SILVES (AM)";"AM";"SILVES";11;5;3;19
2014;"TABATINGA (AM)";"AM";"TABATINGA";63;9;4;76
2014;"TAPAUA (AM)";"AM";"TAPAUA";4;0;2;6
2014;"TEFE (AM)";"AM";"TEFE";75;18;11;104
2014;"TONANTINS (AM)";"AM";"TONANTINS";5;0;1;6
2014;"UARINI (AM)";"AM";"UARINI";10;0;2;12
2014;"URUCARA (AM)";"AM";"URUCARA";17;4;1;22
2014;"URUCURITUBA (AM)";"AM";"URUCURITUBA";7;0;2;9
2014;"AMAPA (AP)";"AP";"AMAPA";10;1;2;13
2014;"CALCOENE (AP)";"AP";"CALCOENE";20;2;3;25
2014;"CUTIAS (AP)";"AP";"CUTIAS";5;2;0;7
2014;"FERREIRA GOMES (AP)";"AP";"FERREIRA GOMES";5;3;5;13
2014;"ITAUBAL (AP)";"AP";"ITAUBAL";7;0;5;12
2014;"LARANJAL DO JARI (AP)";"AP";"LARANJAL DO JARI";102;10;14;126
2014;"MACAPA (AP)";"AP";"MACAPA";2872;343;774;3989
2014;"MAZAGAO (AP)";"AP";"MAZAGAO";52;17;23;92
2014;"OIAPOQUE (AP)";"AP";"OIAPOQUE";67;6;19;92
2014;"PEDRA BRANCA DO AMAPARI (AP)";"AP";"PEDRA BRANCA DO AMAPARI";36;7;16;59
2014;"PORTO GRANDE (AP)";"AP";"PORTO GRANDE";45;5;15;65
2014;"PRACUUBA (AP)";"AP";"PRACUUBA";5;1;2;8
2014;"SANTANA (AP)";"AP";"SANTANA";658;45;163;866
2014;"SERRA DO NAVIO (AP)";"AP";"SERRA DO NAVIO";10;3;3;16
2014;"TARTARUGALZINHO (AP)";"AP";"TARTARUGALZINHO";20;5;4;29
2014;"VITORIA DO JARI (AP)";"AP";"VITORIA DO JARI";3;0;4;7
2014;"ABAIRA (BA)";"BA";"ABAIRA";58;23;16;97
2014;"ABARE (BA)";"BA";"ABARE";56;36;24;116
2014;"ACAJUTIBA (BA)";"BA";"ACAJUTIBA";72;17;18;107
2014;"ADUSTINA (BA)";"BA";"ADUSTINA";13;9;10;32
2014;"AGUA FRIA (BA)";"BA";"AGUA FRIA";26;21;40;87
2014;"AIQUARA (BA)";"BA";"AIQUARA";5;5;6;16
2014;"ALAGOINHAS (BA)";"BA";"ALAGOINHAS";1356;332;560;2248
2014;"ALCOBACA (BA)";"BA";"ALCOBACA";48;8;32;88
2014;"ALMADINA (BA)";"BA";"ALMADINA";17;2;6;25
2014;"AMARGOSA (BA)";"BA";"AMARGOSA";285;73;85;443
2014;"AMELIA RODRIGUES (BA)";"BA";"AMELIA RODRIGUES";206;120;38;364
2014;"AMERICA DOURADA (BA)";"BA";"AMERICA DOURADA";33;18;10;61
2014;"ANAGE (BA)";"BA";"ANAGE";103;73;47;223
2014;"ANDARAI (BA)";"BA";"ANDARAI";36;9;23;68
2014;"ANDORINHA (BA)";"BA";"ANDORINHA";77;17;53;147
2014;"ANGICAL (BA)";"BA";"ANGICAL";38;12;25;75
2014;"ANGUERA (BA)";"BA";"ANGUERA";20;6;15;41
2014;"ANTAS (BA)";"BA";"ANTAS";31;9;10;50
2014;"ANTONIO CARDOSO (BA)";"BA";"ANTONIO CARDOSO";4;39;22;65
2014;"ANTONIO GONCALVES (BA)";"BA";"ANTONIO GONCALVES";27;13;11;51
2014;"APORA (BA)";"BA";"APORA";42;29;32;103
2014;"APUAREMA (BA)";"BA";"APUAREMA";27;7;10;44
2014;"ARACAS (BA)";"BA";"ARACAS";69;19;32;120
2014;"ARACATU (BA)";"BA";"ARACATU";116;34;33;183
2014;"ARACI (BA)";"BA";"ARACI";288;26;64;378
2014;"ARAMARI (BA)";"BA";"ARAMARI";49;6;9;64
2014;"ARATACA (BA)";"BA";"ARATACA";29;0;4;33
2014;"ARATUIPE (BA)";"BA";"ARATUIPE";42;4;14;60
2014;"AURELINO LEAL (BA)";"BA";"AURELINO LEAL";55;5;12;72
2014;"BAIANOPOLIS (BA)";"BA";"BAIANOPOLIS";51;5;40;96
2014;"BAIXA GRANDE (BA)";"BA";"BAIXA GRANDE";100;63;47;210
2014;"BANZAE (BA)";"BA";"BANZAE";23;6;23;52
2014;"BARRA (BA)";"BA";"BARRA";78;36;36;150
2014;"BARRA DA ESTIVA (BA)";"BA";"BARRA DA ESTIVA";245;62;64;371
2014;"BARRA DO CHOCA (BA)";"BA";"BARRA DO CHOCA";134;197;34;365
2014;"BARRA DO MENDES (BA)";"BA";"BARRA DO MENDES";75;30;22;127
2014;"BARRA DO ROCHA (BA)";"BA";"BARRA DO ROCHA";11;5;4;20
2014;"BARREIRAS (BA)";"BA";"BARREIRAS";2675;167;431;3273
2014;"BARRO ALTO (BA)";"BA";"BARRO ALTO";53;19;22;94
2014;"BARRO PRETO (BA)";"BA";"BARRO PRETO";18;1;12;31
2014;"BARROCAS (BA)";"BA";"BARROCAS";103;5;19;127
2014;"BELMONTE (BA)";"BA";"BELMONTE";56;9;12;77
2014;"BELO CAMPO (BA)";"BA";"BELO CAMPO";120;22;33;175
2014;"BIRITINGA (BA)";"BA";"BIRITINGA";32;13;33;78
2014;"BOA NOVA (BA)";"BA";"BOA NOVA";37;49;23;109
2014;"BOA VISTA DO TUPIM (BA)";"BA";"BOA VISTA DO TUPIM";66;13;24;103
2014;"BOM JESUS DA LAPA (BA)";"BA";"BOM JESUS DA LAPA";468;74;138;680
2014;"BOM JESUS DA SERRA (BA)";"BA";"BOM JESUS DA SERRA";35;54;20;109
2014;"BONINAL (BA)";"BA";"BONINAL";82;29;40;151
2014;"BONITO (BA)";"BA";"BONITO";88;14;15;117
2014;"BOQUIRA (BA)";"BA";"BOQUIRA";147;11;72;230
2014;"BOTUPORA (BA)";"BA";"BOTUPORA";70;6;49;125
2014;"BREJOES (BA)";"BA";"BREJOES";95;11;38;144
2014;"BREJOLANDIA (BA)";"BA";"BREJOLANDIA";34;8;19;61
2014;"BROTAS DE MACAUBAS (BA)";"BA";"BROTAS DE MACAUBAS";34;55;22;111
2014;"BRUMADO (BA)";"BA";"BRUMADO";1513;278;361;2152
2014;"BUERAREMA (BA)";"BA";"BUERAREMA";160;9;41;210
2014;"BURITIRAMA (BA)";"BA";"BURITIRAMA";38;9;24;71
2014;"CAATIBA (BA)";"BA";"CAATIBA";21;5;2;28
2014;"CABACEIRAS DO PARAGUACU (BA)";"BA";"CABACEIRAS DO PARAGUACU";82;25;51;158
2014;"CACHOEIRA (BA)";"BA";"CACHOEIRA";124;118;79;321
2014;"CACULE (BA)";"BA";"CACULE";390;35;50;475
2014;"CAEM (BA)";"BA";"CAEM";27;14;19;60
2014;"CAETANOS (BA)";"BA";"CAETANOS";70;14;18;102
2014;"CAETITE (BA)";"BA";"CAETITE";593;113;122;828
2014;"CAFARNAUM (BA)";"BA";"CAFARNAUM";80;6;34;120
2014;"CAIRU (BA)";"BA";"CAIRU";12;13;9;34
2014;"CALDEIRAO GRANDE (BA)";"BA";"CALDEIRAO GRANDE";29;7;18;54
2014;"CAMACAN (BA)";"BA";"CAMACAN";185;22;45;252
2014;"CAMACARI (BA)";"BA";"CAMACARI";2373;581;1273;4227
2014;"CAMAMU (BA)";"BA";"CAMAMU";166;46;38;250
2014;"CAMPO ALEGRE DE LOURDES (BA)";"BA";"CAMPO ALEGRE DE LOURDES";108;10;11;129
2014;"CAMPO FORMOSO (BA)";"BA";"CAMPO FORMOSO";281;32;106;419
2014;"CANAPOLIS (BA)";"BA";"CANAPOLIS";21;28;12;61
2014;"CANARANA (BA)";"BA";"CANARANA";193;27;33;253
2014;"CANAVIEIRAS (BA)";"BA";"CANAVIEIRAS";97;9;18;124
2014;"CANDEAL (BA)";"BA";"CANDEAL";21;20;25;66
2014;"CANDEIAS (BA)";"BA";"CANDEIAS";870;375;357;1602
2014;"CANDIBA (BA)";"BA";"CANDIBA";69;0;27;96
2014;"CANDIDO SALES (BA)";"BA";"CANDIDO SALES";332;48;52;432
2014;"CANSANCAO (BA)";"BA";"CANSANCAO";203;69;73;345
2014;"CANUDOS (BA)";"BA";"CANUDOS";64;10;47;121
2014;"CAPELA DO ALTO ALEGRE (BA)";"BA";"CAPELA DO ALTO ALEGRE";97;26;26;149
2014;"CAPIM GROSSO (BA)";"BA";"CAPIM GROSSO";559;77;70;706
2014;"CARAIBAS (BA)";"BA";"CARAIBAS";57;29;25;111
2014;"CARAVELAS (BA)";"BA";"CARAVELAS";50;17;42;109
2014;"CARDEAL DA SILVA (BA)";"BA";"CARDEAL DA SILVA";29;11;10;50
2014;"CARINHANHA (BA)";"BA";"CARINHANHA";124;42;48;214
2014;"CASA NOVA (BA)";"BA";"CASA NOVA";490;221;228;939
2014;"CASTRO ALVES (BA)";"BA";"CASTRO ALVES";162;24;59;245
2014;"CATOLANDIA (BA)";"BA";"CATOLANDIA";10;3;10;23
2014;"CATU (BA)";"BA";"CATU";424;140;114;678
2014;"CATURAMA (BA)";"BA";"CATURAMA";42;12;16;70
2014;"CENTRAL (BA)";"BA";"CENTRAL";90;30;12;132
2014;"CHORROCHO (BA)";"BA";"CHORROCHO";31;6;15;52
2014;"CICERO DANTAS (BA)";"BA";"CICERO DANTAS";152;35;50;237
2014;"CIPO (BA)";"BA";"CIPO";54;11;16;81
2014;"COARACI (BA)";"BA";"COARACI";121;6;22;149
2014;"COCOS (BA)";"BA";"COCOS";87;7;43;137
2014;"CONCEICAO DA FEIRA (BA)";"BA";"CONCEICAO DA FEIRA";248;127;21;396
2014;"CONCEICAO DO ALMEIDA (BA)";"BA";"CONCEICAO DO ALMEIDA";130;42;35;207
2014;"CONCEICAO DO COITE (BA)";"BA";"CONCEICAO DO COITE";537;125;127;789
2014;"CONCEICAO DO JACUIPE (BA)";"BA";"CONCEICAO DO JACUIPE";351;163;29;543
2014;"CONDE (BA)";"BA";"CONDE";59;22;25;106
2014;"CONDEUBA (BA)";"BA";"CONDEUBA";135;46;81;262
2014;"CONTENDAS DO SINCORA (BA)";"BA";"CONTENDAS DO SINCORA";28;11;10;49
2014;"CORACAO DE MARIA (BA)";"BA";"CORACAO DE MARIA";105;46;60;211
2014;"CORDEIROS (BA)";"BA";"CORDEIROS";39;16;25;80
2014;"CORIBE (BA)";"BA";"CORIBE";52;21;28;101
2014;"CORONEL JOAO SA (BA)";"BA";"CORONEL JOAO SA";10;2;25;37
2014;"CORRENTINA (BA)";"BA";"CORRENTINA";170;37;93;300
2014;"COTEGIPE (BA)";"BA";"COTEGIPE";55;25;23;103
2014;"CRAVOLANDIA (BA)";"BA";"CRAVOLANDIA";18;1;7;26
2014;"CRISOPOLIS (BA)";"BA";"CRISOPOLIS";72;33;39;144
2014;"CRISTOPOLIS (BA)";"BA";"CRISTOPOLIS";62;12;35;109
2014;"CRUZ DAS ALMAS (BA)";"BA";"CRUZ DAS ALMAS";1069;331;100;1500
2014;"CURACA (BA)";"BA";"CURACA";93;36;41;170
2014;"DARIO MEIRA (BA)";"BA";"DARIO MEIRA";21;19;5;45
2014;"DIAS D AVILA (BA)";"BA";"DIAS D AVILA";673;113;409;1195
2014;"DOM BASILIO (BA)";"BA";"DOM BASILIO";328;16;32;376
2014;"DOM MACEDO COSTA (BA)";"BA";"DOM MACEDO COSTA";15;27;8;50
2014;"ELISIO MEDRADO (BA)";"BA";"ELISIO MEDRADO";34;20;16;70
2014;"ENCRUZILHADA (BA)";"BA";"ENCRUZILHADA";87;34;16;137
2014;"ENTRE RIOS (BA)";"BA";"ENTRE RIOS";221;93;104;418
2014;"ERICO CARDOSO (BA)";"BA";"ERICO CARDOSO";37;10;23;70
2014;"ESPLANADA (BA)";"BA";"ESPLANADA";147;42;90;279
2014;"EUCLIDES DA CUNHA (BA)";"BA";"EUCLIDES DA CUNHA";291;60;170;521
2014;"EUNAPOLIS (BA)";"BA";"EUNAPOLIS";1361;122;397;1880
2014;"FATIMA (BA)";"BA";"FATIMA";21;9;21;51
2014;"FEIRA DA MATA (BA)";"BA";"FEIRA DA MATA";17;10;12;39
2014;"FEIRA DE SANTANA (BA)";"BA";"FEIRA DE SANTANA";8801;1280;1334;11415
2014;"FILADELFIA (BA)";"BA";"FILADELFIA";128;15;25;168
2014;"FIRMINO ALVES (BA)";"BA";"FIRMINO ALVES";16;4;4;24
2014;"FLORESTA AZUL (BA)";"BA";"FLORESTA AZUL";41;3;2;46
2014;"FORMOSA DO RIO PRETO (BA)";"BA";"FORMOSA DO RIO PRETO";158;11;26;195
2014;"GANDU (BA)";"BA";"GANDU";317;131;32;480
2014;"GAVIAO (BA)";"BA";"GAVIAO";22;17;8;47
2014;"GENTIO DO OURO (BA)";"BA";"GENTIO DO OURO";24;13;8;45
2014;"GLORIA (BA)";"BA";"GLORIA";54;25;47;126
2014;"GONGOGI (BA)";"BA";"GONGOGI";11;2;3;16
2014;"GOVERNADOR MANGABEIRA (BA)";"BA";"GOVERNADOR MANGABEIRA";212;48;42;302
2014;"GUAJERU (BA)";"BA";"GUAJERU";30;35;15;80
2014;"GUANAMBI (BA)";"BA";"GUANAMBI";1304;101;202;1607
2014;"GUARATINGA (BA)";"BA";"GUARATINGA";90;8;34;132
2014;"HELIOPOLIS (BA)";"BA";"HELIOPOLIS";32;9;21;62
2014;"IACU (BA)";"BA";"IACU";152;26;38;216
2014;"IBIASSUCE (BA)";"BA";"IBIASSUCE";90;23;23;136
2014;"IBICARAI (BA)";"BA";"IBICARAI";141;15;32;188
2014;"IBICOARA (BA)";"BA";"IBICOARA";236;60;65;361
2014;"IBICUI (BA)";"BA";"IBICUI";56;21;14;91
2014;"IBIPEBA (BA)";"BA";"IBIPEBA";46;30;18;94
2014;"IBIPITANGA (BA)";"BA";"IBIPITANGA";92;25;40;157
2014;"IBIQUERA (BA)";"BA";"IBIQUERA";9;7;4;20
2014;"IBIRAPITANGA (BA)";"BA";"IBIRAPITANGA";72;27;14;113
2014;"IBIRAPUA (BA)";"BA";"IBIRAPUA";87;5;15;107
2014;"IBIRATAIA (BA)";"BA";"IBIRATAIA";83;50;18;151
2014;"IBITIARA (BA)";"BA";"IBITIARA";110;56;51;217
2014;"IBITITA (BA)";"BA";"IBITITA";58;16;27;101
2014;"IBOTIRAMA (BA)";"BA";"IBOTIRAMA";255;72;37;364
2014;"ICHU (BA)";"BA";"ICHU";39;26;15;80
2014;"IGAPORA (BA)";"BA";"IGAPORA";119;33;40;192
2014;"IGRAPIUNA (BA)";"BA";"IGRAPIUNA";52;33;23;108
2014;"IGUAI (BA)";"BA";"IGUAI";68;46;43;157
2014;"ILHEUS (BA)";"BA";"ILHEUS";758;171;300;1229
2014;"INHAMBUPE (BA)";"BA";"INHAMBUPE";207;105;85;397
2014;"IPECAETA (BA)";"BA";"IPECAETA";31;10;50;91
2014;"IPIAU (BA)";"BA";"IPIAU";400;50;60;510
2014;"IPIRA (BA)";"BA";"IPIRA";449;66;116;631
2014;"IPUPIARA (BA)";"BA";"IPUPIARA";63;22;8;93
2014;"IRAJUBA (BA)";"BA";"IRAJUBA";40;2;22;64
2014;"IRAMAIA (BA)";"BA";"IRAMAIA";42;11;22;75
2014;"IRAQUARA (BA)";"BA";"IRAQUARA";131;34;44;209
2014;"IRARA (BA)";"BA";"IRARA";160;38;75;273
2014;"IRECE (BA)";"BA";"IRECE";946;108;210;1264
2014;"ITABELA (BA)";"BA";"ITABELA";281;12;106;399
2014;"ITABERABA (BA)";"BA";"ITABERABA";538;103;85;726
2014;"ITABUNA (BA)";"BA";"ITABUNA";1967;85;814;2866
2014;"ITACARE (BA)";"BA";"ITACARE";32;29;9;70
2014;"ITAETE (BA)";"BA";"ITAETE";68;19;26;113
2014;"ITAGI (BA)";"BA";"ITAGI";46;3;6;55
2014;"ITAGIBA (BA)";"BA";"ITAGIBA";30;54;21;105
2014;"ITAGIMIRIM (BA)";"BA";"ITAGIMIRIM";52;4;6;62
2014;"ITAGUACU DA BAHIA (BA)";"BA";"ITAGUACU DA BAHIA";24;14;8;46
2014;"ITAJU DO COLONIA (BA)";"BA";"ITAJU DO COLONIA";25;3;7;35
2014;"ITAJUIPE (BA)";"BA";"ITAJUIPE";82;20;17;119
2014;"ITAMARAJU (BA)";"BA";"ITAMARAJU";479;45;173;697
2014;"ITAMARI (BA)";"BA";"ITAMARI";47;11;2;60
2014;"ITAMBE (BA)";"BA";"ITAMBE";77;65;9;151
2014;"ITANAGRA (BA)";"BA";"ITANAGRA";21;1;5;27
2014;"ITANHEM (BA)";"BA";"ITANHEM";71;11;30;112
2014;"ITAPARICA (BA)";"BA";"ITAPARICA";39;35;73;147
2014;"ITAPE (BA)";"BA";"ITAPE";29;0;5;34
2014;"ITAPEBI (BA)";"BA";"ITAPEBI";56;2;8;66
2014;"ITAPETINGA (BA)";"BA";"ITAPETINGA";515;63;156;734
2014;"ITAPICURU (BA)";"BA";"ITAPICURU";48;16;49;113
2014;"ITAPITANGA (BA)";"BA";"ITAPITANGA";12;4;3;19
2014;"ITAQUARA (BA)";"BA";"ITAQUARA";43;9;9;61
2014;"ITARANTIM (BA)";"BA";"ITARANTIM";96;18;6;120
2014;"ITATIM (BA)";"BA";"ITATIM";228;34;34;296
2014;"ITIRUCU (BA)";"BA";"ITIRUCU";114;16;20;150
2014;"ITIUBA (BA)";"BA";"ITIUBA";110;44;74;228
2014;"ITORORO (BA)";"BA";"ITORORO";93;20;25;138
2014;"ITUACU (BA)";"BA";"ITUACU";172;54;45;271
2014;"ITUBERA (BA)";"BA";"ITUBERA";160;20;37;217
2014;"IUIU (BA)";"BA";"IUIU";44;10;13;67
2014;"JABORANDI (BA)";"BA";"JABORANDI";79;1;31;111
2014;"JACARACI (BA)";"BA";"JACARACI";52;20;37;109
2014;"JACOBINA (BA)";"BA";"JACOBINA";760;129;217;1106
2014;"JAGUAQUARA (BA)";"BA";"JAGUAQUARA";629;35;64;728
2014;"JAGUARARI (BA)";"BA";"JAGUARARI";266;79;84;429
2014;"JAGUARIPE (BA)";"BA";"JAGUARIPE";46;27;28;101
2014;"JANDAIRA (BA)";"BA";"JANDAIRA";20;5;16;41
2014;"JEQUIE (BA)";"BA";"JEQUIE";1750;138;427;2315
2014;"JEREMOABO (BA)";"BA";"JEREMOABO";101;33;53;187
2014;"JIQUIRICA (BA)";"BA";"JIQUIRICA";57;24;23;104
2014;"JITAUNA (BA)";"BA";"JITAUNA";33;15;16;64
2014;"JOAO DOURADO (BA)";"BA";"JOAO DOURADO";124;36;34;194
2014;"JUAZEIRO (BA)";"BA";"JUAZEIRO";2855;987;986;4828
2014;"JUCURUCU (BA)";"BA";"JUCURUCU";15;2;5;22
2014;"JUSSARA (BA)";"BA";"JUSSARA";71;20;20;111
2014;"JUSSARI (BA)";"BA";"JUSSARI";16;1;3;20
2014;"JUSSIAPE (BA)";"BA";"JUSSIAPE";72;29;24;125
2014;"LAFAIETE COUTINHO (BA)";"BA";"LAFAIETE COUTINHO";25;3;11;39
2014;"LAGEDO DO TABOCAL (BA)";"BA";"LAGEDO DO TABOCAL";42;3;10;55
2014;"LAGOA REAL (BA)";"BA";"LAGOA REAL";71;12;30;113
2014;"LAJE (BA)";"BA";"LAJE";173;92;50;315
2014;"LAJEDAO (BA)";"BA";"LAJEDAO";14;0;15;29
2014;"LAJEDINHO (BA)";"BA";"LAJEDINHO";10;7;12;29
2014;"LAMARAO (BA)";"BA";"LAMARAO";7;10;6;23
2014;"LAPAO (BA)";"BA";"LAPAO";151;17;45;213
2014;"LAURO DE FREITAS (BA)";"BA";"LAURO DE FREITAS";2640;544;759;3943
2014;"LENCOIS (BA)";"BA";"LENCOIS";32;17;5;54
2014;"LICINIO DE ALMEIDA (BA)";"BA";"LICINIO DE ALMEIDA";122;16;23;161
2014;"LIVRAMENTO DE NOSSA SENHORA (BA)";"BA";"LIVRAMENTO DE NOSSA SENHORA";507;68;134;709
2014;"LUIS EDUARDO MAGALHAES (BA)";"BA";"LUIS EDUARDO MAGALHAES";1709;87;163;1959
2014;"MACAJUBA (BA)";"BA";"MACAJUBA";31;27;36;94
2014;"MACARANI (BA)";"BA";"MACARANI";100;14;17;131
2014;"MACAUBAS (BA)";"BA";"MACAUBAS";233;36;233;502
2014;"MACURURE (BA)";"BA";"MACURURE";25;4;9;38
2014;"MADRE DE DEUS (BA)";"BA";"MADRE DE DEUS";105;53;34;192
2014;"MAETINGA (BA)";"BA";"MAETINGA";45;12;15;72
2014;"MAIQUINIQUE (BA)";"BA";"MAIQUINIQUE";52;8;13;73
2014;"MAIRI (BA)";"BA";"MAIRI";80;29;43;152
2014;"MALHADA (BA)";"BA";"MALHADA";45;17;26;88
2014;"MALHADA DE PEDRAS (BA)";"BA";"MALHADA DE PEDRAS";101;43;40;184
2014;"MANOEL VITORINO (BA)";"BA";"MANOEL VITORINO";61;17;11;89
2014;"MANSIDAO (BA)";"BA";"MANSIDAO";25;0;11;36
2014;"MARACAS (BA)";"BA";"MARACAS";249;22;57;328
2014;"MARAGOGIPE (BA)";"BA";"MARAGOGIPE";146;63;56;265
2014;"MARAU (BA)";"BA";"MARAU";33;3;8;44
2014;"MARCIONILIO SOUZA (BA)";"BA";"MARCIONILIO SOUZA";39;24;16;79
2014;"MASCOTE (BA)";"BA";"MASCOTE";47;4;11;62
2014;"MATA DE SAO JOAO (BA)";"BA";"MATA DE SAO JOAO";252;92;91;435
2014;"MATINA (BA)";"BA";"MATINA";20;17;32;69
2014;"MEDEIROS NETO (BA)";"BA";"MEDEIROS NETO";93;21;47;161
2014;"MIGUEL CALMON (BA)";"BA";"MIGUEL CALMON";93;30;39;162
2014;"MILAGRES (BA)";"BA";"MILAGRES";156;13;20;189
2014;"MIRANGABA (BA)";"BA";"MIRANGABA";60;15;39;114
2014;"MIRANTE (BA)";"BA";"MIRANTE";64;22;20;106
2014;"MONTE SANTO (BA)";"BA";"MONTE SANTO";245;69;166;480
2014;"MORPARA (BA)";"BA";"MORPARA";21;15;7;43
2014;"MORRO DO CHAPEU (BA)";"BA";"MORRO DO CHAPEU";177;52;22;251
2014;"MORTUGABA (BA)";"BA";"MORTUGABA";91;7;17;115
2014;"MUCUGE (BA)";"BA";"MUCUGE";108;19;65;192
2014;"MUCURI (BA)";"BA";"MUCURI";146;40;123;309
2014;"MULUNGU DO MORRO (BA)";"BA";"MULUNGU DO MORRO";97;10;14;121
2014;"MUNDO NOVO (BA)";"BA";"MUNDO NOVO";65;24;30;119
2014;"MUNIZ FERREIRA (BA)";"BA";"MUNIZ FERREIRA";62;44;9;115
2014;"MUQUEM DO SAO FRANCISCO (BA)";"BA";"MUQUEM DO SAO FRANCISCO";35;19;27;81
2014;"MURITIBA (BA)";"BA";"MURITIBA";145;49;37;231
2014;"MUTUIPE (BA)";"BA";"MUTUIPE";147;82;52;281
2014;"NAZARE (BA)";"BA";"NAZARE";269;74;42;385
2014;"NILO PECANHA (BA)";"BA";"NILO PECANHA";48;30;23;101
2014;"NORDESTINA (BA)";"BA";"NORDESTINA";76;9;27;112
2014;"NOVA CANAA (BA)";"BA";"NOVA CANAA";64;21;16;101
2014;"NOVA FATIMA (BA)";"BA";"NOVA FATIMA";85;8;12;105
2014;"NOVA IBIA (BA)";"BA";"NOVA IBIA";18;6;7;31
2014;"NOVA ITARANA (BA)";"BA";"NOVA ITARANA";41;8;7;56
2014;"NOVA REDENCAO (BA)";"BA";"NOVA REDENCAO";16;8;7;31
2014;"NOVA SOURE (BA)";"BA";"NOVA SOURE";62;14;33;109
2014;"NOVA VICOSA (BA)";"BA";"NOVA VICOSA";193;55;84;332
2014;"NOVO HORIZONTE (BA)";"BA";"NOVO HORIZONTE";53;14;12;79
2014;"NOVO TRIUNFO (BA)";"BA";"NOVO TRIUNFO";19;3;4;26
2014;"OLINDINA (BA)";"BA";"OLINDINA";101;36;70;207
2014;"OLIVEIRA DOS BREJINHOS (BA)";"BA";"OLIVEIRA DOS BREJINHOS";125;54;40;219
2014;"OURICANGAS (BA)";"BA";"OURICANGAS";51;9;24;84
2014;"OUROLANDIA (BA)";"BA";"OUROLANDIA";70;22;8;100
2014;"PALMAS DE MONTE ALTO (BA)";"BA";"PALMAS DE MONTE ALTO";73;8;41;122
2014;"PALMEIRAS (BA)";"BA";"PALMEIRAS";47;30;10;87
2014;"PARAMIRIM (BA)";"BA";"PARAMIRIM";187;22;72;281
2014;"PARATINGA (BA)";"BA";"PARATINGA";75;38;48;161
2014;"PARIPIRANGA (BA)";"BA";"PARIPIRANGA";73;11;42;126
2014;"PAU BRASIL (BA)";"BA";"PAU BRASIL";54;15;40;109
2014;"PAULO AFONSO (BA)";"BA";"PAULO AFONSO";928;332;373;1633
2014;"PE DE SERRA (BA)";"BA";"PE DE SERRA";84;14;30;128
2014;"PEDRAO (BA)";"BA";"PEDRAO";9;6;10;25
2014;"PEDRO ALEXANDRE (BA)";"BA";"PEDRO ALEXANDRE";4;5;10;19
2014;"PIATA (BA)";"BA";"PIATA";101;45;36;182
2014;"PILAO ARCADO (BA)";"BA";"PILAO ARCADO";59;36;7;102
2014;"PINDAI (BA)";"BA";"PINDAI";55;14;30;99
2014;"PINDOBACU (BA)";"BA";"PINDOBACU";61;25;34;120
2014;"PINTADAS (BA)";"BA";"PINTADAS";64;30;56;150
2014;"PIRAI DO NORTE (BA)";"BA";"PIRAI DO NORTE";29;4;2;35
2014;"PIRIPA (BA)";"BA";"PIRIPA";100;34;20;154
2014;"PIRITIBA (BA)";"BA";"PIRITIBA";70;28;22;120
2014;"PLANALTINO (BA)";"BA";"PLANALTINO";41;9;26;76
2014;"PLANALTO (BA)";"BA";"PLANALTO";123;47;64;234
2014;"POCOES (BA)";"BA";"POCOES";417;325;92;834
2014;"POJUCA (BA)";"BA";"POJUCA";395;105;78;578
2014;"PONTO NOVO (BA)";"BA";"PONTO NOVO";78;9;36;123
2014;"PORTO SEGURO (BA)";"BA";"PORTO SEGURO";695;323;392;1410
2014;"POTIRAGUA (BA)";"BA";"POTIRAGUA";47;7;7;61
2014;"PRADO (BA)";"BA";"PRADO";76;14;43;133
2014;"PRESIDENTE DUTRA (BA)";"BA";"PRESIDENTE DUTRA";69;6;10;85
2014;"PRESIDENTE JANIO QUADROS (BA)";"BA";"PRESIDENTE JANIO QUADROS";47;32;22;101
2014;"PRESIDENTE TANCREDO NEVES (BA)";"BA";"PRESIDENTE TANCREDO NEVES";283;177;37;497
2014;"QUEIMADAS (BA)";"BA";"QUEIMADAS";121;24;68;213
2014;"QUIJINGUE (BA)";"BA";"QUIJINGUE";60;26;70;156
2014;"QUIXABEIRA (BA)";"BA";"QUIXABEIRA";53;19;13;85
2014;"RAFAEL JAMBEIRO (BA)";"BA";"RAFAEL JAMBEIRO";82;28;81;191
2014;"REMANSO (BA)";"BA";"REMANSO";285;93;31;409
2014;"RETIROLANDIA (BA)";"BA";"RETIROLANDIA";98;10;19;127
2014;"RIACHAO DAS NEVES (BA)";"BA";"RIACHAO DAS NEVES";76;21;32;129
2014;"RIACHAO DO JACUIPE (BA)";"BA";"RIACHAO DO JACUIPE";328;51;44;423
2014;"RIACHO DE SANTANA (BA)";"BA";"RIACHO DE SANTANA";248;25;72;345
2014;"RIBEIRA DO AMPARO (BA)";"BA";"RIBEIRA DO AMPARO";12;13;34;59
2014;"RIBEIRA DO POMBAL (BA)";"BA";"RIBEIRA DO POMBAL";282;95;130;507
2014;"RIBEIRAO DO LARGO (BA)";"BA";"RIBEIRAO DO LARGO";33;19;7;59
2014;"RIO DE CONTAS (BA)";"BA";"RIO DE CONTAS";84;33;23;140
2014;"RIO DO ANTONIO (BA)";"BA";"RIO DO ANTONIO";153;29;22;204
2014;"RIO DO PIRES (BA)";"BA";"RIO DO PIRES";77;12;22;111
2014;"RIO REAL (BA)";"BA";"RIO REAL";223;25;65;313
2014;"RODELAS (BA)";"BA";"RODELAS";30;7;7;44
2014;"RUY BARBOSA (BA)";"BA";"RUY BARBOSA";138;72;27;237
2014;"SALINAS DA MARGARIDA (BA)";"BA";"SALINAS DA MARGARIDA";30;14;10;54
2014;"SALVADOR (BA)";"BA";"SALVADOR";18094;4241;8775;31110
2014;"SANTA BARBARA (BA)";"BA";"SANTA BARBARA";84;18;21;123
2014;"SANTA BRIGIDA (BA)";"BA";"SANTA BRIGIDA";26;34;27;87
2014;"SANTA CRUZ CABRALIA (BA)";"BA";"SANTA CRUZ CABRALIA";95;38;39;172
2014;"SANTA CRUZ DA VITORIA (BA)";"BA";"SANTA CRUZ DA VITORIA";13;5;5;23
2014;"SANTA INES (BA)";"BA";"SANTA INES";47;18;6;71
2014;"SANTA LUZIA (BA)";"BA";"SANTA LUZIA";40;5;7;52
2014;"SANTA MARIA DA VITORIA (BA)";"BA";"SANTA MARIA DA VITORIA";417;55;68;540
2014;"SANTA RITA DE CASSIA (BA)";"BA";"SANTA RITA DE CASSIA";67;9;20;96
2014;"SANTA TERESINHA (BA)";"BA";"SANTA TERESINHA";44;15;33;92
2014;"SANTALUZ (BA)";"BA";"SANTALUZ";328;39;53;420
2014;"SANTANA (BA)";"BA";"SANTANA";175;12;68;255
2014;"SANTANOPOLIS (BA)";"BA";"SANTANOPOLIS";25;10;15;50
2014;"SANTO AMARO (BA)";"BA";"SANTO AMARO";244;122;210;576
2014;"SANTO ANTONIO DE JESUS (BA)";"BA";"SANTO ANTONIO DE JESUS";2201;256;179;2636
2014;"SANTO ESTEVAO (BA)";"BA";"SANTO ESTEVAO";324;99;68;491
2014;"SAO DESIDERIO (BA)";"BA";"SAO DESIDERIO";299;30;93;422
2014;"SAO DOMINGOS (BA)";"BA";"SAO DOMINGOS";49;2;8;59
2014;"SAO FELIPE (BA)";"BA";"SAO FELIPE";268;54;47;369
2014;"SAO FELIX (BA)";"BA";"SAO FELIX";56;32;17;105
2014;"SAO FELIX DO CORIBE (BA)";"BA";"SAO FELIX DO CORIBE";153;20;21;194
2014;"SAO FRANCISCO DO CONDE (BA)";"BA";"SAO FRANCISCO DO CONDE";154;96;97;347
2014;"SAO GABRIEL (BA)";"BA";"SAO GABRIEL";39;9;19;67
2014;"SAO GONCALO DOS CAMPOS (BA)";"BA";"SAO GONCALO DOS CAMPOS";204;196;43;443
2014;"SAO JOSE DA VITORIA (BA)";"BA";"SAO JOSE DA VITORIA";18;0;5;23
2014;"SAO JOSE DO JACUIPE (BA)";"BA";"SAO JOSE DO JACUIPE";73;18;7;98
2014;"SAO MIGUEL DAS MATAS (BA)";"BA";"SAO MIGUEL DAS MATAS";67;7;21;95
2014;"SAO SEBASTIAO DO PASSE (BA)";"BA";"SAO SEBASTIAO DO PASSE";220;213;142;575
2014;"SAPEACU (BA)";"BA";"SAPEACU";105;74;38;217
2014;"SATIRO DIAS (BA)";"BA";"SATIRO DIAS";31;15;18;64
2014;"SAUBARA (BA)";"BA";"SAUBARA";31;27;3;61
2014;"SAUDE (BA)";"BA";"SAUDE";47;26;19;92
2014;"SEABRA (BA)";"BA";"SEABRA";465;135;151;751
2014;"SEBASTIAO LARANJEIRAS (BA)";"BA";"SEBASTIAO LARANJEIRAS";33;2;29;64
2014;"SENHOR DO BONFIM (BA)";"BA";"SENHOR DO BONFIM";657;143;199;999
2014;"SENTO SE (BA)";"BA";"SENTO SE";54;11;21;86
2014;"SERRA DO RAMALHO (BA)";"BA";"SERRA DO RAMALHO";100;33;40;173
2014;"SERRA DOURADA (BA)";"BA";"SERRA DOURADA";69;17;38;124
2014;"SERRA PRETA (BA)";"BA";"SERRA PRETA";57;15;63;135
2014;"SERRINHA (BA)";"BA";"SERRINHA";738;147;214;1099
2014;"SERROLANDIA (BA)";"BA";"SERROLANDIA";56;45;22;123
2014;"SIMOES FILHO (BA)";"BA";"SIMOES FILHO";2470;496;880;3846
2014;"SITIO DO MATO (BA)";"BA";"SITIO DO MATO";34;11;24;69
2014;"SITIO DO QUINTO (BA)";"BA";"SITIO DO QUINTO";24;3;9;36
2014;"SOBRADINHO (BA)";"BA";"SOBRADINHO";93;45;41;179
2014;"SOUTO SOARES (BA)";"BA";"SOUTO SOARES";114;14;26;154
2014;"TABOCAS DO BREJO VELHO (BA)";"BA";"TABOCAS DO BREJO VELHO";43;4;16;63
2014;"TANHACU (BA)";"BA";"TANHACU";256;63;51;370
2014;"TANQUE NOVO (BA)";"BA";"TANQUE NOVO";261;10;45;316
2014;"TANQUINHO (BA)";"BA";"TANQUINHO";29;20;14;63
2014;"TAPEROA (BA)";"BA";"TAPEROA";141;29;19;189
2014;"TAPIRAMUTA (BA)";"BA";"TAPIRAMUTA";51;13;15;79
2014;"TEIXEIRA DE FREITAS (BA)";"BA";"TEIXEIRA DE FREITAS";1587;123;390;2100
2014;"TEODORO SAMPAIO (BA)";"BA";"TEODORO SAMPAIO";12;15;11;38
2014;"TEOFILANDIA (BA)";"BA";"TEOFILANDIA";116;45;36;197
2014;"TEOLANDIA (BA)";"BA";"TEOLANDIA";149;28;13;190
2014;"TERRA NOVA (BA)";"BA";"TERRA NOVA";25;14;21;60
2014;"TREMEDAL (BA)";"BA";"TREMEDAL";53;29;40;122
2014;"TUCANO (BA)";"BA";"TUCANO";299;56;97;452
2014;"UAUA (BA)";"BA";"UAUA";231;40;32;303
2014;"UBAIRA (BA)";"BA";"UBAIRA";111;33;52;196
2014;"UBAITABA (BA)";"BA";"UBAITABA";195;14;25;234
2014;"UBATA (BA)";"BA";"UBATA";215;21;16;252
2014;"UIBAI (BA)";"BA";"UIBAI";57;16;18;91
2014;"UMBURANAS (BA)";"BA";"UMBURANAS";54;23;21;98
2014;"UNA (BA)";"BA";"UNA";68;10;41;119
2014;"URANDI (BA)";"BA";"URANDI";141;18;33;192
2014;"URUCUCA (BA)";"BA";"URUCUCA";103;8;16;127
2014;"UTINGA (BA)";"BA";"UTINGA";74;14;7;95
2014;"VALENCA (BA)";"BA";"VALENCA";783;228;132;1143
2014;"VALENTE (BA)";"BA";"VALENTE";179;22;34;235
2014;"VARZEA DA ROCA (BA)";"BA";"VARZEA DA ROCA";45;18;22;85
2014;"VARZEA DO POCO (BA)";"BA";"VARZEA DO POCO";68;18;15;101
2014;"VARZEA NOVA (BA)";"BA";"VARZEA NOVA";62;11;17;90
2014;"VARZEDO (BA)";"BA";"VARZEDO";74;13;26;113
2014;"VERA CRUZ (BA)";"BA";"VERA CRUZ";203;183;46;432
2014;"VEREDA (BA)";"BA";"VEREDA";10;4;3;17
2014;"VITORIA DA CONQUISTA (BA)";"BA";"VITORIA DA CONQUISTA";4384;896;1428;6708
2014;"WAGNER (BA)";"BA";"WAGNER";34;4;14;52
2014;"WANDERLEY (BA)";"BA";"WANDERLEY";78;5;20;103
2014;"WENCESLAU GUIMARAES (BA)";"BA";"WENCESLAU GUIMARAES";137;20;18;175
2014;"XIQUE XIQUE (BA)";"BA";"XIQUE XIQUE";161;32;24;217
2014;"ABAIARA (CE)";"CE";"ABAIARA";17;26;7;50
2014;"ACARAPE (CE)";"CE";"ACARAPE";105;19;136;260
2014;"ACARAU (CE)";"CE";"ACARAU";230;33;61;324
2014;"ACOPIARA (CE)";"CE";"ACOPIARA";377;26;40;443
2014;"AIUABA (CE)";"CE";"AIUABA";36;7;4;47
2014;"ALCANTARAS (CE)";"CE";"ALCANTARAS";44;12;18;74
2014;"ALTANEIRA (CE)";"CE";"ALTANEIRA";24;8;5;37
2014;"ALTO SANTO (CE)";"CE";"ALTO SANTO";150;12;19;181
2014;"AMONTADA (CE)";"CE";"AMONTADA";201;28;33;262
2014;"ANTONINA DO NORTE (CE)";"CE";"ANTONINA DO NORTE";48;3;7;58
2014;"APUIARES (CE)";"CE";"APUIARES";87;7;8;102
2014;"AQUIRAZ (CE)";"CE";"AQUIRAZ";616;159;110;885
2014;"ARACATI (CE)";"CE";"ARACATI";497;110;148;755
2014;"ARACOIABA (CE)";"CE";"ARACOIABA";127;18;26;171
2014;"ARARENDA (CE)";"CE";"ARARENDA";41;6;4;51
2014;"ARARIPE (CE)";"CE";"ARARIPE";68;114;44;226
2014;"ARATUBA (CE)";"CE";"ARATUBA";71;0;16;87
2014;"ARNEIROZ (CE)";"CE";"ARNEIROZ";35;14;5;54
2014;"ASSARE (CE)";"CE";"ASSARE";102;34;12;148
2014;"AURORA (CE)";"CE";"AURORA";89;33;16;138
2014;"BAIXIO (CE)";"CE";"BAIXIO";19;16;9;44
2014;"BANABUIU (CE)";"CE";"BANABUIU";118;11;26;155
2014;"BARBALHA (CE)";"CE";"BARBALHA";366;89;90;545
2014;"BARREIRA (CE)";"CE";"BARREIRA";147;10;16;173
2014;"BARRO (CE)";"CE";"BARRO";69;37;16;122
2014;"BARROQUINHA (CE)";"CE";"BARROQUINHA";49;8;6;63
2014;"BATURITE (CE)";"CE";"BATURITE";233;21;33;287
2014;"BEBERIBE (CE)";"CE";"BEBERIBE";257;64;71;392
2014;"BELA CRUZ (CE)";"CE";"BELA CRUZ";123;12;36;171
2014;"BOA VIAGEM (CE)";"CE";"BOA VIAGEM";487;21;63;571
2014;"BREJO SANTO (CE)";"CE";"BREJO SANTO";439;100;64;603
2014;"CAMOCIM (CE)";"CE";"CAMOCIM";239;50;39;328
2014;"CAMPOS SALES (CE)";"CE";"CAMPOS SALES";225;87;54;366
2014;"CANINDE (CE)";"CE";"CANINDE";606;41;95;742
2014;"CAPISTRANO (CE)";"CE";"CAPISTRANO";62;13;19;94
2014;"CARIDADE (CE)";"CE";"CARIDADE";78;9;17;104
2014;"CARIRE (CE)";"CE";"CARIRE";76;14;29;119
2014;"CARIRIACU (CE)";"CE";"CARIRIACU";68;42;12;122
2014;"CARIUS (CE)";"CE";"CARIUS";57;21;7;85
2014;"CARNAUBAL (CE)";"CE";"CARNAUBAL";77;26;10;113
2014;"CASCAVEL (CE)";"CE";"CASCAVEL";513;72;160;745
2014;"CATARINA (CE)";"CE";"CATARINA";52;5;2;59
2014;"CATUNDA (CE)";"CE";"CATUNDA";43;11;8;62
2014;"CAUCAIA (CE)";"CE";"CAUCAIA";1738;300;403;2441
2014;"CEDRO (CE)";"CE";"CEDRO";106;45;45;196
2014;"CHAVAL (CE)";"CE";"CHAVAL";32;16;11;59
2014;"CHORO (CE)";"CE";"CHORO";59;9;38;106
2014;"CHOROZINHO (CE)";"CE";"CHOROZINHO";154;16;37;207
2014;"COREAU (CE)";"CE";"COREAU";109;11;39;159
2014;"CRATEUS (CE)";"CE";"CRATEUS";374;93;100;567
2014;"CRATO (CE)";"CE";"CRATO";1062;179;124;1365
2014;"CROATA (CE)";"CE";"CROATA";71;22;16;109
2014;"CRUZ (CE)";"CE";"CRUZ";176;24;85;285
2014;"DEPUTADO IRAPUAN PINHEIRO (CE)";"CE";"DEPUTADO IRAPUAN PINHEIRO";28;5;12;45
2014;"ERERE (CE)";"CE";"ERERE";4;1;6;11
2014;"EUSEBIO (CE)";"CE";"EUSEBIO";1476;78;71;1625
2014;"FARIAS BRITO (CE)";"CE";"FARIAS BRITO";108;39;23;170
2014;"FORQUILHA (CE)";"CE";"FORQUILHA";127;30;50;207
2014;"FORTALEZA (CE)";"CE";"FORTALEZA";22127;3449;6716;32292
2014;"FORTIM (CE)";"CE";"FORTIM";38;28;19;85
2014;"FRECHEIRINHA (CE)";"CE";"FRECHEIRINHA";94;17;25;136
2014;"GENERAL SAMPAIO (CE)";"CE";"GENERAL SAMPAIO";34;2;7;43
2014;"GRACA (CE)";"CE";"GRACA";34;13;12;59
2014;"GRANJA (CE)";"CE";"GRANJA";210;86;37;333
2014;"GRANJEIRO (CE)";"CE";"GRANJEIRO";8;4;2;14
2014;"GROAIRAS (CE)";"CE";"GROAIRAS";69;25;27;121
2014;"GUAIUBA (CE)";"CE";"GUAIUBA";90;24;11;125
2014;"GUARACIABA DO NORTE (CE)";"CE";"GUARACIABA DO NORTE";454;19;24;497
2014;"GUARAMIRANGA (CE)";"CE";"GUARAMIRANGA";36;2;11;49
2014;"HIDROLANDIA (CE)";"CE";"HIDROLANDIA";152;17;16;185
2014;"HORIZONTE (CE)";"CE";"HORIZONTE";486;91;79;656
2014;"IBARETAMA (CE)";"CE";"IBARETAMA";76;7;22;105
2014;"IBIAPINA (CE)";"CE";"IBIAPINA";173;33;23;229
2014;"IBICUITINGA (CE)";"CE";"IBICUITINGA";95;7;20;122
2014;"ICAPUI (CE)";"CE";"ICAPUI";86;28;60;174
2014;"ICO (CE)";"CE";"ICO";348;90;75;513
2014;"IGUATU (CE)";"CE";"IGUATU";1086;79;135;1300
2014;"INDEPENDENCIA (CE)";"CE";"INDEPENDENCIA";248;2;19;269
2014;"IPAPORANGA (CE)";"CE";"IPAPORANGA";28;3;8;39
2014;"IPAUMIRIM (CE)";"CE";"IPAUMIRIM";288;72;35;395
2014;"IPU (CE)";"CE";"IPU";279;28;29;336
2014;"IPUEIRAS (CE)";"CE";"IPUEIRAS";96;43;12;151
2014;"IRACEMA (CE)";"CE";"IRACEMA";65;18;15;98
2014;"IRAUCUBA (CE)";"CE";"IRAUCUBA";104;20;31;155
2014;"ITAICABA (CE)";"CE";"ITAICABA";35;7;14;56
2014;"ITAITINGA (CE)";"CE";"ITAITINGA";420;69;31;520
2014;"ITAPAJE (CE)";"CE";"ITAPAJE";312;42;46;400
2014;"ITAPIPOCA (CE)";"CE";"ITAPIPOCA";924;43;75;1042
2014;"ITAPIUNA (CE)";"CE";"ITAPIUNA";73;8;27;108
2014;"ITAREMA (CE)";"CE";"ITAREMA";138;18;41;197
2014;"ITATIRA (CE)";"CE";"ITATIRA";130;5;29;164
2014;"JAGUARETAMA (CE)";"CE";"JAGUARETAMA";126;8;18;152
2014;"JAGUARIBARA (CE)";"CE";"JAGUARIBARA";93;10;14;117
2014;"JAGUARIBE (CE)";"CE";"JAGUARIBE";399;54;44;497
2014;"JAGUARUANA (CE)";"CE";"JAGUARUANA";279;22;18;319
2014;"JARDIM (CE)";"CE";"JARDIM";130;63;15;208
2014;"JATI (CE)";"CE";"JATI";32;48;12;92
2014;"JIJOCA DE JERICOACOARA (CE)";"CE";"JIJOCA DE JERICOACOARA";85;16;21;122
2014;"JUAZEIRO DO NORTE (CE)";"CE";"JUAZEIRO DO NORTE";1898;195;231;2324
2014;"JUCAS (CE)";"CE";"JUCAS";118;6;24;148
2014;"LAVRAS DA MANGABEIRA (CE)";"CE";"LAVRAS DA MANGABEIRA";106;25;29;160
2014;"LIMOEIRO DO NORTE (CE)";"CE";"LIMOEIRO DO NORTE";744;40;127;911
2014;"MADALENA (CE)";"CE";"MADALENA";131;6;19;156
2014;"MARACANAU (CE)";"CE";"MARACANAU";1901;254;375;2530
2014;"MARANGUAPE (CE)";"CE";"MARANGUAPE";648;150;277;1075
2014;"MARCO (CE)";"CE";"MARCO";281;19;20;320
2014;"MARTINOPOLE (CE)";"CE";"MARTINOPOLE";41;13;2;56
2014;"MASSAPE (CE)";"CE";"MASSAPE";117;34;91;242
2014;"MAURITI (CE)";"CE";"MAURITI";154;60;48;262
2014;"MERUOCA (CE)";"CE";"MERUOCA";40;18;19;77
2014;"MILAGRES (CE)";"CE";"MILAGRES";89;55;27;171
2014;"MILHA (CE)";"CE";"MILHA";96;7;18;121
2014;"MIRAIMA (CE)";"CE";"MIRAIMA";31;1;13;45
2014;"MISSAO VELHA (CE)";"CE";"MISSAO VELHA";228;75;13;316
2014;"MOMBACA (CE)";"CE";"MOMBACA";261;33;26;320
2014;"MONSENHOR TABOSA (CE)";"CE";"MONSENHOR TABOSA";87;7;5;99
2014;"MORADA NOVA (CE)";"CE";"MORADA NOVA";526;58;101;685
2014;"MORAUJO (CE)";"CE";"MORAUJO";21;4;7;32
2014;"MORRINHOS (CE)";"CE";"MORRINHOS";87;15;27;129
2014;"MUCAMBO (CE)";"CE";"MUCAMBO";39;20;15;74
2014;"MULUNGU (CE)";"CE";"MULUNGU";69;8;12;89
2014;"NOVA OLINDA (CE)";"CE";"NOVA OLINDA";113;33;16;162
2014;"NOVA RUSSAS (CE)";"CE";"NOVA RUSSAS";203;24;11;238
2014;"NOVO ORIENTE (CE)";"CE";"NOVO ORIENTE";78;37;19;134
2014;"OCARA (CE)";"CE";"OCARA";158;15;50;223
2014;"OROS (CE)";"CE";"OROS";141;31;31;203
2014;"PACAJUS (CE)";"CE";"PACAJUS";693;107;178;978
2014;"PACATUBA (CE)";"CE";"PACATUBA";221;78;31;330
2014;"PACOTI (CE)";"CE";"PACOTI";102;5;14;121
2014;"PACUJA (CE)";"CE";"PACUJA";25;5;8;38
2014;"PALHANO (CE)";"CE";"PALHANO";70;13;13;96
2014;"PALMACIA (CE)";"CE";"PALMACIA";48;11;16;75
2014;"PARACURU (CE)";"CE";"PARACURU";214;26;38;278
2014;"PARAIPABA (CE)";"CE";"PARAIPABA";262;18;29;309
2014;"PARAMBU (CE)";"CE";"PARAMBU";234;10;19;263
2014;"PARAMOTI (CE)";"CE";"PARAMOTI";70;5;17;92
2014;"PEDRA BRANCA (CE)";"CE";"PEDRA BRANCA";354;27;42;423
2014;"PENAFORTE (CE)";"CE";"PENAFORTE";44;51;24;119
2014;"PENTECOSTE (CE)";"CE";"PENTECOSTE";276;17;21;314
2014;"PEREIRO (CE)";"CE";"PEREIRO";100;12;30;142
2014;"PINDORETAMA (CE)";"CE";"PINDORETAMA";173;20;19;212
2014;"PIQUET CARNEIRO (CE)";"CE";"PIQUET CARNEIRO";54;7;13;74
2014;"PIRES FERREIRA (CE)";"CE";"PIRES FERREIRA";18;6;3;27
2014;"PORANGA (CE)";"CE";"PORANGA";25;10;7;42
2014;"PORTEIRAS (CE)";"CE";"PORTEIRAS";37;271;51;359
2014;"POTENGI (CE)";"CE";"POTENGI";37;6;10;53
2014;"POTIRETAMA (CE)";"CE";"POTIRETAMA";46;5;6;57
2014;"QUITERIANOPOLIS (CE)";"CE";"QUITERIANOPOLIS";75;14;8;97
2014;"QUIXADA (CE)";"CE";"QUIXADA";804;66;124;994
2014;"QUIXELO (CE)";"CE";"QUIXELO";70;21;39;130
2014;"QUIXERAMOBIM (CE)";"CE";"QUIXERAMOBIM";533;35;116;684
2014;"QUIXERE (CE)";"CE";"QUIXERE";249;18;47;314
2014;"REDENCAO (CE)";"CE";"REDENCAO";234;42;60;336
2014;"RERIUTABA (CE)";"CE";"RERIUTABA";104;23;22;149
2014;"RUSSAS (CE)";"CE";"RUSSAS";928;57;142;1127
2014;"SABOEIRO (CE)";"CE";"SABOEIRO";45;9;11;65
2014;"SALITRE (CE)";"CE";"SALITRE";98;12;32;142
2014;"SANTA QUITERIA (CE)";"CE";"SANTA QUITERIA";329;42;19;390
2014;"SANTANA DO ACARAU (CE)";"CE";"SANTANA DO ACARAU";156;52;53;261
2014;"SANTANA DO CARIRI (CE)";"CE";"SANTANA DO CARIRI";77;36;17;130
2014;"SAO BENEDITO (CE)";"CE";"SAO BENEDITO";467;103;60;630
2014;"SAO GONCALO DO AMARANTE (CE)";"CE";"SAO GONCALO DO AMARANTE";397;89;167;653
2014;"SAO JOAO DO JAGUARIBE (CE)";"CE";"SAO JOAO DO JAGUARIBE";48;3;10;61
2014;"SAO LUIS DO CURU (CE)";"CE";"SAO LUIS DO CURU";68;3;10;81
2014;"SENADOR POMPEU (CE)";"CE";"SENADOR POMPEU";167;22;59;248
2014;"SENADOR SA (CE)";"CE";"SENADOR SA";26;6;16;48
2014;"SOBRAL (CE)";"CE";"SOBRAL";1617;246;424;2287
2014;"SOLONOPOLE (CE)";"CE";"SOLONOPOLE";99;20;20;139
2014;"TABULEIRO DO NORTE (CE)";"CE";"TABULEIRO DO NORTE";368;42;51;461
2014;"TAMBORIL (CE)";"CE";"TAMBORIL";120;21;26;167
2014;"TARRAFAS (CE)";"CE";"TARRAFAS";21;8;6;35
2014;"TAUA (CE)";"CE";"TAUA";481;76;52;609
2014;"TEJUCUOCA (CE)";"CE";"TEJUCUOCA";97;6;20;123
2014;"TIANGUA (CE)";"CE";"TIANGUA";1434;183;186;1803
2014;"TRAIRI (CE)";"CE";"TRAIRI";235;39;64;338
2014;"TURURU (CE)";"CE";"TURURU";64;9;12;85
2014;"UBAJARA (CE)";"CE";"UBAJARA";299;31;73;403
2014;"UMARI (CE)";"CE";"UMARI";12;3;5;20
2014;"UMIRIM (CE)";"CE";"UMIRIM";58;36;36;130
2014;"URUBURETAMA (CE)";"CE";"URUBURETAMA";82;10;38;130
2014;"URUOCA (CE)";"CE";"URUOCA";66;10;21;97
2014;"VARJOTA (CE)";"CE";"VARJOTA";144;35;10;189
2014;"VARZEA ALEGRE (CE)";"CE";"VARZEA ALEGRE";266;51;59;376
2014;"VICOSA DO CEARA (CE)";"CE";"VICOSA DO CEARA";386;43;77;506
2014;"BRASILIA (DF)";"DF";"BRASILIA";22490;5189;11787;39466
2014;"AFONSO CLAUDIO (ES)";"ES";"AFONSO CLAUDIO";650;96;110;856
2014;"AGUA DOCE DO NORTE (ES)";"ES";"AGUA DOCE DO NORTE";126;32;32;190
2014;"AGUIA BRANCA (ES)";"ES";"AGUIA BRANCA";173;5;21;199
2014;"ALEGRE (ES)";"ES";"ALEGRE";253;52;31;336
2014;"ALFREDO CHAVES (ES)";"ES";"ALFREDO CHAVES";460;30;38;528
2014;"ALTO RIO NOVO (ES)";"ES";"ALTO RIO NOVO";119;26;28;173
2014;"ANCHIETA (ES)";"ES";"ANCHIETA";314;94;61;469
2014;"APIACA (ES)";"ES";"APIACA";141;24;7;172
2014;"ARACRUZ (ES)";"ES";"ARACRUZ";1377;229;531;2137
2014;"ATILIO VIVACQUA (ES)";"ES";"ATILIO VIVACQUA";211;13;26;250
2014;"BAIXO GUANDU (ES)";"ES";"BAIXO GUANDU";574;39;87;700
2014;"BARRA DE SAO FRANCISCO (ES)";"ES";"BARRA DE SAO FRANCISCO";591;45;135;771
2014;"BOA ESPERANCA (ES)";"ES";"BOA ESPERANCA";264;22;55;341
2014;"BOM JESUS DO NORTE (ES)";"ES";"BOM JESUS DO NORTE";242;37;30;309
2014;"BREJETUBA (ES)";"ES";"BREJETUBA";251;25;56;332
2014;"CACHOEIRO DE ITAPEMIRIM (ES)";"ES";"CACHOEIRO DE ITAPEMIRIM";5035;235;1856;7126
2014;"CARIACICA (ES)";"ES";"CARIACICA";5787;649;1755;8191
2014;"CASTELO (ES)";"ES";"CASTELO";1250;98;92;1440
2014;"COLATINA (ES)";"ES";"COLATINA";2596;182;560;3338
2014;"CONCEICAO DA BARRA (ES)";"ES";"CONCEICAO DA BARRA";249;22;124;395
2014;"CONCEICAO DO CASTELO (ES)";"ES";"CONCEICAO DO CASTELO";287;47;57;391
2014;"DIVINO DE SAO LOURENCO (ES)";"ES";"DIVINO DE SAO LOURENCO";82;10;11;103
2014;"DOMINGOS MARTINS (ES)";"ES";"DOMINGOS MARTINS";1212;121;78;1411
2014;"DORES DO RIO PRETO (ES)";"ES";"DORES DO RIO PRETO";153;25;16;194
2014;"ECOPORANGA (ES)";"ES";"ECOPORANGA";190;50;95;335
2014;"FUNDAO (ES)";"ES";"FUNDAO";362;55;43;460
2014;"GOVERNADOR LINDENBERG (ES)";"ES";"GOVERNADOR LINDENBERG";312;8;7;327
2014;"GUACUI (ES)";"ES";"GUACUI";644;50;47;741
2014;"GUARAPARI (ES)";"ES";"GUARAPARI";1246;346;273;1865
2014;"IBATIBA (ES)";"ES";"IBATIBA";512;60;65;637
2014;"IBIRACU (ES)";"ES";"IBIRACU";386;39;54;479
2014;"IBITIRAMA (ES)";"ES";"IBITIRAMA";151;34;26;211
2014;"ICONHA (ES)";"ES";"ICONHA";763;25;63;851
2014;"IRUPI (ES)";"ES";"IRUPI";240;41;29;310
2014;"ITAGUACU (ES)";"ES";"ITAGUACU";292;13;63;368
2014;"ITAPEMIRIM (ES)";"ES";"ITAPEMIRIM";579;47;82;708
2014;"ITARANA (ES)";"ES";"ITARANA";402;37;39;478
2014;"IUNA (ES)";"ES";"IUNA";480;71;90;641
2014;"JAGUARE (ES)";"ES";"JAGUARE";490;30;103;623
2014;"JERONIMO MONTEIRO (ES)";"ES";"JERONIMO MONTEIRO";117;24;17;158
2014;"JOAO NEIVA (ES)";"ES";"JOAO NEIVA";351;31;34;416
2014;"LARANJA DA TERRA (ES)";"ES";"LARANJA DA TERRA";311;24;32;367
2014;"LINHARES (ES)";"ES";"LINHARES";3013;210;524;3747
2014;"MANTENOPOLIS (ES)";"ES";"MANTENOPOLIS";172;27;32;231
2014;"MARATAIZES (ES)";"ES";"MARATAIZES";1056;46;75;1177
2014;"MARECHAL FLORIANO (ES)";"ES";"MARECHAL FLORIANO";735;53;36;824
2014;"MARILANDIA (ES)";"ES";"MARILANDIA";423;27;27;477
2014;"MIMOSO DO SUL (ES)";"ES";"MIMOSO DO SUL";344;62;91;497
2014;"MONTANHA (ES)";"ES";"MONTANHA";232;12;66;310
2014;"MUCURICI (ES)";"ES";"MUCURICI";68;10;21;99
2014;"MUNIZ FREIRE (ES)";"ES";"MUNIZ FREIRE";249;52;48;349
2014;"MUQUI (ES)";"ES";"MUQUI";215;26;31;272
2014;"NOVA VENECIA (ES)";"ES";"NOVA VENECIA";979;58;210;1247
2014;"PANCAS (ES)";"ES";"PANCAS";321;35;19;375
2014;"PEDRO CANARIO (ES)";"ES";"PEDRO CANARIO";545;50;273;868
2014;"PINHEIROS (ES)";"ES";"PINHEIROS";339;24;138;501
2014;"PIUMA (ES)";"ES";"PIUMA";276;34;16;326
2014;"PONTO BELO (ES)";"ES";"PONTO BELO";61;11;15;87
2014;"PRESIDENTE KENNEDY (ES)";"ES";"PRESIDENTE KENNEDY";341;19;25;385
2014;"RIO BANANAL (ES)";"ES";"RIO BANANAL";647;26;58;731
2014;"RIO NOVO DO SUL (ES)";"ES";"RIO NOVO DO SUL";372;25;32;429
2014;"SANTA LEOPOLDINA (ES)";"ES";"SANTA LEOPOLDINA";468;42;34;544
2014;"SANTA MARIA DE JETIBA (ES)";"ES";"SANTA MARIA DE JETIBA";2413;104;77;2594
2014;"SANTA TERESA (ES)";"ES";"SANTA TERESA";734;46;118;898
2014;"SAO DOMINGOS DO NORTE (ES)";"ES";"SAO DOMINGOS DO NORTE";256;21;31;308
2014;"SAO GABRIEL DA PALHA (ES)";"ES";"SAO GABRIEL DA PALHA";739;30;121;890
2014;"SAO JOSE DO CALCADO (ES)";"ES";"SAO JOSE DO CALCADO";103;21;20;144
2014;"SAO MATEUS (ES)";"ES";"SAO MATEUS";1207;118;378;1703
2014;"SAO ROQUE DO CANAA (ES)";"ES";"SAO ROQUE DO CANAA";341;20;27;388
2014;"SERRA (ES)";"ES";"SERRA";8930;729;2265;11924
2014;"SOORETAMA (ES)";"ES";"SOORETAMA";349;23;57;429
2014;"VARGEM ALTA (ES)";"ES";"VARGEM ALTA";510;32;60;602
2014;"VENDA NOVA DO IMIGRANTE (ES)";"ES";"VENDA NOVA DO IMIGRANTE";844;32;120;996
2014;"VIANA (ES)";"ES";"VIANA";1288;103;399;1790
2014;"VILA PAVAO (ES)";"ES";"VILA PAVAO";166;10;29;205
2014;"VILA VALERIO (ES)";"ES";"VILA VALERIO";409;17;60;486
2014;"VILA VELHA (ES)";"ES";"VILA VELHA";4503;908;1065;6476
2014;"VITORIA (ES)";"ES";"VITORIA";4133;1102;992;6227
2014;"ABADIA DE GOIAS (GO)";"GO";"ABADIA DE GOIAS";112;7;8;127
2014;"ABADIANIA (GO)";"GO";"ABADIANIA";316;36;27;379
2014;"ACREUNA (GO)";"GO";"ACREUNA";422;17;112;551
2014;"ADELANDIA (GO)";"GO";"ADELANDIA";38;1;5;44
2014;"AGUA FRIA DE GOIAS (GO)";"GO";"AGUA FRIA DE GOIAS";48;8;19;75
2014;"AGUA LIMPA (GO)";"GO";"AGUA LIMPA";18;6;2;26
2014;"AGUAS LINDAS DE GOIAS (GO)";"GO";"AGUAS LINDAS DE GOIAS";1181;180;635;1996
2014;"ALEXANIA (GO)";"GO";"ALEXANIA";433;52;42;527
2014;"ALOANDIA (GO)";"GO";"ALOANDIA";26;2;3;31
2014;"ALTO HORIZONTE (GO)";"GO";"ALTO HORIZONTE";56;9;23;88
2014;"ALTO PARAISO DE GOIAS (GO)";"GO";"ALTO PARAISO DE GOIAS";70;10;12;92
2014;"ALVORADA DO NORTE (GO)";"GO";"ALVORADA DO NORTE";141;7;16;164
2014;"AMARALINA (GO)";"GO";"AMARALINA";14;3;9;26
2014;"AMERICANO DO BRASIL (GO)";"GO";"AMERICANO DO BRASIL";66;8;17;91
2014;"AMORINOPOLIS (GO)";"GO";"AMORINOPOLIS";42;5;10;57
2014;"ANAPOLIS (GO)";"GO";"ANAPOLIS";10412;342;1673;12427
2014;"ANHANGUERA (GO)";"GO";"ANHANGUERA";7;2;1;10
2014;"ANICUNS (GO)";"GO";"ANICUNS";387;22;114;523
2014;"APARECIDA DE GOIANIA (GO)";"GO";"APARECIDA DE GOIANIA";6984;371;607;7962
2014;"APARECIDA DO RIO DOCE (GO)";"GO";"APARECIDA DO RIO DOCE";45;7;9;61
2014;"APORE (GO)";"GO";"APORE";68;16;27;111
2014;"ARACU (GO)";"GO";"ARACU";32;7;9;48
2014;"ARAGARCAS (GO)";"GO";"ARAGARCAS";531;13;27;571
2014;"ARAGOIANIA (GO)";"GO";"ARAGOIANIA";90;1;7;98
2014;"ARAGUAPAZ (GO)";"GO";"ARAGUAPAZ";94;12;15;121
2014;"ARENOPOLIS (GO)";"GO";"ARENOPOLIS";22;7;7;36
2014;"ARUANA (GO)";"GO";"ARUANA";54;1;18;73
2014;"AURILANDIA (GO)";"GO";"AURILANDIA";33;4;3;40
2014;"AVELINOPOLIS (GO)";"GO";"AVELINOPOLIS";63;4;2;69
2014;"BALIZA (GO)";"GO";"BALIZA";11;0;5;16
2014;"BARRO ALTO (GO)";"GO";"BARRO ALTO";161;29;73;263
2014;"BELA VISTA DE GOIAS (GO)";"GO";"BELA VISTA DE GOIAS";431;19;45;495
2014;"BOM JARDIM DE GOIAS (GO)";"GO";"BOM JARDIM DE GOIAS";144;7;36;187
2014;"BOM JESUS (GO)";"GO";"BOM JESUS";396;56;98;550
2014;"BONFINOPOLIS (GO)";"GO";"BONFINOPOLIS";66;6;10;82
2014;"BONOPOLIS (GO)";"GO";"BONOPOLIS";19;5;7;31
2014;"BRAZABRANTES (GO)";"GO";"BRAZABRANTES";65;3;2;70
2014;"BRITANIA (GO)";"GO";"BRITANIA";92;5;11;108
2014;"BURITI ALEGRE (GO)";"GO";"BURITI ALEGRE";225;35;20;280
2014;"BURITI DE GOIAS (GO)";"GO";"BURITI DE GOIAS";15;8;2;25
2014;"BURITINOPOLIS (GO)";"GO";"BURITINOPOLIS";22;3;7;32
2014;"CABECEIRAS (GO)";"GO";"CABECEIRAS";160;8;23;191
2014;"CACHOEIRA ALTA (GO)";"GO";"CACHOEIRA ALTA";151;22;39;212
2014;"CACHOEIRA DE GOIAS (GO)";"GO";"CACHOEIRA DE GOIAS";8;2;2;12
2014;"CACHOEIRA DOURADA (GO)";"GO";"CACHOEIRA DOURADA";112;15;36;163
2014;"CACU (GO)";"GO";"CACU";275;24;38;337
2014;"CAIAPONIA (GO)";"GO";"CAIAPONIA";201;8;13;222
2014;"CALDAS NOVAS (GO)";"GO";"CALDAS NOVAS";777;117;116;1010
2014;"CALDAZINHA (GO)";"GO";"CALDAZINHA";37;2;2;41
2014;"CAMPESTRE DE GOIAS (GO)";"GO";"CAMPESTRE DE GOIAS";50;1;6;57
2014;"CAMPINACU (GO)";"GO";"CAMPINACU";35;2;7;44
2014;"CAMPINORTE (GO)";"GO";"CAMPINORTE";184;19;17;220
2014;"CAMPO ALEGRE DE GOIAS (GO)";"GO";"CAMPO ALEGRE DE GOIAS";142;17;26;185
2014;"CAMPO LIMPO DE GOIAS (GO)";"GO";"CAMPO LIMPO DE GOIAS";158;0;6;164
2014;"CAMPOS BELOS (GO)";"GO";"CAMPOS BELOS";266;17;51;334
2014;"CAMPOS VERDES (GO)";"GO";"CAMPOS VERDES";39;7;2;48
2014;"CARMO DO RIO VERDE (GO)";"GO";"CARMO DO RIO VERDE";91;11;55;157
2014;"CASTELANDIA (GO)";"GO";"CASTELANDIA";62;7;8;77
2014;"CATALAO (GO)";"GO";"CATALAO";1956;201;332;2489
2014;"CATURAI (GO)";"GO";"CATURAI";47;3;8;58
2014;"CAVALCANTE (GO)";"GO";"CAVALCANTE";40;3;5;48
2014;"CERES (GO)";"GO";"CERES";504;20;48;572
2014;"CEZARINA (GO)";"GO";"CEZARINA";134;9;23;166
2014;"CHAPADAO DO CEU (GO)";"GO";"CHAPADAO DO CEU";292;18;27;337
2014;"CIDADE OCIDENTAL (GO)";"GO";"CIDADE OCIDENTAL";153;61;77;291
2014;"COCALZINHO DE GOIAS (GO)";"GO";"COCALZINHO DE GOIAS";179;24;27;230
2014;"COLINAS DO SUL (GO)";"GO";"COLINAS DO SUL";16;3;2;21
2014;"CORREGO DO OURO (GO)";"GO";"CORREGO DO OURO";19;2;3;24
2014;"CORUMBA DE GOIAS (GO)";"GO";"CORUMBA DE GOIAS";86;16;30;132
2014;"CORUMBAIBA (GO)";"GO";"CORUMBAIBA";165;26;11;202
2014;"CRISTALINA (GO)";"GO";"CRISTALINA";1786;108;441;2335
2014;"CRISTIANOPOLIS (GO)";"GO";"CRISTIANOPOLIS";64;9;4;77
2014;"CRIXAS (GO)";"GO";"CRIXAS";167;21;21;209
2014;"CROMINIA (GO)";"GO";"CROMINIA";51;5;3;59
2014;"CUMARI (GO)";"GO";"CUMARI";33;8;1;42
2014;"DAMIANOPOLIS (GO)";"GO";"DAMIANOPOLIS";25;3;12;40
2014;"DAMOLANDIA (GO)";"GO";"DAMOLANDIA";50;6;6;62
2014;"DAVINOPOLIS (GO)";"GO";"DAVINOPOLIS";31;4;4;39
2014;"DIORAMA (GO)";"GO";"DIORAMA";13;5;7;25
2014;"DIVINOPOLIS DE GOIAS (GO)";"GO";"DIVINOPOLIS DE GOIAS";26;5;9;40
2014;"DOVERLANDIA (GO)";"GO";"DOVERLANDIA";123;11;35;169
2014;"EDEALINA (GO)";"GO";"EDEALINA";71;15;10;96
2014;"EDEIA (GO)";"GO";"EDEIA";232;10;20;262
2014;"ESTRELA DO NORTE (GO)";"GO";"ESTRELA DO NORTE";40;2;2;44
2014;"FAINA (GO)";"GO";"FAINA";54;17;8;79
2014;"FAZENDA NOVA (GO)";"GO";"FAZENDA NOVA";53;7;8;68
2014;"FIRMINOPOLIS (GO)";"GO";"FIRMINOPOLIS";105;5;5;115
2014;"FLORES DE GOIAS (GO)";"GO";"FLORES DE GOIAS";46;4;9;59
2014;"FORMOSA (GO)";"GO";"FORMOSA";3382;196;675;4253
2014;"FORMOSO (GO)";"GO";"FORMOSO";40;6;8;54
2014;"GAMELEIRA DE GOIAS (GO)";"GO";"GAMELEIRA DE GOIAS";28;5;15;48
2014;"GOIANAPOLIS (GO)";"GO";"GOIANAPOLIS";237;17;16;270
2014;"GOIANDIRA (GO)";"GO";"GOIANDIRA";48;6;5;59
2014;"GOIANESIA (GO)";"GO";"GOIANESIA";1017;87;288;1392
2014;"GOIANIA (GO)";"GO";"GOIANIA";25812;2047;6573;34432
2014;"GOIANIRA (GO)";"GO";"GOIANIRA";352;17;74;443
2014;"GOIAS (GO)";"GO";"GOIAS";244;22;49;315
2014;"GOIATUBA (GO)";"GO";"GOIATUBA";775;52;134;961
2014;"GOUVELANDIA (GO)";"GO";"GOUVELANDIA";61;9;9;79
2014;"GUAPO (GO)";"GO";"GUAPO";223;24;56;303
2014;"GUARAITA (GO)";"GO";"GUARAITA";19;3;2;24
2014;"GUARANI DE GOIAS (GO)";"GO";"GUARANI DE GOIAS";14;4;10;28
2014;"GUARINOS (GO)";"GO";"GUARINOS";11;5;4;20
2014;"HEITORAI (GO)";"GO";"HEITORAI";36;3;6;45
2014;"HIDROLANDIA (GO)";"GO";"HIDROLANDIA";701;29;41;771
2014;"HIDROLINA (GO)";"GO";"HIDROLINA";22;1;2;25
2014;"IACIARA (GO)";"GO";"IACIARA";127;8;24;159
2014;"INACIOLANDIA (GO)";"GO";"INACIOLANDIA";58;7;11;76
2014;"INDIARA (GO)";"GO";"INDIARA";240;14;31;285
2014;"INHUMAS (GO)";"GO";"INHUMAS";1158;71;172;1401
2014;"IPAMERI (GO)";"GO";"IPAMERI";363;77;80;520
2014;"IPIRANGA DE GOIAS (GO)";"GO";"IPIRANGA DE GOIAS";28;8;6;42
2014;"IPORA (GO)";"GO";"IPORA";512;41;58;611
2014;"ISRAELANDIA (GO)";"GO";"ISRAELANDIA";27;4;6;37
2014;"ITABERAI (GO)";"GO";"ITABERAI";808;41;87;936
2014;"ITAGUARI (GO)";"GO";"ITAGUARI";62;8;12;82
2014;"ITAGUARU (GO)";"GO";"ITAGUARU";100;9;12;121
2014;"ITAJA (GO)";"GO";"ITAJA";84;11;19;114
2014;"ITAPACI (GO)";"GO";"ITAPACI";199;23;93;315
2014;"ITAPIRAPUA (GO)";"GO";"ITAPIRAPUA";63;5;13;81
2014;"ITAPURANGA (GO)";"GO";"ITAPURANGA";392;27;72;491
2014;"ITARUMA (GO)";"GO";"ITARUMA";90;20;17;127
2014;"ITAUCU (GO)";"GO";"ITAUCU";124;8;10;142
2014;"ITUMBIARA (GO)";"GO";"ITUMBIARA";2079;234;420;2733
2014;"IVOLANDIA (GO)";"GO";"IVOLANDIA";9;4;1;14
2014;"JANDAIA (GO)";"GO";"JANDAIA";109;8;15;132
2014;"JARAGUA (GO)";"GO";"JARAGUA";431;42;39;512
2014;"JATAI (GO)";"GO";"JATAI";2282;133;236;2651
2014;"JAUPACI (GO)";"GO";"JAUPACI";25;5;8;38
2014;"JESUPOLIS (GO)";"GO";"JESUPOLIS";22;2;7;31
2014;"JOVIANIA (GO)";"GO";"JOVIANIA";133;17;20;170
2014;"JUSSARA (GO)";"GO";"JUSSARA";421;17;22;460
2014;"LAGOA SANTA (GO)";"GO";"LAGOA SANTA";15;3;7;25
2014;"LEOPOLDO DE BULHOES (GO)";"GO";"LEOPOLDO DE BULHOES";159;18;6;183
2014;"LUZIANIA (GO)";"GO";"LUZIANIA";2349;208;498;3055
2014;"MAIRIPOTABA (GO)";"GO";"MAIRIPOTABA";32;6;4;42
2014;"MAMBAI (GO)";"GO";"MAMBAI";74;4;22;100
2014;"MARA ROSA (GO)";"GO";"MARA ROSA";144;9;16;169
2014;"MARZAGAO (GO)";"GO";"MARZAGAO";32;2;3;37
2014;"MATRINCHA (GO)";"GO";"MATRINCHA";38;4;8;50
2014;"MAURILANDIA (GO)";"GO";"MAURILANDIA";389;20;118;527
2014;"MIMOSO DE GOIAS (GO)";"GO";"MIMOSO DE GOIAS";11;5;4;20
2014;"MINACU (GO)";"GO";"MINACU";480;56;45;581
2014;"MINEIROS (GO)";"GO";"MINEIROS";1334;96;170;1600
2014;"MOIPORA (GO)";"GO";"MOIPORA";7;0;2;9
2014;"MONTE ALEGRE DE GOIAS (GO)";"GO";"MONTE ALEGRE DE GOIAS";26;5;7;38
2014;"MONTES CLAROS DE GOIAS (GO)";"GO";"MONTES CLAROS DE GOIAS";87;16;22;125
2014;"MONTIVIDIU (GO)";"GO";"MONTIVIDIU";370;32;74;476
2014;"MONTIVIDIU DO NORTE (GO)";"GO";"MONTIVIDIU DO NORTE";27;2;20;49
2014;"MORRINHOS (GO)";"GO";"MORRINHOS";873;69;133;1075
2014;"MORRO AGUDO DE GOIAS (GO)";"GO";"MORRO AGUDO DE GOIAS";25;5;4;34
2014;"MOSSAMEDES (GO)";"GO";"MOSSAMEDES";40;11;5;56
2014;"MOZARLANDIA (GO)";"GO";"MOZARLANDIA";145;19;43;207
2014;"MUNDO NOVO (GO)";"GO";"MUNDO NOVO";38;6;19;63
2014;"MUTUNOPOLIS (GO)";"GO";"MUTUNOPOLIS";30;3;16;49
2014;"NAZARIO (GO)";"GO";"NAZARIO";115;9;15;139
2014;"NEROPOLIS (GO)";"GO";"NEROPOLIS";578;23;34;635
2014;"NIQUELANDIA (GO)";"GO";"NIQUELANDIA";660;79;159;898
2014;"NOVA AMERICA (GO)";"GO";"NOVA AMERICA";23;0;2;25
2014;"NOVA AURORA (GO)";"GO";"NOVA AURORA";42;6;5;53
2014;"NOVA CRIXAS (GO)";"GO";"NOVA CRIXAS";98;10;39;147
2014;"NOVA GLORIA (GO)";"GO";"NOVA GLORIA";84;9;25;118
2014;"NOVA IGUACU DE GOIAS (GO)";"GO";"NOVA IGUACU DE GOIAS";28;7;7;42
2014;"NOVA ROMA (GO)";"GO";"NOVA ROMA";5;4;6;15
2014;"NOVA VENEZA (GO)";"GO";"NOVA VENEZA";151;14;17;182
2014;"NOVO BRASIL (GO)";"GO";"NOVO BRASIL";26;7;3;36
2014;"NOVO GAMA (GO)";"GO";"NOVO GAMA";389;101;114;604
2014;"NOVO PLANALTO (GO)";"GO";"NOVO PLANALTO";37;11;3;51
2014;"ORIZONA (GO)";"GO";"ORIZONA";228;46;44;318
2014;"OURO VERDE DE GOIAS (GO)";"GO";"OURO VERDE DE GOIAS";98;1;11;110
2014;"OUVIDOR (GO)";"GO";"OUVIDOR";93;6;14;113
2014;"PADRE BERNARDO (GO)";"GO";"PADRE BERNARDO";474;35;91;600
2014;"PALESTINA DE GOIAS (GO)";"GO";"PALESTINA DE GOIAS";22;15;9;46
2014;"PALMEIRAS DE GOIAS (GO)";"GO";"PALMEIRAS DE GOIAS";378;20;108;506
2014;"PALMELO (GO)";"GO";"PALMELO";25;2;5;32
2014;"PALMINOPOLIS (GO)";"GO";"PALMINOPOLIS";55;1;5;61
2014;"PANAMA (GO)";"GO";"PANAMA";59;11;10;80
2014;"PARANAIGUARA (GO)";"GO";"PARANAIGUARA";109;12;18;139
2014;"PARAUNA (GO)";"GO";"PARAUNA";182;19;44;245
2014;"PEROLANDIA (GO)";"GO";"PEROLANDIA";58;8;8;74
2014;"PETROLINA DE GOIAS (GO)";"GO";"PETROLINA DE GOIAS";162;4;21;187
2014;"PILAR DE GOIAS (GO)";"GO";"PILAR DE GOIAS";25;5;8;38
2014;"PIRACANJUBA (GO)";"GO";"PIRACANJUBA";442;37;35;514
2014;"PIRANHAS (GO)";"GO";"PIRANHAS";208;9;43;260
2014;"PIRENOPOLIS (GO)";"GO";"PIRENOPOLIS";284;59;41;384
2014;"PIRES DO RIO (GO)";"GO";"PIRES DO RIO";542;37;45;624
2014;"PLANALTINA (GO)";"GO";"PLANALTINA";718;81;466;1265
2014;"PONTALINA (GO)";"GO";"PONTALINA";288;20;35;343
2014;"PORANGATU (GO)";"GO";"PORANGATU";721;53;79;853
2014;"PORTEIRAO (GO)";"GO";"PORTEIRAO";106;8;12;126
2014;"PORTELANDIA (GO)";"GO";"PORTELANDIA";52;33;5;90
2014;"POSSE (GO)";"GO";"POSSE";651;54;118;823
2014;"PROFESSOR JAMIL (GO)";"GO";"PROFESSOR JAMIL";37;4;6;47
2014;"QUIRINOPOLIS (GO)";"GO";"QUIRINOPOLIS";999;67;242;1308
2014;"RIALMA (GO)";"GO";"RIALMA";298;26;37;361
2014;"RIANAPOLIS (GO)";"GO";"RIANAPOLIS";79;7;8;94
2014;"RIO QUENTE (GO)";"GO";"RIO QUENTE";50;18;55;123
2014;"RIO VERDE (GO)";"GO";"RIO VERDE";3727;361;569;4657
2014;"RUBIATABA (GO)";"GO";"RUBIATABA";342;29;78;449
2014;"SANCLERLANDIA (GO)";"GO";"SANCLERLANDIA";121;11;9;141
2014;"SANTA BARBARA DE GOIAS (GO)";"GO";"SANTA BARBARA DE GOIAS";128;6;7;141
2014;"SANTA CRUZ DE GOIAS (GO)";"GO";"SANTA CRUZ DE GOIAS";10;3;4;17
2014;"SANTA FE DE GOIAS (GO)";"GO";"SANTA FE DE GOIAS";49;8;5;62
2014;"SANTA HELENA DE GOIAS (GO)";"GO";"SANTA HELENA DE GOIAS";948;56;254;1258
2014;"SANTA ISABEL (GO)";"GO";"SANTA ISABEL";10;9;6;25
2014;"SANTA RITA DO ARAGUAIA (GO)";"GO";"SANTA RITA DO ARAGUAIA";139;17;6;162
2014;"SANTA RITA DO NOVO DESTINO (GO)";"GO";"SANTA RITA DO NOVO DESTINO";23;11;10;44
2014;"SANTA ROSA DE GOIAS (GO)";"GO";"SANTA ROSA DE GOIAS";25;3;5;33
2014;"SANTA TEREZA DE GOIAS (GO)";"GO";"SANTA TEREZA DE GOIAS";38;4;6;48
2014;"SANTA TEREZINHA DE GOIAS (GO)";"GO";"SANTA TEREZINHA DE GOIAS";110;11;22;143
2014;"SANTO ANTONIO DA BARRA (GO)";"GO";"SANTO ANTONIO DA BARRA";42;14;21;77
2014;"SANTO ANTONIO DE GOIAS (GO)";"GO";"SANTO ANTONIO DE GOIAS";87;10;20;117
2014;"SANTO ANTONIO DO DESCOBERTO (GO)";"GO";"SANTO ANTONIO DO DESCOBERTO";312;44;197;553
2014;"SAO DOMINGOS (GO)";"GO";"SAO DOMINGOS";44;6;23;73
2014;"SAO FRANCISCO DE GOIAS (GO)";"GO";"SAO FRANCISCO DE GOIAS";53;6;9;68
2014;"SAO JOAO D ALIANCA (GO)";"GO";"SAO JOAO D ALIANCA";125;6;18;149
2014;"SAO JOAO DA PARAUNA (GO)";"GO";"SAO JOAO DA PARAUNA";25;1;3;29
2014;"SAO LUIS DE MONTES BELOS (GO)";"GO";"SAO LUIS DE MONTES BELOS";434;31;88;553
2014;"SAO LUIZ DO NORTE (GO)";"GO";"SAO LUIZ DO NORTE";55;8;17;80
2014;"SAO MIGUEL DO ARAGUAIA (GO)";"GO";"SAO MIGUEL DO ARAGUAIA";334;18;65;417
2014;"SAO MIGUEL DO PASSA QUATRO (GO)";"GO";"SAO MIGUEL DO PASSA QUATRO";55;3;5;63
2014;"SAO PATRICIO (GO)";"GO";"SAO PATRICIO";13;0;4;17
2014;"SAO SIMAO (GO)";"GO";"SAO SIMAO";229;34;64;327
2014;"SENADOR CANEDO (GO)";"GO";"SENADOR CANEDO";866;91;90;1047
2014;"SERRANOPOLIS (GO)";"GO";"SERRANOPOLIS";112;12;23;147
2014;"SILVANIA (GO)";"GO";"SILVANIA";401;41;45;487
2014;"SIMOLANDIA (GO)";"GO";"SIMOLANDIA";132;4;9;145
2014;"SITIO D ABADIA (GO)";"GO";"SITIO D ABADIA";12;1;8;21
2014;"TAQUARAL DE GOIAS (GO)";"GO";"TAQUARAL DE GOIAS";28;6;7;41
2014;"TERESINA DE GOIAS (GO)";"GO";"TERESINA DE GOIAS";15;1;2;18
2014;"TEREZOPOLIS DE GOIAS (GO)";"GO";"TEREZOPOLIS DE GOIAS";99;2;22;123
2014;"TRES RANCHOS (GO)";"GO";"TRES RANCHOS";48;10;5;63
2014;"TRINDADE (GO)";"GO";"TRINDADE";1169;79;129;1377
2014;"TROMBAS (GO)";"GO";"TROMBAS";37;4;13;54
2014;"TURVANIA (GO)";"GO";"TURVANIA";65;3;8;76
2014;"TURVELANDIA (GO)";"GO";"TURVELANDIA";43;7;18;68
2014;"UIRAPURU (GO)";"GO";"UIRAPURU";16;9;7;32
2014;"URUACU (GO)";"GO";"URUACU";619;36;91;746
2014;"URUANA (GO)";"GO";"URUANA";277;6;11;294
2014;"URUTAI (GO)";"GO";"URUTAI";25;2;10;37
2014;"VALPARAISO DE GOIAS (GO)";"GO";"VALPARAISO DE GOIAS";665;210;224;1099
2014;"VARJAO (GO)";"GO";"VARJAO";50;0;8;58
2014;"VIANOPOLIS (GO)";"GO";"VIANOPOLIS";507;31;42;580
2014;"VICENTINOPOLIS (GO)";"GO";"VICENTINOPOLIS";186;13;64;263
2014;"VILA BOA (GO)";"GO";"VILA BOA";21;3;21;45
2014;"VILA PROPICIO (GO)";"GO";"VILA PROPICIO";24;13;24;61
2014;"ACAILANDIA (MA)";"MA";"ACAILANDIA";1352;115;205;1672
2014;"AFONSO CUNHA (MA)";"MA";"AFONSO CUNHA";6;2;5;13
2014;"AGUA DOCE DO MARANHAO (MA)";"MA";"AGUA DOCE DO MARANHAO";3;1;5;9
2014;"ALCANTARA (MA)";"MA";"ALCANTARA";49;14;17;80
2014;"ALDEIAS ALTAS (MA)";"MA";"ALDEIAS ALTAS";46;5;24;75
2014;"ALTAMIRA DO MARANHAO (MA)";"MA";"ALTAMIRA DO MARANHAO";21;3;2;26
2014;"ALTO ALEGRE DO MARANHAO (MA)";"MA";"ALTO ALEGRE DO MARANHAO";50;24;3;77
2014;"ALTO ALEGRE DO PINDARE (MA)";"MA";"ALTO ALEGRE DO PINDARE";40;10;3;53
2014;"ALTO PARNAIBA (MA)";"MA";"ALTO PARNAIBA";68;4;6;78
2014;"AMAPA DO MARANHAO (MA)";"MA";"AMAPA DO MARANHAO";14;2;3;19
2014;"AMARANTE DO MARANHAO (MA)";"MA";"AMARANTE DO MARANHAO";100;5;6;111
2014;"ANAJATUBA (MA)";"MA";"ANAJATUBA";39;4;11;54
2014;"ANAPURUS (MA)";"MA";"ANAPURUS";52;1;18;71
2014;"APICUM ACU (MA)";"MA";"APICUM ACU";15;9;3;27
2014;"ARAGUANA (MA)";"MA";"ARAGUANA";11;0;7;18
2014;"ARAIOSES (MA)";"MA";"ARAIOSES";32;6;27;65
2014;"ARAME (MA)";"MA";"ARAME";103;10;3;116
2014;"ARARI (MA)";"MA";"ARARI";100;8;5;113
2014;"AXIXA (MA)";"MA";"AXIXA";19;6;9;34
2014;"BACABAL (MA)";"MA";"BACABAL";917;87;90;1094
2014;"BACABEIRA (MA)";"MA";"BACABEIRA";110;6;23;139
2014;"BACURI (MA)";"MA";"BACURI";12;7;3;22
2014;"BACURITUBA (MA)";"MA";"BACURITUBA";3;0;5;8
2014;"BALSAS (MA)";"MA";"BALSAS";1688;49;108;1845
2014;"BARAO DE GRAJAU (MA)";"MA";"BARAO DE GRAJAU";75;4;11;90
2014;"BARRA DO CORDA (MA)";"MA";"BARRA DO CORDA";639;24;17;680
2014;"BARREIRINHAS (MA)";"MA";"BARREIRINHAS";84;4;18;106
2014;"BELA VISTA DO MARANHAO (MA)";"MA";"BELA VISTA DO MARANHAO";46;5;4;55
2014;"BELAGUA (MA)";"MA";"BELAGUA";2;6;4;12
2014;"BENEDITO LEITE (MA)";"MA";"BENEDITO LEITE";6;3;1;10
2014;"BEQUIMAO (MA)";"MA";"BEQUIMAO";89;11;12;112
2014;"BERNARDO DO MEARIM (MA)";"MA";"BERNARDO DO MEARIM";35;1;1;37
2014;"BOA VISTA DO GURUPI (MA)";"MA";"BOA VISTA DO GURUPI";6;3;2;11
2014;"BOM JARDIM (MA)";"MA";"BOM JARDIM";116;7;8;131
2014;"BOM JESUS DAS SELVAS (MA)";"MA";"BOM JESUS DAS SELVAS";124;6;6;136
2014;"BOM LUGAR (MA)";"MA";"BOM LUGAR";28;13;16;57
2014;"BREJO (MA)";"MA";"BREJO";74;15;15;104
2014;"BREJO DE AREIA (MA)";"MA";"BREJO DE AREIA";23;3;3;29
2014;"BURITI (MA)";"MA";"BURITI";20;12;19;51
2014;"BURITI BRAVO (MA)";"MA";"BURITI BRAVO";37;2;7;46
2014;"BURITICUPU (MA)";"MA";"BURITICUPU";451;40;17;508
2014;"BURITIRANA (MA)";"MA";"BURITIRANA";24;2;0;26
2014;"CACHOEIRA GRANDE (MA)";"MA";"CACHOEIRA GRANDE";7;2;2;11
2014;"CAJAPIO (MA)";"MA";"CAJAPIO";9;0;2;11
2014;"CAJARI (MA)";"MA";"CAJARI";7;3;4;14
2014;"CAMPESTRE DO MARANHAO (MA)";"MA";"CAMPESTRE DO MARANHAO";24;13;8;45
2014;"CANDIDO MENDES (MA)";"MA";"CANDIDO MENDES";12;6;4;22
2014;"CANTANHEDE (MA)";"MA";"CANTANHEDE";23;3;8;34
2014;"CAPINZAL DO NORTE (MA)";"MA";"CAPINZAL DO NORTE";38;14;2;54
2014;"CAROLINA (MA)";"MA";"CAROLINA";74;3;10;87
2014;"CARUTAPERA (MA)";"MA";"CARUTAPERA";28;14;9;51
2014;"CAXIAS (MA)";"MA";"CAXIAS";865;55;135;1055
2014;"CEDRAL (MA)";"MA";"CEDRAL";10;0;6;16
2014;"CENTRAL DO MARANHAO (MA)";"MA";"CENTRAL DO MARANHAO";11;3;3;17
2014;"CENTRO DO GUILHERME (MA)";"MA";"CENTRO DO GUILHERME";20;0;4;24
2014;"CENTRO NOVO DO MARANHAO (MA)";"MA";"CENTRO NOVO DO MARANHAO";30;2;9;41
2014;"CHAPADINHA (MA)";"MA";"CHAPADINHA";352;35;16;403
2014;"CIDELANDIA (MA)";"MA";"CIDELANDIA";50;8;11;69
2014;"CODO (MA)";"MA";"CODO";622;31;41;694
2014;"COELHO NETO (MA)";"MA";"COELHO NETO";106;17;47;170
2014;"COLINAS (MA)";"MA";"COLINAS";147;15;18;180
2014;"CONCEICAO DO LAGO ACU (MA)";"MA";"CONCEICAO DO LAGO ACU";20;5;1;26
2014;"COROATA (MA)";"MA";"COROATA";203;39;10;252
2014;"CURURUPU (MA)";"MA";"CURURUPU";31;9;8;48
2014;"DAVINOPOLIS (MA)";"MA";"DAVINOPOLIS";56;3;5;64
2014;"DOM PEDRO (MA)";"MA";"DOM PEDRO";439;14;37;490
2014;"DUQUE BACELAR (MA)";"MA";"DUQUE BACELAR";3;1;6;10
2014;"ESPERANTINOPOLIS (MA)";"MA";"ESPERANTINOPOLIS";97;17;1;115
2014;"ESTREITO (MA)";"MA";"ESTREITO";153;15;16;184
2014;"FEIRA NOVA DO MARANHAO (MA)";"MA";"FEIRA NOVA DO MARANHAO";12;0;5;17
2014;"FERNANDO FALCAO (MA)";"MA";"FERNANDO FALCAO";16;0;5;21
2014;"FORMOSA DA SERRA NEGRA (MA)";"MA";"FORMOSA DA SERRA NEGRA";33;4;5;42
2014;"FORTALEZA DOS NOGUEIRAS (MA)";"MA";"FORTALEZA DOS NOGUEIRAS";84;7;8;99
2014;"FORTUNA (MA)";"MA";"FORTUNA";45;14;4;63
2014;"GODOFREDO VIANA (MA)";"MA";"GODOFREDO VIANA";13;9;12;34
2014;"GONCALVES DIAS (MA)";"MA";"GONCALVES DIAS";62;5;8;75
2014;"GOVERNADOR ARCHER (MA)";"MA";"GOVERNADOR ARCHER";32;7;8;47
2014;"GOVERNADOR EDISON LOBAO (MA)";"MA";"GOVERNADOR EDISON LOBAO";78;2;8;88
2014;"GOVERNADOR EUGENIO BARROS (MA)";"MA";"GOVERNADOR EUGENIO BARROS";55;11;19;85
2014;"GOVERNADOR LUIZ ROCHA (MA)";"MA";"GOVERNADOR LUIZ ROCHA";20;3;5;28
2014;"GOVERNADOR NEWTON BELLO (MA)";"MA";"GOVERNADOR NEWTON BELLO";18;1;1;20
2014;"GOVERNADOR NUNES FREIRE (MA)";"MA";"GOVERNADOR NUNES FREIRE";80;7;7;94
2014;"GRACA ARANHA (MA)";"MA";"GRACA ARANHA";16;4;5;25
2014;"GRAJAU (MA)";"MA";"GRAJAU";467;25;39;531
2014;"GUIMARAES (MA)";"MA";"GUIMARAES";16;2;12;30
2014;"HUMBERTO DE CAMPOS (MA)";"MA";"HUMBERTO DE CAMPOS";16;7;6;29
2014;"ICATU (MA)";"MA";"ICATU";23;3;8;34
2014;"IGARAPE DO MEIO (MA)";"MA";"IGARAPE DO MEIO";25;3;8;36
2014;"IGARAPE GRANDE (MA)";"MA";"IGARAPE GRANDE";69;9;7;85
2014;"IMPERATRIZ (MA)";"MA";"IMPERATRIZ";3638;238;404;4280
2014;"ITAIPAVA DO GRAJAU (MA)";"MA";"ITAIPAVA DO GRAJAU";27;5;3;35
2014;"ITAPECURU MIRIM (MA)";"MA";"ITAPECURU MIRIM";380;27;37;444
2014;"ITINGA DO MARANHAO (MA)";"MA";"ITINGA DO MARANHAO";141;6;9;156
2014;"JATOBA (MA)";"MA";"JATOBA";3;2;4;9
2014;"JENIPAPO DOS VIEIRAS (MA)";"MA";"JENIPAPO DOS VIEIRAS";49;2;7;58
2014;"JOAO LISBOA (MA)";"MA";"JOAO LISBOA";123;7;5;135
2014;"JOSELANDIA (MA)";"MA";"JOSELANDIA";60;8;8;76
2014;"JUNCO DO MARANHAO (MA)";"MA";"JUNCO DO MARANHAO";12;15;2;29
2014;"LAGO DA PEDRA (MA)";"MA";"LAGO DA PEDRA";288;47;11;346
2014;"LAGO DO JUNCO (MA)";"MA";"LAGO DO JUNCO";19;2;8;29
2014;"LAGO DOS RODRIGUES (MA)";"MA";"LAGO DOS RODRIGUES";47;11;7;65
2014;"LAGO VERDE (MA)";"MA";"LAGO VERDE";26;0;9;35
2014;"LAGOA DO MATO (MA)";"MA";"LAGOA DO MATO";22;0;10;32
2014;"LAGOA GRANDE DO MARANHAO (MA)";"MA";"LAGOA GRANDE DO MARANHAO";26;1;1;28
2014;"LAJEADO NOVO (MA)";"MA";"LAJEADO NOVO";16;5;2;23
2014;"LIMA CAMPOS (MA)";"MA";"LIMA CAMPOS";86;32;7;125
2014;"LORETO (MA)";"MA";"LORETO";24;3;8;35
2014;"LUIS DOMINGUES (MA)";"MA";"LUIS DOMINGUES";5;3;2;10
2014;"MAGALHAES DE ALMEIDA (MA)";"MA";"MAGALHAES DE ALMEIDA";20;2;8;30
2014;"MARACACUME (MA)";"MA";"MARACACUME";75;45;3;123
2014;"MARAJA DO SENA (MA)";"MA";"MARAJA DO SENA";10;0;1;11
2014;"MARANHAOZINHO (MA)";"MA";"MARANHAOZINHO";37;3;3;43
2014;"MATA ROMA (MA)";"MA";"MATA ROMA";43;8;16;67
2014;"MATINHA (MA)";"MA";"MATINHA";47;8;5;60
2014;"MATOES (MA)";"MA";"MATOES";38;4;21;63
2014;"MATOES DO NORTE (MA)";"MA";"MATOES DO NORTE";21;6;5;32
2014;"MILAGRES DO MARANHAO (MA)";"MA";"MILAGRES DO MARANHAO";7;2;5;14
2014;"MIRADOR (MA)";"MA";"MIRADOR";24;3;3;30
2014;"MIRANDA DO NORTE (MA)";"MA";"MIRANDA DO NORTE";148;8;10;166
2014;"MIRINZAL (MA)";"MA";"MIRINZAL";45;3;6;54
2014;"MONCAO (MA)";"MA";"MONCAO";24;6;8;38
2014;"MONTES ALTOS (MA)";"MA";"MONTES ALTOS";35;0;1;36
2014;"MORROS (MA)";"MA";"MORROS";15;4;4;23
2014;"NINA RODRIGUES (MA)";"MA";"NINA RODRIGUES";8;2;4;14
2014;"NOVA COLINAS (MA)";"MA";"NOVA COLINAS";17;2;10;29
2014;"NOVA IORQUE (MA)";"MA";"NOVA IORQUE";9;1;2;12
2014;"NOVA OLINDA DO MARANHAO (MA)";"MA";"NOVA OLINDA DO MARANHAO";50;16;7;73
2014;"OLHO D AGUA DAS CUNHAS (MA)";"MA";"OLHO D AGUA DAS CUNHAS";81;19;12;112
2014;"OLINDA NOVA DO MARANHAO (MA)";"MA";"OLINDA NOVA DO MARANHAO";33;2;10;45
2014;"PACO DO LUMIAR (MA)";"MA";"PACO DO LUMIAR";431;125;139;695
2014;"PALMEIRANDIA (MA)";"MA";"PALMEIRANDIA";23;2;11;36
2014;"PARAIBANO (MA)";"MA";"PARAIBANO";67;14;5;86
2014;"PARNARAMA (MA)";"MA";"PARNARAMA";46;3;6;55
2014;"PASSAGEM FRANCA (MA)";"MA";"PASSAGEM FRANCA";35;4;7;46
2014;"PASTOS BONS (MA)";"MA";"PASTOS BONS";114;9;8;131
2014;"PAULINO NEVES (MA)";"MA";"PAULINO NEVES";8;1;8;17
2014;"PAULO RAMOS (MA)";"MA";"PAULO RAMOS";82;10;5;97
2014;"PEDREIRAS (MA)";"MA";"PEDREIRAS";385;53;38;476
2014;"PEDRO DO ROSARIO (MA)";"MA";"PEDRO DO ROSARIO";18;1;6;25
2014;"PENALVA (MA)";"MA";"PENALVA";33;2;4;39
2014;"PERI MIRIM (MA)";"MA";"PERI MIRIM";22;7;8;37
2014;"PERITORO (MA)";"MA";"PERITORO";50;64;11;125
2014;"PINDARE MIRIM (MA)";"MA";"PINDARE MIRIM";97;19;16;132
2014;"PINHEIRO (MA)";"MA";"PINHEIRO";462;32;75;569
2014;"PIO XII (MA)";"MA";"PIO XII";108;6;7;121
2014;"PIRAPEMAS (MA)";"MA";"PIRAPEMAS";22;8;3;33
2014;"POCAO DE PEDRAS (MA)";"MA";"POCAO DE PEDRAS";49;17;6;72
2014;"PORTO FRANCO (MA)";"MA";"PORTO FRANCO";93;22;10;125
2014;"PORTO RICO DO MARANHAO (MA)";"MA";"PORTO RICO DO MARANHAO";4;1;3;8
2014;"PRESIDENTE DUTRA (MA)";"MA";"PRESIDENTE DUTRA";449;25;28;502
2014;"PRESIDENTE JUSCELINO (MA)";"MA";"PRESIDENTE JUSCELINO";7;2;3;12
2014;"PRESIDENTE MEDICI (MA)";"MA";"PRESIDENTE MEDICI";15;6;3;24
2014;"PRESIDENTE SARNEY (MA)";"MA";"PRESIDENTE SARNEY";10;8;4;22
2014;"PRESIDENTE VARGAS (MA)";"MA";"PRESIDENTE VARGAS";21;6;5;32
2014;"PRIMEIRA CRUZ (MA)";"MA";"PRIMEIRA CRUZ";2;1;1;4
2014;"RAPOSA (MA)";"MA";"RAPOSA";104;6;56;166
2014;"RIACHAO (MA)";"MA";"RIACHAO";73;9;19;101
2014;"RIBAMAR FIQUENE (MA)";"MA";"RIBAMAR FIQUENE";17;3;4;24
2014;"ROSARIO (MA)";"MA";"ROSARIO";220;29;49;298
2014;"SAMBAIBA (MA)";"MA";"SAMBAIBA";25;5;2;32
2014;"SANTA FILOMENA DO MARANHAO (MA)";"MA";"SANTA FILOMENA DO MARANHAO";8;7;4;19
2014;"SANTA HELENA (MA)";"MA";"SANTA HELENA";105;7;7;119
2014;"SANTA INES (MA)";"MA";"SANTA INES";820;176;110;1106
2014;"SANTA LUZIA (MA)";"MA";"SANTA LUZIA";277;94;14;385
2014;"SANTA LUZIA DO PARUA (MA)";"MA";"SANTA LUZIA DO PARUA";143;14;10;167
2014;"SANTA QUITERIA DO MARANHAO (MA)";"MA";"SANTA QUITERIA DO MARANHAO";39;3;14;56
2014;"SANTA RITA (MA)";"MA";"SANTA RITA";164;10;16;190
2014;"SANTANA DO MARANHAO (MA)";"MA";"SANTANA DO MARANHAO";12;1;5;18
2014;"SANTO AMARO DO MARANHAO (MA)";"MA";"SANTO AMARO DO MARANHAO";2;4;2;8
2014;"SANTO ANTONIO DOS LOPES (MA)";"MA";"SANTO ANTONIO DOS LOPES";103;8;9;120
2014;"SAO BENEDITO DO RIO PRETO (MA)";"MA";"SAO BENEDITO DO RIO PRETO";13;8;3;24
2014;"SAO BENTO (MA)";"MA";"SAO BENTO";152;36;18;206
2014;"SAO BERNARDO (MA)";"MA";"SAO BERNARDO";87;6;18;111
2014;"SAO DOMINGOS DO AZEITAO (MA)";"MA";"SAO DOMINGOS DO AZEITAO";44;2;1;47
2014;"SAO DOMINGOS DO MARANHAO (MA)";"MA";"SAO DOMINGOS DO MARANHAO";195;2;11;208
2014;"SAO FELIX DE BALSAS (MA)";"MA";"SAO FELIX DE BALSAS";5;0;1;6
2014;"SAO FRANCISCO DO BREJAO (MA)";"MA";"SAO FRANCISCO DO BREJAO";54;2;2;58
2014;"SAO FRANCISCO DO MARANHAO (MA)";"MA";"SAO FRANCISCO DO MARANHAO";11;0;2;13
2014;"SAO JOAO BATISTA (MA)";"MA";"SAO JOAO BATISTA";33;6;11;50
2014;"SAO JOAO DO CARU (MA)";"MA";"SAO JOAO DO CARU";30;1;1;32
2014;"SAO JOAO DO PARAISO (MA)";"MA";"SAO JOAO DO PARAISO";15;5;4;24
2014;"SAO JOAO DO SOTER (MA)";"MA";"SAO JOAO DO SOTER";28;1;5;34
2014;"SAO JOAO DOS PATOS (MA)";"MA";"SAO JOAO DOS PATOS";191;8;5;204
2014;"SAO JOSE DE RIBAMAR (MA)";"MA";"SAO JOSE DE RIBAMAR";769;155;234;1158
2014;"SAO JOSE DOS BASILIOS (MA)";"MA";"SAO JOSE DOS BASILIOS";15;3;2;20
2014;"SAO LUIS (MA)";"MA";"SAO LUIS";9416;1414;3962;14792
2014;"SAO LUIS GONZAGA DO MARANHAO (MA)";"MA";"SAO LUIS GONZAGA DO MARANHAO";35;10;9;54
2014;"SAO MATEUS DO MARANHAO (MA)";"MA";"SAO MATEUS DO MARANHAO";126;40;20;186
2014;"SAO PEDRO DA AGUA BRANCA (MA)";"MA";"SAO PEDRO DA AGUA BRANCA";16;6;4;26
2014;"SAO PEDRO DOS CRENTES (MA)";"MA";"SAO PEDRO DOS CRENTES";27;0;8;35
2014;"SAO RAIMUNDO DAS MANGABEIRAS (MA)";"MA";"SAO RAIMUNDO DAS MANGABEIRAS";146;9;48;203
2014;"SAO RAIMUNDO DO DOCA BEZERRA (MA)";"MA";"SAO RAIMUNDO DO DOCA BEZERRA";13;0;1;14
2014;"SAO ROBERTO (MA)";"MA";"SAO ROBERTO";18;5;3;26
2014;"SAO VICENTE FERRER (MA)";"MA";"SAO VICENTE FERRER";29;2;5;36
2014;"SATUBINHA (MA)";"MA";"SATUBINHA";15;5;2;22
2014;"SENADOR ALEXANDRE COSTA (MA)";"MA";"SENADOR ALEXANDRE COSTA";28;7;5;40
2014;"SENADOR LA ROCQUE (MA)";"MA";"SENADOR LA ROCQUE";68;0;3;71
2014;"SERRANO DO MARANHAO (MA)";"MA";"SERRANO DO MARANHAO";4;0;4;8
2014;"SITIO NOVO (MA)";"MA";"SITIO NOVO";64;5;6;75
2014;"SUCUPIRA DO NORTE (MA)";"MA";"SUCUPIRA DO NORTE";22;3;5;30
2014;"SUCUPIRA DO RIACHAO (MA)";"MA";"SUCUPIRA DO RIACHAO";8;6;3;17
2014;"TASSO FRAGOSO (MA)";"MA";"TASSO FRAGOSO";79;3;6;88
2014;"TIMBIRAS (MA)";"MA";"TIMBIRAS";38;4;3;45
2014;"TIMON (MA)";"MA";"TIMON";649;44;100;793
2014;"TRIZIDELA DO VALE (MA)";"MA";"TRIZIDELA DO VALE";147;22;9;178
2014;"TUFILANDIA (MA)";"MA";"TUFILANDIA";9;6;1;16
2014;"TUNTUM (MA)";"MA";"TUNTUM";127;7;16;150
2014;"TURIACU (MA)";"MA";"TURIACU";37;3;4;44
2014;"TURILANDIA (MA)";"MA";"TURILANDIA";14;4;2;20
2014;"TUTOIA (MA)";"MA";"TUTOIA";81;14;9;104
2014;"URBANO SANTOS (MA)";"MA";"URBANO SANTOS";66;7;14;87
2014;"VARGEM GRANDE (MA)";"MA";"VARGEM GRANDE";124;8;13;145
2014;"VIANA (MA)";"MA";"VIANA";210;9;5;224
2014;"VILA NOVA DOS MARTIRIOS (MA)";"MA";"VILA NOVA DOS MARTIRIOS";35;5;3;43
2014;"VITORIA DO MEARIM (MA)";"MA";"VITORIA DO MEARIM";96;10;10;116
2014;"VITORINO FREIRE (MA)";"MA";"VITORINO FREIRE";125;11;9;145
2014;"ZE DOCA (MA)";"MA";"ZE DOCA";235;25;28;288
2014;"ABADIA DOS DOURADOS (MG)";"MG";"ABADIA DOS DOURADOS";144;32;13;189
2014;"ABAETE (MG)";"MG";"ABAETE";481;35;173;689
2014;"ABRE CAMPO (MG)";"MG";"ABRE CAMPO";214;15;52;281
2014;"ACAIACA (MG)";"MG";"ACAIACA";30;10;10;50
2014;"ACUCENA (MG)";"MG";"ACUCENA";43;15;36;94
2014;"AGUA BOA (MG)";"MG";"AGUA BOA";70;9;34;113
2014;"AGUA COMPRIDA (MG)";"MG";"AGUA COMPRIDA";36;11;9;56
2014;"AGUANIL (MG)";"MG";"AGUANIL";64;6;12;82
2014;"AGUAS FORMOSAS (MG)";"MG";"AGUAS FORMOSAS";109;25;41;175
2014;"AGUAS VERMELHAS (MG)";"MG";"AGUAS VERMELHAS";85;20;24;129
2014;"AIMORES (MG)";"MG";"AIMORES";206;39;42;287
2014;"AIURUOCA (MG)";"MG";"AIURUOCA";109;22;10;141
2014;"ALAGOA (MG)";"MG";"ALAGOA";27;4;19;50
2014;"ALBERTINA (MG)";"MG";"ALBERTINA";49;17;7;73
2014;"ALEM PARAIBA (MG)";"MG";"ALEM PARAIBA";1305;108;76;1489
2014;"ALFENAS (MG)";"MG";"ALFENAS";1292;142;363;1797
2014;"ALFREDO VASCONCELOS (MG)";"MG";"ALFREDO VASCONCELOS";160;13;21;194
2014;"ALMENARA (MG)";"MG";"ALMENARA";286;80;118;484
2014;"ALPERCATA (MG)";"MG";"ALPERCATA";71;4;8;83
2014;"ALPINOPOLIS (MG)";"MG";"ALPINOPOLIS";452;48;63;563
2014;"ALTEROSA (MG)";"MG";"ALTEROSA";245;33;59;337
2014;"ALTO CAPARAO (MG)";"MG";"ALTO CAPARAO";79;15;14;108
2014;"ALTO JEQUITIBA (MG)";"MG";"ALTO JEQUITIBA";100;11;17;128
2014;"ALTO RIO DOCE (MG)";"MG";"ALTO RIO DOCE";120;38;31;189
2014;"ALVARENGA (MG)";"MG";"ALVARENGA";34;4;16;54
2014;"ALVINOPOLIS (MG)";"MG";"ALVINOPOLIS";206;19;22;247
2014;"ALVORADA DE MINAS (MG)";"MG";"ALVORADA DE MINAS";25;16;20;61
2014;"AMPARO DA SERRA (MG)";"MG";"AMPARO DA SERRA";40;8;33;81
2014;"ANDRADAS (MG)";"MG";"ANDRADAS";1116;93;109;1318
2014;"ANDRELANDIA (MG)";"MG";"ANDRELANDIA";160;43;23;226
2014;"ANGELANDIA (MG)";"MG";"ANGELANDIA";77;11;33;121
2014;"ANTONIO CARLOS (MG)";"MG";"ANTONIO CARLOS";180;29;44;253
2014;"ANTONIO DIAS (MG)";"MG";"ANTONIO DIAS";118;14;52;184
2014;"ANTONIO PRADO DE MINAS (MG)";"MG";"ANTONIO PRADO DE MINAS";16;4;5;25
2014;"ARACAI (MG)";"MG";"ARACAI";17;8;8;33
2014;"ARACITABA (MG)";"MG";"ARACITABA";13;2;3;18
2014;"ARACUAI (MG)";"MG";"ARACUAI";259;21;103;383
2014;"ARAGUARI (MG)";"MG";"ARAGUARI";2523;370;177;3070
2014;"ARANTINA (MG)";"MG";"ARANTINA";38;2;4;44
2014;"ARAPONGA (MG)";"MG";"ARAPONGA";65;8;12;85
2014;"ARAPORA (MG)";"MG";"ARAPORA";198;17;64;279
2014;"ARAPUA (MG)";"MG";"ARAPUA";44;4;12;60
2014;"ARAUJOS (MG)";"MG";"ARAUJOS";148;15;9;172
2014;"ARAXA (MG)";"MG";"ARAXA";1904;199;343;2446
2014;"ARCEBURGO (MG)";"MG";"ARCEBURGO";136;25;59;220
2014;"ARCOS (MG)";"MG";"ARCOS";1198;106;293;1597
2014;"AREADO (MG)";"MG";"AREADO";239;26;80;345
2014;"ARGIRITA (MG)";"MG";"ARGIRITA";24;6;9;39
2014;"ARICANDUVA (MG)";"MG";"ARICANDUVA";25;6;15;46
2014;"ARINOS (MG)";"MG";"ARINOS";326;32;107;465
2014;"ASTOLFO DUTRA (MG)";"MG";"ASTOLFO DUTRA";261;8;28;297
2014;"ATALEIA (MG)";"MG";"ATALEIA";100;25;34;159
2014;"AUGUSTO DE LIMA (MG)";"MG";"AUGUSTO DE LIMA";33;6;22;61
2014;"BAEPENDI (MG)";"MG";"BAEPENDI";384;65;37;486
2014;"BALDIM (MG)";"MG";"BALDIM";185;14;20;219
2014;"BAMBUI (MG)";"MG";"BAMBUI";534;48;81;663
2014;"BANDEIRA (MG)";"MG";"BANDEIRA";14;7;11;32
2014;"BANDEIRA DO SUL (MG)";"MG";"BANDEIRA DO SUL";128;33;10;171
2014;"BARAO DE COCAIS (MG)";"MG";"BARAO DE COCAIS";539;107;94;740
2014;"BARAO D0 MONTE ALTO (MG)";"MG";"BARAO D0 MONTE ALTO";55;8;11;74
2014;"BARBACENA (MG)";"MG";"BARBACENA";1816;328;266;2410
2014;"BARRA LONGA (MG)";"MG";"BARRA LONGA";45;6;12;63
2014;"BARROSO (MG)";"MG";"BARROSO";433;34;38;505
2014;"BELA VISTA DE MINAS (MG)";"MG";"BELA VISTA DE MINAS";166;16;10;192
2014;"BELMIRO BRAGA (MG)";"MG";"BELMIRO BRAGA";72;14;7;93
2014;"BELO HORIZONTE (MG)";"MG";"BELO HORIZONTE";36283;6201;8989;51473
2014;"BELO ORIENTE (MG)";"MG";"BELO ORIENTE";251;27;97;375
2014;"BELO VALE (MG)";"MG";"BELO VALE";210;25;37;272
2014;"BERILO (MG)";"MG";"BERILO";74;5;31;110
2014;"BERIZAL (MG)";"MG";"BERIZAL";30;6;8;44
2014;"BERTOPOLIS (MG)";"MG";"BERTOPOLIS";15;4;4;23
2014;"BETIM (MG)";"MG";"BETIM";5911;688;1500;8099
2014;"BIAS FORTES (MG)";"MG";"BIAS FORTES";26;5;6;37
2014;"BICAS (MG)";"MG";"BICAS";227;35;43;305
2014;"BIQUINHAS (MG)";"MG";"BIQUINHAS";58;9;4;71
2014;"BOA ESPERANCA (MG)";"MG";"BOA ESPERANCA";797;111;211;1119
2014;"BOCAINA DE MINAS (MG)";"MG";"BOCAINA DE MINAS";79;17;11;107
2014;"BOCAIUVA (MG)";"MG";"BOCAIUVA";520;67;170;757
2014;"BOM DESPACHO (MG)";"MG";"BOM DESPACHO";1077;94;453;1624
2014;"BOM JARDIM DE MINAS (MG)";"MG";"BOM JARDIM DE MINAS";125;16;18;159
2014;"BOM JESUS DA PENHA (MG)";"MG";"BOM JESUS DA PENHA";121;17;18;156
2014;"BOM JESUS DO AMPARO (MG)";"MG";"BOM JESUS DO AMPARO";85;9;13;107
2014;"BOM JESUS DO GALHO (MG)";"MG";"BOM JESUS DO GALHO";108;7;24;139
2014;"BOM REPOUSO (MG)";"MG";"BOM REPOUSO";203;19;13;235
2014;"BOM SUCESSO (MG)";"MG";"BOM SUCESSO";222;31;57;310
2014;"BONFIM (MG)";"MG";"BONFIM";149;20;22;191
2014;"BONFINOPOLIS DE MINAS (MG)";"MG";"BONFINOPOLIS DE MINAS";87;3;31;121
2014;"BONITO DE MINAS (MG)";"MG";"BONITO DE MINAS";29;3;28;60
2014;"BORDA DA MATA (MG)";"MG";"BORDA DA MATA";297;44;86;427
2014;"BOTELHOS (MG)";"MG";"BOTELHOS";248;76;47;371
2014;"BOTUMIRIM (MG)";"MG";"BOTUMIRIM";38;6;19;63
2014;"BRAS PIRES (MG)";"MG";"BRAS PIRES";51;11;8;70
2014;"BRASILANDIA DE MINAS (MG)";"MG";"BRASILANDIA DE MINAS";213;26;100;339
2014;"BRASILIA DE MINAS (MG)";"MG";"BRASILIA DE MINAS";315;18;83;416
2014;"BRASOPOLIS (MG)";"MG";"BRASOPOLIS";207;40;36;283
2014;"BRAUNAS (MG)";"MG";"BRAUNAS";19;10;21;50
2014;"BRUMADINHO (MG)";"MG";"BRUMADINHO";962;128;248;1338
2014;"BUENO BRANDAO (MG)";"MG";"BUENO BRANDAO";213;49;22;284
2014;"BUENOPOLIS (MG)";"MG";"BUENOPOLIS";106;12;28;146
2014;"BUGRE (MG)";"MG";"BUGRE";22;3;6;31
2014;"BURITIS (MG)";"MG";"BURITIS";294;13;102;409
2014;"BURITIZEIRO (MG)";"MG";"BURITIZEIRO";264;31;112;407
2014;"CABECEIRA GRANDE (MG)";"MG";"CABECEIRA GRANDE";61;2;11;74
2014;"CABO VERDE (MG)";"MG";"CABO VERDE";169;45;44;258
2014;"CACHOEIRA DA PRATA (MG)";"MG";"CACHOEIRA DA PRATA";59;2;6;67
2014;"CACHOEIRA DE MINAS (MG)";"MG";"CACHOEIRA DE MINAS";139;26;18;183
2014;"CACHOEIRA DE PAJEU (MG)";"MG";"CACHOEIRA DE PAJEU";45;15;22;82
2014;"CACHOEIRA DOURADA (MG)";"MG";"CACHOEIRA DOURADA";16;10;3;29
2014;"CAETANOPOLIS (MG)";"MG";"CAETANOPOLIS";151;19;49;219
2014;"CAETE (MG)";"MG";"CAETE";556;106;60;722
2014;"CAIANA (MG)";"MG";"CAIANA";49;13;13;75
2014;"CAJURI (MG)";"MG";"CAJURI";57;9;12;78
2014;"CALDAS (MG)";"MG";"CALDAS";313;37;32;382
2014;"CAMACHO (MG)";"MG";"CAMACHO";51;10;16;77
2014;"CAMANDUCAIA (MG)";"MG";"CAMANDUCAIA";508;50;52;610
2014;"CAMBUI (MG)";"MG";"CAMBUI";613;73;110;796
2014;"CAMBUQUIRA (MG)";"MG";"CAMBUQUIRA";148;36;31;215
2014;"CAMPANARIO (MG)";"MG";"CAMPANARIO";16;4;4;24
2014;"CAMPANHA (MG)";"MG";"CAMPANHA";262;60;46;368
2014;"CAMPESTRE (MG)";"MG";"CAMPESTRE";515;59;62;636
2014;"CAMPINA VERDE (MG)";"MG";"CAMPINA VERDE";278;42;55;375
2014;"CAMPO AZUL (MG)";"MG";"CAMPO AZUL";9;3;7;19
2014;"CAMPO BELO (MG)";"MG";"CAMPO BELO";1280;94;129;1503
2014;"CAMPO DO MEIO (MG)";"MG";"CAMPO DO MEIO";125;27;78;230
2014;"CAMPO FLORIDO (MG)";"MG";"CAMPO FLORIDO";184;33;85;302
2014;"CAMPOS ALTOS (MG)";"MG";"CAMPOS ALTOS";350;36;105;491
2014;"CAMPOS GERAIS (MG)";"MG";"CAMPOS GERAIS";348;36;133;517
2014;"CANA VERDE (MG)";"MG";"CANA VERDE";72;9;15;96
2014;"CANAA (MG)";"MG";"CANAA";62;6;10;78
2014;"CANAPOLIS (MG)";"MG";"CANAPOLIS";229;13;95;337
2014;"CANDEIAS (MG)";"MG";"CANDEIAS";266;36;35;337
2014;"CANTAGALO (MG)";"MG";"CANTAGALO";22;5;8;35
2014;"CAPARAO (MG)";"MG";"CAPARAO";75;7;13;95
2014;"CAPELA NOVA (MG)";"MG";"CAPELA NOVA";22;13;3;38
2014;"CAPELINHA (MG)";"MG";"CAPELINHA";751;48;173;972
2014;"CAPETINGA (MG)";"MG";"CAPETINGA";167;24;38;229
2014;"CAPIM BRANCO (MG)";"MG";"CAPIM BRANCO";94;20;10;124
2014;"CAPINOPOLIS (MG)";"MG";"CAPINOPOLIS";277;32;74;383
2014;"CAPITAO ANDRADE (MG)";"MG";"CAPITAO ANDRADE";52;6;6;64
2014;"CAPITAO ENEAS (MG)";"MG";"CAPITAO ENEAS";86;4;31;121
2014;"CAPITOLIO (MG)";"MG";"CAPITOLIO";179;22;25;226
2014;"CAPUTIRA (MG)";"MG";"CAPUTIRA";142;8;50;200
2014;"CARAI (MG)";"MG";"CARAI";77;47;52;176
2014;"CARANAIBA (MG)";"MG";"CARANAIBA";24;12;15;51
2014;"CARANDAI (MG)";"MG";"CARANDAI";589;62;106;757
2014;"CARANGOLA (MG)";"MG";"CARANGOLA";419;59;60;538
2014;"CARATINGA (MG)";"MG";"CARATINGA";1310;86;503;1899
2014;"CARBONITA (MG)";"MG";"CARBONITA";163;24;39;226
2014;"CAREACU (MG)";"MG";"CAREACU";130;12;10;152
2014;"CARLOS CHAGAS (MG)";"MG";"CARLOS CHAGAS";163;41;53;257
2014;"CARMESIA (MG)";"MG";"CARMESIA";71;3;1549;1623
2014;"CARMO DA CACHOEIRA (MG)";"MG";"CARMO DA CACHOEIRA";175;41;60;276
2014;"CARMO DA MATA (MG)";"MG";"CARMO DA MATA";137;38;47;222
2014;"CARMO DE MINAS (MG)";"MG";"CARMO DE MINAS";145;49;28;222
2014;"CARMO DO CAJURU (MG)";"MG";"CARMO DO CAJURU";412;63;91;566
2014;"CARMO DO PARANAIBA (MG)";"MG";"CARMO DO PARANAIBA";696;76;125;897
2014;"CARMO DO RIO CLARO (MG)";"MG";"CARMO DO RIO CLARO";380;38;101;519
2014;"CARMOPOLIS DE MINAS (MG)";"MG";"CARMOPOLIS DE MINAS";489;61;47;597
2014;"CARNEIRINHO (MG)";"MG";"CARNEIRINHO";194;20;67;281
2014;"CARRANCAS (MG)";"MG";"CARRANCAS";53;10;12;75
2014;"CARVALHOPOLIS (MG)";"MG";"CARVALHOPOLIS";46;10;8;64
2014;"CARVALHOS (MG)";"MG";"CARVALHOS";75;8;8;91
2014;"CASA GRANDE (MG)";"MG";"CASA GRANDE";41;5;5;51
2014;"CASCALHO RICO (MG)";"MG";"CASCALHO RICO";49;30;4;83
2014;"CASSIA (MG)";"MG";"CASSIA";405;51;68;524
2014;"CATAGUASES (MG)";"MG";"CATAGUASES";734;92;174;1000
2014;"CATAS ALTAS (MG)";"MG";"CATAS ALTAS";160;20;10;190
2014;"CATAS ALTAS DA NORUEGA (MG)";"MG";"CATAS ALTAS DA NORUEGA";46;5;11;62
2014;"CATUJI (MG)";"MG";"CATUJI";47;20;16;83
2014;"CATUTI (MG)";"MG";"CATUTI";35;6;22;63
2014;"CAXAMBU (MG)";"MG";"CAXAMBU";212;40;24;276
2014;"CEDRO DO ABAETE (MG)";"MG";"CEDRO DO ABAETE";12;2;3;17
2014;"CENTRAL DE MINAS (MG)";"MG";"CENTRAL DE MINAS";85;10;18;113
2014;"CENTRALINA (MG)";"MG";"CENTRALINA";107;6;17;130
2014;"CHACARA (MG)";"MG";"CHACARA";37;5;13;55
2014;"CHALE (MG)";"MG";"CHALE";72;11;17;100
2014;"CHAPADA DO NORTE (MG)";"MG";"CHAPADA DO NORTE";47;25;28;100
2014;"CHAPADA GAUCHA (MG)";"MG";"CHAPADA GAUCHA";118;7;38;163
2014;"CHIADOR (MG)";"MG";"CHIADOR";85;10;11;106
2014;"CIPOTANEA (MG)";"MG";"CIPOTANEA";59;6;17;82
2014;"CLARAVAL (MG)";"MG";"CLARAVAL";115;9;23;147
2014;"CLARO DOS POCOES (MG)";"MG";"CLARO DOS POCOES";60;10;33;103
2014;"CLAUDIO (MG)";"MG";"CLAUDIO";769;45;60;874
2014;"COIMBRA (MG)";"MG";"COIMBRA";135;7;12;154
2014;"COLUNA (MG)";"MG";"COLUNA";66;4;15;85
2014;"COMENDADOR GOMES (MG)";"MG";"COMENDADOR GOMES";50;9;15;74
2014;"COMERCINHO (MG)";"MG";"COMERCINHO";29;10;18;57
2014;"CONCEICAO DA APARECIDA (MG)";"MG";"CONCEICAO DA APARECIDA";165;16;26;207
2014;"CONCEICAO DA BARRA DE MINAS (MG)";"MG";"CONCEICAO DA BARRA DE MINAS";40;13;9;62
2014;"CONCEICAO DAS ALAGOAS (MG)";"MG";"CONCEICAO DAS ALAGOAS";544;57;114;715
2014;"CONCEICAO DAS PEDRAS (MG)";"MG";"CONCEICAO DAS PEDRAS";26;8;7;41
2014;"CONCEICAO DE IPANEMA (MG)";"MG";"CONCEICAO DE IPANEMA";45;8;6;59
2014;"CONCEICAO DO MATO DENTRO (MG)";"MG";"CONCEICAO DO MATO DENTRO";168;57;215;440
2014;"CONCEICAO DO PARA (MG)";"MG";"CONCEICAO DO PARA";78;17;17;112
2014;"CONCEICAO DO RIO VERDE (MG)";"MG";"CONCEICAO DO RIO VERDE";193;52;34;279
2014;"CONCEICAO DOS OUROS (MG)";"MG";"CONCEICAO DOS OUROS";290;31;18;339
2014;"CONEGO MARINHO (MG)";"MG";"CONEGO MARINHO";26;5;21;52
2014;"CONFINS (MG)";"MG";"CONFINS";138;20;26;184
2014;"CONGONHAL (MG)";"MG";"CONGONHAL";270;11;15;296
2014;"CONGONHAS (MG)";"MG";"CONGONHAS";1124;175;140;1439
2014;"CONGONHAS DO NORTE (MG)";"MG";"CONGONHAS DO NORTE";51;9;9;69
2014;"CONQUISTA (MG)";"MG";"CONQUISTA";167;25;40;232
2014;"CONSELHEIRO LAFAIETE (MG)";"MG";"CONSELHEIRO LAFAIETE";1549;372;721;2642
2014;"CONSELHEIRO PENA (MG)";"MG";"CONSELHEIRO PENA";212;5;65;282
2014;"CONSOLACAO (MG)";"MG";"CONSOLACAO";17;10;3;30
2014;"CONTAGEM (MG)";"MG";"CONTAGEM";14715;1634;2968;19317
2014;"COQUEIRAL (MG)";"MG";"COQUEIRAL";117;20;26;163
2014;"CORACAO DE JESUS (MG)";"MG";"CORACAO DE JESUS";192;9;106;307
2014;"CORDISBURGO (MG)";"MG";"CORDISBURGO";100;17;16;133
2014;"CORDISLANDIA (MG)";"MG";"CORDISLANDIA";43;11;8;62
2014;"CORINTO (MG)";"MG";"CORINTO";338;30;84;452
2014;"COROACI (MG)";"MG";"COROACI";71;9;14;94
2014;"COROMANDEL (MG)";"MG";"COROMANDEL";625;101;96;822
2014;"CORONEL FABRICIANO (MG)";"MG";"CORONEL FABRICIANO";1270;209;601;2080
2014;"CORONEL MURTA (MG)";"MG";"CORONEL MURTA";34;6;15;55
2014;"CORONEL PACHECO (MG)";"MG";"CORONEL PACHECO";36;5;8;49
2014;"CORONEL XAVIER CHAVES (MG)";"MG";"CORONEL XAVIER CHAVES";90;9;4;103
2014;"CORREGO DANTA (MG)";"MG";"CORREGO DANTA";44;5;15;64
2014;"CORREGO DO BOM JESUS (MG)";"MG";"CORREGO DO BOM JESUS";40;10;12;62
2014;"CORREGO FUNDO (MG)";"MG";"CORREGO FUNDO";360;19;20;399
2014;"CORREGO NOVO (MG)";"MG";"CORREGO NOVO";14;4;9;27
2014;"COUTO DE MAGALHAES DE MINAS (MG)";"MG";"COUTO DE MAGALHAES DE MINAS";57;2;12;71
2014;"CRISOLITA (MG)";"MG";"CRISOLITA";14;20;18;52
2014;"CRISTAIS (MG)";"MG";"CRISTAIS";154;29;33;216
2014;"CRISTALIA (MG)";"MG";"CRISTALIA";28;7;25;60
2014;"CRISTIANO OTONI (MG)";"MG";"CRISTIANO OTONI";94;19;10;123
2014;"CRISTINA (MG)";"MG";"CRISTINA";110;27;15;152
2014;"CRUCILANDIA (MG)";"MG";"CRUCILANDIA";164;9;14;187
2014;"CRUZEIRO DA FORTALEZA (MG)";"MG";"CRUZEIRO DA FORTALEZA";90;7;16;113
2014;"CRUZILIA (MG)";"MG";"CRUZILIA";357;42;40;439
2014;"CUPARAQUE (MG)";"MG";"CUPARAQUE";50;10;5;65
2014;"CURRAL DE DENTRO (MG)";"MG";"CURRAL DE DENTRO";61;12;16;89
2014;"CURVELO (MG)";"MG";"CURVELO";1238;65;1868;3171
2014;"DATAS (MG)";"MG";"DATAS";36;4;15;55
2014;"DELFIM MOREIRA (MG)";"MG";"DELFIM MOREIRA";88;10;25;123
2014;"DELFINOPOLIS (MG)";"MG";"DELFINOPOLIS";103;19;14;136
2014;"DELTA (MG)";"MG";"DELTA";461;39;138;638
2014;"DESCOBERTO (MG)";"MG";"DESCOBERTO";44;9;3;56
2014;"DESTERRO DE ENTRE RIOS (MG)";"MG";"DESTERRO DE ENTRE RIOS";105;24;21;150
2014;"DESTERRO DO MELO (MG)";"MG";"DESTERRO DO MELO";39;9;18;66
2014;"DIAMANTINA (MG)";"MG";"DIAMANTINA";422;90;346;858
2014;"DIOGO DE VASCONCELOS (MG)";"MG";"DIOGO DE VASCONCELOS";21;6;11;38
2014;"DIONISIO (MG)";"MG";"DIONISIO";42;6;17;65
2014;"DIVINESIA (MG)";"MG";"DIVINESIA";86;6;14;106
2014;"DIVINO (MG)";"MG";"DIVINO";257;20;56;333
2014;"DIVINO DAS LARANJEIRAS (MG)";"MG";"DIVINO DAS LARANJEIRAS";43;1;6;50
2014;"DIVINOLANDIA DE MINAS (MG)";"MG";"DIVINOLANDIA DE MINAS";78;5;17;100
2014;"DIVINOPOLIS (MG)";"MG";"DIVINOPOLIS";3369;251;761;4381
2014;"DIVISA ALEGRE (MG)";"MG";"DIVISA ALEGRE";52;5;9;66
2014;"DIVISA NOVA (MG)";"MG";"DIVISA NOVA";83;27;33;143
2014;"DIVISOPOLIS (MG)";"MG";"DIVISOPOLIS";48;13;13;74
2014;"DOM BOSCO (MG)";"MG";"DOM BOSCO";25;6;12;43
2014;"DOM CAVATI (MG)";"MG";"DOM CAVATI";175;7;11;193
2014;"DOM JOAQUIM (MG)";"MG";"DOM JOAQUIM";29;6;12;47
2014;"DOM SILVERIO (MG)";"MG";"DOM SILVERIO";70;10;9;89
2014;"DOM VICOSO (MG)";"MG";"DOM VICOSO";32;13;12;57
2014;"DONA EUZEBIA (MG)";"MG";"DONA EUZEBIA";305;3;6;314
2014;"DORES DE CAMPOS (MG)";"MG";"DORES DE CAMPOS";113;24;39;176
2014;"DORES DE GUANHAES (MG)";"MG";"DORES DE GUANHAES";38;7;23;68
2014;"DORES DO INDAIA (MG)";"MG";"DORES DO INDAIA";255;41;17;313
2014;"DORES DO TURVO (MG)";"MG";"DORES DO TURVO";51;6;16;73
2014;"DORESOPOLIS (MG)";"MG";"DORESOPOLIS";19;7;6;32
2014;"DOURADOQUARA (MG)";"MG";"DOURADOQUARA";21;9;2;32
2014;"DURANDE (MG)";"MG";"DURANDE";102;9;21;132
2014;"ELOI MENDES (MG)";"MG";"ELOI MENDES";522;78;56;656
2014;"ENGENHEIRO CALDAS (MG)";"MG";"ENGENHEIRO CALDAS";158;8;15;181
2014;"ENGENHEIRO NAVARRO (MG)";"MG";"ENGENHEIRO NAVARRO";66;3;22;91
2014;"ENTRE FOLHAS (MG)";"MG";"ENTRE FOLHAS";59;6;9;74
2014;"ENTRE RIOS DE MINAS (MG)";"MG";"ENTRE RIOS DE MINAS";312;25;78;415
2014;"ERVALIA (MG)";"MG";"ERVALIA";322;28;54;404
2014;"ESMERALDAS (MG)";"MG";"ESMERALDAS";498;50;316;864
2014;"ESPERA FELIZ (MG)";"MG";"ESPERA FELIZ";365;44;58;467
2014;"ESPINOSA (MG)";"MG";"ESPINOSA";332;24;78;434
2014;"ESPIRITO SANTO DO DOURADO (MG)";"MG";"ESPIRITO SANTO DO DOURADO";84;7;8;99
2014;"ESTIVA (MG)";"MG";"ESTIVA";283;24;19;326
2014;"ESTRELA DALVA (MG)";"MG";"ESTRELA DALVA";30;3;3;36
2014;"ESTRELA DO INDAIA (MG)";"MG";"ESTRELA DO INDAIA";50;10;5;65
2014;"ESTRELA DO SUL (MG)";"MG";"ESTRELA DO SUL";109;16;22;147
2014;"EUGENOPOLIS (MG)";"MG";"EUGENOPOLIS";123;28;34;185
2014;"EWBANK DA CAMARA (MG)";"MG";"EWBANK DA CAMARA";41;4;3;48
2014;"EXTREMA (MG)";"MG";"EXTREMA";548;114;115;777
2014;"FAMA (MG)";"MG";"FAMA";18;8;1;27
2014;"FARIA LEMOS (MG)";"MG";"FARIA LEMOS";30;5;3;38
2014;"FELICIO DOS SANTOS (MG)";"MG";"FELICIO DOS SANTOS";45;13;25;83
2014;"FELISBURGO (MG)";"MG";"FELISBURGO";26;8;15;49
2014;"FELIXLANDIA (MG)";"MG";"FELIXLANDIA";226;18;66;310
2014;"FERNANDES TOURINHO (MG)";"MG";"FERNANDES TOURINHO";21;11;11;43
2014;"FERROS (MG)";"MG";"FERROS";111;17;51;179
2014;"FERVEDOURO (MG)";"MG";"FERVEDOURO";133;11;15;159
2014;"FLORESTAL (MG)";"MG";"FLORESTAL";109;15;42;166
2014;"FORMIGA (MG)";"MG";"FORMIGA";1702;178;239;2119
2014;"FORMOSO (MG)";"MG";"FORMOSO";45;2;32;79
2014;"FORTALEZA DE MINAS (MG)";"MG";"FORTALEZA DE MINAS";64;24;14;102
2014;"FORTUNA DE MINAS (MG)";"MG";"FORTUNA DE MINAS";32;7;13;52
2014;"FRANCISCO BADARO (MG)";"MG";"FRANCISCO BADARO";57;12;25;94
2014;"FRANCISCO DUMONT (MG)";"MG";"FRANCISCO DUMONT";58;10;34;102
2014;"FRANCISCO SA (MG)";"MG";"FRANCISCO SA";157;13;101;271
2014;"FRANCISCOPOLIS (MG)";"MG";"FRANCISCOPOLIS";19;8;18;45
2014;"FREI GASPAR (MG)";"MG";"FREI GASPAR";30;10;12;52
2014;"FREI INOCENCIO (MG)";"MG";"FREI INOCENCIO";102;10;28;140
2014;"FREI LAGONEGRO (MG)";"MG";"FREI LAGONEGRO";9;2;14;25
2014;"FRONTEIRA (MG)";"MG";"FRONTEIRA";223;45;79;347
2014;"FRONTEIRA DOS VALES (MG)";"MG";"FRONTEIRA DOS VALES";12;4;2;18
2014;"FRUTA DE LEITE (MG)";"MG";"FRUTA DE LEITE";22;3;24;49
2014;"FRUTAL (MG)";"MG";"FRUTAL";1549;137;205;1891
2014;"FUNILANDIA (MG)";"MG";"FUNILANDIA";50;2;19;71
2014;"GALILEIA (MG)";"MG";"GALILEIA";68;2;10;80
2014;"GAMELEIRAS (MG)";"MG";"GAMELEIRAS";29;5;17;51
2014;"GLAUCILANDIA (MG)";"MG";"GLAUCILANDIA";4;2;6;12
2014;"GOIABEIRA (MG)";"MG";"GOIABEIRA";27;9;4;40
2014;"GOIANA (MG)";"MG";"GOIANA";27;7;6;40
2014;"GONCALVES (MG)";"MG";"GONCALVES";98;22;8;128
2014;"GONZAGA (MG)";"MG";"GONZAGA";38;5;15;58
2014;"GOUVEA (MG)";"MG";"GOUVEA";131;15;34;180
2014;"GOVERNADOR VALADARES (MG)";"MG";"GOVERNADOR VALADARES";3442;302;345;4089
2014;"GRAO MOGOL (MG)";"MG";"GRAO MOGOL";95;23;74;192
2014;"GRUPIARA (MG)";"MG";"GRUPIARA";13;4;5;22
2014;"GUANHAES (MG)";"MG";"GUANHAES";617;57;136;810
2014;"GUAPE (MG)";"MG";"GUAPE";263;27;56;346
2014;"GUARACIABA (MG)";"MG";"GUARACIABA";84;24;33;141
2014;"GUARACIAMA (MG)";"MG";"GUARACIAMA";48;3;16;67
2014;"GUARANESIA (MG)";"MG";"GUARANESIA";356;63;108;527
2014;"GUARANI (MG)";"MG";"GUARANI";83;19;14;116
2014;"GUARARA (MG)";"MG";"GUARARA";54;12;4;70
2014;"GUARDA MOR (MG)";"MG";"GUARDA MOR";104;15;26;145
2014;"GUAXUPE (MG)";"MG";"GUAXUPE";862;94;153;1109
2014;"GUIDOVAL (MG)";"MG";"GUIDOVAL";153;4;10;167
2014;"GUIMARANIA (MG)";"MG";"GUIMARANIA";158;16;34;208
2014;"GUIRICEMA (MG)";"MG";"GUIRICEMA";268;16;26;310
2014;"GURINHATA (MG)";"MG";"GURINHATA";87;12;31;130
2014;"HELIODORA (MG)";"MG";"HELIODORA";81;11;17;109
2014;"IAPU (MG)";"MG";"IAPU";156;14;26;196
2014;"IBERTIOGA (MG)";"MG";"IBERTIOGA";47;14;9;70
2014;"IBIA (MG)";"MG";"IBIA";404;56;100;560
2014;"IBIAI (MG)";"MG";"IBIAI";58;10;11;79
2014;"IBIRACATU (MG)";"MG";"IBIRACATU";19;9;19;47
2014;"IBIRACI (MG)";"MG";"IBIRACI";370;35;41;446
2014;"IBIRITE (MG)";"MG";"IBIRITE";1432;237;316;1985
2014;"IBITIURA DE MINAS (MG)";"MG";"IBITIURA DE MINAS";96;8;7;111
2014;"IBITURUNA (MG)";"MG";"IBITURUNA";28;5;5;38
2014;"ICARAI DE MINAS (MG)";"MG";"ICARAI DE MINAS";31;1;8;40
2014;"IGARAPE (MG)";"MG";"IGARAPE";714;52;187;953
2014;"IGARATINGA (MG)";"MG";"IGARATINGA";533;10;19;562
2014;"IGUATAMA (MG)";"MG";"IGUATAMA";136;18;19;173
2014;"IJACI (MG)";"MG";"IJACI";220;12;25;257
2014;"ILICINEA (MG)";"MG";"ILICINEA";239;17;39;295
2014;"IMBE DE MINAS (MG)";"MG";"IMBE DE MINAS";48;6;13;67
2014;"INCONFIDENTES (MG)";"MG";"INCONFIDENTES";93;22;34;149
2014;"INDAIABIRA (MG)";"MG";"INDAIABIRA";80;14;26;120
2014;"INDIANOPOLIS (MG)";"MG";"INDIANOPOLIS";98;37;20;155
2014;"INGAI (MG)";"MG";"INGAI";21;18;12;51
2014;"INHAPIM (MG)";"MG";"INHAPIM";429;27;80;536
2014;"INHAUMA (MG)";"MG";"INHAUMA";112;8;22;142
2014;"INIMUTABA (MG)";"MG";"INIMUTABA";48;6;11;65
2014;"IPABA (MG)";"MG";"IPABA";96;17;24;137
2014;"IPANEMA (MG)";"MG";"IPANEMA";256;36;38;330
2014;"IPATINGA (MG)";"MG";"IPATINGA";3245;597;638;4480
2014;"IPIACU (MG)";"MG";"IPIACU";61;4;13;78
2014;"IPUIUNA (MG)";"MG";"IPUIUNA";394;42;36;472
2014;"IRAI DE MINAS (MG)";"MG";"IRAI DE MINAS";219;25;31;275
2014;"ITABIRA (MG)";"MG";"ITABIRA";1883;390;694;2967
2014;"ITABIRINHA (MG)";"MG";"ITABIRINHA";135;9;31;175
2014;"ITABIRITO (MG)";"MG";"ITABIRITO";1028;250;406;1684
2014;"ITACAMBIRA (MG)";"MG";"ITACAMBIRA";18;1;8;27
2014;"ITACARAMBI (MG)";"MG";"ITACARAMBI";123;11;41;175
2014;"ITAGUARA (MG)";"MG";"ITAGUARA";458;23;72;553
2014;"ITAIPE (MG)";"MG";"ITAIPE";73;13;29;115
2014;"ITAJUBA (MG)";"MG";"ITAJUBA";845;115;116;1076
2014;"ITAMARANDIBA (MG)";"MG";"ITAMARANDIBA";685;49;136;870
2014;"ITAMARATI DE MINAS (MG)";"MG";"ITAMARATI DE MINAS";119;14;14;147
2014;"ITAMBACURI (MG)";"MG";"ITAMBACURI";198;36;46;280
2014;"ITAMBE DO MATO DENTRO (MG)";"MG";"ITAMBE DO MATO DENTRO";21;6;6;33
2014;"ITAMOGI (MG)";"MG";"ITAMOGI";258;27;38;323
2014;"ITAMONTE (MG)";"MG";"ITAMONTE";308;23;32;363
2014;"ITANHANDU (MG)";"MG";"ITANHANDU";469;35;34;538
2014;"ITANHOMI (MG)";"MG";"ITANHOMI";109;19;21;149
2014;"ITAOBIM (MG)";"MG";"ITAOBIM";230;29;45;304
2014;"ITAPAGIPE (MG)";"MG";"ITAPAGIPE";266;25;46;337
2014;"ITAPECERICA (MG)";"MG";"ITAPECERICA";350;58;59;467
2014;"ITAPEVA (MG)";"MG";"ITAPEVA";265;32;11;308
2014;"ITATIAIUCU (MG)";"MG";"ITATIAIUCU";349;20;48;417
2014;"ITAU DE MINAS (MG)";"MG";"ITAU DE MINAS";376;51;53;480
2014;"ITAUNA (MG)";"MG";"ITAUNA";1591;240;282;2113
2014;"ITAVERAVA (MG)";"MG";"ITAVERAVA";62;7;18;87
2014;"ITINGA (MG)";"MG";"ITINGA";72;28;36;136
2014;"ITUETA (MG)";"MG";"ITUETA";68;8;19;95
2014;"ITUIUTABA (MG)";"MG";"ITUIUTABA";1357;259;376;1992
2014;"ITUMIRIM (MG)";"MG";"ITUMIRIM";67;25;10;102
2014;"ITURAMA (MG)";"MG";"ITURAMA";866;91;320;1277
2014;"ITUTINGA (MG)";"MG";"ITUTINGA";65;27;5;97
2014;"JABOTICATUBAS (MG)";"MG";"JABOTICATUBAS";292;12;63;367
2014;"JACINTO (MG)";"MG";"JACINTO";40;7;40;87
2014;"JACUI (MG)";"MG";"JACUI";147;17;34;198
2014;"JACUTINGA (MG)";"MG";"JACUTINGA";388;77;81;546
2014;"JAGUARACU (MG)";"MG";"JAGUARACU";48;3;7;58
2014;"JAIBA (MG)";"MG";"JAIBA";400;24;154;578
2014;"JAMPRUCA (MG)";"MG";"JAMPRUCA";17;4;26;47
2014;"JANAUBA (MG)";"MG";"JANAUBA";894;37;169;1100
2014;"JANUARIA (MG)";"MG";"JANUARIA";416;26;135;577
2014;"JAPARAIBA (MG)";"MG";"JAPARAIBA";86;9;19;114
2014;"JAPONVAR (MG)";"MG";"JAPONVAR";36;12;16;64
2014;"JECEABA (MG)";"MG";"JECEABA";126;38;17;181
2014;"JENIPAPO DE MINAS (MG)";"MG";"JENIPAPO DE MINAS";41;10;25;76
2014;"JEQUERI (MG)";"MG";"JEQUERI";120;10;33;163
2014;"JEQUITAI (MG)";"MG";"JEQUITAI";76;3;29;108
2014;"JEQUITIBA (MG)";"MG";"JEQUITIBA";97;13;28;138
2014;"JEQUITINHONHA (MG)";"MG";"JEQUITINHONHA";99;41;32;172
2014;"JESUANIA (MG)";"MG";"JESUANIA";67;22;14;103
2014;"JOAIMA (MG)";"MG";"JOAIMA";66;9;34;109
2014;"JOANESIA (MG)";"MG";"JOANESIA";18;8;14;40
2014;"JOAO MONLEVADE (MG)";"MG";"JOAO MONLEVADE";1247;179;275;1701
2014;"JOAO PINHEIRO (MG)";"MG";"JOAO PINHEIRO";966;66;263;1295
2014;"JOAQUIM FELICIO (MG)";"MG";"JOAQUIM FELICIO";51;2;13;66
2014;"JORDANIA (MG)";"MG";"JORDANIA";37;13;23;73
2014;"JOSE GONCALVES DE MINAS (MG)";"MG";"JOSE GONCALVES DE MINAS";30;11;18;59
2014;"JOSE RAYDAN (MG)";"MG";"JOSE RAYDAN";26;1;15;42
2014;"JOSENOPOLIS (MG)";"MG";"JOSENOPOLIS";20;6;13;39
2014;"JUATUBA (MG)";"MG";"JUATUBA";303;42;193;538
2014;"JUIZ DE FORA (MG)";"MG";"JUIZ DE FORA";6271;836;1680;8787
2014;"JURAMENTO (MG)";"MG";"JURAMENTO";23;2;15;40
2014;"JURUAIA (MG)";"MG";"JURUAIA";100;24;26;150
2014;"JUVENILIA (MG)";"MG";"JUVENILIA";23;5;10;38
2014;"LADAINHA (MG)";"MG";"LADAINHA";56;21;45;122
2014;"LAGAMAR (MG)";"MG";"LAGAMAR";109;33;21;163
2014;"LAGOA DA PRATA (MG)";"MG";"LAGOA DA PRATA";1162;74;173;1409
2014;"LAGOA DOS PATOS (MG)";"MG";"LAGOA DOS PATOS";41;0;13;54
2014;"LAGOA DOURADA (MG)";"MG";"LAGOA DOURADA";419;31;137;587
2014;"LAGOA FORMOSA (MG)";"MG";"LAGOA FORMOSA";365;28;91;484
2014;"LAGOA GRANDE (MG)";"MG";"LAGOA GRANDE";115;11;53;179
2014;"LAGOA SANTA (MG)";"MG";"LAGOA SANTA";834;127;152;1113
2014;"LAJINHA (MG)";"MG";"LAJINHA";305;42;55;402
2014;"LAMBARI (MG)";"MG";"LAMBARI";361;64;33;458
2014;"LAMIM (MG)";"MG";"LAMIM";45;4;8;57
2014;"LARANJAL (MG)";"MG";"LARANJAL";125;12;5;142
2014;"LASSANCE (MG)";"MG";"LASSANCE";50;12;8;70
2014;"LAVRAS (MG)";"MG";"LAVRAS";1463;226;278;1967
2014;"LEANDRO FERREIRA (MG)";"MG";"LEANDRO FERREIRA";37;6;10;53
2014;"LEME DO PRADO (MG)";"MG";"LEME DO PRADO";30;4;16;50
2014;"LEOPOLDINA (MG)";"MG";"LEOPOLDINA";714;79;79;872
2014;"LIBERDADE (MG)";"MG";"LIBERDADE";95;22;11;128
2014;"LIMA DUARTE (MG)";"MG";"LIMA DUARTE";214;30;37;281
2014;"LIMEIRA DO OESTE (MG)";"MG";"LIMEIRA DO OESTE";173;36;59;268
2014;"LONTRA (MG)";"MG";"LONTRA";33;6;17;56
2014;"LUISBURGO (MG)";"MG";"LUISBURGO";38;10;24;72
2014;"LUISLANDIA (MG)";"MG";"LUISLANDIA";26;5;15;46
2014;"LUMINARIAS (MG)";"MG";"LUMINARIAS";109;7;45;161
2014;"LUZ (MG)";"MG";"LUZ";358;56;34;448
2014;"MACHACALIS (MG)";"MG";"MACHACALIS";33;4;10;47
2014;"MACHADO (MG)";"MG";"MACHADO";768;153;126;1047
2014;"MADRE DE DEUS DE MINAS (MG)";"MG";"MADRE DE DEUS DE MINAS";107;10;15;132
2014;"MALACACHETA (MG)";"MG";"MALACACHETA";128;13;53;194
2014;"MAMONAS (MG)";"MG";"MAMONAS";106;9;26;141
2014;"MANGA (MG)";"MG";"MANGA";153;11;56;220
2014;"MANHUACU (MG)";"MG";"MANHUACU";1707;142;187;2036
2014;"MANHUMIRIM (MG)";"MG";"MANHUMIRIM";331;42;44;417
2014;"MANTENA (MG)";"MG";"MANTENA";563;45;84;692
2014;"MAR DE ESPANHA (MG)";"MG";"MAR DE ESPANHA";174;28;16;218
2014;"MARAVILHAS (MG)";"MG";"MARAVILHAS";167;21;12;200
2014;"MARIA DA FE (MG)";"MG";"MARIA DA FE";250;19;32;301
2014;"MARIANA (MG)";"MG";"MARIANA";704;204;344;1252
2014;"MARILAC (MG)";"MG";"MARILAC";22;7;13;42
2014;"MARIO CAMPOS (MG)";"MG";"MARIO CAMPOS";245;28;20;293
2014;"MARIPA DE MINAS (MG)";"MG";"MARIPA DE MINAS";50;6;7;63
2014;"MARLIERIA (MG)";"MG";"MARLIERIA";46;6;11;63
2014;"MARMELOPOLIS (MG)";"MG";"MARMELOPOLIS";42;10;11;63
2014;"MARTINHO CAMPOS (MG)";"MG";"MARTINHO CAMPOS";407;36;81;524
2014;"MARTINS SOARES (MG)";"MG";"MARTINS SOARES";112;10;19;141
2014;"MATA VERDE (MG)";"MG";"MATA VERDE";43;30;8;81
2014;"MATERLANDIA (MG)";"MG";"MATERLANDIA";17;5;3;25
2014;"MATEUS LEME (MG)";"MG";"MATEUS LEME";626;89;127;842
2014;"MATHIAS LOBATO (MG)";"MG";"MATHIAS LOBATO";35;3;9;47
2014;"MATIAS BARBOSA (MG)";"MG";"MATIAS BARBOSA";678;44;43;765
2014;"MATIAS CARDOSO (MG)";"MG";"MATIAS CARDOSO";37;3;29;69
2014;"MATIPO (MG)";"MG";"MATIPO";297;30;49;376
2014;"MATO VERDE (MG)";"MG";"MATO VERDE";180;9;38;227
2014;"MATOZINHOS (MG)";"MG";"MATOZINHOS";403;99;178;680
2014;"MATUTINA (MG)";"MG";"MATUTINA";82;23;6;111
2014;"MEDEIROS (MG)";"MG";"MEDEIROS";64;20;8;92
2014;"MEDINA (MG)";"MG";"MEDINA";160;54;39;253
2014;"MENDES PIMENTEL (MG)";"MG";"MENDES PIMENTEL";45;9;13;67
2014;"MERCES (MG)";"MG";"MERCES";188;24;19;231
2014;"MESQUITA (MG)";"MG";"MESQUITA";25;20;10;55
2014;"MINAS NOVAS (MG)";"MG";"MINAS NOVAS";165;39;115;319
2014;"MINDURI (MG)";"MG";"MINDURI";76;12;3;91
2014;"MIRABELA (MG)";"MG";"MIRABELA";118;20;33;171
2014;"MIRADOURO (MG)";"MG";"MIRADOURO";110;21;35;166
2014;"MIRAI (MG)";"MG";"MIRAI";174;14;24;212
2014;"MIRAVANIA (MG)";"MG";"MIRAVANIA";14;4;17;35
2014;"MOEDA (MG)";"MG";"MOEDA";137;8;43;188
2014;"MOEMA (MG)";"MG";"MOEMA";181;14;125;320
2014;"MONJOLOS (MG)";"MG";"MONJOLOS";8;3;8;19
2014;"MONSENHOR PAULO (MG)";"MG";"MONSENHOR PAULO";194;28;14;236
2014;"MONTALVANIA (MG)";"MG";"MONTALVANIA";133;9;69;211
2014;"MONTE ALEGRE DE MINAS (MG)";"MG";"MONTE ALEGRE DE MINAS";572;71;60;703
2014;"MONTE AZUL (MG)";"MG";"MONTE AZUL";187;11;68;266
2014;"MONTE BELO (MG)";"MG";"MONTE BELO";277;47;54;378
2014;"MONTE CARMELO (MG)";"MG";"MONTE CARMELO";1455;133;163;1751
2014;"MONTE FORMOSO (MG)";"MG";"MONTE FORMOSO";24;14;42;80
2014;"MONTE SANTO DE MINAS (MG)";"MG";"MONTE SANTO DE MINAS";515;59;123;697
2014;"MONTE SIAO (MG)";"MG";"MONTE SIAO";282;53;37;372
2014;"MONTES CLAROS (MG)";"MG";"MONTES CLAROS";4797;362;1209;6368
2014;"MONTEZUMA (MG)";"MG";"MONTEZUMA";40;11;27;78
2014;"MORADA NOVA DE MINAS (MG)";"MG";"MORADA NOVA DE MINAS";128;24;27;179
2014;"MORRO DA GARCA (MG)";"MG";"MORRO DA GARCA";48;9;20;77
2014;"MORRO DO PILAR (MG)";"MG";"MORRO DO PILAR";33;7;3;43
2014;"MUNHOZ (MG)";"MG";"MUNHOZ";151;20;12;183
2014;"MURIAE (MG)";"MG";"MURIAE";1451;129;209;1789
2014;"MUTUM (MG)";"MG";"MUTUM";249;30;83;362
2014;"MUZAMBINHO (MG)";"MG";"MUZAMBINHO";470;94;53;617
2014;"NACIP RAYDAN (MG)";"MG";"NACIP RAYDAN";12;0;5;17
2014;"NANUQUE (MG)";"MG";"NANUQUE";572;66;213;851
2014;"NAQUE (MG)";"MG";"NAQUE";39;4;29;72
2014;"NATALANDIA (MG)";"MG";"NATALANDIA";31;2;19;52
2014;"NATERCIA (MG)";"MG";"NATERCIA";91;12;22;125
2014;"NAZARENO (MG)";"MG";"NAZARENO";182;16;35;233
2014;"NEPOMUCENO (MG)";"MG";"NEPOMUCENO";453;49;115;617
2014;"NINHEIRA (MG)";"MG";"NINHEIRA";50;6;35;91
2014;"NOVA BELEM (MG)";"MG";"NOVA BELEM";39;2;14;55
2014;"NOVA ERA (MG)";"MG";"NOVA ERA";255;25;76;356
2014;"NOVA LIMA (MG)";"MG";"NOVA LIMA";1642;424;245;2311
2014;"NOVA MODICA (MG)";"MG";"NOVA MODICA";21;4;14;39
2014;"NOVA PONTE (MG)";"MG";"NOVA PONTE";249;53;67;369
2014;"NOVA PORTEIRINHA (MG)";"MG";"NOVA PORTEIRINHA";43;5;18;66
2014;"NOVA RESENDE (MG)";"MG";"NOVA RESENDE";363;33;70;466
2014;"NOVA SERRANA (MG)";"MG";"NOVA SERRANA";580;67;117;764
2014;"NOVA UNIAO (MG)";"MG";"NOVA UNIAO";169;13;23;205
2014;"NOVO CRUZEIRO (MG)";"MG";"NOVO CRUZEIRO";202;42;128;372
2014;"NOVO ORIENTE DE MINAS (MG)";"MG";"NOVO ORIENTE DE MINAS";46;34;19;99
2014;"NOVORIZONTE (MG)";"MG";"NOVORIZONTE";67;1;25;93
2014;"OLARIA (MG)";"MG";"OLARIA";24;8;7;39
2014;"OLHOS D AGUA (MG)";"MG";"OLHOS D AGUA";80;14;48;142
2014;"OLIMPIO NORONHA (MG)";"MG";"OLIMPIO NORONHA";26;15;9;50
2014;"OLIVEIRA (MG)";"MG";"OLIVEIRA";782;95;127;1004
2014;"OLIVEIRA FORTES (MG)";"MG";"OLIVEIRA FORTES";28;3;1;32
2014;"ONCA DE PITANGUI (MG)";"MG";"ONCA DE PITANGUI";29;13;12;54
2014;"ORATORIOS (MG)";"MG";"ORATORIOS";85;5;21;111
2014;"ORIZANIA (MG)";"MG";"ORIZANIA";81;16;16;113
2014;"OURO BRANCO (MG)";"MG";"OURO BRANCO";565;145;226;936
2014;"OURO FINO (MG)";"MG";"OURO FINO";616;98;88;802
2014;"OURO PRETO (MG)";"MG";"OURO PRETO";1061;265;299;1625
2014;"OURO VERDE DE MINAS (MG)";"MG";"OURO VERDE DE MINAS";29;9;7;45
2014;"PADRE CARVALHO (MG)";"MG";"PADRE CARVALHO";28;9;30;67
2014;"PADRE PARAISO (MG)";"MG";"PADRE PARAISO";154;68;68;290
2014;"PAI PEDRO (MG)";"MG";"PAI PEDRO";20;4;26;50
2014;"PAINEIRAS (MG)";"MG";"PAINEIRAS";86;16;11;113
2014;"PAINS (MG)";"MG";"PAINS";259;20;26;305
2014;"PAIVA (MG)";"MG";"PAIVA";11;3;2;16
2014;"PALMA (MG)";"MG";"PALMA";115;10;8;133
2014;"PALMOPOLIS (MG)";"MG";"PALMOPOLIS";18;8;10;36
2014;"PAPAGAIOS (MG)";"MG";"PAPAGAIOS";563;14;61;638
2014;"PARA DE MINAS (MG)";"MG";"PARA DE MINAS";2370;207;225;2802
2014;"PARACATU (MG)";"MG";"PARACATU";1578;158;366;2102
2014;"PARAGUACU (MG)";"MG";"PARAGUACU";314;64;41;419
2014;"PARAISOPOLIS (MG)";"MG";"PARAISOPOLIS";341;56;51;448
2014;"PARAOPEBA (MG)";"MG";"PARAOPEBA";479;33;53;565
2014;"PASSA QUATRO (MG)";"MG";"PASSA QUATRO";384;34;28;446
2014;"PASSA TEMPO (MG)";"MG";"PASSA TEMPO";210;39;26;275
2014;"PASSA VINTE (MG)";"MG";"PASSA VINTE";176;22;11;209
2014;"PASSABEM (MG)";"MG";"PASSABEM";15;5;4;24
2014;"PASSOS (MG)";"MG";"PASSOS";2047;190;395;2632
2014;"PATIS (MG)";"MG";"PATIS";20;5;14;39
2014;"PATOS DE MINAS (MG)";"MG";"PATOS DE MINAS";3258;180;374;3812
2014;"PATROCINIO (MG)";"MG";"PATROCINIO";1825;169;597;2591
2014;"PATROCINIO DO MURIAE (MG)";"MG";"PATROCINIO DO MURIAE";97;12;8;117
2014;"PAULA CANDIDO (MG)";"MG";"PAULA CANDIDO";85;11;16;112
2014;"PAULISTAS (MG)";"MG";"PAULISTAS";37;3;9;49
2014;"PAVAO (MG)";"MG";"PAVAO";45;25;12;82
2014;"PECANHA (MG)";"MG";"PECANHA";140;12;62;214
2014;"PEDRA AZUL (MG)";"MG";"PEDRA AZUL";158;21;60;239
2014;"PEDRA BONITA (MG)";"MG";"PEDRA BONITA";69;15;22;106
2014;"PEDRA DO ANTA (MG)";"MG";"PEDRA DO ANTA";36;3;17;56
2014;"PEDRA DO INDAIA (MG)";"MG";"PEDRA DO INDAIA";85;14;5;104
2014;"PEDRA DOURADA (MG)";"MG";"PEDRA DOURADA";19;7;22;48
2014;"PEDRALVA (MG)";"MG";"PEDRALVA";161;29;29;219
2014;"PEDRAS DE MARIA DA CRUZ (MG)";"MG";"PEDRAS DE MARIA DA CRUZ";30;7;42;79
2014;"PEDRINOPOLIS (MG)";"MG";"PEDRINOPOLIS";62;19;8;89
2014;"PEDRO LEOPOLDO (MG)";"MG";"PEDRO LEOPOLDO";1264;206;214;1684
2014;"PEDRO TEIXEIRA (MG)";"MG";"PEDRO TEIXEIRA";19;8;5;32
2014;"PEQUERI (MG)";"MG";"PEQUERI";87;7;5;99
2014;"PEQUI (MG)";"MG";"PEQUI";62;20;8;90
2014;"PERDIGAO (MG)";"MG";"PERDIGAO";164;13;12;189
2014;"PERDIZES (MG)";"MG";"PERDIZES";284;62;56;402
2014;"PERDOES (MG)";"MG";"PERDOES";536;36;85;657
2014;"PERIQUITO (MG)";"MG";"PERIQUITO";66;5;21;92
2014;"PESCADOR (MG)";"MG";"PESCADOR";17;9;9;35
2014;"PIAU (MG)";"MG";"PIAU";51;10;8;69
2014;"PIEDADE DE CARATINGA (MG)";"MG";"PIEDADE DE CARATINGA";161;13;18;192
2014;"PIEDADE DE PONTE NOVA (MG)";"MG";"PIEDADE DE PONTE NOVA";41;2;18;61
2014;"PIEDADE DO RIO GRANDE (MG)";"MG";"PIEDADE DO RIO GRANDE";67;6;7;80
2014;"PIEDADE DOS GERAIS (MG)";"MG";"PIEDADE DOS GERAIS";98;10;22;130
2014;"PIMENTA (MG)";"MG";"PIMENTA";252;17;30;299
2014;"PINGO D AGUA (MG)";"MG";"PINGO D AGUA";34;3;8;45
2014;"PINTOPOLIS (MG)";"MG";"PINTOPOLIS";23;2;9;34
2014;"PIRACEMA (MG)";"MG";"PIRACEMA";121;12;21;154
2014;"PIRAJUBA (MG)";"MG";"PIRAJUBA";164;27;9;200
2014;"PIRANGA (MG)";"MG";"PIRANGA";154;24;64;242
2014;"PIRANGUCU (MG)";"MG";"PIRANGUCU";53;25;33;111
2014;"PIRANGUINHO (MG)";"MG";"PIRANGUINHO";236;29;27;292
2014;"PIRAPETINGA (MG)";"MG";"PIRAPETINGA";397;28;36;461
2014;"PIRAPORA (MG)";"MG";"PIRAPORA";613;50;177;840
2014;"PIRAUBA (MG)";"MG";"PIRAUBA";138;21;15;174
2014;"PITANGUI (MG)";"MG";"PITANGUI";556;83;95;734
2014;"PIUMHI (MG)";"MG";"PIUMHI";833;83;87;1003
2014;"PLANURA (MG)";"MG";"PLANURA";168;20;57;245
2014;"POCO FUNDO (MG)";"MG";"POCO FUNDO";311;47;29;387
2014;"POCOS DE CALDAS (MG)";"MG";"POCOS DE CALDAS";2838;584;456;3878
2014;"POCRANE (MG)";"MG";"POCRANE";93;7;13;113
2014;"POMPEU (MG)";"MG";"POMPEU";473;30;143;646
2014;"PONTE NOVA (MG)";"MG";"PONTE NOVA";1127;129;183;1439
2014;"PONTO CHIQUE (MG)";"MG";"PONTO CHIQUE";13;2;14;29
2014;"PONTO DOS VOLANTES (MG)";"MG";"PONTO DOS VOLANTES";46;10;37;93
2014;"PORTEIRINHA (MG)";"MG";"PORTEIRINHA";407;22;223;652
2014;"PORTO FIRME (MG)";"MG";"PORTO FIRME";82;7;19;108
2014;"POTE (MG)";"MG";"POTE";91;22;35;148
2014;"POUSO ALEGRE (MG)";"MG";"POUSO ALEGRE";2763;334;531;3628
2014;"POUSO ALTO (MG)";"MG";"POUSO ALTO";109;13;12;134
2014;"PRADOS (MG)";"MG";"PRADOS";116;23;14;153
2014;"PRATA (MG)";"MG";"PRATA";442;119;111;672
2014;"PRATAPOLIS (MG)";"MG";"PRATAPOLIS";221;27;25;273
2014;"PRATINHA (MG)";"MG";"PRATINHA";68;11;8;87
2014;"PRESIDENTE BERNARDES (MG)";"MG";"PRESIDENTE BERNARDES";31;9;11;51
2014;"PRESIDENTE JUSCELINO (MG)";"MG";"PRESIDENTE JUSCELINO";45;5;19;69
2014;"PRESIDENTE KUBITSCHEK (MG)";"MG";"PRESIDENTE KUBITSCHEK";28;13;8;49
2014;"PRESIDENTE OLEGARIO (MG)";"MG";"PRESIDENTE OLEGARIO";255;20;109;384
2014;"PRUDENTE DE MORAIS (MG)";"MG";"PRUDENTE DE MORAIS";123;9;14;146
2014;"QUARTEL GERAL (MG)";"MG";"QUARTEL GERAL";44;6;5;55
2014;"QUELUZITA (MG)";"MG";"QUELUZITA";23;10;5;38
2014;"RAPOSOS (MG)";"MG";"RAPOSOS";85;40;32;157
2014;"RAUL SOARES (MG)";"MG";"RAUL SOARES";267;43;60;370
2014;"RECREIO (MG)";"MG";"RECREIO";211;30;26;267
2014;"REDUTO (MG)";"MG";"REDUTO";107;13;9;129
2014;"RESENDE COSTA (MG)";"MG";"RESENDE COSTA";232;22;24;278
2014;"RESPLENDOR (MG)";"MG";"RESPLENDOR";231;39;40;310
2014;"RESSAQUINHA (MG)";"MG";"RESSAQUINHA";164;14;28;206
2014;"RIACHINHO (MG)";"MG";"RIACHINHO";110;5;24;139
2014;"RIACHO DOS MACHADOS (MG)";"MG";"RIACHO DOS MACHADOS";54;4;43;101
2014;"RIBEIRAO DAS NEVES (MG)";"MG";"RIBEIRAO DAS NEVES";2856;476;704;4036
2014;"RIBEIRAO VERMELHO (MG)";"MG";"RIBEIRAO VERMELHO";43;13;4;60
2014;"RIO ACIMA (MG)";"MG";"RIO ACIMA";123;21;16;160
2014;"RIO CASCA (MG)";"MG";"RIO CASCA";230;11;53;294
2014;"RIO DO PRADO (MG)";"MG";"RIO DO PRADO";18;9;9;36
2014;"RIO DOCE (MG)";"MG";"RIO DOCE";18;10;6;34
2014;"RIO ESPERA (MG)";"MG";"RIO ESPERA";42;0;13;55
2014;"RIO MANSO (MG)";"MG";"RIO MANSO";175;8;17;200
2014;"RIO NOVO (MG)";"MG";"RIO NOVO";181;24;30;235
2014;"RIO PARANAIBA (MG)";"MG";"RIO PARANAIBA";258;15;77;350
2014;"RIO PARDO DE MINAS (MG)";"MG";"RIO PARDO DE MINAS";244;28;157;429
2014;"RIO PIRACICABA (MG)";"MG";"RIO PIRACICABA";213;20;29;262
2014;"RIO POMBA (MG)";"MG";"RIO POMBA";285;35;38;358
2014;"RIO PRETO (MG)";"MG";"RIO PRETO";606;56;64;726
2014;"RIO VERMELHO (MG)";"MG";"RIO VERMELHO";86;28;41;155
2014;"RITAPOLIS (MG)";"MG";"RITAPOLIS";39;13;8;60
2014;"ROCHEDO DE MINAS (MG)";"MG";"ROCHEDO DE MINAS";31;6;3;40
2014;"RODEIRO (MG)";"MG";"RODEIRO";283;9;23;315
2014;"ROMARIA (MG)";"MG";"ROMARIA";50;25;10;85
2014;"ROSARIO DA LIMEIRA (MG)";"MG";"ROSARIO DA LIMEIRA";81;5;37;123
2014;"RUBELITA (MG)";"MG";"RUBELITA";22;5;11;38
2014;"RUBIM (MG)";"MG";"RUBIM";30;1;29;60
2014;"SABARA (MG)";"MG";"SABARA";818;223;346;1387
2014;"SABINOPOLIS (MG)";"MG";"SABINOPOLIS";136;37;59;232
2014;"SACRAMENTO (MG)";"MG";"SACRAMENTO";540;93;78;711
2014;"SALINAS (MG)";"MG";"SALINAS";466;51;136;653
2014;"SALTO DA DIVISA (MG)";"MG";"SALTO DA DIVISA";16;8;12;36
2014;"SANTA BARBARA (MG)";"MG";"SANTA BARBARA";466;82;107;655
2014;"SANTA BARBARA DO LESTE (MG)";"MG";"SANTA BARBARA DO LESTE";182;11;10;203
2014;"SANTA BARBARA DO MONTE VERDE (MG)";"MG";"SANTA BARBARA DO MONTE VERDE";746;66;138;950
2014;"SANTA BARBARA DO TUGURIO (MG)";"MG";"SANTA BARBARA DO TUGURIO";73;32;64;169
2014;"SANTA CRUZ DE MINAS (MG)";"MG";"SANTA CRUZ DE MINAS";89;11;3;103
2014;"SANTA CRUZ DE SALINAS (MG)";"MG";"SANTA CRUZ DE SALINAS";28;5;26;59
2014;"SANTA CRUZ DO ESCALVADO (MG)";"MG";"SANTA CRUZ DO ESCALVADO";40;11;14;65
2014;"SANTA EFIGENIA DE MINAS (MG)";"MG";"SANTA EFIGENIA DE MINAS";26;9;7;42
2014;"SANTA FE DE MINAS (MG)";"MG";"SANTA FE DE MINAS";9;2;5;16
2014;"SANTA HELENA DE MINAS (MG)";"MG";"SANTA HELENA DE MINAS";11;10;8;29
2014;"SANTA JULIANA (MG)";"MG";"SANTA JULIANA";451;46;56;553
2014;"SANTA LUZIA (MG)";"MG";"SANTA LUZIA";2048;331;747;3126
2014;"SANTA MARGARIDA (MG)";"MG";"SANTA MARGARIDA";239;32;41;312
2014;"SANTA MARIA DE ITABIRA (MG)";"MG";"SANTA MARIA DE ITABIRA";144;21;57;222
2014;"SANTA MARIA DO SALTO (MG)";"MG";"SANTA MARIA DO SALTO";11;8;8;27
2014;"SANTA MARIA DO SUACUI (MG)";"MG";"SANTA MARIA DO SUACUI";99;8;52;159
2014;"SANTA RITA DE CALDAS (MG)";"MG";"SANTA RITA DE CALDAS";316;33;19;368
2014;"SANTA RITA DE IBITIPOCA (MG)";"MG";"SANTA RITA DE IBITIPOCA";51;13;4;68
2014;"SANTA RITA DE JACUTINGA (MG)";"MG";"SANTA RITA DE JACUTINGA";97;10;7;114
2014;"SANTA RITA DE MINAS (MG)";"MG";"SANTA RITA DE MINAS";124;15;17;156
2014;"SANTA RITA DO ITUETO (MG)";"MG";"SANTA RITA DO ITUETO";81;11;21;113
2014;"SANTA RITA DO SAPUCAI (MG)";"MG";"SANTA RITA DO SAPUCAI";426;87;101;614
2014;"SANTA ROSA DA SERRA (MG)";"MG";"SANTA ROSA DA SERRA";60;10;12;82
2014;"SANTA VITORIA (MG)";"MG";"SANTA VITORIA";461;55;45;561
2014;"SANTANA DA VARGEM (MG)";"MG";"SANTANA DA VARGEM";99;14;27;140
2014;"SANTANA DE CATAGUASES (MG)";"MG";"SANTANA DE CATAGUASES";33;13;5;51
2014;"SANTANA DE PIRAPAMA (MG)";"MG";"SANTANA DE PIRAPAMA";79;4;34;117
2014;"SANTANA DO DESERTO (MG)";"MG";"SANTANA DO DESERTO";62;13;13;88
2014;"SANTANA DO GARAMBEU (MG)";"MG";"SANTANA DO GARAMBEU";15;4;7;26
2014;"SANTANA DO JACARE (MG)";"MG";"SANTANA DO JACARE";54;7;17;78
2014;"SANTANA DO MANHUACU (MG)";"MG";"SANTANA DO MANHUACU";211;10;23;244
2014;"SANTANA DO PARAISO (MG)";"MG";"SANTANA DO PARAISO";146;26;35;207
2014;"SANTANA DO RIACHO (MG)";"MG";"SANTANA DO RIACHO";46;9;7;62
2014;"SANTANA DOS MONTES (MG)";"MG";"SANTANA DOS MONTES";40;9;9;58
2014;"SANTO ANTONIO DO AMPARO (MG)";"MG";"SANTO ANTONIO DO AMPARO";274;48;95;417
2014;"SANTO ANTONIO DO AVENTUREIRO (MG)";"MG";"SANTO ANTONIO DO AVENTUREIRO";64;2;10;76
2014;"SANTO ANTONIO DO GRAMA (MG)";"MG";"SANTO ANTONIO DO GRAMA";54;11;16;81
2014;"SANTO ANTONIO DO ITAMBE (MG)";"MG";"SANTO ANTONIO DO ITAMBE";17;7;10;34
2014;"SANTO ANTONIO DO JACINTO (MG)";"MG";"SANTO ANTONIO DO JACINTO";45;4;41;90
2014;"SANTO ANTONIO DO MONTE (MG)";"MG";"SANTO ANTONIO DO MONTE";564;68;110;742
2014;"SANTO ANTONIO DO RETIRO (MG)";"MG";"SANTO ANTONIO DO RETIRO";52;7;30;89
2014;"SANTO ANTONIO DO RIO ABAIXO (MG)";"MG";"SANTO ANTONIO DO RIO ABAIXO";13;7;9;29
2014;"SANTO HIPOLITO (MG)";"MG";"SANTO HIPOLITO";24;7;4;35
2014;"SANTOS DUMONT (MG)";"MG";"SANTOS DUMONT";437;106;160;703
2014;"SAO BENTO ABADE (MG)";"MG";"SAO BENTO ABADE";46;20;20;86
2014;"SAO BRAS DO SUACUI (MG)";"MG";"SAO BRAS DO SUACUI";56;6;8;70
2014;"SAO DOMINGOS DAS DORES (MG)";"MG";"SAO DOMINGOS DAS DORES";105;8;15;128
2014;"SAO DOMINGOS DO PRATA (MG)";"MG";"SAO DOMINGOS DO PRATA";297;22;68;387
2014;"SAO FELIX DE MINAS (MG)";"MG";"SAO FELIX DE MINAS";24;2;15;41
2014;"SAO FRANCISCO (MG)";"MG";"SAO FRANCISCO";286;27;142;455
2014;"SAO FRANCISCO DE PAULA (MG)";"MG";"SAO FRANCISCO DE PAULA";72;23;26;121
2014;"SAO FRANCISCO DE SALES (MG)";"MG";"SAO FRANCISCO DE SALES";76;11;25;112
2014;"SAO FRANCISCO DO GLORIA (MG)";"MG";"SAO FRANCISCO DO GLORIA";68;9;14;91
2014;"SAO GERALDO (MG)";"MG";"SAO GERALDO";184;11;15;210
2014;"SAO GERALDO DA PIEDADE (MG)";"MG";"SAO GERALDO DA PIEDADE";16;6;8;30
2014;"SAO GERALDO DO BAIXIO (MG)";"MG";"SAO GERALDO DO BAIXIO";19;6;9;34
2014;"SAO GONCALO DO ABAETE (MG)";"MG";"SAO GONCALO DO ABAETE";100;14;21;135
2014;"SAO GONCALO DO PARA (MG)";"MG";"SAO GONCALO DO PARA";227;17;22;266
2014;"SAO GONCALO DO RIO ABAIXO (MG)";"MG";"SAO GONCALO DO RIO ABAIXO";236;55;34;325
2014;"SAO GONCALO DO RIO PRETO (MG)";"MG";"SAO GONCALO DO RIO PRETO";36;10;5;51
2014;"SAO GONCALO DO SAPUCAI (MG)";"MG";"SAO GONCALO DO SAPUCAI";460;52;80;592
2014;"SAO GOTARDO (MG)";"MG";"SAO GOTARDO";953;100;247;1300
2014;"SAO JOAO BATISTA DO GLORIA (MG)";"MG";"SAO JOAO BATISTA DO GLORIA";149;12;16;177
2014;"SAO JOAO DA LAGOA (MG)";"MG";"SAO JOAO DA LAGOA";34;13;14;61
2014;"SAO JOAO DA MATA (MG)";"MG";"SAO JOAO DA MATA";65;19;5;89
2014;"SAO JOAO DA PONTE (MG)";"MG";"SAO JOAO DA PONTE";79;15;62;156
2014;"SAO JOAO DAS MISSOES (MG)";"MG";"SAO JOAO DAS MISSOES";37;3;21;61
2014;"SAO JOAO DEL REI (MG)";"MG";"SAO JOAO DEL REI";1228;220;241;1689
2014;"SAO JOAO DO MANHUACU (MG)";"MG";"SAO JOAO DO MANHUACU";157;20;32;209
2014;"SAO JOAO DO MANTENINHA (MG)";"MG";"SAO JOAO DO MANTENINHA";86;13;6;105
2014;"SAO JOAO DO ORIENTE (MG)";"MG";"SAO JOAO DO ORIENTE";114;10;8;132
2014;"SAO JOAO DO PACUI (MG)";"MG";"SAO JOAO DO PACUI";17;4;7;28
2014;"SAO JOAO DO PARAISO (MG)";"MG";"SAO JOAO DO PARAISO";228;24;93;345
2014;"SAO JOAO EVANGELISTA (MG)";"MG";"SAO JOAO EVANGELISTA";141;14;54;209
2014;"SAO JOAO NEPOMUCENO (MG)";"MG";"SAO JOAO NEPOMUCENO";309;41;28;378
2014;"SAO JOAQUIM DE BICAS (MG)";"MG";"SAO JOAQUIM DE BICAS";630;77;45;752
2014;"SAO JOSE DA BARRA (MG)";"MG";"SAO JOSE DA BARRA";125;15;28;168
2014;"SAO JOSE DA LAPA (MG)";"MG";"SAO JOSE DA LAPA";332;54;82;468
2014;"SAO JOSE DA SAFIRA (MG)";"MG";"SAO JOSE DA SAFIRA";9;2;6;17
2014;"SAO JOSE DA VARGINHA (MG)";"MG";"SAO JOSE DA VARGINHA";54;4;21;79
2014;"SAO JOSE DO ALEGRE (MG)";"MG";"SAO JOSE DO ALEGRE";46;6;7;59
2014;"SAO JOSE DO DIVINO (MG)";"MG";"SAO JOSE DO DIVINO";18;6;14;38
2014;"SAO JOSE DO GOIABAL (MG)";"MG";"SAO JOSE DO GOIABAL";45;12;35;92
2014;"SAO JOSE DO JACURI (MG)";"MG";"SAO JOSE DO JACURI";31;5;8;44
2014;"SAO JOSE DO MANTIMENTO (MG)";"MG";"SAO JOSE DO MANTIMENTO";38;1;5;44
2014;"SAO LOURENCO (MG)";"MG";"SAO LOURENCO";567;82;56;705
2014;"SAO MIGUEL DO ANTA (MG)";"MG";"SAO MIGUEL DO ANTA";89;10;12;111
2014;"SAO PEDRO DA UNIAO (MG)";"MG";"SAO PEDRO DA UNIAO";112;16;16;144
2014;"SAO PEDRO DO SUACUI (MG)";"MG";"SAO PEDRO DO SUACUI";37;4;9;50
2014;"SAO PEDRO DOS FERROS (MG)";"MG";"SAO PEDRO DOS FERROS";110;8;42;160
2014;"SAO ROMAO (MG)";"MG";"SAO ROMAO";39;3;10;52
2014;"SAO ROQUE DE MINAS (MG)";"MG";"SAO ROQUE DE MINAS";195;13;23;231
2014;"SAO SEBASTIAO DA BELA VISTA (MG)";"MG";"SAO SEBASTIAO DA BELA VISTA";88;14;16;118
2014;"SAO SEBASTIAO DA VARGEM ALEGRE (MG)";"MG";"SAO SEBASTIAO DA VARGEM ALEGRE";36;6;6;48
2014;"SAO SEBASTIAO DO ANTA (MG)";"MG";"SAO SEBASTIAO DO ANTA";62;8;8;78
2014;"SAO SEBASTIAO DO MARANHAO (MG)";"MG";"SAO SEBASTIAO DO MARANHAO";27;9;19;55
2014;"SAO SEBASTIAO DO OESTE (MG)";"MG";"SAO SEBASTIAO DO OESTE";165;7;18;190
2014;"SAO SEBASTIAO DO PARAISO (MG)";"MG";"SAO SEBASTIAO DO PARAISO";1670;136;214;2020
2014;"SAO SEBASTIAO DO RIO PRETO (MG)";"MG";"SAO SEBASTIAO DO RIO PRETO";11;6;7;24
2014;"SAO SEBASTIAO DO RIO VERDE (MG)";"MG";"SAO SEBASTIAO DO RIO VERDE";14;2;7;23
2014;"SAO TIAGO (MG)";"MG";"SAO TIAGO";206;20;23;249
2014;"SAO TOMAS DE AQUINO (MG)";"MG";"SAO TOMAS DE AQUINO";88;27;15;130
2014;"SAO TOME DAS LETRAS (MG)";"MG";"SAO TOME DAS LETRAS";96;12;20;128
2014;"SAO VICENTE DE MINAS (MG)";"MG";"SAO VICENTE DE MINAS";120;26;5;151
2014;"SAPUCAI MIRIM (MG)";"MG";"SAPUCAI MIRIM";226;45;17;288
2014;"SARDOA (MG)";"MG";"SARDOA";59;9;10;78
2014;"SARZEDO (MG)";"MG";"SARZEDO";781;66;91;938
2014;"SEM PEIXE (MG)";"MG";"SEM PEIXE";18;5;14;37
2014;"SENADOR AMARAL (MG)";"MG";"SENADOR AMARAL";113;11;10;134
2014;"SENADOR CORTES (MG)";"MG";"SENADOR CORTES";19;6;3;28
2014;"SENADOR FIRMINO (MG)";"MG";"SENADOR FIRMINO";111;11;26;148
2014;"SENADOR JOSE BENTO (MG)";"MG";"SENADOR JOSE BENTO";15;2;8;25
2014;"SENADOR MODESTINO GONCALVES (MG)";"MG";"SENADOR MODESTINO GONCALVES";33;7;13;53
2014;"SENHORA DE OLIVEIRA (MG)";"MG";"SENHORA DE OLIVEIRA";71;4;15;90
2014;"SENHORA DO PORTO (MG)";"MG";"SENHORA DO PORTO";30;6;13;49
2014;"SENHORA DOS REMEDIOS (MG)";"MG";"SENHORA DOS REMEDIOS";117;37;25;179
2014;"SERICITA (MG)";"MG";"SERICITA";108;3;9;120
2014;"SERITINGA (MG)";"MG";"SERITINGA";27;2;4;33
2014;"SERRA AZUL DE MINAS (MG)";"MG";"SERRA AZUL DE MINAS";21;7;11;39
2014;"SERRA DA SAUDADE (MG)";"MG";"SERRA DA SAUDADE";8;5;2;15
2014;"SERRA DO SALITRE (MG)";"MG";"SERRA DO SALITRE";257;16;93;366
2014;"SERRA DOS AIMORES (MG)";"MG";"SERRA DOS AIMORES";78;5;28;111
2014;"SERRANIA (MG)";"MG";"SERRANIA";129;20;20;169
2014;"SERRANOPOLIS DE MINAS (MG)";"MG";"SERRANOPOLIS DE MINAS";20;0;18;38
2014;"SERRANOS (MG)";"MG";"SERRANOS";19;7;4;30
2014;"SERRO (MG)";"MG";"SERRO";184;33;73;290
2014;"SETE LAGOAS (MG)";"MG";"SETE LAGOAS";3511;461;742;4714
2014;"SETUBINHA (MG)";"MG";"SETUBINHA";29;6;27;62
2014;"SILVEIRANIA (MG)";"MG";"SILVEIRANIA";16;4;6;26
2014;"SILVIANOPOLIS (MG)";"MG";"SILVIANOPOLIS";95;10;13;118
2014;"SIMAO PEREIRA (MG)";"MG";"SIMAO PEREIRA";49;13;6;68
2014;"SIMONESIA (MG)";"MG";"SIMONESIA";261;17;46;324
2014;"SOBRALIA (MG)";"MG";"SOBRALIA";44;5;10;59
2014;"SOLEDADE DE MINAS (MG)";"MG";"SOLEDADE DE MINAS";56;14;3;73
2014;"TABULEIRO (MG)";"MG";"TABULEIRO";86;6;12;104
2014;"TAIOBEIRAS (MG)";"MG";"TAIOBEIRAS";740;35;187;962
2014;"TAPARUBA (MG)";"MG";"TAPARUBA";32;3;11;46
2014;"TAPIRA (MG)";"MG";"TAPIRA";122;7;29;158
2014;"TAPIRAI (MG)";"MG";"TAPIRAI";19;7;5;31
2014;"TAQUARACU DE MINAS (MG)";"MG";"TAQUARACU DE MINAS";109;10;15;134
2014;"TARUMIRIM (MG)";"MG";"TARUMIRIM";149;20;28;197
2014;"TEIXEIRAS (MG)";"MG";"TEIXEIRAS";162;14;20;196
2014;"TEOFILO OTONI (MG)";"MG";"TEOFILO OTONI";1551;205;176;1932
2014;"TIMOTEO (MG)";"MG";"TIMOTEO";1025;216;142;1383
2014;"TIRADENTES (MG)";"MG";"TIRADENTES";91;20;12;123
2014;"TIROS (MG)";"MG";"TIROS";174;19;15;208
2014;"TOCANTINS (MG)";"MG";"TOCANTINS";264;12;22;298
2014;"TOCOS DO MOJI (MG)";"MG";"TOCOS DO MOJI";56;15;14;85
2014;"TOLEDO (MG)";"MG";"TOLEDO";120;9;19;148
2014;"TOMBOS (MG)";"MG";"TOMBOS";120;30;31;181
2014;"TRES CORACOES (MG)";"MG";"TRES CORACOES";1025;102;217;1344
2014;"TRES MARIAS (MG)";"MG";"TRES MARIAS";421;50;98;569
2014;"TRES PONTAS (MG)";"MG";"TRES PONTAS";1084;130;214;1428
2014;"TUMIRITINGA (MG)";"MG";"TUMIRITINGA";34;7;10;51
2014;"TUPACIGUARA (MG)";"MG";"TUPACIGUARA";559;89;83;731
2014;"TURMALINA (MG)";"MG";"TURMALINA";362;42;77;481
2014;"TURVOLANDIA (MG)";"MG";"TURVOLANDIA";111;34;8;153
2014;"UBA (MG)";"MG";"UBA";2125;110;188;2423
2014;"UBAI (MG)";"MG";"UBAI";43;13;31;87
2014;"UBAPORANGA (MG)";"MG";"UBAPORANGA";168;12;25;205
2014;"UBERABA (MG)";"MG";"UBERABA";5033;1042;1086;7161
2014;"UBERLANDIA (MG)";"MG";"UBERLANDIA";12067;1198;1549;14814
2014;"UMBURATIBA (MG)";"MG";"UMBURATIBA";8;4;3;15
2014;"UNAI (MG)";"MG";"UNAI";1549;91;391;2031
2014;"UNIAO DE MINAS (MG)";"MG";"UNIAO DE MINAS";52;8;39;99
2014;"URUANA DE MINAS (MG)";"MG";"URUANA DE MINAS";26;4;13;43
2014;"URUCANIA (MG)";"MG";"URUCANIA";166;12;55;233
2014;"URUCUIA (MG)";"MG";"URUCUIA";98;8;38;144
2014;"VARGEM ALEGRE (MG)";"MG";"VARGEM ALEGRE";72;6;10;88
2014;"VARGEM BONITA (MG)";"MG";"VARGEM BONITA";37;3;8;48
2014;"VARGEM GRANDE DO RIO PARDO (MG)";"MG";"VARGEM GRANDE DO RIO PARDO";60;10;16;86
2014;"VARGINHA (MG)";"MG";"VARGINHA";2281;195;309;2785
2014;"VARJAO DE MINAS (MG)";"MG";"VARJAO DE MINAS";96;13;50;159
2014;"VARZEA DA PALMA (MG)";"MG";"VARZEA DA PALMA";483;22;100;605
2014;"VARZELANDIA (MG)";"MG";"VARZELANDIA";68;12;44;124
2014;"VAZANTE (MG)";"MG";"VAZANTE";345;43;91;479
2014;"VERDELANDIA (MG)";"MG";"VERDELANDIA";19;3;10;32
2014;"VEREDINHA (MG)";"MG";"VEREDINHA";51;16;22;89
2014;"VERISSIMO (MG)";"MG";"VERISSIMO";39;31;6;76
2014;"VERMELHO NOVO (MG)";"MG";"VERMELHO NOVO";105;12;27;144
2014;"VESPASIANO (MG)";"MG";"VESPASIANO";1138;238;206;1582
2014;"VICOSA (MG)";"MG";"VICOSA";716;171;203;1090
2014;"VIEIRAS (MG)";"MG";"VIEIRAS";44;13;9;66
2014;"VIRGEM DA LAPA (MG)";"MG";"VIRGEM DA LAPA";73;11;28;112
2014;"VIRGINIA (MG)";"MG";"VIRGINIA";175;17;6;198
2014;"VIRGINOPOLIS (MG)";"MG";"VIRGINOPOLIS";110;6;30;146
2014;"VIRGOLANDIA (MG)";"MG";"VIRGOLANDIA";26;6;11;43
2014;"VISCONDE DO RIO BRANCO (MG)";"MG";"VISCONDE DO RIO BRANCO";1079;60;72;1211
2014;"VOLTA GRANDE (MG)";"MG";"VOLTA GRANDE";51;14;8;73
2014;"WENCESLAU BRAZ (MG)";"MG";"WENCESLAU BRAZ";38;7;9;54
2014;"AGUA CLARA (MS)";"MS";"AGUA CLARA";395;29;100;524
2014;"ALCINOPOLIS (MS)";"MS";"ALCINOPOLIS";100;21;18;139
2014;"AMAMBAI (MS)";"MS";"AMAMBAI";720;24;71;815
2014;"ANASTACIO (MS)";"MS";"ANASTACIO";405;28;31;464
2014;"ANAURILANDIA (MS)";"MS";"ANAURILANDIA";110;18;60;188
2014;"ANGELICA (MS)";"MS";"ANGELICA";273;58;70;401
2014;"ANTONIO JOAO (MS)";"MS";"ANTONIO JOAO";125;5;27;157
2014;"APARECIDA DO TABOADO (MS)";"MS";"APARECIDA DO TABOADO";453;41;58;552
2014;"AQUIDAUANA (MS)";"MS";"AQUIDAUANA";376;24;78;478
2014;"ARAL MOREIRA (MS)";"MS";"ARAL MOREIRA";213;14;28;255
2014;"BANDEIRANTES (MS)";"MS";"BANDEIRANTES";195;16;49;260
2014;"BATAGUASSU (MS)";"MS";"BATAGUASSU";453;47;208;708
2014;"BATAYPORA (MS)";"MS";"BATAYPORA";186;14;33;233
2014;"BELA VISTA (MS)";"MS";"BELA VISTA";289;42;58;389
2014;"BODOQUENA (MS)";"MS";"BODOQUENA";100;25;40;165
2014;"BONITO (MS)";"MS";"BONITO";310;77;72;459
2014;"BRASILANDIA (MS)";"MS";"BRASILANDIA";264;37;77;378
2014;"CAARAPO (MS)";"MS";"CAARAPO";587;15;142;744
2014;"CAMAPUA (MS)";"MS";"CAMAPUA";355;43;45;443
2014;"CAMPO GRANDE (MS)";"MS";"CAMPO GRANDE";14390;962;2215;17567
2014;"CARACOL (MS)";"MS";"CARACOL";62;17;14;93
2014;"CASSILANDIA (MS)";"MS";"CASSILANDIA";499;22;55;576
2014;"CHAPADAO DO SUL (MS)";"MS";"CHAPADAO DO SUL";889;31;117;1037
2014;"CORGUINHO (MS)";"MS";"CORGUINHO";64;13;25;102
2014;"CORONEL SAPUCAIA (MS)";"MS";"CORONEL SAPUCAIA";332;10;33;375
2014;"CORUMBA (MS)";"MS";"CORUMBA";891;82;236;1209
2014;"COSTA RICA (MS)";"MS";"COSTA RICA";521;21;139;681
2014;"COXIM (MS)";"MS";"COXIM";632;22;75;729
2014;"DEODAPOLIS (MS)";"MS";"DEODAPOLIS";255;24;105;384
2014;"DOIS IRMAOS DO BURITI (MS)";"MS";"DOIS IRMAOS DO BURITI";146;21;36;203
2014;"DOURADINA (MS)";"MS";"DOURADINA";280;13;25;318
2014;"DOURADOS (MS)";"MS";"DOURADOS";4050;223;535;4808
2014;"ELDORADO (MS)";"MS";"ELDORADO";266;15;36;317
2014;"FATIMA DO SUL (MS)";"MS";"FATIMA DO SUL";435;17;32;484
2014;"FIGUEIRAO (MS)";"MS";"FIGUEIRAO";45;22;5;72
2014;"GLORIA DE DOURADOS (MS)";"MS";"GLORIA DE DOURADOS";227;13;40;280
2014;"GUIA LOPES DA LAGUNA (MS)";"MS";"GUIA LOPES DA LAGUNA";191;20;33;244
2014;"IGUATEMI (MS)";"MS";"IGUATEMI";262;9;73;344
2014;"INOCENCIA (MS)";"MS";"INOCENCIA";186;8;40;234
2014;"ITAPORA (MS)";"MS";"ITAPORA";443;28;50;521
2014;"ITAQUIRAI (MS)";"MS";"ITAQUIRAI";249;14;106;369
2014;"IVINHEMA (MS)";"MS";"IVINHEMA";693;44;198;935
2014;"JAPORA (MS)";"MS";"JAPORA";39;4;20;63
2014;"JARAGUARI (MS)";"MS";"JARAGUARI";77;7;19;103
2014;"JARDIM (MS)";"MS";"JARDIM";472;32;54;558
2014;"JATEI (MS)";"MS";"JATEI";58;26;93;177
2014;"JUTI (MS)";"MS";"JUTI";82;9;21;112
2014;"LADARIO (MS)";"MS";"LADARIO";157;22;64;243
2014;"LAGUNA CARAPA (MS)";"MS";"LAGUNA CARAPA";191;4;28;223
2014;"MARACAJU (MS)";"MS";"MARACAJU";1048;34;130;1212
2014;"MIRANDA (MS)";"MS";"MIRANDA";362;29;101;492
2014;"MUNDO NOVO (MS)";"MS";"MUNDO NOVO";317;41;26;384
2014;"NAVIRAI (MS)";"MS";"NAVIRAI";940;46;174;1160
2014;"NIOAQUE (MS)";"MS";"NIOAQUE";174;25;57;256
2014;"NOVA ALVORADA DO SUL (MS)";"MS";"NOVA ALVORADA DO SUL";401;29;83;513
2014;"NOVA ANDRADINA (MS)";"MS";"NOVA ANDRADINA";1108;35;248;1391
2014;"NOVO HORIZONTE DO SUL (MS)";"MS";"NOVO HORIZONTE DO SUL";76;9;24;109
2014;"PARAISO DAS AGUAS (MS)";"MS";"PARAISO DAS AGUAS";26;15;10;51
2014;"PARANAIBA (MS)";"MS";"PARANAIBA";910;41;116;1067
2014;"PARANHOS (MS)";"MS";"PARANHOS";122;5;31;158
2014;"PEDRO GOMES (MS)";"MS";"PEDRO GOMES";99;6;16;121
2014;"PONTA PORA (MS)";"MS";"PONTA PORA";1920;105;331;2356
2014;"PORTO MURTINHO (MS)";"MS";"PORTO MURTINHO";87;12;27;126
2014;"RIBAS DO RIO PARDO (MS)";"MS";"RIBAS DO RIO PARDO";624;51;80;755
2014;"RIO BRILHANTE (MS)";"MS";"RIO BRILHANTE";726;66;135;927
2014;"RIO NEGRO (MS)";"MS";"RIO NEGRO";84;13;11;108
2014;"RIO VERDE DE MATO GROSSO (MS)";"MS";"RIO VERDE DE MATO GROSSO";389;20;31;440
2014;"ROCHEDO (MS)";"MS";"ROCHEDO";67;4;11;82
2014;"SANTA RITA DO PARDO (MS)";"MS";"SANTA RITA DO PARDO";126;8;33;167
2014;"SAO GABRIEL DO OESTE (MS)";"MS";"SAO GABRIEL DO OESTE";976;28;88;1092
2014;"SELVIRIA (MS)";"MS";"SELVIRIA";112;15;25;152
2014;"SETE QUEDAS (MS)";"MS";"SETE QUEDAS";239;10;21;270
2014;"SIDROLANDIA (MS)";"MS";"SIDROLANDIA";699;110;251;1060
2014;"SONORA (MS)";"MS";"SONORA";236;19;95;350
2014;"TACURU (MS)";"MS";"TACURU";121;7;22;150
2014;"TAQUARUSSU (MS)";"MS";"TAQUARUSSU";51;5;15;71
2014;"TERENOS (MS)";"MS";"TERENOS";368;17;59;444
2014;"TRES LAGOAS (MS)";"MS";"TRES LAGOAS";1850;201;463;2514
2014;"VICENTINA (MS)";"MS";"VICENTINA";144;8;115;267
2014;"ACORIZAL (MT)";"MT";"ACORIZAL";20;4;4;28
2014;"AGUA BOA (MT)";"MT";"AGUA BOA";659;19;49;727
2014;"ALTA FLORESTA (MT)";"MT";"ALTA FLORESTA";1340;27;137;1504
2014;"ALTO ARAGUAIA (MT)";"MT";"ALTO ARAGUAIA";189;25;43;257
2014;"ALTO BOA VISTA (MT)";"MT";"ALTO BOA VISTA";49;0;6;55
2014;"ALTO GARCAS (MT)";"MT";"ALTO GARCAS";301;17;51;369
2014;"ALTO PARAGUAI (MT)";"MT";"ALTO PARAGUAI";44;7;8;59
2014;"ALTO TAQUARI (MT)";"MT";"ALTO TAQUARI";238;24;25;287
2014;"APIACAS (MT)";"MT";"APIACAS";130;10;9;149
2014;"ARAGUAIANA (MT)";"MT";"ARAGUAIANA";14;0;3;17
2014;"ARAGUAINHA (MT)";"MT";"ARAGUAINHA";8;1;1;10
2014;"ARAPUTANGA (MT)";"MT";"ARAPUTANGA";281;9;25;315
2014;"ARENAPOLIS (MT)";"MT";"ARENAPOLIS";203;11;62;276
2014;"ARIPUANA (MT)";"MT";"ARIPUANA";412;9;45;466
2014;"BARAO DE MELGACO (MT)";"MT";"BARAO DE MELGACO";14;5;4;23
2014;"BARRA DO BUGRES (MT)";"MT";"BARRA DO BUGRES";570;20;151;741
2014;"BARRA DO GARCAS (MT)";"MT";"BARRA DO GARCAS";875;35;189;1099
2014;"BOM JESUS DO ARAGUAIA (MT)";"MT";"BOM JESUS DO ARAGUAIA";59;1;16;76
2014;"BRASNORTE (MT)";"MT";"BRASNORTE";338;9;64;411
2014;"CACERES (MT)";"MT";"CACERES";885;56;291;1232
2014;"CAMPINAPOLIS (MT)";"MT";"CAMPINAPOLIS";90;6;17;113
2014;"CAMPO NOVO DO PARECIS (MT)";"MT";"CAMPO NOVO DO PARECIS";750;61;131;942
2014;"CAMPO VERDE (MT)";"MT";"CAMPO VERDE";943;55;145;1143
2014;"CAMPOS DE JULIO (MT)";"MT";"CAMPOS DE JULIO";189;14;37;240
2014;"CANABRAVA DO NORTE (MT)";"MT";"CANABRAVA DO NORTE";41;0;9;50
2014;"CANARANA (MT)";"MT";"CANARANA";570;16;30;616
2014;"CARLINDA (MT)";"MT";"CARLINDA";145;1;23;169
2014;"CASTANHEIRA (MT)";"MT";"CASTANHEIRA";137;2;21;160
2014;"CHAPADA DOS GUIMARAES (MT)";"MT";"CHAPADA DOS GUIMARAES";208;30;49;287
2014;"CLAUDIA (MT)";"MT";"CLAUDIA";419;6;27;452
2014;"COCALINHO (MT)";"MT";"COCALINHO";33;1;9;43
2014;"COLIDER (MT)";"MT";"COLIDER";895;20;122;1037
2014;"COLNIZA (MT)";"MT";"COLNIZA";382;0;21;403
2014;"COMODORO (MT)";"MT";"COMODORO";521;10;86;617
2014;"CONFRESA (MT)";"MT";"CONFRESA";280;7;58;345
2014;"CONQUISTA D OESTE (MT)";"MT";"CONQUISTA D OESTE";43;3;14;60
2014;"COTRIGUACU (MT)";"MT";"COTRIGUACU";155;5;40;200
2014;"CUIABA (MT)";"MT";"CUIABA";10140;878;3187;14205
2014;"CURVELANDIA (MT)";"MT";"CURVELANDIA";86;0;18;104
2014;"DENISE (MT)";"MT";"DENISE";78;6;33;117
2014;"DIAMANTINO (MT)";"MT";"DIAMANTINO";496;21;91;608
2014;"DOM AQUINO (MT)";"MT";"DOM AQUINO";135;10;24;169
2014;"FELIZ NATAL (MT)";"MT";"FELIZ NATAL";258;3;27;288
2014;"FIGUEIROPOLIS D OESTE (MT)";"MT";"FIGUEIROPOLIS D OESTE";76;3;10;89
2014;"GAUCHA DO NORTE (MT)";"MT";"GAUCHA DO NORTE";121;5;22;148
2014;"GENERAL CARNEIRO (MT)";"MT";"GENERAL CARNEIRO";27;5;6;38
2014;"GLORIA D OESTE (MT)";"MT";"GLORIA D OESTE";58;3;17;78
2014;"GUARANTA DO NORTE (MT)";"MT";"GUARANTA DO NORTE";969;14;75;1058
2014;"GUIRATINGA (MT)";"MT";"GUIRATINGA";189;12;14;215
2014;"INDIAVAI (MT)";"MT";"INDIAVAI";17;3;7;27
2014;"IPIRANGA DO NORTE (MT)";"MT";"IPIRANGA DO NORTE";155;3;9;167
2014;"ITANHANGA (MT)";"MT";"ITANHANGA";177;4;18;199
2014;"ITAUBA (MT)";"MT";"ITAUBA";136;8;11;155
2014;"ITIQUIRA (MT)";"MT";"ITIQUIRA";137;24;82;243
2014;"JACIARA (MT)";"MT";"JACIARA";635;45;149;829
2014;"JANGADA (MT)";"MT";"JANGADA";50;8;23;81
2014;"JAURU (MT)";"MT";"JAURU";158;11;39;208
2014;"JUARA (MT)";"MT";"JUARA";838;20;68;926
2014;"JUINA (MT)";"MT";"JUINA";1004;20;90;1114
2014;"JURUENA (MT)";"MT";"JURUENA";194;2;17;213
2014;"JUSCIMEIRA (MT)";"MT";"JUSCIMEIRA";150;7;63;220
2014;"LAMBARI D OESTE (MT)";"MT";"LAMBARI D OESTE";88;3;29;120
2014;"LUCAS DO RIO VERDE (MT)";"MT";"LUCAS DO RIO VERDE";1684;56;144;1884
2014;"LUCIARA (MT)";"MT";"LUCIARA";12;0;3;15
2014;"MARCELANDIA (MT)";"MT";"MARCELANDIA";397;7;20;424
2014;"MATUPA (MT)";"MT";"MATUPA";424;10;50;484
2014;"MIRASSOL D OESTE (MT)";"MT";"MIRASSOL D OESTE";771;9;89;869
2014;"NOBRES (MT)";"MT";"NOBRES";317;28;64;409
2014;"NORTELANDIA (MT)";"MT";"NORTELANDIA";78;9;17;104
2014;"NOSSA SENHORA DO LIVRAMENTO (MT)";"MT";"NOSSA SENHORA DO LIVRAMENTO";93;6;34;133
2014;"NOVA BANDEIRANTES (MT)";"MT";"NOVA BANDEIRANTES";198;3;32;233
2014;"NOVA BRASILANDIA (MT)";"MT";"NOVA BRASILANDIA";61;2;12;75
2014;"NOVA CANAA DO NORTE (MT)";"MT";"NOVA CANAA DO NORTE";225;8;67;300
2014;"NOVA GUARITA (MT)";"MT";"NOVA GUARITA";104;1;17;122
2014;"NOVA LACERDA (MT)";"MT";"NOVA LACERDA";120;1;31;152
2014;"NOVA MARILANDIA (MT)";"MT";"NOVA MARILANDIA";39;6;11;56
2014;"NOVA MARINGA (MT)";"MT";"NOVA MARINGA";129;1;11;141
2014;"NOVA MONTE VERDE (MT)";"MT";"NOVA MONTE VERDE";158;4;12;174
2014;"NOVA MUTUM (MT)";"MT";"NOVA MUTUM";1107;23;117;1247
2014;"NOVA NAZARE (MT)";"MT";"NOVA NAZARE";6;6;4;16
2014;"NOVA OLIMPIA (MT)";"MT";"NOVA OLIMPIA";354;12;147;513
2014;"NOVA SANTA HELENA (MT)";"MT";"NOVA SANTA HELENA";69;4;12;85
2014;"NOVA UBIRATA (MT)";"MT";"NOVA UBIRATA";203;19;33;255
2014;"NOVA XAVANTINA (MT)";"MT";"NOVA XAVANTINA";437;25;49;511
2014;"NOVO HORIZONTE DO NORTE (MT)";"MT";"NOVO HORIZONTE DO NORTE";48;1;15;64
2014;"NOVO MUNDO (MT)";"MT";"NOVO MUNDO";110;2;21;133
2014;"NOVO SANTO ANTONIO (MT)";"MT";"NOVO SANTO ANTONIO";1;0;2;3
2014;"NOVO SAO JOAQUIM (MT)";"MT";"NOVO SAO JOAQUIM";102;1;17;120
2014;"PARANAITA (MT)";"MT";"PARANAITA";230;12;75;317
2014;"PARANATINGA (MT)";"MT";"PARANATINGA";473;19;70;562
2014;"PEDRA PRETA (MT)";"MT";"PEDRA PRETA";341;11;51;403
2014;"PEIXOTO DE AZEVEDO (MT)";"MT";"PEIXOTO DE AZEVEDO";415;12;73;500
2014;"PLANALTO DA SERRA (MT)";"MT";"PLANALTO DA SERRA";23;1;9;33
2014;"POCONE (MT)";"MT";"POCONE";479;26;36;541
2014;"PONTAL DO ARAGUAIA (MT)";"MT";"PONTAL DO ARAGUAIA";30;2;2;34
2014;"PONTE BRANCA (MT)";"MT";"PONTE BRANCA";6;1;1;8
2014;"PONTES E LACERDA (MT)";"MT";"PONTES E LACERDA";972;23;117;1112
2014;"PORTO ALEGRE DO NORTE (MT)";"MT";"PORTO ALEGRE DO NORTE";78;6;33;117
2014;"PORTO DOS GAUCHOS (MT)";"MT";"PORTO DOS GAUCHOS";127;11;10;148
2014;"PORTO ESPERIDIAO (MT)";"MT";"PORTO ESPERIDIAO";149;8;50;207
2014;"PORTO ESTRELA (MT)";"MT";"PORTO ESTRELA";29;4;9;42
2014;"POXOREO (MT)";"MT";"POXOREO";130;21;47;198
2014;"PRIMAVERA DO LESTE (MT)";"MT";"PRIMAVERA DO LESTE";2035;100;178;2313
2014;"QUERENCIA (MT)";"MT";"QUERENCIA";361;27;29;417
2014;"RESERVA DO CABACAL (MT)";"MT";"RESERVA DO CABACAL";19;1;8;28
2014;"RIBEIRAO CASCALHEIRA (MT)";"MT";"RIBEIRAO CASCALHEIRA";123;12;18;153
2014;"RIBEIRAOZINHO (MT)";"MT";"RIBEIRAOZINHO";7;1;7;15
2014;"RIO BRANCO (MT)";"MT";"RIO BRANCO";86;3;32;121
2014;"RONDOLANDIA (MT)";"MT";"RONDOLANDIA";25;0;16;41
2014;"RONDONOPOLIS (MT)";"MT";"RONDONOPOLIS";4637;190;519;5346
2014;"ROSARIO OESTE (MT)";"MT";"ROSARIO OESTE";170;14;32;216
2014;"SALTO DO CEU (MT)";"MT";"SALTO DO CEU";55;7;23;85
2014;"SANTA CARMEM (MT)";"MT";"SANTA CARMEM";147;3;14;164
2014;"SANTA CRUZ DO XINGU (MT)";"MT";"SANTA CRUZ DO XINGU";11;1;6;18
2014;"SANTA RITA DO TRIVELATO (MT)";"MT";"SANTA RITA DO TRIVELATO";77;5;9;91
2014;"SANTA TEREZINHA (MT)";"MT";"SANTA TEREZINHA";11;2;16;29
2014;"SANTO AFONSO (MT)";"MT";"SANTO AFONSO";27;3;12;42
2014;"SANTO ANTONIO DO LESTE (MT)";"MT";"SANTO ANTONIO DO LESTE";70;4;19;93
2014;"SANTO ANTONIO DO LEVERGER (MT)";"MT";"SANTO ANTONIO DO LEVERGER";115;8;16;139
2014;"SAO FELIX DO ARAGUAIA (MT)";"MT";"SAO FELIX DO ARAGUAIA";50;8;23;81
2014;"SAO JOSE DO POVO (MT)";"MT";"SAO JOSE DO POVO";17;3;5;25
2014;"SAO JOSE DO RIO CLARO (MT)";"MT";"SAO JOSE DO RIO CLARO";340;16;53;409
2014;"SAO JOSE DO XINGU (MT)";"MT";"SAO JOSE DO XINGU";28;1;13;42
2014;"SAO JOSE DOS QUATRO MARCOS (MT)";"MT";"SAO JOSE DOS QUATRO MARCOS";474;11;70;555
2014;"SAO PEDRO DA CIPA (MT)";"MT";"SAO PEDRO DA CIPA";23;7;23;53
2014;"SAPEZAL (MT)";"MT";"SAPEZAL";577;44;99;720
2014;"SERRA NOVA DOURADA (MT)";"MT";"SERRA NOVA DOURADA";8;1;2;11
2014;"SINOP (MT)";"MT";"SINOP";3565;121;198;3884
2014;"SORRISO (MT)";"MT";"SORRISO";2385;72;182;2639
2014;"TABAPORA (MT)";"MT";"TABAPORA";162;5;27;194
2014;"TANGARA DA SERRA (MT)";"MT";"TANGARA DA SERRA";2048;87;210;2345
2014;"TAPURAH (MT)";"MT";"TAPURAH";350;6;36;392
2014;"TERRA NOVA DO NORTE (MT)";"MT";"TERRA NOVA DO NORTE";290;11;34;335
2014;"TESOURO (MT)";"MT";"TESOURO";18;4;3;25
2014;"TORIXOREU (MT)";"MT";"TORIXOREU";37;3;5;45
2014;"UNIAO DO SUL (MT)";"MT";"UNIAO DO SUL";104;0;12;116
2014;"VALE DE SAO DOMINGOS (MT)";"MT";"VALE DE SAO DOMINGOS";27;0;16;43
2014;"VARZEA GRANDE (MT)";"MT";"VARZEA GRANDE";5008;324;599;5931
2014;"VERA (MT)";"MT";"VERA";266;5;26;297
2014;"VILA BELA DA SANTISSIMA TRINDA (MT)";"MT";"VILA BELA DA SANTISSIMA TRINDA";123;3;39;165
2014;"VILA RICA (MT)";"MT";"VILA RICA";281;1;39;321
2014;"ABAETETUBA (PA)";"PA";"ABAETETUBA";346;26;259;631
2014;"ABEL FIGUEIREDO (PA)";"PA";"ABEL FIGUEIREDO";66;5;4;75
2014;"ACARA (PA)";"PA";"ACARA";90;8;77;175
2014;"AFUA (PA)";"PA";"AFUA";2;0;0;2
2014;"AGUA AZUL DO NORTE (PA)";"PA";"AGUA AZUL DO NORTE";72;8;28;108
2014;"ALENQUER (PA)";"PA";"ALENQUER";193;6;52;251
2014;"ALMEIRIM (PA)";"PA";"ALMEIRIM";257;22;115;394
2014;"ALTAMIRA (PA)";"PA";"ALTAMIRA";1949;172;570;2691
2014;"ANAJAS (PA)";"PA";"ANAJAS";0;0;1;1
2014;"ANANINDEUA (PA)";"PA";"ANANINDEUA";4451;394;1514;6359
2014;"ANAPU (PA)";"PA";"ANAPU";89;16;11;116
2014;"AUGUSTO CORREA (PA)";"PA";"AUGUSTO CORREA";48;1;55;104
2014;"AURORA DO PARA (PA)";"PA";"AURORA DO PARA";80;11;73;164
2014;"AVEIRO (PA)";"PA";"AVEIRO";3;0;5;8
2014;"BAGRE (PA)";"PA";"BAGRE";1;0;2;3
2014;"BAIAO (PA)";"PA";"BAIAO";48;5;17;70
2014;"BANNACH (PA)";"PA";"BANNACH";18;0;3;21
2014;"BARCARENA (PA)";"PA";"BARCARENA";949;172;657;1778
2014;"BELEM (PA)";"PA";"BELEM";8742;1911;3671;14324
2014;"BELTERRA (PA)";"PA";"BELTERRA";43;8;43;94
2014;"BENEVIDES (PA)";"PA";"BENEVIDES";850;56;115;1021
2014;"BOM JESUS DO TOCANTINS (PA)";"PA";"BOM JESUS DO TOCANTINS";73;9;9;91
2014;"BONITO (PA)";"PA";"BONITO";49;4;50;103
2014;"BRAGANCA (PA)";"PA";"BRAGANCA";439;32;184;655
2014;"BRASIL NOVO (PA)";"PA";"BRASIL NOVO";179;16;14;209
2014;"BREJO GRANDE DO ARAGUAIA (PA)";"PA";"BREJO GRANDE DO ARAGUAIA";25;4;9;38
2014;"BREU BRANCO (PA)";"PA";"BREU BRANCO";288;9;87;384
2014;"BREVES (PA)";"PA";"BREVES";57;4;10;71
2014;"BUJARU (PA)";"PA";"BUJARU";49;10;30;89
2014;"CACHOEIRA DO ARARI (PA)";"PA";"CACHOEIRA DO ARARI";12;6;14;32
2014;"CACHOEIRA DO PIRIA (PA)";"PA";"CACHOEIRA DO PIRIA";33;5;26;64
2014;"CAMETA (PA)";"PA";"CAMETA";150;13;65;228
2014;"CANAA DOS CARAJAS (PA)";"PA";"CANAA DOS CARAJAS";358;67;215;640
2014;"CAPANEMA (PA)";"PA";"CAPANEMA";708;26;113;847
2014;"CAPITAO POCO (PA)";"PA";"CAPITAO POCO";390;20;93;503
2014;"CASTANHAL (PA)";"PA";"CASTANHAL";2743;177;421;3341
2014;"CHAVES (PA)";"PA";"CHAVES";0;0;0;0
2014;"COLARES (PA)";"PA";"COLARES";9;0;4;13
2014;"CONCEICAO DO ARAGUAIA (PA)";"PA";"CONCEICAO DO ARAGUAIA";385;45;80;510
2014;"CONCORDIA DO PARA (PA)";"PA";"CONCORDIA DO PARA";150;11;76;237
2014;"CUMARU DO NORTE (PA)";"PA";"CUMARU DO NORTE";25;1;7;33
2014;"CURIONOPOLIS (PA)";"PA";"CURIONOPOLIS";125;90;12;227
2014;"CURRALINHO (PA)";"PA";"CURRALINHO";1;0;2;3
2014;"CURUA (PA)";"PA";"CURUA";7;1;3;11
2014;"CURUCA (PA)";"PA";"CURUCA";51;15;18;84
2014;"DOM ELISEU (PA)";"PA";"DOM ELISEU";546;57;50;653
2014;"ELDORADO DOS CARAJAS (PA)";"PA";"ELDORADO DOS CARAJAS";177;48;19;244
2014;"FARO (PA)";"PA";"FARO";3;1;1;5
2014;"FLORESTA DO ARAGUAIA (PA)";"PA";"FLORESTA DO ARAGUAIA";123;2;19;144
2014;"GARRAFAO DO NORTE (PA)";"PA";"GARRAFAO DO NORTE";112;6;19;137
2014;"GOIANESIA DO PARA (PA)";"PA";"GOIANESIA DO PARA";307;19;37;363
2014;"GURUPA (PA)";"PA";"GURUPA";8;0;3;11
2014;"IGARAPE ACU (PA)";"PA";"IGARAPE ACU";186;74;89;349
2014;"IGARAPE MIRI (PA)";"PA";"IGARAPE MIRI";83;21;38;142
2014;"INHANGAPI (PA)";"PA";"INHANGAPI";42;1;32;75
2014;"IPIXUNA DO PARA (PA)";"PA";"IPIXUNA DO PARA";70;9;45;124
2014;"IRITUIA (PA)";"PA";"IRITUIA";89;4;47;140
2014;"ITAITUBA (PA)";"PA";"ITAITUBA";1006;39;120;1165
2014;"ITUPIRANGA (PA)";"PA";"ITUPIRANGA";202;87;33;322
2014;"JACAREACANGA (PA)";"PA";"JACAREACANGA";25;1;1;27
2014;"JACUNDA (PA)";"PA";"JACUNDA";627;26;57;710
2014;"JURUTI (PA)";"PA";"JURUTI";95;11;12;118
2014;"LIMOEIRO DO AJURU (PA)";"PA";"LIMOEIRO DO AJURU";2;0;3;5
2014;"MAE DO RIO (PA)";"PA";"MAE DO RIO";338;30;64;432
2014;"MAGALHAES BARATA (PA)";"PA";"MAGALHAES BARATA";9;14;9;32
2014;"MARABA (PA)";"PA";"MARABA";3634;316;635;4585
2014;"MARACANA (PA)";"PA";"MARACANA";35;13;26;74
2014;"MARAPANIM (PA)";"PA";"MARAPANIM";45;15;31;91
2014;"MARITUBA (PA)";"PA";"MARITUBA";858;109;525;1492
2014;"MEDICILANDIA (PA)";"PA";"MEDICILANDIA";204;14;32;250
2014;"MELGACO (PA)";"PA";"MELGACO";7;0;4;11
2014;"MOCAJUBA (PA)";"PA";"MOCAJUBA";20;2;12;34
2014;"MOJU (PA)";"PA";"MOJU";204;21;193;418
2014;"MOJUI DOS CAMPOS (PA)";"PA";"MOJUI DOS CAMPOS";11;1;18;30
2014;"MONTE ALEGRE (PA)";"PA";"MONTE ALEGRE";274;12;141;427
2014;"MUANA (PA)";"PA";"MUANA";5;3;12;20
2014;"NOVA ESPERANCA DO PIRIA (PA)";"PA";"NOVA ESPERANCA DO PIRIA";83;4;23;110
2014;"NOVA IPIXUNA (PA)";"PA";"NOVA IPIXUNA";156;3;27;186
2014;"NOVA TIMBOTEUA (PA)";"PA";"NOVA TIMBOTEUA";66;3;25;94
2014;"NOVO PROGRESSO (PA)";"PA";"NOVO PROGRESSO";625;10;34;669
2014;"NOVO REPARTIMENTO (PA)";"PA";"NOVO REPARTIMENTO";451;29;49;529
2014;"OBIDOS (PA)";"PA";"OBIDOS";189;2;60;251
2014;"OEIRAS DO PARA (PA)";"PA";"OEIRAS DO PARA";10;1;13;24
2014;"ORIXIMINA (PA)";"PA";"ORIXIMINA";357;15;34;406
2014;"OUREM (PA)";"PA";"OUREM";169;3;19;191
2014;"OURILANDIA DO NORTE (PA)";"PA";"OURILANDIA DO NORTE";262;12;42;316
2014;"PACAJA (PA)";"PA";"PACAJA";128;25;13;166
2014;"PALESTINA DO PARA (PA)";"PA";"PALESTINA DO PARA";33;5;6;44
2014;"PARAGOMINAS (PA)";"PA";"PARAGOMINAS";1401;46;175;1622
2014;"PARAUAPEBAS (PA)";"PA";"PARAUAPEBAS";2267;685;1194;4146
2014;"PAU D ARCO (PA)";"PA";"PAU D ARCO";16;10;5;31
2014;"PEIXE BOI (PA)";"PA";"PEIXE BOI";24;6;14;44
2014;"PICARRA (PA)";"PA";"PICARRA";33;0;6;39
2014;"PLACAS (PA)";"PA";"PLACAS";81;6;3;90
2014;"PONTA DE PEDRAS (PA)";"PA";"PONTA DE PEDRAS";10;1;5;16
2014;"PORTEL (PA)";"PA";"PORTEL";24;1;11;36
2014;"PORTO DE MOZ (PA)";"PA";"PORTO DE MOZ";22;1;7;30
2014;"PRAINHA (PA)";"PA";"PRAINHA";36;0;5;41
2014;"PRIMAVERA (PA)";"PA";"PRIMAVERA";20;2;18;40
2014;"QUATIPURU (PA)";"PA";"QUATIPURU";12;5;12;29
2014;"REDENCAO (PA)";"PA";"REDENCAO";1582;84;149;1815
2014;"RIO MARIA (PA)";"PA";"RIO MARIA";287;33;53;373
2014;"RONDON DO PARA (PA)";"PA";"RONDON DO PARA";507;51;22;580
2014;"RUROPOLIS (PA)";"PA";"RUROPOLIS";210;10;16;236
2014;"SALINOPOLIS (PA)";"PA";"SALINOPOLIS";162;31;72;265
2014;"SALVATERRA (PA)";"PA";"SALVATERRA";35;34;25;94
2014;"SANTA BARBARA DO PARA (PA)";"PA";"SANTA BARBARA DO PARA";67;21;98;186
2014;"SANTA CRUZ DO ARARI (PA)";"PA";"SANTA CRUZ DO ARARI";5;0;1;6
2014;"SANTA ISABEL DO PARA (PA)";"PA";"SANTA ISABEL DO PARA";675;51;150;876
2014;"SANTA LUZIA DO PARA (PA)";"PA";"SANTA LUZIA DO PARA";119;11;34;164
2014;"SANTA MARIA DAS BARREIRAS (PA)";"PA";"SANTA MARIA DAS BARREIRAS";83;4;31;118
2014;"SANTA MARIA DO PARA (PA)";"PA";"SANTA MARIA DO PARA";307;22;47;376
2014;"SANTANA DO ARAGUAIA (PA)";"PA";"SANTANA DO ARAGUAIA";237;9;29;275
2014;"SANTAREM (PA)";"PA";"SANTAREM";2819;138;698;3655
2014;"SANTAREM NOVO (PA)";"PA";"SANTAREM NOVO";9;6;17;32
2014;"SANTO ANTONIO DO TAUA (PA)";"PA";"SANTO ANTONIO DO TAUA";145;27;95;267
2014;"SAO CAETANO DE ODIVELAS (PA)";"PA";"SAO CAETANO DE ODIVELAS";24;3;7;34
2014;"SAO DOMINGOS DO ARAGUAIA (PA)";"PA";"SAO DOMINGOS DO ARAGUAIA";161;25;27;213
2014;"SAO DOMINGOS DO CAPIM (PA)";"PA";"SAO DOMINGOS DO CAPIM";41;0;30;71
2014;"SAO FELIX DO XINGU (PA)";"PA";"SAO FELIX DO XINGU";318;8;33;359
2014;"SAO FRANCISCO DO PARA (PA)";"PA";"SAO FRANCISCO DO PARA";51;37;28;116
2014;"SAO GERALDO DO ARAGUAIA (PA)";"PA";"SAO GERALDO DO ARAGUAIA";127;5;17;149
2014;"SAO JOAO DA PONTA (PA)";"PA";"SAO JOAO DA PONTA";5;4;8;17
2014;"SAO JOAO DE PIRABAS (PA)";"PA";"SAO JOAO DE PIRABAS";35;10;21;66
2014;"SAO JOAO DO ARAGUAIA (PA)";"PA";"SAO JOAO DO ARAGUAIA";26;16;11;53
2014;"SAO MIGUEL DO GUAMA (PA)";"PA";"SAO MIGUEL DO GUAMA";427;24;116;567
2014;"SAO SEBASTIAO DA BOA VISTA (PA)";"PA";"SAO SEBASTIAO DA BOA VISTA";5;0;1;6
2014;"SAPUCAIA (PA)";"PA";"SAPUCAIA";33;4;10;47
2014;"SENADOR JOSE PORFIRIO (PA)";"PA";"SENADOR JOSE PORFIRIO";24;2;9;35
2014;"SOURE (PA)";"PA";"SOURE";35;4;17;56
2014;"TAILANDIA (PA)";"PA";"TAILANDIA";760;36;186;982
2014;"TERRA ALTA (PA)";"PA";"TERRA ALTA";25;16;20;61
2014;"TERRA SANTA (PA)";"PA";"TERRA SANTA";25;0;2;27
2014;"TOME ACU (PA)";"PA";"TOME ACU";516;18;161;695
2014;"TRACUATEUA (PA)";"PA";"TRACUATEUA";38;7;40;85
2014;"TRAIRAO (PA)";"PA";"TRAIRAO";128;2;8;138
2014;"TUCUMA (PA)";"PA";"TUCUMA";611;24;100;735
2014;"TUCURUI (PA)";"PA";"TUCURUI";873;94;213;1180
2014;"ULIANOPOLIS (PA)";"PA";"ULIANOPOLIS";194;22;38;254
2014;"URUARA (PA)";"PA";"URUARA";533;19;35;587
2014;"VIGIA (PA)";"PA";"VIGIA";156;19;83;258
2014;"VISEU (PA)";"PA";"VISEU";69;6;44;119
2014;"VITORIA DO XINGU (PA)";"PA";"VITORIA DO XINGU";38;15;17;70
2014;"XINGUARA (PA)";"PA";"XINGUARA";895;31;103;1029
2014;"AGUA BRANCA (PB)";"PB";"AGUA BRANCA";12;8;7;27
2014;"AGUIAR (PB)";"PB";"AGUIAR";10;7;2;19
2014;"ALAGOA GRANDE (PB)";"PB";"ALAGOA GRANDE";112;36;40;188
2014;"ALAGOA NOVA (PB)";"PB";"ALAGOA NOVA";153;38;13;204
2014;"ALAGOINHA (PB)";"PB";"ALAGOINHA";40;19;25;84
2014;"ALCANTIL (PB)";"PB";"ALCANTIL";54;16;17;87
2014;"ALGODAO DE JANDAIRA (PB)";"PB";"ALGODAO DE JANDAIRA";31;0;4;35
2014;"ALHANDRA (PB)";"PB";"ALHANDRA";166;26;25;217
2014;"AMPARO (PB)";"PB";"AMPARO";12;8;6;26
2014;"APARECIDA (PB)";"PB";"APARECIDA";43;5;16;64
2014;"ARACAGI (PB)";"PB";"ARACAGI";65;2;50;117
2014;"ARARA (PB)";"PB";"ARARA";74;10;20;104
2014;"ARARUNA (PB)";"PB";"ARARUNA";94;39;17;150
2014;"AREIA (PB)";"PB";"AREIA";118;42;26;186
2014;"AREIA DE BARAUNAS (PB)";"PB";"AREIA DE BARAUNAS";6;4;2;12
2014;"AREIAL (PB)";"PB";"AREIAL";43;4;10;57
2014;"AROEIRAS (PB)";"PB";"AROEIRAS";79;53;15;147
2014;"ASSUNCAO (PB)";"PB";"ASSUNCAO";29;8;5;42
2014;"BAIA DA TRAICAO (PB)";"PB";"BAIA DA TRAICAO";14;6;12;32
2014;"BANANEIRAS (PB)";"PB";"BANANEIRAS";98;30;29;157
2014;"BARAUNA (PB)";"PB";"BARAUNA";32;2;5;39
2014;"BARRA DE SANTA ROSA (PB)";"PB";"BARRA DE SANTA ROSA";95;8;20;123
2014;"BARRA DE SANTANA (PB)";"PB";"BARRA DE SANTANA";72;6;16;94
2014;"BARRA DE SAO MIGUEL (PB)";"PB";"BARRA DE SAO MIGUEL";10;2;5;17
2014;"BAYEUX (PB)";"PB";"BAYEUX";739;39;163;941
2014;"BELEM (PB)";"PB";"BELEM";127;11;12;150
2014;"BELEM DO BREJO DO CRUZ (PB)";"PB";"BELEM DO BREJO DO CRUZ";15;9;4;28
2014;"BERNARDINO BATISTA (PB)";"PB";"BERNARDINO BATISTA";4;0;5;9
2014;"BOA VENTURA (PB)";"PB";"BOA VENTURA";15;4;2;21
2014;"BOA VISTA (PB)";"PB";"BOA VISTA";106;9;19;134
2014;"BOM JESUS (PB)";"PB";"BOM JESUS";12;0;3;15
2014;"BOM SUCESSO (PB)";"PB";"BOM SUCESSO";12;2;8;22
2014;"BONITO DE SANTA FE (PB)";"PB";"BONITO DE SANTA FE";30;12;3;45
2014;"BOQUEIRAO (PB)";"PB";"BOQUEIRAO";205;12;24;241
2014;"BORBOREMA (PB)";"PB";"BORBOREMA";38;7;3;48
2014;"BREJO DO CRUZ (PB)";"PB";"BREJO DO CRUZ";78;14;7;99
2014;"BREJO DOS SANTOS (PB)";"PB";"BREJO DOS SANTOS";24;2;3;29
2014;"CAAPORA (PB)";"PB";"CAAPORA";51;10;11;72
2014;"CABACEIRAS (PB)";"PB";"CABACEIRAS";27;4;17;48
2014;"CABEDELO (PB)";"PB";"CABEDELO";526;47;27;600
2014;"CACHOEIRA DOS INDIOS (PB)";"PB";"CACHOEIRA DOS INDIOS";20;5;8;33
2014;"CACIMBA DE AREIA (PB)";"PB";"CACIMBA DE AREIA";6;2;5;13
2014;"CACIMBA DE DENTRO (PB)";"PB";"CACIMBA DE DENTRO";73;15;34;122
2014;"CACIMBAS (PB)";"PB";"CACIMBAS";7;9;3;19
2014;"CAICARA (PB)";"PB";"CAICARA";15;3;6;24
2014;"CAJAZEIRAS (PB)";"PB";"CAJAZEIRAS";474;47;60;581
2014;"CAJAZEIRINHAS (PB)";"PB";"CAJAZEIRINHAS";6;1;2;9
2014;"CALDAS BRANDAO (PB)";"PB";"CALDAS BRANDAO";41;4;8;53
2014;"CAMALAU (PB)";"PB";"CAMALAU";31;10;16;57
2014;"CAMPINA GRANDE (PB)";"PB";"CAMPINA GRANDE";4350;339;786;5475
2014;"CAMPO DE SANTANA (PB)";"PB";"CAMPO DE SANTANA";37;8;17;62
2014;"CAPIM (PB)";"PB";"CAPIM";32;11;16;59
2014;"CARAUBAS (PB)";"PB";"CARAUBAS";11;7;4;22
2014;"CARRAPATEIRA (PB)";"PB";"CARRAPATEIRA";4;1;3;8
2014;"CASSERENGUE (PB)";"PB";"CASSERENGUE";38;9;18;65
2014;"CATINGUEIRA (PB)";"PB";"CATINGUEIRA";14;4;2;20
2014;"CATOLE DO ROCHA (PB)";"PB";"CATOLE DO ROCHA";257;52;16;325
2014;"CATURITE (PB)";"PB";"CATURITE";111;13;13;137
2014;"CONCEICAO (PB)";"PB";"CONCEICAO";96;37;9;142
2014;"CONDADO (PB)";"PB";"CONDADO";40;6;9;55
2014;"CONDE (PB)";"PB";"CONDE";97;27;18;142
2014;"CONGO (PB)";"PB";"CONGO";23;7;6;36
2014;"COREMAS (PB)";"PB";"COREMAS";61;22;10;93
2014;"COXIXOLA (PB)";"PB";"COXIXOLA";5;7;0;12
2014;"CRUZ DO ESPIRITO SANTO (PB)";"PB";"CRUZ DO ESPIRITO SANTO";27;9;26;62
2014;"CUBATI (PB)";"PB";"CUBATI";49;5;5;59
2014;"CUITE (PB)";"PB";"CUITE";104;9;18;131
2014;"CUITE DE MAMANGUAPE (PB)";"PB";"CUITE DE MAMANGUAPE";14;8;30;52
2014;"CUITEGI (PB)";"PB";"CUITEGI";25;6;3;34
2014;"CURRAL DE CIMA (PB)";"PB";"CURRAL DE CIMA";14;6;19;39
2014;"CURRAL VELHO (PB)";"PB";"CURRAL VELHO";6;5;2;13
2014;"DAMIAO (PB)";"PB";"DAMIAO";34;5;9;48
2014;"DESTERRO (PB)";"PB";"DESTERRO";31;8;6;45
2014;"DIAMANTE (PB)";"PB";"DIAMANTE";18;2;3;23
2014;"DONA INES (PB)";"PB";"DONA INES";50;13;17;80
2014;"DUAS ESTRADAS (PB)";"PB";"DUAS ESTRADAS";12;4;6;22
2014;"EMAS (PB)";"PB";"EMAS";6;6;3;15
2014;"ESPERANCA (PB)";"PB";"ESPERANCA";541;28;99;668
2014;"FAGUNDES (PB)";"PB";"FAGUNDES";41;11;25;77
2014;"FREI MARTINHO (PB)";"PB";"FREI MARTINHO";10;1;6;17
2014;"GADO BRAVO (PB)";"PB";"GADO BRAVO";39;24;19;82
2014;"GUARABIRA (PB)";"PB";"GUARABIRA";549;68;176;793
2014;"GURINHEM (PB)";"PB";"GURINHEM";46;7;24;77
2014;"GURJAO (PB)";"PB";"GURJAO";16;2;5;23
2014;"IBIARA (PB)";"PB";"IBIARA";10;4;4;18
2014;"IGARACY (PB)";"PB";"IGARACY";15;10;5;30
2014;"IMACULADA (PB)";"PB";"IMACULADA";11;9;5;25
2014;"INGA (PB)";"PB";"INGA";120;14;31;165
2014;"ITABAIANA (PB)";"PB";"ITABAIANA";155;11;39;205
2014;"ITAPORANGA (PB)";"PB";"ITAPORANGA";144;35;24;203
2014;"ITAPOROROCA (PB)";"PB";"ITAPOROROCA";98;3;25;126
2014;"ITATUBA (PB)";"PB";"ITATUBA";39;4;11;54
2014;"JACARAU (PB)";"PB";"JACARAU";66;5;18;89
2014;"JERICO (PB)";"PB";"JERICO";24;4;1;29
2014;"JOAO PESSOA (PB)";"PB";"JOAO PESSOA";5991;1101;2412;9504
2014;"JUAREZ TAVORA (PB)";"PB";"JUAREZ TAVORA";32;4;14;50
2014;"JUAZEIRINHO (PB)";"PB";"JUAZEIRINHO";90;20;15;125
2014;"JUNCO DO SERIDO (PB)";"PB";"JUNCO DO SERIDO";58;5;4;67
2014;"JURIPIRANGA (PB)";"PB";"JURIPIRANGA";51;5;20;76
2014;"JURU (PB)";"PB";"JURU";12;6;3;21
2014;"LAGOA (PB)";"PB";"LAGOA";12;4;5;21
2014;"LAGOA DE DENTRO (PB)";"PB";"LAGOA DE DENTRO";37;7;13;57
2014;"LAGOA SECA (PB)";"PB";"LAGOA SECA";205;59;17;281
2014;"LASTRO (PB)";"PB";"LASTRO";4;4;4;12
2014;"LIVRAMENTO (PB)";"PB";"LIVRAMENTO";36;5;5;46
2014;"LOGRADOURO (PB)";"PB";"LOGRADOURO";6;3;12;21
2014;"LUCENA (PB)";"PB";"LUCENA";28;4;11;43
2014;"MAE D AGUA (PB)";"PB";"MAE D AGUA";8;0;4;12
2014;"MALTA (PB)";"PB";"MALTA";14;7;2;23
2014;"MAMANGUAPE (PB)";"PB";"MAMANGUAPE";429;16;87;532
2014;"MANAIRA (PB)";"PB";"MANAIRA";18;10;2;30
2014;"MARCACAO (PB)";"PB";"MARCACAO";4;5;13;22
2014;"MARI (PB)";"PB";"MARI";107;11;52;170
2014;"MARIZOPOLIS (PB)";"PB";"MARIZOPOLIS";33;5;2;40
2014;"MASSARANDUBA (PB)";"PB";"MASSARANDUBA";38;9;13;60
2014;"MATARACA (PB)";"PB";"MATARACA";40;4;16;60
2014;"MATINHAS (PB)";"PB";"MATINHAS";12;2;4;18
2014;"MATO GROSSO (PB)";"PB";"MATO GROSSO";11;3;3;17
2014;"MATUREIA (PB)";"PB";"MATUREIA";17;19;6;42
2014;"MOGEIRO (PB)";"PB";"MOGEIRO";36;6;6;48
2014;"MONTADAS (PB)";"PB";"MONTADAS";26;4;9;39
2014;"MONTE HOREBE (PB)";"PB";"MONTE HOREBE";7;3;5;15
2014;"MONTEIRO (PB)";"PB";"MONTEIRO";265;74;50;389
2014;"MULUNGU (PB)";"PB";"MULUNGU";47;7;16;70
2014;"NATUBA (PB)";"PB";"NATUBA";27;2;6;35
2014;"NAZAREZINHO (PB)";"PB";"NAZAREZINHO";29;6;4;39
2014;"NOVA FLORESTA (PB)";"PB";"NOVA FLORESTA";44;14;11;69
2014;"NOVA OLINDA (PB)";"PB";"NOVA OLINDA";21;9;6;36
2014;"NOVA PALMEIRA (PB)";"PB";"NOVA PALMEIRA";30;2;4;36
2014;"OLHO D AGUA (PB)";"PB";"OLHO D AGUA";8;9;3;20
2014;"OLIVEDOS (PB)";"PB";"OLIVEDOS";29;6;9;44
2014;"OURO VELHO (PB)";"PB";"OURO VELHO";13;3;4;20
2014;"PARARI (PB)";"PB";"PARARI";6;1;2;9
2014;"PASSAGEM (PB)";"PB";"PASSAGEM";17;0;2;19
2014;"PATOS (PB)";"PB";"PATOS";751;160;54;965
2014;"PAULISTA (PB)";"PB";"PAULISTA";62;10;13;85
2014;"PEDRA BRANCA (PB)";"PB";"PEDRA BRANCA";10;9;2;21
2014;"PEDRA LAVRADA (PB)";"PB";"PEDRA LAVRADA";48;5;10;63
2014;"PEDRAS DE FOGO (PB)";"PB";"PEDRAS DE FOGO";242;31;92;365
2014;"PEDRO REGIS (PB)";"PB";"PEDRO REGIS";22;1;4;27
2014;"PIANCO (PB)";"PB";"PIANCO";91;19;7;117
2014;"PICUI (PB)";"PB";"PICUI";139;12;42;193
2014;"PILAR (PB)";"PB";"PILAR";35;2;13;50
2014;"PILOES (PB)";"PB";"PILOES";29;3;9;41
2014;"PILOEZINHOS (PB)";"PB";"PILOEZINHOS";14;4;6;24
2014;"PIRPIRITUBA (PB)";"PB";"PIRPIRITUBA";37;0;13;50
2014;"PITIMBU (PB)";"PB";"PITIMBU";34;18;9;61
2014;"POCINHOS (PB)";"PB";"POCINHOS";128;22;30;180
2014;"POCO DANTAS (PB)";"PB";"POCO DANTAS";7;0;5;12
2014;"POCO DE JOSE DE MOURA (PB)";"PB";"POCO DE JOSE DE MOURA";7;6;6;19
2014;"POMBAL (PB)";"PB";"POMBAL";336;50;19;405
2014;"PRATA (PB)";"PB";"PRATA";27;9;5;41
2014;"PRINCESA ISABEL (PB)";"PB";"PRINCESA ISABEL";101;85;15;201
2014;"PUXINANA (PB)";"PB";"PUXINANA";75;29;15;119
2014;"QUEIMADAS (PB)";"PB";"QUEIMADAS";472;101;91;664
2014;"QUIXABA (PB)";"PB";"QUIXABA";11;2;4;17
2014;"REMIGIO (PB)";"PB";"REMIGIO";279;9;22;310
2014;"RIACHAO (PB)";"PB";"RIACHAO";6;2;7;15
2014;"RIACHAO DO BACAMARTE (PB)";"PB";"RIACHAO DO BACAMARTE";20;0;4;24
2014;"RIACHAO DO POCO (PB)";"PB";"RIACHAO DO POCO";17;1;10;28
2014;"RIACHO DE SANTO ANTONIO (PB)";"PB";"RIACHO DE SANTO ANTONIO";13;4;3;20
2014;"RIACHO DOS CAVALOS (PB)";"PB";"RIACHO DOS CAVALOS";27;2;6;35
2014;"RIO TINTO (PB)";"PB";"RIO TINTO";97;8;41;146
2014;"SALGADINHO (PB)";"PB";"SALGADINHO";5;4;3;12
2014;"SALGADO DE SAO FELIX (PB)";"PB";"SALGADO DE SAO FELIX";17;6;9;32
2014;"SANTA CECILIA (PB)";"PB";"SANTA CECILIA";31;8;10;49
2014;"SANTA CRUZ (PB)";"PB";"SANTA CRUZ";16;3;13;32
2014;"SANTA HELENA (PB)";"PB";"SANTA HELENA";12;4;12;28
2014;"SANTA INES (PB)";"PB";"SANTA INES";12;2;3;17
2014;"SANTA LUZIA (PB)";"PB";"SANTA LUZIA";171;17;17;205
2014;"SANTA RITA (PB)";"PB";"SANTA RITA";877;84;280;1241
2014;"SANTA TERESINHA (PB)";"PB";"SANTA TERESINHA";24;3;7;34
2014;"SANTANA DE MANGUEIRA (PB)";"PB";"SANTANA DE MANGUEIRA";5;1;3;9
2014;"SANTANA DOS GARROTES (PB)";"PB";"SANTANA DOS GARROTES";23;11;2;36
2014;"SANTAREM (PB)";"PB";"SANTAREM";5;2;4;11
2014;"SANTO ANDRE (PB)";"PB";"SANTO ANDRE";18;5;21;44
2014;"SAO BENTINHO (PB)";"PB";"SAO BENTINHO";18;4;2;24
2014;"SAO BENTO (PB)";"PB";"SAO BENTO";273;28;20;321
2014;"SAO DOMINGOS DE POMBAL (PB)";"PB";"SAO DOMINGOS DE POMBAL";7;3;6;16
2014;"SAO DOMINGOS DO CARIRI (PB)";"PB";"SAO DOMINGOS DO CARIRI";9;2;4;15
2014;"SAO FRANCISCO (PB)";"PB";"SAO FRANCISCO";10;1;4;15
2014;"SAO JOAO DO CARIRI (PB)";"PB";"SAO JOAO DO CARIRI";29;4;9;42
2014;"SAO JOAO DO RIO DO PEIXE (PB)";"PB";"SAO JOAO DO RIO DO PEIXE";65;8;22;95
2014;"SAO JOAO DO TIGRE (PB)";"PB";"SAO JOAO DO TIGRE";12;3;5;20
2014;"SAO JOSE DA LAGOA TAPADA (PB)";"PB";"SAO JOSE DA LAGOA TAPADA";25;6;7;38
2014;"SAO JOSE DE CAIANA (PB)";"PB";"SAO JOSE DE CAIANA";6;7;5;18
2014;"SAO JOSE DE ESPINHARAS (PB)";"PB";"SAO JOSE DE ESPINHARAS";22;4;6;32
2014;"SAO JOSE DE PIRANHAS (PB)";"PB";"SAO JOSE DE PIRANHAS";45;16;11;72
2014;"SAO JOSE DE PRINCESA (PB)";"PB";"SAO JOSE DE PRINCESA";5;1;2;8
2014;"SAO JOSE DO BONFIM (PB)";"PB";"SAO JOSE DO BONFIM";12;4;4;20
2014;"SAO JOSE DO BREJO DO CRUZ (PB)";"PB";"SAO JOSE DO BREJO DO CRUZ";4;1;2;7
2014;"SAO JOSE DO SABUGI (PB)";"PB";"SAO JOSE DO SABUGI";19;1;5;25
2014;"SAO JOSE DOS CORDEIROS (PB)";"PB";"SAO JOSE DOS CORDEIROS";14;6;3;23
2014;"SAO JOSE DOS RAMOS (PB)";"PB";"SAO JOSE DOS RAMOS";22;1;10;33
2014;"SAO MAMEDE (PB)";"PB";"SAO MAMEDE";26;3;5;34
2014;"SAO MIGUEL DE TAIPU (PB)";"PB";"SAO MIGUEL DE TAIPU";26;0;9;35
2014;"SAO SEBASTIAO DE LAGOA DE ROCA (PB)";"PB";"SAO SEBASTIAO DE LAGOA DE ROCA";71;19;13;103
2014;"SAO SEBASTIAO DO UMBUZEIRO (PB)";"PB";"SAO SEBASTIAO DO UMBUZEIRO";12;2;5;19
2014;"SAO VICENTE DO SERIDO (PB)";"PB";"SAO VICENTE DO SERIDO";31;10;10;51
2014;"SAPE (PB)";"PB";"SAPE";350;31;102;483
2014;"SERRA BRANCA (PB)";"PB";"SERRA BRANCA";94;21;10;125
2014;"SERRA DA RAIZ (PB)";"PB";"SERRA DA RAIZ";12;1;5;18
2014;"SERRA GRANDE (PB)";"PB";"SERRA GRANDE";6;1;4;11
2014;"SERRA REDONDA (PB)";"PB";"SERRA REDONDA";20;10;4;34
2014;"SERRARIA (PB)";"PB";"SERRARIA";16;9;8;33
2014;"SERTAOZINHO (PB)";"PB";"SERTAOZINHO";10;3;11;24
2014;"SOBRADO (PB)";"PB";"SOBRADO";63;4;5;72
2014;"SOLANEA (PB)";"PB";"SOLANEA";225;35;41;301
2014;"SOLEDADE (PB)";"PB";"SOLEDADE";178;24;19;221
2014;"SOSSEGO (PB)";"PB";"SOSSEGO";31;3;7;41
2014;"SOUSA (PB)";"PB";"SOUSA";830;47;61;938
2014;"SUME (PB)";"PB";"SUME";108;28;20;156
2014;"TAPEROA (PB)";"PB";"TAPEROA";86;16;7;109
2014;"TAVARES (PB)";"PB";"TAVARES";26;13;12;51
2014;"TEIXEIRA (PB)";"PB";"TEIXEIRA";94;18;22;134
2014;"TENORIO (PB)";"PB";"TENORIO";17;0;4;21
2014;"TRIUNFO (PB)";"PB";"TRIUNFO";20;3;5;28
2014;"UIRAUNA (PB)";"PB";"UIRAUNA";78;16;7;101
2014;"UMBUZEIRO (PB)";"PB";"UMBUZEIRO";58;23;24;105
2014;"VARZEA (PB)";"PB";"VARZEA";22;4;4;30
2014;"VIEIROPOLIS (PB)";"PB";"VIEIROPOLIS";12;5;10;27
2014;"VISTA SERRANA (PB)";"PB";"VISTA SERRANA";20;0;6;26
2014;"ZABELE (PB)";"PB";"ZABELE";12;5;7;24
2014;"ABREU E LIMA (PE)";"PE";"ABREU E LIMA";572;71;396;1039
2014;"AFOGADOS DA INGAZEIRA (PE)";"PE";"AFOGADOS DA INGAZEIRA";461;66;66;593
2014;"AFRANIO (PE)";"PE";"AFRANIO";206;7;21;234
2014;"AGRESTINA (PE)";"PE";"AGRESTINA";181;37;25;243
2014;"AGUA PRETA (PE)";"PE";"AGUA PRETA";157;54;63;274
2014;"AGUAS BELAS (PE)";"PE";"AGUAS BELAS";323;75;40;438
2014;"ALAGOINHA (PE)";"PE";"ALAGOINHA";136;41;19;196
2014;"ALIANCA (PE)";"PE";"ALIANCA";168;18;128;314
2014;"ALTINHO (PE)";"PE";"ALTINHO";91;68;34;193
2014;"AMARAJI (PE)";"PE";"AMARAJI";105;25;39;169
2014;"ANGELIM (PE)";"PE";"ANGELIM";50;22;7;79
2014;"ARACOIABA (PE)";"PE";"ARACOIABA";70;8;91;169
2014;"ARARIPINA (PE)";"PE";"ARARIPINA";1156;56;69;1281
2014;"ARCOVERDE (PE)";"PE";"ARCOVERDE";1176;190;121;1487
2014;"BARRA DE GUABIRABA (PE)";"PE";"BARRA DE GUABIRABA";75;20;12;107
2014;"BARREIROS (PE)";"PE";"BARREIROS";269;37;68;374
2014;"BELEM DE MARIA (PE)";"PE";"BELEM DE MARIA";83;48;19;150
2014;"BELEM DE SAO FRANCISCO (PE)";"PE";"BELEM DE SAO FRANCISCO";112;24;20;156
2014;"BELO JARDIM (PE)";"PE";"BELO JARDIM";754;345;86;1185
2014;"BETANIA (PE)";"PE";"BETANIA";54;3;9;66
2014;"BEZERROS (PE)";"PE";"BEZERROS";835;124;78;1037
2014;"BODOCO (PE)";"PE";"BODOCO";237;3;20;260
2014;"BOM CONSELHO (PE)";"PE";"BOM CONSELHO";305;65;39;409
2014;"BOM JARDIM (PE)";"PE";"BOM JARDIM";227;304;52;583
2014;"BONITO (PE)";"PE";"BONITO";378;83;37;498
2014;"BREJAO (PE)";"PE";"BREJAO";67;17;12;96
2014;"BREJINHO (PE)";"PE";"BREJINHO";58;13;9;80
2014;"BREJO DA MADRE DE DEUS (PE)";"PE";"BREJO DA MADRE DE DEUS";295;441;19;755
2014;"BUENOS AIRES (PE)";"PE";"BUENOS AIRES";62;9;19;90
2014;"BUIQUE (PE)";"PE";"BUIQUE";270;77;46;393
2014;"CABO DE SANTO AGOSTINHO (PE)";"PE";"CABO DE SANTO AGOSTINHO";1404;279;557;2240
2014;"CABROBO (PE)";"PE";"CABROBO";242;13;32;287
2014;"CACHOEIRINHA (PE)";"PE";"CACHOEIRINHA";165;71;13;249
2014;"CAETES (PE)";"PE";"CAETES";264;54;33;351
2014;"CALCADO (PE)";"PE";"CALCADO";65;10;26;101
2014;"CALUMBI (PE)";"PE";"CALUMBI";56;7;7;70
2014;"CAMARAGIBE (PE)";"PE";"CAMARAGIBE";757;267;152;1176
2014;"CAMOCIM DE SAO FELIX (PE)";"PE";"CAMOCIM DE SAO FELIX";137;48;7;192
2014;"CAMUTANGA (PE)";"PE";"CAMUTANGA";90;1;16;107
2014;"CANHOTINHO (PE)";"PE";"CANHOTINHO";213;75;14;302
2014;"CAPOEIRAS (PE)";"PE";"CAPOEIRAS";236;38;15;289
2014;"CARNAIBA (PE)";"PE";"CARNAIBA";174;51;26;251
2014;"CARNAUBEIRA DA PENHA (PE)";"PE";"CARNAUBEIRA DA PENHA";52;8;4;64
2014;"CARPINA (PE)";"PE";"CARPINA";892;124;151;1167
2014;"CARUARU (PE)";"PE";"CARUARU";4439;811;584;5834
2014;"CASINHAS (PE)";"PE";"CASINHAS";59;135;19;213
2014;"CATENDE (PE)";"PE";"CATENDE";198;73;67;338
2014;"CEDRO (PE)";"PE";"CEDRO";43;7;12;62
2014;"CHA DE ALEGRIA (PE)";"PE";"CHA DE ALEGRIA";54;18;36;108
2014;"CHA GRANDE (PE)";"PE";"CHA GRANDE";263;67;27;357
2014;"CONDADO (PE)";"PE";"CONDADO";132;7;65;204
2014;"CORRENTES (PE)";"PE";"CORRENTES";90;27;14;131
2014;"CORTES (PE)";"PE";"CORTES";167;53;35;255
2014;"CUMARU (PE)";"PE";"CUMARU";140;87;19;246
2014;"CUPIRA (PE)";"PE";"CUPIRA";276;81;18;375
2014;"CUSTODIA (PE)";"PE";"CUSTODIA";350;74;35;459
2014;"DORMENTES (PE)";"PE";"DORMENTES";256;11;29;296
2014;"ESCADA (PE)";"PE";"ESCADA";370;95;146;611
2014;"EXU (PE)";"PE";"EXU";304;12;31;347
2014;"FEIRA NOVA (PE)";"PE";"FEIRA NOVA";238;40;14;292
2014;"FERNANDO DE NORONHA (PE)";"PE";"FERNANDO DE NORONHA";17;25;7;49
2014;"FERREIROS (PE)";"PE";"FERREIROS";83;1;52;136
2014;"FLORES (PE)";"PE";"FLORES";114;38;10;162
2014;"FLORESTA (PE)";"PE";"FLORESTA";501;15;21;537
2014;"FREI MIGUELINHO (PE)";"PE";"FREI MIGUELINHO";180;134;19;333
2014;"GAMELEIRA (PE)";"PE";"GAMELEIRA";90;14;61;165
2014;"GARANHUNS (PE)";"PE";"GARANHUNS";1706;305;149;2160
2014;"GLORIA DO GOITA (PE)";"PE";"GLORIA DO GOITA";176;57;41;274
2014;"GOIANA (PE)";"PE";"GOIANA";769;182;141;1092
2014;"GRANITO (PE)";"PE";"GRANITO";32;2;14;48
2014;"GRAVATA (PE)";"PE";"GRAVATA";949;113;86;1148
2014;"IATI (PE)";"PE";"IATI";69;35;26;130
2014;"IBIMIRIM (PE)";"PE";"IBIMIRIM";227;42;16;285
2014;"IBIRAJUBA (PE)";"PE";"IBIRAJUBA";52;11;6;69
2014;"IGARASSU (PE)";"PE";"IGARASSU";902;114;729;1745
2014;"IGUARACI (PE)";"PE";"IGUARACI";121;29;27;177
2014;"ILHA DE ITAMARACA (PE)";"PE";"ILHA DE ITAMARACA";96;16;16;128
2014;"INAJA (PE)";"PE";"INAJA";65;10;9;84
2014;"INGAZEIRA (PE)";"PE";"INGAZEIRA";27;11;6;44
2014;"IPOJUCA (PE)";"PE";"IPOJUCA";683;297;214;1194
2014;"IPUBI (PE)";"PE";"IPUBI";249;15;36;300
2014;"ITACURUBA (PE)";"PE";"ITACURUBA";28;2;7;37
2014;"ITAIBA (PE)";"PE";"ITAIBA";128;38;16;182
2014;"ITAMBE (PE)";"PE";"ITAMBE";427;37;131;595
2014;"ITAPETIM (PE)";"PE";"ITAPETIM";80;8;9;97
2014;"ITAPISSUMA (PE)";"PE";"ITAPISSUMA";115;34;25;174
2014;"ITAQUITINGA (PE)";"PE";"ITAQUITINGA";41;7;36;84
2014;"JABOATAO DOS GUARARAPES (PE)";"PE";"JABOATAO DOS GUARARAPES";5488;810;2153;8451
2014;"JAQUEIRA (PE)";"PE";"JAQUEIRA";60;6;30;96
2014;"JATAUBA (PE)";"PE";"JATAUBA";125;174;11;310
2014;"JATOBA (PE)";"PE";"JATOBA";46;15;11;72
2014;"JOAO ALFREDO (PE)";"PE";"JOAO ALFREDO";210;614;16;840
2014;"JOAQUIM NABUCO (PE)";"PE";"JOAQUIM NABUCO";89;21;48;158
2014;"JUCATI (PE)";"PE";"JUCATI";142;26;22;190
2014;"JUPI (PE)";"PE";"JUPI";190;35;36;261
2014;"JUREMA (PE)";"PE";"JUREMA";82;34;13;129
2014;"LAGOA DO CARRO (PE)";"PE";"LAGOA DO CARRO";98;13;15;126
2014;"LAGOA DO ITAENGA (PE)";"PE";"LAGOA DO ITAENGA";462;34;64;560
2014;"LAGOA DO OURO (PE)";"PE";"LAGOA DO OURO";52;29;14;95
2014;"LAGOA DOS GATOS (PE)";"PE";"LAGOA DOS GATOS";100;32;7;139
2014;"LAGOA GRANDE (PE)";"PE";"LAGOA GRANDE";152;10;16;178
2014;"LAJEDO (PE)";"PE";"LAJEDO";553;97;50;700
2014;"LIMOEIRO (PE)";"PE";"LIMOEIRO";518;141;63;722
2014;"MACAPARANA (PE)";"PE";"MACAPARANA";179;16;41;236
2014;"MACHADOS (PE)";"PE";"MACHADOS";126;35;17;178
2014;"MANARI (PE)";"PE";"MANARI";65;18;10;93
2014;"MARAIAL (PE)";"PE";"MARAIAL";132;15;20;167
2014;"MIRANDIBA (PE)";"PE";"MIRANDIBA";133;7;7;147
2014;"MOREILANDIA (PE)";"PE";"MOREILANDIA";75;4;10;89
2014;"MORENO (PE)";"PE";"MORENO";639;186;232;1057
2014;"NAZARE DA MATA (PE)";"PE";"NAZARE DA MATA";253;25;56;334
2014;"OLINDA (PE)";"PE";"OLINDA";3078;398;1431;4907
2014;"OROBO (PE)";"PE";"OROBO";186;201;62;449
2014;"OROCO (PE)";"PE";"OROCO";78;2;14;94
2014;"OURICURI (PE)";"PE";"OURICURI";682;32;95;809
2014;"PALMARES (PE)";"PE";"PALMARES";539;82;195;816
2014;"PALMEIRINA (PE)";"PE";"PALMEIRINA";26;19;7;52
2014;"PANELAS (PE)";"PE";"PANELAS";99;70;19;188
2014;"PARANATAMA (PE)";"PE";"PARANATAMA";93;25;18;136
2014;"PARNAMIRIM (PE)";"PE";"PARNAMIRIM";212;8;20;240
2014;"PASSIRA (PE)";"PE";"PASSIRA";240;107;28;375
2014;"PAUDALHO (PE)";"PE";"PAUDALHO";615;39;73;727
2014;"PAULISTA (PE)";"PE";"PAULISTA";1566;323;310;2199
2014;"PEDRA (PE)";"PE";"PEDRA";165;45;18;228
2014;"PESQUEIRA (PE)";"PE";"PESQUEIRA";761;93;132;986
2014;"PETROLANDIA (PE)";"PE";"PETROLANDIA";290;10;68;368
2014;"PETROLINA (PE)";"PE";"PETROLINA";3748;278;438;4464
2014;"POCAO (PE)";"PE";"POCAO";58;31;13;102
2014;"POMBOS (PE)";"PE";"POMBOS";584;49;46;679
2014;"PRIMAVERA (PE)";"PE";"PRIMAVERA";77;13;38;128
2014;"QUIPAPA (PE)";"PE";"QUIPAPA";96;34;45;175
2014;"QUIXABA (PE)";"PE";"QUIXABA";47;26;10;83
2014;"RECIFE (PE)";"PE";"RECIFE";20286;2627;4208;27121
2014;"RIACHO DAS ALMAS (PE)";"PE";"RIACHO DAS ALMAS";309;84;26;419
2014;"RIBEIRAO (PE)";"PE";"RIBEIRAO";260;48;101;409
2014;"RIO FORMOSO (PE)";"PE";"RIO FORMOSO";118;31;68;217
2014;"SAIRE (PE)";"PE";"SAIRE";105;11;33;149
2014;"SALGADINHO (PE)";"PE";"SALGADINHO";21;52;5;78
2014;"SALGUEIRO (PE)";"PE";"SALGUEIRO";537;50;63;650
2014;"SALOA (PE)";"PE";"SALOA";73;35;12;120
2014;"SANHARO (PE)";"PE";"SANHARO";128;26;33;187
2014;"SANTA CRUZ (PE)";"PE";"SANTA CRUZ";171;8;21;200
2014;"SANTA CRUZ DA BAIXA VERDE (PE)";"PE";"SANTA CRUZ DA BAIXA VERDE";213;12;9;234
2014;"SANTA CRUZ DO CAPIBARIBE (PE)";"PE";"SANTA CRUZ DO CAPIBARIBE";916;423;60;1399
2014;"SANTA FILOMENA (PE)";"PE";"SANTA FILOMENA";99;1;27;127
2014;"SANTA MARIA DA BOA VISTA (PE)";"PE";"SANTA MARIA DA BOA VISTA";253;14;60;327
2014;"SANTA MARIA DO CAMBUCA (PE)";"PE";"SANTA MARIA DO CAMBUCA";189;115;26;330
2014;"SANTA TEREZINHA (PE)";"PE";"SANTA TEREZINHA";70;11;10;91
2014;"SAO BENEDITO DO SUL (PE)";"PE";"SAO BENEDITO DO SUL";31;11;15;57
2014;"SAO BENTO DO UNA (PE)";"PE";"SAO BENTO DO UNA";903;84;94;1081
2014;"SAO CAITANO (PE)";"PE";"SAO CAITANO";330;192;38;560
2014;"SAO JOAO (PE)";"PE";"SAO JOAO";112;44;21;177
2014;"SAO JOAQUIM DO MONTE (PE)";"PE";"SAO JOAQUIM DO MONTE";85;35;24;144
2014;"SAO JOSE DA COROA GRANDE (PE)";"PE";"SAO JOSE DA COROA GRANDE";71;18;29;118
2014;"SAO JOSE DO BELMONTE (PE)";"PE";"SAO JOSE DO BELMONTE";320;33;33;386
2014;"SAO JOSE DO EGITO (PE)";"PE";"SAO JOSE DO EGITO";524;57;70;651
2014;"SAO LOURENCO DA MATA (PE)";"PE";"SAO LOURENCO DA MATA";411;79;458;948
2014;"SAO VICENTE FERRER (PE)";"PE";"SAO VICENTE FERRER";173;15;20;208
2014;"SERRA TALHADA (PE)";"PE";"SERRA TALHADA";1581;96;82;1759
2014;"SERRITA (PE)";"PE";"SERRITA";119;7;14;140
2014;"SERTANIA (PE)";"PE";"SERTANIA";452;56;50;558
2014;"SIRINHAEM (PE)";"PE";"SIRINHAEM";196;23;79;298
2014;"SOLIDAO (PE)";"PE";"SOLIDAO";27;5;5;37
2014;"SURUBIM (PE)";"PE";"SURUBIM";784;702;72;1558
2014;"TABIRA (PE)";"PE";"TABIRA";270;40;37;347
2014;"TACAIMBO (PE)";"PE";"TACAIMBO";88;33;20;141
2014;"TACARATU (PE)";"PE";"TACARATU";61;21;13;95
2014;"TAMANDARE (PE)";"PE";"TAMANDARE";74;32;22;128
2014;"TAQUARITINGA DO NORTE (PE)";"PE";"TAQUARITINGA DO NORTE";227;96;30;353
2014;"TEREZINHA (PE)";"PE";"TEREZINHA";25;5;7;37
2014;"TERRA NOVA (PE)";"PE";"TERRA NOVA";92;2;12;106
2014;"TIMBAUBA (PE)";"PE";"TIMBAUBA";730;36;111;877
2014;"TORITAMA (PE)";"PE";"TORITAMA";278;80;30;388
2014;"TRACUNHAEM (PE)";"PE";"TRACUNHAEM";50;24;17;91
2014;"TRINDADE (PE)";"PE";"TRINDADE";379;37;21;437
2014;"TRIUNFO (PE)";"PE";"TRIUNFO";235;17;11;263
2014;"TUPANATINGA (PE)";"PE";"TUPANATINGA";137;48;20;205
2014;"TUPARETAMA (PE)";"PE";"TUPARETAMA";126;25;18;169
2014;"VENTUROSA (PE)";"PE";"VENTUROSA";190;44;16;250
2014;"VERDEJANTE (PE)";"PE";"VERDEJANTE";88;9;15;112
2014;"VERTENTE DO LERIO (PE)";"PE";"VERTENTE DO LERIO";87;99;18;204
2014;"VERTENTES (PE)";"PE";"VERTENTES";180;97;23;300
2014;"VICENCIA (PE)";"PE";"VICENCIA";257;14;77;348
2014;"VITORIA DE SANTO ANTAO (PE)";"PE";"VITORIA DE SANTO ANTAO";2350;139;328;2817
2014;"XEXEU (PE)";"PE";"XEXEU";74;10;43;127
2014;"ACAUA (PI)";"PI";"ACAUA";66;7;11;84
2014;"AGRICOLANDIA (PI)";"PI";"AGRICOLANDIA";16;2;7;25
2014;"AGUA BRANCA (PI)";"PI";"AGUA BRANCA";175;19;19;213
2014;"ALAGOINHA DO PIAUI (PI)";"PI";"ALAGOINHA DO PIAUI";55;4;5;64
2014;"ALEGRETE DO PIAUI (PI)";"PI";"ALEGRETE DO PIAUI";69;5;4;78
2014;"ALTO LONGA (PI)";"PI";"ALTO LONGA";47;6;19;72
2014;"ALTOS (PI)";"PI";"ALTOS";275;9;42;326
2014;"ALVORADA DO GURGUEIA (PI)";"PI";"ALVORADA DO GURGUEIA";15;3;8;26
2014;"AMARANTE (PI)";"PI";"AMARANTE";81;14;21;116
2014;"ANGICAL DO PIAUI (PI)";"PI";"ANGICAL DO PIAUI";21;3;6;30
2014;"ANISIO DE ABREU (PI)";"PI";"ANISIO DE ABREU";39;11;12;62
2014;"ANTONIO ALMEIDA (PI)";"PI";"ANTONIO ALMEIDA";29;3;5;37
2014;"AROAZES (PI)";"PI";"AROAZES";15;4;9;28
2014;"AROEIRAS DO ITAIM (PI)";"PI";"AROEIRAS DO ITAIM";11;1;11;23
2014;"ARRAIAL (PI)";"PI";"ARRAIAL";13;2;4;19
2014;"ASSUNCAO DO PIAUI (PI)";"PI";"ASSUNCAO DO PIAUI";10;0;2;12
2014;"AVELINO LOPES (PI)";"PI";"AVELINO LOPES";19;6;5;30
2014;"BAIXA GRANDE DO RIBEIRO (PI)";"PI";"BAIXA GRANDE DO RIBEIRO";93;5;18;116
2014;"BARRA D ALCANTARA (PI)";"PI";"BARRA D ALCANTARA";22;1;2;25
2014;"BARRAS (PI)";"PI";"BARRAS";146;10;71;227
2014;"BARREIRAS DO PIAUI (PI)";"PI";"BARREIRAS DO PIAUI";5;0;2;7
2014;"BARRO DURO (PI)";"PI";"BARRO DURO";46;5;3;54
2014;"BATALHA (PI)";"PI";"BATALHA";79;3;16;98
2014;"BELA VISTA DO PIAUI (PI)";"PI";"BELA VISTA DO PIAUI";16;1;6;23
2014;"BELEM DO PIAUI (PI)";"PI";"BELEM DO PIAUI";25;1;3;29
2014;"BENEDITINOS (PI)";"PI";"BENEDITINOS";36;3;13;52
2014;"BERTOLINIA (PI)";"PI";"BERTOLINIA";23;8;10;41
2014;"BETANIA DO PIAUI (PI)";"PI";"BETANIA DO PIAUI";28;8;4;40
2014;"BOA HORA (PI)";"PI";"BOA HORA";23;1;8;32
2014;"BOCAINA (PI)";"PI";"BOCAINA";12;7;4;23
2014;"BOM JESUS (PI)";"PI";"BOM JESUS";251;6;16;273
2014;"BOM PRINCIPIO DO PIAUI (PI)";"PI";"BOM PRINCIPIO DO PIAUI";12;4;7;23
2014;"BONFIM DO PIAUI (PI)";"PI";"BONFIM DO PIAUI";36;5;8;49
2014;"BOQUEIRAO DO PIAUI (PI)";"PI";"BOQUEIRAO DO PIAUI";13;0;4;17
2014;"BRASILEIRA (PI)";"PI";"BRASILEIRA";26;5;10;41
2014;"BREJO DO PIAUI (PI)";"PI";"BREJO DO PIAUI";8;5;2;15
2014;"BURITI DOS LOPES (PI)";"PI";"BURITI DOS LOPES";36;9;22;67
2014;"BURITI DOS MONTES (PI)";"PI";"BURITI DOS MONTES";17;5;5;27
2014;"CABECEIRAS DO PIAUI (PI)";"PI";"CABECEIRAS DO PIAUI";22;2;26;50
2014;"CAJAZEIRAS DO PIAUI (PI)";"PI";"CAJAZEIRAS DO PIAUI";7;0;3;10
2014;"CAJUEIRO DA PRAIA (PI)";"PI";"CAJUEIRO DA PRAIA";12;3;11;26
2014;"CALDEIRAO GRANDE DO PIAUI (PI)";"PI";"CALDEIRAO GRANDE DO PIAUI";25;6;7;38
2014;"CAMPINAS DO PIAUI (PI)";"PI";"CAMPINAS DO PIAUI";5;1;2;8
2014;"CAMPO ALEGRE DO FIDALGO (PI)";"PI";"CAMPO ALEGRE DO FIDALGO";25;5;2;32
2014;"CAMPO GRANDE DO PIAUI (PI)";"PI";"CAMPO GRANDE DO PIAUI";47;8;4;59
2014;"CAMPO LARGO DO PIAUI (PI)";"PI";"CAMPO LARGO DO PIAUI";7;2;4;13
2014;"CAMPO MAIOR (PI)";"PI";"CAMPO MAIOR";437;33;77;547
2014;"CANAVIEIRA (PI)";"PI";"CANAVIEIRA";2;1;1;4
2014;"CANTO DO BURITI (PI)";"PI";"CANTO DO BURITI";120;28;23;171
2014;"CAPITAO DE CAMPOS (PI)";"PI";"CAPITAO DE CAMPOS";32;5;10;47
2014;"CAPITAO GERVASIO OLIVEIRA (PI)";"PI";"CAPITAO GERVASIO OLIVEIRA";22;0;8;30
2014;"CARACOL (PI)";"PI";"CARACOL";54;3;6;63
2014;"CARAUBAS DO PIAUI (PI)";"PI";"CARAUBAS DO PIAUI";17;3;7;27
2014;"CARIDADE DO PIAUI (PI)";"PI";"CARIDADE DO PIAUI";15;2;5;22
2014;"CASTELO DO PIAUI (PI)";"PI";"CASTELO DO PIAUI";79;14;15;108
2014;"CAXINGO (PI)";"PI";"CAXINGO";9;1;7;17
2014;"COCAL (PI)";"PI";"COCAL";111;9;16;136
2014;"COCAL DE TELHA (PI)";"PI";"COCAL DE TELHA";13;2;4;19
2014;"COCAL DOS ALVES (PI)";"PI";"COCAL DOS ALVES";6;5;4;15
2014;"COIVARAS (PI)";"PI";"COIVARAS";9;0;7;16
2014;"COLONIA DO GURGUEIA (PI)";"PI";"COLONIA DO GURGUEIA";11;10;3;24
2014;"COLONIA DO PIAUI (PI)";"PI";"COLONIA DO PIAUI";15;6;6;27
2014;"CONCEICAO DO CANINDE (PI)";"PI";"CONCEICAO DO CANINDE";14;1;5;20
2014;"CORONEL JOSE DIAS (PI)";"PI";"CORONEL JOSE DIAS";10;6;6;22
2014;"CORRENTE (PI)";"PI";"CORRENTE";126;6;16;148
2014;"CRISTALANDIA DO PIAUI (PI)";"PI";"CRISTALANDIA DO PIAUI";9;4;3;16
2014;"CRISTINO CASTRO (PI)";"PI";"CRISTINO CASTRO";40;4;7;51
2014;"CURIMATA (PI)";"PI";"CURIMATA";33;1;6;40
2014;"CURRAIS (PI)";"PI";"CURRAIS";3;1;2;6
2014;"CURRAL NOVO DO PIAUI (PI)";"PI";"CURRAL NOVO DO PIAUI";10;5;3;18
2014;"CURRALINHOS (PI)";"PI";"CURRALINHOS";6;0;2;8
2014;"DEMERVAL LOBAO (PI)";"PI";"DEMERVAL LOBAO";65;1;20;86
2014;"DIRCEU ARCOVERDE (PI)";"PI";"DIRCEU ARCOVERDE";40;8;4;52
2014;"DOM EXPEDITO LOPES (PI)";"PI";"DOM EXPEDITO LOPES";69;9;6;84
2014;"DOM INOCENCIO (PI)";"PI";"DOM INOCENCIO";43;15;9;67
2014;"DOMINGOS MOURAO (PI)";"PI";"DOMINGOS MOURAO";4;1;5;10
2014;"ELESBAO VELOSO (PI)";"PI";"ELESBAO VELOSO";73;3;8;84
2014;"ELISEU MARTINS (PI)";"PI";"ELISEU MARTINS";13;3;3;19
2014;"ESPERANTINA (PI)";"PI";"ESPERANTINA";209;17;48;274
2014;"FARTURA DO PIAUI (PI)";"PI";"FARTURA DO PIAUI";11;7;3;21
2014;"FLORES DO PIAUI (PI)";"PI";"FLORES DO PIAUI";13;4;3;20
2014;"FLORESTA DO PIAUI (PI)";"PI";"FLORESTA DO PIAUI";9;6;4;19
2014;"FLORIANO (PI)";"PI";"FLORIANO";1116;90;71;1277
2014;"FRANCINOPOLIS (PI)";"PI";"FRANCINOPOLIS";18;8;2;28
2014;"FRANCISCO AYRES (PI)";"PI";"FRANCISCO AYRES";11;11;7;29
2014;"FRANCISCO MACEDO (PI)";"PI";"FRANCISCO MACEDO";40;8;8;56
2014;"FRANCISCO SANTOS (PI)";"PI";"FRANCISCO SANTOS";79;10;8;97
2014;"FRONTEIRAS (PI)";"PI";"FRONTEIRAS";89;15;9;113
2014;"GEMINIANO (PI)";"PI";"GEMINIANO";34;11;9;54
2014;"GILBUES (PI)";"PI";"GILBUES";8;3;8;19
2014;"GUADALUPE (PI)";"PI";"GUADALUPE";83;15;8;106
2014;"GUARIBAS (PI)";"PI";"GUARIBAS";7;0;4;11
2014;"HUGO NAPOLEAO (PI)";"PI";"HUGO NAPOLEAO";8;1;2;11
2014;"ILHA GRANDE (PI)";"PI";"ILHA GRANDE";14;6;5;25
2014;"INHUMA (PI)";"PI";"INHUMA";103;8;15;126
2014;"IPIRANGA DO PIAUI (PI)";"PI";"IPIRANGA DO PIAUI";56;9;8;73
2014;"ISAIAS COELHO (PI)";"PI";"ISAIAS COELHO";16;0;6;22
2014;"ITAINOPOLIS (PI)";"PI";"ITAINOPOLIS";45;21;18;84
2014;"ITAUEIRA (PI)";"PI";"ITAUEIRA";64;9;4;77
2014;"JACOBINA DO PIAUI (PI)";"PI";"JACOBINA DO PIAUI";64;3;1;68
2014;"JAICOS (PI)";"PI";"JAICOS";124;9;11;144
2014;"JARDIM DO MULATO (PI)";"PI";"JARDIM DO MULATO";8;2;2;12
2014;"JATOBA DO PIAUI (PI)";"PI";"JATOBA DO PIAUI";35;0;12;47
2014;"JERUMENHA (PI)";"PI";"JERUMENHA";18;1;1;20
2014;"JOAO COSTA (PI)";"PI";"JOAO COSTA";5;0;3;8
2014;"JOAQUIM PIRES (PI)";"PI";"JOAQUIM PIRES";34;2;8;44
2014;"JOCA MARQUES (PI)";"PI";"JOCA MARQUES";6;0;5;11
2014;"JOSE DE FREITAS (PI)";"PI";"JOSE DE FREITAS";109;13;42;164
2014;"JUAZEIRO DO PIAUI (PI)";"PI";"JUAZEIRO DO PIAUI";20;1;4;25
2014;"JULIO BORGES (PI)";"PI";"JULIO BORGES";5;2;4;11
2014;"JUREMA (PI)";"PI";"JUREMA";15;3;8;26
2014;"LAGOA ALEGRE (PI)";"PI";"LAGOA ALEGRE";11;2;18;31
2014;"LAGOA DE SAO FRANCISCO (PI)";"PI";"LAGOA DE SAO FRANCISCO";11;3;4;18
2014;"LAGOA DO BARRO DO PIAUI (PI)";"PI";"LAGOA DO BARRO DO PIAUI";18;5;9;32
2014;"LAGOA DO PIAUI (PI)";"PI";"LAGOA DO PIAUI";16;0;2;18
2014;"LAGOA DO SITIO (PI)";"PI";"LAGOA DO SITIO";13;1;4;18
2014;"LAGOINHA DO PIAUI (PI)";"PI";"LAGOINHA DO PIAUI";6;0;4;10
2014;"LANDRI SALES (PI)";"PI";"LANDRI SALES";14;4;1;19
2014;"LUIS CORREIA (PI)";"PI";"LUIS CORREIA";62;13;42;117
2014;"LUZILANDIA (PI)";"PI";"LUZILANDIA";68;8;20;96
2014;"MADEIRO (PI)";"PI";"MADEIRO";9;3;2;14
2014;"MANOEL EMIDIO (PI)";"PI";"MANOEL EMIDIO";16;4;6;26
2014;"MARCOLANDIA (PI)";"PI";"MARCOLANDIA";368;41;14;423
2014;"MARCOS PARENTE (PI)";"PI";"MARCOS PARENTE";10;4;2;16
2014;"MASSAPE DO PIAUI (PI)";"PI";"MASSAPE DO PIAUI";20;1;4;25
2014;"MATIAS OLIMPIO (PI)";"PI";"MATIAS OLIMPIO";28;7;5;40
2014;"MIGUEL ALVES (PI)";"PI";"MIGUEL ALVES";48;5;25;78
2014;"MIGUEL LEAO (PI)";"PI";"MIGUEL LEAO";4;0;1;5
2014;"MILTON BRANDAO (PI)";"PI";"MILTON BRANDAO";12;0;2;14
2014;"MONSENHOR GIL (PI)";"PI";"MONSENHOR GIL";30;3;7;40
2014;"MONSENHOR HIPOLITO (PI)";"PI";"MONSENHOR HIPOLITO";40;9;5;54
2014;"MONTE ALEGRE DO PIAUI (PI)";"PI";"MONTE ALEGRE DO PIAUI";15;0;4;19
2014;"MORRO CABECA NO TEMPO (PI)";"PI";"MORRO CABECA NO TEMPO";5;0;4;9
2014;"MORRO DO CHAPEU DO PIAUI (PI)";"PI";"MORRO DO CHAPEU DO PIAUI";10;1;9;20
2014;"MURICI DOS PORTELAS (PI)";"PI";"MURICI DOS PORTELAS";10;0;6;16
2014;"NAZARE DO PIAUI (PI)";"PI";"NAZARE DO PIAUI";23;16;3;42
2014;"NAZARIA (PI)";"PI";"NAZARIA";17;0;10;27
2014;"NOSSA SENHORA DE NAZARE (PI)";"PI";"NOSSA SENHORA DE NAZARE";15;2;9;26
2014;"NOSSA SENHORA DOS REMEDIOS (PI)";"PI";"NOSSA SENHORA DOS REMEDIOS";12;4;5;21
2014;"NOVA SANTA RITA (PI)";"PI";"NOVA SANTA RITA";5;7;4;16
2014;"NOVO ORIENTE DO PIAUI (PI)";"PI";"NOVO ORIENTE DO PIAUI";21;4;14;39
2014;"NOVO SANTO ANTONIO (PI)";"PI";"NOVO SANTO ANTONIO";15;1;4;20
2014;"OEIRAS (PI)";"PI";"OEIRAS";349;54;45;448
2014;"OLHO D AGUA DO PIAUI (PI)";"PI";"OLHO D AGUA DO PIAUI";6;1;3;10
2014;"PADRE MARCOS (PI)";"PI";"PADRE MARCOS";50;8;6;64
2014;"PAES LANDIM (PI)";"PI";"PAES LANDIM";7;2;2;11
2014;"PAJEU DO PIAUI (PI)";"PI";"PAJEU DO PIAUI";10;3;4;17
2014;"PALMEIRA DO PIAUI (PI)";"PI";"PALMEIRA DO PIAUI";37;3;3;43
2014;"PALMEIRAIS (PI)";"PI";"PALMEIRAIS";17;3;9;29
2014;"PAQUETA (PI)";"PI";"PAQUETA";17;6;6;29
2014;"PARNAGUA (PI)";"PI";"PARNAGUA";16;4;1;21
2014;"PARNAIBA (PI)";"PI";"PARNAIBA";1174;112;265;1551
2014;"PASSAGEM FRANCA DO PIAUI (PI)";"PI";"PASSAGEM FRANCA DO PIAUI";7;1;5;13
2014;"PATOS DO PIAUI (PI)";"PI";"PATOS DO PIAUI";23;3;8;34
2014;"PAU D ARCO DO PIAUI (PI)";"PI";"PAU D ARCO DO PIAUI";6;0;5;11
2014;"PAULISTANA (PI)";"PI";"PAULISTANA";234;15;55;304
2014;"PAVUSSU (PI)";"PI";"PAVUSSU";9;3;1;13
2014;"PEDRO II (PI)";"PI";"PEDRO II";123;36;24;183
2014;"PEDRO LAURENTINO (PI)";"PI";"PEDRO LAURENTINO";5;0;2;7
2014;"PICOS (PI)";"PI";"PICOS";1734;146;100;1980
2014;"PIMENTEIRAS (PI)";"PI";"PIMENTEIRAS";43;8;6;57
2014;"PIO IX (PI)";"PI";"PIO IX";76;10;15;101
2014;"PIRACURUCA (PI)";"PI";"PIRACURUCA";271;20;51;342
2014;"PIRIPIRI (PI)";"PI";"PIRIPIRI";374;56;157;587
2014;"PORTO (PI)";"PI";"PORTO";10;3;5;18
2014;"PORTO ALEGRE DO PIAUI (PI)";"PI";"PORTO ALEGRE DO PIAUI";9;4;2;15
2014;"PRATA DO PIAUI (PI)";"PI";"PRATA DO PIAUI";12;1;2;15
2014;"QUEIMADA NOVA (PI)";"PI";"QUEIMADA NOVA";74;5;26;105
2014;"REDENCAO DO GURGUEIA (PI)";"PI";"REDENCAO DO GURGUEIA";17;0;17;34
2014;"REGENERACAO (PI)";"PI";"REGENERACAO";89;8;15;112
2014;"RIACHO FRIO (PI)";"PI";"RIACHO FRIO";5;2;5;12
2014;"RIBEIRA DO PIAUI (PI)";"PI";"RIBEIRA DO PIAUI";7;4;2;13
2014;"RIBEIRO GONCALVES (PI)";"PI";"RIBEIRO GONCALVES";25;1;1;27
2014;"RIO GRANDE DO PIAUI (PI)";"PI";"RIO GRANDE DO PIAUI";27;11;5;43
2014;"SANTA CRUZ DO PIAUI (PI)";"PI";"SANTA CRUZ DO PIAUI";24;19;6;49
2014;"SANTA CRUZ DOS MILAGRES (PI)";"PI";"SANTA CRUZ DOS MILAGRES";5;1;3;9
2014;"SANTA FILOMENA (PI)";"PI";"SANTA FILOMENA";22;1;3;26
2014;"SANTA LUZ (PI)";"PI";"SANTA LUZ";11;1;4;16
2014;"SANTA ROSA DO PIAUI (PI)";"PI";"SANTA ROSA DO PIAUI";12;10;10;32
2014;"SANTANA DO PIAUI (PI)";"PI";"SANTANA DO PIAUI";26;15;12;53
2014;"SANTO ANTONIO DE LISBOA (PI)";"PI";"SANTO ANTONIO DE LISBOA";51;12;6;69
2014;"SANTO ANTONIO DOS MILAGRES (PI)";"PI";"SANTO ANTONIO DOS MILAGRES";4;3;2;9
2014;"SANTO INACIO DO PIAUI (PI)";"PI";"SANTO INACIO DO PIAUI";10;5;2;17
2014;"SAO BRAZ DO PIAUI (PI)";"PI";"SAO BRAZ DO PIAUI";19;2;5;26
2014;"SAO FELIX DO PIAUI (PI)";"PI";"SAO FELIX DO PIAUI";7;2;3;12
2014;"SAO FRANCISCO DE ASSIS DO PIAU (PI)";"PI";"SAO FRANCISCO DE ASSIS DO PIAU";14;5;3;22
2014;"SAO FRANCISCO DO PIAUI (PI)";"PI";"SAO FRANCISCO DO PIAUI";11;7;7;25
2014;"SAO GONCALO DO GURGUEIA (PI)";"PI";"SAO GONCALO DO GURGUEIA";4;1;1;6
2014;"SAO GONCALO DO PIAUI (PI)";"PI";"SAO GONCALO DO PIAUI";15;3;6;24
2014;"SAO JOAO DA CANABRAVA (PI)";"PI";"SAO JOAO DA CANABRAVA";16;10;5;31
2014;"SAO JOAO DA FRONTEIRA (PI)";"PI";"SAO JOAO DA FRONTEIRA";4;1;6;11
2014;"SAO JOAO DA SERRA (PI)";"PI";"SAO JOAO DA SERRA";16;0;2;18
2014;"SAO JOAO DA VARJOTA (PI)";"PI";"SAO JOAO DA VARJOTA";5;6;4;15
2014;"SAO JOAO DO ARRAIAL (PI)";"PI";"SAO JOAO DO ARRAIAL";12;3;5;20
2014;"SAO JOAO DO PIAUI (PI)";"PI";"SAO JOAO DO PIAUI";111;20;18;149
2014;"SAO JOSE DO DIVINO (PI)";"PI";"SAO JOSE DO DIVINO";23;4;4;31
2014;"SAO JOSE DO PEIXE (PI)";"PI";"SAO JOSE DO PEIXE";9;0;4;13
2014;"SAO JOSE DO PIAUI (PI)";"PI";"SAO JOSE DO PIAUI";33;7;8;48
2014;"SAO JULIAO (PI)";"PI";"SAO JULIAO";32;8;5;45
2014;"SAO LOURENCO DO PIAUI (PI)";"PI";"SAO LOURENCO DO PIAUI";7;5;6;18
2014;"SAO LUIS DO PIAUI (PI)";"PI";"SAO LUIS DO PIAUI";11;5;2;18
2014;"SAO MIGUEL DA BAIXA GRANDE (PI)";"PI";"SAO MIGUEL DA BAIXA GRANDE";11;2;3;16
2014;"SAO MIGUEL DO FIDALGO (PI)";"PI";"SAO MIGUEL DO FIDALGO";6;1;3;10
2014;"SAO MIGUEL DO TAPUIO (PI)";"PI";"SAO MIGUEL DO TAPUIO";39;3;19;61
2014;"SAO PEDRO DO PIAUI (PI)";"PI";"SAO PEDRO DO PIAUI";43;4;9;56
2014;"SAO RAIMUNDO NONATO (PI)";"PI";"SAO RAIMUNDO NONATO";339;66;47;452
2014;"SEBASTIAO BARROS (PI)";"PI";"SEBASTIAO BARROS";4;2;2;8
2014;"SEBASTIAO LEAL (PI)";"PI";"SEBASTIAO LEAL";33;1;3;37
2014;"SIGEFREDO PACHECO (PI)";"PI";"SIGEFREDO PACHECO";34;5;8;47
2014;"SIMOES (PI)";"PI";"SIMOES";73;12;13;98
2014;"SIMPLICIO MENDES (PI)";"PI";"SIMPLICIO MENDES";77;12;9;98
2014;"SOCORRO DO PIAUI (PI)";"PI";"SOCORRO DO PIAUI";5;3;1;9
2014;"SUSSUAPARA (PI)";"PI";"SUSSUAPARA";38;17;5;60
2014;"TAMBORIL DO PIAUI (PI)";"PI";"TAMBORIL DO PIAUI";6;1;1;8
2014;"TANQUE DO PIAUI (PI)";"PI";"TANQUE DO PIAUI";13;2;4;19
2014;"TERESINA (PI)";"PI";"TERESINA";11121;1106;3082;15309
2014;"UNIAO (PI)";"PI";"UNIAO";154;36;52;242
2014;"URUCUI (PI)";"PI";"URUCUI";169;10;22;201
2014;"VALENCA DO PIAUI (PI)";"PI";"VALENCA DO PIAUI";155;31;29;215
2014;"VARZEA BRANCA (PI)";"PI";"VARZEA BRANCA";18;4;13;35
2014;"VARZEA GRANDE (PI)";"PI";"VARZEA GRANDE";13;5;3;21
2014;"VERA MENDES (PI)";"PI";"VERA MENDES";14;6;3;23
2014;"VILA NOVA DO PIAUI (PI)";"PI";"VILA NOVA DO PIAUI";17;8;5;30
2014;"WALL FERRAZ (PI)";"PI";"WALL FERRAZ";15;13;8;36
2014;"ABATIA (PR)";"PR";"ABATIA";130;4;44;178
2014;"ADRIANOPOLIS (PR)";"PR";"ADRIANOPOLIS";119;9;18;146
2014;"AGUDOS DO SUL (PR)";"PR";"AGUDOS DO SUL";384;10;31;425
2014;"ALMIRANTE TAMANDARE (PR)";"PR";"ALMIRANTE TAMANDARE";1582;98;231;1911
2014;"ALTAMIRA DO PARANA (PR)";"PR";"ALTAMIRA DO PARANA";54;2;17;73
2014;"ALTO PARAISO (PR)";"PR";"ALTO PARAISO";53;9;14;76
2014;"ALTO PARANA (PR)";"PR";"ALTO PARANA";296;18;88;402
2014;"ALTO PIQUIRI (PR)";"PR";"ALTO PIQUIRI";197;9;44;250
2014;"ALTONIA (PR)";"PR";"ALTONIA";464;26;47;537
2014;"ALVORADA DO SUL (PR)";"PR";"ALVORADA DO SUL";313;9;54;376
2014;"AMAPORA (PR)";"PR";"AMAPORA";70;5;60;135
2014;"AMPERE (PR)";"PR";"AMPERE";505;19;40;564
2014;"ANAHY (PR)";"PR";"ANAHY";101;2;6;109
2014;"ANDIRA (PR)";"PR";"ANDIRA";601;16;84;701
2014;"ANGULO (PR)";"PR";"ANGULO";79;3;11;93
2014;"ANTONINA (PR)";"PR";"ANTONINA";103;16;48;167
2014;"ANTONIO OLINTO (PR)";"PR";"ANTONIO OLINTO";185;7;41;233
2014;"APUCARANA (PR)";"PR";"APUCARANA";2561;369;326;3256
2014;"ARAPONGAS (PR)";"PR";"ARAPONGAS";3460;251;149;3860
2014;"ARAPOTI (PR)";"PR";"ARAPOTI";615;32;70;717
2014;"ARAPUA (PR)";"PR";"ARAPUA";107;5;27;139
2014;"ARARUNA (PR)";"PR";"ARARUNA";416;21;36;473
2014;"ARAUCARIA (PR)";"PR";"ARAUCARIA";2950;363;655;3968
2014;"ARIRANHA DO IVAI (PR)";"PR";"ARIRANHA DO IVAI";61;2;17;80
2014;"ASSAI (PR)";"PR";"ASSAI";493;26;45;564
2014;"ASSIS CHATEAUBRIAND (PR)";"PR";"ASSIS CHATEAUBRIAND";1241;46;70;1357
2014;"ASTORGA (PR)";"PR";"ASTORGA";713;45;101;859
2014;"ATALAIA (PR)";"PR";"ATALAIA";119;11;32;162
2014;"BALSA NOVA (PR)";"PR";"BALSA NOVA";416;17;81;514
2014;"BANDEIRANTES (PR)";"PR";"BANDEIRANTES";846;56;109;1011
2014;"BARBOSA FERRAZ (PR)";"PR";"BARBOSA FERRAZ";203;6;39;248
2014;"BARRA DO JACARE (PR)";"PR";"BARRA DO JACARE";58;7;11;76
2014;"BARRACAO (PR)";"PR";"BARRACAO";260;27;40;327
2014;"BELA VISTA DO CAROBA (PR)";"PR";"BELA VISTA DO CAROBA";63;3;18;84
2014;"BELA VISTA DO PARAISO (PR)";"PR";"BELA VISTA DO PARAISO";433;30;58;521
2014;"BITURUNA (PR)";"PR";"BITURUNA";474;23;170;667
2014;"BOA ESPERANCA (PR)";"PR";"BOA ESPERANCA";196;5;16;217
2014;"BOA ESPERANCA DO IGUACU (PR)";"PR";"BOA ESPERANCA DO IGUACU";69;3;15;87
2014;"BOA VENTURA DE SAO ROQUE (PR)";"PR";"BOA VENTURA DE SAO ROQUE";201;12;38;251
2014;"BOA VISTA DA APARECIDA (PR)";"PR";"BOA VISTA DA APARECIDA";177;12;25;214
2014;"BOCAIUVA DO SUL (PR)";"PR";"BOCAIUVA DO SUL";326;19;24;369
2014;"BOM JESUS DO SUL (PR)";"PR";"BOM JESUS DO SUL";53;5;14;72
2014;"BOM SUCESSO (PR)";"PR";"BOM SUCESSO";125;9;70;204
2014;"BOM SUCESSO DO SUL (PR)";"PR";"BOM SUCESSO DO SUL";122;7;11;140
2014;"BORRAZOPOLIS (PR)";"PR";"BORRAZOPOLIS";294;6;16;316
2014;"BRAGANEY (PR)";"PR";"BRAGANEY";187;6;22;215
2014;"BRASILANDIA DO SUL (PR)";"PR";"BRASILANDIA DO SUL";87;7;10;104
2014;"CAFEARA (PR)";"PR";"CAFEARA";43;4;20;67
2014;"CAFELANDIA (PR)";"PR";"CAFELANDIA";646;38;66;750
2014;"CAFEZAL DO SUL (PR)";"PR";"CAFEZAL DO SUL";86;2;29;117
2014;"CALIFORNIA (PR)";"PR";"CALIFORNIA";269;15;22;306
2014;"CAMBARA (PR)";"PR";"CAMBARA";798;39;94;931
2014;"CAMBE (PR)";"PR";"CAMBE";2022;274;155;2451
2014;"CAMBIRA (PR)";"PR";"CAMBIRA";287;4;25;316
2014;"CAMPINA DA LAGOA (PR)";"PR";"CAMPINA DA LAGOA";436;27;49;512
2014;"CAMPINA DO SIMAO (PR)";"PR";"CAMPINA DO SIMAO";101;3;30;134
2014;"CAMPINA GRANDE DO SUL (PR)";"PR";"CAMPINA GRANDE DO SUL";928;93;81;1102
2014;"CAMPO BONITO (PR)";"PR";"CAMPO BONITO";100;12;15;127
2014;"CAMPO DO TENENTE (PR)";"PR";"CAMPO DO TENENTE";165;11;42;218
2014;"CAMPO LARGO (PR)";"PR";"CAMPO LARGO";2465;333;484;3282
2014;"CAMPO MAGRO (PR)";"PR";"CAMPO MAGRO";549;83;28;660
2014;"CAMPO MOURAO (PR)";"PR";"CAMPO MOURAO";2435;136;585;3156
2014;"CANDIDO DE ABREU (PR)";"PR";"CANDIDO DE ABREU";265;12;56;333
2014;"CANDOI (PR)";"PR";"CANDOI";426;12;122;560
2014;"CANTAGALO (PR)";"PR";"CANTAGALO";278;11;46;335
2014;"CAPANEMA (PR)";"PR";"CAPANEMA";485;16;68;569
2014;"CAPITAO LEONIDAS MARQUES (PR)";"PR";"CAPITAO LEONIDAS MARQUES";620;23;59;702
2014;"CARAMBEI (PR)";"PR";"CARAMBEI";668;48;70;786
2014;"CARLOPOLIS (PR)";"PR";"CARLOPOLIS";310;26;68;404
2014;"CASCAVEL (PR)";"PR";"CASCAVEL";8136;409;991;9536
2014;"CASTRO (PR)";"PR";"CASTRO";1966;230;295;2491
2014;"CATANDUVAS (PR)";"PR";"CATANDUVAS";231;15;38;284
2014;"CENTENARIO DO SUL (PR)";"PR";"CENTENARIO DO SUL";141;30;76;247
2014;"CERRO AZUL (PR)";"PR";"CERRO AZUL";469;19;69;557
2014;"CEU AZUL (PR)";"PR";"CEU AZUL";344;15;48;407
2014;"CHOPINZINHO (PR)";"PR";"CHOPINZINHO";621;25;88;734
2014;"CIANORTE (PR)";"PR";"CIANORTE";1697;97;251;2045
2014;"CIDADE GAUCHA (PR)";"PR";"CIDADE GAUCHA";305;19;80;404
2014;"CLEVELANDIA (PR)";"PR";"CLEVELANDIA";571;41;50;662
2014;"COLOMBO (PR)";"PR";"COLOMBO";4442;333;543;5318
2014;"COLORADO (PR)";"PR";"COLORADO";585;38;179;802
2014;"CONGONHINHAS (PR)";"PR";"CONGONHINHAS";132;6;39;177
2014;"CONSELHEIRO MAIRINCK (PR)";"PR";"CONSELHEIRO MAIRINCK";49;3;10;62
2014;"CONTENDA (PR)";"PR";"CONTENDA";763;20;53;836
2014;"CORBELIA (PR)";"PR";"CORBELIA";804;24;69;897
2014;"CORNELIO PROCOPIO (PR)";"PR";"CORNELIO PROCOPIO";1102;124;147;1373
2014;"CORONEL DOMINGOS SOARES (PR)";"PR";"CORONEL DOMINGOS SOARES";158;8;30;196
2014;"CORONEL VIVIDA (PR)";"PR";"CORONEL VIVIDA";762;31;112;905
2014;"CORUMBATAI DO SUL (PR)";"PR";"CORUMBATAI DO SUL";67;2;30;99
2014;"CRUZ MACHADO (PR)";"PR";"CRUZ MACHADO";628;17;102;747
2014;"CRUZEIRO DO IGUACU (PR)";"PR";"CRUZEIRO DO IGUACU";90;5;18;113
2014;"CRUZEIRO DO OESTE (PR)";"PR";"CRUZEIRO DO OESTE";521;20;81;622
2014;"CRUZEIRO DO SUL (PR)";"PR";"CRUZEIRO DO SUL";82;7;25;114
2014;"CRUZMALTINA (PR)";"PR";"CRUZMALTINA";92;2;11;105
2014;"CURITIBA (PR)";"PR";"CURITIBA";40736;4132;7182;52050
2014;"CURIUVA (PR)";"PR";"CURIUVA";266;16;90;372
2014;"DIAMANTE D OESTE (PR)";"PR";"DIAMANTE D OESTE";79;7;24;110
2014;"DIAMANTE DO NORTE (PR)";"PR";"DIAMANTE DO NORTE";69;3;30;102
2014;"DIAMANTE DO SUL (PR)";"PR";"DIAMANTE DO SUL";41;3;10;54
2014;"DOIS VIZINHOS (PR)";"PR";"DOIS VIZINHOS";1187;78;116;1381
2014;"DOURADINA (PR)";"PR";"DOURADINA";417;10;22;449
2014;"DOUTOR CAMARGO (PR)";"PR";"DOUTOR CAMARGO";184;3;58;245
2014;"DOUTOR ULYSSES (PR)";"PR";"DOUTOR ULYSSES";69;2;23;94
2014;"ENEAS MARQUES (PR)";"PR";"ENEAS MARQUES";188;6;25;219
2014;"ENGENHEIRO BELTRAO (PR)";"PR";"ENGENHEIRO BELTRAO";511;17;89;617
2014;"ENTRE RIOS DO OESTE (PR)";"PR";"ENTRE RIOS DO OESTE";140;6;9;155
2014;"ESPERANCA NOVA (PR)";"PR";"ESPERANCA NOVA";36;4;6;46
2014;"ESPIGAO ALTO DO IGUACU (PR)";"PR";"ESPIGAO ALTO DO IGUACU";82;10;10;102
2014;"FAROL (PR)";"PR";"FAROL";99;1;12;112
2014;"FAXINAL (PR)";"PR";"FAXINAL";454;18;43;515
2014;"FAZENDA RIO GRANDE (PR)";"PR";"FAZENDA RIO GRANDE";1271;66;260;1597
2014;"FENIX (PR)";"PR";"FENIX";113;5;17;135
2014;"FERNANDES PINHEIRO (PR)";"PR";"FERNANDES PINHEIRO";118;7;29;154
2014;"FIGUEIRA (PR)";"PR";"FIGUEIRA";154;10;31;195
2014;"FLOR DA SERRA DO SUL (PR)";"PR";"FLOR DA SERRA DO SUL";114;4;29;147
2014;"FLORAI (PR)";"PR";"FLORAI";156;6;25;187
2014;"FLORESTA (PR)";"PR";"FLORESTA";275;19;26;320
2014;"FLORESTOPOLIS (PR)";"PR";"FLORESTOPOLIS";202;23;106;331
2014;"FLORIDA (PR)";"PR";"FLORIDA";72;5;23;100
2014;"FORMOSA DO OESTE (PR)";"PR";"FORMOSA DO OESTE";252;15;22;289
2014;"FOZ DO IGUACU (PR)";"PR";"FOZ DO IGUACU";3528;1149;1165;5842
2014;"FOZ DO JORDAO (PR)";"PR";"FOZ DO JORDAO";82;5;21;108
2014;"FRANCISCO ALVES (PR)";"PR";"FRANCISCO ALVES";186;4;28;218
2014;"FRANCISCO BELTRAO (PR)";"PR";"FRANCISCO BELTRAO";2223;166;236;2625
2014;"GENERAL CARNEIRO (PR)";"PR";"GENERAL CARNEIRO";420;24;72;516
2014;"GODOY MOREIRA (PR)";"PR";"GODOY MOREIRA";60;3;12;75
2014;"GOIOERE (PR)";"PR";"GOIOERE";683;49;59;791
2014;"GOIOXIM (PR)";"PR";"GOIOXIM";123;12;32;167
2014;"GRANDES RIOS (PR)";"PR";"GRANDES RIOS";109;10;16;135
2014;"GUAIRA (PR)";"PR";"GUAIRA";1117;38;191;1346
2014;"GUAIRACA (PR)";"PR";"GUAIRACA";140;7;34;181
2014;"GUAMIRANGA (PR)";"PR";"GUAMIRANGA";178;10;43;231
2014;"GUAPIRAMA (PR)";"PR";"GUAPIRAMA";129;4;20;153
2014;"GUAPOREMA (PR)";"PR";"GUAPOREMA";52;2;9;63
2014;"GUARACI (PR)";"PR";"GUARACI";118;5;38;161
2014;"GUARANIACU (PR)";"PR";"GUARANIACU";441;33;57;531
2014;"GUARAPUAVA (PR)";"PR";"GUARAPUAVA";4730;526;476;5732
2014;"GUARAQUECABA (PR)";"PR";"GUARAQUECABA";33;2;12;47
2014;"GUARATUBA (PR)";"PR";"GUARATUBA";429;33;56;518
2014;"HONORIO SERPA (PR)";"PR";"HONORIO SERPA";121;6;39;166
2014;"IBAITI (PR)";"PR";"IBAITI";575;39;161;775
2014;"IBEMA (PR)";"PR";"IBEMA";156;12;16;184
2014;"IBIPORA (PR)";"PR";"IBIPORA";1104;56;164;1324
2014;"ICARAIMA (PR)";"PR";"ICARAIMA";161;12;38;211
2014;"IGUARACU (PR)";"PR";"IGUARACU";86;8;10;104
2014;"IGUATU (PR)";"PR";"IGUATU";51;1;7;59
2014;"IMBAU (PR)";"PR";"IMBAU";233;19;32;284
2014;"IMBITUVA (PR)";"PR";"IMBITUVA";828;40;67;935
2014;"INACIO MARTINS (PR)";"PR";"INACIO MARTINS";281;34;41;356
2014;"INAJA (PR)";"PR";"INAJA";32;3;20;55
2014;"INDIANOPOLIS (PR)";"PR";"INDIANOPOLIS";211;3;11;225
2014;"IPIRANGA (PR)";"PR";"IPIRANGA";345;28;70;443
2014;"IPORA (PR)";"PR";"IPORA";406;12;43;461
2014;"IRACEMA DO OESTE (PR)";"PR";"IRACEMA DO OESTE";72;4;8;84
2014;"IRATI (PR)";"PR";"IRATI";1644;103;148;1895
2014;"IRETAMA (PR)";"PR";"IRETAMA";201;3;43;247
2014;"ITAGUAJE (PR)";"PR";"ITAGUAJE";78;11;31;120
2014;"ITAIPULANDIA (PR)";"PR";"ITAIPULANDIA";229;27;38;294
2014;"ITAMBARACA (PR)";"PR";"ITAMBARACA";161;11;29;201
2014;"ITAMBE (PR)";"PR";"ITAMBE";185;8;33;226
2014;"ITAPEJARA D OESTE (PR)";"PR";"ITAPEJARA D OESTE";341;12;43;396
2014;"ITAPERUCU (PR)";"PR";"ITAPERUCU";641;72;91;804
2014;"ITAUNA DO SUL (PR)";"PR";"ITAUNA DO SUL";49;5;10;64
2014;"IVAI (PR)";"PR";"IVAI";347;14;41;402
2014;"IVAIPORA (PR)";"PR";"IVAIPORA";915;36;99;1050
2014;"IVATE (PR)";"PR";"IVATE";209;12;70;291
2014;"IVATUBA (PR)";"PR";"IVATUBA";63;5;10;78
2014;"JABOTI (PR)";"PR";"JABOTI";89;8;15;112
2014;"JACAREZINHO (PR)";"PR";"JACAREZINHO";605;110;150;865
2014;"JAGUAPITA (PR)";"PR";"JAGUAPITA";366;32;63;461
2014;"JAGUARIAIVA (PR)";"PR";"JAGUARIAIVA";816;65;130;1011
2014;"JANDAIA DO SUL (PR)";"PR";"JANDAIA DO SUL";652;40;86;778
2014;"JANIOPOLIS (PR)";"PR";"JANIOPOLIS";159;7;30;196
2014;"JAPIRA (PR)";"PR";"JAPIRA";60;2;23;85
2014;"JAPURA (PR)";"PR";"JAPURA";298;8;25;331
2014;"JARDIM ALEGRE (PR)";"PR";"JARDIM ALEGRE";252;10;36;298
2014;"JARDIM OLINDA (PR)";"PR";"JARDIM OLINDA";37;2;9;48
2014;"JATAIZINHO (PR)";"PR";"JATAIZINHO";369;26;26;421
2014;"JESUITAS (PR)";"PR";"JESUITAS";303;22;32;357
2014;"JOAQUIM TAVORA (PR)";"PR";"JOAQUIM TAVORA";272;18;33;323
2014;"JUNDIAI DO SUL (PR)";"PR";"JUNDIAI DO SUL";37;2;24;63
2014;"JURANDA (PR)";"PR";"JURANDA";315;4;13;332
2014;"JUSSARA (PR)";"PR";"JUSSARA";178;5;38;221
2014;"KALORE (PR)";"PR";"KALORE";171;16;22;209
2014;"LAPA (PR)";"PR";"LAPA";1290;130;190;1610
2014;"LARANJAL (PR)";"PR";"LARANJAL";67;7;21;95
2014;"LARANJEIRAS DO SUL (PR)";"PR";"LARANJEIRAS DO SUL";845;44;91;980
2014;"LEOPOLIS (PR)";"PR";"LEOPOLIS";89;6;9;104
2014;"LIDIANOPOLIS (PR)";"PR";"LIDIANOPOLIS";91;7;23;121
2014;"LINDOESTE (PR)";"PR";"LINDOESTE";113;9;31;153
2014;"LOANDA (PR)";"PR";"LOANDA";432;18;62;512
2014;"LOBATO (PR)";"PR";"LOBATO";162;4;32;198
2014;"LONDRINA (PR)";"PR";"LONDRINA";9356;829;2075;12260
2014;"LUIZIANA (PR)";"PR";"LUIZIANA";181;8;19;208
2014;"LUNARDELLI (PR)";"PR";"LUNARDELLI";100;8;12;120
2014;"LUPIONOPOLIS (PR)";"PR";"LUPIONOPOLIS";108;30;91;229
2014;"MALLET (PR)";"PR";"MALLET";410;14;59;483
2014;"MAMBORE (PR)";"PR";"MAMBORE";604;5;49;658
2014;"MANDAGUACU (PR)";"PR";"MANDAGUACU";495;30;52;577
2014;"MANDAGUARI (PR)";"PR";"MANDAGUARI";840;47;73;960
2014;"MANDIRITUBA (PR)";"PR";"MANDIRITUBA";1078;40;82;1200
2014;"MANFRINOPOLIS (PR)";"PR";"MANFRINOPOLIS";37;5;22;64
2014;"MANGUEIRINHA (PR)";"PR";"MANGUEIRINHA";537;32;70;639
2014;"MANOEL RIBAS (PR)";"PR";"MANOEL RIBAS";381;18;34;433
2014;"MARECHAL CANDIDO RONDON (PR)";"PR";"MARECHAL CANDIDO RONDON";1547;87;192;1826
2014;"MARIA HELENA (PR)";"PR";"MARIA HELENA";125;8;26;159
2014;"MARIALVA (PR)";"PR";"MARIALVA";926;62;96;1084
2014;"MARILANDIA DO SUL (PR)";"PR";"MARILANDIA DO SUL";271;16;29;316
2014;"MARILENA (PR)";"PR";"MARILENA";124;8;29;161
2014;"MARILUZ (PR)";"PR";"MARILUZ";198;14;76;288
2014;"MARINGA (PR)";"PR";"MARINGA";9896;564;1001;11461
2014;"MARIOPOLIS (PR)";"PR";"MARIOPOLIS";249;18;38;305
2014;"MARIPA (PR)";"PR";"MARIPA";329;9;13;351
2014;"MARMELEIRO (PR)";"PR";"MARMELEIRO";397;29;53;479
2014;"MARQUINHO (PR)";"PR";"MARQUINHO";73;7;17;97
2014;"MARUMBI (PR)";"PR";"MARUMBI";107;14;23;144
2014;"MATELANDIA (PR)";"PR";"MATELANDIA";670;11;66;747
2014;"MATINHOS (PR)";"PR";"MATINHOS";373;35;31;439
2014;"MATO RICO (PR)";"PR";"MATO RICO";60;3;9;72
2014;"MAUA DA SERRA (PR)";"PR";"MAUA DA SERRA";227;10;22;259
2014;"MEDIANEIRA (PR)";"PR";"MEDIANEIRA";1369;62;117;1548
2014;"MERCEDES (PR)";"PR";"MERCEDES";249;6;30;285
2014;"MIRADOR (PR)";"PR";"MIRADOR";17;0;9;26
2014;"MIRASELVA (PR)";"PR";"MIRASELVA";39;5;29;73
2014;"MISSAL (PR)";"PR";"MISSAL";384;27;38;449
2014;"MOREIRA SALES (PR)";"PR";"MOREIRA SALES";294;13;94;401
2014;"MORRETES (PR)";"PR";"MORRETES";226;22;39;287
2014;"MUNHOZ DE MELLO (PR)";"PR";"MUNHOZ DE MELLO";75;7;8;90
2014;"NOSSA SENHORA DAS GRACAS (PR)";"PR";"NOSSA SENHORA DAS GRACAS";44;9;37;90
2014;"NOVA ALIANCA DO IVAI (PR)";"PR";"NOVA ALIANCA DO IVAI";26;4;7;37
2014;"NOVA AMERICA DA COLINA (PR)";"PR";"NOVA AMERICA DA COLINA";124;7;16;147
2014;"NOVA AURORA (PR)";"PR";"NOVA AURORA";458;12;48;518
2014;"NOVA CANTU (PR)";"PR";"NOVA CANTU";139;0;26;165
2014;"NOVA ESPERANCA (PR)";"PR";"NOVA ESPERANCA";854;46;75;975
2014;"NOVA ESPERANCA DO SUDOESTE (PR)";"PR";"NOVA ESPERANCA DO SUDOESTE";152;14;33;199
2014;"NOVA FATIMA (PR)";"PR";"NOVA FATIMA";289;5;44;338
2014;"NOVA LARANJEIRAS (PR)";"PR";"NOVA LARANJEIRAS";189;6;32;227
2014;"NOVA LONDRINA (PR)";"PR";"NOVA LONDRINA";405;15;48;468
2014;"NOVA OLIMPIA (PR)";"PR";"NOVA OLIMPIA";112;6;22;140
2014;"NOVA PRATA DO IGUACU (PR)";"PR";"NOVA PRATA DO IGUACU";338;13;34;385
2014;"NOVA SANTA BARBARA (PR)";"PR";"NOVA SANTA BARBARA";137;11;8;156
2014;"NOVA SANTA ROSA (PR)";"PR";"NOVA SANTA ROSA";396;11;18;425
2014;"NOVA TEBAS (PR)";"PR";"NOVA TEBAS";130;7;29;166
2014;"NOVO ITACOLOMI (PR)";"PR";"NOVO ITACOLOMI";95;2;10;107
2014;"ORTIGUEIRA (PR)";"PR";"ORTIGUEIRA";403;35;88;526
2014;"OURIZONA (PR)";"PR";"OURIZONA";93;4;20;117
2014;"OURO VERDE DO OESTE (PR)";"PR";"OURO VERDE DO OESTE";158;3;13;174
2014;"PAICANDU (PR)";"PR";"PAICANDU";549;30;64;643
2014;"PALMAS (PR)";"PR";"PALMAS";966;76;105;1147
2014;"PALMEIRA (PR)";"PR";"PALMEIRA";1001;52;95;1148
2014;"PALMITAL (PR)";"PR";"PALMITAL";289;14;55;358
2014;"PALOTINA (PR)";"PR";"PALOTINA";1304;52;148;1504
2014;"PARAISO DO NORTE (PR)";"PR";"PARAISO DO NORTE";288;19;69;376
2014;"PARANACITY (PR)";"PR";"PARANACITY";288;22;51;361
2014;"PARANAGUA (PR)";"PR";"PARANAGUA";1898;177;179;2254
2014;"PARANAPOEMA (PR)";"PR";"PARANAPOEMA";65;6;20;91
2014;"PARANAVAI (PR)";"PR";"PARANAVAI";2113;137;255;2505
2014;"PATO BRAGADO (PR)";"PR";"PATO BRAGADO";162;6;17;185
2014;"PATO BRANCO (PR)";"PR";"PATO BRANCO";2338;166;436;2940
2014;"PAULA FREITAS (PR)";"PR";"PAULA FREITAS";161;5;25;191
2014;"PAULO FRONTIN (PR)";"PR";"PAULO FRONTIN";240;5;17;262
2014;"PEABIRU (PR)";"PR";"PEABIRU";327;19;30;376
2014;"PEROBAL (PR)";"PR";"PEROBAL";112;5;34;151
2014;"PEROLA (PR)";"PR";"PEROLA";233;13;18;264
2014;"PEROLA D OESTE (PR)";"PR";"PEROLA D OESTE";217;5;29;251
2014;"PIEN (PR)";"PR";"PIEN";427;24;32;483
2014;"PINHAIS (PR)";"PR";"PINHAIS";2388;266;455;3109
2014;"PINHAL DO SAO BENTO (PR)";"PR";"PINHAL DO SAO BENTO";50;3;17;70
2014;"PINHALAO (PR)";"PR";"PINHALAO";106;11;19;136
2014;"PINHAO (PR)";"PR";"PINHAO";597;49;117;763
2014;"PIRAI DO SUL (PR)";"PR";"PIRAI DO SUL";490;48;105;643
2014;"PIRAQUARA (PR)";"PR";"PIRAQUARA";669;99;215;983
2014;"PITANGA (PR)";"PR";"PITANGA";929;38;128;1095
2014;"PITANGUEIRAS (PR)";"PR";"PITANGUEIRAS";63;3;31;97
2014;"PLANALTINA DO PARANA (PR)";"PR";"PLANALTINA DO PARANA";110;5;25;140
2014;"PLANALTO (PR)";"PR";"PLANALTO";355;20;41;416
2014;"PONTA GROSSA (PR)";"PR";"PONTA GROSSA";6465;673;1136;8274
2014;"PONTAL DO PARANA (PR)";"PR";"PONTAL DO PARANA";289;27;57;373
2014;"PORECATU (PR)";"PR";"PORECATU";297;36;152;485
2014;"PORTO AMAZONAS (PR)";"PR";"PORTO AMAZONAS";85;9;12;106
2014;"PORTO BARREIRO (PR)";"PR";"PORTO BARREIRO";78;5;28;111
2014;"PORTO RICO (PR)";"PR";"PORTO RICO";38;0;7;45
2014;"PORTO VITORIA (PR)";"PR";"PORTO VITORIA";175;4;13;192
2014;"PRADO FERREIRA (PR)";"PR";"PRADO FERREIRA";100;4;13;117
2014;"PRANCHITA (PR)";"PR";"PRANCHITA";272;8;16;296
2014;"PRESIDENTE CASTELO BRANCO (PR)";"PR";"PRESIDENTE CASTELO BRANCO";126;5;27;158
2014;"PRIMEIRO DE MAIO (PR)";"PR";"PRIMEIRO DE MAIO";337;16;31;384
2014;"PRUDENTOPOLIS (PR)";"PR";"PRUDENTOPOLIS";1366;59;130;1555
2014;"QUARTO CENTENARIO (PR)";"PR";"QUARTO CENTENARIO";140;6;7;153
2014;"QUATIGUA (PR)";"PR";"QUATIGUA";384;10;21;415
2014;"QUATRO BARRAS (PR)";"PR";"QUATRO BARRAS";658;48;121;827
2014;"QUATRO PONTES (PR)";"PR";"QUATRO PONTES";187;5;8;200
2014;"QUEDAS DO IGUACU (PR)";"PR";"QUEDAS DO IGUACU";778;38;152;968
2014;"QUERENCIA DO NORTE (PR)";"PR";"QUERENCIA DO NORTE";232;6;36;274
2014;"QUINTA DO SOL (PR)";"PR";"QUINTA DO SOL";123;4;21;148
2014;"QUITANDINHA (PR)";"PR";"QUITANDINHA";511;11;81;603
2014;"RAMILANDIA (PR)";"PR";"RAMILANDIA";60;4;16;80
2014;"RANCHO ALEGRE (PR)";"PR";"RANCHO ALEGRE";119;6;13;138
2014;"RANCHO ALEGRE D OESTE (PR)";"PR";"RANCHO ALEGRE D OESTE";82;2;11;95
2014;"REALEZA (PR)";"PR";"REALEZA";617;25;45;687
2014;"REBOUCAS (PR)";"PR";"REBOUCAS";296;21;51;368
2014;"RENASCENCA (PR)";"PR";"RENASCENCA";259;11;35;305
2014;"RESERVA (PR)";"PR";"RESERVA";657;30;95;782
2014;"RESERVA DO IGUACU (PR)";"PR";"RESERVA DO IGUACU";83;10;21;114
2014;"RIBEIRAO CLARO (PR)";"PR";"RIBEIRAO CLARO";230;33;37;300
2014;"RIBEIRAO DO PINHAL (PR)";"PR";"RIBEIRAO DO PINHAL";209;33;53;295
2014;"RIO AZUL (PR)";"PR";"RIO AZUL";320;9;42;371
2014;"RIO BOM (PR)";"PR";"RIO BOM";91;6;11;108
2014;"RIO BONITO DO IGUACU (PR)";"PR";"RIO BONITO DO IGUACU";279;10;82;371
2014;"RIO BRANCO DO IVAI (PR)";"PR";"RIO BRANCO DO IVAI";46;5;13;64
2014;"RIO BRANCO DO SUL (PR)";"PR";"RIO BRANCO DO SUL";741;110;167;1018
2014;"RIO NEGRO (PR)";"PR";"RIO NEGRO";1001;84;74;1159
2014;"ROLANDIA (PR)";"PR";"ROLANDIA";1777;125;109;2011
2014;"RONCADOR (PR)";"PR";"RONCADOR";377;4;41;422
2014;"RONDON (PR)";"PR";"RONDON";285;15;72;372
2014;"ROSARIO DO IVAI (PR)";"PR";"ROSARIO DO IVAI";88;9;25;122
2014;"SABAUDIA (PR)";"PR";"SABAUDIA";227;12;22;261
2014;"SALGADO FILHO (PR)";"PR";"SALGADO FILHO";82;4;27;113
2014;"SALTO DO ITARARE (PR)";"PR";"SALTO DO ITARARE";117;5;17;139
2014;"SALTO DO LONTRA (PR)";"PR";"SALTO DO LONTRA";301;12;38;351
2014;"SANTA AMELIA (PR)";"PR";"SANTA AMELIA";94;7;21;122
2014;"SANTA CECILIA DO PAVAO (PR)";"PR";"SANTA CECILIA DO PAVAO";89;8;13;110
2014;"SANTA CRUZ DO MONTE CASTELO (PR)";"PR";"SANTA CRUZ DO MONTE CASTELO";222;11;46;279
2014;"SANTA FE (PR)";"PR";"SANTA FE";285;12;36;333
2014;"SANTA HELENA (PR)";"PR";"SANTA HELENA";648;62;127;837
2014;"SANTA INES (PR)";"PR";"SANTA INES";18;9;10;37
2014;"SANTA ISABEL DO IVAI (PR)";"PR";"SANTA ISABEL DO IVAI";199;16;38;253
2014;"SANTA IZABEL DO OESTE (PR)";"PR";"SANTA IZABEL DO OESTE";227;26;36;289
2014;"SANTA LUCIA (PR)";"PR";"SANTA LUCIA";118;5;12;135
2014;"SANTA MARIA DO OESTE (PR)";"PR";"SANTA MARIA DO OESTE";243;8;23;274
2014;"SANTA MARIANA (PR)";"PR";"SANTA MARIANA";311;23;52;386
2014;"SANTA MONICA (PR)";"PR";"SANTA MONICA";54;4;16;74
2014;"SANTA TEREZA DO OESTE (PR)";"PR";"SANTA TEREZA DO OESTE";238;10;13;261
2014;"SANTA TEREZINHA DE ITAIPU (PR)";"PR";"SANTA TEREZINHA DE ITAIPU";488;57;62;607
2014;"SANTANA DO ITARARE (PR)";"PR";"SANTANA DO ITARARE";92;6;23;121
2014;"SANTO ANTONIO DA PLATINA (PR)";"PR";"SANTO ANTONIO DA PLATINA";721;66;257;1044
2014;"SANTO ANTONIO DO CAIUA (PR)";"PR";"SANTO ANTONIO DO CAIUA";25;2;13;40
2014;"SANTO ANTONIO DO PARAISO (PR)";"PR";"SANTO ANTONIO DO PARAISO";72;7;10;89
2014;"SANTO ANTONIO DO SUDOESTE (PR)";"PR";"SANTO ANTONIO DO SUDOESTE";425;14;47;486
2014;"SANTO INACIO (PR)";"PR";"SANTO INACIO";121;8;24;153
2014;"SAO CARLOS DO IVAI (PR)";"PR";"SAO CARLOS DO IVAI";245;8;29;282
2014;"SAO JERONIMO DA SERRA (PR)";"PR";"SAO JERONIMO DA SERRA";173;11;26;210
2014;"SAO JOAO (PR)";"PR";"SAO JOAO";388;16;49;453
2014;"SAO JOAO DO CAIUA (PR)";"PR";"SAO JOAO DO CAIUA";75;5;33;113
2014;"SAO JOAO DO IVAI (PR)";"PR";"SAO JOAO DO IVAI";348;11;33;392
2014;"SAO JOAO DO TRIUNFO (PR)";"PR";"SAO JOAO DO TRIUNFO";268;13;39;320
2014;"SAO JORGE D OESTE (PR)";"PR";"SAO JORGE D OESTE";243;12;49;304
2014;"SAO JORGE DO IVAI (PR)";"PR";"SAO JORGE DO IVAI";278;6;20;304
2014;"SAO JORGE DO PATROCINIO (PR)";"PR";"SAO JORGE DO PATROCINIO";136;6;25;167
2014;"SAO JOSE DA BOA VISTA (PR)";"PR";"SAO JOSE DA BOA VISTA";108;4;25;137
2014;"SAO JOSE DAS PALMEIRAS (PR)";"PR";"SAO JOSE DAS PALMEIRAS";84;8;30;122
2014;"SAO JOSE DOS PINHAIS (PR)";"PR";"SAO JOSE DOS PINHAIS";7460;688;817;8965
2014;"SAO MANOEL DO PARANA (PR)";"PR";"SAO MANOEL DO PARANA";51;1;13;65
2014;"SAO MATEUS DO SUL (PR)";"PR";"SAO MATEUS DO SUL";1074;98;159;1331
2014;"SAO MIGUEL DO IGUACU (PR)";"PR";"SAO MIGUEL DO IGUACU";913;47;79;1039
2014;"SAO PEDRO DO IGUACU (PR)";"PR";"SAO PEDRO DO IGUACU";187;6;38;231
2014;"SAO PEDRO DO IVAI (PR)";"PR";"SAO PEDRO DO IVAI";344;10;48;402
2014;"SAO PEDRO DO PARANA (PR)";"PR";"SAO PEDRO DO PARANA";46;6;7;59
2014;"SAO SEBASTIAO DA AMOREIRA (PR)";"PR";"SAO SEBASTIAO DA AMOREIRA";204;6;51;261
2014;"SAO TOME (PR)";"PR";"SAO TOME";154;12;39;205
2014;"SAPOPEMA (PR)";"PR";"SAPOPEMA";131;4;18;153
2014;"SARANDI (PR)";"PR";"SARANDI";1097;92;201;1390
2014;"SAUDADE DO IGUACU (PR)";"PR";"SAUDADE DO IGUACU";86;19;23;128
2014;"SENGES (PR)";"PR";"SENGES";552;37;74;663
2014;"SERRANOPOLIS DO IGUACU (PR)";"PR";"SERRANOPOLIS DO IGUACU";167;13;14;194
2014;"SERTANEJA (PR)";"PR";"SERTANEJA";209;13;30;252
2014;"SERTANOPOLIS (PR)";"PR";"SERTANOPOLIS";617;20;65;702
2014;"SIQUEIRA CAMPOS (PR)";"PR";"SIQUEIRA CAMPOS";439;22;66;527
2014;"SULINA (PR)";"PR";"SULINA";89;2;14;105
2014;"TAMARANA (PR)";"PR";"TAMARANA";312;16;53;381
2014;"TAMBOARA (PR)";"PR";"TAMBOARA";101;11;14;126
2014;"TAPEJARA (PR)";"PR";"TAPEJARA";446;8;105;559
2014;"TAPIRA (PR)";"PR";"TAPIRA";163;5;32;200
2014;"TEIXEIRA SOARES (PR)";"PR";"TEIXEIRA SOARES";223;12;82;317
2014;"TELEMACO BORBA (PR)";"PR";"TELEMACO BORBA";1092;217;224;1533
2014;"TERRA BOA (PR)";"PR";"TERRA BOA";350;19;96;465
2014;"TERRA RICA (PR)";"PR";"TERRA RICA";401;22;79;502
2014;"TERRA ROXA (PR)";"PR";"TERRA ROXA";552;16;51;619
2014;"TIBAGI (PR)";"PR";"TIBAGI";349;46;60;455
2014;"TIJUCAS DO SUL (PR)";"PR";"TIJUCAS DO SUL";468;18;44;530
2014;"TOLEDO (PR)";"PR";"TOLEDO";3252;240;229;3721
2014;"TOMAZINA (PR)";"PR";"TOMAZINA";122;12;22;156
2014;"TRES BARRAS DO PARANA (PR)";"PR";"TRES BARRAS DO PARANA";346;8;35;389
2014;"TUNAS DO PARANA (PR)";"PR";"TUNAS DO PARANA";122;13;45;180
2014;"TUNEIRAS DO OESTE (PR)";"PR";"TUNEIRAS DO OESTE";152;9;56;217
2014;"TUPASSI (PR)";"PR";"TUPASSI";340;12;38;390
2014;"TURVO (PR)";"PR";"TURVO";425;25;69;519
2014;"UBIRATA (PR)";"PR";"UBIRATA";758;35;58;851
2014;"UMUARAMA (PR)";"PR";"UMUARAMA";2846;97;284;3227
2014;"UNIAO DA VITORIA (PR)";"PR";"UNIAO DA VITORIA";1532;66;88;1686
2014;"UNIFLOR (PR)";"PR";"UNIFLOR";53;9;13;75
2014;"URAI (PR)";"PR";"URAI";342;22;30;394
2014;"VENTANIA (PR)";"PR";"VENTANIA";173;24;31;228
2014;"VERA CRUZ DO OESTE (PR)";"PR";"VERA CRUZ DO OESTE";283;9;18;310
2014;"VERE (PR)";"PR";"VERE";240;6;25;271
2014;"VIRMOND (PR)";"PR";"VIRMOND";125;1;19;145
2014;"VITORINO (PR)";"PR";"VITORINO";248;11;27;286
2014;"WENCESLAU BRAZ (PR)";"PR";"WENCESLAU BRAZ";458;23;81;562
2014;"XAMBRE (PR)";"PR";"XAMBRE";170;8;16;194
2014;"ANGRA DOS REIS (RJ)";"RJ";"ANGRA DOS REIS";1161;206;369;1736
2014;"APERIBE (RJ)";"RJ";"APERIBE";133;17;10;160
2014;"ARARUAMA (RJ)";"RJ";"ARARUAMA";1863;310;170;2343
2014;"AREAL (RJ)";"RJ";"AREAL";177;34;42;253
2014;"ARMACAO DE BUZIOS (RJ)";"RJ";"ARMACAO DE BUZIOS";328;315;59;702
2014;"ARRAIAL DO CABO (RJ)";"RJ";"ARRAIAL DO CABO";155;56;13;224
2014;"BARRA DO PIRAI (RJ)";"RJ";"BARRA DO PIRAI";1469;216;275;1960
2014;"BARRA MANSA (RJ)";"RJ";"BARRA MANSA";2085;234;651;2970
2014;"BELFORD ROXO (RJ)";"RJ";"BELFORD ROXO";1842;401;918;3161
2014;"BOM JARDIM (RJ)";"RJ";"BOM JARDIM";648;50;51;749
2014;"BOM JESUS DO ITABAPOANA (RJ)";"RJ";"BOM JESUS DO ITABAPOANA";321;63;64;448
2014;"CABO FRIO (RJ)";"RJ";"CABO FRIO";3171;352;494;4017
2014;"CACHOEIRAS DE MACACU (RJ)";"RJ";"CACHOEIRAS DE MACACU";863;168;46;1077
2014;"CAMBUCI (RJ)";"RJ";"CAMBUCI";110;28;23;161
2014;"CAMPOS DOS GOYTACAZES (RJ)";"RJ";"CAMPOS DOS GOYTACAZES";6948;1075;1302;9325
2014;"CANTAGALO (RJ)";"RJ";"CANTAGALO";202;45;44;291
2014;"CARAPEBUS (RJ)";"RJ";"CARAPEBUS";109;22;11;142
2014;"CARDOSO MOREIRA (RJ)";"RJ";"CARDOSO MOREIRA";168;31;41;240
2014;"CARMO (RJ)";"RJ";"CARMO";142;30;33;205
2014;"CASIMIRO DE ABREU (RJ)";"RJ";"CASIMIRO DE ABREU";588;110;30;728
2014;"COMENDADOR LEVY GASPARIAN (RJ)";"RJ";"COMENDADOR LEVY GASPARIAN";186;35;19;240
2014;"CONCEICAO DE MACABU (RJ)";"RJ";"CONCEICAO DE MACABU";175;42;64;281
2014;"CORDEIRO (RJ)";"RJ";"CORDEIRO";292;49;54;395
2014;"DUAS BARRAS (RJ)";"RJ";"DUAS BARRAS";141;39;9;189
2014;"DUQUE DE CAXIAS (RJ)";"RJ";"DUQUE DE CAXIAS";9290;931;3910;14131
2014;"ENGENHEIRO PAULO DE FRONTIN (RJ)";"RJ";"ENGENHEIRO PAULO DE FRONTIN";140;32;16;188
2014;"GUAPIMIRIM (RJ)";"RJ";"GUAPIMIRIM";382;75;49;506
2014;"IGUABA GRANDE (RJ)";"RJ";"IGUABA GRANDE";171;71;22;264
2014;"ITABORAI (RJ)";"RJ";"ITABORAI";3082;748;537;4367
2014;"ITAGUAI (RJ)";"RJ";"ITAGUAI";1680;286;297;2263
2014;"ITALVA (RJ)";"RJ";"ITALVA";208;28;32;268
2014;"ITAOCARA (RJ)";"RJ";"ITAOCARA";366;51;36;453
2014;"ITAPERUNA (RJ)";"RJ";"ITAPERUNA";1184;123;117;1424
2014;"ITATIAIA (RJ)";"RJ";"ITATIAIA";165;79;49;293
2014;"JAPERI (RJ)";"RJ";"JAPERI";542;61;55;658
2014;"LAJE DO MURIAE (RJ)";"RJ";"LAJE DO MURIAE";44;7;16;67
2014;"MACAE (RJ)";"RJ";"MACAE";3139;1115;1068;5322
2014;"MACUCO (RJ)";"RJ";"MACUCO";175;16;11;202
2014;"MAGE (RJ)";"RJ";"MAGE";1801;408;194;2403
2014;"MANGARATIBA (RJ)";"RJ";"MANGARATIBA";190;154;165;509
2014;"MARICA (RJ)";"RJ";"MARICA";1097;345;404;1846
2014;"MENDES (RJ)";"RJ";"MENDES";226;52;37;315
2014;"MESQUITA (RJ)";"RJ";"MESQUITA";826;107;683;1616
2014;"MIGUEL PEREIRA (RJ)";"RJ";"MIGUEL PEREIRA";361;82;34;477
2014;"MIRACEMA (RJ)";"RJ";"MIRACEMA";263;38;36;337
2014;"NATIVIDADE (RJ)";"RJ";"NATIVIDADE";88;22;47;157
2014;"NILOPOLIS (RJ)";"RJ";"NILOPOLIS";657;152;337;1146
2014;"NITEROI (RJ)";"RJ";"NITEROI";2671;1304;2858;6833
2014;"NOVA FRIBURGO (RJ)";"RJ";"NOVA FRIBURGO";3622;280;366;4268
2014;"NOVA IGUACU (RJ)";"RJ";"NOVA IGUACU";6184;1442;1751;9377
2014;"PARACAMBI (RJ)";"RJ";"PARACAMBI";660;92;107;859
2014;"PARAIBA DO SUL (RJ)";"RJ";"PARAIBA DO SUL";615;123;120;858
2014;"PARATI (RJ)";"RJ";"PARATI";214;69;48;331
2014;"PATY DO ALFERES (RJ)";"RJ";"PATY DO ALFERES";485;56;42;583
2014;"PETROPOLIS (RJ)";"RJ";"PETROPOLIS";3092;680;926;4698
2014;"PINHEIRAL (RJ)";"RJ";"PINHEIRAL";211;53;97;361
2014;"PIRAI (RJ)";"RJ";"PIRAI";461;75;70;606
2014;"PORCIUNCULA (RJ)";"RJ";"PORCIUNCULA";76;23;23;122
2014;"PORTO REAL (RJ)";"RJ";"PORTO REAL";385;56;17;458
2014;"QUATIS (RJ)";"RJ";"QUATIS";178;81;31;290
2014;"QUEIMADOS (RJ)";"RJ";"QUEIMADOS";629;209;228;1066
2014;"QUISSAMA (RJ)";"RJ";"QUISSAMA";221;38;121;380
2014;"RESENDE (RJ)";"RJ";"RESENDE";1425;301;765;2491
2014;"RIO BONITO (RJ)";"RJ";"RIO BONITO";3498;345;149;3992
2014;"RIO CLARO (RJ)";"RJ";"RIO CLARO";110;21;22;153
2014;"RIO DAS FLORES (RJ)";"RJ";"RIO DAS FLORES";56;28;17;101
2014;"RIO DAS OSTRAS (RJ)";"RJ";"RIO DAS OSTRAS";1066;777;116;1959
2014;"RIO DE JANEIRO (RJ)";"RJ";"RIO DE JANEIRO";41388;17933;17723;77044
2014;"SANTA MARIA MADALENA (RJ)";"RJ";"SANTA MARIA MADALENA";74;22;14;110
2014;"SANTO ANTONIO DE PADUA (RJ)";"RJ";"SANTO ANTONIO DE PADUA";642;105;35;782
2014;"SAO FIDELIS (RJ)";"RJ";"SAO FIDELIS";432;41;67;540
2014;"SAO FRANCISCO DE ITABAPOANA (RJ)";"RJ";"SAO FRANCISCO DE ITABAPOANA";403;104;88;595
2014;"SAO GONCALO (RJ)";"RJ";"SAO GONCALO";4619;1927;3252;9798
2014;"SAO JOAO DA BARRA (RJ)";"RJ";"SAO JOAO DA BARRA";657;109;67;833
2014;"SAO JOAO DE MERITI (RJ)";"RJ";"SAO JOAO DE MERITI";3740;558;1402;5700
2014;"SAO JOSE DE UBA (RJ)";"RJ";"SAO JOSE DE UBA";50;11;10;71
2014;"SAO JOSE DO VALE DO RIO PRETO (RJ)";"RJ";"SAO JOSE DO VALE DO RIO PRETO";699;36;37;772
2014;"SAO PEDRO DA ALDEIA (RJ)";"RJ";"SAO PEDRO DA ALDEIA";929;103;78;1110
2014;"SAO SEBASTIAO DO ALTO (RJ)";"RJ";"SAO SEBASTIAO DO ALTO";110;30;7;147
2014;"SAPUCAIA (RJ)";"RJ";"SAPUCAIA";128;24;11;163
2014;"SAQUAREMA (RJ)";"RJ";"SAQUAREMA";778;143;138;1059
2014;"SEROPEDICA (RJ)";"RJ";"SEROPEDICA";1180;79;293;1552
2014;"SILVA JARDIM (RJ)";"RJ";"SILVA JARDIM";291;58;48;397
2014;"SUMIDOURO (RJ)";"RJ";"SUMIDOURO";320;15;14;349
2014;"TANGUA (RJ)";"RJ";"TANGUA";300;64;145;509
2014;"TERESOPOLIS (RJ)";"RJ";"TERESOPOLIS";2218;302;316;2836
2014;"TRAJANO DE MORAIS (RJ)";"RJ";"TRAJANO DE MORAIS";97;24;16;137
2014;"TRES RIOS (RJ)";"RJ";"TRES RIOS";1064;121;209;1394
2014;"VALENCA (RJ)";"RJ";"VALENCA";393;125;99;617
2014;"VARRE SAI (RJ)";"RJ";"VARRE SAI";70;17;5;92
2014;"VASSOURAS (RJ)";"RJ";"VASSOURAS";562;88;97;747
2014;"VOLTA REDONDA (RJ)";"RJ";"VOLTA REDONDA";2364;415;624;3403
2014;"ACARI (RN)";"RN";"ACARI";103;10;14;127
2014;"AFONSO BEZERRA (RN)";"RN";"AFONSO BEZERRA";31;4;8;43
2014;"AGUA NOVA (RN)";"RN";"AGUA NOVA";8;12;2;22
2014;"ALEXANDRIA (RN)";"RN";"ALEXANDRIA";72;36;13;121
2014;"ALMINO AFONSO (RN)";"RN";"ALMINO AFONSO";20;9;1;30
2014;"ALTO DO RODRIGUES (RN)";"RN";"ALTO DO RODRIGUES";169;19;27;215
2014;"ANGICOS (RN)";"RN";"ANGICOS";122;18;12;152
2014;"ANTONIO MARTINS (RN)";"RN";"ANTONIO MARTINS";22;9;3;34
2014;"APODI (RN)";"RN";"APODI";303;32;40;375
2014;"AREIA BRANCA (RN)";"RN";"AREIA BRANCA";125;52;71;248
2014;"ARES (RN)";"RN";"ARES";57;7;40;104
2014;"ASSU (RN)";"RN";"ASSU";646;65;85;796
2014;"BAIA FORMOSA (RN)";"RN";"BAIA FORMOSA";51;2;20;73
2014;"BARAUNA (RN)";"RN";"BARAUNA";596;29;33;658
2014;"BARCELONA (RN)";"RN";"BARCELONA";27;2;3;32
2014;"BENTO FERNANDES (RN)";"RN";"BENTO FERNANDES";14;5;10;29
2014;"BOA SAUDE (RN)";"RN";"BOA SAUDE";61;5;14;80
2014;"BODO (RN)";"RN";"BODO";7;5;2;14
2014;"BOM JESUS (RN)";"RN";"BOM JESUS";56;2;8;66
2014;"BREJINHO (RN)";"RN";"BREJINHO";104;13;15;132
2014;"CAICARA DO NORTE (RN)";"RN";"CAICARA DO NORTE";16;2;5;23
2014;"CAICARA DO RIO DO VENTO (RN)";"RN";"CAICARA DO RIO DO VENTO";20;4;2;26
2014;"CAICO (RN)";"RN";"CAICO";1832;121;56;2009
2014;"CAMPO GRANDE (RN)";"RN";"CAMPO GRANDE";43;10;7;60
2014;"CAMPO REDONDO (RN)";"RN";"CAMPO REDONDO";58;11;10;79
2014;"CANGUARETAMA (RN)";"RN";"CANGUARETAMA";173;29;73;275
2014;"CARAUBAS (RN)";"RN";"CARAUBAS";163;41;17;221
2014;"CARNAUBA DOS DANTAS (RN)";"RN";"CARNAUBA DOS DANTAS";218;10;10;238
2014;"CARNAUBAIS (RN)";"RN";"CARNAUBAIS";52;18;15;85
2014;"CEARA MIRIM (RN)";"RN";"CEARA MIRIM";333;44;130;507
2014;"CERRO CORA (RN)";"RN";"CERRO CORA";100;10;9;119
2014;"CORONEL EZEQUIEL (RN)";"RN";"CORONEL EZEQUIEL";57;8;4;69
2014;"CORONEL JOAO PESSOA (RN)";"RN";"CORONEL JOAO PESSOA";15;3;3;21
2014;"CRUZETA (RN)";"RN";"CRUZETA";85;18;11;114
2014;"CURRAIS NOVOS (RN)";"RN";"CURRAIS NOVOS";717;58;64;839
2014;"DOUTOR SEVERIANO (RN)";"RN";"DOUTOR SEVERIANO";28;5;10;43
2014;"ENCANTO (RN)";"RN";"ENCANTO";13;8;9;30
2014;"EQUADOR (RN)";"RN";"EQUADOR";129;5;4;138
2014;"ESPIRITO SANTO (RN)";"RN";"ESPIRITO SANTO";27;3;13;43
2014;"EXTREMOZ (RN)";"RN";"EXTREMOZ";72;20;40;132
2014;"FELIPE GUERRA (RN)";"RN";"FELIPE GUERRA";19;9;8;36
2014;"FERNANDO PEDROZA (RN)";"RN";"FERNANDO PEDROZA";26;4;2;32
2014;"FLORANIA (RN)";"RN";"FLORANIA";67;9;6;82
2014;"FRANCISCO DANTAS (RN)";"RN";"FRANCISCO DANTAS";15;4;3;22
2014;"FRUTUOSO GOMES (RN)";"RN";"FRUTUOSO GOMES";23;8;2;33
2014;"GALINHOS (RN)";"RN";"GALINHOS";12;4;4;20
2014;"GOIANINHA (RN)";"RN";"GOIANINHA";181;44;76;301
2014;"GOVERNADOR DIX SEPT ROSADO (RN)";"RN";"GOVERNADOR DIX SEPT ROSADO";149;26;17;192
2014;"GROSSOS (RN)";"RN";"GROSSOS";54;4;16;74
2014;"GUAMARE (RN)";"RN";"GUAMARE";122;23;41;186
2014;"IELMO MARINHO (RN)";"RN";"IELMO MARINHO";47;4;25;76
2014;"IPANGUACU (RN)";"RN";"IPANGUACU";99;29;51;179
2014;"IPUEIRA (RN)";"RN";"IPUEIRA";16;7;6;29
2014;"ITAJA (RN)";"RN";"ITAJA";103;4;6;113
2014;"ITAU (RN)";"RN";"ITAU";34;7;1;42
2014;"JACANA (RN)";"RN";"JACANA";201;49;24;274
2014;"JANDAIRA (RN)";"RN";"JANDAIRA";46;0;13;59
2014;"JANDUIS (RN)";"RN";"JANDUIS";16;3;3;22
2014;"JAPI (RN)";"RN";"JAPI";52;12;6;70
2014;"JARDIM DE ANGICOS (RN)";"RN";"JARDIM DE ANGICOS";11;0;4;15
2014;"JARDIM DE PIRANHAS (RN)";"RN";"JARDIM DE PIRANHAS";86;28;9;123
2014;"JARDIM DO SERIDO (RN)";"RN";"JARDIM DO SERIDO";146;19;51;216
2014;"JOAO CAMARA (RN)";"RN";"JOAO CAMARA";351;21;37;409
2014;"JOAO DIAS (RN)";"RN";"JOAO DIAS";6;1;1;8
2014;"JOSE DA PENHA (RN)";"RN";"JOSE DA PENHA";32;16;2;50
2014;"JUCURUTU (RN)";"RN";"JUCURUTU";136;40;12;188
2014;"JUNDIA (RN)";"RN";"JUNDIA";12;5;9;26
2014;"LAGOA DANTA (RN)";"RN";"LAGOA DANTA";44;10;14;68
2014;"LAGOA DE PEDRAS (RN)";"RN";"LAGOA DE PEDRAS";31;5;15;51
2014;"LAGOA DE VELHOS (RN)";"RN";"LAGOA DE VELHOS";22;2;2;26
2014;"LAGOA NOVA (RN)";"RN";"LAGOA NOVA";99;7;12;118
2014;"LAGOA SALGADA (RN)";"RN";"LAGOA SALGADA";84;5;8;97
2014;"LAJES (RN)";"RN";"LAJES";69;6;11;86
2014;"LAJES PINTADAS (RN)";"RN";"LAJES PINTADAS";25;11;7;43
2014;"LUCRECIA (RN)";"RN";"LUCRECIA";24;8;4;36
2014;"LUIS GOMES (RN)";"RN";"LUIS GOMES";42;37;6;85
2014;"MACAIBA (RN)";"RN";"MACAIBA";827;123;83;1033
2014;"MACAU (RN)";"RN";"MACAU";213;34;60;307
2014;"MAJOR SALES (RN)";"RN";"MAJOR SALES";16;13;2;31
2014;"MARCELINO VIEIRA (RN)";"RN";"MARCELINO VIEIRA";22;14;1;37
2014;"MARTINS (RN)";"RN";"MARTINS";45;13;7;65
2014;"MAXARANGUAPE (RN)";"RN";"MAXARANGUAPE";25;10;9;44
2014;"MESSIAS TARGINO (RN)";"RN";"MESSIAS TARGINO";37;8;4;49
2014;"MONTANHAS (RN)";"RN";"MONTANHAS";53;5;17;75
2014;"MONTE ALEGRE (RN)";"RN";"MONTE ALEGRE";116;19;28;163
2014;"MONTE DAS GAMELEIRAS (RN)";"RN";"MONTE DAS GAMELEIRAS";13;3;7;23
2014;"MOSSORO (RN)";"RN";"MOSSORO";3808;309;296;4413
2014;"NATAL (RN)";"RN";"NATAL";6857;1272;2530;10659
2014;"NISIA FLORESTA (RN)";"RN";"NISIA FLORESTA";85;44;49;178
2014;"NOVA CRUZ (RN)";"RN";"NOVA CRUZ";412;44;68;524
2014;"OLHO D AGUA DO BORGES (RN)";"RN";"OLHO D AGUA DO BORGES";23;3;1;27
2014;"OURO BRANCO (RN)";"RN";"OURO BRANCO";46;14;4;64
2014;"PARANA (RN)";"RN";"PARANA";16;11;4;31
2014;"PARAU (RN)";"RN";"PARAU";19;12;2;33
2014;"PARAZINHO (RN)";"RN";"PARAZINHO";32;5;15;52
2014;"PARELHAS (RN)";"RN";"PARELHAS";425;32;42;499
2014;"PARNAMIRIM (RN)";"RN";"PARNAMIRIM";2023;385;402;2810
2014;"PASSA E FICA (RN)";"RN";"PASSA E FICA";143;42;38;223
2014;"PASSAGEM (RN)";"RN";"PASSAGEM";16;8;2;26
2014;"PATU (RN)";"RN";"PATU";106;20;4;130
2014;"PAU DOS FERROS (RN)";"RN";"PAU DOS FERROS";509;58;33;600
2014;"PEDRA GRANDE (RN)";"RN";"PEDRA GRANDE";12;1;6;19
2014;"PEDRA PRETA (RN)";"RN";"PEDRA PRETA";32;3;11;46
2014;"PEDRO AVELINO (RN)";"RN";"PEDRO AVELINO";34;4;6;44
2014;"PEDRO VELHO (RN)";"RN";"PEDRO VELHO";50;7;13;70
2014;"PENDENCIAS (RN)";"RN";"PENDENCIAS";69;14;16;99
2014;"PILOES (RN)";"RN";"PILOES";20;5;2;27
2014;"POCO BRANCO (RN)";"RN";"POCO BRANCO";35;4;11;50
2014;"PORTALEGRE (RN)";"RN";"PORTALEGRE";43;13;5;61
2014;"PORTO DO MANGUE (RN)";"RN";"PORTO DO MANGUE";33;14;7;54
2014;"PUREZA (RN)";"RN";"PUREZA";78;7;19;104
2014;"RAFAEL FERNANDES (RN)";"RN";"RAFAEL FERNANDES";26;5;1;32
2014;"RAFAEL GODEIRO (RN)";"RN";"RAFAEL GODEIRO";9;2;2;13
2014;"RIACHO DA CRUZ (RN)";"RN";"RIACHO DA CRUZ";8;3;1;12
2014;"RIACHO DE SANTANA (RN)";"RN";"RIACHO DE SANTANA";8;9;4;21
2014;"RIACHUELO (RN)";"RN";"RIACHUELO";28;4;7;39
2014;"RIO DO FOGO (RN)";"RN";"RIO DO FOGO";39;7;7;53
2014;"RODOLFO FERNANDES (RN)";"RN";"RODOLFO FERNANDES";25;6;3;34
2014;"RUY BARBOSA (RN)";"RN";"RUY BARBOSA";19;2;2;23
2014;"SANTA CRUZ (RN)";"RN";"SANTA CRUZ";462;34;34;530
2014;"SANTA MARIA (RN)";"RN";"SANTA MARIA";67;4;7;78
2014;"SANTANA DO MATOS (RN)";"RN";"SANTANA DO MATOS";84;16;11;111
2014;"SANTANA DO SERIDO (RN)";"RN";"SANTANA DO SERIDO";28;2;2;32
2014;"SANTO ANTONIO (RN)";"RN";"SANTO ANTONIO";123;54;34;211
2014;"SAO BENTO DO NORTE (RN)";"RN";"SAO BENTO DO NORTE";9;0;9;18
2014;"SAO BENTO DO TRAIRI (RN)";"RN";"SAO BENTO DO TRAIRI";17;2;4;23
2014;"SAO FERNANDO (RN)";"RN";"SAO FERNANDO";15;11;2;28
2014;"SAO FRANCISCO DO OESTE (RN)";"RN";"SAO FRANCISCO DO OESTE";29;4;3;36
2014;"SAO GONCALO DO AMARANTE (RN)";"RN";"SAO GONCALO DO AMARANTE";451;151;242;844
2014;"SAO JOAO DO SABUGI (RN)";"RN";"SAO JOAO DO SABUGI";49;22;3;74
2014;"SAO JOSE DE MIPIBU (RN)";"RN";"SAO JOSE DE MIPIBU";308;38;55;401
2014;"SAO JOSE DO CAMPESTRE (RN)";"RN";"SAO JOSE DO CAMPESTRE";77;2;19;98
2014;"SAO JOSE DO SERIDO (RN)";"RN";"SAO JOSE DO SERIDO";35;9;3;47
2014;"SAO MIGUEL (RN)";"RN";"SAO MIGUEL";204;44;26;274
2014;"SAO MIGUEL DO GOSTOSO (RN)";"RN";"SAO MIGUEL DO GOSTOSO";29;12;11;52
2014;"SAO PAULO DO POTENGI (RN)";"RN";"SAO PAULO DO POTENGI";122;10;20;152
2014;"SAO PEDRO (RN)";"RN";"SAO PEDRO";31;4;7;42
2014;"SAO RAFAEL (RN)";"RN";"SAO RAFAEL";37;14;5;56
2014;"SAO TOME (RN)";"RN";"SAO TOME";61;5;26;92
2014;"SAO VICENTE (RN)";"RN";"SAO VICENTE";47;4;6;57
2014;"SENADOR ELOI DE SOUZA (RN)";"RN";"SENADOR ELOI DE SOUZA";22;3;13;38
2014;"SENADOR GEORGINO AVELINO (RN)";"RN";"SENADOR GEORGINO AVELINO";14;2;2;18
2014;"SERRA CAIADA (RN)";"RN";"SERRA CAIADA";36;7;15;58
2014;"SERRA DE SAO BENTO (RN)";"RN";"SERRA DE SAO BENTO";38;6;6;50
2014;"SERRA DO MEL (RN)";"RN";"SERRA DO MEL";93;10;13;116
2014;"SERRA NEGRA DO NORTE (RN)";"RN";"SERRA NEGRA DO NORTE";80;18;9;107
2014;"SERRINHA (RN)";"RN";"SERRINHA";24;15;8;47
2014;"SERRINHA DOS PINTOS (RN)";"RN";"SERRINHA DOS PINTOS";30;5;2;37
2014;"SEVERIANO MELO (RN)";"RN";"SEVERIANO MELO";37;8;7;52
2014;"SITIO NOVO (RN)";"RN";"SITIO NOVO";16;6;3;25
2014;"TABOLEIRO GRANDE (RN)";"RN";"TABOLEIRO GRANDE";9;5;3;17
2014;"TAIPU (RN)";"RN";"TAIPU";57;5;18;80
2014;"TANGARA (RN)";"RN";"TANGARA";159;7;35;201
2014;"TENENTE ANANIAS (RN)";"RN";"TENENTE ANANIAS";54;19;3;76
2014;"TENENTE LAURENTINO CRUZ (RN)";"RN";"TENENTE LAURENTINO CRUZ";51;8;5;64
2014;"TIBAU (RN)";"RN";"TIBAU";34;10;17;61
2014;"TIBAU DO SUL (RN)";"RN";"TIBAU DO SUL";48;42;15;105
2014;"TIMBAUBA DOS BATISTAS (RN)";"RN";"TIMBAUBA DOS BATISTAS";16;7;3;26
2014;"TOUROS (RN)";"RN";"TOUROS";180;33;49;262
2014;"TRIUNFO POTIGUAR (RN)";"RN";"TRIUNFO POTIGUAR";13;6;3;22
2014;"UMARIZAL (RN)";"RN";"UMARIZAL";66;32;4;102
2014;"UPANEMA (RN)";"RN";"UPANEMA";70;11;13;94
2014;"VARZEA (RN)";"RN";"VARZEA";14;4;7;25
2014;"VENHA VER (RN)";"RN";"VENHA VER";18;8;4;30
2014;"VERA CRUZ (RN)";"RN";"VERA CRUZ";151;6;21;178
2014;"VICOSA (RN)";"RN";"VICOSA";6;2;1;9
2014;"VILA FLOR (RN)";"RN";"VILA FLOR";12;2;3;17
2014;"ALTA FLORESTA D OESTE (RO)";"RO";"ALTA FLORESTA D OESTE";552;16;64;632
2014;"ALTO ALEGRE DOS PARECIS (RO)";"RO";"ALTO ALEGRE DOS PARECIS";152;13;33;198
2014;"ALTO PARAISO (RO)";"RO";"ALTO PARAISO";299;8;60;367
2014;"ALVORADA D OESTE (RO)";"RO";"ALVORADA D OESTE";268;7;65;340
2014;"ARIQUEMES (RO)";"RO";"ARIQUEMES";2108;35;188;2331
2014;"BURITIS (RO)";"RO";"BURITIS";486;8;32;526
2014;"CABIXI (RO)";"RO";"CABIXI";85;2;22;109
2014;"CACAULANDIA (RO)";"RO";"CACAULANDIA";72;3;18;93
2014;"CACOAL (RO)";"RO";"CACOAL";1749;63;298;2110
2014;"CAMPO NOVO DE RONDONIA (RO)";"RO";"CAMPO NOVO DE RONDONIA";72;7;27;106
2014;"CANDEIAS DO JAMARI (RO)";"RO";"CANDEIAS DO JAMARI";195;4;34;233
2014;"CASTANHEIRAS (RO)";"RO";"CASTANHEIRAS";33;2;15;50
2014;"CEREJEIRAS (RO)";"RO";"CEREJEIRAS";366;3;57;426
2014;"CHUPINGUAIA (RO)";"RO";"CHUPINGUAIA";139;4;51;194
2014;"COLORADO DO OESTE (RO)";"RO";"COLORADO DO OESTE";383;12;52;447
2014;"CORUMBIARA (RO)";"RO";"CORUMBIARA";79;8;16;103
2014;"COSTA MARQUES (RO)";"RO";"COSTA MARQUES";127;7;21;155
2014;"CUJUBIM (RO)";"RO";"CUJUBIM";257;7;21;285
2014;"ESPIGAO D OESTE (RO)";"RO";"ESPIGAO D OESTE";609;6;112;727
2014;"GOVERNADOR JORGE TEIXEIRA (RO)";"RO";"GOVERNADOR JORGE TEIXEIRA";71;2;20;93
2014;"GUAJARA MIRIM (RO)";"RO";"GUAJARA MIRIM";874;13;42;929
2014;"ITAPUA DO OESTE (RO)";"RO";"ITAPUA DO OESTE";161;4;49;214
2014;"JARU (RO)";"RO";"JARU";1003;24;195;1222
2014;"JI PARANA (RO)";"RO";"JI PARANA";2824;76;626;3526
2014;"MACHADINHO D OESTE (RO)";"RO";"MACHADINHO D OESTE";388;14;58;460
2014;"MINISTRO ANDREAZZA (RO)";"RO";"MINISTRO ANDREAZZA";204;3;19;226
2014;"MIRANTE DA SERRA (RO)";"RO";"MIRANTE DA SERRA";202;5;27;234
2014;"MONTE NEGRO (RO)";"RO";"MONTE NEGRO";310;14;77;401
2014;"NOVA BRASILANDIA D OESTE (RO)";"RO";"NOVA BRASILANDIA D OESTE";260;8;67;335
2014;"NOVA DO MAMORE (RO)";"RO";"NOVA DO MAMORE";288;2;27;317
2014;"NOVA UNIAO (RO)";"RO";"NOVA UNIAO";70;1;28;99
2014;"NOVO HORIZONTE DO OESTE (RO)";"RO";"NOVO HORIZONTE DO OESTE";112;0;17;129
2014;"OURO PRETO DO OESTE (RO)";"RO";"OURO PRETO DO OESTE";799;27;111;937
2014;"PARECIS (RO)";"RO";"PARECIS";42;3;19;64
2014;"PIMENTA BUENO (RO)";"RO";"PIMENTA BUENO";1123;39;82;1244
2014;"PIMENTEIRAS DO OESTE (RO)";"RO";"PIMENTEIRAS DO OESTE";25;1;12;38
2014;"PORTO VELHO (RO)";"RO";"PORTO VELHO";6644;492;1631;8767
2014;"PRESIDENTE MEDICI (RO)";"RO";"PRESIDENTE MEDICI";341;9;58;408
2014;"PRIMAVERA DE RONDONIA (RO)";"RO";"PRIMAVERA DE RONDONIA";46;3;14;63
2014;"RIO CRESPO (RO)";"RO";"RIO CRESPO";50;2;20;72
2014;"ROLIM DE MOURA (RO)";"RO";"ROLIM DE MOURA";1185;36;119;1340
2014;"SANTA LUZIA D OESTE (RO)";"RO";"SANTA LUZIA D OESTE";165;4;47;216
2014;"SAO FELIPE D OESTE (RO)";"RO";"SAO FELIPE D OESTE";86;3;23;112
2014;"SAO FRANCISCO DO GUAPORE (RO)";"RO";"SAO FRANCISCO DO GUAPORE";284;6;72;362
2014;"SAO MIGUEL DO GUAPORE (RO)";"RO";"SAO MIGUEL DO GUAPORE";286;11;64;361
2014;"SERINGUEIRAS (RO)";"RO";"SERINGUEIRAS";210;3;41;254
2014;"TEIXEIROPOLIS (RO)";"RO";"TEIXEIROPOLIS";42;1;12;55
2014;"THEOBROMA (RO)";"RO";"THEOBROMA";103;1;22;126
2014;"URUPA (RO)";"RO";"URUPA";110;5;80;195
2014;"VALE DO ANARI (RO)";"RO";"VALE DO ANARI";86;8;20;114
2014;"VALE DO PARAISO (RO)";"RO";"VALE DO PARAISO";67;0;19;86
2014;"VILHENA (RO)";"RO";"VILHENA";1673;68;178;1919
2014;"ALTO ALEGRE (RR)";"RR";"ALTO ALEGRE";64;8;12;84
2014;"AMAJARI (RR)";"RR";"AMAJARI";23;6;4;33
2014;"BOA VISTA (RR)";"RR";"BOA VISTA";3362;470;746;4578
2014;"BONFIM (RR)";"RR";"BONFIM";15;2;3;20
2014;"CANTA (RR)";"RR";"CANTA";46;7;11;64
2014;"CARACARAI (RR)";"RR";"CARACARAI";118;8;10;136
2014;"CAROEBE (RR)";"RR";"CAROEBE";44;8;32;84
2014;"IRACEMA (RR)";"RR";"IRACEMA";30;16;1;47
2014;"MUCAJAI (RR)";"RR";"MUCAJAI";103;45;44;192
2014;"NORMANDIA (RR)";"RR";"NORMANDIA";14;0;2;16
2014;"PACARAIMA (RR)";"RR";"PACARAIMA";92;3;6;101
2014;"RORAINOPOLIS (RR)";"RR";"RORAINOPOLIS";155;26;21;202
2014;"SAO JOAO DA BALIZA (RR)";"RR";"SAO JOAO DA BALIZA";46;6;4;56
2014;"SAO LUIZ (RR)";"RR";"SAO LUIZ";36;4;5;45
2014;"UIRAMUTA (RR)";"RR";"UIRAMUTA";0;0;0;0
2014;"ACEGUA (RS)";"RS";"ACEGUA";72;20;19;111
2014;"AGUA SANTA (RS)";"RS";"AGUA SANTA";181;13;19;213
2014;"AGUDO (RS)";"RS";"AGUDO";324;17;59;400
2014;"AJURICABA (RS)";"RS";"AJURICABA";424;22;31;477
2014;"ALECRIM (RS)";"RS";"ALECRIM";86;6;28;120
2014;"ALEGRETE (RS)";"RS";"ALEGRETE";986;54;243;1283
2014;"ALEGRIA (RS)";"RS";"ALEGRIA";90;5;25;120
2014;"ALMIRANTE TAMANDARE DO SUL (RS)";"RS";"ALMIRANTE TAMANDARE DO SUL";97;14;4;115
2014;"ALPESTRE (RS)";"RS";"ALPESTRE";143;20;48;211
2014;"ALTO ALEGRE (RS)";"RS";"ALTO ALEGRE";105;7;8;120
2014;"ALTO FELIZ (RS)";"RS";"ALTO FELIZ";107;9;15;131
2014;"ALVORADA (RS)";"RS";"ALVORADA";1765;222;602;2589
2014;"AMARAL FERRADOR (RS)";"RS";"AMARAL FERRADOR";132;14;23;169
2014;"AMETISTA DO SUL (RS)";"RS";"AMETISTA DO SUL";74;6;59;139
2014;"ANDRE DA ROCHA (RS)";"RS";"ANDRE DA ROCHA";55;8;6;69
2014;"ANTA GORDA (RS)";"RS";"ANTA GORDA";260;23;23;306
2014;"ANTONIO PRADO (RS)";"RS";"ANTONIO PRADO";668;17;44;729
2014;"ARAMBARE (RS)";"RS";"ARAMBARE";86;7;13;106
2014;"ARARICA (RS)";"RS";"ARARICA";97;8;15;120
2014;"ARATIBA (RS)";"RS";"ARATIBA";174;34;39;247
2014;"ARROIO DO MEIO (RS)";"RS";"ARROIO DO MEIO";579;46;52;677
2014;"ARROIO DO PADRE (RS)";"RS";"ARROIO DO PADRE";103;5;15;123
2014;"ARROIO DO SAL (RS)";"RS";"ARROIO DO SAL";123;9;12;144
2014;"ARROIO DO TIGRE (RS)";"RS";"ARROIO DO TIGRE";320;26;41;387
2014;"ARROIO DOS RATOS (RS)";"RS";"ARROIO DOS RATOS";234;18;72;324
2014;"ARROIO GRANDE (RS)";"RS";"ARROIO GRANDE";274;23;59;356
2014;"ARVOREZINHA (RS)";"RS";"ARVOREZINHA";497;39;51;587
2014;"AUGUSTO PESTANA (RS)";"RS";"AUGUSTO PESTANA";455;14;34;503
2014;"AUREA (RS)";"RS";"AUREA";161;6;12;179
2014;"BAGE (RS)";"RS";"BAGE";1273;205;345;1823
2014;"BALNEARIO PINHAL (RS)";"RS";"BALNEARIO PINHAL";118;9;24;151
2014;"BARAO (RS)";"RS";"BARAO";195;26;52;273
2014;"BARAO DE COTEGIPE (RS)";"RS";"BARAO DE COTEGIPE";258;16;18;292
2014;"BARAO DO TRIUNFO (RS)";"RS";"BARAO DO TRIUNFO";125;21;45;191
2014;"BARRA DO GUARITA (RS)";"RS";"BARRA DO GUARITA";34;6;8;48
2014;"BARRA DO QUARAI (RS)";"RS";"BARRA DO QUARAI";30;4;15;49
2014;"BARRA DO RIBEIRO (RS)";"RS";"BARRA DO RIBEIRO";210;13;59;282
2014;"BARRA DO RIO AZUL (RS)";"RS";"BARRA DO RIO AZUL";43;12;13;68
2014;"BARRA FUNDA (RS)";"RS";"BARRA FUNDA";187;4;22;213
2014;"BARRACAO (RS)";"RS";"BARRACAO";159;8;21;188
2014;"BARROS CASSAL (RS)";"RS";"BARROS CASSAL";180;28;61;269
2014;"BENJAMIN CONSTANT DO SUL (RS)";"RS";"BENJAMIN CONSTANT DO SUL";27;4;18;49
2014;"BENTO GONCALVES (RS)";"RS";"BENTO GONCALVES";3412;294;336;4042
2014;"BOA VISTA DAS MISSOES (RS)";"RS";"BOA VISTA DAS MISSOES";104;6;15;125
2014;"BOA VISTA DO BURICA (RS)";"RS";"BOA VISTA DO BURICA";246;16;27;289
2014;"BOA VISTA DO CADEADO (RS)";"RS";"BOA VISTA DO CADEADO";125;2;21;148
2014;"BOA VISTA DO INCRA (RS)";"RS";"BOA VISTA DO INCRA";78;3;10;91
2014;"BOA VISTA DO SUL (RS)";"RS";"BOA VISTA DO SUL";335;7;14;356
2014;"BOM JESUS (RS)";"RS";"BOM JESUS";277;39;57;373
2014;"BOM PRINCIPIO (RS)";"RS";"BOM PRINCIPIO";498;34;34;566
2014;"BOM PROGRESSO (RS)";"RS";"BOM PROGRESSO";55;11;8;74
2014;"BOM RETIRO DO SUL (RS)";"RS";"BOM RETIRO DO SUL";196;14;30;240
2014;"BOQUEIRAO DO LEAO (RS)";"RS";"BOQUEIRAO DO LEAO";193;11;20;224
2014;"BOSSOROCA (RS)";"RS";"BOSSOROCA";201;6;24;231
2014;"BOZANO (RS)";"RS";"BOZANO";155;4;7;166
2014;"BRAGA (RS)";"RS";"BRAGA";76;5;19;100
2014;"BROCHIER (RS)";"RS";"BROCHIER";300;14;28;342
2014;"BUTIA (RS)";"RS";"BUTIA";479;36;136;651
2014;"CACAPAVA DO SUL (RS)";"RS";"CACAPAVA DO SUL";668;60;128;856
2014;"CACEQUI (RS)";"RS";"CACEQUI";152;19;24;195
2014;"CACHOEIRA DO SUL (RS)";"RS";"CACHOEIRA DO SUL";1296;106;241;1643
2014;"CACHOEIRINHA (RS)";"RS";"CACHOEIRINHA";2428;229;501;3158
2014;"CACIQUE DOBLE (RS)";"RS";"CACIQUE DOBLE";121;6;14;141
2014;"CAIBATE (RS)";"RS";"CAIBATE";140;8;5;153
2014;"CAICARA (RS)";"RS";"CAICARA";88;8;24;120
2014;"CAMAQUA (RS)";"RS";"CAMAQUA";1381;70;273;1724
2014;"CAMARGO (RS)";"RS";"CAMARGO";190;6;20;216
2014;"CAMBARA DO SUL (RS)";"RS";"CAMBARA DO SUL";263;13;36;312
2014;"CAMPESTRE DA SERRA (RS)";"RS";"CAMPESTRE DA SERRA";169;3;16;188
2014;"CAMPINA DAS MISSOES (RS)";"RS";"CAMPINA DAS MISSOES";166;11;34;211
2014;"CAMPINAS DO SUL (RS)";"RS";"CAMPINAS DO SUL";196;10;25;231
2014;"CAMPO BOM (RS)";"RS";"CAMPO BOM";849;110;90;1049
2014;"CAMPO NOVO (RS)";"RS";"CAMPO NOVO";178;15;30;223
2014;"CAMPOS BORGES (RS)";"RS";"CAMPOS BORGES";166;15;16;197
2014;"CANDELARIA (RS)";"RS";"CANDELARIA";463;31;98;592
2014;"CANDIDO GODOI (RS)";"RS";"CANDIDO GODOI";252;15;20;287
2014;"CANDIOTA (RS)";"RS";"CANDIOTA";150;35;52;237
2014;"CANELA (RS)";"RS";"CANELA";569;104;116;789
2014;"CANGUCU (RS)";"RS";"CANGUCU";1161;121;210;1492
2014;"CANOAS (RS)";"RS";"CANOAS";4774;517;1046;6337
2014;"CANUDOS DO VALE (RS)";"RS";"CANUDOS DO VALE";23;18;4;45
2014;"CAPAO BONITO DO SUL (RS)";"RS";"CAPAO BONITO DO SUL";53;1;4;58
2014;"CAPAO DA CANOA (RS)";"RS";"CAPAO DA CANOA";515;67;111;693
2014;"CAPAO DO CIPO (RS)";"RS";"CAPAO DO CIPO";118;6;13;137
2014;"CAPAO DO LEAO (RS)";"RS";"CAPAO DO LEAO";501;17;27;545
2014;"CAPELA DE SANTANA (RS)";"RS";"CAPELA DE SANTANA";223;11;19;253
2014;"CAPITAO (RS)";"RS";"CAPITAO";73;6;9;88
2014;"CAPIVARI DO SUL (RS)";"RS";"CAPIVARI DO SUL";168;14;7;189
2014;"CARAA (RS)";"RS";"CARAA";108;6;21;135
2014;"CARAZINHO (RS)";"RS";"CARAZINHO";1435;85;202;1722
2014;"CARLOS BARBOSA (RS)";"RS";"CARLOS BARBOSA";882;56;137;1075
2014;"CARLOS GOMES (RS)";"RS";"CARLOS GOMES";37;6;9;52
2014;"CASCA (RS)";"RS";"CASCA";411;23;34;468
2014;"CASEIROS (RS)";"RS";"CASEIROS";160;8;16;184
2014;"CATUIPE (RS)";"RS";"CATUIPE";386;8;34;428
2014;"CAXIAS DO SUL (RS)";"RS";"CAXIAS DO SUL";9266;1510;1765;12541
2014;"CENTENARIO (RS)";"RS";"CENTENARIO";98;8;12;118
2014;"CERRITO (RS)";"RS";"CERRITO";223;14;12;249
2014;"CERRO BRANCO (RS)";"RS";"CERRO BRANCO";69;10;20;99
2014;"CERRO GRANDE (RS)";"RS";"CERRO GRANDE";53;1;14;68
2014;"CERRO GRANDE DO SUL (RS)";"RS";"CERRO GRANDE DO SUL";291;23;25;339
2014;"CERRO LARGO (RS)";"RS";"CERRO LARGO";381;11;41;433
2014;"CHAPADA (RS)";"RS";"CHAPADA";380;44;31;455
2014;"CHARQUEADAS (RS)";"RS";"CHARQUEADAS";388;85;134;607
2014;"CHARRUA (RS)";"RS";"CHARRUA";99;5;13;117
2014;"CHIAPETTA (RS)";"RS";"CHIAPETTA";157;9;14;180
2014;"CHUI (RS)";"RS";"CHUI";113;11;7;131
2014;"CHUVISCA (RS)";"RS";"CHUVISCA";139;9;39;187
2014;"CIDREIRA (RS)";"RS";"CIDREIRA";116;12;35;163
2014;"CIRIACO (RS)";"RS";"CIRIACO";163;17;20;200
2014;"COLINAS (RS)";"RS";"COLINAS";74;10;9;93
2014;"COLORADO (RS)";"RS";"COLORADO";232;15;13;260
2014;"CONDOR (RS)";"RS";"CONDOR";267;19;31;317
2014;"CONSTANTINA (RS)";"RS";"CONSTANTINA";385;21;86;492
2014;"COQUEIRO BAIXO (RS)";"RS";"COQUEIRO BAIXO";19;4;5;28
2014;"COQUEIROS DO SUL (RS)";"RS";"COQUEIROS DO SUL";125;6;10;141
2014;"CORONEL BARROS (RS)";"RS";"CORONEL BARROS";119;0;9;128
2014;"CORONEL BICACO (RS)";"RS";"CORONEL BICACO";239;22;23;284
2014;"CORONEL PILAR (RS)";"RS";"CORONEL PILAR";207;8;9;224
2014;"COTIPORA (RS)";"RS";"COTIPORA";237;8;14;259
2014;"COXILHA (RS)";"RS";"COXILHA";118;7;15;140
2014;"CRISSIUMAL (RS)";"RS";"CRISSIUMAL";362;18;52;432
2014;"CRISTAL (RS)";"RS";"CRISTAL";222;12;51;285
2014;"CRISTAL DO SUL (RS)";"RS";"CRISTAL DO SUL";43;11;17;71
2014;"CRUZ ALTA (RS)";"RS";"CRUZ ALTA";1224;105;134;1463
2014;"CRUZALTENSE (RS)";"RS";"CRUZALTENSE";64;8;10;82
2014;"CRUZEIRO DO SUL (RS)";"RS";"CRUZEIRO DO SUL";456;14;20;490
2014;"DAVID CANABARRO (RS)";"RS";"DAVID CANABARRO";175;11;26;212
2014;"DERRUBADAS (RS)";"RS";"DERRUBADAS";98;11;14;123
2014;"DEZESSEIS DE NOVEMBRO (RS)";"RS";"DEZESSEIS DE NOVEMBRO";58;4;8;70
2014;"DILERMANDO DE AGUIAR (RS)";"RS";"DILERMANDO DE AGUIAR";50;2;30;82
2014;"DOIS IRMAOS (RS)";"RS";"DOIS IRMAOS";481;23;121;625
2014;"DOIS IRMAOS DAS MISSOES (RS)";"RS";"DOIS IRMAOS DAS MISSOES";62;8;6;76
2014;"DOIS LAJEADOS (RS)";"RS";"DOIS LAJEADOS";148;4;17;169
2014;"DOM FELICIANO (RS)";"RS";"DOM FELICIANO";257;14;82;353
2014;"DOM PEDRITO (RS)";"RS";"DOM PEDRITO";604;35;47;686
2014;"DOM PEDRO DE ALCANTARA (RS)";"RS";"DOM PEDRO DE ALCANTARA";105;3;5;113
2014;"DONA FRANCISCA (RS)";"RS";"DONA FRANCISCA";56;2;11;69
2014;"DOUTOR MAURICIO CARDOSO (RS)";"RS";"DOUTOR MAURICIO CARDOSO";201;14;21;236
2014;"DOUTOR RICARDO (RS)";"RS";"DOUTOR RICARDO";76;8;7;91
2014;"ELDORADO DO SUL (RS)";"RS";"ELDORADO DO SUL";576;47;63;686
2014;"ENCANTADO (RS)";"RS";"ENCANTADO";780;66;127;973
2014;"ENCRUZILHADA DO SUL (RS)";"RS";"ENCRUZILHADA DO SUL";395;26;186;607
2014;"ENGENHO VELHO (RS)";"RS";"ENGENHO VELHO";35;2;14;51
2014;"ENTRE IJUIS (RS)";"RS";"ENTRE IJUIS";378;12;25;415
2014;"ENTRE RIOS DO SUL (RS)";"RS";"ENTRE RIOS DO SUL";60;13;20;93
2014;"EREBANGO (RS)";"RS";"EREBANGO";128;3;7;138
2014;"ERECHIM (RS)";"RS";"ERECHIM";2212;318;521;3051
2014;"ERNESTINA (RS)";"RS";"ERNESTINA";168;27;20;215
2014;"ERVAL GRANDE (RS)";"RS";"ERVAL GRANDE";127;28;25;180
2014;"ERVAL SECO (RS)";"RS";"ERVAL SECO";161;6;40;207
2014;"ESMERALDA (RS)";"RS";"ESMERALDA";87;3;14;104
2014;"ESPERANCA DO SUL (RS)";"RS";"ESPERANCA DO SUL";57;3;13;73
2014;"ESPUMOSO (RS)";"RS";"ESPUMOSO";754;35;85;874
2014;"ESTACAO (RS)";"RS";"ESTACAO";235;14;18;267
2014;"ESTANCIA VELHA (RS)";"RS";"ESTANCIA VELHA";833;77;127;1037
2014;"ESTEIO (RS)";"RS";"ESTEIO";1140;126;298;1564
2014;"ESTRELA (RS)";"RS";"ESTRELA";1146;43;78;1267
2014;"ESTRELA VELHA (RS)";"RS";"ESTRELA VELHA";137;7;18;162
2014;"EUGENIO DE CASTRO (RS)";"RS";"EUGENIO DE CASTRO";101;10;12;123
2014;"FAGUNDES VARELA (RS)";"RS";"FAGUNDES VARELA";127;4;18;149
2014;"FARROUPILHA (RS)";"RS";"FARROUPILHA";2300;268;206;2774
2014;"FAXINAL DO SOTURNO (RS)";"RS";"FAXINAL DO SOTURNO";155;4;15;174
2014;"FAXINALZINHO (RS)";"RS";"FAXINALZINHO";61;9;15;85
2014;"FAZENDA VILANOVA (RS)";"RS";"FAZENDA VILANOVA";148;12;20;180
2014;"FELIZ (RS)";"RS";"FELIZ";484;37;83;604
2014;"FLORES DA CUNHA (RS)";"RS";"FLORES DA CUNHA";1557;72;125;1754
2014;"FLORIANO PEIXOTO (RS)";"RS";"FLORIANO PEIXOTO";73;16;18;107
2014;"FONTOURA XAVIER (RS)";"RS";"FONTOURA XAVIER";232;28;46;306
2014;"FORMIGUEIRO (RS)";"RS";"FORMIGUEIRO";172;2;25;199
2014;"FORQUETINHA (RS)";"RS";"FORQUETINHA";80;5;3;88
2014;"FORTALEZA DOS VALOS (RS)";"RS";"FORTALEZA DOS VALOS";270;5;22;297
2014;"FREDERICO WESTPHALEN (RS)";"RS";"FREDERICO WESTPHALEN";797;40;103;940
2014;"GARIBALDI (RS)";"RS";"GARIBALDI";1440;90;127;1657
2014;"GARRUCHOS (RS)";"RS";"GARRUCHOS";48;9;17;74
2014;"GAURAMA (RS)";"RS";"GAURAMA";226;22;25;273
2014;"GENERAL CAMARA (RS)";"RS";"GENERAL CAMARA";100;7;38;145
2014;"GENTIL (RS)";"RS";"GENTIL";106;10;16;132
2014;"GETULIO VARGAS (RS)";"RS";"GETULIO VARGAS";530;33;40;603
2014;"GIRUA (RS)";"RS";"GIRUA";573;42;56;671
2014;"GLORINHA (RS)";"RS";"GLORINHA";216;28;21;265
2014;"GRAMADO (RS)";"RS";"GRAMADO";719;169;148;1036
2014;"GRAMADO DOS LOUREIROS (RS)";"RS";"GRAMADO DOS LOUREIROS";40;2;13;55
2014;"GRAMADO XAVIER (RS)";"RS";"GRAMADO XAVIER";59;6;7;72
2014;"GRAVATAI (RS)";"RS";"GRAVATAI";3591;537;663;4791
2014;"GUABIJU (RS)";"RS";"GUABIJU";47;6;7;60
2014;"GUAIBA (RS)";"RS";"GUAIBA";1068;212;436;1716
2014;"GUAPORE (RS)";"RS";"GUAPORE";491;44;83;618
2014;"GUARANI DAS MISSOES (RS)";"RS";"GUARANI DAS MISSOES";273;7;26;306
2014;"HARMONIA (RS)";"RS";"HARMONIA";236;11;9;256
2014;"HERVAL (RS)";"RS";"HERVAL";130;13;11;154
2014;"HERVEIRAS (RS)";"RS";"HERVEIRAS";66;3;4;73
2014;"HORIZONTINA (RS)";"RS";"HORIZONTINA";403;31;61;495
2014;"HULHA NEGRA (RS)";"RS";"HULHA NEGRA";83;7;30;120
2014;"HUMAITA (RS)";"RS";"HUMAITA";151;11;9;171
2014;"IBARAMA (RS)";"RS";"IBARAMA";102;6;19;127
2014;"IBIACA (RS)";"RS";"IBIACA";271;12;30;313
2014;"IBIRAIARAS (RS)";"RS";"IBIRAIARAS";476;12;31;519
2014;"IBIRAPUITA (RS)";"RS";"IBIRAPUITA";148;14;54;216
2014;"IBIRUBA (RS)";"RS";"IBIRUBA";1006;59;100;1165
2014;"IGREJINHA (RS)";"RS";"IGREJINHA";465;36;107;608
2014;"IJUI (RS)";"RS";"IJUI";1978;141;132;2251
2014;"ILOPOLIS (RS)";"RS";"ILOPOLIS";224;8;11;243
2014;"IMBE (RS)";"RS";"IMBE";295;21;58;374
2014;"IMIGRANTE (RS)";"RS";"IMIGRANTE";101;21;20;142
2014;"INDEPENDENCIA (RS)";"RS";"INDEPENDENCIA";252;16;44;312
2014;"INHACORA (RS)";"RS";"INHACORA";71;5;8;84
2014;"IPE (RS)";"RS";"IPE";296;31;28;355
2014;"IPIRANGA DO SUL (RS)";"RS";"IPIRANGA DO SUL";125;10;16;151
2014;"IRAI (RS)";"RS";"IRAI";146;9;28;183
2014;"ITAARA (RS)";"RS";"ITAARA";124;7;17;148
2014;"ITACURUBI (RS)";"RS";"ITACURUBI";42;9;13;64
2014;"ITAPUCA (RS)";"RS";"ITAPUCA";64;6;11;81
2014;"ITAQUI (RS)";"RS";"ITAQUI";686;25;84;795
2014;"ITATI (RS)";"RS";"ITATI";80;5;12;97
2014;"ITATIBA DO SUL (RS)";"RS";"ITATIBA DO SUL";85;15;11;111
2014;"IVORA (RS)";"RS";"IVORA";76;5;6;87
2014;"IVOTI (RS)";"RS";"IVOTI";574;46;121;741
2014;"JABOTICABA (RS)";"RS";"JABOTICABA";80;5;24;109
2014;"JACUIZINHO (RS)";"RS";"JACUIZINHO";72;5;17;94
2014;"JACUTINGA (RS)";"RS";"JACUTINGA";117;9;10;136
2014;"JAGUARAO (RS)";"RS";"JAGUARAO";321;19;54;394
2014;"JAGUARI (RS)";"RS";"JAGUARI";291;20;63;374
2014;"JAQUIRANA (RS)";"RS";"JAQUIRANA";143;11;14;168
2014;"JARI (RS)";"RS";"JARI";81;7;14;102
2014;"JOIA (RS)";"RS";"JOIA";339;17;47;403
2014;"JULIO DE CASTILHOS (RS)";"RS";"JULIO DE CASTILHOS";653;25;65;743
2014;"LAGOA BONITA DO SUL (RS)";"RS";"LAGOA BONITA DO SUL";59;4;14;77
2014;"LAGOA DOS TRES CANTOS (RS)";"RS";"LAGOA DOS TRES CANTOS";109;6;4;119
2014;"LAGOA VERMELHA (RS)";"RS";"LAGOA VERMELHA";720;69;86;875
2014;"LAGOAO (RS)";"RS";"LAGOAO";95;7;43;145
2014;"LAJEADO (RS)";"RS";"LAJEADO";2223;180;269;2672
2014;"LAJEADO DO BUGRE (RS)";"RS";"LAJEADO DO BUGRE";29;3;12;44
2014;"LAVRAS DO SUL (RS)";"RS";"LAVRAS DO SUL";96;11;25;132
2014;"LIBERATO SALZANO (RS)";"RS";"LIBERATO SALZANO";128;9;32;169
2014;"LINDOLFO COLLOR (RS)";"RS";"LINDOLFO COLLOR";131;10;16;157
2014;"LINHA NOVA (RS)";"RS";"LINHA NOVA";84;8;5;97
2014;"MACAMBARA (RS)";"RS";"MACAMBARA";43;3;37;83
2014;"MACHADINHO (RS)";"RS";"MACHADINHO";130;11;30;171
2014;"MAMPITUBA (RS)";"RS";"MAMPITUBA";32;3;11;46
2014;"MANOEL VIANA (RS)";"RS";"MANOEL VIANA";169;8;14;191
2014;"MAQUINE (RS)";"RS";"MAQUINE";253;15;21;289
2014;"MARATA (RS)";"RS";"MARATA";130;11;21;162
2014;"MARAU (RS)";"RS";"MARAU";1180;109;176;1465
2014;"MARCELINO RAMOS (RS)";"RS";"MARCELINO RAMOS";138;20;30;188
2014;"MARIANA PIMENTEL (RS)";"RS";"MARIANA PIMENTEL";140;8;26;174
2014;"MARIANO MORO (RS)";"RS";"MARIANO MORO";72;14;12;98
2014;"MARQUES DE SOUZA (RS)";"RS";"MARQUES DE SOUZA";140;12;42;194
2014;"MATA (RS)";"RS";"MATA";115;9;24;148
2014;"MATO CASTELHANO (RS)";"RS";"MATO CASTELHANO";138;11;21;170
2014;"MATO LEITAO (RS)";"RS";"MATO LEITAO";138;9;11;158
2014;"MATO QUEIMADO (RS)";"RS";"MATO QUEIMADO";89;7;6;102
2014;"MAXIMILIANO DE ALMEIDA (RS)";"RS";"MAXIMILIANO DE ALMEIDA";145;14;109;268
2014;"MINAS DO LEAO (RS)";"RS";"MINAS DO LEAO";111;12;33;156
2014;"MIRAGUAI (RS)";"RS";"MIRAGUAI";122;3;28;153
2014;"MONTAURI (RS)";"RS";"MONTAURI";71;4;6;81
2014;"MONTE ALEGRE DOS CAMPOS (RS)";"RS";"MONTE ALEGRE DOS CAMPOS";91;2;28;121
2014;"MONTE BELO DO SUL (RS)";"RS";"MONTE BELO DO SUL";242;6;24;272
2014;"MONTENEGRO (RS)";"RS";"MONTENEGRO";1373;164;181;1718
2014;"MORMACO (RS)";"RS";"MORMACO";106;5;12;123
2014;"MORRINHOS DO SUL (RS)";"RS";"MORRINHOS DO SUL";156;3;6;165
2014;"MORRO REDONDO (RS)";"RS";"MORRO REDONDO";244;5;20;269
2014;"MORRO REUTER (RS)";"RS";"MORRO REUTER";192;12;23;227
2014;"MOSTARDAS (RS)";"RS";"MOSTARDAS";335;14;59;408
2014;"MUCUM (RS)";"RS";"MUCUM";86;11;17;114
2014;"MUITOS CAPOES (RS)";"RS";"MUITOS CAPOES";85;4;6;95
2014;"MULITERNO (RS)";"RS";"MULITERNO";116;4;10;130
2014;"NAO ME TOQUE (RS)";"RS";"NAO ME TOQUE";614;44;68;726
2014;"NICOLAU VERGUEIRO (RS)";"RS";"NICOLAU VERGUEIRO";97;8;16;121
2014;"NONOAI (RS)";"RS";"NONOAI";249;17;57;323
2014;"NOVA ALVORADA (RS)";"RS";"NOVA ALVORADA";181;7;19;207
2014;"NOVA ARACA (RS)";"RS";"NOVA ARACA";162;17;42;221
2014;"NOVA BASSANO (RS)";"RS";"NOVA BASSANO";540;38;72;650
2014;"NOVA BOA VISTA (RS)";"RS";"NOVA BOA VISTA";79;10;13;102
2014;"NOVA BRESCIA (RS)";"RS";"NOVA BRESCIA";137;13;13;163
2014;"NOVA CANDELARIA (RS)";"RS";"NOVA CANDELARIA";84;6;6;96
2014;"NOVA ESPERANCA DO SUL (RS)";"RS";"NOVA ESPERANCA DO SUL";97;8;35;140
2014;"NOVA HARTZ (RS)";"RS";"NOVA HARTZ";189;25;93;307
2014;"NOVA PADUA (RS)";"RS";"NOVA PADUA";336;3;6;345
2014;"NOVA PALMA (RS)";"RS";"NOVA PALMA";276;13;36;325
2014;"NOVA PETROPOLIS (RS)";"RS";"NOVA PETROPOLIS";576;40;72;688
2014;"NOVA PRATA (RS)";"RS";"NOVA PRATA";677;23;77;777
2014;"NOVA RAMADA (RS)";"RS";"NOVA RAMADA";122;9;13;144
2014;"NOVA ROMA DO SUL (RS)";"RS";"NOVA ROMA DO SUL";309;7;26;342
2014;"NOVA SANTA RITA (RS)";"RS";"NOVA SANTA RITA";977;56;60;1093
2014;"NOVO BARREIRO (RS)";"RS";"NOVO BARREIRO";156;8;16;180
2014;"NOVO CABRAIS (RS)";"RS";"NOVO CABRAIS";103;3;11;117
2014;"NOVO HAMBURGO (RS)";"RS";"NOVO HAMBURGO";3320;323;404;4047
2014;"NOVO MACHADO (RS)";"RS";"NOVO MACHADO";182;18;15;215
2014;"NOVO TIRADENTES (RS)";"RS";"NOVO TIRADENTES";40;3;8;51
2014;"NOVO XINGU (RS)";"RS";"NOVO XINGU";41;10;12;63
2014;"OSORIO (RS)";"RS";"OSORIO";1022;60;107;1189
2014;"PAIM FILHO (RS)";"RS";"PAIM FILHO";138;3;28;169
2014;"PALMARES DO SUL (RS)";"RS";"PALMARES DO SUL";197;21;42;260
2014;"PALMEIRA DAS MISSOES (RS)";"RS";"PALMEIRA DAS MISSOES";1002;26;103;1131
2014;"PALMITINHO (RS)";"RS";"PALMITINHO";203;16;54;273
2014;"PANAMBI (RS)";"RS";"PANAMBI";1074;66;127;1267
2014;"PANTANO GRANDE (RS)";"RS";"PANTANO GRANDE";328;10;33;371
2014;"PARAI (RS)";"RS";"PARAI";587;9;18;614
2014;"PARAISO DO SUL (RS)";"RS";"PARAISO DO SUL";98;6;22;126
2014;"PARECI NOVO (RS)";"RS";"PARECI NOVO";443;8;18;469
2014;"PAROBE (RS)";"RS";"PAROBE";612;72;164;848
2014;"PASSA SETE (RS)";"RS";"PASSA SETE";100;5;31;136
2014;"PASSO DO SOBRADO (RS)";"RS";"PASSO DO SOBRADO";154;8;45;207
2014;"PASSO FUNDO (RS)";"RS";"PASSO FUNDO";3649;241;380;4270
2014;"PAULO BENTO (RS)";"RS";"PAULO BENTO";88;14;10;112
2014;"PAVERAMA (RS)";"RS";"PAVERAMA";210;42;44;296
2014;"PEDRAS ALTAS (RS)";"RS";"PEDRAS ALTAS";21;15;7;43
2014;"PEDRO OSORIO (RS)";"RS";"PEDRO OSORIO";113;9;31;153
2014;"PEJUCARA (RS)";"RS";"PEJUCARA";228;3;18;249
2014;"PELOTAS (RS)";"RS";"PELOTAS";5683;409;1168;7260
2014;"PICADA CAFE (RS)";"RS";"PICADA CAFE";116;24;56;196
2014;"PINHAL (RS)";"RS";"PINHAL";97;2;11;110
2014;"PINHAL DA SERRA (RS)";"RS";"PINHAL DA SERRA";49;11;18;78
2014;"PINHAL GRANDE (RS)";"RS";"PINHAL GRANDE";125;13;25;163
2014;"PINHEIRINHO DO VALE (RS)";"RS";"PINHEIRINHO DO VALE";58;5;22;85
2014;"PINHEIRO MACHADO (RS)";"RS";"PINHEIRO MACHADO";157;11;57;225
2014;"PINTO BANDEIRA (RS)";"RS";"PINTO BANDEIRA";63;10;2;75
2014;"PIRAPO (RS)";"RS";"PIRAPO";45;8;12;65
2014;"PIRATINI (RS)";"RS";"PIRATINI";287;45;118;450
2014;"PLANALTO (RS)";"RS";"PLANALTO";231;8;37;276
2014;"POCO DAS ANTAS (RS)";"RS";"POCO DAS ANTAS";113;10;16;139
2014;"PONTAO (RS)";"RS";"PONTAO";144;4;20;168
2014;"PONTE PRETA (RS)";"RS";"PONTE PRETA";73;4;10;87
2014;"PORTAO (RS)";"RS";"PORTAO";1546;101;107;1754
2014;"PORTO ALEGRE (RS)";"RS";"PORTO ALEGRE";16350;2380;5166;23896
2014;"PORTO LUCENA (RS)";"RS";"PORTO LUCENA";105;15;16;136
2014;"PORTO MAUA (RS)";"RS";"PORTO MAUA";61;5;6;72
2014;"PORTO VERA CRUZ (RS)";"RS";"PORTO VERA CRUZ";16;4;11;31
2014;"PORTO XAVIER (RS)";"RS";"PORTO XAVIER";198;19;39;256
2014;"POUSO NOVO (RS)";"RS";"POUSO NOVO";46;6;9;61
2014;"PRESIDENTE LUCENA (RS)";"RS";"PRESIDENTE LUCENA";178;7;22;207
2014;"PROGRESSO (RS)";"RS";"PROGRESSO";134;13;28;175
2014;"PROTASIO ALVES (RS)";"RS";"PROTASIO ALVES";54;7;8;69
2014;"PUTINGA (RS)";"RS";"PUTINGA";121;12;10;143
2014;"QUARAI (RS)";"RS";"QUARAI";207;26;48;281
2014;"QUATRO IRMAOS (RS)";"RS";"QUATRO IRMAOS";59;12;6;77
2014;"QUEVEDOS (RS)";"RS";"QUEVEDOS";49;7;8;64
2014;"QUINZE DE NOVEMBRO (RS)";"RS";"QUINZE DE NOVEMBRO";213;27;29;269
2014;"REDENTORA (RS)";"RS";"REDENTORA";114;19;22;155
2014;"RELVADO (RS)";"RS";"RELVADO";48;12;4;64
2014;"RESTINGA SECA (RS)";"RS";"RESTINGA SECA";336;14;59;409
2014;"RIO DOS INDIOS (RS)";"RS";"RIO DOS INDIOS";81;6;29;116
2014;"RIO GRANDE (RS)";"RS";"RIO GRANDE";2399;261;848;3508
2014;"RIO PARDO (RS)";"RS";"RIO PARDO";513;52;93;658
2014;"RIOZINHO (RS)";"RS";"RIOZINHO";51;12;29;92
2014;"ROCA SALES (RS)";"RS";"ROCA SALES";169;25;42;236
2014;"RODEIO BONITO (RS)";"RS";"RODEIO BONITO";180;7;31;218
2014;"ROLADOR (RS)";"RS";"ROLADOR";65;4;8;77
2014;"ROLANTE (RS)";"RS";"ROLANTE";288;37;103;428
2014;"RONDA ALTA (RS)";"RS";"RONDA ALTA";309;17;41;367
2014;"RONDINHA (RS)";"RS";"RONDINHA";201;11;22;234
2014;"ROQUE GONZALES (RS)";"RS";"ROQUE GONZALES";141;6;24;171
2014;"ROSARIO DO SUL (RS)";"RS";"ROSARIO DO SUL";531;50;97;678
2014;"SAGRADA FAMILIA (RS)";"RS";"SAGRADA FAMILIA";49;3;7;59
2014;"SALDANHA MARINHO (RS)";"RS";"SALDANHA MARINHO";164;11;7;182
2014;"SALTO DO JACUI (RS)";"RS";"SALTO DO JACUI";242;24;34;300
2014;"SALVADOR DAS MISSOES (RS)";"RS";"SALVADOR DAS MISSOES";126;4;5;135
2014;"SALVADOR DO SUL (RS)";"RS";"SALVADOR DO SUL";320;25;31;376
2014;"SANANDUVA (RS)";"RS";"SANANDUVA";703;31;62;796
2014;"SANTA BARBARA DO SUL (RS)";"RS";"SANTA BARBARA DO SUL";385;16;40;441
2014;"SANTA CECILIA DO SUL (RS)";"RS";"SANTA CECILIA DO SUL";68;5;17;90
2014;"SANTA CLARA DO SUL (RS)";"RS";"SANTA CLARA DO SUL";141;30;14;185
2014;"SANTA CRUZ DO SUL (RS)";"RS";"SANTA CRUZ DO SUL";2348;170;635;3153
2014;"SANTA MARGARIDA DO SUL (RS)";"RS";"SANTA MARGARIDA DO SUL";50;3;6;59
2014;"SANTA MARIA (RS)";"RS";"SANTA MARIA";3663;397;1032;5092
2014;"SANTA MARIA DO HERVAL (RS)";"RS";"SANTA MARIA DO HERVAL";240;25;55;320
2014;"SANTA ROSA (RS)";"RS";"SANTA ROSA";1696;110;171;1977
2014;"SANTA TEREZA (RS)";"RS";"SANTA TEREZA";99;6;5;110
2014;"SANTA VITORIA DO PALMAR (RS)";"RS";"SANTA VITORIA DO PALMAR";611;19;73;703
2014;"SANTANA DA BOA VISTA (RS)";"RS";"SANTANA DA BOA VISTA";92;17;42;151
2014;"SANTANA DO LIVRAMENTO (RS)";"RS";"SANTANA DO LIVRAMENTO";840;90;217;1147
2014;"SANTIAGO (RS)";"RS";"SANTIAGO";929;96;101;1126
2014;"SANTO ANGELO (RS)";"RS";"SANTO ANGELO";1364;93;126;1583
2014;"SANTO ANTONIO DA PATRULHA (RS)";"RS";"SANTO ANTONIO DA PATRULHA";1007;48;196;1251
2014;"SANTO ANTONIO DAS MISSOES (RS)";"RS";"SANTO ANTONIO DAS MISSOES";223;48;42;313
2014;"SANTO ANTONIO DO PALMA (RS)";"RS";"SANTO ANTONIO DO PALMA";65;5;12;82
2014;"SANTO ANTONIO DO PLANALTO (RS)";"RS";"SANTO ANTONIO DO PLANALTO";99;3;10;112
2014;"SANTO AUGUSTO (RS)";"RS";"SANTO AUGUSTO";542;45;32;619
2014;"SANTO CRISTO (RS)";"RS";"SANTO CRISTO";524;24;53;601
2014;"SANTO EXPEDITO DO SUL (RS)";"RS";"SANTO EXPEDITO DO SUL";108;3;12;123
2014;"SAO BORJA (RS)";"RS";"SAO BORJA";1170;64;122;1356
2014;"SAO DOMINGOS DO SUL (RS)";"RS";"SAO DOMINGOS DO SUL";114;8;14;136
2014;"SAO FRANCISCO DE ASSIS (RS)";"RS";"SAO FRANCISCO DE ASSIS";340;27;103;470
2014;"SAO FRANCISCO DE PAULA (RS)";"RS";"SAO FRANCISCO DE PAULA";539;37;80;656
2014;"SAO GABRIEL (RS)";"RS";"SAO GABRIEL";930;39;127;1096
2014;"SAO JERONIMO (RS)";"RS";"SAO JERONIMO";289;28;117;434
2014;"SAO JOAO DA URTIGA (RS)";"RS";"SAO JOAO DA URTIGA";156;7;22;185
2014;"SAO JOAO DO POLESINE (RS)";"RS";"SAO JOAO DO POLESINE";79;1;7;87
2014;"SAO JORGE (RS)";"RS";"SAO JORGE";148;6;20;174
2014;"SAO JOSE DAS MISSOES (RS)";"RS";"SAO JOSE DAS MISSOES";43;4;9;56
2014;"SAO JOSE DO HERVAL (RS)";"RS";"SAO JOSE DO HERVAL";79;4;13;96
2014;"SAO JOSE DO HORTENCIO (RS)";"RS";"SAO JOSE DO HORTENCIO";201;12;31;244
2014;"SAO JOSE DO INHACORA (RS)";"RS";"SAO JOSE DO INHACORA";52;5;10;67
2014;"SAO JOSE DO NORTE (RS)";"RS";"SAO JOSE DO NORTE";391;15;108;514
2014;"SAO JOSE DO OURO (RS)";"RS";"SAO JOSE DO OURO";332;7;43;382
2014;"SAO JOSE DO SUL (RS)";"RS";"SAO JOSE DO SUL";143;8;13;164
2014;"SAO JOSE DOS AUSENTES (RS)";"RS";"SAO JOSE DOS AUSENTES";124;8;20;152
2014;"SAO LEOPOLDO (RS)";"RS";"SAO LEOPOLDO";2275;283;490;3048
2014;"SAO LOURENCO DO SUL (RS)";"RS";"SAO LOURENCO DO SUL";987;56;156;1199
2014;"SAO LUIZ GONZAGA (RS)";"RS";"SAO LUIZ GONZAGA";675;68;86;829
2014;"SAO MARCOS (RS)";"RS";"SAO MARCOS";781;27;127;935
2014;"SAO MARTINHO (RS)";"RS";"SAO MARTINHO";221;10;21;252
2014;"SAO MARTINHO DA SERRA (RS)";"RS";"SAO MARTINHO DA SERRA";51;4;4;59
2014;"SAO MIGUEL DAS MISSOES (RS)";"RS";"SAO MIGUEL DAS MISSOES";264;25;39;328
2014;"SAO NICOLAU (RS)";"RS";"SAO NICOLAU";78;13;13;104
2014;"SAO PAULO DAS MISSOES (RS)";"RS";"SAO PAULO DAS MISSOES";122;9;35;166
2014;"SAO PEDRO DA SERRA (RS)";"RS";"SAO PEDRO DA SERRA";116;12;17;145
2014;"SAO PEDRO DAS MISSOES (RS)";"RS";"SAO PEDRO DAS MISSOES";41;6;5;52
2014;"SAO PEDRO DO BUTIA (RS)";"RS";"SAO PEDRO DO BUTIA";122;2;15;139
2014;"SAO PEDRO DO SUL (RS)";"RS";"SAO PEDRO DO SUL";304;52;45;401
2014;"SAO SEBASTIAO DO CAI (RS)";"RS";"SAO SEBASTIAO DO CAI";794;30;67;891
2014;"SAO SEPE (RS)";"RS";"SAO SEPE";468;53;114;635
2014;"SAO VALENTIM (RS)";"RS";"SAO VALENTIM";64;15;14;93
2014;"SAO VALENTIM DO SUL (RS)";"RS";"SAO VALENTIM DO SUL";81;6;8;95
2014;"SAO VALERIO DO SUL (RS)";"RS";"SAO VALERIO DO SUL";47;2;9;58
2014;"SAO VENDELINO (RS)";"RS";"SAO VENDELINO";92;11;13;116
2014;"SAO VICENTE DO SUL (RS)";"RS";"SAO VICENTE DO SUL";146;8;54;208
2014;"SAPIRANGA (RS)";"RS";"SAPIRANGA";937;106;175;1218
2014;"SAPUCAIA DO SUL (RS)";"RS";"SAPUCAIA DO SUL";1729;157;134;2020
2014;"SARANDI (RS)";"RS";"SARANDI";626;38;76;740
2014;"SEBERI (RS)";"RS";"SEBERI";318;12;49;379
2014;"SEDE NOVA (RS)";"RS";"SEDE NOVA";98;10;14;122
2014;"SEGREDO (RS)";"RS";"SEGREDO";184;6;51;241
2014;"SELBACH (RS)";"RS";"SELBACH";360;13;24;397
2014;"SENADOR SALGADO FILHO (RS)";"RS";"SENADOR SALGADO FILHO";143;10;11;164
2014;"SENTINELA DO SUL (RS)";"RS";"SENTINELA DO SUL";159;3;13;175
2014;"SERAFINA CORREA (RS)";"RS";"SERAFINA CORREA";365;46;70;481
2014;"SERIO (RS)";"RS";"SERIO";63;8;5;76
2014;"SERTAO (RS)";"RS";"SERTAO";268;18;42;328
2014;"SERTAO SANTANA (RS)";"RS";"SERTAO SANTANA";169;5;25;199
2014;"SETE DE SETEMBRO (RS)";"RS";"SETE DE SETEMBRO";84;4;12;100
2014;"SEVERIANO DE ALMEIDA (RS)";"RS";"SEVERIANO DE ALMEIDA";107;15;14;136
2014;"SILVEIRA MARTINS (RS)";"RS";"SILVEIRA MARTINS";134;2;9;145
2014;"SINIMBU (RS)";"RS";"SINIMBU";144;4;5;153
2014;"SOBRADINHO (RS)";"RS";"SOBRADINHO";336;19;53;408
2014;"SOLEDADE (RS)";"RS";"SOLEDADE";629;39;129;797
2014;"TABAI (RS)";"RS";"TABAI";222;22;15;259
2014;"TAPEJARA (RS)";"RS";"TAPEJARA";829;36;106;971
2014;"TAPERA (RS)";"RS";"TAPERA";412;29;30;471
2014;"TAPES (RS)";"RS";"TAPES";300;22;35;357
2014;"TAQUARA (RS)";"RS";"TAQUARA";853;56;268;1177
2014;"TAQUARI (RS)";"RS";"TAQUARI";476;45;165;686
2014;"TAQUARUCU DO SUL (RS)";"RS";"TAQUARUCU DO SUL";77;2;15;94
2014;"TAVARES (RS)";"RS";"TAVARES";151;9;24;184
2014;"TENENTE PORTELA (RS)";"RS";"TENENTE PORTELA";302;18;55;375
2014;"TERRA DE AREIA (RS)";"RS";"TERRA DE AREIA";347;13;30;390
2014;"TEUTONIA (RS)";"RS";"TEUTONIA";765;38;101;904
2014;"TIO HUGO (RS)";"RS";"TIO HUGO";125;8;14;147
2014;"TIRADENTES DO SUL (RS)";"RS";"TIRADENTES DO SUL";116;7;13;136
2014;"TOROPI (RS)";"RS";"TOROPI";65;8;19;92
2014;"TORRES (RS)";"RS";"TORRES";466;29;86;581
2014;"TRAMANDAI (RS)";"RS";"TRAMANDAI";708;71;140;919
2014;"TRAVESSEIRO (RS)";"RS";"TRAVESSEIRO";46;9;15;70
2014;"TRES ARROIOS (RS)";"RS";"TRES ARROIOS";105;13;5;123
2014;"TRES CACHOEIRAS (RS)";"RS";"TRES CACHOEIRAS";646;12;27;685
2014;"TRES COROAS (RS)";"RS";"TRES COROAS";288;38;80;406
2014;"TRES DE MAIO (RS)";"RS";"TRES DE MAIO";776;47;83;906
2014;"TRES FORQUILHAS (RS)";"RS";"TRES FORQUILHAS";105;4;7;116
2014;"TRES PALMEIRAS (RS)";"RS";"TRES PALMEIRAS";83;6;30;119
2014;"TRES PASSOS (RS)";"RS";"TRES PASSOS";478;27;137;642
2014;"TRINDADE DO SUL (RS)";"RS";"TRINDADE DO SUL";134;15;21;170
2014;"TRIUNFO (RS)";"RS";"TRIUNFO";596;136;293;1025
2014;"TUCUNDUVA (RS)";"RS";"TUCUNDUVA";256;14;16;286
2014;"TUNAS (RS)";"RS";"TUNAS";60;7;20;87
2014;"TUPANCI DO SUL (RS)";"RS";"TUPANCI DO SUL";59;4;17;80
2014;"TUPANCIRETA (RS)";"RS";"TUPANCIRETA";607;66;70;743
2014;"TUPANDI (RS)";"RS";"TUPANDI";124;29;39;192
2014;"TUPARENDI (RS)";"RS";"TUPARENDI";302;13;27;342
2014;"TURUCU (RS)";"RS";"TURUCU";100;7;14;121
2014;"UBIRETAMA (RS)";"RS";"UBIRETAMA";92;11;5;108
2014;"UNIAO DA SERRA (RS)";"RS";"UNIAO DA SERRA";69;3;10;82
2014;"UNISTALDA (RS)";"RS";"UNISTALDA";45;13;19;77
2014;"URUGUAIANA (RS)";"RS";"URUGUAIANA";1842;94;181;2117
2014;"VACARIA (RS)";"RS";"VACARIA";1769;170;525;2464
2014;"VALE DO SOL (RS)";"RS";"VALE DO SOL";204;13;46;263
2014;"VALE REAL (RS)";"RS";"VALE REAL";216;13;10;239
2014;"VALE VERDE (RS)";"RS";"VALE VERDE";62;5;8;75
2014;"VANINI (RS)";"RS";"VANINI";106;9;13;128
2014;"VENANCIO AIRES (RS)";"RS";"VENANCIO AIRES";1218;102;198;1518
2014;"VERA CRUZ (RS)";"RS";"VERA CRUZ";455;38;129;622
2014;"VERANOPOLIS (RS)";"RS";"VERANOPOLIS";964;45;72;1081
2014;"VESPASIANO CORREA (RS)";"RS";"VESPASIANO CORREA";116;7;10;133
2014;"VIADUTOS (RS)";"RS";"VIADUTOS";140;12;28;180
2014;"VIAMAO (RS)";"RS";"VIAMAO";2283;342;672;3297
2014;"VICENTE DUTRA (RS)";"RS";"VICENTE DUTRA";60;2;18;80
2014;"VICTOR GRAEFF (RS)";"RS";"VICTOR GRAEFF";182;14;8;204
2014;"VILA FLORES (RS)";"RS";"VILA FLORES";185;14;18;217
2014;"VILA LANGARO (RS)";"RS";"VILA LANGARO";120;8;15;143
2014;"VILA MARIA (RS)";"RS";"VILA MARIA";261;11;44;316
2014;"VILA NOVA DO SUL (RS)";"RS";"VILA NOVA DO SUL";101;10;12;123
2014;"VISTA ALEGRE (RS)";"RS";"VISTA ALEGRE";78;6;11;95
2014;"VISTA ALEGRE DO PRATA (RS)";"RS";"VISTA ALEGRE DO PRATA";44;11;4;59
2014;"VISTA GAUCHA (RS)";"RS";"VISTA GAUCHA";65;2;14;81
2014;"VITORIA DAS MISSOES (RS)";"RS";"VITORIA DAS MISSOES";117;0;17;134
2014;"WESTFALIA (RS)";"RS";"WESTFALIA";147;18;19;184
2014;"XANGRI LA (RS)";"RS";"XANGRI LA";210;19;13;242
2014;"ABDON BATISTA (SC)";"SC";"ABDON BATISTA";88;5;11;104
2014;"ABELARDO LUZ (SC)";"SC";"ABELARDO LUZ";423;20;103;546
2014;"AGROLANDIA (SC)";"SC";"AGROLANDIA";246;19;17;282
2014;"AGRONOMICA (SC)";"SC";"AGRONOMICA";173;6;15;194
2014;"AGUA DOCE (SC)";"SC";"AGUA DOCE";228;30;28;286
2014;"AGUAS DE CHAPECO (SC)";"SC";"AGUAS DE CHAPECO";87;10;29;126
2014;"AGUAS FRIAS (SC)";"SC";"AGUAS FRIAS";65;5;5;75
2014;"AGUAS MORNAS (SC)";"SC";"AGUAS MORNAS";287;6;17;310
2014;"ALFREDO WAGNER (SC)";"SC";"ALFREDO WAGNER";296;24;19;339
2014;"ALTO BELA VISTA (SC)";"SC";"ALTO BELA VISTA";65;9;8;82
2014;"ANCHIETA (SC)";"SC";"ANCHIETA";246;16;22;284
2014;"ANGELINA (SC)";"SC";"ANGELINA";229;20;16;265
2014;"ANITA GARIBALDI (SC)";"SC";"ANITA GARIBALDI";141;14;28;183
2014;"ANITAPOLIS (SC)";"SC";"ANITAPOLIS";109;7;14;130
2014;"ANTONIO CARLOS (SC)";"SC";"ANTONIO CARLOS";637;6;12;655
2014;"APIUNA (SC)";"SC";"APIUNA";198;26;21;245
2014;"ARABUTA (SC)";"SC";"ARABUTA";134;11;33;178
2014;"ARAQUARI (SC)";"SC";"ARAQUARI";731;69;59;859
2014;"ARARANGUA (SC)";"SC";"ARARANGUA";1346;78;177;1601
2014;"ARMAZEM (SC)";"SC";"ARMAZEM";277;16;19;312
2014;"ARROIO TRINTA (SC)";"SC";"ARROIO TRINTA";179;17;18;214
2014;"ARVOREDO (SC)";"SC";"ARVOREDO";47;17;7;71
2014;"ASCURRA (SC)";"SC";"ASCURRA";253;24;34;311
2014;"ATALANTA (SC)";"SC";"ATALANTA";95;1;6;102
2014;"AURORA (SC)";"SC";"AURORA";196;8;17;221
2014;"BALNEARIO ARROIO DO SILVA (SC)";"SC";"BALNEARIO ARROIO DO SILVA";137;6;17;160
2014;"BALNEARIO BARRA DO SUL (SC)";"SC";"BALNEARIO BARRA DO SUL";162;13;9;184
2014;"BALNEARIO CAMBORIU (SC)";"SC";"BALNEARIO CAMBORIU";989;264;299;1552
2014;"BALNEARIO DE PICARRAS (SC)";"SC";"BALNEARIO DE PICARRAS";348;46;42;436
2014;"BALNEARIO GAIVOTA (SC)";"SC";"BALNEARIO GAIVOTA";183;7;25;215
2014;"BALNEARIO RINCAO (SC)";"SC";"BALNEARIO RINCAO";57;6;5;68
2014;"BANDEIRANTE (SC)";"SC";"BANDEIRANTE";51;6;16;73
2014;"BARRA BONITA (SC)";"SC";"BARRA BONITA";39;7;9;55
2014;"BARRA VELHA (SC)";"SC";"BARRA VELHA";486;40;41;567
2014;"BELA VISTA DO TOLDO (SC)";"SC";"BELA VISTA DO TOLDO";97;7;43;147
2014;"BELMONTE (SC)";"SC";"BELMONTE";73;12;8;93
2014;"BENEDITO NOVO (SC)";"SC";"BENEDITO NOVO";299;42;25;366
2014;"BIGUACU (SC)";"SC";"BIGUACU";1282;81;129;1492
2014;"BLUMENAU (SC)";"SC";"BLUMENAU";5440;434;772;6646
2014;"BOCAINA DO SUL (SC)";"SC";"BOCAINA DO SUL";56;5;16;77
2014;"BOM JARDIM DA SERRA (SC)";"SC";"BOM JARDIM DA SERRA";135;12;26;173
2014;"BOM JESUS (SC)";"SC";"BOM JESUS";62;2;7;71
2014;"BOM JESUS DO OESTE (SC)";"SC";"BOM JESUS DO OESTE";72;7;7;86
2014;"BOM RETIRO (SC)";"SC";"BOM RETIRO";202;14;36;252
2014;"BOMBINHAS (SC)";"SC";"BOMBINHAS";175;49;23;247
2014;"BOTUVERA (SC)";"SC";"BOTUVERA";214;6;14;234
2014;"BRACO DO NORTE (SC)";"SC";"BRACO DO NORTE";1177;60;74;1311
2014;"BRACO DO TROMBUDO (SC)";"SC";"BRACO DO TROMBUDO";138;6;4;148
2014;"BRUNOPOLIS (SC)";"SC";"BRUNOPOLIS";102;6;11;119
2014;"BRUSQUE (SC)";"SC";"BRUSQUE";2520;169;174;2863
2014;"CACADOR (SC)";"SC";"CACADOR";2132;127;774;3033
2014;"CAIBI (SC)";"SC";"CAIBI";180;7;25;212
2014;"CALMON (SC)";"SC";"CALMON";37;13;25;75
2014;"CAMBORIU (SC)";"SC";"CAMBORIU";1125;56;37;1218
2014;"CAMPO ALEGRE (SC)";"SC";"CAMPO ALEGRE";447;15;15;477
2014;"CAMPO BELO DO SUL (SC)";"SC";"CAMPO BELO DO SUL";198;13;42;253
2014;"CAMPO ERE (SC)";"SC";"CAMPO ERE";287;12;32;331
2014;"CAMPOS NOVOS (SC)";"SC";"CAMPOS NOVOS";1063;91;111;1265
2014;"CANELINHA (SC)";"SC";"CANELINHA";537;16;9;562
2014;"CANOINHAS (SC)";"SC";"CANOINHAS";1334;62;145;1541
2014;"CAPAO ALTO (SC)";"SC";"CAPAO ALTO";71;7;16;94
2014;"CAPINZAL (SC)";"SC";"CAPINZAL";466;35;55;556
2014;"CAPIVARI DE BAIXO (SC)";"SC";"CAPIVARI DE BAIXO";366;17;27;410
2014;"CATANDUVAS (SC)";"SC";"CATANDUVAS";345;28;54;427
2014;"CAXAMBU DO SUL (SC)";"SC";"CAXAMBU DO SUL";106;4;16;126
2014;"CELSO RAMOS (SC)";"SC";"CELSO RAMOS";75;6;6;87
2014;"CERRO NEGRO (SC)";"SC";"CERRO NEGRO";63;7;19;89
2014;"CHAPADAO DO LAGEADO (SC)";"SC";"CHAPADAO DO LAGEADO";48;5;12;65
2014;"CHAPECO (SC)";"SC";"CHAPECO";4511;310;423;5244
2014;"COCAL DO SUL (SC)";"SC";"COCAL DO SUL";327;19;28;374
2014;"CONCORDIA (SC)";"SC";"CONCORDIA";2591;139;257;2987
2014;"CORDILHEIRA ALTA (SC)";"SC";"CORDILHEIRA ALTA";304;24;13;341
2014;"CORONEL FREITAS (SC)";"SC";"CORONEL FREITAS";262;12;28;302
2014;"CORONEL MARTINS (SC)";"SC";"CORONEL MARTINS";52;9;16;77
2014;"CORREIA PINTO (SC)";"SC";"CORREIA PINTO";403;49;58;510
2014;"CORUPA (SC)";"SC";"CORUPA";419;5;41;465
2014;"CRICIUMA (SC)";"SC";"CRICIUMA";3654;317;438;4409
2014;"CUNHA PORA (SC)";"SC";"CUNHA PORA";428;18;54;500
2014;"CUNHATAI (SC)";"SC";"CUNHATAI";39;3;9;51
2014;"CURITIBANOS (SC)";"SC";"CURITIBANOS";993;85;123;1201
2014;"DESCANSO (SC)";"SC";"DESCANSO";230;14;27;271
2014;"DIONISIO CERQUEIRA (SC)";"SC";"DIONISIO CERQUEIRA";165;21;20;206
2014;"DONA EMMA (SC)";"SC";"DONA EMMA";132;15;9;156
2014;"DOUTOR PEDRINHO (SC)";"SC";"DOUTOR PEDRINHO";134;7;5;146
2014;"ENTRE RIOS (SC)";"SC";"ENTRE RIOS";38;5;31;74
2014;"ERMO (SC)";"SC";"ERMO";77;3;7;87
2014;"ERVAL VELHO (SC)";"SC";"ERVAL VELHO";112;6;26;144
2014;"FAXINAL DOS GUEDES (SC)";"SC";"FAXINAL DOS GUEDES";413;23;34;470
2014;"FLOR DO SERTAO (SC)";"SC";"FLOR DO SERTAO";28;9;18;55
2014;"FLORIANOPOLIS (SC)";"SC";"FLORIANOPOLIS";3699;921;2206;6826
2014;"FORMOSA DO SUL (SC)";"SC";"FORMOSA DO SUL";78;5;11;94
2014;"FORQUILHINHA (SC)";"SC";"FORQUILHINHA";554;18;37;609
2014;"FRAIBURGO (SC)";"SC";"FRAIBURGO";848;50;210;1108
2014;"FREI ROGERIO (SC)";"SC";"FREI ROGERIO";87;10;15;112
2014;"GALVAO (SC)";"SC";"GALVAO";95;8;20;123
2014;"GAROPABA (SC)";"SC";"GAROPABA";269;27;38;334
2014;"GARUVA (SC)";"SC";"GARUVA";568;33;32;633
2014;"GASPAR (SC)";"SC";"GASPAR";1336;74;80;1490
2014;"GOVERNADOR CELSO RAMOS (SC)";"SC";"GOVERNADOR CELSO RAMOS";165;26;15;206
2014;"GRAO PARA (SC)";"SC";"GRAO PARA";260;10;12;282
2014;"GRAVATAL (SC)";"SC";"GRAVATAL";305;16;20;341
2014;"GUABIRUBA (SC)";"SC";"GUABIRUBA";327;18;20;365
2014;"GUARACIABA (SC)";"SC";"GUARACIABA";246;19;40;305
2014;"GUARAMIRIM (SC)";"SC";"GUARAMIRIM";1084;34;24;1142
2014;"GUARUJA DO SUL (SC)";"SC";"GUARUJA DO SUL";166;10;17;193
2014;"GUATAMBU (SC)";"SC";"GUATAMBU";112;12;24;148
2014;"HERVAL D OESTE (SC)";"SC";"HERVAL D OESTE";343;31;62;436
2014;"IBIAM (SC)";"SC";"IBIAM";74;8;14;96
2014;"IBICARE (SC)";"SC";"IBICARE";153;11;10;174
2014;"IBIRAMA (SC)";"SC";"IBIRAMA";502;62;77;641
2014;"ICARA (SC)";"SC";"ICARA";1900;88;134;2122
2014;"ILHOTA (SC)";"SC";"ILHOTA";352;24;23;399
2014;"IMARUI (SC)";"SC";"IMARUI";164;23;31;218
2014;"IMBITUBA (SC)";"SC";"IMBITUBA";663;82;90;835
2014;"IMBUIA (SC)";"SC";"IMBUIA";183;10;22;215
2014;"INDAIAL (SC)";"SC";"INDAIAL";1499;96;130;1725
2014;"IOMERE (SC)";"SC";"IOMERE";169;7;9;185
2014;"IPIRA (SC)";"SC";"IPIRA";125;11;23;159
2014;"IPORA DO OESTE (SC)";"SC";"IPORA DO OESTE";261;21;58;340
2014;"IPUACU (SC)";"SC";"IPUACU";108;10;30;148
2014;"IPUMIRIM (SC)";"SC";"IPUMIRIM";277;40;32;349
2014;"IRACEMINHA (SC)";"SC";"IRACEMINHA";105;5;26;136
2014;"IRANI (SC)";"SC";"IRANI";337;30;58;425
2014;"IRATI (SC)";"SC";"IRATI";33;5;9;47
2014;"IRINEOPOLIS (SC)";"SC";"IRINEOPOLIS";272;12;18;302
2014;"ITA (SC)";"SC";"ITA";109;15;40;164
2014;"ITAIOPOLIS (SC)";"SC";"ITAIOPOLIS";631;34;89;754
2014;"ITAJAI (SC)";"SC";"ITAJAI";4568;312;382;5262
2014;"ITAPEMA (SC)";"SC";"ITAPEMA";598;60;46;704
2014;"ITAPIRANGA (SC)";"SC";"ITAPIRANGA";358;23;68;449
2014;"ITAPOA (SC)";"SC";"ITAPOA";236;13;12;261
2014;"ITUPORANGA (SC)";"SC";"ITUPORANGA";687;34;61;782
2014;"JABORA (SC)";"SC";"JABORA";143;15;25;183
2014;"JACINTO MACHADO (SC)";"SC";"JACINTO MACHADO";429;14;39;482
2014;"JAGUARUNA (SC)";"SC";"JAGUARUNA";483;25;54;562
2014;"JARAGUA DO SUL (SC)";"SC";"JARAGUA DO SUL";2610;240;378;3228
2014;"JARDINOPOLIS (SC)";"SC";"JARDINOPOLIS";19;6;4;29
2014;"JOACABA (SC)";"SC";"JOACABA";873;81;43;997
2014;"JOINVILLE (SC)";"SC";"JOINVILLE";8444;736;876;10056
2014;"JOSE BOITEUX (SC)";"SC";"JOSE BOITEUX";128;25;11;164
2014;"JUPIA (SC)";"SC";"JUPIA";50;3;8;61
2014;"LACERDOPOLIS (SC)";"SC";"LACERDOPOLIS";110;5;7;122
2014;"LAGEADO GRANDE (SC)";"SC";"LAGEADO GRANDE";42;1;6;49
2014;"LAGES (SC)";"SC";"LAGES";3465;267;368;4100
2014;"LAGUNA (SC)";"SC";"LAGUNA";614;117;106;837
2014;"LAURENTINO (SC)";"SC";"LAURENTINO";339;6;7;352
2014;"LAURO MULLER (SC)";"SC";"LAURO MULLER";472;25;49;546
2014;"LEBON REGIS (SC)";"SC";"LEBON REGIS";248;27;52;327
2014;"LEOBERTO LEAL (SC)";"SC";"LEOBERTO LEAL";116;11;5;132
2014;"LINDOIA DO SUL (SC)";"SC";"LINDOIA DO SUL";149;12;49;210
2014;"LONTRAS (SC)";"SC";"LONTRAS";344;24;40;408
2014;"LUIZ ALVES (SC)";"SC";"LUIZ ALVES";461;7;23;491
2014;"LUZERNA (SC)";"SC";"LUZERNA";155;12;24;191
2014;"MACIEIRA (SC)";"SC";"MACIEIRA";83;7;16;106
2014;"MAFRA (SC)";"SC";"MAFRA";1446;97;150;1693
2014;"MAJOR GERCINO (SC)";"SC";"MAJOR GERCINO";131;4;12;147
2014;"MAJOR VIEIRA (SC)";"SC";"MAJOR VIEIRA";219;4;16;239
2014;"MARACAJA (SC)";"SC";"MARACAJA";247;2;14;263
2014;"MARAVILHA (SC)";"SC";"MARAVILHA";803;40;74;917
2014;"MAREMA (SC)";"SC";"MAREMA";69;4;7;80
2014;"MASSARANDUBA (SC)";"SC";"MASSARANDUBA";543;30;37;610
2014;"MATOS COSTA (SC)";"SC";"MATOS COSTA";47;7;15;69
2014;"MELEIRO (SC)";"SC";"MELEIRO";280;5;22;307
2014;"MIRIM DOCE (SC)";"SC";"MIRIM DOCE";64;3;10;77
2014;"MODELO (SC)";"SC";"MODELO";136;8;10;154
2014;"MONDAI (SC)";"SC";"MONDAI";196;15;55;266
2014;"MONTE CARLO (SC)";"SC";"MONTE CARLO";171;15;97;283
2014;"MONTE CASTELO (SC)";"SC";"MONTE CASTELO";185;14;24;223
2014;"MORRO DA FUMACA (SC)";"SC";"MORRO DA FUMACA";836;34;31;901
2014;"MORRO GRANDE (SC)";"SC";"MORRO GRANDE";128;2;10;140
2014;"NAVEGANTES (SC)";"SC";"NAVEGANTES";871;98;72;1041
2014;"NOVA ERECHIM (SC)";"SC";"NOVA ERECHIM";125;6;10;141
2014;"NOVA ITABERABA (SC)";"SC";"NOVA ITABERABA";118;6;15;139
2014;"NOVA TRENTO (SC)";"SC";"NOVA TRENTO";298;36;38;372
2014;"NOVA VENEZA (SC)";"SC";"NOVA VENEZA";447;35;44;526
2014;"NOVO HORIZONTE (SC)";"SC";"NOVO HORIZONTE";74;10;19;103
2014;"ORLEANS (SC)";"SC";"ORLEANS";867;27;46;940
2014;"OTACILIO COSTA (SC)";"SC";"OTACILIO COSTA";431;57;54;542
2014;"OURO (SC)";"SC";"OURO";261;29;29;319
2014;"OURO VERDE (SC)";"SC";"OURO VERDE";93;2;10;105
2014;"PAIAL (SC)";"SC";"PAIAL";16;3;15;34
2014;"PAINEL (SC)";"SC";"PAINEL";46;4;11;61
2014;"PALHOCA (SC)";"SC";"PALHOCA";2408;161;373;2942
2014;"PALMA SOLA (SC)";"SC";"PALMA SOLA";206;7;36;249
2014;"PALMEIRA (SC)";"SC";"PALMEIRA";118;5;6;129
2014;"PALMITOS (SC)";"SC";"PALMITOS";395;45;54;494
2014;"PAPANDUVA (SC)";"SC";"PAPANDUVA";556;19;84;659
2014;"PARAISO (SC)";"SC";"PARAISO";91;8;7;106
2014;"PASSO DE TORRES (SC)";"SC";"PASSO DE TORRES";152;8;17;177
2014;"PASSOS MAIA (SC)";"SC";"PASSOS MAIA";120;2;30;152
2014;"PAULO LOPES (SC)";"SC";"PAULO LOPES";249;20;24;293
2014;"PEDRAS GRANDES (SC)";"SC";"PEDRAS GRANDES";243;19;16;278
2014;"PENHA (SC)";"SC";"PENHA";395;37;50;482
2014;"PERITIBA (SC)";"SC";"PERITIBA";93;5;16;114
2014;"PESCARIA BRAVA (SC)";"SC";"PESCARIA BRAVA";22;2;3;27
2014;"PETROLANDIA (SC)";"SC";"PETROLANDIA";168;14;25;207
2014;"PINHALZINHO (SC)";"SC";"PINHALZINHO";495;20;65;580
2014;"PINHEIRO PRETO (SC)";"SC";"PINHEIRO PRETO";270;9;18;297
2014;"PIRATUBA (SC)";"SC";"PIRATUBA";123;13;30;166
2014;"PLANALTO ALEGRE (SC)";"SC";"PLANALTO ALEGRE";68;8;4;80
2014;"POMERODE (SC)";"SC";"POMERODE";674;29;98;801
2014;"PONTE ALTA (SC)";"SC";"PONTE ALTA";137;9;16;162
2014;"PONTE ALTA DO NORTE (SC)";"SC";"PONTE ALTA DO NORTE";86;5;12;103
2014;"PONTE SERRADA (SC)";"SC";"PONTE SERRADA";347;44;99;490
2014;"PORTO BELO (SC)";"SC";"PORTO BELO";269;26;32;327
2014;"PORTO UNIAO (SC)";"SC";"PORTO UNIAO";633;29;41;703
2014;"POUSO REDONDO (SC)";"SC";"POUSO REDONDO";502;25;42;569
2014;"PRAIA GRANDE (SC)";"SC";"PRAIA GRANDE";236;11;26;273
2014;"PRESIDENTE CASTELO BRANCO (SC)";"SC";"PRESIDENTE CASTELO BRANCO";66;6;10;82
2014;"PRESIDENTE GETULIO (SC)";"SC";"PRESIDENTE GETULIO";386;47;65;498
2014;"PRESIDENTE NEREU (SC)";"SC";"PRESIDENTE NEREU";39;10;8;57
2014;"PRINCESA (SC)";"SC";"PRINCESA";64;3;12;79
2014;"QUILOMBO (SC)";"SC";"QUILOMBO";234;32;49;315
2014;"RANCHO QUEIMADO (SC)";"SC";"RANCHO QUEIMADO";143;4;7;154
2014;"RIO DAS ANTAS (SC)";"SC";"RIO DAS ANTAS";206;7;28;241
2014;"RIO DO CAMPO (SC)";"SC";"RIO DO CAMPO";190;10;16;216
2014;"RIO DO OESTE (SC)";"SC";"RIO DO OESTE";219;19;21;259
2014;"RIO DO SUL (SC)";"SC";"RIO DO SUL";1532;87;114;1733
2014;"RIO DOS CEDROS (SC)";"SC";"RIO DOS CEDROS";264;32;31;327
2014;"RIO FORTUNA (SC)";"SC";"RIO FORTUNA";296;7;16;319
2014;"RIO NEGRINHO (SC)";"SC";"RIO NEGRINHO";1073;72;108;1253
2014;"RIO RUFINO (SC)";"SC";"RIO RUFINO";58;9;17;84
2014;"RIQUEZA (SC)";"SC";"RIQUEZA";139;5;28;172
2014;"RODEIO (SC)";"SC";"RODEIO";265;15;25;305
2014;"ROMELANDIA (SC)";"SC";"ROMELANDIA";99;9;30;138
2014;"SALETE (SC)";"SC";"SALETE";195;11;24;230
2014;"SALTINHO (SC)";"SC";"SALTINHO";59;6;21;86
2014;"SALTO VELOSO (SC)";"SC";"SALTO VELOSO";154;4;10;168
2014;"SANGAO (SC)";"SC";"SANGAO";477;14;18;509
2014;"SANTA CECILIA (SC)";"SC";"SANTA CECILIA";462;41;53;556
2014;"SANTA HELENA (SC)";"SC";"SANTA HELENA";66;11;13;90
2014;"SANTA ROSA DE LIMA (SC)";"SC";"SANTA ROSA DE LIMA";107;7;10;124
2014;"SANTA ROSA DO SUL (SC)";"SC";"SANTA ROSA DO SUL";288;15;22;325
2014;"SANTA TEREZINHA (SC)";"SC";"SANTA TEREZINHA";189;18;31;238
2014;"SANTA TEREZINHA DO PROGRESSO (SC)";"SC";"SANTA TEREZINHA DO PROGRESSO";50;6;15;71
2014;"SANTIAGO DO SUL (SC)";"SC";"SANTIAGO DO SUL";63;9;5;77
2014;"SANTO AMARO DA IMPERATRIZ (SC)";"SC";"SANTO AMARO DA IMPERATRIZ";661;34;72;767
2014;"SAO BENTO DO SUL (SC)";"SC";"SAO BENTO DO SUL";1738;136;173;2047
2014;"SAO BERNARDINO (SC)";"SC";"SAO BERNARDINO";52;5;21;78
2014;"SAO BONIFACIO (SC)";"SC";"SAO BONIFACIO";132;7;11;150
2014;"SAO CARLOS (SC)";"SC";"SAO CARLOS";227;23;47;297
2014;"SAO CRISTOVAO DO SUL (SC)";"SC";"SAO CRISTOVAO DO SUL";302;6;14;322
2014;"SAO DOMINGOS (SC)";"SC";"SAO DOMINGOS";322;25;45;392
2014;"SAO FRANCISCO DO SUL (SC)";"SC";"SAO FRANCISCO DO SUL";687;66;87;840
2014;"SAO JOAO BATISTA (SC)";"SC";"SAO JOAO BATISTA";600;36;49;685
2014;"SAO JOAO DO ITAPERIU (SC)";"SC";"SAO JOAO DO ITAPERIU";228;6;7;241
2014;"SAO JOAO DO OESTE (SC)";"SC";"SAO JOAO DO OESTE";175;11;22;208
2014;"SAO JOAO DO SUL (SC)";"SC";"SAO JOAO DO SUL";226;5;16;247
2014;"SAO JOAQUIM (SC)";"SC";"SAO JOAQUIM";969;96;194;1259
2014;"SAO JOSE (SC)";"SC";"SAO JOSE";3799;260;224;4283
2014;"SAO JOSE DO CEDRO (SC)";"SC";"SAO JOSE DO CEDRO";429;19;70;518
2014;"SAO JOSE DO CERRITO (SC)";"SC";"SAO JOSE DO CERRITO";208;11;51;270
2014;"SAO LOURENCO D OESTE (SC)";"SC";"SAO LOURENCO D OESTE";829;54;75;958
2014;"SAO LUDGERO (SC)";"SC";"SAO LUDGERO";562;13;30;605
2014;"SAO MARTINHO (SC)";"SC";"SAO MARTINHO";157;8;5;170
2014;"SAO MIGUEL D OESTE (SC)";"SC";"SAO MIGUEL D OESTE";1108;68;102;1278
2014;"SAO MIGUEL DA BOA VISTA (SC)";"SC";"SAO MIGUEL DA BOA VISTA";27;3;15;45
2014;"SAO PEDRO DE ALCANTARA (SC)";"SC";"SAO PEDRO DE ALCANTARA";144;6;7;157
2014;"SAUDADES (SC)";"SC";"SAUDADES";231;10;35;276
2014;"SCHROEDER (SC)";"SC";"SCHROEDER";226;11;18;255
2014;"SEARA (SC)";"SC";"SEARA";394;48;79;521
2014;"SERRA ALTA (SC)";"SC";"SERRA ALTA";74;8;14;96
2014;"SIDEROPOLIS (SC)";"SC";"SIDEROPOLIS";433;28;69;530
2014;"SOMBRIO (SC)";"SC";"SOMBRIO";719;65;68;852
2014;"SUL BRASIL (SC)";"SC";"SUL BRASIL";63;4;15;82
2014;"TAIO (SC)";"SC";"TAIO";595;24;56;675
2014;"TANGARA (SC)";"SC";"TANGARA";439;14;46;499
2014;"TIGRINHOS (SC)";"SC";"TIGRINHOS";31;3;13;47
2014;"TIJUCAS (SC)";"SC";"TIJUCAS";1035;51;52;1138
2014;"TIMBE DO SUL (SC)";"SC";"TIMBE DO SUL";157;16;15;188
2014;"TIMBO (SC)";"SC";"TIMBO";698;54;50;802
2014;"TIMBO GRANDE (SC)";"SC";"TIMBO GRANDE";186;9;24;219
2014;"TRES BARRAS (SC)";"SC";"TRES BARRAS";308;28;64;400
2014;"TREVISO (SC)";"SC";"TREVISO";114;7;8;129
2014;"TREZE DE MAIO (SC)";"SC";"TREZE DE MAIO";420;12;24;456
2014;"TREZE TILIAS (SC)";"SC";"TREZE TILIAS";327;19;38;384
2014;"TROMBUDO CENTRAL (SC)";"SC";"TROMBUDO CENTRAL";225;19;21;265
2014;"TUBARAO (SC)";"SC";"TUBARAO";2452;106;382;2940
2014;"TUNAPOLIS (SC)";"SC";"TUNAPOLIS";105;12;19;136
2014;"TURVO (SC)";"SC";"TURVO";490;16;51;557
2014;"UNIAO DO OESTE (SC)";"SC";"UNIAO DO OESTE";54;3;19;76
2014;"URUBICI (SC)";"SC";"URUBICI";285;20;59;364
2014;"URUPEMA (SC)";"SC";"URUPEMA";78;13;12;103
2014;"URUSSANGA (SC)";"SC";"URUSSANGA";493;41;87;621
2014;"VARGEAO (SC)";"SC";"VARGEAO";150;5;13;168
2014;"VARGEM (SC)";"SC";"VARGEM";70;4;14;88
2014;"VARGEM BONITA (SC)";"SC";"VARGEM BONITA";167;14;22;203
2014;"VIDAL RAMOS (SC)";"SC";"VIDAL RAMOS";174;19;17;210
2014;"VIDEIRA (SC)";"SC";"VIDEIRA";1664;125;156;1945
2014;"VITOR MEIRELES (SC)";"SC";"VITOR MEIRELES";102;19;18;139
2014;"WITMARSUM (SC)";"SC";"WITMARSUM";119;10;16;145
2014;"XANXERE (SC)";"SC";"XANXERE";1325;129;133;1587
2014;"XAVANTINA (SC)";"SC";"XAVANTINA";141;17;5;163
2014;"XAXIM (SC)";"SC";"XAXIM";746;58;140;944
2014;"ZORTEA (SC)";"SC";"ZORTEA";42;9;4;55
2014;"AMPARO DE SAO FRANCISCO (SE)";"SE";"AMPARO DE SAO FRANCISCO";8;10;4;22
2014;"AQUIDABA (SE)";"SE";"AQUIDABA";127;16;50;193
2014;"ARACAJU (SE)";"SE";"ARACAJU";5893;1065;2458;9416
2014;"ARAUA (SE)";"SE";"ARAUA";57;20;17;94
2014;"AREIA BRANCA (SE)";"SE";"AREIA BRANCA";156;14;22;192
2014;"BARRA DOS COQUEIROS (SE)";"SE";"BARRA DOS COQUEIROS";90;28;28;146
2014;"BOQUIM (SE)";"SE";"BOQUIM";200;24;37;261
2014;"BREJO GRANDE (SE)";"SE";"BREJO GRANDE";8;6;8;22
2014;"CAMPO DO BRITO (SE)";"SE";"CAMPO DO BRITO";371;17;69;457
2014;"CANHOBA (SE)";"SE";"CANHOBA";5;4;5;14
2014;"CANINDE DE SAO FRANCISCO (SE)";"SE";"CANINDE DE SAO FRANCISCO";209;72;25;306
2014;"CAPELA (SE)";"SE";"CAPELA";141;38;67;246
2014;"CARIRA (SE)";"SE";"CARIRA";269;37;107;413
2014;"CARMOPOLIS (SE)";"SE";"CARMOPOLIS";102;38;74;214
2014;"CEDRO DE SAO JOAO (SE)";"SE";"CEDRO DE SAO JOAO";25;5;5;35
2014;"CRISTINAPOLIS (SE)";"SE";"CRISTINAPOLIS";75;17;34;126
2014;"CUMBE (SE)";"SE";"CUMBE";35;7;15;57
2014;"DIVINA PASTORA (SE)";"SE";"DIVINA PASTORA";7;8;8;23
2014;"ESTANCIA (SE)";"SE";"ESTANCIA";522;172;264;958
2014;"FEIRA NOVA (SE)";"SE";"FEIRA NOVA";15;10;6;31
2014;"FREI PAULO (SE)";"SE";"FREI PAULO";127;20;37;184
2014;"GARARU (SE)";"SE";"GARARU";47;11;29;87
2014;"GENERAL MAYNARD (SE)";"SE";"GENERAL MAYNARD";10;11;12;33
2014;"GRACCHO CARDOSO (SE)";"SE";"GRACCHO CARDOSO";19;11;8;38
2014;"ILHA DAS FLORES (SE)";"SE";"ILHA DAS FLORES";16;8;10;34
2014;"INDIAROBA (SE)";"SE";"INDIAROBA";42;17;19;78
2014;"ITABAIANA (SE)";"SE";"ITABAIANA";3169;138;178;3485
2014;"ITABAIANINHA (SE)";"SE";"ITABAIANINHA";587;66;64;717
2014;"ITABI (SE)";"SE";"ITABI";20;4;8;32
2014;"ITAPORANGA D AJUDA (SE)";"SE";"ITAPORANGA D AJUDA";300;40;65;405
2014;"JAPARATUBA (SE)";"SE";"JAPARATUBA";51;29;64;144
2014;"JAPOATA (SE)";"SE";"JAPOATA";57;9;32;98
2014;"LAGARTO (SE)";"SE";"LAGARTO";1065;150;207;1422
2014;"LARANJEIRAS (SE)";"SE";"LARANJEIRAS";130;58;41;229
2014;"MACAMBIRA (SE)";"SE";"MACAMBIRA";45;7;18;70
2014;"MALHADA DOS BOIS (SE)";"SE";"MALHADA DOS BOIS";13;4;8;25
2014;"MALHADOR (SE)";"SE";"MALHADOR";209;24;52;285
2014;"MARUIM (SE)";"SE";"MARUIM";53;31;37;121
2014;"MOITA BONITA (SE)";"SE";"MOITA BONITA";457;19;18;494
2014;"MONTE ALEGRE DE SERGIPE (SE)";"SE";"MONTE ALEGRE DE SERGIPE";144;26;30;200
2014;"MURIBECA (SE)";"SE";"MURIBECA";74;7;31;112
2014;"NEOPOLIS (SE)";"SE";"NEOPOLIS";47;18;29;94
2014;"NOSSA SENHORA APARECIDA (SE)";"SE";"NOSSA SENHORA APARECIDA";137;21;15;173
2014;"NOSSA SENHORA DA GLORIA (SE)";"SE";"NOSSA SENHORA DA GLORIA";491;57;139;687
2014;"NOSSA SENHORA DAS DORES (SE)";"SE";"NOSSA SENHORA DAS DORES";252;22;86;360
2014;"NOSSA SENHORA DE LOURDES (SE)";"SE";"NOSSA SENHORA DE LOURDES";27;3;8;38
2014;"NOSSA SENHORA DO SOCORRO (SE)";"SE";"NOSSA SENHORA DO SOCORRO";863;130;152;1145
2014;"PACATUBA (SE)";"SE";"PACATUBA";422;10;52;484
2014;"PEDRA MOLE (SE)";"SE";"PEDRA MOLE";6;3;4;13
2014;"PEDRINHAS (SE)";"SE";"PEDRINHAS";63;6;9;78
2014;"PINHAO (SE)";"SE";"PINHAO";31;18;8;57
2014;"PIRAMBU (SE)";"SE";"PIRAMBU";27;4;17;48
2014;"POCO REDONDO (SE)";"SE";"POCO REDONDO";174;59;74;307
2014;"POCO VERDE (SE)";"SE";"POCO VERDE";125;63;167;355
2014;"PORTO DA FOLHA (SE)";"SE";"PORTO DA FOLHA";142;37;33;212
2014;"PROPRIA (SE)";"SE";"PROPRIA";242;31;56;329
2014;"RIACHAO DO DANTAS (SE)";"SE";"RIACHAO DO DANTAS";30;6;18;54
2014;"RIACHUELO (SE)";"SE";"RIACHUELO";40;14;11;65
2014;"RIBEIROPOLIS (SE)";"SE";"RIBEIROPOLIS";280;38;59;377
2014;"ROSARIO DO CATETE (SE)";"SE";"ROSARIO DO CATETE";32;19;15;66
2014;"SALGADO (SE)";"SE";"SALGADO";136;19;127;282
2014;"SANTA LUZIA DO ITANHY (SE)";"SE";"SANTA LUZIA DO ITANHY";22;11;30;63
2014;"SANTA ROSA DE LIMA (SE)";"SE";"SANTA ROSA DE LIMA";26;4;8;38
2014;"SANTANA DO SAO FRANCISCO (SE)";"SE";"SANTANA DO SAO FRANCISCO";12;3;9;24
2014;"SANTO AMARO DAS BROTAS (SE)";"SE";"SANTO AMARO DAS BROTAS";19;8;20;47
2014;"SAO CRISTOVAO (SE)";"SE";"SAO CRISTOVAO";406;100;184;690
2014;"SAO DOMINGOS (SE)";"SE";"SAO DOMINGOS";129;11;30;170
2014;"SAO FRANCISCO (SE)";"SE";"SAO FRANCISCO";16;4;24;44
2014;"SAO MIGUEL DO ALEIXO (SE)";"SE";"SAO MIGUEL DO ALEIXO";39;4;6;49
2014;"SIMAO DIAS (SE)";"SE";"SIMAO DIAS";258;50;254;562
2014;"SIRIRI (SE)";"SE";"SIRIRI";34;10;39;83
2014;"TELHA (SE)";"SE";"TELHA";15;9;4;28
2014;"TOBIAS BARRETO (SE)";"SE";"TOBIAS BARRETO";308;81;189;578
2014;"TOMAR DO GERU (SE)";"SE";"TOMAR DO GERU";53;6;22;81
2014;"UMBAUBA (SE)";"SE";"UMBAUBA";297;36;44;377
2014;"ADAMANTINA (SP)";"SP";"ADAMANTINA";721;58;75;854
2014;"ADOLFO (SP)";"SP";"ADOLFO";85;4;28;117
2014;"AGUAI (SP)";"SP";"AGUAI";862;75;170;1107
2014;"AGUAS DA PRATA (SP)";"SP";"AGUAS DA PRATA";121;16;13;150
2014;"AGUAS DE LINDOIA (SP)";"SP";"AGUAS DE LINDOIA";191;82;73;346
2014;"AGUAS DE SANTA BARBARA (SP)";"SP";"AGUAS DE SANTA BARBARA";114;28;33;175
2014;"AGUAS DE SAO PEDRO (SP)";"SP";"AGUAS DE SAO PEDRO";43;7;5;55
2014;"AGUDOS (SP)";"SP";"AGUDOS";583;108;100;791
2014;"ALAMBARI (SP)";"SP";"ALAMBARI";100;15;6;121
2014;"ALFREDO MARCONDES (SP)";"SP";"ALFREDO MARCONDES";72;9;7;88
2014;"ALTAIR (SP)";"SP";"ALTAIR";69;7;34;110
2014;"ALTINOPOLIS (SP)";"SP";"ALTINOPOLIS";354;58;116;528
2014;"ALTO ALEGRE (SP)";"SP";"ALTO ALEGRE";98;5;48;151
2014;"ALUMINIO (SP)";"SP";"ALUMINIO";243;37;43;323
2014;"ALVARES FLORENCE (SP)";"SP";"ALVARES FLORENCE";61;5;16;82
2014;"ALVARES MACHADO (SP)";"SP";"ALVARES MACHADO";447;34;33;514
2014;"ALVARO DE CARVALHO (SP)";"SP";"ALVARO DE CARVALHO";23;5;26;54
2014;"ALVINLANDIA (SP)";"SP";"ALVINLANDIA";47;4;21;72
2014;"AMERICANA (SP)";"SP";"AMERICANA";3708;554;665;4927
2014;"AMERICO BRASILIENSE (SP)";"SP";"AMERICO BRASILIENSE";704;71;227;1002
2014;"AMERICO DE CAMPOS (SP)";"SP";"AMERICO DE CAMPOS";125;11;30;166
2014;"AMPARO (SP)";"SP";"AMPARO";1404;247;138;1789
2014;"ANALANDIA (SP)";"SP";"ANALANDIA";90;17;13;120
2014;"ANDRADINA (SP)";"SP";"ANDRADINA";1292;78;137;1507
2014;"ANGATUBA (SP)";"SP";"ANGATUBA";391;60;109;560
2014;"ANHEMBI (SP)";"SP";"ANHEMBI";91;23;20;134
2014;"ANHUMAS (SP)";"SP";"ANHUMAS";81;7;8;96
2014;"APARECIDA (SP)";"SP";"APARECIDA";858;77;582;1517
2014;"APARECIDA D OESTE (SP)";"SP";"APARECIDA D OESTE";107;13;28;148
2014;"APIAI (SP)";"SP";"APIAI";376;52;77;505
2014;"ARACARIGUAMA (SP)";"SP";"ARACARIGUAMA";632;84;51;767
2014;"ARACATUBA (SP)";"SP";"ARACATUBA";3705;293;776;4774
2014;"ARACOIABA DA SERRA (SP)";"SP";"ARACOIABA DA SERRA";539;115;26;680
2014;"ARAMINA (SP)";"SP";"ARAMINA";53;7;25;85
2014;"ARANDU (SP)";"SP";"ARANDU";59;5;24;88
2014;"ARAPEI (SP)";"SP";"ARAPEI";37;11;13;61
2014;"ARARAQUARA (SP)";"SP";"ARARAQUARA";3756;418;1114;5288
2014;"ARARAS (SP)";"SP";"ARARAS";2342;279;341;2962
2014;"ARCO IRIS (SP)";"SP";"ARCO IRIS";73;4;7;84
2014;"AREALVA (SP)";"SP";"AREALVA";180;6;29;215
2014;"AREIAS (SP)";"SP";"AREIAS";53;6;6;65
2014;"AREIOPOLIS (SP)";"SP";"AREIOPOLIS";133;29;98;260
2014;"ARIRANHA (SP)";"SP";"ARIRANHA";299;25;174;498
2014;"ARTUR NOGUEIRA (SP)";"SP";"ARTUR NOGUEIRA";1071;96;151;1318
2014;"ARUJA (SP)";"SP";"ARUJA";3168;401;412;3981
2014;"ASPASIA (SP)";"SP";"ASPASIA";33;7;5;45
2014;"ASSIS (SP)";"SP";"ASSIS";1916;195;379;2490
2014;"ATIBAIA (SP)";"SP";"ATIBAIA";2578;389;363;3330
2014;"AURIFLAMA (SP)";"SP";"AURIFLAMA";345;31;47;423
2014;"AVAI (SP)";"SP";"AVAI";78;10;19;107
2014;"AVANHANDAVA (SP)";"SP";"AVANHANDAVA";156;13;55;224
2014;"AVARE (SP)";"SP";"AVARE";1342;160;290;1792
2014;"BADY BASSITT (SP)";"SP";"BADY BASSITT";432;51;68;551
2014;"BALBINOS (SP)";"SP";"BALBINOS";25;3;8;36
2014;"BALSAMO (SP)";"SP";"BALSAMO";199;9;24;232
2014;"BANANAL (SP)";"SP";"BANANAL";147;20;34;201
2014;"BARAO DE ANTONINA (SP)";"SP";"BARAO DE ANTONINA";23;3;15;41
2014;"BARBOSA (SP)";"SP";"BARBOSA";131;4;42;177
2014;"BARIRI (SP)";"SP";"BARIRI";835;67;92;994
2014;"BARRA BONITA (SP)";"SP";"BARRA BONITA";1151;95;257;1503
2014;"BARRA DO CHAPEU (SP)";"SP";"BARRA DO CHAPEU";50;4;18;72
2014;"BARRA DO TURVO (SP)";"SP";"BARRA DO TURVO";66;19;43;128
2014;"BARRETOS (SP)";"SP";"BARRETOS";2082;239;532;2853
2014;"BARRINHA (SP)";"SP";"BARRINHA";498;44;183;725
2014;"BARUERI (SP)";"SP";"BARUERI";6488;814;1230;8532
2014;"BASTOS (SP)";"SP";"BASTOS";806;27;89;922
2014;"BATATAIS (SP)";"SP";"BATATAIS";1171;147;182;1500
2014;"BAURU (SP)";"SP";"BAURU";5829;497;1234;7560
2014;"BEBEDOURO (SP)";"SP";"BEBEDOURO";1678;151;283;2112
2014;"BENTO DE ABREU (SP)";"SP";"BENTO DE ABREU";68;12;13;93
2014;"BERNARDINO DE CAMPOS (SP)";"SP";"BERNARDINO DE CAMPOS";338;37;38;413
2014;"BERTIOGA (SP)";"SP";"BERTIOGA";532;70;113;715
2014;"BILAC (SP)";"SP";"BILAC";166;11;25;202
2014;"BIRIGUI (SP)";"SP";"BIRIGUI";1812;113;182;2107
2014;"BIRITIBA MIRIM (SP)";"SP";"BIRITIBA MIRIM";418;30;26;474
2014;"BOA ESPERANCA DO SUL (SP)";"SP";"BOA ESPERANCA DO SUL";348;41;99;488
2014;"BOCAINA (SP)";"SP";"BOCAINA";219;44;35;298
2014;"BOFETE (SP)";"SP";"BOFETE";230;53;49;332
2014;"BOITUVA (SP)";"SP";"BOITUVA";1293;167;153;1613
2014;"BOM JESUS DOS PERDOES (SP)";"SP";"BOM JESUS DOS PERDOES";568;87;79;734
2014;"BOM SUCESSO DE ITARARE (SP)";"SP";"BOM SUCESSO DE ITARARE";73;9;14;96
2014;"BORA (SP)";"SP";"BORA";43;1;6;50
2014;"BORACEIA (SP)";"SP";"BORACEIA";230;10;22;262
2014;"BORBOREMA (SP)";"SP";"BORBOREMA";366;26;82;474
2014;"BOREBI (SP)";"SP";"BOREBI";54;9;6;69
2014;"BOTUCATU (SP)";"SP";"BOTUCATU";1775;306;538;2619
2014;"BRAGANCA PAULISTA (SP)";"SP";"BRAGANCA PAULISTA";2849;398;390;3637
2014;"BRAUNA (SP)";"SP";"BRAUNA";76;8;87;171
2014;"BREJO ALEGRE (SP)";"SP";"BREJO ALEGRE";150;1;19;170
2014;"BRODOWSKI (SP)";"SP";"BRODOWSKI";611;38;39;688
2014;"BROTAS (SP)";"SP";"BROTAS";541;62;199;802
2014;"BURI (SP)";"SP";"BURI";457;42;78;577
2014;"BURITAMA (SP)";"SP";"BURITAMA";349;27;62;438
2014;"BURITIZAL (SP)";"SP";"BURITIZAL";116;16;34;166
2014;"CABRALIA PAULISTA (SP)";"SP";"CABRALIA PAULISTA";135;8;17;160
2014;"CABREUVA (SP)";"SP";"CABREUVA";1008;143;63;1214
2014;"CACAPAVA (SP)";"SP";"CACAPAVA";1171;353;231;1755
2014;"CACHOEIRA PAULISTA (SP)";"SP";"CACHOEIRA PAULISTA";384;88;23;495
2014;"CACONDE (SP)";"SP";"CACONDE";250;54;87;391
2014;"CAFELANDIA (SP)";"SP";"CAFELANDIA";299;23;76;398
2014;"CAIABU (SP)";"SP";"CAIABU";43;11;42;96
2014;"CAIEIRAS (SP)";"SP";"CAIEIRAS";1203;269;549;2021
2014;"CAIUA (SP)";"SP";"CAIUA";54;9;22;85
2014;"CAJAMAR (SP)";"SP";"CAJAMAR";1639;229;336;2204
2014;"CAJATI (SP)";"SP";"CAJATI";607;78;89;774
2014;"CAJOBI (SP)";"SP";"CAJOBI";243;10;84;337
2014;"CAJURU (SP)";"SP";"CAJURU";489;31;101;621
2014;"CAMPINA DO MONTE ALEGRE (SP)";"SP";"CAMPINA DO MONTE ALEGRE";73;22;28;123
2014;"CAMPINAS (SP)";"SP";"CAMPINAS";21007;3833;5565;30405
2014;"CAMPO LIMPO PAULISTA (SP)";"SP";"CAMPO LIMPO PAULISTA";647;118;31;796
2014;"CAMPOS DO JORDAO (SP)";"SP";"CAMPOS DO JORDAO";621;170;64;855
2014;"CAMPOS NOVOS PAULISTA (SP)";"SP";"CAMPOS NOVOS PAULISTA";90;7;29;126
2014;"CANANEIA (SP)";"SP";"CANANEIA";104;11;13;128
2014;"CANAS (SP)";"SP";"CANAS";127;10;10;147
2014;"CANDIDO MOTA (SP)";"SP";"CANDIDO MOTA";923;56;61;1040
2014;"CANDIDO RODRIGUES (SP)";"SP";"CANDIDO RODRIGUES";116;9;10;135
2014;"CANITAR (SP)";"SP";"CANITAR";55;19;20;94
2014;"CAPAO BONITO (SP)";"SP";"CAPAO BONITO";940;133;183;1256
2014;"CAPELA DO ALTO (SP)";"SP";"CAPELA DO ALTO";515;58;36;609
2014;"CAPIVARI (SP)";"SP";"CAPIVARI";1183;109;231;1523
2014;"CARAGUATATUBA (SP)";"SP";"CARAGUATATUBA";1674;180;107;1961
2014;"CARAPICUIBA (SP)";"SP";"CARAPICUIBA";3979;859;928;5766
2014;"CARDOSO (SP)";"SP";"CARDOSO";180;19;49;248
2014;"CASA BRANCA (SP)";"SP";"CASA BRANCA";592;69;90;751
2014;"CASSIA DOS COQUEIROS (SP)";"SP";"CASSIA DOS COQUEIROS";25;5;16;46
2014;"CASTILHO (SP)";"SP";"CASTILHO";246;41;108;395
2014;"CATANDUVA (SP)";"SP";"CATANDUVA";3027;253;509;3789
2014;"CATIGUA (SP)";"SP";"CATIGUA";94;12;28;134
2014;"CEDRAL (SP)";"SP";"CEDRAL";226;22;18;266
2014;"CERQUEIRA CESAR (SP)";"SP";"CERQUEIRA CESAR";372;50;134;556
2014;"CERQUILHO (SP)";"SP";"CERQUILHO";905;121;98;1124
2014;"CESARIO LANGE (SP)";"SP";"CESARIO LANGE";395;58;50;503
2014;"CHARQUEADA (SP)";"SP";"CHARQUEADA";450;40;100;590
2014;"CHAVANTES (SP)";"SP";"CHAVANTES";146;35;52;233
2014;"CLEMENTINA (SP)";"SP";"CLEMENTINA";279;14;64;357
2014;"COLINA (SP)";"SP";"COLINA";388;35;85;508
2014;"COLOMBIA (SP)";"SP";"COLOMBIA";123;34;68;225
2014;"CONCHAL (SP)";"SP";"CONCHAL";815;55;257;1127
2014;"CONCHAS (SP)";"SP";"CONCHAS";361;44;43;448
2014;"CORDEIROPOLIS (SP)";"SP";"CORDEIROPOLIS";745;78;46;869
2014;"COROADOS (SP)";"SP";"COROADOS";88;4;20;112
2014;"CORONEL MACEDO (SP)";"SP";"CORONEL MACEDO";59;13;23;95
2014;"CORUMBATAI (SP)";"SP";"CORUMBATAI";159;16;10;185
2014;"COSMOPOLIS (SP)";"SP";"COSMOPOLIS";923;291;313;1527
2014;"COSMORAMA (SP)";"SP";"COSMORAMA";229;15;49;293
2014;"COTIA (SP)";"SP";"COTIA";3370;932;804;5106
2014;"CRAVINHOS (SP)";"SP";"CRAVINHOS";993;55;182;1230
2014;"CRISTAIS PAULISTA (SP)";"SP";"CRISTAIS PAULISTA";122;11;26;159
2014;"CRUZALIA (SP)";"SP";"CRUZALIA";77;7;5;89
2014;"CRUZEIRO (SP)";"SP";"CRUZEIRO";755;143;46;944
2014;"CUBATAO (SP)";"SP";"CUBATAO";2819;410;437;3666
2014;"CUNHA (SP)";"SP";"CUNHA";294;52;43;389
2014;"DESCALVADO (SP)";"SP";"DESCALVADO";984;108;195;1287
2014;"DIADEMA (SP)";"SP";"DIADEMA";4517;778;629;5924
2014;"DIRCE REIS (SP)";"SP";"DIRCE REIS";64;6;9;79
2014;"DIVINOLANDIA (SP)";"SP";"DIVINOLANDIA";439;26;42;507
2014;"DOBRADA (SP)";"SP";"DOBRADA";61;11;82;154
2014;"DOIS CORREGOS (SP)";"SP";"DOIS CORREGOS";670;82;136;888
2014;"DOLCINOPOLIS (SP)";"SP";"DOLCINOPOLIS";34;5;9;48
2014;"DOURADO (SP)";"SP";"DOURADO";200;27;54;281
2014;"DRACENA (SP)";"SP";"DRACENA";1095;59;132;1286
2014;"DUARTINA (SP)";"SP";"DUARTINA";270;28;70;368
2014;"DUMONT (SP)";"SP";"DUMONT";314;10;54;378
2014;"ECHAPORA (SP)";"SP";"ECHAPORA";151;3;20;174
2014;"ELDORADO (SP)";"SP";"ELDORADO";257;25;53;335
2014;"ELIAS FAUSTO (SP)";"SP";"ELIAS FAUSTO";356;19;93;468
2014;"ELISIARIO (SP)";"SP";"ELISIARIO";52;8;8;68
2014;"EMBAUBA (SP)";"SP";"EMBAUBA";81;4;27;112
2014;"EMBU (SP)";"SP";"EMBU";2839;680;752;4271
2014;"EMBU GUACU (SP)";"SP";"EMBU GUACU";2535;274;298;3107
2014;"EMILIANOPOLIS (SP)";"SP";"EMILIANOPOLIS";56;3;13;72
2014;"ENGENHEIRO COELHO (SP)";"SP";"ENGENHEIRO COELHO";364;50;152;566
2014;"ESPIRITO SANTO DO PINHAL (SP)";"SP";"ESPIRITO SANTO DO PINHAL";649;127;78;854
2014;"ESPIRITO SANTO DO TURVO (SP)";"SP";"ESPIRITO SANTO DO TURVO";158;24;37;219
2014;"ESTIVA GERBI (SP)";"SP";"ESTIVA GERBI";284;21;27;332
2014;"ESTRELA D OESTE (SP)";"SP";"ESTRELA D OESTE";283;8;33;324
2014;"ESTRELA DO NORTE (SP)";"SP";"ESTRELA DO NORTE";23;3;8;34
2014;"EUCLIDES DA CUNHA PAULISTA (SP)";"SP";"EUCLIDES DA CUNHA PAULISTA";96;5;52;153
2014;"FARTURA (SP)";"SP";"FARTURA";290;32;46;368
2014;"FERNANDO PRESTES (SP)";"SP";"FERNANDO PRESTES";229;9;17;255
2014;"FERNANDOPOLIS (SP)";"SP";"FERNANDOPOLIS";1519;101;195;1815
2014;"FERNAO (SP)";"SP";"FERNAO";35;4;8;47
2014;"FERRAZ DE VASCONCELOS (SP)";"SP";"FERRAZ DE VASCONCELOS";2169;309;352;2830
2014;"FLORA RICA (SP)";"SP";"FLORA RICA";21;1;10;32
2014;"FLOREAL (SP)";"SP";"FLOREAL";62;9;7;78
2014;"FLORIDA PAULISTA (SP)";"SP";"FLORIDA PAULISTA";322;23;116;461
2014;"FLORINEA (SP)";"SP";"FLORINEA";50;7;9;66
2014;"FRANCA (SP)";"SP";"FRANCA";3518;420;630;4568
2014;"FRANCISCO MORATO (SP)";"SP";"FRANCISCO MORATO";615;228;225;1068
2014;"FRANCO DA ROCHA (SP)";"SP";"FRANCO DA ROCHA";973;234;189;1396
2014;"GABRIEL MONTEIRO (SP)";"SP";"GABRIEL MONTEIRO";64;1;12;77
2014;"GALIA (SP)";"SP";"GALIA";147;18;38;203
2014;"GARCA (SP)";"SP";"GARCA";769;76;115;960
2014;"GASTAO VIDIGAL (SP)";"SP";"GASTAO VIDIGAL";59;9;55;123
2014;"GAVIAO PEIXOTO (SP)";"SP";"GAVIAO PEIXOTO";56;13;20;89
2014;"GENERAL SALGADO (SP)";"SP";"GENERAL SALGADO";280;22;106;408
2014;"GETULINA (SP)";"SP";"GETULINA";146;6;67;219
2014;"GLICERIO (SP)";"SP";"GLICERIO";126;6;28;160
2014;"GUAICARA (SP)";"SP";"GUAICARA";129;13;30;172
2014;"GUAIMBE (SP)";"SP";"GUAIMBE";140;4;29;173
2014;"GUAIRA (SP)";"SP";"GUAIRA";1252;87;207;1546
2014;"GUAPIACU (SP)";"SP";"GUAPIACU";449;27;71;547
2014;"GUAPIARA (SP)";"SP";"GUAPIARA";342;46;54;442
2014;"GUARA (SP)";"SP";"GUARA";223;41;171;435
2014;"GUARACAI (SP)";"SP";"GUARACAI";304;27;35;366
2014;"GUARACI (SP)";"SP";"GUARACI";201;19;70;290
2014;"GUARANI D OESTE (SP)";"SP";"GUARANI D OESTE";28;4;6;38
2014;"GUARANTA (SP)";"SP";"GUARANTA";100;8;41;149
2014;"GUARARAPES (SP)";"SP";"GUARARAPES";704;62;139;905
2014;"GUARAREMA (SP)";"SP";"GUARAREMA";559;84;50;693
2014;"GUARATINGUETA (SP)";"SP";"GUARATINGUETA";1268;370;180;1818
2014;"GUAREI (SP)";"SP";"GUAREI";277;31;75;383
2014;"GUARIBA (SP)";"SP";"GUARIBA";891;67;296;1254
2014;"GUARUJA (SP)";"SP";"GUARUJA";2166;398;430;2994
2014;"GUARULHOS (SP)";"SP";"GUARULHOS";22115;4039;3967;30121
2014;"GUATAPARA (SP)";"SP";"GUATAPARA";203;18;53;274
2014;"GUZOLANDIA (SP)";"SP";"GUZOLANDIA";69;2;32;103
2014;"HERCULANDIA (SP)";"SP";"HERCULANDIA";487;7;24;518
2014;"HOLAMBRA (SP)";"SP";"HOLAMBRA";379;46;97;522
2014;"HORTOLANDIA (SP)";"SP";"HORTOLANDIA";1925;469;461;2855
2014;"IACANGA (SP)";"SP";"IACANGA";242;29;38;309
2014;"IACRI (SP)";"SP";"IACRI";150;3;23;176
2014;"IARAS (SP)";"SP";"IARAS";60;17;38;115
2014;"IBATE (SP)";"SP";"IBATE";597;126;203;926
2014;"IBIRA (SP)";"SP";"IBIRA";184;17;53;254
2014;"IBIRAREMA (SP)";"SP";"IBIRAREMA";175;15;27;217
2014;"IBITINGA (SP)";"SP";"IBITINGA";881;98;176;1155
2014;"IBIUNA (SP)";"SP";"IBIUNA";2100;224;134;2458
2014;"ICEM (SP)";"SP";"ICEM";217;8;65;290
2014;"IEPE (SP)";"SP";"IEPE";173;13;28;214
2014;"IGARACU DO TIETE (SP)";"SP";"IGARACU DO TIETE";353;39;91;483
2014;"IGARAPAVA (SP)";"SP";"IGARAPAVA";413;55;115;583
2014;"IGARATA (SP)";"SP";"IGARATA";151;28;14;193
2014;"IGUAPE (SP)";"SP";"IGUAPE";240;56;52;348
2014;"ILHA COMPRIDA (SP)";"SP";"ILHA COMPRIDA";180;28;72;280
2014;"ILHA SOLTEIRA (SP)";"SP";"ILHA SOLTEIRA";259;33;91;383
2014;"ILHABELA (SP)";"SP";"ILHABELA";340;60;53;453
2014;"INDAIATUBA (SP)";"SP";"INDAIATUBA";3394;639;291;4324
2014;"INDIANA (SP)";"SP";"INDIANA";130;10;12;152
2014;"INDIAPORA (SP)";"SP";"INDIAPORA";69;5;21;95
2014;"INUBIA PAULISTA (SP)";"SP";"INUBIA PAULISTA";54;6;13;73
2014;"IPAUSSU (SP)";"SP";"IPAUSSU";206;26;57;289
2014;"IPERO (SP)";"SP";"IPERO";266;47;29;342
2014;"IPEUNA (SP)";"SP";"IPEUNA";193;31;37;261
2014;"IPIGUA (SP)";"SP";"IPIGUA";42;5;10;57
2014;"IPORANGA (SP)";"SP";"IPORANGA";32;19;10;61
2014;"IPUA (SP)";"SP";"IPUA";269;25;87;381
2014;"IRACEMAPOLIS (SP)";"SP";"IRACEMAPOLIS";546;59;114;719
2014;"IRAPUA (SP)";"SP";"IRAPUA";131;8;83;222
2014;"IRAPURU (SP)";"SP";"IRAPURU";108;14;26;148
2014;"ITABERA (SP)";"SP";"ITABERA";276;46;44;366
2014;"ITAI (SP)";"SP";"ITAI";542;75;169;786
2014;"ITAJOBI (SP)";"SP";"ITAJOBI";510;17;49;576
2014;"ITAJU (SP)";"SP";"ITAJU";77;2;20;99
2014;"ITANHAEM (SP)";"SP";"ITANHAEM";878;227;119;1224
2014;"ITAOCA (SP)";"SP";"ITAOCA";32;8;9;49
2014;"ITAPECERICA DA SERRA (SP)";"SP";"ITAPECERICA DA SERRA";2770;678;764;4212
2014;"ITAPETININGA (SP)";"SP";"ITAPETININGA";2892;449;484;3825
2014;"ITAPEVA (SP)";"SP";"ITAPEVA";1974;338;401;2713
2014;"ITAPEVI (SP)";"SP";"ITAPEVI";2071;394;183;2648
2014;"ITAPIRA (SP)";"SP";"ITAPIRA";1730;139;225;2094
2014;"ITAPIRAPUA PAULISTA (SP)";"SP";"ITAPIRAPUA PAULISTA";49;16;15;80
2014;"ITAPOLIS (SP)";"SP";"ITAPOLIS";1268;111;205;1584
2014;"ITAPORANGA (SP)";"SP";"ITAPORANGA";239;22;77;338
2014;"ITAPUI (SP)";"SP";"ITAPUI";399;45;71;515
2014;"ITAPURA (SP)";"SP";"ITAPURA";28;8;15;51
2014;"ITAQUAQUECETUBA (SP)";"SP";"ITAQUAQUECETUBA";3988;468;533;4989
2014;"ITARARE (SP)";"SP";"ITARARE";946;94;271;1311
2014;"ITARIRI (SP)";"SP";"ITARIRI";358;36;23;417
2014;"ITATIBA (SP)";"SP";"ITATIBA";2608;269;353;3230
2014;"ITATINGA (SP)";"SP";"ITATINGA";226;44;112;382
2014;"ITIRAPINA (SP)";"SP";"ITIRAPINA";313;46;59;418
2014;"ITIRAPUA (SP)";"SP";"ITIRAPUA";94;6;21;121
2014;"ITOBI (SP)";"SP";"ITOBI";153;24;82;259
2014;"ITU (SP)";"SP";"ITU";3351;471;667;4489
2014;"ITUPEVA (SP)";"SP";"ITUPEVA";1274;130;112;1516
2014;"ITUVERAVA (SP)";"SP";"ITUVERAVA";646;53;118;817
2014;"JABORANDI (SP)";"SP";"JABORANDI";177;11;41;229
2014;"JABOTICABAL (SP)";"SP";"JABOTICABAL";1981;114;240;2335
2014;"JACAREI (SP)";"SP";"JACAREI";2722;635;356;3713
2014;"JACI (SP)";"SP";"JACI";215;13;15;243
2014;"JACUPIRANGA (SP)";"SP";"JACUPIRANGA";405;50;428;883
2014;"JAGUARIUNA (SP)";"SP";"JAGUARIUNA";1132;99;192;1423
2014;"JALES (SP)";"SP";"JALES";1262;49;80;1391
2014;"JAMBEIRO (SP)";"SP";"JAMBEIRO";116;39;16;171
2014;"JANDIRA (SP)";"SP";"JANDIRA";1198;316;208;1722
2014;"JARDINOPOLIS (SP)";"SP";"JARDINOPOLIS";980;111;131;1222
2014;"JARINU (SP)";"SP";"JARINU";650;57;45;752
2014;"JAU (SP)";"SP";"JAU";2523;316;448;3287
2014;"JERIQUARA (SP)";"SP";"JERIQUARA";61;5;23;89
2014;"JOANOPOLIS (SP)";"SP";"JOANOPOLIS";404;22;18;444
2014;"JOAO RAMALHO (SP)";"SP";"JOAO RAMALHO";34;10;21;65
2014;"JOSE BONIFACIO (SP)";"SP";"JOSE BONIFACIO";880;62;101;1043
2014;"JULIO MESQUITA (SP)";"SP";"JULIO MESQUITA";42;9;31;82
2014;"JUMIRIM (SP)";"SP";"JUMIRIM";107;12;5;124
2014;"JUNDIAI (SP)";"SP";"JUNDIAI";8304;870;1183;10357
2014;"JUNQUEIROPOLIS (SP)";"SP";"JUNQUEIROPOLIS";484;27;191;702
2014;"JUQUIA (SP)";"SP";"JUQUIA";422;32;23;477
2014;"JUQUITIBA (SP)";"SP";"JUQUITIBA";653;101;111;865
2014;"LAGOINHA (SP)";"SP";"LAGOINHA";144;24;24;192
2014;"LARANJAL PAULISTA (SP)";"SP";"LARANJAL PAULISTA";687;57;197;941
2014;"LAVINIA (SP)";"SP";"LAVINIA";76;5;14;95
2014;"LAVRINHAS (SP)";"SP";"LAVRINHAS";93;24;13;130
2014;"LEME (SP)";"SP";"LEME";2594;195;524;3313
2014;"LENCOIS PAULISTA (SP)";"SP";"LENCOIS PAULISTA";1464;204;316;1984
2014;"LIMEIRA (SP)";"SP";"LIMEIRA";4976;957;628;6561
2014;"LINDOIA (SP)";"SP";"LINDOIA";183;27;29;239
2014;"LINS (SP)";"SP";"LINS";1523;133;173;1829
2014;"LORENA (SP)";"SP";"LORENA";922;200;36;1158
2014;"LOURDES (SP)";"SP";"LOURDES";29;4;18;51
2014;"LOUVEIRA (SP)";"SP";"LOUVEIRA";947;156;63;1166
2014;"LUCELIA (SP)";"SP";"LUCELIA";388;30;190;608
2014;"LUCIANOPOLIS (SP)";"SP";"LUCIANOPOLIS";55;10;18;83
2014;"LUIS ANTONIO (SP)";"SP";"LUIS ANTONIO";291;31;153;475
2014;"LUIZIANIA (SP)";"SP";"LUIZIANIA";71;3;25;99
2014;"LUPERCIO (SP)";"SP";"LUPERCIO";50;5;31;86
2014;"LUTECIA (SP)";"SP";"LUTECIA";42;7;10;59
2014;"MACATUBA (SP)";"SP";"MACATUBA";470;34;86;590
2014;"MACAUBAL (SP)";"SP";"MACAUBAL";142;16;24;182
2014;"MACEDONIA (SP)";"SP";"MACEDONIA";49;2;12;63
2014;"MAGDA (SP)";"SP";"MAGDA";106;13;8;127
2014;"MAIRINQUE (SP)";"SP";"MAIRINQUE";638;110;116;864
2014;"MAIRIPORA (SP)";"SP";"MAIRIPORA";2180;301;153;2634
2014;"MANDURI (SP)";"SP";"MANDURI";235;42;81;358
2014;"MARABA PAULISTA (SP)";"SP";"MARABA PAULISTA";38;8;19;65
2014;"MARACAI (SP)";"SP";"MARACAI";330;70;51;451
2014;"MARAPOAMA (SP)";"SP";"MARAPOAMA";141;10;9;160
2014;"MARIAPOLIS (SP)";"SP";"MARIAPOLIS";44;4;28;76
2014;"MARILIA (SP)";"SP";"MARILIA";3314;334;555;4203
2014;"MARINOPOLIS (SP)";"SP";"MARINOPOLIS";85;8;8;101
2014;"MARTINOPOLIS (SP)";"SP";"MARTINOPOLIS";432;44;109;585
2014;"MATAO (SP)";"SP";"MATAO";1614;112;376;2102
2014;"MAUA (SP)";"SP";"MAUA";3948;1107;1310;6365
2014;"MENDONCA (SP)";"SP";"MENDONCA";104;4;26;134
2014;"MERIDIANO (SP)";"SP";"MERIDIANO";173;12;20;205
2014;"MESOPOLIS (SP)";"SP";"MESOPOLIS";16;4;16;36
2014;"MIGUELOPOLIS (SP)";"SP";"MIGUELOPOLIS";321;15;96;432
2014;"MINEIROS DO TIETE (SP)";"SP";"MINEIROS DO TIETE";266;17;45;328
2014;"MIRA ESTRELA (SP)";"SP";"MIRA ESTRELA";41;6;27;74
2014;"MIRACATU (SP)";"SP";"MIRACATU";656;78;33;767
2014;"MIRANDOPOLIS (SP)";"SP";"MIRANDOPOLIS";539;51;162;752
2014;"MIRANTE DO PARANAPANEMA (SP)";"SP";"MIRANTE DO PARANAPANEMA";276;59;89;424
2014;"MIRASSOL (SP)";"SP";"MIRASSOL";1304;58;84;1446
2014;"MIRASSOLANDIA (SP)";"SP";"MIRASSOLANDIA";48;11;10;69
2014;"MOCOCA (SP)";"SP";"MOCOCA";1211;132;338;1681
2014;"MOGI DAS CRUZES (SP)";"SP";"MOGI DAS CRUZES";6447;934;1620;9001
2014;"MOGI GUACU (SP)";"SP";"MOGI GUACU";2573;478;574;3625
2014;"MOGI MIRIM (SP)";"SP";"MOGI MIRIM";1972;216;471;2659
2014;"MOMBUCA (SP)";"SP";"MOMBUCA";101;7;18;126
2014;"MONCOES (SP)";"SP";"MONCOES";78;12;14;104
2014;"MONGAGUA (SP)";"SP";"MONGAGUA";573;108;79;760
2014;"MONTE ALEGRE DO SUL (SP)";"SP";"MONTE ALEGRE DO SUL";223;42;40;305
2014;"MONTE ALTO (SP)";"SP";"MONTE ALTO";1471;94;121;1686
2014;"MONTE APRAZIVEL (SP)";"SP";"MONTE APRAZIVEL";609;50;223;882
2014;"MONTE AZUL PAULISTA (SP)";"SP";"MONTE AZUL PAULISTA";494;38;163;695
2014;"MONTE CASTELO (SP)";"SP";"MONTE CASTELO";81;6;13;100
2014;"MONTE MOR (SP)";"SP";"MONTE MOR";736;99;131;966
2014;"MONTEIRO LOBATO (SP)";"SP";"MONTEIRO LOBATO";196;50;18;264
2014;"MORRO AGUDO (SP)";"SP";"MORRO AGUDO";681;48;171;900
2014;"MORUNGABA (SP)";"SP";"MORUNGABA";387;62;32;481
2014;"MOTUCA (SP)";"SP";"MOTUCA";140;10;31;181
2014;"MUNICIPIO NAO INFORMADO (SP)";"SP";"MUNICIPIO NAO INFORMADO";0;0;0;0
2014;"MURUTINGA DO SUL (SP)";"SP";"MURUTINGA DO SUL";90;9;19;118
2014;"NANTES (SP)";"SP";"NANTES";21;14;17;52
2014;"NARANDIBA (SP)";"SP";"NARANDIBA";85;8;19;112
2014;"NATIVIDADE DA SERRA (SP)";"SP";"NATIVIDADE DA SERRA";93;46;8;147
2014;"NAZARE PAULISTA (SP)";"SP";"NAZARE PAULISTA";706;24;30;760
2014;"NEVES PAULISTA (SP)";"SP";"NEVES PAULISTA";182;11;32;225
2014;"NHANDEARA (SP)";"SP";"NHANDEARA";201;23;42;266
2014;"NIPOA (SP)";"SP";"NIPOA";148;11;32;191
2014;"NOVA ALIANCA (SP)";"SP";"NOVA ALIANCA";146;15;18;179
2014;"NOVA CAMPINA (SP)";"SP";"NOVA CAMPINA";78;18;22;118
2014;"NOVA CANAA PAULISTA (SP)";"SP";"NOVA CANAA PAULISTA";37;5;6;48
2014;"NOVA CASTILHO (SP)";"SP";"NOVA CASTILHO";17;4;4;25
2014;"NOVA EUROPA (SP)";"SP";"NOVA EUROPA";176;12;144;332
2014;"NOVA GRANADA (SP)";"SP";"NOVA GRANADA";356;56;106;518
2014;"NOVA GUATAPORANGA (SP)";"SP";"NOVA GUATAPORANGA";41;5;14;60
2014;"NOVA INDEPENDENCIA (SP)";"SP";"NOVA INDEPENDENCIA";55;11;15;81
2014;"NOVA LUZITANIA (SP)";"SP";"NOVA LUZITANIA";41;2;25;68
2014;"NOVA ODESSA (SP)";"SP";"NOVA ODESSA";919;138;128;1185
2014;"NOVAIS (SP)";"SP";"NOVAIS";98;7;29;134
2014;"NOVO HORIZONTE (SP)";"SP";"NOVO HORIZONTE";1164;41;284;1489
2014;"NUPORANGA (SP)";"SP";"NUPORANGA";225;21;53;299
2014;"OCAUCU (SP)";"SP";"OCAUCU";116;10;19;145
2014;"OLEO (SP)";"SP";"OLEO";38;12;8;58
2014;"OLIMPIA (SP)";"SP";"OLIMPIA";980;121;241;1342
2014;"ONDA VERDE (SP)";"SP";"ONDA VERDE";98;9;23;130
2014;"ORIENTE (SP)";"SP";"ORIENTE";95;13;18;126
2014;"ORINDIUVA (SP)";"SP";"ORINDIUVA";218;9;81;308
2014;"ORLANDIA (SP)";"SP";"ORLANDIA";943;59;286;1288
2014;"OSASCO (SP)";"SP";"OSASCO";10647;2144;2689;15480
2014;"OSCAR BRESSANE (SP)";"SP";"OSCAR BRESSANE";60;7;5;72
2014;"OSVALDO CRUZ (SP)";"SP";"OSVALDO CRUZ";570;34;110;714
2014;"OURINHOS (SP)";"SP";"OURINHOS";2216;163;630;3009
2014;"OURO VERDE (SP)";"SP";"OURO VERDE";134;5;64;203
2014;"OUROESTE (SP)";"SP";"OUROESTE";189;13;38;240
2014;"PACAEMBU (SP)";"SP";"PACAEMBU";205;24;42;271
2014;"PALESTINA (SP)";"SP";"PALESTINA";179;24;50;253
2014;"PALMARES PAULISTA (SP)";"SP";"PALMARES PAULISTA";77;17;110;204
2014;"PALMEIRA D OESTE (SP)";"SP";"PALMEIRA D OESTE";249;7;36;292
2014;"PALMITAL (SP)";"SP";"PALMITAL";658;45;57;760
2014;"PANORAMA (SP)";"SP";"PANORAMA";329;11;20;360
2014;"PARAGUACU PAULISTA (SP)";"SP";"PARAGUACU PAULISTA";874;168;113;1155
2014;"PARAIBUNA (SP)";"SP";"PARAIBUNA";257;77;70;404
2014;"PARAISO (SP)";"SP";"PARAISO";202;18;106;326
2014;"PARANAPANEMA (SP)";"SP";"PARANAPANEMA";592;44;73;709
2014;"PARANAPUA (SP)";"SP";"PARANAPUA";97;11;15;123
2014;"PARAPUA (SP)";"SP";"PARAPUA";312;10;53;375
2014;"PARDINHO (SP)";"SP";"PARDINHO";155;25;33;213
2014;"PARIQUERA ACU (SP)";"SP";"PARIQUERA ACU";439;31;20;490
2014;"PARISI (SP)";"SP";"PARISI";32;9;9;50
2014;"PATROCINIO PAULISTA (SP)";"SP";"PATROCINIO PAULISTA";329;18;63;410
2014;"PAULICEIA (SP)";"SP";"PAULICEIA";317;10;30;357
2014;"PAULINIA (SP)";"SP";"PAULINIA";2084;227;409;2720
2014;"PAULISTANIA (SP)";"SP";"PAULISTANIA";27;15;8;50
2014;"PAULO DE FARIA (SP)";"SP";"PAULO DE FARIA";107;12;45;164
2014;"PEDERNEIRAS (SP)";"SP";"PEDERNEIRAS";1105;107;220;1432
2014;"PEDRA BELA (SP)";"SP";"PEDRA BELA";229;10;18;257
2014;"PEDRANOPOLIS (SP)";"SP";"PEDRANOPOLIS";55;3;14;72
2014;"PEDREGULHO (SP)";"SP";"PEDREGULHO";293;36;124;453
2014;"PEDREIRA (SP)";"SP";"PEDREIRA";801;131;81;1013
2014;"PEDRINHAS PAULISTA (SP)";"SP";"PEDRINHAS PAULISTA";159;9;12;180
2014;"PEDRO DE TOLEDO (SP)";"SP";"PEDRO DE TOLEDO";165;38;17;220
2014;"PENAPOLIS (SP)";"SP";"PENAPOLIS";1389;86;288;1763
2014;"PEREIRA BARRETO (SP)";"SP";"PEREIRA BARRETO";377;54;95;526
2014;"PEREIRAS (SP)";"SP";"PEREIRAS";258;15;28;301
2014;"PERUIBE (SP)";"SP";"PERUIBE";669;216;98;983
2014;"PIACATU (SP)";"SP";"PIACATU";95;3;17;115
2014;"PIEDADE (SP)";"SP";"PIEDADE";1458;153;106;1717
2014;"PILAR DO SUL (SP)";"SP";"PILAR DO SUL";1127;77;96;1300
2014;"PINDAMONHANGABA (SP)";"SP";"PINDAMONHANGABA";2044;452;201;2697
2014;"PINDORAMA (SP)";"SP";"PINDORAMA";312;29;55;396
2014;"PINHALZINHO (SP)";"SP";"PINHALZINHO";429;56;15;500
2014;"PIQUEROBI (SP)";"SP";"PIQUEROBI";42;4;11;57
2014;"PIQUETE (SP)";"SP";"PIQUETE";175;80;18;273
2014;"PIRACAIA (SP)";"SP";"PIRACAIA";544;89;41;674
2014;"PIRACICABA (SP)";"SP";"PIRACICABA";7920;951;1484;10355
2014;"PIRAJU (SP)";"SP";"PIRAJU";482;77;79;638
2014;"PIRAJUI (SP)";"SP";"PIRAJUI";322;26;92;440
2014;"PIRANGI (SP)";"SP";"PIRANGI";389;20;72;481
2014;"PIRAPORA DO BOM JESUS (SP)";"SP";"PIRAPORA DO BOM JESUS";250;45;91;386
2014;"PIRAPOZINHO (SP)";"SP";"PIRAPOZINHO";469;46;96;611
2014;"PIRASSUNUNGA (SP)";"SP";"PIRASSUNUNGA";1122;152;248;1522
2014;"PIRATININGA (SP)";"SP";"PIRATININGA";260;27;46;333
2014;"PITANGUEIRAS (SP)";"SP";"PITANGUEIRAS";949;54;282;1285
2014;"PLANALTO (SP)";"SP";"PLANALTO";117;13;55;185
2014;"PLATINA (SP)";"SP";"PLATINA";61;16;13;90
2014;"POA (SP)";"SP";"POA";1140;218;194;1552
2014;"POLONI (SP)";"SP";"POLONI";183;8;52;243
2014;"POMPEIA (SP)";"SP";"POMPEIA";291;19;54;364
2014;"PONGAI (SP)";"SP";"PONGAI";69;6;19;94
2014;"PONTAL (SP)";"SP";"PONTAL";1043;37;528;1608
2014;"PONTALINDA (SP)";"SP";"PONTALINDA";34;11;28;73
2014;"PONTES GESTAL (SP)";"SP";"PONTES GESTAL";118;5;30;153
2014;"POPULINA (SP)";"SP";"POPULINA";49;8;14;71
2014;"PORANGABA (SP)";"SP";"PORANGABA";159;16;14;189
2014;"PORTO FELIZ (SP)";"SP";"PORTO FELIZ";1397;103;203;1703
2014;"PORTO FERREIRA (SP)";"SP";"PORTO FERREIRA";1206;112;152;1470
2014;"POTIM (SP)";"SP";"POTIM";94;50;28;172
2014;"POTIRENDABA (SP)";"SP";"POTIRENDABA";541;19;75;635
2014;"PRACINHA (SP)";"SP";"PRACINHA";13;2;13;28
2014;"PRADOPOLIS (SP)";"SP";"PRADOPOLIS";397;24;234;655
2014;"PRAIA GRANDE (SP)";"SP";"PRAIA GRANDE";2593;387;266;3246
2014;"PRATANIA (SP)";"SP";"PRATANIA";110;16;49;175
2014;"PRESIDENTE ALVES (SP)";"SP";"PRESIDENTE ALVES";67;4;46;117
2014;"PRESIDENTE BERNARDES (SP)";"SP";"PRESIDENTE BERNARDES";252;34;54;340
2014;"PRESIDENTE EPITACIO (SP)";"SP";"PRESIDENTE EPITACIO";536;79;163;778
2014;"PRESIDENTE PRUDENTE (SP)";"SP";"PRESIDENTE PRUDENTE";4019;386;938;5343
2014;"PRESIDENTE VENCESLAU (SP)";"SP";"PRESIDENTE VENCESLAU";714;62;70;846
2014;"PROMISSAO (SP)";"SP";"PROMISSAO";701;117;171;989
2014;"QUADRA (SP)";"SP";"QUADRA";71;10;17;98
2014;"QUATA (SP)";"SP";"QUATA";250;22;71;343
2014;"QUEIROZ (SP)";"SP";"QUEIROZ";27;8;9;44
2014;"QUELUZ (SP)";"SP";"QUELUZ";121;37;8;166
2014;"QUINTANA (SP)";"SP";"QUINTANA";153;11;26;190
2014;"RAFARD (SP)";"SP";"RAFARD";281;23;26;330
2014;"RANCHARIA (SP)";"SP";"RANCHARIA";623;77;98;798
2014;"REDENCAO DA SERRA (SP)";"SP";"REDENCAO DA SERRA";101;23;35;159
2014;"REGENTE FEIJO (SP)";"SP";"REGENTE FEIJO";417;45;37;499
2014;"REGINOPOLIS (SP)";"SP";"REGINOPOLIS";81;7;22;110
2014;"REGISTRO (SP)";"SP";"REGISTRO";1311;116;318;1745
2014;"RESTINGA (SP)";"SP";"RESTINGA";74;11;26;111
2014;"RIBEIRA (SP)";"SP";"RIBEIRA";25;8;14;47
2014;"RIBEIRAO BONITO (SP)";"SP";"RIBEIRAO BONITO";299;46;94;439
2014;"RIBEIRAO BRANCO (SP)";"SP";"RIBEIRAO BRANCO";201;35;52;288
2014;"RIBEIRAO CORRENTE (SP)";"SP";"RIBEIRAO CORRENTE";82;9;38;129
2014;"RIBEIRAO DO SUL (SP)";"SP";"RIBEIRAO DO SUL";148;13;16;177
2014;"RIBEIRAO DOS INDIOS (SP)";"SP";"RIBEIRAO DOS INDIOS";28;2;8;38
2014;"RIBEIRAO GRANDE (SP)";"SP";"RIBEIRAO GRANDE";72;34;17;123
2014;"RIBEIRAO PIRES (SP)";"SP";"RIBEIRAO PIRES";3415;540;442;4397
2014;"RIBEIRAO PRETO (SP)";"SP";"RIBEIRAO PRETO";11030;1070;1810;13910
2014;"RIFAINA (SP)";"SP";"RIFAINA";39;12;10;61
2014;"RINCAO (SP)";"SP";"RINCAO";281;20;49;350
2014;"RINOPOLIS (SP)";"SP";"RINOPOLIS";198;9;48;255
2014;"RIO CLARO (SP)";"SP";"RIO CLARO";3388;388;438;4214
2014;"RIO DAS PEDRAS (SP)";"SP";"RIO DAS PEDRAS";708;97;166;971
2014;"RIO GRANDE DA SERRA (SP)";"SP";"RIO GRANDE DA SERRA";610;221;106;937
2014;"RIOLANDIA (SP)";"SP";"RIOLANDIA";94;14;50;158
2014;"RIVERSUL (SP)";"SP";"RIVERSUL";79;25;30;134
2014;"ROSANA (SP)";"SP";"ROSANA";166;30;66;262
2014;"ROSEIRA (SP)";"SP";"ROSEIRA";136;82;24;242
2014;"RUBIACEA (SP)";"SP";"RUBIACEA";30;3;11;44
2014;"RUBINEIA (SP)";"SP";"RUBINEIA";24;10;12;46
2014;"SABINO (SP)";"SP";"SABINO";65;7;16;88
2014;"SAGRES (SP)";"SP";"SAGRES";23;1;6;30
2014;"SALES (SP)";"SP";"SALES";94;1;34;129
2014;"SALES OLIVEIRA (SP)";"SP";"SALES OLIVEIRA";274;15;57;346
2014;"SALESOPOLIS (SP)";"SP";"SALESOPOLIS";897;91;107;1095
2014;"SALMOURAO (SP)";"SP";"SALMOURAO";38;4;33;75
2014;"SALTINHO (SP)";"SP";"SALTINHO";376;12;11;399
2014;"SALTO (SP)";"SP";"SALTO";2393;277;179;2849
2014;"SALTO DE PIRAPORA (SP)";"SP";"SALTO DE PIRAPORA";718;70;60;848
2014;"SALTO GRANDE (SP)";"SP";"SALTO GRANDE";156;15;31;202
2014;"SANDOVALINA (SP)";"SP";"SANDOVALINA";58;6;18;82
2014;"SANTA ADELIA (SP)";"SP";"SANTA ADELIA";623;32;92;747
2014;"SANTA ALBERTINA (SP)";"SP";"SANTA ALBERTINA";132;7;29;168
2014;"SANTA BARBARA D OESTE (SP)";"SP";"SANTA BARBARA D OESTE";2477;451;343;3271
2014;"SANTA BRANCA (SP)";"SP";"SANTA BRANCA";144;43;35;222
2014;"SANTA CLARA D OESTE (SP)";"SP";"SANTA CLARA D OESTE";30;6;6;42
2014;"SANTA CRUZ DA CONCEICAO (SP)";"SP";"SANTA CRUZ DA CONCEICAO";151;20;16;187
2014;"SANTA CRUZ DA ESPERANCA (SP)";"SP";"SANTA CRUZ DA ESPERANCA";37;2;3;42
2014;"SANTA CRUZ DAS PALMEIRAS (SP)";"SP";"SANTA CRUZ DAS PALMEIRAS";600;58;203;861
2014;"SANTA CRUZ DO RIO PARDO (SP)";"SP";"SANTA CRUZ DO RIO PARDO";1450;109;102;1661
2014;"SANTA ERNESTINA (SP)";"SP";"SANTA ERNESTINA";78;22;77;177
2014;"SANTA FE DO SUL (SP)";"SP";"SANTA FE DO SUL";662;35;41;738
2014;"SANTA GERTRUDES (SP)";"SP";"SANTA GERTRUDES";622;52;32;706
2014;"SANTA ISABEL (SP)";"SP";"SANTA ISABEL";1299;107;123;1529
2014;"SANTA LUCIA (SP)";"SP";"SANTA LUCIA";128;26;44;198
2014;"SANTA MARIA DA SERRA (SP)";"SP";"SANTA MARIA DA SERRA";308;33;27;368
2014;"SANTA MERCEDES (SP)";"SP";"SANTA MERCEDES";67;10;10;87
2014;"SANTA RITA D OESTE (SP)";"SP";"SANTA RITA D OESTE";33;2;7;42
2014;"SANTA RITA DO PASSA QUATRO (SP)";"SP";"SANTA RITA DO PASSA QUATRO";584;71;54;709
2014;"SANTA ROSA DE VITERBO (SP)";"SP";"SANTA ROSA DE VITERBO";450;43;106;599
2014;"SANTA SALETE (SP)";"SP";"SANTA SALETE";42;6;7;55
2014;"SANTANA DA PONTE PENSA (SP)";"SP";"SANTANA DA PONTE PENSA";28;5;5;38
2014;"SANTANA DE PARNAIBA (SP)";"SP";"SANTANA DE PARNAIBA";1969;532;198;2699
2014;"SANTO ANASTACIO (SP)";"SP";"SANTO ANASTACIO";496;39;64;599
2014;"SANTO ANDRE (SP)";"SP";"SANTO ANDRE";9755;1837;1693;13285
2014;"SANTO ANTONIO DA ALEGRIA (SP)";"SP";"SANTO ANTONIO DA ALEGRIA";116;12;29;157
2014;"SANTO ANTONIO DE POSSE (SP)";"SP";"SANTO ANTONIO DE POSSE";869;67;155;1091
2014;"SANTO ANTONIO DO ARACANGUA (SP)";"SP";"SANTO ANTONIO DO ARACANGUA";209;32;88;329
2014;"SANTO ANTONIO DO JARDIM (SP)";"SP";"SANTO ANTONIO DO JARDIM";216;15;14;245
2014;"SANTO ANTONIO DO PINHAL (SP)";"SP";"SANTO ANTONIO DO PINHAL";173;26;12;211
2014;"SANTO EXPEDITO (SP)";"SP";"SANTO EXPEDITO";28;3;13;44
2014;"SANTOPOLIS DO AGUAPEI (SP)";"SP";"SANTOPOLIS DO AGUAPEI";66;2;31;99
2014;"SANTOS (SP)";"SP";"SANTOS";5834;969;696;7499
2014;"SAO BENTO DO SAPUCAI (SP)";"SP";"SAO BENTO DO SAPUCAI";154;47;15;216
2014;"SAO BERNARDO DO CAMPO (SP)";"SP";"SAO BERNARDO DO CAMPO";13084;2610;4238;19932
2014;"SAO CAETANO DO SUL (SP)";"SP";"SAO CAETANO DO SUL";2893;547;646;4086
2014;"SAO CARLOS (SP)";"SP";"SAO CARLOS";3928;442;428;4798
2014;"SAO FRANCISCO (SP)";"SP";"SAO FRANCISCO";47;6;29;82
2014;"SAO JOAO DA BOA VISTA (SP)";"SP";"SAO JOAO DA BOA VISTA";2010;271;101;2382
2014;"SAO JOAO DAS DUAS PONTES (SP)";"SP";"SAO JOAO DAS DUAS PONTES";18;8;5;31
2014;"SAO JOAO DE IRACEMA (SP)";"SP";"SAO JOAO DE IRACEMA";43;5;10;58
2014;"SAO JOAO DO PAU D ALHO (SP)";"SP";"SAO JOAO DO PAU D ALHO";38;4;6;48
2014;"SAO JOAQUIM DA BARRA (SP)";"SP";"SAO JOAQUIM DA BARRA";849;83;206;1138
2014;"SAO JOSE DA BELA VISTA (SP)";"SP";"SAO JOSE DA BELA VISTA";74;17;50;141
2014;"SAO JOSE DO BARREIRO (SP)";"SP";"SAO JOSE DO BARREIRO";43;17;6;66
2014;"SAO JOSE DO RIO PARDO (SP)";"SP";"SAO JOSE DO RIO PARDO";1252;88;153;1493
2014;"SAO JOSE DO RIO PRETO (SP)";"SP";"SAO JOSE DO RIO PRETO";8605;636;1718;10959
2014;"SAO JOSE DOS CAMPOS (SP)";"SP";"SAO JOSE DOS CAMPOS";7254;1902;1695;10851
2014;"SAO LOURENCO DA SERRA (SP)";"SP";"SAO LOURENCO DA SERRA";358;31;31;420
2014;"SAO LUIZ DO PARAITINGA (SP)";"SP";"SAO LUIZ DO PARAITINGA";177;32;30;239
2014;"SAO MANUEL (SP)";"SP";"SAO MANUEL";797;135;234;1166
2014;"SAO MIGUEL ARCANJO (SP)";"SP";"SAO MIGUEL ARCANJO";718;105;79;902
2014;"SAO PAULO (SP)";"SP";"SAO PAULO";119902;35870;42917;198689
2014;"SAO PEDRO (SP)";"SP";"SAO PEDRO";622;111;85;818
2014;"SAO PEDRO DO TURVO (SP)";"SP";"SAO PEDRO DO TURVO";176;19;45;240
2014;"SAO ROQUE (SP)";"SP";"SAO ROQUE";1224;251;217;1692
2014;"SAO SEBASTIAO (SP)";"SP";"SAO SEBASTIAO";796;140;172;1108
2014;"SAO SEBASTIAO DA GRAMA (SP)";"SP";"SAO SEBASTIAO DA GRAMA";250;32;32;314
2014;"SAO SIMAO (SP)";"SP";"SAO SIMAO";372;26;46;444
2014;"SAO VICENTE (SP)";"SP";"SAO VICENTE";1983;644;951;3578
2014;"SARAPUI (SP)";"SP";"SARAPUI";176;30;19;225
2014;"SARUTAIA (SP)";"SP";"SARUTAIA";56;8;28;92
2014;"SEBASTIANOPOLIS DO SUL (SP)";"SP";"SEBASTIANOPOLIS DO SUL";267;4;16;287
2014;"SERRA AZUL (SP)";"SP";"SERRA AZUL";167;15;109;291
2014;"SERRA NEGRA (SP)";"SP";"SERRA NEGRA";441;67;24;532
2014;"SERRANA (SP)";"SP";"SERRANA";622;113;235;970
2014;"SERTAOZINHO (SP)";"SP";"SERTAOZINHO";2739;173;606;3518
2014;"SETE BARRAS (SP)";"SP";"SETE BARRAS";230;17;35;282
2014;"SEVERINIA (SP)";"SP";"SEVERINIA";321;17;230;568
2014;"SILVEIRAS (SP)";"SP";"SILVEIRAS";91;26;7;124
2014;"SOCORRO (SP)";"SP";"SOCORRO";929;153;51;1133
2014;"SOROCABA (SP)";"SP";"SOROCABA";8122;1472;1678;11272
2014;"SUD MENNUCCI (SP)";"SP";"SUD MENNUCCI";147;16;53;216
2014;"SUMARE (SP)";"SP";"SUMARE";2713;660;632;4005
2014;"SUZANAPOLIS (SP)";"SP";"SUZANAPOLIS";89;9;18;116
2014;"SUZANO (SP)";"SP";"SUZANO";3278;863;819;4960
2014;"TABAPUA (SP)";"SP";"TABAPUA";177;14;56;247
2014;"TABATINGA (SP)";"SP";"TABATINGA";338;23;165;526
2014;"TABOAO DA SERRA (SP)";"SP";"TABOAO DA SERRA";2895;1016;626;4537
2014;"TACIBA (SP)";"SP";"TACIBA";88;14;23;125
2014;"TAGUAI (SP)";"SP";"TAGUAI";187;14;33;234
2014;"TAIACU (SP)";"SP";"TAIACU";157;7;23;187
2014;"TAIUVA (SP)";"SP";"TAIUVA";172;12;27;211
2014;"TAMBAU (SP)";"SP";"TAMBAU";573;53;68;694
2014;"TANABI (SP)";"SP";"TANABI";519;55;114;688
2014;"TAPIRAI (SP)";"SP";"TAPIRAI";202;17;11;230
2014;"TAPIRATIBA (SP)";"SP";"TAPIRATIBA";388;23;77;488
2014;"TAQUARAL (SP)";"SP";"TAQUARAL";69;7;20;96
2014;"TAQUARITINGA (SP)";"SP";"TAQUARITINGA";1548;111;343;2002
2014;"TAQUARITUBA (SP)";"SP";"TAQUARITUBA";707;67;97;871
2014;"TAQUARIVAI (SP)";"SP";"TAQUARIVAI";68;13;14;95
2014;"TARABAI (SP)";"SP";"TARABAI";117;6;25;148
2014;"TARUMA (SP)";"SP";"TARUMA";357;34;170;561
2014;"TATUI (SP)";"SP";"TATUI";2278;203;806;3287
2014;"TAUBATE (SP)";"SP";"TAUBATE";3291;873;800;4964
2014;"TEJUPA (SP)";"SP";"TEJUPA";61;23;8;92
2014;"TEODORO SAMPAIO (SP)";"SP";"TEODORO SAMPAIO";298;44;339;681
2014;"TERRA ROXA (SP)";"SP";"TERRA ROXA";168;17;70;255
2014;"TIETE (SP)";"SP";"TIETE";1287;66;202;1555
2014;"TIMBURI (SP)";"SP";"TIMBURI";28;8;5;41
2014;"TORRE DE PEDRA (SP)";"SP";"TORRE DE PEDRA";47;7;9;63
2014;"TORRINHA (SP)";"SP";"TORRINHA";433;21;51;505
2014;"TRABIJU (SP)";"SP";"TRABIJU";48;12;9;69
2014;"TREMEMBE (SP)";"SP";"TREMEMBE";460;71;16;547
2014;"TRES FRONTEIRAS (SP)";"SP";"TRES FRONTEIRAS";65;13;13;91
2014;"TUIUTI (SP)";"SP";"TUIUTI";118;28;13;159
2014;"TUPA (SP)";"SP";"TUPA";1528;69;259;1856
2014;"TUPI PAULISTA (SP)";"SP";"TUPI PAULISTA";327;24;31;382
2014;"TURIUBA (SP)";"SP";"TURIUBA";25;4;14;43
2014;"TURMALINA (SP)";"SP";"TURMALINA";29;3;13;45
2014;"UBARANA (SP)";"SP";"UBARANA";130;3;38;171
2014;"UBATUBA (SP)";"SP";"UBATUBA";721;119;76;916
2014;"UBIRAJARA (SP)";"SP";"UBIRAJARA";101;9;33;143
2014;"UCHOA (SP)";"SP";"UCHOA";161;14;46;221
2014;"UNIAO PAULISTA (SP)";"SP";"UNIAO PAULISTA";59;7;11;77
2014;"URANIA (SP)";"SP";"URANIA";153;17;37;207
2014;"URU (SP)";"SP";"URU";12;10;10;32
2014;"URUPES (SP)";"SP";"URUPES";379;21;49;449
2014;"VALENTIM GENTIL (SP)";"SP";"VALENTIM GENTIL";308;22;32;362
2014;"VALINHOS (SP)";"SP";"VALINHOS";2179;527;2035;4741
2014;"VALPARAISO (SP)";"SP";"VALPARAISO";466;33;163;662
2014;"VARGEM (SP)";"SP";"VARGEM";314;26;23;363
2014;"VARGEM GRANDE DO SUL (SP)";"SP";"VARGEM GRANDE DO SUL";1209;103;226;1538
2014;"VARGEM GRANDE PAULISTA (SP)";"SP";"VARGEM GRANDE PAULISTA";1034;117;82;1233
2014;"VARZEA PAULISTA (SP)";"SP";"VARZEA PAULISTA";1228;401;321;1950
2014;"VERA CRUZ (SP)";"SP";"VERA CRUZ";157;22;33;212
2014;"VINHEDO (SP)";"SP";"VINHEDO";1610;170;161;1941
2014;"VIRADOURO (SP)";"SP";"VIRADOURO";364;26;82;472
2014;"VISTA ALEGRE DO ALTO (SP)";"SP";"VISTA ALEGRE DO ALTO";416;37;128;581
2014;"VITORIA BRASIL (SP)";"SP";"VITORIA BRASIL";30;3;8;41
2014;"VOTORANTIM (SP)";"SP";"VOTORANTIM";1311;307;286;1904
2014;"VOTUPORANGA (SP)";"SP";"VOTUPORANGA";2132;144;248;2524
2014;"ZACARIAS (SP)";"SP";"ZACARIAS";55;7;19;81
2014;"ABREULANDIA (TO)";"TO";"ABREULANDIA";19;1;2;22
2014;"AGUIARNOPOLIS (TO)";"TO";"AGUIARNOPOLIS";58;2;14;74
2014;"ALIANCA DO TOCANTINS (TO)";"TO";"ALIANCA DO TOCANTINS";73;8;12;93
2014;"ALMAS (TO)";"TO";"ALMAS";70;0;9;79
2014;"ALVORADA (TO)";"TO";"ALVORADA";196;1;14;211
2014;"ANANAS (TO)";"TO";"ANANAS";76;1;27;104
2014;"ANGICO (TO)";"TO";"ANGICO";17;5;7;29
2014;"APARECIDA DO RIO NEGRO (TO)";"TO";"APARECIDA DO RIO NEGRO";60;13;5;78
2014;"ARAGOMINAS (TO)";"TO";"ARAGOMINAS";60;2;14;76
2014;"ARAGUACEMA (TO)";"TO";"ARAGUACEMA";28;3;10;41
2014;"ARAGUACU (TO)";"TO";"ARAGUACU";101;11;12;124
2014;"ARAGUAINA (TO)";"TO";"ARAGUAINA";3760;166;659;4585
2014;"ARAGUANA (TO)";"TO";"ARAGUANA";106;4;28;138
2014;"ARAGUATINS (TO)";"TO";"ARAGUATINS";331;47;71;449
2014;"ARAPOEMA (TO)";"TO";"ARAPOEMA";49;5;13;67
2014;"ARRAIAS (TO)";"TO";"ARRAIAS";50;2;7;59
2014;"AUGUSTINOPOLIS (TO)";"TO";"AUGUSTINOPOLIS";190;32;32;254
2014;"AURORA DO TOCANTINS (TO)";"TO";"AURORA DO TOCANTINS";10;0;5;15
2014;"AXIXA DO TOCANTINS (TO)";"TO";"AXIXA DO TOCANTINS";48;22;8;78
2014;"BABACULANDIA (TO)";"TO";"BABACULANDIA";293;13;24;330
2014;"BANDEIRANTES DO TOCANTINS (TO)";"TO";"BANDEIRANTES DO TOCANTINS";27;3;4;34
2014;"BARRA DO OURO (TO)";"TO";"BARRA DO OURO";16;1;3;20
2014;"BARROLANDIA (TO)";"TO";"BARROLANDIA";54;3;7;64
2014;"BERNARDO SAYAO (TO)";"TO";"BERNARDO SAYAO";30;1;7;38
2014;"BOM JESUS DO TOCANTINS (TO)";"TO";"BOM JESUS DO TOCANTINS";9;1;3;13
2014;"BRASILANDIA DO TOCANTINS (TO)";"TO";"BRASILANDIA DO TOCANTINS";19;2;2;23
2014;"BREJINHO DE NAZARE (TO)";"TO";"BREJINHO DE NAZARE";52;1;19;72
2014;"BURITI DO TOCANTINS (TO)";"TO";"BURITI DO TOCANTINS";47;13;4;64
2014;"CACHOEIRINHA (TO)";"TO";"CACHOEIRINHA";8;0;2;10
2014;"CAMPOS LINDOS (TO)";"TO";"CAMPOS LINDOS";67;0;7;74
2014;"CARIRI DO TOCANTINS (TO)";"TO";"CARIRI DO TOCANTINS";38;5;10;53
2014;"CARMOLANDIA (TO)";"TO";"CARMOLANDIA";256;17;113;386
2014;"CARRASCO BONITO (TO)";"TO";"CARRASCO BONITO";5;5;2;12
2014;"CASEARA (TO)";"TO";"CASEARA";29;2;5;36
2014;"CENTENARIO (TO)";"TO";"CENTENARIO";3;0;3;6
2014;"CHAPADA DA NATIVIDADE (TO)";"TO";"CHAPADA DA NATIVIDADE";16;1;9;26
2014;"CHAPADA DE AREIA (TO)";"TO";"CHAPADA DE AREIA";4;1;1;6
2014;"COLINAS DO TOCANTINS (TO)";"TO";"COLINAS DO TOCANTINS";556;13;69;638
2014;"COLMEIA (TO)";"TO";"COLMEIA";125;8;18;151
2014;"COMBINADO (TO)";"TO";"COMBINADO";18;1;11;30
2014;"CONCEICAO DO TOCANTINS (TO)";"TO";"CONCEICAO DO TOCANTINS";18;1;4;23
2014;"COUTO DE MAGALHAES (TO)";"TO";"COUTO DE MAGALHAES";24;6;11;41
2014;"CRISTALANDIA (TO)";"TO";"CRISTALANDIA";105;1;7;113
2014;"CRIXAS DO TOCANTINS (TO)";"TO";"CRIXAS DO TOCANTINS";13;1;3;17
2014;"DARCINOPOLIS (TO)";"TO";"DARCINOPOLIS";90;8;10;108
2014;"DIANOPOLIS (TO)";"TO";"DIANOPOLIS";195;20;51;266
2014;"DIVINOPOLIS DO TOCANTINS (TO)";"TO";"DIVINOPOLIS DO TOCANTINS";80;3;7;90
2014;"DOIS IRMAOS DO TOCANTINS (TO)";"TO";"DOIS IRMAOS DO TOCANTINS";37;6;10;53
2014;"DUERE (TO)";"TO";"DUERE";46;3;4;53
2014;"ESPERANTINA (TO)";"TO";"ESPERANTINA";22;14;8;44
2014;"FATIMA (TO)";"TO";"FATIMA";53;2;7;62
2014;"FIGUEIROPOLIS (TO)";"TO";"FIGUEIROPOLIS";73;4;9;86
2014;"FILADELFIA (TO)";"TO";"FILADELFIA";51;9;9;69
2014;"FORMOSO DO ARAGUAIA (TO)";"TO";"FORMOSO DO ARAGUAIA";243;10;33;286
2014;"FORTALEZA DO TABOCAO (TO)";"TO";"FORTALEZA DO TABOCAO";30;4;4;38
2014;"GOIANORTE (TO)";"TO";"GOIANORTE";47;2;12;61
2014;"GOIATINS (TO)";"TO";"GOIATINS";58;6;9;73
2014;"GUARAI (TO)";"TO";"GUARAI";410;18;38;466
2014;"GURUPI (TO)";"TO";"GURUPI";1654;46;230;1930
2014;"IPUEIRAS (TO)";"TO";"IPUEIRAS";6;0;2;8
2014;"ITACAJA (TO)";"TO";"ITACAJA";46;2;4;52
2014;"ITAGUATINS (TO)";"TO";"ITAGUATINS";39;4;16;59
2014;"ITAPIRATINS (TO)";"TO";"ITAPIRATINS";26;2;8;36
2014;"ITAPORA DO TOCANTINS (TO)";"TO";"ITAPORA DO TOCANTINS";17;3;6;26
2014;"JAU DO TOCANTINS (TO)";"TO";"JAU DO TOCANTINS";17;1;8;26
2014;"JUARINA (TO)";"TO";"JUARINA";10;3;6;19
2014;"LAGOA DA CONFUSAO (TO)";"TO";"LAGOA DA CONFUSAO";157;3;14;174
2014;"LAGOA DO TOCANTINS (TO)";"TO";"LAGOA DO TOCANTINS";9;0;8;17
2014;"LAJEADO (TO)";"TO";"LAJEADO";28;2;9;39
2014;"LAVANDEIRA (TO)";"TO";"LAVANDEIRA";3;0;1;4
2014;"LIZARDA (TO)";"TO";"LIZARDA";15;2;1;18
2014;"LUZINOPOLIS (TO)";"TO";"LUZINOPOLIS";16;2;0;18
2014;"MARIANOPOLIS DO TOCANTINS (TO)";"TO";"MARIANOPOLIS DO TOCANTINS";38;1;7;46
2014;"MATEIROS (TO)";"TO";"MATEIROS";24;0;4;28
2014;"MAURILANDIA DO TOCANTINS (TO)";"TO";"MAURILANDIA DO TOCANTINS";11;7;4;22
2014;"MIRACEMA DO TOCANTINS (TO)";"TO";"MIRACEMA DO TOCANTINS";188;17;34;239
2014;"MIRANORTE (TO)";"TO";"MIRANORTE";237;12;21;270
2014;"MONTE DO CARMO (TO)";"TO";"MONTE DO CARMO";25;4;5;34
2014;"MONTE SANTO DO TOCANTINS (TO)";"TO";"MONTE SANTO DO TOCANTINS";19;3;3;25
2014;"MURICILANDIA (TO)";"TO";"MURICILANDIA";12;1;6;19
2014;"NATIVIDADE (TO)";"TO";"NATIVIDADE";90;4;7;101
2014;"NAZARE (TO)";"TO";"NAZARE";21;3;6;30
2014;"NOVA OLINDA (TO)";"TO";"NOVA OLINDA";105;4;29;138
2014;"NOVA ROSALANDIA (TO)";"TO";"NOVA ROSALANDIA";22;2;2;26
2014;"NOVO ACORDO (TO)";"TO";"NOVO ACORDO";24;1;6;31
2014;"NOVO ALEGRE (TO)";"TO";"NOVO ALEGRE";11;2;5;18
2014;"NOVO JARDIM (TO)";"TO";"NOVO JARDIM";18;0;4;22
2014;"OLIVEIRA DE FATIMA (TO)";"TO";"OLIVEIRA DE FATIMA";11;2;4;17
2014;"PALMAS (TO)";"TO";"PALMAS";4819;310;1764;6893
2014;"PALMEIRANTE (TO)";"TO";"PALMEIRANTE";16;4;2;22
2014;"PALMEIRAS DO TOCANTINS (TO)";"TO";"PALMEIRAS DO TOCANTINS";34;9;9;52
2014;"PALMEIROPOLIS (TO)";"TO";"PALMEIROPOLIS";115;3;18;136
2014;"PARAISO DO TOCANTINS (TO)";"TO";"PARAISO DO TOCANTINS";1267;33;119;1419
2014;"PARANA (TO)";"TO";"PARANA";33;3;1;37
2014;"PAU D ARCO (TO)";"TO";"PAU D ARCO";24;1;8;33
2014;"PEDRO AFONSO (TO)";"TO";"PEDRO AFONSO";218;10;63;291
2014;"PEIXE (TO)";"TO";"PEIXE";74;11;42;127
2014;"PEQUIZEIRO (TO)";"TO";"PEQUIZEIRO";40;2;11;53
2014;"PINDORAMA DO TOCANTINS (TO)";"TO";"PINDORAMA DO TOCANTINS";19;1;6;26
2014;"PIRAQUE (TO)";"TO";"PIRAQUE";9;0;6;15
2014;"PIUM (TO)";"TO";"PIUM";48;2;14;64
2014;"PONTE ALTA DO BOM JESUS (TO)";"TO";"PONTE ALTA DO BOM JESUS";15;3;3;21
2014;"PONTE ALTA DO TOCANTINS (TO)";"TO";"PONTE ALTA DO TOCANTINS";25;2;6;33
2014;"PORTO ALEGRE DO TOCANTINS (TO)";"TO";"PORTO ALEGRE DO TOCANTINS";12;0;5;17
2014;"PORTO NACIONAL (TO)";"TO";"PORTO NACIONAL";749;65;122;936
2014;"PRAIA NORTE (TO)";"TO";"PRAIA NORTE";11;5;4;20
2014;"PRESIDENTE KENNEDY (TO)";"TO";"PRESIDENTE KENNEDY";39;1;3;43
2014;"PUGMIL (TO)";"TO";"PUGMIL";23;2;2;27
2014;"RECURSOLANDIA (TO)";"TO";"RECURSOLANDIA";12;0;1;13
2014;"RIACHINHO (TO)";"TO";"RIACHINHO";135;15;92;242
2014;"RIO DA CONCEICAO (TO)";"TO";"RIO DA CONCEICAO";8;1;2;11
2014;"RIO DOS BOIS (TO)";"TO";"RIO DOS BOIS";15;2;4;21
2014;"RIO SONO (TO)";"TO";"RIO SONO";22;1;6;29
2014;"SAMPAIO (TO)";"TO";"SAMPAIO";65;2;5;72
2014;"SANDOLANDIA (TO)";"TO";"SANDOLANDIA";17;9;1;27
2014;"SANTA FE DO ARAGUAIA (TO)";"TO";"SANTA FE DO ARAGUAIA";59;10;16;85
2014;"SANTA MARIA DO TOCANTINS (TO)";"TO";"SANTA MARIA DO TOCANTINS";11;4;3;18
2014;"SANTA RITA DO TOCANTINS (TO)";"TO";"SANTA RITA DO TOCANTINS";14;1;4;19
2014;"SANTA ROSA DO TOCANTINS (TO)";"TO";"SANTA ROSA DO TOCANTINS";41;0;3;44
2014;"SANTA TEREZA DO TOCANTINS (TO)";"TO";"SANTA TEREZA DO TOCANTINS";25;1;4;30
2014;"SANTA TEREZINHA DO TOCANTINS (TO)";"TO";"SANTA TEREZINHA DO TOCANTINS";19;3;4;26
2014;"SAO BENTO DO TOCANTINS (TO)";"TO";"SAO BENTO DO TOCANTINS";21;3;10;34
2014;"SAO FELIX DO TOCANTINS (TO)";"TO";"SAO FELIX DO TOCANTINS";7;0;0;7
2014;"SAO MIGUEL DO TOCANTINS (TO)";"TO";"SAO MIGUEL DO TOCANTINS";115;15;49;179
2014;"SAO SALVADOR DO TOCANTINS (TO)";"TO";"SAO SALVADOR DO TOCANTINS";22;4;5;31
2014;"SAO SEBASTIAO DO TOCANTINS (TO)";"TO";"SAO SEBASTIAO DO TOCANTINS";18;2;2;22
2014;"SAO VALERIO DA NATIVIDADE (TO)";"TO";"SAO VALERIO DA NATIVIDADE";53;1;7;61
2014;"SILVANOPOLIS (TO)";"TO";"SILVANOPOLIS";42;1;5;48
2014;"SITIO NOVO DO TOCANTINS (TO)";"TO";"SITIO NOVO DO TOCANTINS";47;6;15;68
2014;"SUCUPIRA (TO)";"TO";"SUCUPIRA";12;0;6;18
2014;"TAGUATINGA (TO)";"TO";"TAGUATINGA";94;10;27;131
2014;"TAIPAS DO TOCANTINS (TO)";"TO";"TAIPAS DO TOCANTINS";7;0;2;9
2014;"TALISMA (TO)";"TO";"TALISMA";23;6;1;30
2014;"TOCANTINIA (TO)";"TO";"TOCANTINIA";25;2;8;35
2014;"TOCANTINOPOLIS (TO)";"TO";"TOCANTINOPOLIS";1295;286;395;1976
2014;"TUPIRAMA (TO)";"TO";"TUPIRAMA";19;4;4;27
2014;"TUPIRATINS (TO)";"TO";"TUPIRATINS";11;1;7;19
2014;"WANDERLANDIA (TO)";"TO";"WANDERLANDIA";79;4;9;92
2014;"XAMBIOA (TO)";"TO";"XAMBIOA";129;8;21;158
