"ano";"chave";"UF";"MUNICIPIO";"CAMINHAO";"MICRO_ONIBUS";"ONIBUS";"total"
2012;"ACRELANDIA (AC)";"AC";"ACRELANDIA";190;4;34;228
2012;"ASSIS BRASIL (AC)";"AC";"ASSIS BRASIL";16;2;2;20
2012;"BRASILEIA (AC)";"AC";"BRASILEIA";167;2;9;178
2012;"BUJARI (AC)";"AC";"BUJARI";83;3;5;91
2012;"CAPIXABA (AC)";"AC";"CAPIXABA";68;1;8;77
2012;"CRUZEIRO DO SUL (AC)";"AC";"CRUZEIRO DO SUL";557;51;50;658
2012;"EPITACIOLANDIA (AC)";"AC";"EPITACIOLANDIA";164;1;11;176
2012;"FEIJO (AC)";"AC";"FEIJO";85;1;2;88
2012;"JORDAO (AC)";"AC";"JORDAO";2;0;0;2
2012;"MANCIO LIMA (AC)";"AC";"MANCIO LIMA";68;2;8;78
2012;"MANOEL URBANO (AC)";"AC";"MANOEL URBANO";23;0;2;25
2012;"MARECHAL THAUMATURGO (AC)";"AC";"MARECHAL THAUMATURGO";5;0;2;7
2012;"PLACIDO DE CASTRO (AC)";"AC";"PLACIDO DE CASTRO";134;1;11;146
2012;"PORTO ACRE (AC)";"AC";"PORTO ACRE";136;2;29;167
2012;"PORTO WALTER (AC)";"AC";"PORTO WALTER";4;0;2;6
2012;"RIO BRANCO (AC)";"AC";"RIO BRANCO";3706;166;526;4398
2012;"RODRIGUES ALVES (AC)";"AC";"RODRIGUES ALVES";10;0;1;11
2012;"SANTA ROSA DO PURUS (AC)";"AC";"SANTA ROSA DO PURUS";3;0;1;4
2012;"SENA MADUREIRA (AC)";"AC";"SENA MADUREIRA";84;3;4;91
2012;"SENADOR GUIOMARD (AC)";"AC";"SENADOR GUIOMARD";297;5;17;319
2012;"TARAUACA (AC)";"AC";"TARAUACA";128;10;8;146
2012;"XAPURI (AC)";"AC";"XAPURI";58;3;2;63
2012;"AGUA BRANCA (AL)";"AL";"AGUA BRANCA";58;64;8;130
2012;"ANADIA (AL)";"AL";"ANADIA";46;54;35;135
2012;"ARAPIRACA (AL)";"AL";"ARAPIRACA";2716;428;305;3449
2012;"ATALAIA (AL)";"AL";"ATALAIA";199;49;113;361
2012;"BARRA DE SANTO ANTONIO (AL)";"AL";"BARRA DE SANTO ANTONIO";22;7;17;46
2012;"BARRA DE SAO MIGUEL (AL)";"AL";"BARRA DE SAO MIGUEL";19;2;5;26
2012;"BATALHA (AL)";"AL";"BATALHA";86;24;4;114
2012;"BELEM (AL)";"AL";"BELEM";9;21;5;35
2012;"BELO MONTE (AL)";"AL";"BELO MONTE";34;7;2;43
2012;"BOCA DA MATA (AL)";"AL";"BOCA DA MATA";230;59;86;375
2012;"BRANQUINHA (AL)";"AL";"BRANQUINHA";19;23;11;53
2012;"CACIMBINHAS (AL)";"AL";"CACIMBINHAS";38;27;9;74
2012;"CAJUEIRO (AL)";"AL";"CAJUEIRO";95;8;47;150
2012;"CAMPESTRE (AL)";"AL";"CAMPESTRE";14;47;8;69
2012;"CAMPO ALEGRE (AL)";"AL";"CAMPO ALEGRE";135;125;112;372
2012;"CAMPO GRANDE (AL)";"AL";"CAMPO GRANDE";43;22;10;75
2012;"CANAPI (AL)";"AL";"CANAPI";27;22;13;62
2012;"CAPELA (AL)";"AL";"CAPELA";63;6;40;109
2012;"CARNEIROS (AL)";"AL";"CARNEIROS";20;7;2;29
2012;"CHA PRETA (AL)";"AL";"CHA PRETA";22;6;4;32
2012;"COITE DO NOIA (AL)";"AL";"COITE DO NOIA";43;5;16;64
2012;"COLONIA LEOPOLDINA (AL)";"AL";"COLONIA LEOPOLDINA";58;21;25;104
2012;"COQUEIRO SECO (AL)";"AL";"COQUEIRO SECO";7;4;5;16
2012;"CORURIPE (AL)";"AL";"CORURIPE";332;60;174;566
2012;"CRAIBAS (AL)";"AL";"CRAIBAS";95;30;20;145
2012;"DELMIRO GOUVEIA (AL)";"AL";"DELMIRO GOUVEIA";395;338;32;765
2012;"DOIS RIACHOS (AL)";"AL";"DOIS RIACHOS";50;10;5;65
2012;"ESTRELA DE ALAGOAS (AL)";"AL";"ESTRELA DE ALAGOAS";39;63;18;120
2012;"FEIRA GRANDE (AL)";"AL";"FEIRA GRANDE";52;2;37;91
2012;"FELIZ DESERTO (AL)";"AL";"FELIZ DESERTO";4;6;6;16
2012;"FLEXEIRAS (AL)";"AL";"FLEXEIRAS";22;19;32;73
2012;"GIRAU DO PONCIANO (AL)";"AL";"GIRAU DO PONCIANO";131;39;41;211
2012;"IBATEGUARA (AL)";"AL";"IBATEGUARA";35;52;17;104
2012;"IGACI (AL)";"AL";"IGACI";71;42;25;138
2012;"IGREJA NOVA (AL)";"AL";"IGREJA NOVA";71;20;68;159
2012;"INHAPI (AL)";"AL";"INHAPI";44;20;8;72
2012;"JACARE DOS HOMENS (AL)";"AL";"JACARE DOS HOMENS";31;5;4;40
2012;"JACUIPE (AL)";"AL";"JACUIPE";9;9;10;28
2012;"JAPARATINGA (AL)";"AL";"JAPARATINGA";10;15;5;30
2012;"JARAMATAIA (AL)";"AL";"JARAMATAIA";17;13;4;34
2012;"JEQUIA DA PRAIA (AL)";"AL";"JEQUIA DA PRAIA";31;12;33;76
2012;"JOAQUIM GOMES (AL)";"AL";"JOAQUIM GOMES";84;23;69;176
2012;"JUNDIA (AL)";"AL";"JUNDIA";9;5;9;23
2012;"JUNQUEIRO (AL)";"AL";"JUNQUEIRO";203;24;97;324
2012;"LAGOA DA CANOA (AL)";"AL";"LAGOA DA CANOA";68;13;24;105
2012;"LIMOEIRO DE ANADIA (AL)";"AL";"LIMOEIRO DE ANADIA";87;19;37;143
2012;"MACEIO (AL)";"AL";"MACEIO";6533;984;1791;9308
2012;"MAJOR ISIDORO (AL)";"AL";"MAJOR ISIDORO";64;20;17;101
2012;"MAR VERMELHO (AL)";"AL";"MAR VERMELHO";11;2;5;18
2012;"MARAGOGI (AL)";"AL";"MARAGOGI";54;87;28;169
2012;"MARAVILHA (AL)";"AL";"MARAVILHA";26;33;7;66
2012;"MARECHAL DEODORO (AL)";"AL";"MARECHAL DEODORO";243;76;98;417
2012;"MARIBONDO (AL)";"AL";"MARIBONDO";53;19;14;86
2012;"MATA GRANDE (AL)";"AL";"MATA GRANDE";44;24;9;77
2012;"MATRIZ DE CAMARAGIBE (AL)";"AL";"MATRIZ DE CAMARAGIBE";126;30;112;268
2012;"MESSIAS (AL)";"AL";"MESSIAS";61;31;70;162
2012;"MINADOR DO NEGRAO (AL)";"AL";"MINADOR DO NEGRAO";30;13;5;48
2012;"MONTEIROPOLIS (AL)";"AL";"MONTEIROPOLIS";6;3;5;14
2012;"MURICI (AL)";"AL";"MURICI";102;23;92;217
2012;"NOVO LINO (AL)";"AL";"NOVO LINO";40;21;42;103
2012;"OLHO D AGUA DAS FLORES (AL)";"AL";"OLHO D AGUA DAS FLORES";106;67;17;190
2012;"OLHO D AGUA DO CASADO (AL)";"AL";"OLHO D AGUA DO CASADO";22;15;5;42
2012;"OLHO D AGUA GRANDE (AL)";"AL";"OLHO D AGUA GRANDE";12;1;8;21
2012;"OLIVENCA (AL)";"AL";"OLIVENCA";34;12;6;52
2012;"OURO BRANCO (AL)";"AL";"OURO BRANCO";45;31;18;94
2012;"PALESTINA (AL)";"AL";"PALESTINA";6;4;2;12
2012;"PALMEIRA DOS INDIOS (AL)";"AL";"PALMEIRA DOS INDIOS";561;145;54;760
2012;"PAO DE ACUCAR (AL)";"AL";"PAO DE ACUCAR";65;15;7;87
2012;"PARICONHA (AL)";"AL";"PARICONHA";25;17;5;47
2012;"PARIPUEIRA (AL)";"AL";"PARIPUEIRA";48;3;11;62
2012;"PASSO DE CAMARAGIBE (AL)";"AL";"PASSO DE CAMARAGIBE";33;7;25;65
2012;"PAULO JACINTO (AL)";"AL";"PAULO JACINTO";13;10;6;29
2012;"PENEDO (AL)";"AL";"PENEDO";234;71;177;482
2012;"PIACABUCU (AL)";"AL";"PIACABUCU";24;16;11;51
2012;"PILAR (AL)";"AL";"PILAR";154;57;58;269
2012;"PINDOBA (AL)";"AL";"PINDOBA";10;1;2;13
2012;"PIRANHAS (AL)";"AL";"PIRANHAS";49;66;10;125
2012;"POCO DAS TRINCHEIRAS (AL)";"AL";"POCO DAS TRINCHEIRAS";45;50;19;114
2012;"PORTO CALVO (AL)";"AL";"PORTO CALVO";181;119;59;359
2012;"PORTO DE PEDRAS (AL)";"AL";"PORTO DE PEDRAS";8;8;6;22
2012;"PORTO REAL DO COLEGIO (AL)";"AL";"PORTO REAL DO COLEGIO";18;29;18;65
2012;"QUEBRANGULO (AL)";"AL";"QUEBRANGULO";27;5;4;36
2012;"RIO LARGO (AL)";"AL";"RIO LARGO";424;169;169;762
2012;"ROTEIRO (AL)";"AL";"ROTEIRO";10;22;7;39
2012;"SANTA LUZIA DO NORTE (AL)";"AL";"SANTA LUZIA DO NORTE";17;5;62;84
2012;"SANTANA DO IPANEMA (AL)";"AL";"SANTANA DO IPANEMA";332;110;37;479
2012;"SANTANA DO MUNDAU (AL)";"AL";"SANTANA DO MUNDAU";60;32;3;95
2012;"SAO BRAS (AL)";"AL";"SAO BRAS";2;2;3;7
2012;"SAO JOSE DA LAJE (AL)";"AL";"SAO JOSE DA LAJE";95;79;39;213
2012;"SAO JOSE DA TAPERA (AL)";"AL";"SAO JOSE DA TAPERA";86;30;16;132
2012;"SAO LUIS DO QUITUNDE (AL)";"AL";"SAO LUIS DO QUITUNDE";190;21;116;327
2012;"SAO MIGUEL DOS CAMPOS (AL)";"AL";"SAO MIGUEL DOS CAMPOS";457;152;160;769
2012;"SAO MIGUEL DOS MILAGRES (AL)";"AL";"SAO MIGUEL DOS MILAGRES";20;2;5;27
2012;"SAO SEBASTIAO (AL)";"AL";"SAO SEBASTIAO";142;31;96;269
2012;"SATUBA (AL)";"AL";"SATUBA";72;17;21;110
2012;"SENADOR RUI PALMEIRA (AL)";"AL";"SENADOR RUI PALMEIRA";23;13;12;48
2012;"TANQUE D ARCA (AL)";"AL";"TANQUE D ARCA";11;13;5;29
2012;"TAQUARANA (AL)";"AL";"TAQUARANA";88;42;23;153
2012;"TEOTONIO VILELA (AL)";"AL";"TEOTONIO VILELA";202;84;163;449
2012;"TRAIPU (AL)";"AL";"TRAIPU";75;14;14;103
2012;"UNIAO DOS PALMARES (AL)";"AL";"UNIAO DOS PALMARES";462;184;161;807
2012;"VICOSA (AL)";"AL";"VICOSA";128;13;39;180
2012;"ALVARAES (AM)";"AM";"ALVARAES";5;0;3;8
2012;"AMATURA (AM)";"AM";"AMATURA";2;0;1;3
2012;"ANAMA (AM)";"AM";"ANAMA";0;0;3;3
2012;"ANORI (AM)";"AM";"ANORI";2;0;3;5
2012;"APUI (AM)";"AM";"APUI";80;1;21;102
2012;"ATALAIA DO NORTE (AM)";"AM";"ATALAIA DO NORTE";1;0;1;2
2012;"AUTAZES (AM)";"AM";"AUTAZES";24;2;11;37
2012;"BARCELOS (AM)";"AM";"BARCELOS";10;1;0;11
2012;"BARREIRINHA (AM)";"AM";"BARREIRINHA";2;0;0;2
2012;"BENJAMIN CONSTANT (AM)";"AM";"BENJAMIN CONSTANT";10;4;3;17
2012;"BERURI (AM)";"AM";"BERURI";0;0;0;0
2012;"BOA VISTA DO RAMOS (AM)";"AM";"BOA VISTA DO RAMOS";3;0;1;4
2012;"BOCA DO ACRE (AM)";"AM";"BOCA DO ACRE";36;2;5;43
2012;"BORBA (AM)";"AM";"BORBA";12;0;5;17
2012;"CAAPIRANGA (AM)";"AM";"CAAPIRANGA";8;1;3;12
2012;"CANUTAMA (AM)";"AM";"CANUTAMA";2;0;0;2
2012;"CARAUARI (AM)";"AM";"CARAUARI";33;1;1;35
2012;"CAREIRO (AM)";"AM";"CAREIRO";55;23;48;126
2012;"CAREIRO DA VARZEA (AM)";"AM";"CAREIRO DA VARZEA";12;23;36;71
2012;"COARI (AM)";"AM";"COARI";104;4;13;121
2012;"CODAJAS (AM)";"AM";"CODAJAS";8;0;4;12
2012;"EIRUNEPE (AM)";"AM";"EIRUNEPE";23;0;5;28
2012;"ENVIRA (AM)";"AM";"ENVIRA";15;0;4;19
2012;"FONTE BOA (AM)";"AM";"FONTE BOA";12;0;0;12
2012;"GUAJARA (AM)";"AM";"GUAJARA";0;0;1;1
2012;"HUMAITA (AM)";"AM";"HUMAITA";134;3;14;151
2012;"IPIXUNA (AM)";"AM";"IPIXUNA";2;0;0;2
2012;"IRANDUBA (AM)";"AM";"IRANDUBA";184;14;58;256
2012;"ITACOATIARA (AM)";"AM";"ITACOATIARA";331;25;127;483
2012;"ITAMARATI (AM)";"AM";"ITAMARATI";2;0;0;2
2012;"ITAPIRANGA (AM)";"AM";"ITAPIRANGA";12;1;2;15
2012;"JAPURA (AM)";"AM";"JAPURA";4;0;1;5
2012;"JURUA (AM)";"AM";"JURUA";6;0;1;7
2012;"JUTAI (AM)";"AM";"JUTAI";2;0;0;2
2012;"LABREA (AM)";"AM";"LABREA";21;1;3;25
2012;"MANACAPURU (AM)";"AM";"MANACAPURU";261;59;69;389
2012;"MANAQUIRI (AM)";"AM";"MANAQUIRI";8;4;5;17
2012;"MANAUS (AM)";"AM";"MANAUS";16102;2812;7338;26252
2012;"MANICORE (AM)";"AM";"MANICORE";31;1;10;42
2012;"MARAA (AM)";"AM";"MARAA";4;0;0;4
2012;"MAUES (AM)";"AM";"MAUES";35;2;9;46
2012;"NHAMUNDA (AM)";"AM";"NHAMUNDA";7;0;1;8
2012;"NOVA OLINDA DO NORTE (AM)";"AM";"NOVA OLINDA DO NORTE";15;6;6;27
2012;"NOVO AIRAO (AM)";"AM";"NOVO AIRAO";20;6;12;38
2012;"NOVO ARIPUANA (AM)";"AM";"NOVO ARIPUANA";14;2;6;22
2012;"PARINTINS (AM)";"AM";"PARINTINS";133;6;22;161
2012;"PAUINI (AM)";"AM";"PAUINI";2;1;1;4
2012;"PRESIDENTE FIGUEIREDO (AM)";"AM";"PRESIDENTE FIGUEIREDO";241;40;69;350
2012;"RIO PRETO DA EVA (AM)";"AM";"RIO PRETO DA EVA";117;13;62;192
2012;"SANTA ISABEL DO RIO NEGRO (AM)";"AM";"SANTA ISABEL DO RIO NEGRO";7;2;3;12
2012;"SANTO ANTONIO DO ICA (AM)";"AM";"SANTO ANTONIO DO ICA";6;0;0;6
2012;"SAO GABRIEL DA CACHOEIRA (AM)";"AM";"SAO GABRIEL DA CACHOEIRA";72;11;24;107
2012;"SAO PAULO DE OLIVENCA (AM)";"AM";"SAO PAULO DE OLIVENCA";4;0;5;9
2012;"SAO SEBASTIAO DO UATUMA (AM)";"AM";"SAO SEBASTIAO DO UATUMA";5;0;0;5
2012;"SILVES (AM)";"AM";"SILVES";10;5;3;18
2012;"TABATINGA (AM)";"AM";"TABATINGA";55;7;3;65
2012;"TAPAUA (AM)";"AM";"TAPAUA";3;0;2;5
2012;"TEFE (AM)";"AM";"TEFE";60;14;11;85
2012;"TONANTINS (AM)";"AM";"TONANTINS";3;0;1;4
2012;"UARINI (AM)";"AM";"UARINI";8;0;2;10
2012;"URUCARA (AM)";"AM";"URUCARA";13;2;2;17
2012;"URUCURITUBA (AM)";"AM";"URUCURITUBA";5;0;2;7
2012;"AMAPA (AP)";"AP";"AMAPA";7;2;2;11
2012;"CALCOENE (AP)";"AP";"CALCOENE";14;2;2;18
2012;"CUTIAS (AP)";"AP";"CUTIAS";3;1;0;4
2012;"FERREIRA GOMES (AP)";"AP";"FERREIRA GOMES";4;1;1;6
2012;"ITAUBAL (AP)";"AP";"ITAUBAL";3;0;4;7
2012;"LARANJAL DO JARI (AP)";"AP";"LARANJAL DO JARI";79;7;9;95
2012;"MACAPA (AP)";"AP";"MACAPA";2671;303;657;3631
2012;"MAZAGAO (AP)";"AP";"MAZAGAO";47;9;17;73
2012;"OIAPOQUE (AP)";"AP";"OIAPOQUE";50;4;9;63
2012;"PEDRA BRANCA DO AMAPARI (AP)";"AP";"PEDRA BRANCA DO AMAPARI";30;4;6;40
2012;"PORTO GRANDE (AP)";"AP";"PORTO GRANDE";27;3;9;39
2012;"PRACUUBA (AP)";"AP";"PRACUUBA";3;0;2;5
2012;"SANTANA (AP)";"AP";"SANTANA";535;42;136;713
2012;"SERRA DO NAVIO (AP)";"AP";"SERRA DO NAVIO";3;3;1;7
2012;"TARTARUGALZINHO (AP)";"AP";"TARTARUGALZINHO";12;3;1;16
2012;"VITORIA DO JARI (AP)";"AP";"VITORIA DO JARI";1;0;1;2
2012;"ABAIRA (BA)";"BA";"ABAIRA";52;23;15;90
2012;"ABARE (BA)";"BA";"ABARE";51;25;21;97
2012;"ACAJUTIBA (BA)";"BA";"ACAJUTIBA";69;13;13;95
2012;"ADUSTINA (BA)";"BA";"ADUSTINA";12;8;10;30
2012;"AGUA FRIA (BA)";"BA";"AGUA FRIA";20;17;32;69
2012;"AIQUARA (BA)";"BA";"AIQUARA";4;4;4;12
2012;"ALAGOINHAS (BA)";"BA";"ALAGOINHAS";1087;307;482;1876
2012;"ALCOBACA (BA)";"BA";"ALCOBACA";41;4;24;69
2012;"ALMADINA (BA)";"BA";"ALMADINA";13;0;5;18
2012;"AMARGOSA (BA)";"BA";"AMARGOSA";256;51;72;379
2012;"AMELIA RODRIGUES (BA)";"BA";"AMELIA RODRIGUES";178;100;30;308
2012;"AMERICA DOURADA (BA)";"BA";"AMERICA DOURADA";18;11;9;38
2012;"ANAGE (BA)";"BA";"ANAGE";81;67;39;187
2012;"ANDARAI (BA)";"BA";"ANDARAI";28;2;16;46
2012;"ANDORINHA (BA)";"BA";"ANDORINHA";68;12;33;113
2012;"ANGICAL (BA)";"BA";"ANGICAL";27;9;23;59
2012;"ANGUERA (BA)";"BA";"ANGUERA";19;5;12;36
2012;"ANTAS (BA)";"BA";"ANTAS";29;7;10;46
2012;"ANTONIO CARDOSO (BA)";"BA";"ANTONIO CARDOSO";3;30;13;46
2012;"ANTONIO GONCALVES (BA)";"BA";"ANTONIO GONCALVES";22;9;7;38
2012;"APORA (BA)";"BA";"APORA";29;22;28;79
2012;"APUAREMA (BA)";"BA";"APUAREMA";28;4;9;41
2012;"ARACAS (BA)";"BA";"ARACAS";60;17;26;103
2012;"ARACATU (BA)";"BA";"ARACATU";94;28;19;141
2012;"ARACI (BA)";"BA";"ARACI";237;22;56;315
2012;"ARAMARI (BA)";"BA";"ARAMARI";45;4;11;60
2012;"ARATACA (BA)";"BA";"ARATACA";24;0;3;27
2012;"ARATUIPE (BA)";"BA";"ARATUIPE";33;2;12;47
2012;"AURELINO LEAL (BA)";"BA";"AURELINO LEAL";48;3;12;63
2012;"BAIANOPOLIS (BA)";"BA";"BAIANOPOLIS";43;5;33;81
2012;"BAIXA GRANDE (BA)";"BA";"BAIXA GRANDE";86;54;44;184
2012;"BANZAE (BA)";"BA";"BANZAE";20;6;19;45
2012;"BARRA (BA)";"BA";"BARRA";58;30;27;115
2012;"BARRA DA ESTIVA (BA)";"BA";"BARRA DA ESTIVA";205;48;61;314
2012;"BARRA DO CHOCA (BA)";"BA";"BARRA DO CHOCA";123;188;27;338
2012;"BARRA DO MENDES (BA)";"BA";"BARRA DO MENDES";62;24;11;97
2012;"BARRA DO ROCHA (BA)";"BA";"BARRA DO ROCHA";8;5;2;15
2012;"BARREIRAS (BA)";"BA";"BARREIRAS";2554;132;402;3088
2012;"BARRO ALTO (BA)";"BA";"BARRO ALTO";44;13;18;75
2012;"BARRO PRETO (BA)";"BA";"BARRO PRETO";10;1;9;20
2012;"BARROCAS (BA)";"BA";"BARROCAS";87;3;17;107
2012;"BELMONTE (BA)";"BA";"BELMONTE";47;5;10;62
2012;"BELO CAMPO (BA)";"BA";"BELO CAMPO";97;18;24;139
2012;"BIRITINGA (BA)";"BA";"BIRITINGA";21;11;28;60
2012;"BOA NOVA (BA)";"BA";"BOA NOVA";30;36;22;88
2012;"BOA VISTA DO TUPIM (BA)";"BA";"BOA VISTA DO TUPIM";42;12;17;71
2012;"BOM JESUS DA LAPA (BA)";"BA";"BOM JESUS DA LAPA";420;54;107;581
2012;"BOM JESUS DA SERRA (BA)";"BA";"BOM JESUS DA SERRA";29;42;18;89
2012;"BONINAL (BA)";"BA";"BONINAL";68;21;29;118
2012;"BONITO (BA)";"BA";"BONITO";75;12;15;102
2012;"BOQUIRA (BA)";"BA";"BOQUIRA";125;8;60;193
2012;"BOTUPORA (BA)";"BA";"BOTUPORA";50;3;38;91
2012;"BREJOES (BA)";"BA";"BREJOES";78;6;35;119
2012;"BREJOLANDIA (BA)";"BA";"BREJOLANDIA";29;10;17;56
2012;"BROTAS DE MACAUBAS (BA)";"BA";"BROTAS DE MACAUBAS";31;44;15;90
2012;"BRUMADO (BA)";"BA";"BRUMADO";1266;225;286;1777
2012;"BUERAREMA (BA)";"BA";"BUERAREMA";145;8;33;186
2012;"BURITIRAMA (BA)";"BA";"BURITIRAMA";22;3;19;44
2012;"CAATIBA (BA)";"BA";"CAATIBA";20;4;2;26
2012;"CABACEIRAS DO PARAGUACU (BA)";"BA";"CABACEIRAS DO PARAGUACU";53;16;47;116
2012;"CACHOEIRA (BA)";"BA";"CACHOEIRA";102;104;71;277
2012;"CACULE (BA)";"BA";"CACULE";348;23;52;423
2012;"CAEM (BA)";"BA";"CAEM";19;9;14;42
2012;"CAETANOS (BA)";"BA";"CAETANOS";51;13;14;78
2012;"CAETITE (BA)";"BA";"CAETITE";533;85;90;708
2012;"CAFARNAUM (BA)";"BA";"CAFARNAUM";59;6;28;93
2012;"CAIRU (BA)";"BA";"CAIRU";8;9;7;24
2012;"CALDEIRAO GRANDE (BA)";"BA";"CALDEIRAO GRANDE";23;5;14;42
2012;"CAMACAN (BA)";"BA";"CAMACAN";181;25;37;243
2012;"CAMACARI (BA)";"BA";"CAMACARI";2194;470;1222;3886
2012;"CAMAMU (BA)";"BA";"CAMAMU";145;40;31;216
2012;"CAMPO ALEGRE DE LOURDES (BA)";"BA";"CAMPO ALEGRE DE LOURDES";81;5;11;97
2012;"CAMPO FORMOSO (BA)";"BA";"CAMPO FORMOSO";217;27;78;322
2012;"CANAPOLIS (BA)";"BA";"CANAPOLIS";19;19;11;49
2012;"CANARANA (BA)";"BA";"CANARANA";153;17;18;188
2012;"CANAVIEIRAS (BA)";"BA";"CANAVIEIRAS";97;9;15;121
2012;"CANDEAL (BA)";"BA";"CANDEAL";19;21;17;57
2012;"CANDEIAS (BA)";"BA";"CANDEIAS";850;362;350;1562
2012;"CANDIBA (BA)";"BA";"CANDIBA";56;1;25;82
2012;"CANDIDO SALES (BA)";"BA";"CANDIDO SALES";303;33;44;380
2012;"CANSANCAO (BA)";"BA";"CANSANCAO";154;51;57;262
2012;"CANUDOS (BA)";"BA";"CANUDOS";43;6;37;86
2012;"CAPELA DO ALTO ALEGRE (BA)";"BA";"CAPELA DO ALTO ALEGRE";74;24;19;117
2012;"CAPIM GROSSO (BA)";"BA";"CAPIM GROSSO";466;56;55;577
2012;"CARAIBAS (BA)";"BA";"CARAIBAS";39;22;17;78
2012;"CARAVELAS (BA)";"BA";"CARAVELAS";38;18;43;99
2012;"CARDEAL DA SILVA (BA)";"BA";"CARDEAL DA SILVA";25;7;6;38
2012;"CARINHANHA (BA)";"BA";"CARINHANHA";120;27;37;184
2012;"CASA NOVA (BA)";"BA";"CASA NOVA";413;191;186;790
2012;"CASTRO ALVES (BA)";"BA";"CASTRO ALVES";144;20;55;219
2012;"CATOLANDIA (BA)";"BA";"CATOLANDIA";7;3;8;18
2012;"CATU (BA)";"BA";"CATU";372;116;101;589
2012;"CATURAMA (BA)";"BA";"CATURAMA";34;9;9;52
2012;"CENTRAL (BA)";"BA";"CENTRAL";80;23;9;112
2012;"CHORROCHO (BA)";"BA";"CHORROCHO";22;5;8;35
2012;"CICERO DANTAS (BA)";"BA";"CICERO DANTAS";138;26;44;208
2012;"CIPO (BA)";"BA";"CIPO";49;11;13;73
2012;"COARACI (BA)";"BA";"COARACI";100;4;18;122
2012;"COCOS (BA)";"BA";"COCOS";78;6;37;121
2012;"CONCEICAO DA FEIRA (BA)";"BA";"CONCEICAO DA FEIRA";236;104;12;352
2012;"CONCEICAO DO ALMEIDA (BA)";"BA";"CONCEICAO DO ALMEIDA";114;30;24;168
2012;"CONCEICAO DO COITE (BA)";"BA";"CONCEICAO DO COITE";451;100;103;654
2012;"CONCEICAO DO JACUIPE (BA)";"BA";"CONCEICAO DO JACUIPE";297;139;24;460
2012;"CONDE (BA)";"BA";"CONDE";55;18;21;94
2012;"CONDEUBA (BA)";"BA";"CONDEUBA";117;43;66;226
2012;"CONTENDAS DO SINCORA (BA)";"BA";"CONTENDAS DO SINCORA";19;9;5;33
2012;"CORACAO DE MARIA (BA)";"BA";"CORACAO DE MARIA";95;41;49;185
2012;"CORDEIROS (BA)";"BA";"CORDEIROS";34;16;19;69
2012;"CORIBE (BA)";"BA";"CORIBE";49;15;23;87
2012;"CORONEL JOAO SA (BA)";"BA";"CORONEL JOAO SA";16;1;22;39
2012;"CORRENTINA (BA)";"BA";"CORRENTINA";154;27;77;258
2012;"COTEGIPE (BA)";"BA";"COTEGIPE";41;11;19;71
2012;"CRAVOLANDIA (BA)";"BA";"CRAVOLANDIA";16;2;6;24
2012;"CRISOPOLIS (BA)";"BA";"CRISOPOLIS";59;25;32;116
2012;"CRISTOPOLIS (BA)";"BA";"CRISTOPOLIS";56;10;28;94
2012;"CRUZ DAS ALMAS (BA)";"BA";"CRUZ DAS ALMAS";1006;253;88;1347
2012;"CURACA (BA)";"BA";"CURACA";70;28;27;125
2012;"DARIO MEIRA (BA)";"BA";"DARIO MEIRA";18;13;5;36
2012;"DIAS D AVILA (BA)";"BA";"DIAS D AVILA";628;86;409;1123
2012;"DOM BASILIO (BA)";"BA";"DOM BASILIO";288;14;22;324
2012;"DOM MACEDO COSTA (BA)";"BA";"DOM MACEDO COSTA";11;31;7;49
2012;"ELISIO MEDRADO (BA)";"BA";"ELISIO MEDRADO";28;10;13;51
2012;"ENCRUZILHADA (BA)";"BA";"ENCRUZILHADA";87;34;13;134
2012;"ENTRE RIOS (BA)";"BA";"ENTRE RIOS";200;80;101;381
2012;"ERICO CARDOSO (BA)";"BA";"ERICO CARDOSO";32;8;17;57
2012;"ESPLANADA (BA)";"BA";"ESPLANADA";133;34;68;235
2012;"EUCLIDES DA CUNHA (BA)";"BA";"EUCLIDES DA CUNHA";261;39;136;436
2012;"EUNAPOLIS (BA)";"BA";"EUNAPOLIS";1293;110;356;1759
2012;"FATIMA (BA)";"BA";"FATIMA";16;9;22;47
2012;"FEIRA DA MATA (BA)";"BA";"FEIRA DA MATA";15;9;13;37
2012;"FEIRA DE SANTANA (BA)";"BA";"FEIRA DE SANTANA";8321;1119;1201;10641
2012;"FILADELFIA (BA)";"BA";"FILADELFIA";102;9;28;139
2012;"FIRMINO ALVES (BA)";"BA";"FIRMINO ALVES";13;3;2;18
2012;"FLORESTA AZUL (BA)";"BA";"FLORESTA AZUL";52;2;2;56
2012;"FORMOSA DO RIO PRETO (BA)";"BA";"FORMOSA DO RIO PRETO";141;4;23;168
2012;"GANDU (BA)";"BA";"GANDU";287;77;22;386
2012;"GAVIAO (BA)";"BA";"GAVIAO";19;13;8;40
2012;"GENTIO DO OURO (BA)";"BA";"GENTIO DO OURO";17;5;3;25
2012;"GLORIA (BA)";"BA";"GLORIA";44;22;39;105
2012;"GONGOGI (BA)";"BA";"GONGOGI";9;1;2;12
2012;"GOVERNADOR MANGABEIRA (BA)";"BA";"GOVERNADOR MANGABEIRA";175;39;37;251
2012;"GUAJERU (BA)";"BA";"GUAJERU";18;23;11;52
2012;"GUANAMBI (BA)";"BA";"GUANAMBI";1173;93;182;1448
2012;"GUARATINGA (BA)";"BA";"GUARATINGA";80;4;25;109
2012;"HELIOPOLIS (BA)";"BA";"HELIOPOLIS";29;11;13;53
2012;"IACU (BA)";"BA";"IACU";131;22;30;183
2012;"IBIASSUCE (BA)";"BA";"IBIASSUCE";83;15;16;114
2012;"IBICARAI (BA)";"BA";"IBICARAI";145;11;27;183
2012;"IBICOARA (BA)";"BA";"IBICOARA";218;38;54;310
2012;"IBICUI (BA)";"BA";"IBICUI";45;14;14;73
2012;"IBIPEBA (BA)";"BA";"IBIPEBA";38;25;12;75
2012;"IBIPITANGA (BA)";"BA";"IBIPITANGA";84;18;36;138
2012;"IBIQUERA (BA)";"BA";"IBIQUERA";7;6;2;15
2012;"IBIRAPITANGA (BA)";"BA";"IBIRAPITANGA";54;17;9;80
2012;"IBIRAPUA (BA)";"BA";"IBIRAPUA";68;5;16;89
2012;"IBIRATAIA (BA)";"BA";"IBIRATAIA";78;41;12;131
2012;"IBITIARA (BA)";"BA";"IBITIARA";97;39;35;171
2012;"IBITITA (BA)";"BA";"IBITITA";45;5;20;70
2012;"IBOTIRAMA (BA)";"BA";"IBOTIRAMA";226;66;25;317
2012;"ICHU (BA)";"BA";"ICHU";28;14;14;56
2012;"IGAPORA (BA)";"BA";"IGAPORA";98;27;29;154
2012;"IGRAPIUNA (BA)";"BA";"IGRAPIUNA";44;28;18;90
2012;"IGUAI (BA)";"BA";"IGUAI";63;35;32;130
2012;"ILHEUS (BA)";"BA";"ILHEUS";671;156;294;1121
2012;"INHAMBUPE (BA)";"BA";"INHAMBUPE";178;93;87;358
2012;"IPECAETA (BA)";"BA";"IPECAETA";15;7;44;66
2012;"IPIAU (BA)";"BA";"IPIAU";359;39;48;446
2012;"IPIRA (BA)";"BA";"IPIRA";386;51;97;534
2012;"IPUPIARA (BA)";"BA";"IPUPIARA";54;20;5;79
2012;"IRAJUBA (BA)";"BA";"IRAJUBA";28;1;22;51
2012;"IRAMAIA (BA)";"BA";"IRAMAIA";35;10;13;58
2012;"IRAQUARA (BA)";"BA";"IRAQUARA";118;27;35;180
2012;"IRARA (BA)";"BA";"IRARA";133;37;62;232
2012;"IRECE (BA)";"BA";"IRECE";838;82;135;1055
2012;"ITABELA (BA)";"BA";"ITABELA";255;9;86;350
2012;"ITABERABA (BA)";"BA";"ITABERABA";492;81;67;640
2012;"ITABUNA (BA)";"BA";"ITABUNA";1867;77;737;2681
2012;"ITACARE (BA)";"BA";"ITACARE";21;27;7;55
2012;"ITAETE (BA)";"BA";"ITAETE";62;12;26;100
2012;"ITAGI (BA)";"BA";"ITAGI";38;4;6;48
2012;"ITAGIBA (BA)";"BA";"ITAGIBA";26;42;21;89
2012;"ITAGIMIRIM (BA)";"BA";"ITAGIMIRIM";48;3;6;57
2012;"ITAGUACU DA BAHIA (BA)";"BA";"ITAGUACU DA BAHIA";18;6;8;32
2012;"ITAJU DO COLONIA (BA)";"BA";"ITAJU DO COLONIA";17;1;5;23
2012;"ITAJUIPE (BA)";"BA";"ITAJUIPE";78;13;16;107
2012;"ITAMARAJU (BA)";"BA";"ITAMARAJU";437;37;148;622
2012;"ITAMARI (BA)";"BA";"ITAMARI";36;5;2;43
2012;"ITAMBE (BA)";"BA";"ITAMBE";67;51;7;125
2012;"ITANAGRA (BA)";"BA";"ITANAGRA";20;1;5;26
2012;"ITANHEM (BA)";"BA";"ITANHEM";69;9;22;100
2012;"ITAPARICA (BA)";"BA";"ITAPARICA";29;32;48;109
2012;"ITAPE (BA)";"BA";"ITAPE";24;0;1;25
2012;"ITAPEBI (BA)";"BA";"ITAPEBI";48;4;8;60
2012;"ITAPETINGA (BA)";"BA";"ITAPETINGA";501;50;171;722
2012;"ITAPICURU (BA)";"BA";"ITAPICURU";43;16;41;100
2012;"ITAPITANGA (BA)";"BA";"ITAPITANGA";10;4;3;17
2012;"ITAQUARA (BA)";"BA";"ITAQUARA";37;4;6;47
2012;"ITARANTIM (BA)";"BA";"ITARANTIM";86;10;3;99
2012;"ITATIM (BA)";"BA";"ITATIM";181;28;30;239
2012;"ITIRUCU (BA)";"BA";"ITIRUCU";108;11;16;135
2012;"ITIUBA (BA)";"BA";"ITIUBA";84;38;56;178
2012;"ITORORO (BA)";"BA";"ITORORO";94;17;25;136
2012;"ITUACU (BA)";"BA";"ITUACU";139;26;38;203
2012;"ITUBERA (BA)";"BA";"ITUBERA";147;19;18;184
2012;"IUIU (BA)";"BA";"IUIU";42;6;11;59
2012;"JABORANDI (BA)";"BA";"JABORANDI";51;1;26;78
2012;"JACARACI (BA)";"BA";"JACARACI";41;16;26;83
2012;"JACOBINA (BA)";"BA";"JACOBINA";708;109;167;984
2012;"JAGUAQUARA (BA)";"BA";"JAGUAQUARA";604;24;52;680
2012;"JAGUARARI (BA)";"BA";"JAGUARARI";213;66;70;349
2012;"JAGUARIPE (BA)";"BA";"JAGUARIPE";39;20;22;81
2012;"JANDAIRA (BA)";"BA";"JANDAIRA";16;4;10;30
2012;"JEQUIE (BA)";"BA";"JEQUIE";1571;97;374;2042
2012;"JEREMOABO (BA)";"BA";"JEREMOABO";88;28;50;166
2012;"JIQUIRICA (BA)";"BA";"JIQUIRICA";41;24;23;88
2012;"JITAUNA (BA)";"BA";"JITAUNA";30;12;10;52
2012;"JOAO DOURADO (BA)";"BA";"JOAO DOURADO";97;26;18;141
2012;"JUAZEIRO (BA)";"BA";"JUAZEIRO";3046;940;916;4902
2012;"JUCURUCU (BA)";"BA";"JUCURUCU";13;1;5;19
2012;"JUSSARA (BA)";"BA";"JUSSARA";56;20;18;94
2012;"JUSSARI (BA)";"BA";"JUSSARI";15;1;3;19
2012;"JUSSIAPE (BA)";"BA";"JUSSIAPE";60;14;25;99
2012;"LAFAIETE COUTINHO (BA)";"BA";"LAFAIETE COUTINHO";19;5;5;29
2012;"LAGEDO DO TABOCAL (BA)";"BA";"LAGEDO DO TABOCAL";38;1;8;47
2012;"LAGOA REAL (BA)";"BA";"LAGOA REAL";50;8;21;79
2012;"LAJE (BA)";"BA";"LAJE";143;64;40;247
2012;"LAJEDAO (BA)";"BA";"LAJEDAO";7;1;18;26
2012;"LAJEDINHO (BA)";"BA";"LAJEDINHO";8;4;9;21
2012;"LAMARAO (BA)";"BA";"LAMARAO";3;6;6;15
2012;"LAPAO (BA)";"BA";"LAPAO";128;10;29;167
2012;"LAURO DE FREITAS (BA)";"BA";"LAURO DE FREITAS";2390;491;656;3537
2012;"LENCOIS (BA)";"BA";"LENCOIS";21;11;2;34
2012;"LICINIO DE ALMEIDA (BA)";"BA";"LICINIO DE ALMEIDA";105;14;18;137
2012;"LIVRAMENTO DE NOSSA SENHORA (BA)";"BA";"LIVRAMENTO DE NOSSA SENHORA";438;48;103;589
2012;"LUIS EDUARDO MAGALHAES (BA)";"BA";"LUIS EDUARDO MAGALHAES";1517;66;126;1709
2012;"MACAJUBA (BA)";"BA";"MACAJUBA";24;18;34;76
2012;"MACARANI (BA)";"BA";"MACARANI";90;15;14;119
2012;"MACAUBAS (BA)";"BA";"MACAUBAS";208;26;210;444
2012;"MACURURE (BA)";"BA";"MACURURE";14;4;8;26
2012;"MADRE DE DEUS (BA)";"BA";"MADRE DE DEUS";83;47;31;161
2012;"MAETINGA (BA)";"BA";"MAETINGA";35;8;12;55
2012;"MAIQUINIQUE (BA)";"BA";"MAIQUINIQUE";52;5;10;67
2012;"MAIRI (BA)";"BA";"MAIRI";68;25;39;132
2012;"MALHADA (BA)";"BA";"MALHADA";35;11;18;64
2012;"MALHADA DE PEDRAS (BA)";"BA";"MALHADA DE PEDRAS";85;36;33;154
2012;"MANOEL VITORINO (BA)";"BA";"MANOEL VITORINO";55;15;9;79
2012;"MANSIDAO (BA)";"BA";"MANSIDAO";14;0;9;23
2012;"MARACAS (BA)";"BA";"MARACAS";209;18;50;277
2012;"MARAGOGIPE (BA)";"BA";"MARAGOGIPE";107;38;30;175
2012;"MARAU (BA)";"BA";"MARAU";17;3;3;23
2012;"MARCIONILIO SOUZA (BA)";"BA";"MARCIONILIO SOUZA";24;22;14;60
2012;"MASCOTE (BA)";"BA";"MASCOTE";44;4;9;57
2012;"MATA DE SAO JOAO (BA)";"BA";"MATA DE SAO JOAO";220;88;80;388
2012;"MATINA (BA)";"BA";"MATINA";18;17;25;60
2012;"MEDEIROS NETO (BA)";"BA";"MEDEIROS NETO";88;17;42;147
2012;"MIGUEL CALMON (BA)";"BA";"MIGUEL CALMON";83;18;38;139
2012;"MILAGRES (BA)";"BA";"MILAGRES";122;12;17;151
2012;"MIRANGABA (BA)";"BA";"MIRANGABA";46;14;33;93
2012;"MIRANTE (BA)";"BA";"MIRANTE";47;20;16;83
2012;"MONTE SANTO (BA)";"BA";"MONTE SANTO";178;44;133;355
2012;"MORPARA (BA)";"BA";"MORPARA";16;16;4;36
2012;"MORRO DO CHAPEU (BA)";"BA";"MORRO DO CHAPEU";142;38;20;200
2012;"MORTUGABA (BA)";"BA";"MORTUGABA";91;7;18;116
2012;"MUCUGE (BA)";"BA";"MUCUGE";109;12;52;173
2012;"MUCURI (BA)";"BA";"MUCURI";132;33;133;298
2012;"MULUNGU DO MORRO (BA)";"BA";"MULUNGU DO MORRO";73;8;12;93
2012;"MUNDO NOVO (BA)";"BA";"MUNDO NOVO";50;21;23;94
2012;"MUNIZ FERREIRA (BA)";"BA";"MUNIZ FERREIRA";47;52;5;104
2012;"MUQUEM DO SAO FRANCISCO (BA)";"BA";"MUQUEM DO SAO FRANCISCO";28;15;22;65
2012;"MURITIBA (BA)";"BA";"MURITIBA";129;38;32;199
2012;"MUTUIPE (BA)";"BA";"MUTUIPE";122;74;43;239
2012;"NAZARE (BA)";"BA";"NAZARE";244;60;34;338
2012;"NILO PECANHA (BA)";"BA";"NILO PECANHA";42;22;17;81
2012;"NORDESTINA (BA)";"BA";"NORDESTINA";41;9;19;69
2012;"NOVA CANAA (BA)";"BA";"NOVA CANAA";51;15;15;81
2012;"NOVA FATIMA (BA)";"BA";"NOVA FATIMA";61;6;9;76
2012;"NOVA IBIA (BA)";"BA";"NOVA IBIA";17;7;7;31
2012;"NOVA ITARANA (BA)";"BA";"NOVA ITARANA";34;7;6;47
2012;"NOVA REDENCAO (BA)";"BA";"NOVA REDENCAO";12;5;6;23
2012;"NOVA SOURE (BA)";"BA";"NOVA SOURE";58;15;26;99
2012;"NOVA VICOSA (BA)";"BA";"NOVA VICOSA";157;46;56;259
2012;"NOVO HORIZONTE (BA)";"BA";"NOVO HORIZONTE";45;9;13;67
2012;"NOVO TRIUNFO (BA)";"BA";"NOVO TRIUNFO";12;2;2;16
2012;"OLINDINA (BA)";"BA";"OLINDINA";89;33;59;181
2012;"OLIVEIRA DOS BREJINHOS (BA)";"BA";"OLIVEIRA DOS BREJINHOS";97;43;33;173
2012;"OURICANGAS (BA)";"BA";"OURICANGAS";34;11;24;69
2012;"OUROLANDIA (BA)";"BA";"OUROLANDIA";60;19;7;86
2012;"PALMAS DE MONTE ALTO (BA)";"BA";"PALMAS DE MONTE ALTO";56;2;34;92
2012;"PALMEIRAS (BA)";"BA";"PALMEIRAS";36;20;8;64
2012;"PARAMIRIM (BA)";"BA";"PARAMIRIM";170;17;61;248
2012;"PARATINGA (BA)";"BA";"PARATINGA";60;26;44;130
2012;"PARIPIRANGA (BA)";"BA";"PARIPIRANGA";72;5;50;127
2012;"PAU BRASIL (BA)";"BA";"PAU BRASIL";44;9;32;85
2012;"PAULO AFONSO (BA)";"BA";"PAULO AFONSO";917;324;339;1580
2012;"PE DE SERRA (BA)";"BA";"PE DE SERRA";65;11;19;95
2012;"PEDRAO (BA)";"BA";"PEDRAO";8;3;6;17
2012;"PEDRO ALEXANDRE (BA)";"BA";"PEDRO ALEXANDRE";2;4;8;14
2012;"PIATA (BA)";"BA";"PIATA";103;28;31;162
2012;"PILAO ARCADO (BA)";"BA";"PILAO ARCADO";40;36;8;84
2012;"PINDAI (BA)";"BA";"PINDAI";54;9;25;88
2012;"PINDOBACU (BA)";"BA";"PINDOBACU";56;22;26;104
2012;"PINTADAS (BA)";"BA";"PINTADAS";53;24;45;122
2012;"PIRAI DO NORTE (BA)";"BA";"PIRAI DO NORTE";25;4;2;31
2012;"PIRIPA (BA)";"BA";"PIRIPA";90;31;19;140
2012;"PIRITIBA (BA)";"BA";"PIRITIBA";59;22;19;100
2012;"PLANALTINO (BA)";"BA";"PLANALTINO";34;8;16;58
2012;"PLANALTO (BA)";"BA";"PLANALTO";121;34;57;212
2012;"POCOES (BA)";"BA";"POCOES";375;251;80;706
2012;"POJUCA (BA)";"BA";"POJUCA";348;87;60;495
2012;"PONTO NOVO (BA)";"BA";"PONTO NOVO";69;8;28;105
2012;"PORTO SEGURO (BA)";"BA";"PORTO SEGURO";600;252;410;1262
2012;"POTIRAGUA (BA)";"BA";"POTIRAGUA";43;7;5;55
2012;"PRADO (BA)";"BA";"PRADO";63;11;35;109
2012;"PRESIDENTE DUTRA (BA)";"BA";"PRESIDENTE DUTRA";55;5;7;67
2012;"PRESIDENTE JANIO QUADROS (BA)";"BA";"PRESIDENTE JANIO QUADROS";38;25;12;75
2012;"PRESIDENTE TANCREDO NEVES (BA)";"BA";"PRESIDENTE TANCREDO NEVES";191;110;31;332
2012;"QUEIMADAS (BA)";"BA";"QUEIMADAS";100;19;65;184
2012;"QUIJINGUE (BA)";"BA";"QUIJINGUE";39;22;52;113
2012;"QUIXABEIRA (BA)";"BA";"QUIXABEIRA";34;17;13;64
2012;"RAFAEL JAMBEIRO (BA)";"BA";"RAFAEL JAMBEIRO";72;24;51;147
2012;"REMANSO (BA)";"BA";"REMANSO";286;88;36;410
2012;"RETIROLANDIA (BA)";"BA";"RETIROLANDIA";71;9;12;92
2012;"RIACHAO DAS NEVES (BA)";"BA";"RIACHAO DAS NEVES";72;22;27;121
2012;"RIACHAO DO JACUIPE (BA)";"BA";"RIACHAO DO JACUIPE";267;44;36;347
2012;"RIACHO DE SANTANA (BA)";"BA";"RIACHO DE SANTANA";232;27;65;324
2012;"RIBEIRA DO AMPARO (BA)";"BA";"RIBEIRA DO AMPARO";11;15;35;61
2012;"RIBEIRA DO POMBAL (BA)";"BA";"RIBEIRA DO POMBAL";262;73;120;455
2012;"RIBEIRAO DO LARGO (BA)";"BA";"RIBEIRAO DO LARGO";34;15;6;55
2012;"RIO DE CONTAS (BA)";"BA";"RIO DE CONTAS";66;28;19;113
2012;"RIO DO ANTONIO (BA)";"BA";"RIO DO ANTONIO";138;24;17;179
2012;"RIO DO PIRES (BA)";"BA";"RIO DO PIRES";61;13;19;93
2012;"RIO REAL (BA)";"BA";"RIO REAL";184;21;51;256
2012;"RODELAS (BA)";"BA";"RODELAS";23;7;4;34
2012;"RUY BARBOSA (BA)";"BA";"RUY BARBOSA";113;53;18;184
2012;"SALINAS DA MARGARIDA (BA)";"BA";"SALINAS DA MARGARIDA";25;10;8;43
2012;"SALVADOR (BA)";"BA";"SALVADOR";17130;3854;7675;28659
2012;"SANTA BARBARA (BA)";"BA";"SANTA BARBARA";67;8;16;91
2012;"SANTA BRIGIDA (BA)";"BA";"SANTA BRIGIDA";25;26;25;76
2012;"SANTA CRUZ CABRALIA (BA)";"BA";"SANTA CRUZ CABRALIA";79;30;22;131
2012;"SANTA CRUZ DA VITORIA (BA)";"BA";"SANTA CRUZ DA VITORIA";13;4;5;22
2012;"SANTA INES (BA)";"BA";"SANTA INES";43;12;4;59
2012;"SANTA LUZIA (BA)";"BA";"SANTA LUZIA";37;2;7;46
2012;"SANTA MARIA DA VITORIA (BA)";"BA";"SANTA MARIA DA VITORIA";384;47;54;485
2012;"SANTA RITA DE CASSIA (BA)";"BA";"SANTA RITA DE CASSIA";64;9;11;84
2012;"SANTA TERESINHA (BA)";"BA";"SANTA TERESINHA";29;11;20;60
2012;"SANTALUZ (BA)";"BA";"SANTALUZ";235;28;41;304
2012;"SANTANA (BA)";"BA";"SANTANA";149;11;54;214
2012;"SANTANOPOLIS (BA)";"BA";"SANTANOPOLIS";23;10;11;44
2012;"SANTO AMARO (BA)";"BA";"SANTO AMARO";223;116;260;599
2012;"SANTO ANTONIO DE JESUS (BA)";"BA";"SANTO ANTONIO DE JESUS";2003;222;157;2382
2012;"SANTO ESTEVAO (BA)";"BA";"SANTO ESTEVAO";268;87;59;414
2012;"SAO DESIDERIO (BA)";"BA";"SAO DESIDERIO";264;22;69;355
2012;"SAO DOMINGOS (BA)";"BA";"SAO DOMINGOS";45;1;7;53
2012;"SAO FELIPE (BA)";"BA";"SAO FELIPE";220;55;39;314
2012;"SAO FELIX (BA)";"BA";"SAO FELIX";50;17;14;81
2012;"SAO FELIX DO CORIBE (BA)";"BA";"SAO FELIX DO CORIBE";121;20;16;157
2012;"SAO FRANCISCO DO CONDE (BA)";"BA";"SAO FRANCISCO DO CONDE";137;97;85;319
2012;"SAO GABRIEL (BA)";"BA";"SAO GABRIEL";28;9;14;51
2012;"SAO GONCALO DOS CAMPOS (BA)";"BA";"SAO GONCALO DOS CAMPOS";116;159;37;312
2012;"SAO JOSE DA VITORIA (BA)";"BA";"SAO JOSE DA VITORIA";12;0;4;16
2012;"SAO JOSE DO JACUIPE (BA)";"BA";"SAO JOSE DO JACUIPE";61;14;4;79
2012;"SAO MIGUEL DAS MATAS (BA)";"BA";"SAO MIGUEL DAS MATAS";49;6;14;69
2012;"SAO SEBASTIAO DO PASSE (BA)";"BA";"SAO SEBASTIAO DO PASSE";198;191;142;531
2012;"SAPEACU (BA)";"BA";"SAPEACU";93;73;33;199
2012;"SATIRO DIAS (BA)";"BA";"SATIRO DIAS";26;11;15;52
2012;"SAUBARA (BA)";"BA";"SAUBARA";22;21;3;46
2012;"SAUDE (BA)";"BA";"SAUDE";40;18;12;70
2012;"SEABRA (BA)";"BA";"SEABRA";398;107;138;643
2012;"SEBASTIAO LARANJEIRAS (BA)";"BA";"SEBASTIAO LARANJEIRAS";22;1;27;50
2012;"SENHOR DO BONFIM (BA)";"BA";"SENHOR DO BONFIM";581;133;179;893
2012;"SENTO SE (BA)";"BA";"SENTO SE";50;4;18;72
2012;"SERRA DO RAMALHO (BA)";"BA";"SERRA DO RAMALHO";80;24;28;132
2012;"SERRA DOURADA (BA)";"BA";"SERRA DOURADA";69;12;29;110
2012;"SERRA PRETA (BA)";"BA";"SERRA PRETA";39;14;57;110
2012;"SERRINHA (BA)";"BA";"SERRINHA";638;119;185;942
2012;"SERROLANDIA (BA)";"BA";"SERROLANDIA";51;42;16;109
2012;"SIMOES FILHO (BA)";"BA";"SIMOES FILHO";2307;470;793;3570
2012;"SITIO DO MATO (BA)";"BA";"SITIO DO MATO";26;10;20;56
2012;"SITIO DO QUINTO (BA)";"BA";"SITIO DO QUINTO";22;3;9;34
2012;"SOBRADINHO (BA)";"BA";"SOBRADINHO";89;45;39;173
2012;"SOUTO SOARES (BA)";"BA";"SOUTO SOARES";97;9;27;133
2012;"TABOCAS DO BREJO VELHO (BA)";"BA";"TABOCAS DO BREJO VELHO";32;2;10;44
2012;"TANHACU (BA)";"BA";"TANHACU";213;42;39;294
2012;"TANQUE NOVO (BA)";"BA";"TANQUE NOVO";267;7;36;310
2012;"TANQUINHO (BA)";"BA";"TANQUINHO";28;17;10;55
2012;"TAPEROA (BA)";"BA";"TAPEROA";119;26;11;156
2012;"TAPIRAMUTA (BA)";"BA";"TAPIRAMUTA";39;9;12;60
2012;"TEIXEIRA DE FREITAS (BA)";"BA";"TEIXEIRA DE FREITAS";1487;97;344;1928
2012;"TEODORO SAMPAIO (BA)";"BA";"TEODORO SAMPAIO";14;14;10;38
2012;"TEOFILANDIA (BA)";"BA";"TEOFILANDIA";86;32;33;151
2012;"TEOLANDIA (BA)";"BA";"TEOLANDIA";120;27;10;157
2012;"TERRA NOVA (BA)";"BA";"TERRA NOVA";18;7;20;45
2012;"TREMEDAL (BA)";"BA";"TREMEDAL";45;21;40;106
2012;"TUCANO (BA)";"BA";"TUCANO";269;47;87;403
2012;"UAUA (BA)";"BA";"UAUA";167;22;26;215
2012;"UBAIRA (BA)";"BA";"UBAIRA";95;25;41;161
2012;"UBAITABA (BA)";"BA";"UBAITABA";166;11;16;193
2012;"UBATA (BA)";"BA";"UBATA";212;18;15;245
2012;"UIBAI (BA)";"BA";"UIBAI";42;11;8;61
2012;"UMBURANAS (BA)";"BA";"UMBURANAS";40;19;17;76
2012;"UNA (BA)";"BA";"UNA";60;7;24;91
2012;"URANDI (BA)";"BA";"URANDI";102;18;24;144
2012;"URUCUCA (BA)";"BA";"URUCUCA";99;3;16;118
2012;"UTINGA (BA)";"BA";"UTINGA";63;14;8;85
2012;"VALENCA (BA)";"BA";"VALENCA";699;147;124;970
2012;"VALENTE (BA)";"BA";"VALENTE";142;14;26;182
2012;"VARZEA DA ROCA (BA)";"BA";"VARZEA DA ROCA";40;11;17;68
2012;"VARZEA DO POCO (BA)";"BA";"VARZEA DO POCO";61;16;13;90
2012;"VARZEA NOVA (BA)";"BA";"VARZEA NOVA";54;10;11;75
2012;"VARZEDO (BA)";"BA";"VARZEDO";60;9;19;88
2012;"VERA CRUZ (BA)";"BA";"VERA CRUZ";166;167;27;360
2012;"VEREDA (BA)";"BA";"VEREDA";11;3;2;16
2012;"VITORIA DA CONQUISTA (BA)";"BA";"VITORIA DA CONQUISTA";4018;729;1209;5956
2012;"WAGNER (BA)";"BA";"WAGNER";28;4;14;46
2012;"WANDERLEY (BA)";"BA";"WANDERLEY";61;5;18;84
2012;"WENCESLAU GUIMARAES (BA)";"BA";"WENCESLAU GUIMARAES";125;13;13;151
2012;"XIQUE XIQUE (BA)";"BA";"XIQUE XIQUE";138;19;13;170
2012;"ABAIARA (CE)";"CE";"ABAIARA";11;26;5;42
2012;"ACARAPE (CE)";"CE";"ACARAPE";96;19;131;246
2012;"ACARAU (CE)";"CE";"ACARAU";203;18;44;265
2012;"ACOPIARA (CE)";"CE";"ACOPIARA";323;21;34;378
2012;"AIUABA (CE)";"CE";"AIUABA";22;5;3;30
2012;"ALCANTARAS (CE)";"CE";"ALCANTARAS";40;12;18;70
2012;"ALTANEIRA (CE)";"CE";"ALTANEIRA";19;8;3;30
2012;"ALTO SANTO (CE)";"CE";"ALTO SANTO";148;11;16;175
2012;"AMONTADA (CE)";"CE";"AMONTADA";173;23;27;223
2012;"ANTONINA DO NORTE (CE)";"CE";"ANTONINA DO NORTE";37;6;3;46
2012;"APUIARES (CE)";"CE";"APUIARES";72;8;4;84
2012;"AQUIRAZ (CE)";"CE";"AQUIRAZ";523;131;86;740
2012;"ARACATI (CE)";"CE";"ARACATI";443;85;126;654
2012;"ARACOIABA (CE)";"CE";"ARACOIABA";108;10;15;133
2012;"ARARENDA (CE)";"CE";"ARARENDA";28;4;3;35
2012;"ARARIPE (CE)";"CE";"ARARIPE";56;89;28;173
2012;"ARATUBA (CE)";"CE";"ARATUBA";62;3;12;77
2012;"ARNEIROZ (CE)";"CE";"ARNEIROZ";28;7;2;37
2012;"ASSARE (CE)";"CE";"ASSARE";90;26;6;122
2012;"AURORA (CE)";"CE";"AURORA";80;34;9;123
2012;"BAIXIO (CE)";"CE";"BAIXIO";16;16;5;37
2012;"BANABUIU (CE)";"CE";"BANABUIU";102;12;18;132
2012;"BARBALHA (CE)";"CE";"BARBALHA";316;69;79;464
2012;"BARREIRA (CE)";"CE";"BARREIRA";111;9;10;130
2012;"BARRO (CE)";"CE";"BARRO";56;31;13;100
2012;"BARROQUINHA (CE)";"CE";"BARROQUINHA";35;7;5;47
2012;"BATURITE (CE)";"CE";"BATURITE";208;20;32;260
2012;"BEBERIBE (CE)";"CE";"BEBERIBE";213;52;56;321
2012;"BELA CRUZ (CE)";"CE";"BELA CRUZ";103;9;28;140
2012;"BOA VIAGEM (CE)";"CE";"BOA VIAGEM";409;17;45;471
2012;"BREJO SANTO (CE)";"CE";"BREJO SANTO";359;75;52;486
2012;"CAMOCIM (CE)";"CE";"CAMOCIM";194;41;34;269
2012;"CAMPOS SALES (CE)";"CE";"CAMPOS SALES";197;73;44;314
2012;"CANINDE (CE)";"CE";"CANINDE";521;24;63;608
2012;"CAPISTRANO (CE)";"CE";"CAPISTRANO";62;7;11;80
2012;"CARIDADE (CE)";"CE";"CARIDADE";67;6;13;86
2012;"CARIRE (CE)";"CE";"CARIRE";66;17;23;106
2012;"CARIRIACU (CE)";"CE";"CARIRIACU";53;36;11;100
2012;"CARIUS (CE)";"CE";"CARIUS";53;22;6;81
2012;"CARNAUBAL (CE)";"CE";"CARNAUBAL";74;21;9;104
2012;"CASCAVEL (CE)";"CE";"CASCAVEL";441;48;103;592
2012;"CATARINA (CE)";"CE";"CATARINA";39;5;1;45
2012;"CATUNDA (CE)";"CE";"CATUNDA";31;10;5;46
2012;"CAUCAIA (CE)";"CE";"CAUCAIA";1486;215;350;2051
2012;"CEDRO (CE)";"CE";"CEDRO";82;35;28;145
2012;"CHAVAL (CE)";"CE";"CHAVAL";29;13;7;49
2012;"CHORO (CE)";"CE";"CHORO";50;10;18;78
2012;"CHOROZINHO (CE)";"CE";"CHOROZINHO";124;14;39;177
2012;"COREAU (CE)";"CE";"COREAU";103;13;28;144
2012;"CRATEUS (CE)";"CE";"CRATEUS";331;66;74;471
2012;"CRATO (CE)";"CE";"CRATO";957;128;93;1178
2012;"CROATA (CE)";"CE";"CROATA";56;18;11;85
2012;"CRUZ (CE)";"CE";"CRUZ";127;23;61;211
2012;"DEPUTADO IRAPUAN PINHEIRO (CE)";"CE";"DEPUTADO IRAPUAN PINHEIRO";23;5;10;38
2012;"ERERE (CE)";"CE";"ERERE";2;1;2;5
2012;"EUSEBIO (CE)";"CE";"EUSEBIO";1079;58;56;1193
2012;"FARIAS BRITO (CE)";"CE";"FARIAS BRITO";86;30;17;133
2012;"FORQUILHA (CE)";"CE";"FORQUILHA";112;28;33;173
2012;"FORTALEZA (CE)";"CE";"FORTALEZA";20753;3057;6361;30171
2012;"FORTIM (CE)";"CE";"FORTIM";28;29;17;74
2012;"FRECHEIRINHA (CE)";"CE";"FRECHEIRINHA";81;11;18;110
2012;"GENERAL SAMPAIO (CE)";"CE";"GENERAL SAMPAIO";33;2;3;38
2012;"GRACA (CE)";"CE";"GRACA";25;7;6;38
2012;"GRANJA (CE)";"CE";"GRANJA";172;33;22;227
2012;"GRANJEIRO (CE)";"CE";"GRANJEIRO";7;4;2;13
2012;"GROAIRAS (CE)";"CE";"GROAIRAS";57;22;17;96
2012;"GUAIUBA (CE)";"CE";"GUAIUBA";77;24;10;111
2012;"GUARACIABA DO NORTE (CE)";"CE";"GUARACIABA DO NORTE";389;15;18;422
2012;"GUARAMIRANGA (CE)";"CE";"GUARAMIRANGA";34;1;6;41
2012;"HIDROLANDIA (CE)";"CE";"HIDROLANDIA";130;17;14;161
2012;"HORIZONTE (CE)";"CE";"HORIZONTE";384;85;77;546
2012;"IBARETAMA (CE)";"CE";"IBARETAMA";59;7;18;84
2012;"IBIAPINA (CE)";"CE";"IBIAPINA";130;24;20;174
2012;"IBICUITINGA (CE)";"CE";"IBICUITINGA";75;9;9;93
2012;"ICAPUI (CE)";"CE";"ICAPUI";75;23;56;154
2012;"ICO (CE)";"CE";"ICO";311;64;56;431
2012;"IGUATU (CE)";"CE";"IGUATU";980;62;104;1146
2012;"INDEPENDENCIA (CE)";"CE";"INDEPENDENCIA";195;3;17;215
2012;"IPAPORANGA (CE)";"CE";"IPAPORANGA";26;4;4;34
2012;"IPAUMIRIM (CE)";"CE";"IPAUMIRIM";238;58;33;329
2012;"IPU (CE)";"CE";"IPU";250;28;27;305
2012;"IPUEIRAS (CE)";"CE";"IPUEIRAS";80;26;8;114
2012;"IRACEMA (CE)";"CE";"IRACEMA";55;10;10;75
2012;"IRAUCUBA (CE)";"CE";"IRAUCUBA";96;12;21;129
2012;"ITAICABA (CE)";"CE";"ITAICABA";31;5;11;47
2012;"ITAITINGA (CE)";"CE";"ITAITINGA";347;56;23;426
2012;"ITAPAJE (CE)";"CE";"ITAPAJE";267;31;26;324
2012;"ITAPIPOCA (CE)";"CE";"ITAPIPOCA";777;27;53;857
2012;"ITAPIUNA (CE)";"CE";"ITAPIUNA";68;4;16;88
2012;"ITAREMA (CE)";"CE";"ITAREMA";112;8;33;153
2012;"ITATIRA (CE)";"CE";"ITATIRA";114;5;12;131
2012;"JAGUARETAMA (CE)";"CE";"JAGUARETAMA";92;5;13;110
2012;"JAGUARIBARA (CE)";"CE";"JAGUARIBARA";73;8;8;89
2012;"JAGUARIBE (CE)";"CE";"JAGUARIBE";361;27;22;410
2012;"JAGUARUANA (CE)";"CE";"JAGUARUANA";244;12;12;268
2012;"JARDIM (CE)";"CE";"JARDIM";88;62;10;160
2012;"JATI (CE)";"CE";"JATI";23;26;6;55
2012;"JIJOCA DE JERICOACOARA (CE)";"CE";"JIJOCA DE JERICOACOARA";66;10;11;87
2012;"JUAZEIRO DO NORTE (CE)";"CE";"JUAZEIRO DO NORTE";1706;179;218;2103
2012;"JUCAS (CE)";"CE";"JUCAS";97;6;22;125
2012;"LAVRAS DA MANGABEIRA (CE)";"CE";"LAVRAS DA MANGABEIRA";94;20;19;133
2012;"LIMOEIRO DO NORTE (CE)";"CE";"LIMOEIRO DO NORTE";675;27;120;822
2012;"MADALENA (CE)";"CE";"MADALENA";96;4;14;114
2012;"MARACANAU (CE)";"CE";"MARACANAU";1496;210;334;2040
2012;"MARANGUAPE (CE)";"CE";"MARANGUAPE";547;118;202;867
2012;"MARCO (CE)";"CE";"MARCO";232;15;13;260
2012;"MARTINOPOLE (CE)";"CE";"MARTINOPOLE";26;11;2;39
2012;"MASSAPE (CE)";"CE";"MASSAPE";88;25;73;186
2012;"MAURITI (CE)";"CE";"MAURITI";126;55;39;220
2012;"MERUOCA (CE)";"CE";"MERUOCA";34;11;15;60
2012;"MILAGRES (CE)";"CE";"MILAGRES";92;36;19;147
2012;"MILHA (CE)";"CE";"MILHA";65;5;13;83
2012;"MIRAIMA (CE)";"CE";"MIRAIMA";25;0;5;30
2012;"MISSAO VELHA (CE)";"CE";"MISSAO VELHA";203;61;10;274
2012;"MOMBACA (CE)";"CE";"MOMBACA";230;15;15;260
2012;"MONSENHOR TABOSA (CE)";"CE";"MONSENHOR TABOSA";72;8;3;83
2012;"MORADA NOVA (CE)";"CE";"MORADA NOVA";437;49;72;558
2012;"MORAUJO (CE)";"CE";"MORAUJO";22;4;10;36
2012;"MORRINHOS (CE)";"CE";"MORRINHOS";76;13;21;110
2012;"MUCAMBO (CE)";"CE";"MUCAMBO";35;19;9;63
2012;"MULUNGU (CE)";"CE";"MULUNGU";70;7;9;86
2012;"NOVA OLINDA (CE)";"CE";"NOVA OLINDA";105;32;8;145
2012;"NOVA RUSSAS (CE)";"CE";"NOVA RUSSAS";183;16;7;206
2012;"NOVO ORIENTE (CE)";"CE";"NOVO ORIENTE";67;28;13;108
2012;"OCARA (CE)";"CE";"OCARA";123;13;41;177
2012;"OROS (CE)";"CE";"OROS";123;23;26;172
2012;"PACAJUS (CE)";"CE";"PACAJUS";619;88;181;888
2012;"PACATUBA (CE)";"CE";"PACATUBA";189;68;20;277
2012;"PACOTI (CE)";"CE";"PACOTI";97;4;13;114
2012;"PACUJA (CE)";"CE";"PACUJA";30;4;11;45
2012;"PALHANO (CE)";"CE";"PALHANO";54;14;12;80
2012;"PALMACIA (CE)";"CE";"PALMACIA";39;12;14;65
2012;"PARACURU (CE)";"CE";"PARACURU";185;23;30;238
2012;"PARAIPABA (CE)";"CE";"PARAIPABA";212;18;20;250
2012;"PARAMBU (CE)";"CE";"PARAMBU";201;3;14;218
2012;"PARAMOTI (CE)";"CE";"PARAMOTI";53;4;11;68
2012;"PEDRA BRANCA (CE)";"CE";"PEDRA BRANCA";272;20;29;321
2012;"PENAFORTE (CE)";"CE";"PENAFORTE";34;36;19;89
2012;"PENTECOSTE (CE)";"CE";"PENTECOSTE";231;13;20;264
2012;"PEREIRO (CE)";"CE";"PEREIRO";82;12;27;121
2012;"PINDORETAMA (CE)";"CE";"PINDORETAMA";149;20;13;182
2012;"PIQUET CARNEIRO (CE)";"CE";"PIQUET CARNEIRO";36;6;9;51
2012;"PIRES FERREIRA (CE)";"CE";"PIRES FERREIRA";16;5;3;24
2012;"PORANGA (CE)";"CE";"PORANGA";18;10;2;30
2012;"PORTEIRAS (CE)";"CE";"PORTEIRAS";23;139;18;180
2012;"POTENGI (CE)";"CE";"POTENGI";25;6;5;36
2012;"POTIRETAMA (CE)";"CE";"POTIRETAMA";27;4;6;37
2012;"QUITERIANOPOLIS (CE)";"CE";"QUITERIANOPOLIS";56;12;6;74
2012;"QUIXADA (CE)";"CE";"QUIXADA";673;47;86;806
2012;"QUIXELO (CE)";"CE";"QUIXELO";60;18;26;104
2012;"QUIXERAMOBIM (CE)";"CE";"QUIXERAMOBIM";437;33;92;562
2012;"QUIXERE (CE)";"CE";"QUIXERE";196;14;41;251
2012;"REDENCAO (CE)";"CE";"REDENCAO";206;35;36;277
2012;"RERIUTABA (CE)";"CE";"RERIUTABA";78;19;22;119
2012;"RUSSAS (CE)";"CE";"RUSSAS";780;46;101;927
2012;"SABOEIRO (CE)";"CE";"SABOEIRO";38;10;4;52
2012;"SALITRE (CE)";"CE";"SALITRE";65;8;26;99
2012;"SANTA QUITERIA (CE)";"CE";"SANTA QUITERIA";272;33;16;321
2012;"SANTANA DO ACARAU (CE)";"CE";"SANTANA DO ACARAU";150;30;26;206
2012;"SANTANA DO CARIRI (CE)";"CE";"SANTANA DO CARIRI";64;26;13;103
2012;"SAO BENEDITO (CE)";"CE";"SAO BENEDITO";410;89;47;546
2012;"SAO GONCALO DO AMARANTE (CE)";"CE";"SAO GONCALO DO AMARANTE";308;71;147;526
2012;"SAO JOAO DO JAGUARIBE (CE)";"CE";"SAO JOAO DO JAGUARIBE";47;3;11;61
2012;"SAO LUIS DO CURU (CE)";"CE";"SAO LUIS DO CURU";53;4;11;68
2012;"SENADOR POMPEU (CE)";"CE";"SENADOR POMPEU";151;14;38;203
2012;"SENADOR SA (CE)";"CE";"SENADOR SA";22;5;11;38
2012;"SOBRAL (CE)";"CE";"SOBRAL";1462;218;327;2007
2012;"SOLONOPOLE (CE)";"CE";"SOLONOPOLE";85;5;15;105
2012;"TABULEIRO DO NORTE (CE)";"CE";"TABULEIRO DO NORTE";338;34;44;416
2012;"TAMBORIL (CE)";"CE";"TAMBORIL";82;17;23;122
2012;"TARRAFAS (CE)";"CE";"TARRAFAS";17;4;6;27
2012;"TAUA (CE)";"CE";"TAUA";410;36;41;487
2012;"TEJUCUOCA (CE)";"CE";"TEJUCUOCA";75;4;11;90
2012;"TIANGUA (CE)";"CE";"TIANGUA";1335;177;143;1655
2012;"TRAIRI (CE)";"CE";"TRAIRI";187;21;36;244
2012;"TURURU (CE)";"CE";"TURURU";48;6;6;60
2012;"UBAJARA (CE)";"CE";"UBAJARA";277;18;50;345
2012;"UMARI (CE)";"CE";"UMARI";7;3;5;15
2012;"UMIRIM (CE)";"CE";"UMIRIM";50;34;20;104
2012;"URUBURETAMA (CE)";"CE";"URUBURETAMA";69;9;35;113
2012;"URUOCA (CE)";"CE";"URUOCA";58;11;15;84
2012;"VARJOTA (CE)";"CE";"VARJOTA";122;30;6;158
2012;"VARZEA ALEGRE (CE)";"CE";"VARZEA ALEGRE";231;41;43;315
2012;"VICOSA DO CEARA (CE)";"CE";"VICOSA DO CEARA";322;36;68;426
2012;"BRASILIA (DF)";"DF";"BRASILIA";21019;4731;8888;34638
2012;"AFONSO CLAUDIO (ES)";"ES";"AFONSO CLAUDIO";537;81;103;721
2012;"AGUA DOCE DO NORTE (ES)";"ES";"AGUA DOCE DO NORTE";104;18;24;146
2012;"AGUIA BRANCA (ES)";"ES";"AGUIA BRANCA";141;4;23;168
2012;"ALEGRE (ES)";"ES";"ALEGRE";212;37;26;275
2012;"ALFREDO CHAVES (ES)";"ES";"ALFREDO CHAVES";426;27;34;487
2012;"ALTO RIO NOVO (ES)";"ES";"ALTO RIO NOVO";109;22;22;153
2012;"ANCHIETA (ES)";"ES";"ANCHIETA";291;72;52;415
2012;"APIACA (ES)";"ES";"APIACA";78;24;4;106
2012;"ARACRUZ (ES)";"ES";"ARACRUZ";1308;191;544;2043
2012;"ATILIO VIVACQUA (ES)";"ES";"ATILIO VIVACQUA";190;10;20;220
2012;"BAIXO GUANDU (ES)";"ES";"BAIXO GUANDU";524;28;64;616
2012;"BARRA DE SAO FRANCISCO (ES)";"ES";"BARRA DE SAO FRANCISCO";518;31;116;665
2012;"BOA ESPERANCA (ES)";"ES";"BOA ESPERANCA";235;14;42;291
2012;"BOM JESUS DO NORTE (ES)";"ES";"BOM JESUS DO NORTE";182;32;21;235
2012;"BREJETUBA (ES)";"ES";"BREJETUBA";215;17;47;279
2012;"CACHOEIRO DE ITAPEMIRIM (ES)";"ES";"CACHOEIRO DE ITAPEMIRIM";4744;205;1939;6888
2012;"CARIACICA (ES)";"ES";"CARIACICA";5171;573;1530;7274
2012;"CASTELO (ES)";"ES";"CASTELO";1265;88;73;1426
2012;"COLATINA (ES)";"ES";"COLATINA";2399;164;510;3073
2012;"CONCEICAO DA BARRA (ES)";"ES";"CONCEICAO DA BARRA";239;15;122;376
2012;"CONCEICAO DO CASTELO (ES)";"ES";"CONCEICAO DO CASTELO";271;54;49;374
2012;"DIVINO DE SAO LOURENCO (ES)";"ES";"DIVINO DE SAO LOURENCO";57;8;9;74
2012;"DOMINGOS MARTINS (ES)";"ES";"DOMINGOS MARTINS";1051;105;73;1229
2012;"DORES DO RIO PRETO (ES)";"ES";"DORES DO RIO PRETO";133;21;14;168
2012;"ECOPORANGA (ES)";"ES";"ECOPORANGA";160;37;80;277
2012;"FUNDAO (ES)";"ES";"FUNDAO";317;51;38;406
2012;"GOVERNADOR LINDENBERG (ES)";"ES";"GOVERNADOR LINDENBERG";267;6;4;277
2012;"GUACUI (ES)";"ES";"GUACUI";469;47;47;563
2012;"GUARAPARI (ES)";"ES";"GUARAPARI";1073;303;218;1594
2012;"IBATIBA (ES)";"ES";"IBATIBA";478;42;58;578
2012;"IBIRACU (ES)";"ES";"IBIRACU";368;30;69;467
2012;"IBITIRAMA (ES)";"ES";"IBITIRAMA";132;24;17;173
2012;"ICONHA (ES)";"ES";"ICONHA";708;19;63;790
2012;"IRUPI (ES)";"ES";"IRUPI";222;34;22;278
2012;"ITAGUACU (ES)";"ES";"ITAGUACU";271;11;59;341
2012;"ITAPEMIRIM (ES)";"ES";"ITAPEMIRIM";497;43;66;606
2012;"ITARANA (ES)";"ES";"ITARANA";344;27;38;409
2012;"IUNA (ES)";"ES";"IUNA";409;53;78;540
2012;"JAGUARE (ES)";"ES";"JAGUARE";418;20;74;512
2012;"JERONIMO MONTEIRO (ES)";"ES";"JERONIMO MONTEIRO";92;20;16;128
2012;"JOAO NEIVA (ES)";"ES";"JOAO NEIVA";316;22;29;367
2012;"LARANJA DA TERRA (ES)";"ES";"LARANJA DA TERRA";282;19;26;327
2012;"LINHARES (ES)";"ES";"LINHARES";2754;157;451;3362
2012;"MANTENOPOLIS (ES)";"ES";"MANTENOPOLIS";152;21;26;199
2012;"MARATAIZES (ES)";"ES";"MARATAIZES";871;40;59;970
2012;"MARECHAL FLORIANO (ES)";"ES";"MARECHAL FLORIANO";642;42;30;714
2012;"MARILANDIA (ES)";"ES";"MARILANDIA";380;18;18;416
2012;"MIMOSO DO SUL (ES)";"ES";"MIMOSO DO SUL";271;38;72;381
2012;"MONTANHA (ES)";"ES";"MONTANHA";196;10;32;238
2012;"MUCURICI (ES)";"ES";"MUCURICI";53;8;17;78
2012;"MUNIZ FREIRE (ES)";"ES";"MUNIZ FREIRE";188;41;43;272
2012;"MUQUI (ES)";"ES";"MUQUI";161;17;23;201
2012;"NOVA VENECIA (ES)";"ES";"NOVA VENECIA";899;42;174;1115
2012;"PANCAS (ES)";"ES";"PANCAS";283;29;16;328
2012;"PEDRO CANARIO (ES)";"ES";"PEDRO CANARIO";441;41;226;708
2012;"PINHEIROS (ES)";"ES";"PINHEIROS";298;24;124;446
2012;"PIUMA (ES)";"ES";"PIUMA";224;33;15;272
2012;"PONTO BELO (ES)";"ES";"PONTO BELO";57;7;16;80
2012;"PRESIDENTE KENNEDY (ES)";"ES";"PRESIDENTE KENNEDY";261;16;21;298
2012;"RIO BANANAL (ES)";"ES";"RIO BANANAL";561;21;47;629
2012;"RIO NOVO DO SUL (ES)";"ES";"RIO NOVO DO SUL";326;11;25;362
2012;"SANTA LEOPOLDINA (ES)";"ES";"SANTA LEOPOLDINA";403;33;30;466
2012;"SANTA MARIA DE JETIBA (ES)";"ES";"SANTA MARIA DE JETIBA";2009;93;62;2164
2012;"SANTA TERESA (ES)";"ES";"SANTA TERESA";677;43;97;817
2012;"SAO DOMINGOS DO NORTE (ES)";"ES";"SAO DOMINGOS DO NORTE";225;10;24;259
2012;"SAO GABRIEL DA PALHA (ES)";"ES";"SAO GABRIEL DA PALHA";655;18;104;777
2012;"SAO JOSE DO CALCADO (ES)";"ES";"SAO JOSE DO CALCADO";86;15;16;117
2012;"SAO MATEUS (ES)";"ES";"SAO MATEUS";1062;106;371;1539
2012;"SAO ROQUE DO CANAA (ES)";"ES";"SAO ROQUE DO CANAA";299;17;25;341
2012;"SERRA (ES)";"ES";"SERRA";8543;598;2199;11340
2012;"SOORETAMA (ES)";"ES";"SOORETAMA";315;19;54;388
2012;"VARGEM ALTA (ES)";"ES";"VARGEM ALTA";461;25;54;540
2012;"VENDA NOVA DO IMIGRANTE (ES)";"ES";"VENDA NOVA DO IMIGRANTE";792;27;112;931
2012;"VIANA (ES)";"ES";"VIANA";1163;91;330;1584
2012;"VILA PAVAO (ES)";"ES";"VILA PAVAO";136;4;22;162
2012;"VILA VALERIO (ES)";"ES";"VILA VALERIO";352;8;34;394
2012;"VILA VELHA (ES)";"ES";"VILA VELHA";4209;818;763;5790
2012;"VITORIA (ES)";"ES";"VITORIA";3735;1078;938;5751
2012;"ABADIA DE GOIAS (GO)";"GO";"ABADIA DE GOIAS";78;7;5;90
2012;"ABADIANIA (GO)";"GO";"ABADIANIA";293;27;21;341
2012;"ACREUNA (GO)";"GO";"ACREUNA";386;9;91;486
2012;"ADELANDIA (GO)";"GO";"ADELANDIA";32;1;6;39
2012;"AGUA FRIA DE GOIAS (GO)";"GO";"AGUA FRIA DE GOIAS";35;8;12;55
2012;"AGUA LIMPA (GO)";"GO";"AGUA LIMPA";17;7;2;26
2012;"AGUAS LINDAS DE GOIAS (GO)";"GO";"AGUAS LINDAS DE GOIAS";799;130;450;1379
2012;"ALEXANIA (GO)";"GO";"ALEXANIA";357;31;29;417
2012;"ALOANDIA (GO)";"GO";"ALOANDIA";26;3;2;31
2012;"ALTO HORIZONTE (GO)";"GO";"ALTO HORIZONTE";38;5;16;59
2012;"ALTO PARAISO DE GOIAS (GO)";"GO";"ALTO PARAISO DE GOIAS";57;9;12;78
2012;"ALVORADA DO NORTE (GO)";"GO";"ALVORADA DO NORTE";129;5;11;145
2012;"AMARALINA (GO)";"GO";"AMARALINA";12;2;6;20
2012;"AMERICANO DO BRASIL (GO)";"GO";"AMERICANO DO BRASIL";51;7;13;71
2012;"AMORINOPOLIS (GO)";"GO";"AMORINOPOLIS";37;3;8;48
2012;"ANAPOLIS (GO)";"GO";"ANAPOLIS";10000;284;1562;11846
2012;"ANHANGUERA (GO)";"GO";"ANHANGUERA";4;2;1;7
2012;"ANICUNS (GO)";"GO";"ANICUNS";372;22;109;503
2012;"APARECIDA DE GOIANIA (GO)";"GO";"APARECIDA DE GOIANIA";6239;292;568;7099
2012;"APARECIDA DO RIO DOCE (GO)";"GO";"APARECIDA DO RIO DOCE";43;4;10;57
2012;"APORE (GO)";"GO";"APORE";63;16;25;104
2012;"ARACU (GO)";"GO";"ARACU";24;4;7;35
2012;"ARAGARCAS (GO)";"GO";"ARAGARCAS";449;9;29;487
2012;"ARAGOIANIA (GO)";"GO";"ARAGOIANIA";83;1;9;93
2012;"ARAGUAPAZ (GO)";"GO";"ARAGUAPAZ";89;7;13;109
2012;"ARENOPOLIS (GO)";"GO";"ARENOPOLIS";10;6;4;20
2012;"ARUANA (GO)";"GO";"ARUANA";43;1;12;56
2012;"AURILANDIA (GO)";"GO";"AURILANDIA";25;5;1;31
2012;"AVELINOPOLIS (GO)";"GO";"AVELINOPOLIS";50;3;1;54
2012;"BALIZA (GO)";"GO";"BALIZA";5;0;5;10
2012;"BARRO ALTO (GO)";"GO";"BARRO ALTO";148;21;72;241
2012;"BELA VISTA DE GOIAS (GO)";"GO";"BELA VISTA DE GOIAS";378;18;37;433
2012;"BOM JARDIM DE GOIAS (GO)";"GO";"BOM JARDIM DE GOIAS";116;7;16;139
2012;"BOM JESUS (GO)";"GO";"BOM JESUS";355;43;71;469
2012;"BONFINOPOLIS (GO)";"GO";"BONFINOPOLIS";57;4;8;69
2012;"BONOPOLIS (GO)";"GO";"BONOPOLIS";13;3;3;19
2012;"BRAZABRANTES (GO)";"GO";"BRAZABRANTES";60;1;2;63
2012;"BRITANIA (GO)";"GO";"BRITANIA";81;4;4;89
2012;"BURITI ALEGRE (GO)";"GO";"BURITI ALEGRE";189;35;11;235
2012;"BURITI DE GOIAS (GO)";"GO";"BURITI DE GOIAS";17;11;2;30
2012;"BURITINOPOLIS (GO)";"GO";"BURITINOPOLIS";18;2;6;26
2012;"CABECEIRAS (GO)";"GO";"CABECEIRAS";168;9;23;200
2012;"CACHOEIRA ALTA (GO)";"GO";"CACHOEIRA ALTA";133;21;35;189
2012;"CACHOEIRA DE GOIAS (GO)";"GO";"CACHOEIRA DE GOIAS";6;1;1;8
2012;"CACHOEIRA DOURADA (GO)";"GO";"CACHOEIRA DOURADA";84;12;33;129
2012;"CACU (GO)";"GO";"CACU";242;16;31;289
2012;"CAIAPONIA (GO)";"GO";"CAIAPONIA";171;3;8;182
2012;"CALDAS NOVAS (GO)";"GO";"CALDAS NOVAS";696;96;104;896
2012;"CALDAZINHA (GO)";"GO";"CALDAZINHA";33;3;2;38
2012;"CAMPESTRE DE GOIAS (GO)";"GO";"CAMPESTRE DE GOIAS";39;2;5;46
2012;"CAMPINACU (GO)";"GO";"CAMPINACU";17;2;7;26
2012;"CAMPINORTE (GO)";"GO";"CAMPINORTE";159;15;14;188
2012;"CAMPO ALEGRE DE GOIAS (GO)";"GO";"CAMPO ALEGRE DE GOIAS";131;10;21;162
2012;"CAMPO LIMPO DE GOIAS (GO)";"GO";"CAMPO LIMPO DE GOIAS";118;0;5;123
2012;"CAMPOS BELOS (GO)";"GO";"CAMPOS BELOS";216;16;45;277
2012;"CAMPOS VERDES (GO)";"GO";"CAMPOS VERDES";35;4;1;40
2012;"CARMO DO RIO VERDE (GO)";"GO";"CARMO DO RIO VERDE";84;10;56;150
2012;"CASTELANDIA (GO)";"GO";"CASTELANDIA";52;6;8;66
2012;"CATALAO (GO)";"GO";"CATALAO";1708;156;269;2133
2012;"CATURAI (GO)";"GO";"CATURAI";47;2;8;57
2012;"CAVALCANTE (GO)";"GO";"CAVALCANTE";36;3;4;43
2012;"CERES (GO)";"GO";"CERES";478;22;38;538
2012;"CEZARINA (GO)";"GO";"CEZARINA";111;8;20;139
2012;"CHAPADAO DO CEU (GO)";"GO";"CHAPADAO DO CEU";223;20;17;260
2012;"CIDADE OCIDENTAL (GO)";"GO";"CIDADE OCIDENTAL";120;53;61;234
2012;"COCALZINHO DE GOIAS (GO)";"GO";"COCALZINHO DE GOIAS";155;26;22;203
2012;"COLINAS DO SUL (GO)";"GO";"COLINAS DO SUL";9;3;2;14
2012;"CORREGO DO OURO (GO)";"GO";"CORREGO DO OURO";18;2;3;23
2012;"CORUMBA DE GOIAS (GO)";"GO";"CORUMBA DE GOIAS";65;13;21;99
2012;"CORUMBAIBA (GO)";"GO";"CORUMBAIBA";136;23;11;170
2012;"CRISTALINA (GO)";"GO";"CRISTALINA";1882;101;436;2419
2012;"CRISTIANOPOLIS (GO)";"GO";"CRISTIANOPOLIS";52;10;1;63
2012;"CRIXAS (GO)";"GO";"CRIXAS";140;16;17;173
2012;"CROMINIA (GO)";"GO";"CROMINIA";45;4;2;51
2012;"CUMARI (GO)";"GO";"CUMARI";28;7;0;35
2012;"DAMIANOPOLIS (GO)";"GO";"DAMIANOPOLIS";19;2;9;30
2012;"DAMOLANDIA (GO)";"GO";"DAMOLANDIA";43;5;4;52
2012;"DAVINOPOLIS (GO)";"GO";"DAVINOPOLIS";29;5;3;37
2012;"DIORAMA (GO)";"GO";"DIORAMA";8;7;6;21
2012;"DIVINOPOLIS DE GOIAS (GO)";"GO";"DIVINOPOLIS DE GOIAS";24;1;7;32
2012;"DOVERLANDIA (GO)";"GO";"DOVERLANDIA";100;5;33;138
2012;"EDEALINA (GO)";"GO";"EDEALINA";65;6;8;79
2012;"EDEIA (GO)";"GO";"EDEIA";169;9;14;192
2012;"ESTRELA DO NORTE (GO)";"GO";"ESTRELA DO NORTE";26;2;3;31
2012;"FAINA (GO)";"GO";"FAINA";48;15;6;69
2012;"FAZENDA NOVA (GO)";"GO";"FAZENDA NOVA";43;4;7;54
2012;"FIRMINOPOLIS (GO)";"GO";"FIRMINOPOLIS";91;4;5;100
2012;"FLORES DE GOIAS (GO)";"GO";"FLORES DE GOIAS";32;3;9;44
2012;"FORMOSA (GO)";"GO";"FORMOSA";3044;159;637;3840
2012;"FORMOSO (GO)";"GO";"FORMOSO";35;6;6;47
2012;"GAMELEIRA DE GOIAS (GO)";"GO";"GAMELEIRA DE GOIAS";26;6;13;45
2012;"GOIANAPOLIS (GO)";"GO";"GOIANAPOLIS";206;8;9;223
2012;"GOIANDIRA (GO)";"GO";"GOIANDIRA";48;6;4;58
2012;"GOIANESIA (GO)";"GO";"GOIANESIA";911;81;252;1244
2012;"GOIANIA (GO)";"GO";"GOIANIA";24926;1926;6323;33175
2012;"GOIANIRA (GO)";"GO";"GOIANIRA";264;10;66;340
2012;"GOIAS (GO)";"GO";"GOIAS";204;18;39;261
2012;"GOIATUBA (GO)";"GO";"GOIATUBA";716;39;117;872
2012;"GOUVELANDIA (GO)";"GO";"GOUVELANDIA";59;9;7;75
2012;"GUAPO (GO)";"GO";"GUAPO";195;22;28;245
2012;"GUARAITA (GO)";"GO";"GUARAITA";16;1;2;19
2012;"GUARANI DE GOIAS (GO)";"GO";"GUARANI DE GOIAS";13;3;8;24
2012;"GUARINOS (GO)";"GO";"GUARINOS";6;5;2;13
2012;"HEITORAI (GO)";"GO";"HEITORAI";25;3;5;33
2012;"HIDROLANDIA (GO)";"GO";"HIDROLANDIA";395;19;35;449
2012;"HIDROLINA (GO)";"GO";"HIDROLINA";17;0;2;19
2012;"IACIARA (GO)";"GO";"IACIARA";112;7;18;137
2012;"INACIOLANDIA (GO)";"GO";"INACIOLANDIA";45;7;9;61
2012;"INDIARA (GO)";"GO";"INDIARA";219;11;23;253
2012;"INHUMAS (GO)";"GO";"INHUMAS";1043;44;155;1242
2012;"IPAMERI (GO)";"GO";"IPAMERI";304;56;70;430
2012;"IPIRANGA DE GOIAS (GO)";"GO";"IPIRANGA DE GOIAS";24;7;7;38
2012;"IPORA (GO)";"GO";"IPORA";452;27;46;525
2012;"ISRAELANDIA (GO)";"GO";"ISRAELANDIA";23;3;5;31
2012;"ITABERAI (GO)";"GO";"ITABERAI";662;28;70;760
2012;"ITAGUARI (GO)";"GO";"ITAGUARI";55;8;9;72
2012;"ITAGUARU (GO)";"GO";"ITAGUARU";69;5;10;84
2012;"ITAJA (GO)";"GO";"ITAJA";74;6;17;97
2012;"ITAPACI (GO)";"GO";"ITAPACI";163;23;80;266
2012;"ITAPIRAPUA (GO)";"GO";"ITAPIRAPUA";55;4;11;70
2012;"ITAPURANGA (GO)";"GO";"ITAPURANGA";352;20;66;438
2012;"ITARUMA (GO)";"GO";"ITARUMA";81;13;11;105
2012;"ITAUCU (GO)";"GO";"ITAUCU";100;10;10;120
2012;"ITUMBIARA (GO)";"GO";"ITUMBIARA";1991;202;366;2559
2012;"IVOLANDIA (GO)";"GO";"IVOLANDIA";7;4;0;11
2012;"JANDAIA (GO)";"GO";"JANDAIA";102;5;12;119
2012;"JARAGUA (GO)";"GO";"JARAGUA";377;30;40;447
2012;"JATAI (GO)";"GO";"JATAI";2101;114;204;2419
2012;"JAUPACI (GO)";"GO";"JAUPACI";24;4;5;33
2012;"JESUPOLIS (GO)";"GO";"JESUPOLIS";16;2;5;23
2012;"JOVIANIA (GO)";"GO";"JOVIANIA";120;11;23;154
2012;"JUSSARA (GO)";"GO";"JUSSARA";360;13;17;390
2012;"LAGOA SANTA (GO)";"GO";"LAGOA SANTA";12;2;5;19
2012;"LEOPOLDO DE BULHOES (GO)";"GO";"LEOPOLDO DE BULHOES";120;11;8;139
2012;"LUZIANIA (GO)";"GO";"LUZIANIA";2171;153;409;2733
2012;"MAIRIPOTABA (GO)";"GO";"MAIRIPOTABA";22;4;4;30
2012;"MAMBAI (GO)";"GO";"MAMBAI";61;5;16;82
2012;"MARA ROSA (GO)";"GO";"MARA ROSA";115;5;16;136
2012;"MARZAGAO (GO)";"GO";"MARZAGAO";24;4;1;29
2012;"MATRINCHA (GO)";"GO";"MATRINCHA";33;4;6;43
2012;"MAURILANDIA (GO)";"GO";"MAURILANDIA";367;19;107;493
2012;"MIMOSO DE GOIAS (GO)";"GO";"MIMOSO DE GOIAS";6;2;4;12
2012;"MINACU (GO)";"GO";"MINACU";437;49;43;529
2012;"MINEIROS (GO)";"GO";"MINEIROS";1166;85;149;1400
2012;"MOIPORA (GO)";"GO";"MOIPORA";7;1;1;9
2012;"MONTE ALEGRE DE GOIAS (GO)";"GO";"MONTE ALEGRE DE GOIAS";19;3;5;27
2012;"MONTES CLAROS DE GOIAS (GO)";"GO";"MONTES CLAROS DE GOIAS";72;14;26;112
2012;"MONTIVIDIU (GO)";"GO";"MONTIVIDIU";340;15;57;412
2012;"MONTIVIDIU DO NORTE (GO)";"GO";"MONTIVIDIU DO NORTE";20;2;19;41
2012;"MORRINHOS (GO)";"GO";"MORRINHOS";714;48;106;868
2012;"MORRO AGUDO DE GOIAS (GO)";"GO";"MORRO AGUDO DE GOIAS";22;5;2;29
2012;"MOSSAMEDES (GO)";"GO";"MOSSAMEDES";35;9;3;47
2012;"MOZARLANDIA (GO)";"GO";"MOZARLANDIA";115;7;30;152
2012;"MUNDO NOVO (GO)";"GO";"MUNDO NOVO";27;5;15;47
2012;"MUTUNOPOLIS (GO)";"GO";"MUTUNOPOLIS";23;3;13;39
2012;"NAZARIO (GO)";"GO";"NAZARIO";99;9;8;116
2012;"NEROPOLIS (GO)";"GO";"NEROPOLIS";478;17;23;518
2012;"NIQUELANDIA (GO)";"GO";"NIQUELANDIA";556;61;137;754
2012;"NOVA AMERICA (GO)";"GO";"NOVA AMERICA";18;1;2;21
2012;"NOVA AURORA (GO)";"GO";"NOVA AURORA";32;5;4;41
2012;"NOVA CRIXAS (GO)";"GO";"NOVA CRIXAS";72;10;33;115
2012;"NOVA GLORIA (GO)";"GO";"NOVA GLORIA";70;5;23;98
2012;"NOVA IGUACU DE GOIAS (GO)";"GO";"NOVA IGUACU DE GOIAS";16;6;4;26
2012;"NOVA ROMA (GO)";"GO";"NOVA ROMA";4;3;3;10
2012;"NOVA VENEZA (GO)";"GO";"NOVA VENEZA";170;10;14;194
2012;"NOVO BRASIL (GO)";"GO";"NOVO BRASIL";21;3;1;25
2012;"NOVO GAMA (GO)";"GO";"NOVO GAMA";316;68;111;495
2012;"NOVO PLANALTO (GO)";"GO";"NOVO PLANALTO";32;6;1;39
2012;"ORIZONA (GO)";"GO";"ORIZONA";196;40;41;277
2012;"OURO VERDE DE GOIAS (GO)";"GO";"OURO VERDE DE GOIAS";85;0;9;94
2012;"OUVIDOR (GO)";"GO";"OUVIDOR";91;6;12;109
2012;"PADRE BERNARDO (GO)";"GO";"PADRE BERNARDO";400;21;81;502
2012;"PALESTINA DE GOIAS (GO)";"GO";"PALESTINA DE GOIAS";22;13;8;43
2012;"PALMEIRAS DE GOIAS (GO)";"GO";"PALMEIRAS DE GOIAS";313;11;85;409
2012;"PALMELO (GO)";"GO";"PALMELO";21;1;5;27
2012;"PALMINOPOLIS (GO)";"GO";"PALMINOPOLIS";42;1;5;48
2012;"PANAMA (GO)";"GO";"PANAMA";43;10;6;59
2012;"PARANAIGUARA (GO)";"GO";"PARANAIGUARA";96;11;9;116
2012;"PARAUNA (GO)";"GO";"PARAUNA";145;21;38;204
2012;"PEROLANDIA (GO)";"GO";"PEROLANDIA";40;7;7;54
2012;"PETROLINA DE GOIAS (GO)";"GO";"PETROLINA DE GOIAS";143;3;18;164
2012;"PILAR DE GOIAS (GO)";"GO";"PILAR DE GOIAS";9;5;5;19
2012;"PIRACANJUBA (GO)";"GO";"PIRACANJUBA";390;26;30;446
2012;"PIRANHAS (GO)";"GO";"PIRANHAS";184;6;39;229
2012;"PIRENOPOLIS (GO)";"GO";"PIRENOPOLIS";266;36;30;332
2012;"PIRES DO RIO (GO)";"GO";"PIRES DO RIO";481;37;38;556
2012;"PLANALTINA (GO)";"GO";"PLANALTINA";444;36;336;816
2012;"PONTALINA (GO)";"GO";"PONTALINA";250;17;33;300
2012;"PORANGATU (GO)";"GO";"PORANGATU";616;40;73;729
2012;"PORTEIRAO (GO)";"GO";"PORTEIRAO";78;8;12;98
2012;"PORTELANDIA (GO)";"GO";"PORTELANDIA";44;21;4;69
2012;"POSSE (GO)";"GO";"POSSE";568;41;93;702
2012;"PROFESSOR JAMIL (GO)";"GO";"PROFESSOR JAMIL";28;4;5;37
2012;"QUIRINOPOLIS (GO)";"GO";"QUIRINOPOLIS";865;48;232;1145
2012;"RIALMA (GO)";"GO";"RIALMA";282;25;25;332
2012;"RIANAPOLIS (GO)";"GO";"RIANAPOLIS";77;4;6;87
2012;"RIO QUENTE (GO)";"GO";"RIO QUENTE";42;21;57;120
2012;"RIO VERDE (GO)";"GO";"RIO VERDE";3431;284;518;4233
2012;"RUBIATABA (GO)";"GO";"RUBIATABA";310;25;58;393
2012;"SANCLERLANDIA (GO)";"GO";"SANCLERLANDIA";93;8;7;108
2012;"SANTA BARBARA DE GOIAS (GO)";"GO";"SANTA BARBARA DE GOIAS";104;3;5;112
2012;"SANTA CRUZ DE GOIAS (GO)";"GO";"SANTA CRUZ DE GOIAS";6;2;3;11
2012;"SANTA FE DE GOIAS (GO)";"GO";"SANTA FE DE GOIAS";36;2;4;42
2012;"SANTA HELENA DE GOIAS (GO)";"GO";"SANTA HELENA DE GOIAS";858;43;203;1104
2012;"SANTA ISABEL (GO)";"GO";"SANTA ISABEL";8;7;4;19
2012;"SANTA RITA DO ARAGUAIA (GO)";"GO";"SANTA RITA DO ARAGUAIA";130;14;4;148
2012;"SANTA RITA DO NOVO DESTINO (GO)";"GO";"SANTA RITA DO NOVO DESTINO";26;7;9;42
2012;"SANTA ROSA DE GOIAS (GO)";"GO";"SANTA ROSA DE GOIAS";25;3;5;33
2012;"SANTA TEREZA DE GOIAS (GO)";"GO";"SANTA TEREZA DE GOIAS";37;2;3;42
2012;"SANTA TEREZINHA DE GOIAS (GO)";"GO";"SANTA TEREZINHA DE GOIAS";82;12;20;114
2012;"SANTO ANTONIO DA BARRA (GO)";"GO";"SANTO ANTONIO DA BARRA";30;11;16;57
2012;"SANTO ANTONIO DE GOIAS (GO)";"GO";"SANTO ANTONIO DE GOIAS";54;11;10;75
2012;"SANTO ANTONIO DO DESCOBERTO (GO)";"GO";"SANTO ANTONIO DO DESCOBERTO";286;38;196;520
2012;"SAO DOMINGOS (GO)";"GO";"SAO DOMINGOS";39;5;20;64
2012;"SAO FRANCISCO DE GOIAS (GO)";"GO";"SAO FRANCISCO DE GOIAS";46;8;8;62
2012;"SAO JOAO D ALIANCA (GO)";"GO";"SAO JOAO D ALIANCA";115;7;14;136
2012;"SAO JOAO DA PARAUNA (GO)";"GO";"SAO JOAO DA PARAUNA";19;0;3;22
2012;"SAO LUIS DE MONTES BELOS (GO)";"GO";"SAO LUIS DE MONTES BELOS";394;23;71;488
2012;"SAO LUIZ DO NORTE (GO)";"GO";"SAO LUIZ DO NORTE";46;6;16;68
2012;"SAO MIGUEL DO ARAGUAIA (GO)";"GO";"SAO MIGUEL DO ARAGUAIA";313;11;53;377
2012;"SAO MIGUEL DO PASSA QUATRO (GO)";"GO";"SAO MIGUEL DO PASSA QUATRO";40;1;3;44
2012;"SAO PATRICIO (GO)";"GO";"SAO PATRICIO";9;0;5;14
2012;"SAO SIMAO (GO)";"GO";"SAO SIMAO";205;38;60;303
2012;"SENADOR CANEDO (GO)";"GO";"SENADOR CANEDO";678;61;54;793
2012;"SERRANOPOLIS (GO)";"GO";"SERRANOPOLIS";91;12;20;123
2012;"SILVANIA (GO)";"GO";"SILVANIA";363;26;38;427
2012;"SIMOLANDIA (GO)";"GO";"SIMOLANDIA";106;3;8;117
2012;"SITIO D ABADIA (GO)";"GO";"SITIO D ABADIA";7;1;6;14
2012;"TAQUARAL DE GOIAS (GO)";"GO";"TAQUARAL DE GOIAS";19;5;4;28
2012;"TERESINA DE GOIAS (GO)";"GO";"TERESINA DE GOIAS";10;1;2;13
2012;"TEREZOPOLIS DE GOIAS (GO)";"GO";"TEREZOPOLIS DE GOIAS";87;2;13;102
2012;"TRES RANCHOS (GO)";"GO";"TRES RANCHOS";41;12;3;56
2012;"TRINDADE (GO)";"GO";"TRINDADE";1009;57;118;1184
2012;"TROMBAS (GO)";"GO";"TROMBAS";26;3;10;39
2012;"TURVANIA (GO)";"GO";"TURVANIA";68;3;6;77
2012;"TURVELANDIA (GO)";"GO";"TURVELANDIA";45;4;17;66
2012;"UIRAPURU (GO)";"GO";"UIRAPURU";17;10;4;31
2012;"URUACU (GO)";"GO";"URUACU";512;37;71;620
2012;"URUANA (GO)";"GO";"URUANA";246;4;11;261
2012;"URUTAI (GO)";"GO";"URUTAI";21;1;8;30
2012;"VALPARAISO DE GOIAS (GO)";"GO";"VALPARAISO DE GOIAS";580;191;184;955
2012;"VARJAO (GO)";"GO";"VARJAO";45;0;5;50
2012;"VIANOPOLIS (GO)";"GO";"VIANOPOLIS";429;20;25;474
2012;"VICENTINOPOLIS (GO)";"GO";"VICENTINOPOLIS";169;12;44;225
2012;"VILA BOA (GO)";"GO";"VILA BOA";17;2;13;32
2012;"VILA PROPICIO (GO)";"GO";"VILA PROPICIO";9;3;14;26
2012;"ACAILANDIA (MA)";"MA";"ACAILANDIA";1134;117;168;1419
2012;"AFONSO CUNHA (MA)";"MA";"AFONSO CUNHA";3;1;1;5
2012;"AGUA DOCE DO MARANHAO (MA)";"MA";"AGUA DOCE DO MARANHAO";4;1;4;9
2012;"ALCANTARA (MA)";"MA";"ALCANTARA";45;12;15;72
2012;"ALDEIAS ALTAS (MA)";"MA";"ALDEIAS ALTAS";40;5;22;67
2012;"ALTAMIRA DO MARANHAO (MA)";"MA";"ALTAMIRA DO MARANHAO";18;3;1;22
2012;"ALTO ALEGRE DO MARANHAO (MA)";"MA";"ALTO ALEGRE DO MARANHAO";35;21;2;58
2012;"ALTO ALEGRE DO PINDARE (MA)";"MA";"ALTO ALEGRE DO PINDARE";37;11;3;51
2012;"ALTO PARNAIBA (MA)";"MA";"ALTO PARNAIBA";52;2;6;60
2012;"AMAPA DO MARANHAO (MA)";"MA";"AMAPA DO MARANHAO";7;2;2;11
2012;"AMARANTE DO MARANHAO (MA)";"MA";"AMARANTE DO MARANHAO";92;3;6;101
2012;"ANAJATUBA (MA)";"MA";"ANAJATUBA";33;3;5;41
2012;"ANAPURUS (MA)";"MA";"ANAPURUS";41;1;11;53
2012;"APICUM ACU (MA)";"MA";"APICUM ACU";12;7;1;20
2012;"ARAGUANA (MA)";"MA";"ARAGUANA";8;0;5;13
2012;"ARAIOSES (MA)";"MA";"ARAIOSES";24;6;22;52
2012;"ARAME (MA)";"MA";"ARAME";94;10;2;106
2012;"ARARI (MA)";"MA";"ARARI";76;6;5;87
2012;"AXIXA (MA)";"MA";"AXIXA";16;6;7;29
2012;"BACABAL (MA)";"MA";"BACABAL";806;83;62;951
2012;"BACABEIRA (MA)";"MA";"BACABEIRA";151;4;11;166
2012;"BACURI (MA)";"MA";"BACURI";9;3;3;15
2012;"BACURITUBA (MA)";"MA";"BACURITUBA";3;0;2;5
2012;"BALSAS (MA)";"MA";"BALSAS";1302;42;84;1428
2012;"BARAO DE GRAJAU (MA)";"MA";"BARAO DE GRAJAU";68;1;4;73
2012;"BARRA DO CORDA (MA)";"MA";"BARRA DO CORDA";543;22;16;581
2012;"BARREIRINHAS (MA)";"MA";"BARREIRINHAS";72;6;12;90
2012;"BELA VISTA DO MARANHAO (MA)";"MA";"BELA VISTA DO MARANHAO";30;1;4;35
2012;"BELAGUA (MA)";"MA";"BELAGUA";1;6;3;10
2012;"BENEDITO LEITE (MA)";"MA";"BENEDITO LEITE";5;2;1;8
2012;"BEQUIMAO (MA)";"MA";"BEQUIMAO";73;10;12;95
2012;"BERNARDO DO MEARIM (MA)";"MA";"BERNARDO DO MEARIM";24;1;1;26
2012;"BOA VISTA DO GURUPI (MA)";"MA";"BOA VISTA DO GURUPI";5;3;2;10
2012;"BOM JARDIM (MA)";"MA";"BOM JARDIM";96;6;7;109
2012;"BOM JESUS DAS SELVAS (MA)";"MA";"BOM JESUS DAS SELVAS";98;5;4;107
2012;"BOM LUGAR (MA)";"MA";"BOM LUGAR";24;9;13;46
2012;"BREJO (MA)";"MA";"BREJO";61;17;12;90
2012;"BREJO DE AREIA (MA)";"MA";"BREJO DE AREIA";23;3;3;29
2012;"BURITI (MA)";"MA";"BURITI";15;9;17;41
2012;"BURITI BRAVO (MA)";"MA";"BURITI BRAVO";26;1;1;28
2012;"BURITICUPU (MA)";"MA";"BURITICUPU";381;40;11;432
2012;"BURITIRANA (MA)";"MA";"BURITIRANA";18;0;0;18
2012;"CACHOEIRA GRANDE (MA)";"MA";"CACHOEIRA GRANDE";4;2;2;8
2012;"CAJAPIO (MA)";"MA";"CAJAPIO";7;1;2;10
2012;"CAJARI (MA)";"MA";"CAJARI";5;2;2;9
2012;"CAMPESTRE DO MARANHAO (MA)";"MA";"CAMPESTRE DO MARANHAO";18;14;9;41
2012;"CANDIDO MENDES (MA)";"MA";"CANDIDO MENDES";13;7;2;22
2012;"CANTANHEDE (MA)";"MA";"CANTANHEDE";20;3;4;27
2012;"CAPINZAL DO NORTE (MA)";"MA";"CAPINZAL DO NORTE";25;13;2;40
2012;"CAROLINA (MA)";"MA";"CAROLINA";56;3;8;67
2012;"CARUTAPERA (MA)";"MA";"CARUTAPERA";23;13;7;43
2012;"CAXIAS (MA)";"MA";"CAXIAS";773;53;96;922
2012;"CEDRAL (MA)";"MA";"CEDRAL";8;0;4;12
2012;"CENTRAL DO MARANHAO (MA)";"MA";"CENTRAL DO MARANHAO";8;2;2;12
2012;"CENTRO DO GUILHERME (MA)";"MA";"CENTRO DO GUILHERME";14;0;3;17
2012;"CENTRO NOVO DO MARANHAO (MA)";"MA";"CENTRO NOVO DO MARANHAO";24;3;6;33
2012;"CHAPADINHA (MA)";"MA";"CHAPADINHA";306;33;12;351
2012;"CIDELANDIA (MA)";"MA";"CIDELANDIA";34;9;10;53
2012;"CODO (MA)";"MA";"CODO";558;25;28;611
2012;"COELHO NETO (MA)";"MA";"COELHO NETO";96;13;43;152
2012;"COLINAS (MA)";"MA";"COLINAS";121;9;16;146
2012;"CONCEICAO DO LAGO ACU (MA)";"MA";"CONCEICAO DO LAGO ACU";14;4;1;19
2012;"COROATA (MA)";"MA";"COROATA";181;35;11;227
2012;"CURURUPU (MA)";"MA";"CURURUPU";24;8;6;38
2012;"DAVINOPOLIS (MA)";"MA";"DAVINOPOLIS";51;3;3;57
2012;"DOM PEDRO (MA)";"MA";"DOM PEDRO";396;11;33;440
2012;"DUQUE BACELAR (MA)";"MA";"DUQUE BACELAR";2;2;5;9
2012;"ESPERANTINOPOLIS (MA)";"MA";"ESPERANTINOPOLIS";89;17;1;107
2012;"ESTREITO (MA)";"MA";"ESTREITO";125;20;12;157
2012;"FEIRA NOVA DO MARANHAO (MA)";"MA";"FEIRA NOVA DO MARANHAO";6;0;3;9
2012;"FERNANDO FALCAO (MA)";"MA";"FERNANDO FALCAO";15;0;5;20
2012;"FORMOSA DA SERRA NEGRA (MA)";"MA";"FORMOSA DA SERRA NEGRA";29;3;3;35
2012;"FORTALEZA DOS NOGUEIRAS (MA)";"MA";"FORTALEZA DOS NOGUEIRAS";61;3;6;70
2012;"FORTUNA (MA)";"MA";"FORTUNA";37;10;1;48
2012;"GODOFREDO VIANA (MA)";"MA";"GODOFREDO VIANA";8;8;5;21
2012;"GONCALVES DIAS (MA)";"MA";"GONCALVES DIAS";48;4;6;58
2012;"GOVERNADOR ARCHER (MA)";"MA";"GOVERNADOR ARCHER";26;8;4;38
2012;"GOVERNADOR EDISON LOBAO (MA)";"MA";"GOVERNADOR EDISON LOBAO";55;2;9;66
2012;"GOVERNADOR EUGENIO BARROS (MA)";"MA";"GOVERNADOR EUGENIO BARROS";44;9;12;65
2012;"GOVERNADOR LUIZ ROCHA (MA)";"MA";"GOVERNADOR LUIZ ROCHA";19;3;5;27
2012;"GOVERNADOR NEWTON BELLO (MA)";"MA";"GOVERNADOR NEWTON BELLO";17;1;2;20
2012;"GOVERNADOR NUNES FREIRE (MA)";"MA";"GOVERNADOR NUNES FREIRE";68;6;3;77
2012;"GRACA ARANHA (MA)";"MA";"GRACA ARANHA";10;4;3;17
2012;"GRAJAU (MA)";"MA";"GRAJAU";402;23;25;450
2012;"GUIMARAES (MA)";"MA";"GUIMARAES";15;1;10;26
2012;"HUMBERTO DE CAMPOS (MA)";"MA";"HUMBERTO DE CAMPOS";11;4;3;18
2012;"ICATU (MA)";"MA";"ICATU";18;1;6;25
2012;"IGARAPE DO MEIO (MA)";"MA";"IGARAPE DO MEIO";18;2;7;27
2012;"IGARAPE GRANDE (MA)";"MA";"IGARAPE GRANDE";66;9;6;81
2012;"IMPERATRIZ (MA)";"MA";"IMPERATRIZ";3147;217;327;3691
2012;"ITAIPAVA DO GRAJAU (MA)";"MA";"ITAIPAVA DO GRAJAU";20;2;3;25
2012;"ITAPECURU MIRIM (MA)";"MA";"ITAPECURU MIRIM";340;22;33;395
2012;"ITINGA DO MARANHAO (MA)";"MA";"ITINGA DO MARANHAO";121;5;5;131
2012;"JATOBA (MA)";"MA";"JATOBA";2;2;1;5
2012;"JENIPAPO DOS VIEIRAS (MA)";"MA";"JENIPAPO DOS VIEIRAS";38;1;3;42
2012;"JOAO LISBOA (MA)";"MA";"JOAO LISBOA";105;9;5;119
2012;"JOSELANDIA (MA)";"MA";"JOSELANDIA";53;6;4;63
2012;"JUNCO DO MARANHAO (MA)";"MA";"JUNCO DO MARANHAO";7;14;1;22
2012;"LAGO DA PEDRA (MA)";"MA";"LAGO DA PEDRA";249;45;7;301
2012;"LAGO DO JUNCO (MA)";"MA";"LAGO DO JUNCO";20;1;6;27
2012;"LAGO DOS RODRIGUES (MA)";"MA";"LAGO DOS RODRIGUES";38;11;4;53
2012;"LAGO VERDE (MA)";"MA";"LAGO VERDE";23;3;5;31
2012;"LAGOA DO MATO (MA)";"MA";"LAGOA DO MATO";17;0;7;24
2012;"LAGOA GRANDE DO MARANHAO (MA)";"MA";"LAGOA GRANDE DO MARANHAO";18;1;1;20
2012;"LAJEADO NOVO (MA)";"MA";"LAJEADO NOVO";14;5;2;21
2012;"LIMA CAMPOS (MA)";"MA";"LIMA CAMPOS";69;31;4;104
2012;"LORETO (MA)";"MA";"LORETO";15;4;3;22
2012;"LUIS DOMINGUES (MA)";"MA";"LUIS DOMINGUES";4;2;2;8
2012;"MAGALHAES DE ALMEIDA (MA)";"MA";"MAGALHAES DE ALMEIDA";16;2;4;22
2012;"MARACACUME (MA)";"MA";"MARACACUME";58;38;3;99
2012;"MARAJA DO SENA (MA)";"MA";"MARAJA DO SENA";7;0;1;8
2012;"MARANHAOZINHO (MA)";"MA";"MARANHAOZINHO";26;5;2;33
2012;"MATA ROMA (MA)";"MA";"MATA ROMA";34;7;12;53
2012;"MATINHA (MA)";"MA";"MATINHA";37;8;4;49
2012;"MATOES (MA)";"MA";"MATOES";33;4;14;51
2012;"MATOES DO NORTE (MA)";"MA";"MATOES DO NORTE";17;5;4;26
2012;"MILAGRES DO MARANHAO (MA)";"MA";"MILAGRES DO MARANHAO";4;2;3;9
2012;"MIRADOR (MA)";"MA";"MIRADOR";17;3;4;24
2012;"MIRANDA DO NORTE (MA)";"MA";"MIRANDA DO NORTE";126;6;5;137
2012;"MIRINZAL (MA)";"MA";"MIRINZAL";32;3;6;41
2012;"MONCAO (MA)";"MA";"MONCAO";20;4;6;30
2012;"MONTES ALTOS (MA)";"MA";"MONTES ALTOS";28;0;1;29
2012;"MORROS (MA)";"MA";"MORROS";12;3;3;18
2012;"NINA RODRIGUES (MA)";"MA";"NINA RODRIGUES";5;2;4;11
2012;"NOVA COLINAS (MA)";"MA";"NOVA COLINAS";12;3;8;23
2012;"NOVA IORQUE (MA)";"MA";"NOVA IORQUE";5;1;1;7
2012;"NOVA OLINDA DO MARANHAO (MA)";"MA";"NOVA OLINDA DO MARANHAO";47;16;3;66
2012;"OLHO D AGUA DAS CUNHAS (MA)";"MA";"OLHO D AGUA DAS CUNHAS";76;12;10;98
2012;"OLINDA NOVA DO MARANHAO (MA)";"MA";"OLINDA NOVA DO MARANHAO";23;2;2;27
2012;"PACO DO LUMIAR (MA)";"MA";"PACO DO LUMIAR";397;116;117;630
2012;"PALMEIRANDIA (MA)";"MA";"PALMEIRANDIA";16;1;9;26
2012;"PARAIBANO (MA)";"MA";"PARAIBANO";49;12;6;67
2012;"PARNARAMA (MA)";"MA";"PARNARAMA";38;3;3;44
2012;"PASSAGEM FRANCA (MA)";"MA";"PASSAGEM FRANCA";30;4;4;38
2012;"PASTOS BONS (MA)";"MA";"PASTOS BONS";82;8;4;94
2012;"PAULINO NEVES (MA)";"MA";"PAULINO NEVES";5;1;5;11
2012;"PAULO RAMOS (MA)";"MA";"PAULO RAMOS";60;8;3;71
2012;"PEDREIRAS (MA)";"MA";"PEDREIRAS";359;45;35;439
2012;"PEDRO DO ROSARIO (MA)";"MA";"PEDRO DO ROSARIO";16;1;3;20
2012;"PENALVA (MA)";"MA";"PENALVA";25;3;2;30
2012;"PERI MIRIM (MA)";"MA";"PERI MIRIM";18;6;8;32
2012;"PERITORO (MA)";"MA";"PERITORO";48;60;13;121
2012;"PINDARE MIRIM (MA)";"MA";"PINDARE MIRIM";89;15;15;119
2012;"PINHEIRO (MA)";"MA";"PINHEIRO";416;23;62;501
2012;"PIO XII (MA)";"MA";"PIO XII";99;4;3;106
2012;"PIRAPEMAS (MA)";"MA";"PIRAPEMAS";17;8;2;27
2012;"POCAO DE PEDRAS (MA)";"MA";"POCAO DE PEDRAS";43;16;4;63
2012;"PORTO FRANCO (MA)";"MA";"PORTO FRANCO";71;22;7;100
2012;"PORTO RICO DO MARANHAO (MA)";"MA";"PORTO RICO DO MARANHAO";3;1;3;7
2012;"PRESIDENTE DUTRA (MA)";"MA";"PRESIDENTE DUTRA";374;25;20;419
2012;"PRESIDENTE JUSCELINO (MA)";"MA";"PRESIDENTE JUSCELINO";4;2;3;9
2012;"PRESIDENTE MEDICI (MA)";"MA";"PRESIDENTE MEDICI";13;5;3;21
2012;"PRESIDENTE SARNEY (MA)";"MA";"PRESIDENTE SARNEY";10;5;2;17
2012;"PRESIDENTE VARGAS (MA)";"MA";"PRESIDENTE VARGAS";16;6;2;24
2012;"PRIMEIRA CRUZ (MA)";"MA";"PRIMEIRA CRUZ";1;1;1;3
2012;"RAPOSA (MA)";"MA";"RAPOSA";83;6;51;140
2012;"RIACHAO (MA)";"MA";"RIACHAO";48;6;7;61
2012;"RIBAMAR FIQUENE (MA)";"MA";"RIBAMAR FIQUENE";15;4;3;22
2012;"ROSARIO (MA)";"MA";"ROSARIO";199;23;44;266
2012;"SAMBAIBA (MA)";"MA";"SAMBAIBA";17;2;1;20
2012;"SANTA FILOMENA DO MARANHAO (MA)";"MA";"SANTA FILOMENA DO MARANHAO";5;7;2;14
2012;"SANTA HELENA (MA)";"MA";"SANTA HELENA";92;10;8;110
2012;"SANTA INES (MA)";"MA";"SANTA INES";719;153;94;966
2012;"SANTA LUZIA (MA)";"MA";"SANTA LUZIA";247;77;12;336
2012;"SANTA LUZIA DO PARUA (MA)";"MA";"SANTA LUZIA DO PARUA";119;12;6;137
2012;"SANTA QUITERIA DO MARANHAO (MA)";"MA";"SANTA QUITERIA DO MARANHAO";29;4;9;42
2012;"SANTA RITA (MA)";"MA";"SANTA RITA";138;6;8;152
2012;"SANTANA DO MARANHAO (MA)";"MA";"SANTANA DO MARANHAO";7;1;4;12
2012;"SANTO AMARO DO MARANHAO (MA)";"MA";"SANTO AMARO DO MARANHAO";2;4;2;8
2012;"SANTO ANTONIO DOS LOPES (MA)";"MA";"SANTO ANTONIO DOS LOPES";87;6;3;96
2012;"SAO BENEDITO DO RIO PRETO (MA)";"MA";"SAO BENEDITO DO RIO PRETO";14;8;2;24
2012;"SAO BENTO (MA)";"MA";"SAO BENTO";125;29;16;170
2012;"SAO BERNARDO (MA)";"MA";"SAO BERNARDO";82;2;9;93
2012;"SAO DOMINGOS DO AZEITAO (MA)";"MA";"SAO DOMINGOS DO AZEITAO";36;0;1;37
2012;"SAO DOMINGOS DO MARANHAO (MA)";"MA";"SAO DOMINGOS DO MARANHAO";161;3;2;166
2012;"SAO FELIX DE BALSAS (MA)";"MA";"SAO FELIX DE BALSAS";3;0;1;4
2012;"SAO FRANCISCO DO BREJAO (MA)";"MA";"SAO FRANCISCO DO BREJAO";39;1;2;42
2012;"SAO FRANCISCO DO MARANHAO (MA)";"MA";"SAO FRANCISCO DO MARANHAO";8;0;2;10
2012;"SAO JOAO BATISTA (MA)";"MA";"SAO JOAO BATISTA";31;5;9;45
2012;"SAO JOAO DO CARU (MA)";"MA";"SAO JOAO DO CARU";29;1;1;31
2012;"SAO JOAO DO PARAISO (MA)";"MA";"SAO JOAO DO PARAISO";13;4;2;19
2012;"SAO JOAO DO SOTER (MA)";"MA";"SAO JOAO DO SOTER";19;1;3;23
2012;"SAO JOAO DOS PATOS (MA)";"MA";"SAO JOAO DOS PATOS";149;7;5;161
2012;"SAO JOSE DE RIBAMAR (MA)";"MA";"SAO JOSE DE RIBAMAR";630;134;176;940
2012;"SAO JOSE DOS BASILIOS (MA)";"MA";"SAO JOSE DOS BASILIOS";13;2;2;17
2012;"SAO LUIS (MA)";"MA";"SAO LUIS";8318;1299;3634;13251
2012;"SAO LUIS GONZAGA DO MARANHAO (MA)";"MA";"SAO LUIS GONZAGA DO MARANHAO";30;7;4;41
2012;"SAO MATEUS DO MARANHAO (MA)";"MA";"SAO MATEUS DO MARANHAO";111;40;19;170
2012;"SAO PEDRO DA AGUA BRANCA (MA)";"MA";"SAO PEDRO DA AGUA BRANCA";17;6;3;26
2012;"SAO PEDRO DOS CRENTES (MA)";"MA";"SAO PEDRO DOS CRENTES";14;0;4;18
2012;"SAO RAIMUNDO DAS MANGABEIRAS (MA)";"MA";"SAO RAIMUNDO DAS MANGABEIRAS";126;7;41;174
2012;"SAO RAIMUNDO DO DOCA BEZERRA (MA)";"MA";"SAO RAIMUNDO DO DOCA BEZERRA";11;0;2;13
2012;"SAO ROBERTO (MA)";"MA";"SAO ROBERTO";14;4;1;19
2012;"SAO VICENTE FERRER (MA)";"MA";"SAO VICENTE FERRER";27;1;5;33
2012;"SATUBINHA (MA)";"MA";"SATUBINHA";16;4;1;21
2012;"SENADOR ALEXANDRE COSTA (MA)";"MA";"SENADOR ALEXANDRE COSTA";22;6;2;30
2012;"SENADOR LA ROCQUE (MA)";"MA";"SENADOR LA ROCQUE";51;0;3;54
2012;"SERRANO DO MARANHAO (MA)";"MA";"SERRANO DO MARANHAO";1;0;2;3
2012;"SITIO NOVO (MA)";"MA";"SITIO NOVO";45;6;6;57
2012;"SUCUPIRA DO NORTE (MA)";"MA";"SUCUPIRA DO NORTE";18;4;4;26
2012;"SUCUPIRA DO RIACHAO (MA)";"MA";"SUCUPIRA DO RIACHAO";8;4;2;14
2012;"TASSO FRAGOSO (MA)";"MA";"TASSO FRAGOSO";56;3;6;65
2012;"TIMBIRAS (MA)";"MA";"TIMBIRAS";32;5;1;38
2012;"TIMON (MA)";"MA";"TIMON";569;45;82;696
2012;"TRIZIDELA DO VALE (MA)";"MA";"TRIZIDELA DO VALE";121;17;6;144
2012;"TUFILANDIA (MA)";"MA";"TUFILANDIA";8;7;1;16
2012;"TUNTUM (MA)";"MA";"TUNTUM";107;6;7;120
2012;"TURIACU (MA)";"MA";"TURIACU";40;3;3;46
2012;"TURILANDIA (MA)";"MA";"TURILANDIA";14;4;2;20
2012;"TUTOIA (MA)";"MA";"TUTOIA";59;8;8;75
2012;"URBANO SANTOS (MA)";"MA";"URBANO SANTOS";47;7;11;65
2012;"VARGEM GRANDE (MA)";"MA";"VARGEM GRANDE";107;6;7;120
2012;"VIANA (MA)";"MA";"VIANA";190;8;6;204
2012;"VILA NOVA DOS MARTIRIOS (MA)";"MA";"VILA NOVA DOS MARTIRIOS";37;4;1;42
2012;"VITORIA DO MEARIM (MA)";"MA";"VITORIA DO MEARIM";82;12;7;101
2012;"VITORINO FREIRE (MA)";"MA";"VITORINO FREIRE";124;12;5;141
2012;"ZE DOCA (MA)";"MA";"ZE DOCA";216;25;21;262
2012;"ABADIA DOS DOURADOS (MG)";"MG";"ABADIA DOS DOURADOS";98;29;11;138
2012;"ABAETE (MG)";"MG";"ABAETE";447;28;157;632
2012;"ABRE CAMPO (MG)";"MG";"ABRE CAMPO";189;16;44;249
2012;"ACAIACA (MG)";"MG";"ACAIACA";26;7;6;39
2012;"ACUCENA (MG)";"MG";"ACUCENA";42;13;31;86
2012;"AGUA BOA (MG)";"MG";"AGUA BOA";61;7;26;94
2012;"AGUA COMPRIDA (MG)";"MG";"AGUA COMPRIDA";33;9;6;48
2012;"AGUANIL (MG)";"MG";"AGUANIL";53;11;12;76
2012;"AGUAS FORMOSAS (MG)";"MG";"AGUAS FORMOSAS";94;18;30;142
2012;"AGUAS VERMELHAS (MG)";"MG";"AGUAS VERMELHAS";78;13;19;110
2012;"AIMORES (MG)";"MG";"AIMORES";183;33;36;252
2012;"AIURUOCA (MG)";"MG";"AIURUOCA";96;20;11;127
2012;"ALAGOA (MG)";"MG";"ALAGOA";22;3;12;37
2012;"ALBERTINA (MG)";"MG";"ALBERTINA";39;13;5;57
2012;"ALEM PARAIBA (MG)";"MG";"ALEM PARAIBA";1256;81;79;1416
2012;"ALFENAS (MG)";"MG";"ALFENAS";1174;111;331;1616
2012;"ALFREDO VASCONCELOS (MG)";"MG";"ALFREDO VASCONCELOS";132;9;20;161
2012;"ALMENARA (MG)";"MG";"ALMENARA";253;61;97;411
2012;"ALPERCATA (MG)";"MG";"ALPERCATA";69;5;5;79
2012;"ALPINOPOLIS (MG)";"MG";"ALPINOPOLIS";419;34;45;498
2012;"ALTEROSA (MG)";"MG";"ALTEROSA";210;34;50;294
2012;"ALTO CAPARAO (MG)";"MG";"ALTO CAPARAO";64;10;10;84
2012;"ALTO JEQUITIBA (MG)";"MG";"ALTO JEQUITIBA";86;10;11;107
2012;"ALTO RIO DOCE (MG)";"MG";"ALTO RIO DOCE";97;24;24;145
2012;"ALVARENGA (MG)";"MG";"ALVARENGA";33;2;12;47
2012;"ALVINOPOLIS (MG)";"MG";"ALVINOPOLIS";187;17;20;224
2012;"ALVORADA DE MINAS (MG)";"MG";"ALVORADA DE MINAS";14;11;14;39
2012;"AMPARO DA SERRA (MG)";"MG";"AMPARO DA SERRA";30;4;29;63
2012;"ANDRADAS (MG)";"MG";"ANDRADAS";994;74;94;1162
2012;"ANDRELANDIA (MG)";"MG";"ANDRELANDIA";149;33;16;198
2012;"ANGELANDIA (MG)";"MG";"ANGELANDIA";63;7;28;98
2012;"ANTONIO CARLOS (MG)";"MG";"ANTONIO CARLOS";162;18;41;221
2012;"ANTONIO DIAS (MG)";"MG";"ANTONIO DIAS";111;8;47;166
2012;"ANTONIO PRADO DE MINAS (MG)";"MG";"ANTONIO PRADO DE MINAS";13;5;4;22
2012;"ARACAI (MG)";"MG";"ARACAI";12;6;6;24
2012;"ARACITABA (MG)";"MG";"ARACITABA";12;3;1;16
2012;"ARACUAI (MG)";"MG";"ARACUAI";233;17;84;334
2012;"ARAGUARI (MG)";"MG";"ARAGUARI";2639;336;174;3149
2012;"ARANTINA (MG)";"MG";"ARANTINA";32;1;3;36
2012;"ARAPONGA (MG)";"MG";"ARAPONGA";69;7;8;84
2012;"ARAPORA (MG)";"MG";"ARAPORA";185;13;56;254
2012;"ARAPUA (MG)";"MG";"ARAPUA";35;3;10;48
2012;"ARAUJOS (MG)";"MG";"ARAUJOS";151;14;7;172
2012;"ARAXA (MG)";"MG";"ARAXA";1624;190;296;2110
2012;"ARCEBURGO (MG)";"MG";"ARCEBURGO";101;21;46;168
2012;"ARCOS (MG)";"MG";"ARCOS";1220;97;279;1596
2012;"AREADO (MG)";"MG";"AREADO";212;21;81;314
2012;"ARGIRITA (MG)";"MG";"ARGIRITA";20;6;4;30
2012;"ARICANDUVA (MG)";"MG";"ARICANDUVA";11;4;14;29
2012;"ARINOS (MG)";"MG";"ARINOS";299;21;98;418
2012;"ASTOLFO DUTRA (MG)";"MG";"ASTOLFO DUTRA";233;10;31;274
2012;"ATALEIA (MG)";"MG";"ATALEIA";77;22;29;128
2012;"AUGUSTO DE LIMA (MG)";"MG";"AUGUSTO DE LIMA";32;5;18;55
2012;"BAEPENDI (MG)";"MG";"BAEPENDI";346;46;27;419
2012;"BALDIM (MG)";"MG";"BALDIM";175;12;17;204
2012;"BAMBUI (MG)";"MG";"BAMBUI";487;36;75;598
2012;"BANDEIRA (MG)";"MG";"BANDEIRA";3;3;7;13
2012;"BANDEIRA DO SUL (MG)";"MG";"BANDEIRA DO SUL";128;30;5;163
2012;"BARAO DE COCAIS (MG)";"MG";"BARAO DE COCAIS";495;70;82;647
2012;"BARAO D0 MONTE ALTO (MG)";"MG";"BARAO D0 MONTE ALTO";36;6;7;49
2012;"BARBACENA (MG)";"MG";"BARBACENA";1709;314;222;2245
2012;"BARRA LONGA (MG)";"MG";"BARRA LONGA";44;7;9;60
2012;"BARROSO (MG)";"MG";"BARROSO";403;25;35;463
2012;"BELA VISTA DE MINAS (MG)";"MG";"BELA VISTA DE MINAS";141;14;10;165
2012;"BELMIRO BRAGA (MG)";"MG";"BELMIRO BRAGA";60;11;4;75
2012;"BELO HORIZONTE (MG)";"MG";"BELO HORIZONTE";34181;5653;8739;48573
2012;"BELO ORIENTE (MG)";"MG";"BELO ORIENTE";236;23;87;346
2012;"BELO VALE (MG)";"MG";"BELO VALE";159;19;23;201
2012;"BERILO (MG)";"MG";"BERILO";65;6;27;98
2012;"BERIZAL (MG)";"MG";"BERIZAL";18;3;9;30
2012;"BERTOPOLIS (MG)";"MG";"BERTOPOLIS";13;2;3;18
2012;"BETIM (MG)";"MG";"BETIM";5047;552;1252;6851
2012;"BIAS FORTES (MG)";"MG";"BIAS FORTES";21;5;3;29
2012;"BICAS (MG)";"MG";"BICAS";228;28;34;290
2012;"BIQUINHAS (MG)";"MG";"BIQUINHAS";45;9;3;57
2012;"BOA ESPERANCA (MG)";"MG";"BOA ESPERANCA";647;92;175;914
2012;"BOCAINA DE MINAS (MG)";"MG";"BOCAINA DE MINAS";62;13;7;82
2012;"BOCAIUVA (MG)";"MG";"BOCAIUVA";445;47;140;632
2012;"BOM DESPACHO (MG)";"MG";"BOM DESPACHO";966;76;384;1426
2012;"BOM JARDIM DE MINAS (MG)";"MG";"BOM JARDIM DE MINAS";110;14;13;137
2012;"BOM JESUS DA PENHA (MG)";"MG";"BOM JESUS DA PENHA";117;16;17;150
2012;"BOM JESUS DO AMPARO (MG)";"MG";"BOM JESUS DO AMPARO";88;10;9;107
2012;"BOM JESUS DO GALHO (MG)";"MG";"BOM JESUS DO GALHO";98;6;24;128
2012;"BOM REPOUSO (MG)";"MG";"BOM REPOUSO";186;19;8;213
2012;"BOM SUCESSO (MG)";"MG";"BOM SUCESSO";228;30;52;310
2012;"BONFIM (MG)";"MG";"BONFIM";134;19;15;168
2012;"BONFINOPOLIS DE MINAS (MG)";"MG";"BONFINOPOLIS DE MINAS";79;2;24;105
2012;"BONITO DE MINAS (MG)";"MG";"BONITO DE MINAS";18;2;23;43
2012;"BORDA DA MATA (MG)";"MG";"BORDA DA MATA";268;29;77;374
2012;"BOTELHOS (MG)";"MG";"BOTELHOS";234;65;39;338
2012;"BOTUMIRIM (MG)";"MG";"BOTUMIRIM";27;2;14;43
2012;"BRAS PIRES (MG)";"MG";"BRAS PIRES";42;13;6;61
2012;"BRASILANDIA DE MINAS (MG)";"MG";"BRASILANDIA DE MINAS";209;15;95;319
2012;"BRASILIA DE MINAS (MG)";"MG";"BRASILIA DE MINAS";276;13;82;371
2012;"BRASOPOLIS (MG)";"MG";"BRASOPOLIS";195;39;27;261
2012;"BRAUNAS (MG)";"MG";"BRAUNAS";16;8;17;41
2012;"BRUMADINHO (MG)";"MG";"BRUMADINHO";867;121;288;1276
2012;"BUENO BRANDAO (MG)";"MG";"BUENO BRANDAO";179;49;20;248
2012;"BUENOPOLIS (MG)";"MG";"BUENOPOLIS";108;10;27;145
2012;"BUGRE (MG)";"MG";"BUGRE";20;4;5;29
2012;"BURITIS (MG)";"MG";"BURITIS";243;12;84;339
2012;"BURITIZEIRO (MG)";"MG";"BURITIZEIRO";239;23;98;360
2012;"CABECEIRA GRANDE (MG)";"MG";"CABECEIRA GRANDE";52;2;10;64
2012;"CABO VERDE (MG)";"MG";"CABO VERDE";174;37;42;253
2012;"CACHOEIRA DA PRATA (MG)";"MG";"CACHOEIRA DA PRATA";57;2;4;63
2012;"CACHOEIRA DE MINAS (MG)";"MG";"CACHOEIRA DE MINAS";116;23;15;154
2012;"CACHOEIRA DE PAJEU (MG)";"MG";"CACHOEIRA DE PAJEU";31;8;17;56
2012;"CACHOEIRA DOURADA (MG)";"MG";"CACHOEIRA DOURADA";15;11;2;28
2012;"CAETANOPOLIS (MG)";"MG";"CAETANOPOLIS";129;20;44;193
2012;"CAETE (MG)";"MG";"CAETE";519;82;58;659
2012;"CAIANA (MG)";"MG";"CAIANA";38;9;10;57
2012;"CAJURI (MG)";"MG";"CAJURI";44;4;10;58
2012;"CALDAS (MG)";"MG";"CALDAS";256;33;28;317
2012;"CAMACHO (MG)";"MG";"CAMACHO";53;10;12;75
2012;"CAMANDUCAIA (MG)";"MG";"CAMANDUCAIA";472;46;41;559
2012;"CAMBUI (MG)";"MG";"CAMBUI";565;57;108;730
2012;"CAMBUQUIRA (MG)";"MG";"CAMBUQUIRA";141;36;20;197
2012;"CAMPANARIO (MG)";"MG";"CAMPANARIO";13;5;4;22
2012;"CAMPANHA (MG)";"MG";"CAMPANHA";245;49;37;331
2012;"CAMPESTRE (MG)";"MG";"CAMPESTRE";493;55;59;607
2012;"CAMPINA VERDE (MG)";"MG";"CAMPINA VERDE";243;36;41;320
2012;"CAMPO AZUL (MG)";"MG";"CAMPO AZUL";9;4;4;17
2012;"CAMPO BELO (MG)";"MG";"CAMPO BELO";1174;85;117;1376
2012;"CAMPO DO MEIO (MG)";"MG";"CAMPO DO MEIO";115;22;70;207
2012;"CAMPO FLORIDO (MG)";"MG";"CAMPO FLORIDO";147;34;80;261
2012;"CAMPOS ALTOS (MG)";"MG";"CAMPOS ALTOS";298;32;89;419
2012;"CAMPOS GERAIS (MG)";"MG";"CAMPOS GERAIS";315;34;131;480
2012;"CANA VERDE (MG)";"MG";"CANA VERDE";63;10;10;83
2012;"CANAA (MG)";"MG";"CANAA";54;5;9;68
2012;"CANAPOLIS (MG)";"MG";"CANAPOLIS";221;11;105;337
2012;"CANDEIAS (MG)";"MG";"CANDEIAS";242;23;34;299
2012;"CANTAGALO (MG)";"MG";"CANTAGALO";12;4;6;22
2012;"CAPARAO (MG)";"MG";"CAPARAO";104;7;7;118
2012;"CAPELA NOVA (MG)";"MG";"CAPELA NOVA";21;12;4;37
2012;"CAPELINHA (MG)";"MG";"CAPELINHA";659;43;153;855
2012;"CAPETINGA (MG)";"MG";"CAPETINGA";158;20;31;209
2012;"CAPIM BRANCO (MG)";"MG";"CAPIM BRANCO";76;13;11;100
2012;"CAPINOPOLIS (MG)";"MG";"CAPINOPOLIS";267;28;75;370
2012;"CAPITAO ANDRADE (MG)";"MG";"CAPITAO ANDRADE";41;5;5;51
2012;"CAPITAO ENEAS (MG)";"MG";"CAPITAO ENEAS";64;3;23;90
2012;"CAPITOLIO (MG)";"MG";"CAPITOLIO";152;19;19;190
2012;"CAPUTIRA (MG)";"MG";"CAPUTIRA";135;8;44;187
2012;"CARAI (MG)";"MG";"CARAI";51;20;34;105
2012;"CARANAIBA (MG)";"MG";"CARANAIBA";24;8;11;43
2012;"CARANDAI (MG)";"MG";"CARANDAI";535;49;100;684
2012;"CARANGOLA (MG)";"MG";"CARANGOLA";379;40;61;480
2012;"CARATINGA (MG)";"MG";"CARATINGA";1246;75;652;1973
2012;"CARBONITA (MG)";"MG";"CARBONITA";149;17;40;206
2012;"CAREACU (MG)";"MG";"CAREACU";126;10;11;147
2012;"CARLOS CHAGAS (MG)";"MG";"CARLOS CHAGAS";139;34;58;231
2012;"CARMESIA (MG)";"MG";"CARMESIA";64;4;1304;1372
2012;"CARMO DA CACHOEIRA (MG)";"MG";"CARMO DA CACHOEIRA";139;34;51;224
2012;"CARMO DA MATA (MG)";"MG";"CARMO DA MATA";126;29;37;192
2012;"CARMO DE MINAS (MG)";"MG";"CARMO DE MINAS";130;42;20;192
2012;"CARMO DO CAJURU (MG)";"MG";"CARMO DO CAJURU";369;45;73;487
2012;"CARMO DO PARANAIBA (MG)";"MG";"CARMO DO PARANAIBA";597;66;103;766
2012;"CARMO DO RIO CLARO (MG)";"MG";"CARMO DO RIO CLARO";351;32;91;474
2012;"CARMOPOLIS DE MINAS (MG)";"MG";"CARMOPOLIS DE MINAS";456;48;44;548
2012;"CARNEIRINHO (MG)";"MG";"CARNEIRINHO";176;16;60;252
2012;"CARRANCAS (MG)";"MG";"CARRANCAS";45;13;10;68
2012;"CARVALHOPOLIS (MG)";"MG";"CARVALHOPOLIS";41;9;6;56
2012;"CARVALHOS (MG)";"MG";"CARVALHOS";62;5;8;75
2012;"CASA GRANDE (MG)";"MG";"CASA GRANDE";33;6;2;41
2012;"CASCALHO RICO (MG)";"MG";"CASCALHO RICO";46;27;3;76
2012;"CASSIA (MG)";"MG";"CASSIA";390;41;57;488
2012;"CATAGUASES (MG)";"MG";"CATAGUASES";661;85;177;923
2012;"CATAS ALTAS (MG)";"MG";"CATAS ALTAS";107;15;7;129
2012;"CATAS ALTAS DA NORUEGA (MG)";"MG";"CATAS ALTAS DA NORUEGA";38;6;8;52
2012;"CATUJI (MG)";"MG";"CATUJI";45;13;13;71
2012;"CATUTI (MG)";"MG";"CATUTI";24;5;17;46
2012;"CAXAMBU (MG)";"MG";"CAXAMBU";188;44;20;252
2012;"CEDRO DO ABAETE (MG)";"MG";"CEDRO DO ABAETE";10;1;1;12
2012;"CENTRAL DE MINAS (MG)";"MG";"CENTRAL DE MINAS";71;7;13;91
2012;"CENTRALINA (MG)";"MG";"CENTRALINA";99;5;14;118
2012;"CHACARA (MG)";"MG";"CHACARA";31;7;9;47
2012;"CHALE (MG)";"MG";"CHALE";64;12;10;86
2012;"CHAPADA DO NORTE (MG)";"MG";"CHAPADA DO NORTE";44;18;20;82
2012;"CHAPADA GAUCHA (MG)";"MG";"CHAPADA GAUCHA";85;7;26;118
2012;"CHIADOR (MG)";"MG";"CHIADOR";61;7;10;78
2012;"CIPOTANEA (MG)";"MG";"CIPOTANEA";41;5;14;60
2012;"CLARAVAL (MG)";"MG";"CLARAVAL";118;7;19;144
2012;"CLARO DOS POCOES (MG)";"MG";"CLARO DOS POCOES";43;8;24;75
2012;"CLAUDIO (MG)";"MG";"CLAUDIO";745;41;53;839
2012;"COIMBRA (MG)";"MG";"COIMBRA";119;4;12;135
2012;"COLUNA (MG)";"MG";"COLUNA";48;2;14;64
2012;"COMENDADOR GOMES (MG)";"MG";"COMENDADOR GOMES";42;8;10;60
2012;"COMERCINHO (MG)";"MG";"COMERCINHO";28;7;18;53
2012;"CONCEICAO DA APARECIDA (MG)";"MG";"CONCEICAO DA APARECIDA";145;16;20;181
2012;"CONCEICAO DA BARRA DE MINAS (MG)";"MG";"CONCEICAO DA BARRA DE MINAS";33;9;7;49
2012;"CONCEICAO DAS ALAGOAS (MG)";"MG";"CONCEICAO DAS ALAGOAS";482;33;101;616
2012;"CONCEICAO DAS PEDRAS (MG)";"MG";"CONCEICAO DAS PEDRAS";24;12;5;41
2012;"CONCEICAO DE IPANEMA (MG)";"MG";"CONCEICAO DE IPANEMA";41;8;2;51
2012;"CONCEICAO DO MATO DENTRO (MG)";"MG";"CONCEICAO DO MATO DENTRO";126;38;173;337
2012;"CONCEICAO DO PARA (MG)";"MG";"CONCEICAO DO PARA";68;12;18;98
2012;"CONCEICAO DO RIO VERDE (MG)";"MG";"CONCEICAO DO RIO VERDE";178;51;31;260
2012;"CONCEICAO DOS OUROS (MG)";"MG";"CONCEICAO DOS OUROS";284;34;15;333
2012;"CONEGO MARINHO (MG)";"MG";"CONEGO MARINHO";18;3;15;36
2012;"CONFINS (MG)";"MG";"CONFINS";116;16;17;149
2012;"CONGONHAL (MG)";"MG";"CONGONHAL";246;11;16;273
2012;"CONGONHAS (MG)";"MG";"CONGONHAS";959;176;121;1256
2012;"CONGONHAS DO NORTE (MG)";"MG";"CONGONHAS DO NORTE";38;6;8;52
2012;"CONQUISTA (MG)";"MG";"CONQUISTA";165;22;40;227
2012;"CONSELHEIRO LAFAIETE (MG)";"MG";"CONSELHEIRO LAFAIETE";1423;319;643;2385
2012;"CONSELHEIRO PENA (MG)";"MG";"CONSELHEIRO PENA";202;1;53;256
2012;"CONSOLACAO (MG)";"MG";"CONSOLACAO";11;9;1;21
2012;"CONTAGEM (MG)";"MG";"CONTAGEM";13999;1563;2834;18396
2012;"COQUEIRAL (MG)";"MG";"COQUEIRAL";93;15;20;128
2012;"CORACAO DE JESUS (MG)";"MG";"CORACAO DE JESUS";151;8;89;248
2012;"CORDISBURGO (MG)";"MG";"CORDISBURGO";84;12;10;106
2012;"CORDISLANDIA (MG)";"MG";"CORDISLANDIA";39;9;7;55
2012;"CORINTO (MG)";"MG";"CORINTO";317;29;67;413
2012;"COROACI (MG)";"MG";"COROACI";55;10;10;75
2012;"COROMANDEL (MG)";"MG";"COROMANDEL";547;67;82;696
2012;"CORONEL FABRICIANO (MG)";"MG";"CORONEL FABRICIANO";1231;161;573;1965
2012;"CORONEL MURTA (MG)";"MG";"CORONEL MURTA";26;3;13;42
2012;"CORONEL PACHECO (MG)";"MG";"CORONEL PACHECO";35;7;8;50
2012;"CORONEL XAVIER CHAVES (MG)";"MG";"CORONEL XAVIER CHAVES";83;7;3;93
2012;"CORREGO DANTA (MG)";"MG";"CORREGO DANTA";38;4;13;55
2012;"CORREGO DO BOM JESUS (MG)";"MG";"CORREGO DO BOM JESUS";35;11;9;55
2012;"CORREGO FUNDO (MG)";"MG";"CORREGO FUNDO";359;17;17;393
2012;"CORREGO NOVO (MG)";"MG";"CORREGO NOVO";11;5;5;21
2012;"COUTO DE MAGALHAES DE MINAS (MG)";"MG";"COUTO DE MAGALHAES DE MINAS";43;3;10;56
2012;"CRISOLITA (MG)";"MG";"CRISOLITA";12;16;13;41
2012;"CRISTAIS (MG)";"MG";"CRISTAIS";140;19;24;183
2012;"CRISTALIA (MG)";"MG";"CRISTALIA";23;4;19;46
2012;"CRISTIANO OTONI (MG)";"MG";"CRISTIANO OTONI";70;15;10;95
2012;"CRISTINA (MG)";"MG";"CRISTINA";111;23;11;145
2012;"CRUCILANDIA (MG)";"MG";"CRUCILANDIA";140;8;11;159
2012;"CRUZEIRO DA FORTALEZA (MG)";"MG";"CRUZEIRO DA FORTALEZA";72;5;13;90
2012;"CRUZILIA (MG)";"MG";"CRUZILIA";326;30;26;382
2012;"CUPARAQUE (MG)";"MG";"CUPARAQUE";41;10;4;55
2012;"CURRAL DE DENTRO (MG)";"MG";"CURRAL DE DENTRO";49;10;13;72
2012;"CURVELO (MG)";"MG";"CURVELO";1083;57;1862;3002
2012;"DATAS (MG)";"MG";"DATAS";29;4;13;46
2012;"DELFIM MOREIRA (MG)";"MG";"DELFIM MOREIRA";80;7;21;108
2012;"DELFINOPOLIS (MG)";"MG";"DELFINOPOLIS";82;17;8;107
2012;"DELTA (MG)";"MG";"DELTA";432;43;122;597
2012;"DESCOBERTO (MG)";"MG";"DESCOBERTO";33;10;2;45
2012;"DESTERRO DE ENTRE RIOS (MG)";"MG";"DESTERRO DE ENTRE RIOS";93;16;19;128
2012;"DESTERRO DO MELO (MG)";"MG";"DESTERRO DO MELO";33;7;11;51
2012;"DIAMANTINA (MG)";"MG";"DIAMANTINA";351;70;371;792
2012;"DIOGO DE VASCONCELOS (MG)";"MG";"DIOGO DE VASCONCELOS";20;4;7;31
2012;"DIONISIO (MG)";"MG";"DIONISIO";42;6;15;63
2012;"DIVINESIA (MG)";"MG";"DIVINESIA";76;5;6;87
2012;"DIVINO (MG)";"MG";"DIVINO";236;14;48;298
2012;"DIVINO DAS LARANJEIRAS (MG)";"MG";"DIVINO DAS LARANJEIRAS";39;2;8;49
2012;"DIVINOLANDIA DE MINAS (MG)";"MG";"DIVINOLANDIA DE MINAS";58;4;16;78
2012;"DIVINOPOLIS (MG)";"MG";"DIVINOPOLIS";3279;239;719;4237
2012;"DIVISA ALEGRE (MG)";"MG";"DIVISA ALEGRE";44;2;7;53
2012;"DIVISA NOVA (MG)";"MG";"DIVISA NOVA";71;27;27;125
2012;"DIVISOPOLIS (MG)";"MG";"DIVISOPOLIS";35;9;8;52
2012;"DOM BOSCO (MG)";"MG";"DOM BOSCO";23;4;11;38
2012;"DOM CAVATI (MG)";"MG";"DOM CAVATI";191;12;10;213
2012;"DOM JOAQUIM (MG)";"MG";"DOM JOAQUIM";27;4;9;40
2012;"DOM SILVERIO (MG)";"MG";"DOM SILVERIO";67;8;7;82
2012;"DOM VICOSO (MG)";"MG";"DOM VICOSO";28;10;9;47
2012;"DONA EUZEBIA (MG)";"MG";"DONA EUZEBIA";288;6;5;299
2012;"DORES DE CAMPOS (MG)";"MG";"DORES DE CAMPOS";86;12;40;138
2012;"DORES DE GUANHAES (MG)";"MG";"DORES DE GUANHAES";35;5;22;62
2012;"DORES DO INDAIA (MG)";"MG";"DORES DO INDAIA";223;29;16;268
2012;"DORES DO TURVO (MG)";"MG";"DORES DO TURVO";44;4;16;64
2012;"DORESOPOLIS (MG)";"MG";"DORESOPOLIS";14;7;2;23
2012;"DOURADOQUARA (MG)";"MG";"DOURADOQUARA";23;8;1;32
2012;"DURANDE (MG)";"MG";"DURANDE";92;9;15;116
2012;"ELOI MENDES (MG)";"MG";"ELOI MENDES";492;66;50;608
2012;"ENGENHEIRO CALDAS (MG)";"MG";"ENGENHEIRO CALDAS";142;8;8;158
2012;"ENGENHEIRO NAVARRO (MG)";"MG";"ENGENHEIRO NAVARRO";54;2;20;76
2012;"ENTRE FOLHAS (MG)";"MG";"ENTRE FOLHAS";57;3;7;67
2012;"ENTRE RIOS DE MINAS (MG)";"MG";"ENTRE RIOS DE MINAS";293;24;73;390
2012;"ERVALIA (MG)";"MG";"ERVALIA";303;16;40;359
2012;"ESMERALDAS (MG)";"MG";"ESMERALDAS";425;35;311;771
2012;"ESPERA FELIZ (MG)";"MG";"ESPERA FELIZ";324;34;44;402
2012;"ESPINOSA (MG)";"MG";"ESPINOSA";268;17;64;349
2012;"ESPIRITO SANTO DO DOURADO (MG)";"MG";"ESPIRITO SANTO DO DOURADO";68;4;5;77
2012;"ESTIVA (MG)";"MG";"ESTIVA";285;22;16;323
2012;"ESTRELA DALVA (MG)";"MG";"ESTRELA DALVA";28;4;1;33
2012;"ESTRELA DO INDAIA (MG)";"MG";"ESTRELA DO INDAIA";44;9;4;57
2012;"ESTRELA DO SUL (MG)";"MG";"ESTRELA DO SUL";110;19;19;148
2012;"EUGENOPOLIS (MG)";"MG";"EUGENOPOLIS";98;31;27;156
2012;"EWBANK DA CAMARA (MG)";"MG";"EWBANK DA CAMARA";39;5;2;46
2012;"EXTREMA (MG)";"MG";"EXTREMA";571;96;99;766
2012;"FAMA (MG)";"MG";"FAMA";17;9;1;27
2012;"FARIA LEMOS (MG)";"MG";"FARIA LEMOS";25;8;1;34
2012;"FELICIO DOS SANTOS (MG)";"MG";"FELICIO DOS SANTOS";35;11;22;68
2012;"FELISBURGO (MG)";"MG";"FELISBURGO";18;5;9;32
2012;"FELIXLANDIA (MG)";"MG";"FELIXLANDIA";196;17;60;273
2012;"FERNANDES TOURINHO (MG)";"MG";"FERNANDES TOURINHO";20;11;10;41
2012;"FERROS (MG)";"MG";"FERROS";100;13;46;159
2012;"FERVEDOURO (MG)";"MG";"FERVEDOURO";111;11;9;131
2012;"FLORESTAL (MG)";"MG";"FLORESTAL";147;21;34;202
2012;"FORMIGA (MG)";"MG";"FORMIGA";1649;151;232;2032
2012;"FORMOSO (MG)";"MG";"FORMOSO";43;2;26;71
2012;"FORTALEZA DE MINAS (MG)";"MG";"FORTALEZA DE MINAS";47;24;10;81
2012;"FORTUNA DE MINAS (MG)";"MG";"FORTUNA DE MINAS";29;6;10;45
2012;"FRANCISCO BADARO (MG)";"MG";"FRANCISCO BADARO";55;2;18;75
2012;"FRANCISCO DUMONT (MG)";"MG";"FRANCISCO DUMONT";52;5;32;89
2012;"FRANCISCO SA (MG)";"MG";"FRANCISCO SA";138;8;80;226
2012;"FRANCISCOPOLIS (MG)";"MG";"FRANCISCOPOLIS";15;8;14;37
2012;"FREI GASPAR (MG)";"MG";"FREI GASPAR";28;8;12;48
2012;"FREI INOCENCIO (MG)";"MG";"FREI INOCENCIO";92;7;21;120
2012;"FREI LAGONEGRO (MG)";"MG";"FREI LAGONEGRO";7;3;7;17
2012;"FRONTEIRA (MG)";"MG";"FRONTEIRA";199;37;66;302
2012;"FRONTEIRA DOS VALES (MG)";"MG";"FRONTEIRA DOS VALES";10;5;1;16
2012;"FRUTA DE LEITE (MG)";"MG";"FRUTA DE LEITE";20;3;28;51
2012;"FRUTAL (MG)";"MG";"FRUTAL";1447;128;196;1771
2012;"FUNILANDIA (MG)";"MG";"FUNILANDIA";42;6;14;62
2012;"GALILEIA (MG)";"MG";"GALILEIA";63;1;11;75
2012;"GAMELEIRAS (MG)";"MG";"GAMELEIRAS";25;6;16;47
2012;"GLAUCILANDIA (MG)";"MG";"GLAUCILANDIA";2;2;3;7
2012;"GOIABEIRA (MG)";"MG";"GOIABEIRA";26;11;4;41
2012;"GOIANA (MG)";"MG";"GOIANA";20;11;4;35
2012;"GONCALVES (MG)";"MG";"GONCALVES";96;16;7;119
2012;"GONZAGA (MG)";"MG";"GONZAGA";37;6;10;53
2012;"GOUVEA (MG)";"MG";"GOUVEA";130;15;32;177
2012;"GOVERNADOR VALADARES (MG)";"MG";"GOVERNADOR VALADARES";3348;263;344;3955
2012;"GRAO MOGOL (MG)";"MG";"GRAO MOGOL";76;15;68;159
2012;"GRUPIARA (MG)";"MG";"GRUPIARA";10;4;4;18
2012;"GUANHAES (MG)";"MG";"GUANHAES";526;45;95;666
2012;"GUAPE (MG)";"MG";"GUAPE";237;22;52;311
2012;"GUARACIABA (MG)";"MG";"GUARACIABA";68;17;33;118
2012;"GUARACIAMA (MG)";"MG";"GUARACIAMA";35;3;14;52
2012;"GUARANESIA (MG)";"MG";"GUARANESIA";323;45;101;469
2012;"GUARANI (MG)";"MG";"GUARANI";81;20;9;110
2012;"GUARARA (MG)";"MG";"GUARARA";51;12;3;66
2012;"GUARDA MOR (MG)";"MG";"GUARDA MOR";93;12;18;123
2012;"GUAXUPE (MG)";"MG";"GUAXUPE";835;83;161;1079
2012;"GUIDOVAL (MG)";"MG";"GUIDOVAL";144;2;7;153
2012;"GUIMARANIA (MG)";"MG";"GUIMARANIA";131;9;30;170
2012;"GUIRICEMA (MG)";"MG";"GUIRICEMA";261;17;22;300
2012;"GURINHATA (MG)";"MG";"GURINHATA";74;15;21;110
2012;"HELIODORA (MG)";"MG";"HELIODORA";79;9;14;102
2012;"IAPU (MG)";"MG";"IAPU";116;14;17;147
2012;"IBERTIOGA (MG)";"MG";"IBERTIOGA";40;12;4;56
2012;"IBIA (MG)";"MG";"IBIA";369;47;89;505
2012;"IBIAI (MG)";"MG";"IBIAI";45;8;7;60
2012;"IBIRACATU (MG)";"MG";"IBIRACATU";15;7;16;38
2012;"IBIRACI (MG)";"MG";"IBIRACI";338;34;40;412
2012;"IBIRITE (MG)";"MG";"IBIRITE";1280;207;303;1790
2012;"IBITIURA DE MINAS (MG)";"MG";"IBITIURA DE MINAS";102;7;4;113
2012;"IBITURUNA (MG)";"MG";"IBITURUNA";24;4;3;31
2012;"ICARAI DE MINAS (MG)";"MG";"ICARAI DE MINAS";24;1;6;31
2012;"IGARAPE (MG)";"MG";"IGARAPE";677;53;184;914
2012;"IGARATINGA (MG)";"MG";"IGARATINGA";490;11;15;516
2012;"IGUATAMA (MG)";"MG";"IGUATAMA";124;13;18;155
2012;"IJACI (MG)";"MG";"IJACI";191;10;16;217
2012;"ILICINEA (MG)";"MG";"ILICINEA";201;14;37;252
2012;"IMBE DE MINAS (MG)";"MG";"IMBE DE MINAS";41;2;9;52
2012;"INCONFIDENTES (MG)";"MG";"INCONFIDENTES";71;20;29;120
2012;"INDAIABIRA (MG)";"MG";"INDAIABIRA";60;6;22;88
2012;"INDIANOPOLIS (MG)";"MG";"INDIANOPOLIS";75;31;21;127
2012;"INGAI (MG)";"MG";"INGAI";18;15;9;42
2012;"INHAPIM (MG)";"MG";"INHAPIM";393;23;71;487
2012;"INHAUMA (MG)";"MG";"INHAUMA";96;6;19;121
2012;"INIMUTABA (MG)";"MG";"INIMUTABA";38;6;11;55
2012;"IPABA (MG)";"MG";"IPABA";87;15;15;117
2012;"IPANEMA (MG)";"MG";"IPANEMA";235;30;30;295
2012;"IPATINGA (MG)";"MG";"IPATINGA";3129;549;652;4330
2012;"IPIACU (MG)";"MG";"IPIACU";53;3;12;68
2012;"IPUIUNA (MG)";"MG";"IPUIUNA";347;30;21;398
2012;"IRAI DE MINAS (MG)";"MG";"IRAI DE MINAS";200;16;28;244
2012;"ITABIRA (MG)";"MG";"ITABIRA";1658;337;545;2540
2012;"ITABIRINHA (MG)";"MG";"ITABIRINHA";116;6;29;151
2012;"ITABIRITO (MG)";"MG";"ITABIRITO";936;208;371;1515
2012;"ITACAMBIRA (MG)";"MG";"ITACAMBIRA";13;1;8;22
2012;"ITACARAMBI (MG)";"MG";"ITACARAMBI";97;6;30;133
2012;"ITAGUARA (MG)";"MG";"ITAGUARA";451;19;52;522
2012;"ITAIPE (MG)";"MG";"ITAIPE";65;7;26;98
2012;"ITAJUBA (MG)";"MG";"ITAJUBA";831;103;117;1051
2012;"ITAMARANDIBA (MG)";"MG";"ITAMARANDIBA";625;40;110;775
2012;"ITAMARATI DE MINAS (MG)";"MG";"ITAMARATI DE MINAS";118;13;13;144
2012;"ITAMBACURI (MG)";"MG";"ITAMBACURI";184;21;38;243
2012;"ITAMBE DO MATO DENTRO (MG)";"MG";"ITAMBE DO MATO DENTRO";19;8;3;30
2012;"ITAMOGI (MG)";"MG";"ITAMOGI";236;20;31;287
2012;"ITAMONTE (MG)";"MG";"ITAMONTE";305;23;24;352
2012;"ITANHANDU (MG)";"MG";"ITANHANDU";391;28;30;449
2012;"ITANHOMI (MG)";"MG";"ITANHOMI";96;16;18;130
2012;"ITAOBIM (MG)";"MG";"ITAOBIM";207;27;42;276
2012;"ITAPAGIPE (MG)";"MG";"ITAPAGIPE";210;18;34;262
2012;"ITAPECERICA (MG)";"MG";"ITAPECERICA";331;48;63;442
2012;"ITAPEVA (MG)";"MG";"ITAPEVA";250;25;9;284
2012;"ITATIAIUCU (MG)";"MG";"ITATIAIUCU";349;15;37;401
2012;"ITAU DE MINAS (MG)";"MG";"ITAU DE MINAS";274;43;41;358
2012;"ITAUNA (MG)";"MG";"ITAUNA";1474;237;264;1975
2012;"ITAVERAVA (MG)";"MG";"ITAVERAVA";53;5;9;67
2012;"ITINGA (MG)";"MG";"ITINGA";62;20;35;117
2012;"ITUETA (MG)";"MG";"ITUETA";56;8;16;80
2012;"ITUIUTABA (MG)";"MG";"ITUIUTABA";1202;209;319;1730
2012;"ITUMIRIM (MG)";"MG";"ITUMIRIM";56;24;6;86
2012;"ITURAMA (MG)";"MG";"ITURAMA";784;89;310;1183
2012;"ITUTINGA (MG)";"MG";"ITUTINGA";63;25;2;90
2012;"JABOTICATUBAS (MG)";"MG";"JABOTICATUBAS";248;9;60;317
2012;"JACINTO (MG)";"MG";"JACINTO";27;7;38;72
2012;"JACUI (MG)";"MG";"JACUI";125;14;25;164
2012;"JACUTINGA (MG)";"MG";"JACUTINGA";356;59;61;476
2012;"JAGUARACU (MG)";"MG";"JAGUARACU";50;5;4;59
2012;"JAIBA (MG)";"MG";"JAIBA";322;17;111;450
2012;"JAMPRUCA (MG)";"MG";"JAMPRUCA";15;4;19;38
2012;"JANAUBA (MG)";"MG";"JANAUBA";808;31;138;977
2012;"JANUARIA (MG)";"MG";"JANUARIA";365;25;101;491
2012;"JAPARAIBA (MG)";"MG";"JAPARAIBA";71;6;19;96
2012;"JAPONVAR (MG)";"MG";"JAPONVAR";16;5;12;33
2012;"JECEABA (MG)";"MG";"JECEABA";119;35;14;168
2012;"JENIPAPO DE MINAS (MG)";"MG";"JENIPAPO DE MINAS";27;13;21;61
2012;"JEQUERI (MG)";"MG";"JEQUERI";87;9;26;122
2012;"JEQUITAI (MG)";"MG";"JEQUITAI";60;3;25;88
2012;"JEQUITIBA (MG)";"MG";"JEQUITIBA";79;10;24;113
2012;"JEQUITINHONHA (MG)";"MG";"JEQUITINHONHA";93;27;27;147
2012;"JESUANIA (MG)";"MG";"JESUANIA";66;20;12;98
2012;"JOAIMA (MG)";"MG";"JOAIMA";58;7;29;94
2012;"JOANESIA (MG)";"MG";"JOANESIA";13;5;14;32
2012;"JOAO MONLEVADE (MG)";"MG";"JOAO MONLEVADE";1180;144;251;1575
2012;"JOAO PINHEIRO (MG)";"MG";"JOAO PINHEIRO";888;50;211;1149
2012;"JOAQUIM FELICIO (MG)";"MG";"JOAQUIM FELICIO";41;2;9;52
2012;"JORDANIA (MG)";"MG";"JORDANIA";26;9;19;54
2012;"JOSE GONCALVES DE MINAS (MG)";"MG";"JOSE GONCALVES DE MINAS";23;7;12;42
2012;"JOSE RAYDAN (MG)";"MG";"JOSE RAYDAN";22;2;16;40
2012;"JOSENOPOLIS (MG)";"MG";"JOSENOPOLIS";18;4;8;30
2012;"JUATUBA (MG)";"MG";"JUATUBA";280;36;203;519
2012;"JUIZ DE FORA (MG)";"MG";"JUIZ DE FORA";5717;754;1580;8051
2012;"JURAMENTO (MG)";"MG";"JURAMENTO";18;2;12;32
2012;"JURUAIA (MG)";"MG";"JURUAIA";92;23;22;137
2012;"JUVENILIA (MG)";"MG";"JUVENILIA";19;6;8;33
2012;"LADAINHA (MG)";"MG";"LADAINHA";53;14;37;104
2012;"LAGAMAR (MG)";"MG";"LAGAMAR";82;20;21;123
2012;"LAGOA DA PRATA (MG)";"MG";"LAGOA DA PRATA";961;65;146;1172
2012;"LAGOA DOS PATOS (MG)";"MG";"LAGOA DOS PATOS";33;2;10;45
2012;"LAGOA DOURADA (MG)";"MG";"LAGOA DOURADA";397;27;78;502
2012;"LAGOA FORMOSA (MG)";"MG";"LAGOA FORMOSA";307;24;79;410
2012;"LAGOA GRANDE (MG)";"MG";"LAGOA GRANDE";92;12;50;154
2012;"LAGOA SANTA (MG)";"MG";"LAGOA SANTA";759;108;129;996
2012;"LAJINHA (MG)";"MG";"LAJINHA";268;25;47;340
2012;"LAMBARI (MG)";"MG";"LAMBARI";284;43;22;349
2012;"LAMIM (MG)";"MG";"LAMIM";41;3;6;50
2012;"LARANJAL (MG)";"MG";"LARANJAL";130;10;2;142
2012;"LASSANCE (MG)";"MG";"LASSANCE";36;9;7;52
2012;"LAVRAS (MG)";"MG";"LAVRAS";1327;193;261;1781
2012;"LEANDRO FERREIRA (MG)";"MG";"LEANDRO FERREIRA";32;7;5;44
2012;"LEME DO PRADO (MG)";"MG";"LEME DO PRADO";31;5;27;63
2012;"LEOPOLDINA (MG)";"MG";"LEOPOLDINA";663;67;85;815
2012;"LIBERDADE (MG)";"MG";"LIBERDADE";89;16;5;110
2012;"LIMA DUARTE (MG)";"MG";"LIMA DUARTE";173;29;33;235
2012;"LIMEIRA DO OESTE (MG)";"MG";"LIMEIRA DO OESTE";155;37;53;245
2012;"LONTRA (MG)";"MG";"LONTRA";24;5;9;38
2012;"LUISBURGO (MG)";"MG";"LUISBURGO";29;8;20;57
2012;"LUISLANDIA (MG)";"MG";"LUISLANDIA";14;5;10;29
2012;"LUMINARIAS (MG)";"MG";"LUMINARIAS";100;6;40;146
2012;"LUZ (MG)";"MG";"LUZ";309;58;29;396
2012;"MACHACALIS (MG)";"MG";"MACHACALIS";27;2;7;36
2012;"MACHADO (MG)";"MG";"MACHADO";728;121;111;960
2012;"MADRE DE DEUS DE MINAS (MG)";"MG";"MADRE DE DEUS DE MINAS";83;7;8;98
2012;"MALACACHETA (MG)";"MG";"MALACACHETA";107;11;43;161
2012;"MAMONAS (MG)";"MG";"MAMONAS";91;8;26;125
2012;"MANGA (MG)";"MG";"MANGA";122;10;46;178
2012;"MANHUACU (MG)";"MG";"MANHUACU";1498;111;150;1759
2012;"MANHUMIRIM (MG)";"MG";"MANHUMIRIM";309;29;41;379
2012;"MANTENA (MG)";"MG";"MANTENA";515;40;87;642
2012;"MAR DE ESPANHA (MG)";"MG";"MAR DE ESPANHA";150;24;14;188
2012;"MARAVILHAS (MG)";"MG";"MARAVILHAS";165;19;8;192
2012;"MARIA DA FE (MG)";"MG";"MARIA DA FE";239;14;29;282
2012;"MARIANA (MG)";"MG";"MARIANA";621;197;341;1159
2012;"MARILAC (MG)";"MG";"MARILAC";19;5;9;33
2012;"MARIO CAMPOS (MG)";"MG";"MARIO CAMPOS";202;24;13;239
2012;"MARIPA DE MINAS (MG)";"MG";"MARIPA DE MINAS";39;5;5;49
2012;"MARLIERIA (MG)";"MG";"MARLIERIA";35;3;8;46
2012;"MARMELOPOLIS (MG)";"MG";"MARMELOPOLIS";38;9;7;54
2012;"MARTINHO CAMPOS (MG)";"MG";"MARTINHO CAMPOS";365;35;72;472
2012;"MARTINS SOARES (MG)";"MG";"MARTINS SOARES";83;5;13;101
2012;"MATA VERDE (MG)";"MG";"MATA VERDE";24;20;5;49
2012;"MATERLANDIA (MG)";"MG";"MATERLANDIA";13;4;3;20
2012;"MATEUS LEME (MG)";"MG";"MATEUS LEME";670;86;130;886
2012;"MATHIAS LOBATO (MG)";"MG";"MATHIAS LOBATO";35;2;6;43
2012;"MATIAS BARBOSA (MG)";"MG";"MATIAS BARBOSA";629;38;41;708
2012;"MATIAS CARDOSO (MG)";"MG";"MATIAS CARDOSO";29;4;15;48
2012;"MATIPO (MG)";"MG";"MATIPO";269;25;44;338
2012;"MATO VERDE (MG)";"MG";"MATO VERDE";142;8;30;180
2012;"MATOZINHOS (MG)";"MG";"MATOZINHOS";352;92;176;620
2012;"MATUTINA (MG)";"MG";"MATUTINA";72;19;5;96
2012;"MEDEIROS (MG)";"MG";"MEDEIROS";56;21;4;81
2012;"MEDINA (MG)";"MG";"MEDINA";147;48;37;232
2012;"MENDES PIMENTEL (MG)";"MG";"MENDES PIMENTEL";43;7;10;60
2012;"MERCES (MG)";"MG";"MERCES";184;14;9;207
2012;"MESQUITA (MG)";"MG";"MESQUITA";21;12;7;40
2012;"MINAS NOVAS (MG)";"MG";"MINAS NOVAS";133;32;86;251
2012;"MINDURI (MG)";"MG";"MINDURI";73;11;4;88
2012;"MIRABELA (MG)";"MG";"MIRABELA";93;14;26;133
2012;"MIRADOURO (MG)";"MG";"MIRADOURO";113;21;27;161
2012;"MIRAI (MG)";"MG";"MIRAI";153;14;20;187
2012;"MIRAVANIA (MG)";"MG";"MIRAVANIA";9;3;14;26
2012;"MOEDA (MG)";"MG";"MOEDA";127;5;22;154
2012;"MOEMA (MG)";"MG";"MOEMA";162;10;128;300
2012;"MONJOLOS (MG)";"MG";"MONJOLOS";7;3;7;17
2012;"MONSENHOR PAULO (MG)";"MG";"MONSENHOR PAULO";176;22;16;214
2012;"MONTALVANIA (MG)";"MG";"MONTALVANIA";113;6;49;168
2012;"MONTE ALEGRE DE MINAS (MG)";"MG";"MONTE ALEGRE DE MINAS";502;48;43;593
2012;"MONTE AZUL (MG)";"MG";"MONTE AZUL";167;13;60;240
2012;"MONTE BELO (MG)";"MG";"MONTE BELO";253;43;50;346
2012;"MONTE CARMELO (MG)";"MG";"MONTE CARMELO";1358;107;144;1609
2012;"MONTE FORMOSO (MG)";"MG";"MONTE FORMOSO";14;9;29;52
2012;"MONTE SANTO DE MINAS (MG)";"MG";"MONTE SANTO DE MINAS";452;45;111;608
2012;"MONTE SIAO (MG)";"MG";"MONTE SIAO";252;42;37;331
2012;"MONTES CLAROS (MG)";"MG";"MONTES CLAROS";4370;288;1034;5692
2012;"MONTEZUMA (MG)";"MG";"MONTEZUMA";28;9;24;61
2012;"MORADA NOVA DE MINAS (MG)";"MG";"MORADA NOVA DE MINAS";113;21;21;155
2012;"MORRO DA GARCA (MG)";"MG";"MORRO DA GARCA";43;6;21;70
2012;"MORRO DO PILAR (MG)";"MG";"MORRO DO PILAR";27;7;2;36
2012;"MUNHOZ (MG)";"MG";"MUNHOZ";143;17;10;170
2012;"MURIAE (MG)";"MG";"MURIAE";1381;120;189;1690
2012;"MUTUM (MG)";"MG";"MUTUM";208;28;75;311
2012;"MUZAMBINHO (MG)";"MG";"MUZAMBINHO";420;80;53;553
2012;"NACIP RAYDAN (MG)";"MG";"NACIP RAYDAN";7;0;4;11
2012;"NANUQUE (MG)";"MG";"NANUQUE";589;64;187;840
2012;"NAQUE (MG)";"MG";"NAQUE";34;5;17;56
2012;"NATALANDIA (MG)";"MG";"NATALANDIA";26;2;15;43
2012;"NATERCIA (MG)";"MG";"NATERCIA";79;12;18;109
2012;"NAZARENO (MG)";"MG";"NAZARENO";168;14;29;211
2012;"NEPOMUCENO (MG)";"MG";"NEPOMUCENO";420;34;92;546
2012;"NINHEIRA (MG)";"MG";"NINHEIRA";31;5;23;59
2012;"NOVA BELEM (MG)";"MG";"NOVA BELEM";34;4;13;51
2012;"NOVA ERA (MG)";"MG";"NOVA ERA";216;21;66;303
2012;"NOVA LIMA (MG)";"MG";"NOVA LIMA";1307;347;189;1843
2012;"NOVA MODICA (MG)";"MG";"NOVA MODICA";17;3;13;33
2012;"NOVA PONTE (MG)";"MG";"NOVA PONTE";228;62;71;361
2012;"NOVA PORTEIRINHA (MG)";"MG";"NOVA PORTEIRINHA";38;5;14;57
2012;"NOVA RESENDE (MG)";"MG";"NOVA RESENDE";342;31;57;430
2012;"NOVA SERRANA (MG)";"MG";"NOVA SERRANA";546;58;119;723
2012;"NOVA UNIAO (MG)";"MG";"NOVA UNIAO";137;11;18;166
2012;"NOVO CRUZEIRO (MG)";"MG";"NOVO CRUZEIRO";166;34;96;296
2012;"NOVO ORIENTE DE MINAS (MG)";"MG";"NOVO ORIENTE DE MINAS";46;23;16;85
2012;"NOVORIZONTE (MG)";"MG";"NOVORIZONTE";55;2;17;74
2012;"OLARIA (MG)";"MG";"OLARIA";15;5;4;24
2012;"OLHOS D AGUA (MG)";"MG";"OLHOS D AGUA";70;14;34;118
2012;"OLIMPIO NORONHA (MG)";"MG";"OLIMPIO NORONHA";23;12;7;42
2012;"OLIVEIRA (MG)";"MG";"OLIVEIRA";754;75;120;949
2012;"OLIVEIRA FORTES (MG)";"MG";"OLIVEIRA FORTES";23;4;2;29
2012;"ONCA DE PITANGUI (MG)";"MG";"ONCA DE PITANGUI";29;10;10;49
2012;"ORATORIOS (MG)";"MG";"ORATORIOS";74;7;18;99
2012;"ORIZANIA (MG)";"MG";"ORIZANIA";61;12;14;87
2012;"OURO BRANCO (MG)";"MG";"OURO BRANCO";568;132;200;900
2012;"OURO FINO (MG)";"MG";"OURO FINO";535;73;83;691
2012;"OURO PRETO (MG)";"MG";"OURO PRETO";970;221;277;1468
2012;"OURO VERDE DE MINAS (MG)";"MG";"OURO VERDE DE MINAS";24;7;6;37
2012;"PADRE CARVALHO (MG)";"MG";"PADRE CARVALHO";26;7;25;58
2012;"PADRE PARAISO (MG)";"MG";"PADRE PARAISO";140;63;60;263
2012;"PAI PEDRO (MG)";"MG";"PAI PEDRO";12;5;21;38
2012;"PAINEIRAS (MG)";"MG";"PAINEIRAS";79;16;9;104
2012;"PAINS (MG)";"MG";"PAINS";240;17;21;278
2012;"PAIVA (MG)";"MG";"PAIVA";11;1;1;13
2012;"PALMA (MG)";"MG";"PALMA";97;7;6;110
2012;"PALMOPOLIS (MG)";"MG";"PALMOPOLIS";13;7;9;29
2012;"PAPAGAIOS (MG)";"MG";"PAPAGAIOS";538;11;56;605
2012;"PARA DE MINAS (MG)";"MG";"PARA DE MINAS";2175;164;221;2560
2012;"PARACATU (MG)";"MG";"PARACATU";1469;116;359;1944
2012;"PARAGUACU (MG)";"MG";"PARAGUACU";300;52;36;388
2012;"PARAISOPOLIS (MG)";"MG";"PARAISOPOLIS";333;47;38;418
2012;"PARAOPEBA (MG)";"MG";"PARAOPEBA";453;28;51;532
2012;"PASSA QUATRO (MG)";"MG";"PASSA QUATRO";340;25;25;390
2012;"PASSA TEMPO (MG)";"MG";"PASSA TEMPO";181;33;17;231
2012;"PASSA VINTE (MG)";"MG";"PASSA VINTE";87;18;8;113
2012;"PASSABEM (MG)";"MG";"PASSABEM";14;4;2;20
2012;"PASSOS (MG)";"MG";"PASSOS";1971;169;386;2526
2012;"PATIS (MG)";"MG";"PATIS";10;3;8;21
2012;"PATOS DE MINAS (MG)";"MG";"PATOS DE MINAS";3054;162;393;3609
2012;"PATROCINIO (MG)";"MG";"PATROCINIO";1748;152;575;2475
2012;"PATROCINIO DO MURIAE (MG)";"MG";"PATROCINIO DO MURIAE";83;11;7;101
2012;"PAULA CANDIDO (MG)";"MG";"PAULA CANDIDO";76;12;14;102
2012;"PAULISTAS (MG)";"MG";"PAULISTAS";24;3;9;36
2012;"PAVAO (MG)";"MG";"PAVAO";42;18;10;70
2012;"PECANHA (MG)";"MG";"PECANHA";117;9;53;179
2012;"PEDRA AZUL (MG)";"MG";"PEDRA AZUL";133;18;49;200
2012;"PEDRA BONITA (MG)";"MG";"PEDRA BONITA";49;16;16;81
2012;"PEDRA DO ANTA (MG)";"MG";"PEDRA DO ANTA";30;3;15;48
2012;"PEDRA DO INDAIA (MG)";"MG";"PEDRA DO INDAIA";70;9;3;82
2012;"PEDRA DOURADA (MG)";"MG";"PEDRA DOURADA";17;6;10;33
2012;"PEDRALVA (MG)";"MG";"PEDRALVA";143;23;25;191
2012;"PEDRAS DE MARIA DA CRUZ (MG)";"MG";"PEDRAS DE MARIA DA CRUZ";28;3;39;70
2012;"PEDRINOPOLIS (MG)";"MG";"PEDRINOPOLIS";63;21;5;89
2012;"PEDRO LEOPOLDO (MG)";"MG";"PEDRO LEOPOLDO";1142;171;251;1564
2012;"PEDRO TEIXEIRA (MG)";"MG";"PEDRO TEIXEIRA";18;8;3;29
2012;"PEQUERI (MG)";"MG";"PEQUERI";73;7;3;83
2012;"PEQUI (MG)";"MG";"PEQUI";55;16;6;77
2012;"PERDIGAO (MG)";"MG";"PERDIGAO";153;13;8;174
2012;"PERDIZES (MG)";"MG";"PERDIZES";269;52;42;363
2012;"PERDOES (MG)";"MG";"PERDOES";505;34;70;609
2012;"PERIQUITO (MG)";"MG";"PERIQUITO";51;5;19;75
2012;"PESCADOR (MG)";"MG";"PESCADOR";15;7;7;29
2012;"PIAU (MG)";"MG";"PIAU";42;10;6;58
2012;"PIEDADE DE CARATINGA (MG)";"MG";"PIEDADE DE CARATINGA";136;11;14;161
2012;"PIEDADE DE PONTE NOVA (MG)";"MG";"PIEDADE DE PONTE NOVA";35;4;16;55
2012;"PIEDADE DO RIO GRANDE (MG)";"MG";"PIEDADE DO RIO GRANDE";51;7;5;63
2012;"PIEDADE DOS GERAIS (MG)";"MG";"PIEDADE DOS GERAIS";78;6;13;97
2012;"PIMENTA (MG)";"MG";"PIMENTA";228;15;26;269
2012;"PINGO D AGUA (MG)";"MG";"PINGO D AGUA";21;4;5;30
2012;"PINTOPOLIS (MG)";"MG";"PINTOPOLIS";15;2;6;23
2012;"PIRACEMA (MG)";"MG";"PIRACEMA";100;11;17;128
2012;"PIRAJUBA (MG)";"MG";"PIRAJUBA";140;24;7;171
2012;"PIRANGA (MG)";"MG";"PIRANGA";151;20;45;216
2012;"PIRANGUCU (MG)";"MG";"PIRANGUCU";42;25;32;99
2012;"PIRANGUINHO (MG)";"MG";"PIRANGUINHO";180;22;19;221
2012;"PIRAPETINGA (MG)";"MG";"PIRAPETINGA";370;22;32;424
2012;"PIRAPORA (MG)";"MG";"PIRAPORA";594;38;156;788
2012;"PIRAUBA (MG)";"MG";"PIRAUBA";130;23;13;166
2012;"PITANGUI (MG)";"MG";"PITANGUI";539;69;87;695
2012;"PIUMHI (MG)";"MG";"PIUMHI";774;74;86;934
2012;"PLANURA (MG)";"MG";"PLANURA";145;18;54;217
2012;"POCO FUNDO (MG)";"MG";"POCO FUNDO";289;45;24;358
2012;"POCOS DE CALDAS (MG)";"MG";"POCOS DE CALDAS";2826;550;430;3806
2012;"POCRANE (MG)";"MG";"POCRANE";72;8;8;88
2012;"POMPEU (MG)";"MG";"POMPEU";438;27;121;586
2012;"PONTE NOVA (MG)";"MG";"PONTE NOVA";1020;73;180;1273
2012;"PONTO CHIQUE (MG)";"MG";"PONTO CHIQUE";12;1;10;23
2012;"PONTO DOS VOLANTES (MG)";"MG";"PONTO DOS VOLANTES";40;6;28;74
2012;"PORTEIRINHA (MG)";"MG";"PORTEIRINHA";303;19;177;499
2012;"PORTO FIRME (MG)";"MG";"PORTO FIRME";86;8;17;111
2012;"POTE (MG)";"MG";"POTE";75;11;32;118
2012;"POUSO ALEGRE (MG)";"MG";"POUSO ALEGRE";2545;291;492;3328
2012;"POUSO ALTO (MG)";"MG";"POUSO ALTO";113;14;7;134
2012;"PRADOS (MG)";"MG";"PRADOS";99;15;11;125
2012;"PRATA (MG)";"MG";"PRATA";402;98;89;589
2012;"PRATAPOLIS (MG)";"MG";"PRATAPOLIS";177;26;22;225
2012;"PRATINHA (MG)";"MG";"PRATINHA";56;10;4;70
2012;"PRESIDENTE BERNARDES (MG)";"MG";"PRESIDENTE BERNARDES";26;10;11;47
2012;"PRESIDENTE JUSCELINO (MG)";"MG";"PRESIDENTE JUSCELINO";47;4;15;66
2012;"PRESIDENTE KUBITSCHEK (MG)";"MG";"PRESIDENTE KUBITSCHEK";23;14;9;46
2012;"PRESIDENTE OLEGARIO (MG)";"MG";"PRESIDENTE OLEGARIO";228;17;96;341
2012;"PRUDENTE DE MORAIS (MG)";"MG";"PRUDENTE DE MORAIS";105;13;8;126
2012;"QUARTEL GERAL (MG)";"MG";"QUARTEL GERAL";39;6;3;48
2012;"QUELUZITA (MG)";"MG";"QUELUZITA";20;11;3;34
2012;"RAPOSOS (MG)";"MG";"RAPOSOS";72;44;30;146
2012;"RAUL SOARES (MG)";"MG";"RAUL SOARES";233;27;49;309
2012;"RECREIO (MG)";"MG";"RECREIO";177;21;25;223
2012;"REDUTO (MG)";"MG";"REDUTO";65;9;6;80
2012;"RESENDE COSTA (MG)";"MG";"RESENDE COSTA";205;17;20;242
2012;"RESPLENDOR (MG)";"MG";"RESPLENDOR";222;35;37;294
2012;"RESSAQUINHA (MG)";"MG";"RESSAQUINHA";174;10;24;208
2012;"RIACHINHO (MG)";"MG";"RIACHINHO";83;3;20;106
2012;"RIACHO DOS MACHADOS (MG)";"MG";"RIACHO DOS MACHADOS";51;6;38;95
2012;"RIBEIRAO DAS NEVES (MG)";"MG";"RIBEIRAO DAS NEVES";2606;398;765;3769
2012;"RIBEIRAO VERMELHO (MG)";"MG";"RIBEIRAO VERMELHO";36;12;4;52
2012;"RIO ACIMA (MG)";"MG";"RIO ACIMA";118;18;15;151
2012;"RIO CASCA (MG)";"MG";"RIO CASCA";216;13;50;279
2012;"RIO DO PRADO (MG)";"MG";"RIO DO PRADO";17;10;9;36
2012;"RIO DOCE (MG)";"MG";"RIO DOCE";15;7;5;27
2012;"RIO ESPERA (MG)";"MG";"RIO ESPERA";33;1;6;40
2012;"RIO MANSO (MG)";"MG";"RIO MANSO";144;6;12;162
2012;"RIO NOVO (MG)";"MG";"RIO NOVO";136;25;28;189
2012;"RIO PARANAIBA (MG)";"MG";"RIO PARANAIBA";208;16;66;290
2012;"RIO PARDO DE MINAS (MG)";"MG";"RIO PARDO DE MINAS";214;19;121;354
2012;"RIO PIRACICABA (MG)";"MG";"RIO PIRACICABA";189;23;34;246
2012;"RIO POMBA (MG)";"MG";"RIO POMBA";275;31;34;340
2012;"RIO PRETO (MG)";"MG";"RIO PRETO";707;68;73;848
2012;"RIO VERMELHO (MG)";"MG";"RIO VERMELHO";73;23;41;137
2012;"RITAPOLIS (MG)";"MG";"RITAPOLIS";33;11;7;51
2012;"ROCHEDO DE MINAS (MG)";"MG";"ROCHEDO DE MINAS";19;6;2;27
2012;"RODEIRO (MG)";"MG";"RODEIRO";262;8;21;291
2012;"ROMARIA (MG)";"MG";"ROMARIA";44;24;8;76
2012;"ROSARIO DA LIMEIRA (MG)";"MG";"ROSARIO DA LIMEIRA";67;9;33;109
2012;"RUBELITA (MG)";"MG";"RUBELITA";17;5;9;31
2012;"RUBIM (MG)";"MG";"RUBIM";28;1;27;56
2012;"SABARA (MG)";"MG";"SABARA";722;205;332;1259
2012;"SABINOPOLIS (MG)";"MG";"SABINOPOLIS";133;29;48;210
2012;"SACRAMENTO (MG)";"MG";"SACRAMENTO";475;80;62;617
2012;"SALINAS (MG)";"MG";"SALINAS";403;49;122;574
2012;"SALTO DA DIVISA (MG)";"MG";"SALTO DA DIVISA";10;6;10;26
2012;"SANTA BARBARA (MG)";"MG";"SANTA BARBARA";419;76;104;599
2012;"SANTA BARBARA DO LESTE (MG)";"MG";"SANTA BARBARA DO LESTE";169;11;6;186
2012;"SANTA BARBARA DO MONTE VERDE (MG)";"MG";"SANTA BARBARA DO MONTE VERDE";895;74;149;1118
2012;"SANTA BARBARA DO TUGURIO (MG)";"MG";"SANTA BARBARA DO TUGURIO";65;20;50;135
2012;"SANTA CRUZ DE MINAS (MG)";"MG";"SANTA CRUZ DE MINAS";69;9;2;80
2012;"SANTA CRUZ DE SALINAS (MG)";"MG";"SANTA CRUZ DE SALINAS";20;2;23;45
2012;"SANTA CRUZ DO ESCALVADO (MG)";"MG";"SANTA CRUZ DO ESCALVADO";33;8;14;55
2012;"SANTA EFIGENIA DE MINAS (MG)";"MG";"SANTA EFIGENIA DE MINAS";24;5;3;32
2012;"SANTA FE DE MINAS (MG)";"MG";"SANTA FE DE MINAS";7;2;2;11
2012;"SANTA HELENA DE MINAS (MG)";"MG";"SANTA HELENA DE MINAS";10;7;6;23
2012;"SANTA JULIANA (MG)";"MG";"SANTA JULIANA";391;47;47;485
2012;"SANTA LUZIA (MG)";"MG";"SANTA LUZIA";1867;247;670;2784
2012;"SANTA MARGARIDA (MG)";"MG";"SANTA MARGARIDA";224;31;31;286
2012;"SANTA MARIA DE ITABIRA (MG)";"MG";"SANTA MARIA DE ITABIRA";118;15;51;184
2012;"SANTA MARIA DO SALTO (MG)";"MG";"SANTA MARIA DO SALTO";9;4;4;17
2012;"SANTA MARIA DO SUACUI (MG)";"MG";"SANTA MARIA DO SUACUI";83;5;46;134
2012;"SANTA RITA DE CALDAS (MG)";"MG";"SANTA RITA DE CALDAS";298;28;12;338
2012;"SANTA RITA DE IBITIPOCA (MG)";"MG";"SANTA RITA DE IBITIPOCA";43;8;1;52
2012;"SANTA RITA DE JACUTINGA (MG)";"MG";"SANTA RITA DE JACUTINGA";83;11;6;100
2012;"SANTA RITA DE MINAS (MG)";"MG";"SANTA RITA DE MINAS";105;13;8;126
2012;"SANTA RITA DO ITUETO (MG)";"MG";"SANTA RITA DO ITUETO";74;8;16;98
2012;"SANTA RITA DO SAPUCAI (MG)";"MG";"SANTA RITA DO SAPUCAI";401;77;79;557
2012;"SANTA ROSA DA SERRA (MG)";"MG";"SANTA ROSA DA SERRA";45;6;10;61
2012;"SANTA VITORIA (MG)";"MG";"SANTA VITORIA";375;31;43;449
2012;"SANTANA DA VARGEM (MG)";"MG";"SANTANA DA VARGEM";88;15;24;127
2012;"SANTANA DE CATAGUASES (MG)";"MG";"SANTANA DE CATAGUASES";30;13;7;50
2012;"SANTANA DE PIRAPAMA (MG)";"MG";"SANTANA DE PIRAPAMA";71;2;28;101
2012;"SANTANA DO DESERTO (MG)";"MG";"SANTANA DO DESERTO";59;9;8;76
2012;"SANTANA DO GARAMBEU (MG)";"MG";"SANTANA DO GARAMBEU";10;5;5;20
2012;"SANTANA DO JACARE (MG)";"MG";"SANTANA DO JACARE";36;6;15;57
2012;"SANTANA DO MANHUACU (MG)";"MG";"SANTANA DO MANHUACU";185;8;19;212
2012;"SANTANA DO PARAISO (MG)";"MG";"SANTANA DO PARAISO";114;14;30;158
2012;"SANTANA DO RIACHO (MG)";"MG";"SANTANA DO RIACHO";31;8;9;48
2012;"SANTANA DOS MONTES (MG)";"MG";"SANTANA DOS MONTES";31;8;6;45
2012;"SANTO ANTONIO DO AMPARO (MG)";"MG";"SANTO ANTONIO DO AMPARO";231;49;83;363
2012;"SANTO ANTONIO DO AVENTUREIRO (MG)";"MG";"SANTO ANTONIO DO AVENTUREIRO";55;4;7;66
2012;"SANTO ANTONIO DO GRAMA (MG)";"MG";"SANTO ANTONIO DO GRAMA";50;6;11;67
2012;"SANTO ANTONIO DO ITAMBE (MG)";"MG";"SANTO ANTONIO DO ITAMBE";15;7;9;31
2012;"SANTO ANTONIO DO JACINTO (MG)";"MG";"SANTO ANTONIO DO JACINTO";35;3;36;74
2012;"SANTO ANTONIO DO MONTE (MG)";"MG";"SANTO ANTONIO DO MONTE";517;62;99;678
2012;"SANTO ANTONIO DO RETIRO (MG)";"MG";"SANTO ANTONIO DO RETIRO";33;4;23;60
2012;"SANTO ANTONIO DO RIO ABAIXO (MG)";"MG";"SANTO ANTONIO DO RIO ABAIXO";7;9;4;20
2012;"SANTO HIPOLITO (MG)";"MG";"SANTO HIPOLITO";22;4;3;29
2012;"SANTOS DUMONT (MG)";"MG";"SANTOS DUMONT";402;96;146;644
2012;"SAO BENTO ABADE (MG)";"MG";"SAO BENTO ABADE";43;14;16;73
2012;"SAO BRAS DO SUACUI (MG)";"MG";"SAO BRAS DO SUACUI";47;6;5;58
2012;"SAO DOMINGOS DAS DORES (MG)";"MG";"SAO DOMINGOS DAS DORES";99;5;8;112
2012;"SAO DOMINGOS DO PRATA (MG)";"MG";"SAO DOMINGOS DO PRATA";249;13;57;319
2012;"SAO FELIX DE MINAS (MG)";"MG";"SAO FELIX DE MINAS";15;2;9;26
2012;"SAO FRANCISCO (MG)";"MG";"SAO FRANCISCO";246;16;102;364
2012;"SAO FRANCISCO DE PAULA (MG)";"MG";"SAO FRANCISCO DE PAULA";75;21;20;116
2012;"SAO FRANCISCO DE SALES (MG)";"MG";"SAO FRANCISCO DE SALES";71;10;18;99
2012;"SAO FRANCISCO DO GLORIA (MG)";"MG";"SAO FRANCISCO DO GLORIA";61;12;8;81
2012;"SAO GERALDO (MG)";"MG";"SAO GERALDO";167;13;9;189
2012;"SAO GERALDO DA PIEDADE (MG)";"MG";"SAO GERALDO DA PIEDADE";10;6;6;22
2012;"SAO GERALDO DO BAIXIO (MG)";"MG";"SAO GERALDO DO BAIXIO";18;7;8;33
2012;"SAO GONCALO DO ABAETE (MG)";"MG";"SAO GONCALO DO ABAETE";77;14;18;109
2012;"SAO GONCALO DO PARA (MG)";"MG";"SAO GONCALO DO PARA";192;14;14;220
2012;"SAO GONCALO DO RIO ABAIXO (MG)";"MG";"SAO GONCALO DO RIO ABAIXO";180;36;31;247
2012;"SAO GONCALO DO RIO PRETO (MG)";"MG";"SAO GONCALO DO RIO PRETO";28;9;5;42
2012;"SAO GONCALO DO SAPUCAI (MG)";"MG";"SAO GONCALO DO SAPUCAI";428;47;71;546
2012;"SAO GOTARDO (MG)";"MG";"SAO GOTARDO";820;91;230;1141
2012;"SAO JOAO BATISTA DO GLORIA (MG)";"MG";"SAO JOAO BATISTA DO GLORIA";137;12;14;163
2012;"SAO JOAO DA LAGOA (MG)";"MG";"SAO JOAO DA LAGOA";34;8;11;53
2012;"SAO JOAO DA MATA (MG)";"MG";"SAO JOAO DA MATA";55;11;0;66
2012;"SAO JOAO DA PONTE (MG)";"MG";"SAO JOAO DA PONTE";57;9;56;122
2012;"SAO JOAO DAS MISSOES (MG)";"MG";"SAO JOAO DAS MISSOES";23;2;16;41
2012;"SAO JOAO DEL REI (MG)";"MG";"SAO JOAO DEL REI";1147;184;220;1551
2012;"SAO JOAO DO MANHUACU (MG)";"MG";"SAO JOAO DO MANHUACU";133;16;20;169
2012;"SAO JOAO DO MANTENINHA (MG)";"MG";"SAO JOAO DO MANTENINHA";81;12;5;98
2012;"SAO JOAO DO ORIENTE (MG)";"MG";"SAO JOAO DO ORIENTE";105;14;4;123
2012;"SAO JOAO DO PACUI (MG)";"MG";"SAO JOAO DO PACUI";9;2;4;15
2012;"SAO JOAO DO PARAISO (MG)";"MG";"SAO JOAO DO PARAISO";185;16;76;277
2012;"SAO JOAO EVANGELISTA (MG)";"MG";"SAO JOAO EVANGELISTA";106;11;41;158
2012;"SAO JOAO NEPOMUCENO (MG)";"MG";"SAO JOAO NEPOMUCENO";269;34;28;331
2012;"SAO JOAQUIM DE BICAS (MG)";"MG";"SAO JOAQUIM DE BICAS";622;83;48;753
2012;"SAO JOSE DA BARRA (MG)";"MG";"SAO JOSE DA BARRA";98;14;26;138
2012;"SAO JOSE DA LAPA (MG)";"MG";"SAO JOSE DA LAPA";275;45;34;354
2012;"SAO JOSE DA SAFIRA (MG)";"MG";"SAO JOSE DA SAFIRA";6;1;5;12
2012;"SAO JOSE DA VARGINHA (MG)";"MG";"SAO JOSE DA VARGINHA";65;3;19;87
2012;"SAO JOSE DO ALEGRE (MG)";"MG";"SAO JOSE DO ALEGRE";38;6;5;49
2012;"SAO JOSE DO DIVINO (MG)";"MG";"SAO JOSE DO DIVINO";17;4;10;31
2012;"SAO JOSE DO GOIABAL (MG)";"MG";"SAO JOSE DO GOIABAL";41;15;28;84
2012;"SAO JOSE DO JACURI (MG)";"MG";"SAO JOSE DO JACURI";22;5;6;33
2012;"SAO JOSE DO MANTIMENTO (MG)";"MG";"SAO JOSE DO MANTIMENTO";39;3;4;46
2012;"SAO LOURENCO (MG)";"MG";"SAO LOURENCO";507;76;52;635
2012;"SAO MIGUEL DO ANTA (MG)";"MG";"SAO MIGUEL DO ANTA";81;7;12;100
2012;"SAO PEDRO DA UNIAO (MG)";"MG";"SAO PEDRO DA UNIAO";102;15;10;127
2012;"SAO PEDRO DO SUACUI (MG)";"MG";"SAO PEDRO DO SUACUI";25;3;9;37
2012;"SAO PEDRO DOS FERROS (MG)";"MG";"SAO PEDRO DOS FERROS";110;10;35;155
2012;"SAO ROMAO (MG)";"MG";"SAO ROMAO";31;2;10;43
2012;"SAO ROQUE DE MINAS (MG)";"MG";"SAO ROQUE DE MINAS";167;17;11;195
2012;"SAO SEBASTIAO DA BELA VISTA (MG)";"MG";"SAO SEBASTIAO DA BELA VISTA";47;11;12;70
2012;"SAO SEBASTIAO DA VARGEM ALEGRE (MG)";"MG";"SAO SEBASTIAO DA VARGEM ALEGRE";26;2;8;36
2012;"SAO SEBASTIAO DO ANTA (MG)";"MG";"SAO SEBASTIAO DO ANTA";51;6;5;62
2012;"SAO SEBASTIAO DO MARANHAO (MG)";"MG";"SAO SEBASTIAO DO MARANHAO";24;6;12;42
2012;"SAO SEBASTIAO DO OESTE (MG)";"MG";"SAO SEBASTIAO DO OESTE";143;9;16;168
2012;"SAO SEBASTIAO DO PARAISO (MG)";"MG";"SAO SEBASTIAO DO PARAISO";1530;113;207;1850
2012;"SAO SEBASTIAO DO RIO PRETO (MG)";"MG";"SAO SEBASTIAO DO RIO PRETO";9;4;4;17
2012;"SAO SEBASTIAO DO RIO VERDE (MG)";"MG";"SAO SEBASTIAO DO RIO VERDE";15;2;5;22
2012;"SAO TIAGO (MG)";"MG";"SAO TIAGO";173;16;21;210
2012;"SAO TOMAS DE AQUINO (MG)";"MG";"SAO TOMAS DE AQUINO";81;26;13;120
2012;"SAO TOME DAS LETRAS (MG)";"MG";"SAO TOME DAS LETRAS";96;12;18;126
2012;"SAO VICENTE DE MINAS (MG)";"MG";"SAO VICENTE DE MINAS";96;21;2;119
2012;"SAPUCAI MIRIM (MG)";"MG";"SAPUCAI MIRIM";212;38;11;261
2012;"SARDOA (MG)";"MG";"SARDOA";44;7;10;61
2012;"SARZEDO (MG)";"MG";"SARZEDO";589;45;63;697
2012;"SEM PEIXE (MG)";"MG";"SEM PEIXE";13;5;10;28
2012;"SENADOR AMARAL (MG)";"MG";"SENADOR AMARAL";101;11;10;122
2012;"SENADOR CORTES (MG)";"MG";"SENADOR CORTES";15;5;2;22
2012;"SENADOR FIRMINO (MG)";"MG";"SENADOR FIRMINO";106;10;21;137
2012;"SENADOR JOSE BENTO (MG)";"MG";"SENADOR JOSE BENTO";14;2;6;22
2012;"SENADOR MODESTINO GONCALVES (MG)";"MG";"SENADOR MODESTINO GONCALVES";23;5;9;37
2012;"SENHORA DE OLIVEIRA (MG)";"MG";"SENHORA DE OLIVEIRA";66;3;11;80
2012;"SENHORA DO PORTO (MG)";"MG";"SENHORA DO PORTO";22;6;10;38
2012;"SENHORA DOS REMEDIOS (MG)";"MG";"SENHORA DOS REMEDIOS";98;30;17;145
2012;"SERICITA (MG)";"MG";"SERICITA";94;3;6;103
2012;"SERITINGA (MG)";"MG";"SERITINGA";21;2;3;26
2012;"SERRA AZUL DE MINAS (MG)";"MG";"SERRA AZUL DE MINAS";13;6;11;30
2012;"SERRA DA SAUDADE (MG)";"MG";"SERRA DA SAUDADE";5;6;0;11
2012;"SERRA DO SALITRE (MG)";"MG";"SERRA DO SALITRE";247;17;77;341
2012;"SERRA DOS AIMORES (MG)";"MG";"SERRA DOS AIMORES";69;4;24;97
2012;"SERRANIA (MG)";"MG";"SERRANIA";123;21;18;162
2012;"SERRANOPOLIS DE MINAS (MG)";"MG";"SERRANOPOLIS DE MINAS";12;0;15;27
2012;"SERRANOS (MG)";"MG";"SERRANOS";16;7;4;27
2012;"SERRO (MG)";"MG";"SERRO";166;24;58;248
2012;"SETE LAGOAS (MG)";"MG";"SETE LAGOAS";3335;431;634;4400
2012;"SETUBINHA (MG)";"MG";"SETUBINHA";19;3;24;46
2012;"SILVEIRANIA (MG)";"MG";"SILVEIRANIA";13;3;4;20
2012;"SILVIANOPOLIS (MG)";"MG";"SILVIANOPOLIS";88;11;11;110
2012;"SIMAO PEREIRA (MG)";"MG";"SIMAO PEREIRA";48;11;4;63
2012;"SIMONESIA (MG)";"MG";"SIMONESIA";212;14;40;266
2012;"SOBRALIA (MG)";"MG";"SOBRALIA";39;7;8;54
2012;"SOLEDADE DE MINAS (MG)";"MG";"SOLEDADE DE MINAS";47;9;0;56
2012;"TABULEIRO (MG)";"MG";"TABULEIRO";68;8;7;83
2012;"TAIOBEIRAS (MG)";"MG";"TAIOBEIRAS";663;31;156;850
2012;"TAPARUBA (MG)";"MG";"TAPARUBA";28;3;10;41
2012;"TAPIRA (MG)";"MG";"TAPIRA";46;8;18;72
2012;"TAPIRAI (MG)";"MG";"TAPIRAI";13;5;2;20
2012;"TAQUARACU DE MINAS (MG)";"MG";"TAQUARACU DE MINAS";79;8;7;94
2012;"TARUMIRIM (MG)";"MG";"TARUMIRIM";113;15;26;154
2012;"TEIXEIRAS (MG)";"MG";"TEIXEIRAS";154;13;17;184
2012;"TEOFILO OTONI (MG)";"MG";"TEOFILO OTONI";1507;176;163;1846
2012;"TIMOTEO (MG)";"MG";"TIMOTEO";1047;196;133;1376
2012;"TIRADENTES (MG)";"MG";"TIRADENTES";83;19;11;113
2012;"TIROS (MG)";"MG";"TIROS";153;15;11;179
2012;"TOCANTINS (MG)";"MG";"TOCANTINS";253;8;21;282
2012;"TOCOS DO MOJI (MG)";"MG";"TOCOS DO MOJI";52;14;7;73
2012;"TOLEDO (MG)";"MG";"TOLEDO";80;6;11;97
2012;"TOMBOS (MG)";"MG";"TOMBOS";104;28;24;156
2012;"TRES CORACOES (MG)";"MG";"TRES CORACOES";929;97;201;1227
2012;"TRES MARIAS (MG)";"MG";"TRES MARIAS";383;39;99;521
2012;"TRES PONTAS (MG)";"MG";"TRES PONTAS";865;105;191;1161
2012;"TUMIRITINGA (MG)";"MG";"TUMIRITINGA";29;6;7;42
2012;"TUPACIGUARA (MG)";"MG";"TUPACIGUARA";494;80;72;646
2012;"TURMALINA (MG)";"MG";"TURMALINA";327;40;51;418
2012;"TURVOLANDIA (MG)";"MG";"TURVOLANDIA";95;29;4;128
2012;"UBA (MG)";"MG";"UBA";2042;88;161;2291
2012;"UBAI (MG)";"MG";"UBAI";35;6;25;66
2012;"UBAPORANGA (MG)";"MG";"UBAPORANGA";152;8;20;180
2012;"UBERABA (MG)";"MG";"UBERABA";4759;946;951;6656
2012;"UBERLANDIA (MG)";"MG";"UBERLANDIA";11415;1140;1373;13928
2012;"UMBURATIBA (MG)";"MG";"UMBURATIBA";8;3;2;13
2012;"UNAI (MG)";"MG";"UNAI";1377;76;317;1770
2012;"UNIAO DE MINAS (MG)";"MG";"UNIAO DE MINAS";44;7;34;85
2012;"URUANA DE MINAS (MG)";"MG";"URUANA DE MINAS";17;4;11;32
2012;"URUCANIA (MG)";"MG";"URUCANIA";135;13;41;189
2012;"URUCUIA (MG)";"MG";"URUCUIA";69;4;27;100
2012;"VARGEM ALEGRE (MG)";"MG";"VARGEM ALEGRE";63;7;10;80
2012;"VARGEM BONITA (MG)";"MG";"VARGEM BONITA";33;3;6;42
2012;"VARGEM GRANDE DO RIO PARDO (MG)";"MG";"VARGEM GRANDE DO RIO PARDO";42;5;12;59
2012;"VARGINHA (MG)";"MG";"VARGINHA";1918;170;310;2398
2012;"VARJAO DE MINAS (MG)";"MG";"VARJAO DE MINAS";90;11;46;147
2012;"VARZEA DA PALMA (MG)";"MG";"VARZEA DA PALMA";442;20;88;550
2012;"VARZELANDIA (MG)";"MG";"VARZELANDIA";47;10;39;96
2012;"VAZANTE (MG)";"MG";"VAZANTE";307;38;87;432
2012;"VERDELANDIA (MG)";"MG";"VERDELANDIA";16;2;9;27
2012;"VEREDINHA (MG)";"MG";"VEREDINHA";38;9;18;65
2012;"VERISSIMO (MG)";"MG";"VERISSIMO";39;26;2;67
2012;"VERMELHO NOVO (MG)";"MG";"VERMELHO NOVO";87;9;21;117
2012;"VESPASIANO (MG)";"MG";"VESPASIANO";888;181;145;1214
2012;"VICOSA (MG)";"MG";"VICOSA";651;160;172;983
2012;"VIEIRAS (MG)";"MG";"VIEIRAS";42;11;5;58
2012;"VIRGEM DA LAPA (MG)";"MG";"VIRGEM DA LAPA";67;11;24;102
2012;"VIRGINIA (MG)";"MG";"VIRGINIA";133;17;6;156
2012;"VIRGINOPOLIS (MG)";"MG";"VIRGINOPOLIS";87;5;24;116
2012;"VIRGOLANDIA (MG)";"MG";"VIRGOLANDIA";18;6;9;33
2012;"VISCONDE DO RIO BRANCO (MG)";"MG";"VISCONDE DO RIO BRANCO";950;51;66;1067
2012;"VOLTA GRANDE (MG)";"MG";"VOLTA GRANDE";43;10;6;59
2012;"WENCESLAU BRAZ (MG)";"MG";"WENCESLAU BRAZ";43;7;6;56
2012;"AGUA CLARA (MS)";"MS";"AGUA CLARA";408;22;96;526
2012;"ALCINOPOLIS (MS)";"MS";"ALCINOPOLIS";80;17;14;111
2012;"AMAMBAI (MS)";"MS";"AMAMBAI";682;21;51;754
2012;"ANASTACIO (MS)";"MS";"ANASTACIO";371;23;23;417
2012;"ANAURILANDIA (MS)";"MS";"ANAURILANDIA";103;19;50;172
2012;"ANGELICA (MS)";"MS";"ANGELICA";261;35;47;343
2012;"ANTONIO JOAO (MS)";"MS";"ANTONIO JOAO";111;5;25;141
2012;"APARECIDA DO TABOADO (MS)";"MS";"APARECIDA DO TABOADO";410;33;53;496
2012;"AQUIDAUANA (MS)";"MS";"AQUIDAUANA";344;19;66;429
2012;"ARAL MOREIRA (MS)";"MS";"ARAL MOREIRA";202;12;26;240
2012;"BANDEIRANTES (MS)";"MS";"BANDEIRANTES";156;8;35;199
2012;"BATAGUASSU (MS)";"MS";"BATAGUASSU";470;30;171;671
2012;"BATAYPORA (MS)";"MS";"BATAYPORA";163;11;31;205
2012;"BELA VISTA (MS)";"MS";"BELA VISTA";241;29;47;317
2012;"BODOQUENA (MS)";"MS";"BODOQUENA";83;22;39;144
2012;"BONITO (MS)";"MS";"BONITO";253;67;56;376
2012;"BRASILANDIA (MS)";"MS";"BRASILANDIA";267;34;67;368
2012;"CAARAPO (MS)";"MS";"CAARAPO";539;14;137;690
2012;"CAMAPUA (MS)";"MS";"CAMAPUA";335;34;37;406
2012;"CAMPO GRANDE (MS)";"MS";"CAMPO GRANDE";13356;861;1855;16072
2012;"CARACOL (MS)";"MS";"CARACOL";54;17;9;80
2012;"CASSILANDIA (MS)";"MS";"CASSILANDIA";455;15;42;512
2012;"CHAPADAO DO SUL (MS)";"MS";"CHAPADAO DO SUL";775;22;102;899
2012;"CORGUINHO (MS)";"MS";"CORGUINHO";58;8;23;89
2012;"CORONEL SAPUCAIA (MS)";"MS";"CORONEL SAPUCAIA";299;8;29;336
2012;"CORUMBA (MS)";"MS";"CORUMBA";862;77;207;1146
2012;"COSTA RICA (MS)";"MS";"COSTA RICA";481;19;108;608
2012;"COXIM (MS)";"MS";"COXIM";594;14;66;674
2012;"DEODAPOLIS (MS)";"MS";"DEODAPOLIS";241;21;81;343
2012;"DOIS IRMAOS DO BURITI (MS)";"MS";"DOIS IRMAOS DO BURITI";124;18;33;175
2012;"DOURADINA (MS)";"MS";"DOURADINA";203;9;19;231
2012;"DOURADOS (MS)";"MS";"DOURADOS";3914;209;314;4437
2012;"ELDORADO (MS)";"MS";"ELDORADO";251;15;38;304
2012;"FATIMA DO SUL (MS)";"MS";"FATIMA DO SUL";403;9;32;444
2012;"FIGUEIRAO (MS)";"MS";"FIGUEIRAO";39;19;3;61
2012;"GLORIA DE DOURADOS (MS)";"MS";"GLORIA DE DOURADOS";196;10;40;246
2012;"GUIA LOPES DA LAGUNA (MS)";"MS";"GUIA LOPES DA LAGUNA";152;17;32;201
2012;"IGUATEMI (MS)";"MS";"IGUATEMI";231;7;62;300
2012;"INOCENCIA (MS)";"MS";"INOCENCIA";158;3;35;196
2012;"ITAPORA (MS)";"MS";"ITAPORA";398;26;47;471
2012;"ITAQUIRAI (MS)";"MS";"ITAQUIRAI";208;14;86;308
2012;"IVINHEMA (MS)";"MS";"IVINHEMA";550;26;201;777
2012;"JAPORA (MS)";"MS";"JAPORA";23;5;19;47
2012;"JARAGUARI (MS)";"MS";"JARAGUARI";71;7;22;100
2012;"JARDIM (MS)";"MS";"JARDIM";446;26;39;511
2012;"JATEI (MS)";"MS";"JATEI";47;8;78;133
2012;"JUTI (MS)";"MS";"JUTI";66;5;16;87
2012;"LADARIO (MS)";"MS";"LADARIO";132;19;55;206
2012;"LAGUNA CARAPA (MS)";"MS";"LAGUNA CARAPA";179;2;15;196
2012;"MARACAJU (MS)";"MS";"MARACAJU";929;25;123;1077
2012;"MIRANDA (MS)";"MS";"MIRANDA";318;26;70;414
2012;"MUNDO NOVO (MS)";"MS";"MUNDO NOVO";286;27;20;333
2012;"NAVIRAI (MS)";"MS";"NAVIRAI";868;56;176;1100
2012;"NIOAQUE (MS)";"MS";"NIOAQUE";140;22;47;209
2012;"NOVA ALVORADA DO SUL (MS)";"MS";"NOVA ALVORADA DO SUL";340;28;75;443
2012;"NOVA ANDRADINA (MS)";"MS";"NOVA ANDRADINA";967;24;233;1224
2012;"NOVO HORIZONTE DO SUL (MS)";"MS";"NOVO HORIZONTE DO SUL";66;7;21;94
2012;"PARANAIBA (MS)";"MS";"PARANAIBA";845;31;107;983
2012;"PARANHOS (MS)";"MS";"PARANHOS";117;5;26;148
2012;"PEDRO GOMES (MS)";"MS";"PEDRO GOMES";88;6;12;106
2012;"PONTA PORA (MS)";"MS";"PONTA PORA";1760;71;258;2089
2012;"PORTO MURTINHO (MS)";"MS";"PORTO MURTINHO";69;7;22;98
2012;"RIBAS DO RIO PARDO (MS)";"MS";"RIBAS DO RIO PARDO";582;34;60;676
2012;"RIO BRILHANTE (MS)";"MS";"RIO BRILHANTE";681;53;136;870
2012;"RIO NEGRO (MS)";"MS";"RIO NEGRO";60;12;13;85
2012;"RIO VERDE DE MATO GROSSO (MS)";"MS";"RIO VERDE DE MATO GROSSO";342;17;22;381
2012;"ROCHEDO (MS)";"MS";"ROCHEDO";55;3;11;69
2012;"SANTA RITA DO PARDO (MS)";"MS";"SANTA RITA DO PARDO";120;8;31;159
2012;"SAO GABRIEL DO OESTE (MS)";"MS";"SAO GABRIEL DO OESTE";853;22;53;928
2012;"SELVIRIA (MS)";"MS";"SELVIRIA";105;14;23;142
2012;"SETE QUEDAS (MS)";"MS";"SETE QUEDAS";217;7;22;246
2012;"SIDROLANDIA (MS)";"MS";"SIDROLANDIA";668;83;240;991
2012;"SONORA (MS)";"MS";"SONORA";210;17;90;317
2012;"TACURU (MS)";"MS";"TACURU";102;9;18;129
2012;"TAQUARUSSU (MS)";"MS";"TAQUARUSSU";38;4;13;55
2012;"TERENOS (MS)";"MS";"TERENOS";349;18;47;414
2012;"TRES LAGOAS (MS)";"MS";"TRES LAGOAS";1638;142;455;2235
2012;"VICENTINA (MS)";"MS";"VICENTINA";134;8;90;232
2012;"ACORIZAL (MT)";"MT";"ACORIZAL";17;3;3;23
2012;"AGUA BOA (MT)";"MT";"AGUA BOA";547;9;43;599
2012;"ALTA FLORESTA (MT)";"MT";"ALTA FLORESTA";1226;22;84;1332
2012;"ALTO ARAGUAIA (MT)";"MT";"ALTO ARAGUAIA";167;24;30;221
2012;"ALTO BOA VISTA (MT)";"MT";"ALTO BOA VISTA";38;1;4;43
2012;"ALTO GARCAS (MT)";"MT";"ALTO GARCAS";269;14;41;324
2012;"ALTO PARAGUAI (MT)";"MT";"ALTO PARAGUAI";34;6;4;44
2012;"ALTO TAQUARI (MT)";"MT";"ALTO TAQUARI";177;17;22;216
2012;"APIACAS (MT)";"MT";"APIACAS";106;9;4;119
2012;"ARAGUAIANA (MT)";"MT";"ARAGUAIANA";12;0;3;15
2012;"ARAGUAINHA (MT)";"MT";"ARAGUAINHA";7;1;1;9
2012;"ARAPUTANGA (MT)";"MT";"ARAPUTANGA";257;14;21;292
2012;"ARENAPOLIS (MT)";"MT";"ARENAPOLIS";189;8;61;258
2012;"ARIPUANA (MT)";"MT";"ARIPUANA";358;9;43;410
2012;"BARAO DE MELGACO (MT)";"MT";"BARAO DE MELGACO";9;2;2;13
2012;"BARRA DO BUGRES (MT)";"MT";"BARRA DO BUGRES";525;21;132;678
2012;"BARRA DO GARCAS (MT)";"MT";"BARRA DO GARCAS";826;35;174;1035
2012;"BOM JESUS DO ARAGUAIA (MT)";"MT";"BOM JESUS DO ARAGUAIA";31;1;9;41
2012;"BRASNORTE (MT)";"MT";"BRASNORTE";304;7;59;370
2012;"CACERES (MT)";"MT";"CACERES";779;48;273;1100
2012;"CAMPINAPOLIS (MT)";"MT";"CAMPINAPOLIS";74;3;13;90
2012;"CAMPO NOVO DO PARECIS (MT)";"MT";"CAMPO NOVO DO PARECIS";690;38;106;834
2012;"CAMPO VERDE (MT)";"MT";"CAMPO VERDE";854;49;120;1023
2012;"CAMPOS DE JULIO (MT)";"MT";"CAMPOS DE JULIO";156;12;26;194
2012;"CANABRAVA DO NORTE (MT)";"MT";"CANABRAVA DO NORTE";38;0;7;45
2012;"CANARANA (MT)";"MT";"CANARANA";498;14;23;535
2012;"CARLINDA (MT)";"MT";"CARLINDA";126;0;21;147
2012;"CASTANHEIRA (MT)";"MT";"CASTANHEIRA";115;2;15;132
2012;"CHAPADA DOS GUIMARAES (MT)";"MT";"CHAPADA DOS GUIMARAES";201;22;41;264
2012;"CLAUDIA (MT)";"MT";"CLAUDIA";408;4;19;431
2012;"COCALINHO (MT)";"MT";"COCALINHO";21;1;7;29
2012;"COLIDER (MT)";"MT";"COLIDER";813;18;100;931
2012;"COLNIZA (MT)";"MT";"COLNIZA";292;0;13;305
2012;"COMODORO (MT)";"MT";"COMODORO";486;7;72;565
2012;"CONFRESA (MT)";"MT";"CONFRESA";182;4;43;229
2012;"CONQUISTA D OESTE (MT)";"MT";"CONQUISTA D OESTE";31;1;12;44
2012;"COTRIGUACU (MT)";"MT";"COTRIGUACU";133;3;39;175
2012;"CUIABA (MT)";"MT";"CUIABA";9141;757;2545;12443
2012;"CURVELANDIA (MT)";"MT";"CURVELANDIA";64;0;13;77
2012;"DENISE (MT)";"MT";"DENISE";75;4;30;109
2012;"DIAMANTINO (MT)";"MT";"DIAMANTINO";491;19;63;573
2012;"DOM AQUINO (MT)";"MT";"DOM AQUINO";111;8;18;137
2012;"FELIZ NATAL (MT)";"MT";"FELIZ NATAL";244;3;19;266
2012;"FIGUEIROPOLIS D OESTE (MT)";"MT";"FIGUEIROPOLIS D OESTE";66;3;10;79
2012;"GAUCHA DO NORTE (MT)";"MT";"GAUCHA DO NORTE";74;5;17;96
2012;"GENERAL CARNEIRO (MT)";"MT";"GENERAL CARNEIRO";24;5;4;33
2012;"GLORIA D OESTE (MT)";"MT";"GLORIA D OESTE";49;4;14;67
2012;"GUARANTA DO NORTE (MT)";"MT";"GUARANTA DO NORTE";883;11;66;960
2012;"GUIRATINGA (MT)";"MT";"GUIRATINGA";163;11;11;185
2012;"INDIAVAI (MT)";"MT";"INDIAVAI";15;1;7;23
2012;"IPIRANGA DO NORTE (MT)";"MT";"IPIRANGA DO NORTE";130;3;6;139
2012;"ITANHANGA (MT)";"MT";"ITANHANGA";138;1;13;152
2012;"ITAUBA (MT)";"MT";"ITAUBA";121;5;8;134
2012;"ITIQUIRA (MT)";"MT";"ITIQUIRA";107;22;53;182
2012;"JACIARA (MT)";"MT";"JACIARA";579;43;133;755
2012;"JANGADA (MT)";"MT";"JANGADA";50;9;19;78
2012;"JAURU (MT)";"MT";"JAURU";154;6;28;188
2012;"JUARA (MT)";"MT";"JUARA";753;21;57;831
2012;"JUINA (MT)";"MT";"JUINA";817;19;70;906
2012;"JURUENA (MT)";"MT";"JURUENA";185;1;14;200
2012;"JUSCIMEIRA (MT)";"MT";"JUSCIMEIRA";137;5;49;191
2012;"LAMBARI D OESTE (MT)";"MT";"LAMBARI D OESTE";74;3;21;98
2012;"LUCAS DO RIO VERDE (MT)";"MT";"LUCAS DO RIO VERDE";1461;42;124;1627
2012;"LUCIARA (MT)";"MT";"LUCIARA";9;0;2;11
2012;"MARCELANDIA (MT)";"MT";"MARCELANDIA";366;7;18;391
2012;"MATUPA (MT)";"MT";"MATUPA";357;8;37;402
2012;"MIRASSOL D OESTE (MT)";"MT";"MIRASSOL D OESTE";688;6;82;776
2012;"NOBRES (MT)";"MT";"NOBRES";280;13;57;350
2012;"NORTELANDIA (MT)";"MT";"NORTELANDIA";82;8;14;104
2012;"NOSSA SENHORA DO LIVRAMENTO (MT)";"MT";"NOSSA SENHORA DO LIVRAMENTO";82;2;28;112
2012;"NOVA BANDEIRANTES (MT)";"MT";"NOVA BANDEIRANTES";152;3;28;183
2012;"NOVA BRASILANDIA (MT)";"MT";"NOVA BRASILANDIA";52;1;9;62
2012;"NOVA CANAA DO NORTE (MT)";"MT";"NOVA CANAA DO NORTE";194;7;54;255
2012;"NOVA GUARITA (MT)";"MT";"NOVA GUARITA";83;1;13;97
2012;"NOVA LACERDA (MT)";"MT";"NOVA LACERDA";102;0;29;131
2012;"NOVA MARILANDIA (MT)";"MT";"NOVA MARILANDIA";28;4;6;38
2012;"NOVA MARINGA (MT)";"MT";"NOVA MARINGA";116;1;9;126
2012;"NOVA MONTE VERDE (MT)";"MT";"NOVA MONTE VERDE";117;7;7;131
2012;"NOVA MUTUM (MT)";"MT";"NOVA MUTUM";959;13;81;1053
2012;"NOVA NAZARE (MT)";"MT";"NOVA NAZARE";7;4;4;15
2012;"NOVA OLIMPIA (MT)";"MT";"NOVA OLIMPIA";328;16;134;478
2012;"NOVA SANTA HELENA (MT)";"MT";"NOVA SANTA HELENA";61;2;12;75
2012;"NOVA UBIRATA (MT)";"MT";"NOVA UBIRATA";146;12;28;186
2012;"NOVA XAVANTINA (MT)";"MT";"NOVA XAVANTINA";376;21;40;437
2012;"NOVO HORIZONTE DO NORTE (MT)";"MT";"NOVO HORIZONTE DO NORTE";38;1;14;53
2012;"NOVO MUNDO (MT)";"MT";"NOVO MUNDO";86;3;16;105
2012;"NOVO SANTO ANTONIO (MT)";"MT";"NOVO SANTO ANTONIO";1;0;2;3
2012;"NOVO SAO JOAQUIM (MT)";"MT";"NOVO SAO JOAQUIM";86;1;12;99
2012;"PARANAITA (MT)";"MT";"PARANAITA";190;13;75;278
2012;"PARANATINGA (MT)";"MT";"PARANATINGA";394;12;58;464
2012;"PEDRA PRETA (MT)";"MT";"PEDRA PRETA";289;8;42;339
2012;"PEIXOTO DE AZEVEDO (MT)";"MT";"PEIXOTO DE AZEVEDO";345;10;64;419
2012;"PLANALTO DA SERRA (MT)";"MT";"PLANALTO DA SERRA";18;1;4;23
2012;"POCONE (MT)";"MT";"POCONE";403;22;32;457
2012;"PONTAL DO ARAGUAIA (MT)";"MT";"PONTAL DO ARAGUAIA";22;1;1;24
2012;"PONTE BRANCA (MT)";"MT";"PONTE BRANCA";6;1;0;7
2012;"PONTES E LACERDA (MT)";"MT";"PONTES E LACERDA";877;24;110;1011
2012;"PORTO ALEGRE DO NORTE (MT)";"MT";"PORTO ALEGRE DO NORTE";61;5;30;96
2012;"PORTO DOS GAUCHOS (MT)";"MT";"PORTO DOS GAUCHOS";102;9;10;121
2012;"PORTO ESPERIDIAO (MT)";"MT";"PORTO ESPERIDIAO";131;5;38;174
2012;"PORTO ESTRELA (MT)";"MT";"PORTO ESTRELA";19;2;5;26
2012;"POXOREO (MT)";"MT";"POXOREO";104;19;37;160
2012;"PRIMAVERA DO LESTE (MT)";"MT";"PRIMAVERA DO LESTE";1819;83;149;2051
2012;"QUERENCIA (MT)";"MT";"QUERENCIA";280;7;18;305
2012;"RESERVA DO CABACAL (MT)";"MT";"RESERVA DO CABACAL";19;2;4;25
2012;"RIBEIRAO CASCALHEIRA (MT)";"MT";"RIBEIRAO CASCALHEIRA";107;10;13;130
2012;"RIBEIRAOZINHO (MT)";"MT";"RIBEIRAOZINHO";7;4;6;17
2012;"RIO BRANCO (MT)";"MT";"RIO BRANCO";75;7;21;103
2012;"RONDOLANDIA (MT)";"MT";"RONDOLANDIA";6;0;16;22
2012;"RONDONOPOLIS (MT)";"MT";"RONDONOPOLIS";4078;195;449;4722
2012;"ROSARIO OESTE (MT)";"MT";"ROSARIO OESTE";137;12;28;177
2012;"SALTO DO CEU (MT)";"MT";"SALTO DO CEU";42;5;18;65
2012;"SANTA CARMEM (MT)";"MT";"SANTA CARMEM";140;3;13;156
2012;"SANTA CRUZ DO XINGU (MT)";"MT";"SANTA CRUZ DO XINGU";8;1;3;12
2012;"SANTA RITA DO TRIVELATO (MT)";"MT";"SANTA RITA DO TRIVELATO";62;2;9;73
2012;"SANTA TEREZINHA (MT)";"MT";"SANTA TEREZINHA";7;1;9;17
2012;"SANTO AFONSO (MT)";"MT";"SANTO AFONSO";24;3;8;35
2012;"SANTO ANTONIO DO LESTE (MT)";"MT";"SANTO ANTONIO DO LESTE";58;3;14;75
2012;"SANTO ANTONIO DO LEVERGER (MT)";"MT";"SANTO ANTONIO DO LEVERGER";102;7;12;121
2012;"SAO FELIX DO ARAGUAIA (MT)";"MT";"SAO FELIX DO ARAGUAIA";44;6;18;68
2012;"SAO JOSE DO POVO (MT)";"MT";"SAO JOSE DO POVO";16;2;4;22
2012;"SAO JOSE DO RIO CLARO (MT)";"MT";"SAO JOSE DO RIO CLARO";300;14;48;362
2012;"SAO JOSE DO XINGU (MT)";"MT";"SAO JOSE DO XINGU";15;0;9;24
2012;"SAO JOSE DOS QUATRO MARCOS (MT)";"MT";"SAO JOSE DOS QUATRO MARCOS";432;9;60;501
2012;"SAO PEDRO DA CIPA (MT)";"MT";"SAO PEDRO DA CIPA";18;6;22;46
2012;"SAPEZAL (MT)";"MT";"SAPEZAL";511;24;77;612
2012;"SERRA NOVA DOURADA (MT)";"MT";"SERRA NOVA DOURADA";5;1;2;8
2012;"SINOP (MT)";"MT";"SINOP";3240;78;168;3486
2012;"SORRISO (MT)";"MT";"SORRISO";2170;56;163;2389
2012;"TABAPORA (MT)";"MT";"TABAPORA";133;5;28;166
2012;"TANGARA DA SERRA (MT)";"MT";"TANGARA DA SERRA";1857;74;190;2121
2012;"TAPURAH (MT)";"MT";"TAPURAH";317;5;31;353
2012;"TERRA NOVA DO NORTE (MT)";"MT";"TERRA NOVA DO NORTE";239;13;28;280
2012;"TESOURO (MT)";"MT";"TESOURO";12;2;3;17
2012;"TORIXOREU (MT)";"MT";"TORIXOREU";21;3;4;28
2012;"UNIAO DO SUL (MT)";"MT";"UNIAO DO SUL";90;0;9;99
2012;"VALE DE SAO DOMINGOS (MT)";"MT";"VALE DE SAO DOMINGOS";25;0;13;38
2012;"VARZEA GRANDE (MT)";"MT";"VARZEA GRANDE";4486;287;495;5268
2012;"VERA (MT)";"MT";"VERA";264;6;24;294
2012;"VILA BELA DA SANTISSIMA TRINDA (MT)";"MT";"VILA BELA DA SANTISSIMA TRINDA";96;2;26;124
2012;"VILA RICA (MT)";"MT";"VILA RICA";246;1;32;279
2012;"ABAETETUBA (PA)";"PA";"ABAETETUBA";301;21;227;549
2012;"ABEL FIGUEIREDO (PA)";"PA";"ABEL FIGUEIREDO";63;6;3;72
2012;"ACARA (PA)";"PA";"ACARA";69;5;55;129
2012;"AFUA (PA)";"PA";"AFUA";0;0;0;0
2012;"AGUA AZUL DO NORTE (PA)";"PA";"AGUA AZUL DO NORTE";64;7;15;86
2012;"ALENQUER (PA)";"PA";"ALENQUER";155;4;41;200
2012;"ALMEIRIM (PA)";"PA";"ALMEIRIM";214;19;109;342
2012;"ALTAMIRA (PA)";"PA";"ALTAMIRA";1569;136;232;1937
2012;"ANAJAS (PA)";"PA";"ANAJAS";0;0;1;1
2012;"ANANINDEUA (PA)";"PA";"ANANINDEUA";4011;388;1337;5736
2012;"ANAPU (PA)";"PA";"ANAPU";74;10;7;91
2012;"AUGUSTO CORREA (PA)";"PA";"AUGUSTO CORREA";40;3;54;97
2012;"AURORA DO PARA (PA)";"PA";"AURORA DO PARA";64;6;54;124
2012;"AVEIRO (PA)";"PA";"AVEIRO";3;0;3;6
2012;"BAGRE (PA)";"PA";"BAGRE";1;0;2;3
2012;"BAIAO (PA)";"PA";"BAIAO";39;2;14;55
2012;"BANNACH (PA)";"PA";"BANNACH";12;0;0;12
2012;"BARCARENA (PA)";"PA";"BARCARENA";833;186;636;1655
2012;"BELEM (PA)";"PA";"BELEM";8204;1644;3284;13132
2012;"BELTERRA (PA)";"PA";"BELTERRA";36;4;27;67
2012;"BENEVIDES (PA)";"PA";"BENEVIDES";581;48;102;731
2012;"BOM JESUS DO TOCANTINS (PA)";"PA";"BOM JESUS DO TOCANTINS";70;9;6;85
2012;"BONITO (PA)";"PA";"BONITO";55;3;41;99
2012;"BRAGANCA (PA)";"PA";"BRAGANCA";396;27;155;578
2012;"BRASIL NOVO (PA)";"PA";"BRASIL NOVO";172;19;10;201
2012;"BREJO GRANDE DO ARAGUAIA (PA)";"PA";"BREJO GRANDE DO ARAGUAIA";21;7;7;35
2012;"BREU BRANCO (PA)";"PA";"BREU BRANCO";248;7;81;336
2012;"BREVES (PA)";"PA";"BREVES";41;1;6;48
2012;"BUJARU (PA)";"PA";"BUJARU";41;7;21;69
2012;"CACHOEIRA DO ARARI (PA)";"PA";"CACHOEIRA DO ARARI";10;5;11;26
2012;"CACHOEIRA DO PIRIA (PA)";"PA";"CACHOEIRA DO PIRIA";31;3;21;55
2012;"CAMETA (PA)";"PA";"CAMETA";117;11;55;183
2012;"CANAA DOS CARAJAS (PA)";"PA";"CANAA DOS CARAJAS";219;59;103;381
2012;"CAPANEMA (PA)";"PA";"CAPANEMA";630;25;101;756
2012;"CAPITAO POCO (PA)";"PA";"CAPITAO POCO";324;26;76;426
2012;"CASTANHAL (PA)";"PA";"CASTANHAL";2487;156;356;2999
2012;"CHAVES (PA)";"PA";"CHAVES";0;0;0;0
2012;"COLARES (PA)";"PA";"COLARES";4;0;4;8
2012;"CONCEICAO DO ARAGUAIA (PA)";"PA";"CONCEICAO DO ARAGUAIA";334;36;66;436
2012;"CONCORDIA DO PARA (PA)";"PA";"CONCORDIA DO PARA";126;9;49;184
2012;"CUMARU DO NORTE (PA)";"PA";"CUMARU DO NORTE";20;1;6;27
2012;"CURIONOPOLIS (PA)";"PA";"CURIONOPOLIS";98;89;17;204
2012;"CURRALINHO (PA)";"PA";"CURRALINHO";1;0;2;3
2012;"CURUA (PA)";"PA";"CURUA";4;1;4;9
2012;"CURUCA (PA)";"PA";"CURUCA";44;9;15;68
2012;"DOM ELISEU (PA)";"PA";"DOM ELISEU";512;52;42;606
2012;"ELDORADO DOS CARAJAS (PA)";"PA";"ELDORADO DOS CARAJAS";144;33;11;188
2012;"FARO (PA)";"PA";"FARO";2;1;1;4
2012;"FLORESTA DO ARAGUAIA (PA)";"PA";"FLORESTA DO ARAGUAIA";96;2;7;105
2012;"GARRAFAO DO NORTE (PA)";"PA";"GARRAFAO DO NORTE";77;4;17;98
2012;"GOIANESIA DO PARA (PA)";"PA";"GOIANESIA DO PARA";290;16;32;338
2012;"GURUPA (PA)";"PA";"GURUPA";6;0;3;9
2012;"IGARAPE ACU (PA)";"PA";"IGARAPE ACU";157;63;69;289
2012;"IGARAPE MIRI (PA)";"PA";"IGARAPE MIRI";68;22;29;119
2012;"INHANGAPI (PA)";"PA";"INHANGAPI";34;1;31;66
2012;"IPIXUNA DO PARA (PA)";"PA";"IPIXUNA DO PARA";64;4;36;104
2012;"IRITUIA (PA)";"PA";"IRITUIA";69;2;44;115
2012;"ITAITUBA (PA)";"PA";"ITAITUBA";789;32;98;919
2012;"ITUPIRANGA (PA)";"PA";"ITUPIRANGA";166;89;24;279
2012;"JACAREACANGA (PA)";"PA";"JACAREACANGA";12;1;1;14
2012;"JACUNDA (PA)";"PA";"JACUNDA";600;19;43;662
2012;"JURUTI (PA)";"PA";"JURUTI";71;12;12;95
2012;"LIMOEIRO DO AJURU (PA)";"PA";"LIMOEIRO DO AJURU";0;0;3;3
2012;"MAE DO RIO (PA)";"PA";"MAE DO RIO";270;18;68;356
2012;"MAGALHAES BARATA (PA)";"PA";"MAGALHAES BARATA";5;26;7;38
2012;"MARABA (PA)";"PA";"MARABA";3407;330;541;4278
2012;"MARACANA (PA)";"PA";"MARACANA";29;11;21;61
2012;"MARAPANIM (PA)";"PA";"MARAPANIM";33;14;27;74
2012;"MARITUBA (PA)";"PA";"MARITUBA";761;115;374;1250
2012;"MEDICILANDIA (PA)";"PA";"MEDICILANDIA";170;11;26;207
2012;"MELGACO (PA)";"PA";"MELGACO";2;0;2;4
2012;"MOCAJUBA (PA)";"PA";"MOCAJUBA";16;2;12;30
2012;"MOJU (PA)";"PA";"MOJU";143;22;146;311
2012;"MONTE ALEGRE (PA)";"PA";"MONTE ALEGRE";233;9;125;367
2012;"MUANA (PA)";"PA";"MUANA";3;3;12;18
2012;"NOVA ESPERANCA DO PIRIA (PA)";"PA";"NOVA ESPERANCA DO PIRIA";65;3;16;84
2012;"NOVA IPIXUNA (PA)";"PA";"NOVA IPIXUNA";136;5;25;166
2012;"NOVA TIMBOTEUA (PA)";"PA";"NOVA TIMBOTEUA";55;4;16;75
2012;"NOVO PROGRESSO (PA)";"PA";"NOVO PROGRESSO";398;5;24;427
2012;"NOVO REPARTIMENTO (PA)";"PA";"NOVO REPARTIMENTO";368;24;43;435
2012;"OBIDOS (PA)";"PA";"OBIDOS";165;1;47;213
2012;"OEIRAS DO PARA (PA)";"PA";"OEIRAS DO PARA";8;1;6;15
2012;"ORIXIMINA (PA)";"PA";"ORIXIMINA";346;14;35;395
2012;"OUREM (PA)";"PA";"OUREM";164;3;16;183
2012;"OURILANDIA DO NORTE (PA)";"PA";"OURILANDIA DO NORTE";229;12;35;276
2012;"PACAJA (PA)";"PA";"PACAJA";114;19;9;142
2012;"PALESTINA DO PARA (PA)";"PA";"PALESTINA DO PARA";28;7;5;40
2012;"PARAGOMINAS (PA)";"PA";"PARAGOMINAS";1347;30;159;1536
2012;"PARAUAPEBAS (PA)";"PA";"PARAUAPEBAS";1746;646;1096;3488
2012;"PAU D ARCO (PA)";"PA";"PAU D ARCO";15;9;5;29
2012;"PEIXE BOI (PA)";"PA";"PEIXE BOI";19;4;13;36
2012;"PICARRA (PA)";"PA";"PICARRA";22;1;6;29
2012;"PLACAS (PA)";"PA";"PLACAS";73;5;2;80
2012;"PONTA DE PEDRAS (PA)";"PA";"PONTA DE PEDRAS";6;1;4;11
2012;"PORTEL (PA)";"PA";"PORTEL";21;0;7;28
2012;"PORTO DE MOZ (PA)";"PA";"PORTO DE MOZ";17;0;5;22
2012;"PRAINHA (PA)";"PA";"PRAINHA";23;0;3;26
2012;"PRIMAVERA (PA)";"PA";"PRIMAVERA";13;1;14;28
2012;"QUATIPURU (PA)";"PA";"QUATIPURU";9;2;9;20
2012;"REDENCAO (PA)";"PA";"REDENCAO";1274;70;121;1465
2012;"RIO MARIA (PA)";"PA";"RIO MARIA";247;40;29;316
2012;"RONDON DO PARA (PA)";"PA";"RONDON DO PARA";470;47;22;539
2012;"RUROPOLIS (PA)";"PA";"RUROPOLIS";180;6;12;198
2012;"SALINOPOLIS (PA)";"PA";"SALINOPOLIS";142;30;62;234
2012;"SALVATERRA (PA)";"PA";"SALVATERRA";36;27;25;88
2012;"SANTA BARBARA DO PARA (PA)";"PA";"SANTA BARBARA DO PARA";57;17;56;130
2012;"SANTA CRUZ DO ARARI (PA)";"PA";"SANTA CRUZ DO ARARI";4;1;1;6
2012;"SANTA ISABEL DO PARA (PA)";"PA";"SANTA ISABEL DO PARA";563;44;150;757
2012;"SANTA LUZIA DO PARA (PA)";"PA";"SANTA LUZIA DO PARA";115;12;27;154
2012;"SANTA MARIA DAS BARREIRAS (PA)";"PA";"SANTA MARIA DAS BARREIRAS";66;2;24;92
2012;"SANTA MARIA DO PARA (PA)";"PA";"SANTA MARIA DO PARA";264;19;49;332
2012;"SANTANA DO ARAGUAIA (PA)";"PA";"SANTANA DO ARAGUAIA";181;10;20;211
2012;"SANTAREM (PA)";"PA";"SANTAREM";2444;110;610;3164
2012;"SANTAREM NOVO (PA)";"PA";"SANTAREM NOVO";8;6;13;27
2012;"SANTO ANTONIO DO TAUA (PA)";"PA";"SANTO ANTONIO DO TAUA";103;25;92;220
2012;"SAO CAETANO DE ODIVELAS (PA)";"PA";"SAO CAETANO DE ODIVELAS";24;0;5;29
2012;"SAO DOMINGOS DO ARAGUAIA (PA)";"PA";"SAO DOMINGOS DO ARAGUAIA";137;26;23;186
2012;"SAO DOMINGOS DO CAPIM (PA)";"PA";"SAO DOMINGOS DO CAPIM";38;0;22;60
2012;"SAO FELIX DO XINGU (PA)";"PA";"SAO FELIX DO XINGU";244;7;23;274
2012;"SAO FRANCISCO DO PARA (PA)";"PA";"SAO FRANCISCO DO PARA";38;37;29;104
2012;"SAO GERALDO DO ARAGUAIA (PA)";"PA";"SAO GERALDO DO ARAGUAIA";125;5;12;142
2012;"SAO JOAO DA PONTA (PA)";"PA";"SAO JOAO DA PONTA";3;4;7;14
2012;"SAO JOAO DE PIRABAS (PA)";"PA";"SAO JOAO DE PIRABAS";24;8;16;48
2012;"SAO JOAO DO ARAGUAIA (PA)";"PA";"SAO JOAO DO ARAGUAIA";22;15;8;45
2012;"SAO MIGUEL DO GUAMA (PA)";"PA";"SAO MIGUEL DO GUAMA";396;26;99;521
2012;"SAO SEBASTIAO DA BOA VISTA (PA)";"PA";"SAO SEBASTIAO DA BOA VISTA";4;1;1;6
2012;"SAPUCAIA (PA)";"PA";"SAPUCAIA";27;4;4;35
2012;"SENADOR JOSE PORFIRIO (PA)";"PA";"SENADOR JOSE PORFIRIO";22;4;3;29
2012;"SOURE (PA)";"PA";"SOURE";35;2;10;47
2012;"TAILANDIA (PA)";"PA";"TAILANDIA";647;38;127;812
2012;"TERRA ALTA (PA)";"PA";"TERRA ALTA";22;19;18;59
2012;"TERRA SANTA (PA)";"PA";"TERRA SANTA";21;0;3;24
2012;"TOME ACU (PA)";"PA";"TOME ACU";498;16;128;642
2012;"TRACUATEUA (PA)";"PA";"TRACUATEUA";23;7;28;58
2012;"TRAIRAO (PA)";"PA";"TRAIRAO";102;3;9;114
2012;"TUCUMA (PA)";"PA";"TUCUMA";497;24;85;606
2012;"TUCURUI (PA)";"PA";"TUCURUI";857;85;183;1125
2012;"ULIANOPOLIS (PA)";"PA";"ULIANOPOLIS";167;19;26;212
2012;"URUARA (PA)";"PA";"URUARA";476;16;23;515
2012;"VIGIA (PA)";"PA";"VIGIA";124;20;73;217
2012;"VISEU (PA)";"PA";"VISEU";57;3;34;94
2012;"VITORIA DO XINGU (PA)";"PA";"VITORIA DO XINGU";22;9;8;39
2012;"XINGUARA (PA)";"PA";"XINGUARA";773;28;74;875
2012;"AGUA BRANCA (PB)";"PB";"AGUA BRANCA";11;6;5;22
2012;"AGUIAR (PB)";"PB";"AGUIAR";7;5;1;13
2012;"ALAGOA GRANDE (PB)";"PB";"ALAGOA GRANDE";98;27;37;162
2012;"ALAGOA NOVA (PB)";"PB";"ALAGOA NOVA";127;48;11;186
2012;"ALAGOINHA (PB)";"PB";"ALAGOINHA";47;17;27;91
2012;"ALCANTIL (PB)";"PB";"ALCANTIL";42;20;14;76
2012;"ALGODAO DE JANDAIRA (PB)";"PB";"ALGODAO DE JANDAIRA";17;0;2;19
2012;"ALHANDRA (PB)";"PB";"ALHANDRA";126;19;16;161
2012;"AMPARO (PB)";"PB";"AMPARO";9;4;6;19
2012;"APARECIDA (PB)";"PB";"APARECIDA";33;4;13;50
2012;"ARACAGI (PB)";"PB";"ARACAGI";51;2;42;95
2012;"ARARA (PB)";"PB";"ARARA";57;5;18;80
2012;"ARARUNA (PB)";"PB";"ARARUNA";84;36;17;137
2012;"AREIA (PB)";"PB";"AREIA";107;32;19;158
2012;"AREIA DE BARAUNAS (PB)";"PB";"AREIA DE BARAUNAS";5;2;2;9
2012;"AREIAL (PB)";"PB";"AREIAL";28;4;7;39
2012;"AROEIRAS (PB)";"PB";"AROEIRAS";58;37;16;111
2012;"ASSUNCAO (PB)";"PB";"ASSUNCAO";28;9;4;41
2012;"BAIA DA TRAICAO (PB)";"PB";"BAIA DA TRAICAO";13;6;7;26
2012;"BANANEIRAS (PB)";"PB";"BANANEIRAS";78;17;22;117
2012;"BARAUNA (PB)";"PB";"BARAUNA";27;2;2;31
2012;"BARRA DE SANTA ROSA (PB)";"PB";"BARRA DE SANTA ROSA";74;7;14;95
2012;"BARRA DE SANTANA (PB)";"PB";"BARRA DE SANTANA";60;5;14;79
2012;"BARRA DE SAO MIGUEL (PB)";"PB";"BARRA DE SAO MIGUEL";8;1;3;12
2012;"BAYEUX (PB)";"PB";"BAYEUX";657;28;155;840
2012;"BELEM (PB)";"PB";"BELEM";119;9;11;139
2012;"BELEM DO BREJO DO CRUZ (PB)";"PB";"BELEM DO BREJO DO CRUZ";10;12;2;24
2012;"BERNARDINO BATISTA (PB)";"PB";"BERNARDINO BATISTA";3;0;5;8
2012;"BOA VENTURA (PB)";"PB";"BOA VENTURA";11;2;1;14
2012;"BOA VISTA (PB)";"PB";"BOA VISTA";102;10;16;128
2012;"BOM JESUS (PB)";"PB";"BOM JESUS";9;0;2;11
2012;"BOM SUCESSO (PB)";"PB";"BOM SUCESSO";4;2;6;12
2012;"BONITO DE SANTA FE (PB)";"PB";"BONITO DE SANTA FE";19;10;2;31
2012;"BOQUEIRAO (PB)";"PB";"BOQUEIRAO";195;13;20;228
2012;"BORBOREMA (PB)";"PB";"BORBOREMA";27;19;2;48
2012;"BREJO DO CRUZ (PB)";"PB";"BREJO DO CRUZ";75;12;3;90
2012;"BREJO DOS SANTOS (PB)";"PB";"BREJO DOS SANTOS";15;2;1;18
2012;"CAAPORA (PB)";"PB";"CAAPORA";38;7;9;54
2012;"CABACEIRAS (PB)";"PB";"CABACEIRAS";23;3;12;38
2012;"CABEDELO (PB)";"PB";"CABEDELO";464;37;25;526
2012;"CACHOEIRA DOS INDIOS (PB)";"PB";"CACHOEIRA DOS INDIOS";16;1;5;22
2012;"CACIMBA DE AREIA (PB)";"PB";"CACIMBA DE AREIA";5;1;4;10
2012;"CACIMBA DE DENTRO (PB)";"PB";"CACIMBA DE DENTRO";65;16;34;115
2012;"CACIMBAS (PB)";"PB";"CACIMBAS";2;4;2;8
2012;"CAICARA (PB)";"PB";"CAICARA";14;4;4;22
2012;"CAJAZEIRAS (PB)";"PB";"CAJAZEIRAS";433;48;50;531
2012;"CAJAZEIRINHAS (PB)";"PB";"CAJAZEIRINHAS";4;2;2;8
2012;"CALDAS BRANDAO (PB)";"PB";"CALDAS BRANDAO";30;4;4;38
2012;"CAMALAU (PB)";"PB";"CAMALAU";30;8;13;51
2012;"CAMPINA GRANDE (PB)";"PB";"CAMPINA GRANDE";4267;312;699;5278
2012;"CAMPO DE SANTANA (PB)";"PB";"CAMPO DE SANTANA";32;6;15;53
2012;"CAPIM (PB)";"PB";"CAPIM";23;5;10;38
2012;"CARAUBAS (PB)";"PB";"CARAUBAS";7;7;3;17
2012;"CARRAPATEIRA (PB)";"PB";"CARRAPATEIRA";2;2;2;6
2012;"CASSERENGUE (PB)";"PB";"CASSERENGUE";31;6;16;53
2012;"CATINGUEIRA (PB)";"PB";"CATINGUEIRA";12;2;2;16
2012;"CATOLE DO ROCHA (PB)";"PB";"CATOLE DO ROCHA";237;34;16;287
2012;"CATURITE (PB)";"PB";"CATURITE";91;12;10;113
2012;"CONCEICAO (PB)";"PB";"CONCEICAO";79;31;9;119
2012;"CONDADO (PB)";"PB";"CONDADO";30;8;7;45
2012;"CONDE (PB)";"PB";"CONDE";86;15;14;115
2012;"CONGO (PB)";"PB";"CONGO";21;5;5;31
2012;"COREMAS (PB)";"PB";"COREMAS";55;16;8;79
2012;"COXIXOLA (PB)";"PB";"COXIXOLA";3;7;0;10
2012;"CRUZ DO ESPIRITO SANTO (PB)";"PB";"CRUZ DO ESPIRITO SANTO";27;5;19;51
2012;"CUBATI (PB)";"PB";"CUBATI";34;3;2;39
2012;"CUITE (PB)";"PB";"CUITE";83;8;11;102
2012;"CUITE DE MAMANGUAPE (PB)";"PB";"CUITE DE MAMANGUAPE";10;10;25;45
2012;"CUITEGI (PB)";"PB";"CUITEGI";19;3;3;25
2012;"CURRAL DE CIMA (PB)";"PB";"CURRAL DE CIMA";14;4;16;34
2012;"CURRAL VELHO (PB)";"PB";"CURRAL VELHO";4;0;1;5
2012;"DAMIAO (PB)";"PB";"DAMIAO";18;3;6;27
2012;"DESTERRO (PB)";"PB";"DESTERRO";29;11;4;44
2012;"DIAMANTE (PB)";"PB";"DIAMANTE";12;2;2;16
2012;"DONA INES (PB)";"PB";"DONA INES";40;8;20;68
2012;"DUAS ESTRADAS (PB)";"PB";"DUAS ESTRADAS";9;5;4;18
2012;"EMAS (PB)";"PB";"EMAS";3;4;2;9
2012;"ESPERANCA (PB)";"PB";"ESPERANCA";504;29;92;625
2012;"FAGUNDES (PB)";"PB";"FAGUNDES";37;7;21;65
2012;"FREI MARTINHO (PB)";"PB";"FREI MARTINHO";6;1;4;11
2012;"GADO BRAVO (PB)";"PB";"GADO BRAVO";34;18;10;62
2012;"GUARABIRA (PB)";"PB";"GUARABIRA";504;61;146;711
2012;"GURINHEM (PB)";"PB";"GURINHEM";41;9;21;71
2012;"GURJAO (PB)";"PB";"GURJAO";8;4;2;14
2012;"IBIARA (PB)";"PB";"IBIARA";10;2;2;14
2012;"IGARACY (PB)";"PB";"IGARACY";12;9;3;24
2012;"IMACULADA (PB)";"PB";"IMACULADA";8;8;3;19
2012;"INGA (PB)";"PB";"INGA";97;7;25;129
2012;"ITABAIANA (PB)";"PB";"ITABAIANA";146;8;37;191
2012;"ITAPORANGA (PB)";"PB";"ITAPORANGA";114;36;17;167
2012;"ITAPOROROCA (PB)";"PB";"ITAPOROROCA";94;3;22;119
2012;"ITATUBA (PB)";"PB";"ITATUBA";39;2;9;50
2012;"JACARAU (PB)";"PB";"JACARAU";58;5;17;80
2012;"JERICO (PB)";"PB";"JERICO";18;4;1;23
2012;"JOAO PESSOA (PB)";"PB";"JOAO PESSOA";5383;944;1733;8060
2012;"JUAREZ TAVORA (PB)";"PB";"JUAREZ TAVORA";26;3;14;43
2012;"JUAZEIRINHO (PB)";"PB";"JUAZEIRINHO";65;17;11;93
2012;"JUNCO DO SERIDO (PB)";"PB";"JUNCO DO SERIDO";51;5;3;59
2012;"JURIPIRANGA (PB)";"PB";"JURIPIRANGA";38;2;19;59
2012;"JURU (PB)";"PB";"JURU";12;7;2;21
2012;"LAGOA (PB)";"PB";"LAGOA";10;3;5;18
2012;"LAGOA DE DENTRO (PB)";"PB";"LAGOA DE DENTRO";28;7;9;44
2012;"LAGOA SECA (PB)";"PB";"LAGOA SECA";176;49;19;244
2012;"LASTRO (PB)";"PB";"LASTRO";3;4;2;9
2012;"LIVRAMENTO (PB)";"PB";"LIVRAMENTO";32;7;5;44
2012;"LOGRADOURO (PB)";"PB";"LOGRADOURO";2;4;9;15
2012;"LUCENA (PB)";"PB";"LUCENA";21;4;9;34
2012;"MAE D AGUA (PB)";"PB";"MAE D AGUA";5;0;3;8
2012;"MALTA (PB)";"PB";"MALTA";12;7;2;21
2012;"MAMANGUAPE (PB)";"PB";"MAMANGUAPE";394;12;79;485
2012;"MANAIRA (PB)";"PB";"MANAIRA";11;8;2;21
2012;"MARCACAO (PB)";"PB";"MARCACAO";2;6;11;19
2012;"MARI (PB)";"PB";"MARI";103;9;43;155
2012;"MARIZOPOLIS (PB)";"PB";"MARIZOPOLIS";23;6;2;31
2012;"MASSARANDUBA (PB)";"PB";"MASSARANDUBA";28;8;9;45
2012;"MATARACA (PB)";"PB";"MATARACA";38;4;14;56
2012;"MATINHAS (PB)";"PB";"MATINHAS";9;1;3;13
2012;"MATO GROSSO (PB)";"PB";"MATO GROSSO";8;3;2;13
2012;"MATUREIA (PB)";"PB";"MATUREIA";14;13;3;30
2012;"MOGEIRO (PB)";"PB";"MOGEIRO";31;7;7;45
2012;"MONTADAS (PB)";"PB";"MONTADAS";23;3;6;32
2012;"MONTE HOREBE (PB)";"PB";"MONTE HOREBE";6;2;3;11
2012;"MONTEIRO (PB)";"PB";"MONTEIRO";233;74;40;347
2012;"MULUNGU (PB)";"PB";"MULUNGU";39;7;13;59
2012;"NATUBA (PB)";"PB";"NATUBA";20;1;4;25
2012;"NAZAREZINHO (PB)";"PB";"NAZAREZINHO";21;7;4;32
2012;"NOVA FLORESTA (PB)";"PB";"NOVA FLORESTA";47;10;8;65
2012;"NOVA OLINDA (PB)";"PB";"NOVA OLINDA";19;8;4;31
2012;"NOVA PALMEIRA (PB)";"PB";"NOVA PALMEIRA";19;1;3;23
2012;"OLHO D AGUA (PB)";"PB";"OLHO D AGUA";5;5;4;14
2012;"OLIVEDOS (PB)";"PB";"OLIVEDOS";27;5;8;40
2012;"OURO VELHO (PB)";"PB";"OURO VELHO";9;3;3;15
2012;"PARARI (PB)";"PB";"PARARI";4;0;1;5
2012;"PASSAGEM (PB)";"PB";"PASSAGEM";17;0;2;19
2012;"PATOS (PB)";"PB";"PATOS";761;138;51;950
2012;"PAULISTA (PB)";"PB";"PAULISTA";51;10;6;67
2012;"PEDRA BRANCA (PB)";"PB";"PEDRA BRANCA";7;3;4;14
2012;"PEDRA LAVRADA (PB)";"PB";"PEDRA LAVRADA";39;5;5;49
2012;"PEDRAS DE FOGO (PB)";"PB";"PEDRAS DE FOGO";252;21;72;345
2012;"PEDRO REGIS (PB)";"PB";"PEDRO REGIS";18;1;3;22
2012;"PIANCO (PB)";"PB";"PIANCO";89;18;4;111
2012;"PICUI (PB)";"PB";"PICUI";112;9;38;159
2012;"PILAR (PB)";"PB";"PILAR";25;2;11;38
2012;"PILOES (PB)";"PB";"PILOES";25;3;7;35
2012;"PILOEZINHOS (PB)";"PB";"PILOEZINHOS";12;5;5;22
2012;"PIRPIRITUBA (PB)";"PB";"PIRPIRITUBA";27;0;11;38
2012;"PITIMBU (PB)";"PB";"PITIMBU";19;15;7;41
2012;"POCINHOS (PB)";"PB";"POCINHOS";103;19;23;145
2012;"POCO DANTAS (PB)";"PB";"POCO DANTAS";4;0;4;8
2012;"POCO DE JOSE DE MOURA (PB)";"PB";"POCO DE JOSE DE MOURA";4;2;4;10
2012;"POMBAL (PB)";"PB";"POMBAL";309;39;16;364
2012;"PRATA (PB)";"PB";"PRATA";18;9;5;32
2012;"PRINCESA ISABEL (PB)";"PB";"PRINCESA ISABEL";92;75;8;175
2012;"PUXINANA (PB)";"PB";"PUXINANA";68;20;10;98
2012;"QUEIMADAS (PB)";"PB";"QUEIMADAS";430;95;86;611
2012;"QUIXABA (PB)";"PB";"QUIXABA";6;3;3;12
2012;"REMIGIO (PB)";"PB";"REMIGIO";218;7;18;243
2012;"RIACHAO (PB)";"PB";"RIACHAO";3;1;6;10
2012;"RIACHAO DO BACAMARTE (PB)";"PB";"RIACHAO DO BACAMARTE";15;0;3;18
2012;"RIACHAO DO POCO (PB)";"PB";"RIACHAO DO POCO";11;1;9;21
2012;"RIACHO DE SANTO ANTONIO (PB)";"PB";"RIACHO DE SANTO ANTONIO";9;4;3;16
2012;"RIACHO DOS CAVALOS (PB)";"PB";"RIACHO DOS CAVALOS";19;3;5;27
2012;"RIO TINTO (PB)";"PB";"RIO TINTO";84;6;30;120
2012;"SALGADINHO (PB)";"PB";"SALGADINHO";4;2;4;10
2012;"SALGADO DE SAO FELIX (PB)";"PB";"SALGADO DE SAO FELIX";13;4;5;22
2012;"SANTA CECILIA (PB)";"PB";"SANTA CECILIA";22;3;6;31
2012;"SANTA CRUZ (PB)";"PB";"SANTA CRUZ";10;3;9;22
2012;"SANTA HELENA (PB)";"PB";"SANTA HELENA";7;2;8;17
2012;"SANTA INES (PB)";"PB";"SANTA INES";10;3;1;14
2012;"SANTA LUZIA (PB)";"PB";"SANTA LUZIA";165;15;14;194
2012;"SANTA RITA (PB)";"PB";"SANTA RITA";733;62;241;1036
2012;"SANTA TERESINHA (PB)";"PB";"SANTA TERESINHA";21;4;6;31
2012;"SANTANA DE MANGUEIRA (PB)";"PB";"SANTANA DE MANGUEIRA";2;1;3;6
2012;"SANTANA DOS GARROTES (PB)";"PB";"SANTANA DOS GARROTES";16;6;1;23
2012;"SANTAREM (PB)";"PB";"SANTAREM";2;1;4;7
2012;"SANTO ANDRE (PB)";"PB";"SANTO ANDRE";17;5;19;41
2012;"SAO BENTINHO (PB)";"PB";"SAO BENTINHO";12;4;2;18
2012;"SAO BENTO (PB)";"PB";"SAO BENTO";257;26;17;300
2012;"SAO DOMINGOS DE POMBAL (PB)";"PB";"SAO DOMINGOS DE POMBAL";4;3;4;11
2012;"SAO DOMINGOS DO CARIRI (PB)";"PB";"SAO DOMINGOS DO CARIRI";9;0;3;12
2012;"SAO FRANCISCO (PB)";"PB";"SAO FRANCISCO";8;1;3;12
2012;"SAO JOAO DO CARIRI (PB)";"PB";"SAO JOAO DO CARIRI";20;4;7;31
2012;"SAO JOAO DO RIO DO PEIXE (PB)";"PB";"SAO JOAO DO RIO DO PEIXE";48;7;18;73
2012;"SAO JOAO DO TIGRE (PB)";"PB";"SAO JOAO DO TIGRE";10;2;2;14
2012;"SAO JOSE DA LAGOA TAPADA (PB)";"PB";"SAO JOSE DA LAGOA TAPADA";15;6;5;26
2012;"SAO JOSE DE CAIANA (PB)";"PB";"SAO JOSE DE CAIANA";3;4;4;11
2012;"SAO JOSE DE ESPINHARAS (PB)";"PB";"SAO JOSE DE ESPINHARAS";13;5;4;22
2012;"SAO JOSE DE PIRANHAS (PB)";"PB";"SAO JOSE DE PIRANHAS";30;7;6;43
2012;"SAO JOSE DE PRINCESA (PB)";"PB";"SAO JOSE DE PRINCESA";2;2;3;7
2012;"SAO JOSE DO BONFIM (PB)";"PB";"SAO JOSE DO BONFIM";9;1;3;13
2012;"SAO JOSE DO BREJO DO CRUZ (PB)";"PB";"SAO JOSE DO BREJO DO CRUZ";3;1;1;5
2012;"SAO JOSE DO SABUGI (PB)";"PB";"SAO JOSE DO SABUGI";16;2;2;20
2012;"SAO JOSE DOS CORDEIROS (PB)";"PB";"SAO JOSE DOS CORDEIROS";9;3;3;15
2012;"SAO JOSE DOS RAMOS (PB)";"PB";"SAO JOSE DOS RAMOS";17;1;8;26
2012;"SAO MAMEDE (PB)";"PB";"SAO MAMEDE";23;2;3;28
2012;"SAO MIGUEL DE TAIPU (PB)";"PB";"SAO MIGUEL DE TAIPU";22;0;5;27
2012;"SAO SEBASTIAO DE LAGOA DE ROCA (PB)";"PB";"SAO SEBASTIAO DE LAGOA DE ROCA";52;16;10;78
2012;"SAO SEBASTIAO DO UMBUZEIRO (PB)";"PB";"SAO SEBASTIAO DO UMBUZEIRO";11;2;4;17
2012;"SAO VICENTE DO SERIDO (PB)";"PB";"SAO VICENTE DO SERIDO";16;6;6;28
2012;"SAPE (PB)";"PB";"SAPE";338;27;87;452
2012;"SERRA BRANCA (PB)";"PB";"SERRA BRANCA";88;22;10;120
2012;"SERRA DA RAIZ (PB)";"PB";"SERRA DA RAIZ";5;0;5;10
2012;"SERRA GRANDE (PB)";"PB";"SERRA GRANDE";4;0;3;7
2012;"SERRA REDONDA (PB)";"PB";"SERRA REDONDA";19;7;2;28
2012;"SERRARIA (PB)";"PB";"SERRARIA";14;10;5;29
2012;"SERTAOZINHO (PB)";"PB";"SERTAOZINHO";7;3;8;18
2012;"SOBRADO (PB)";"PB";"SOBRADO";57;5;5;67
2012;"SOLANEA (PB)";"PB";"SOLANEA";193;27;33;253
2012;"SOLEDADE (PB)";"PB";"SOLEDADE";153;22;17;192
2012;"SOSSEGO (PB)";"PB";"SOSSEGO";22;3;4;29
2012;"SOUSA (PB)";"PB";"SOUSA";714;45;59;818
2012;"SUME (PB)";"PB";"SUME";92;24;15;131
2012;"TAPEROA (PB)";"PB";"TAPEROA";77;11;5;93
2012;"TAVARES (PB)";"PB";"TAVARES";26;6;6;38
2012;"TEIXEIRA (PB)";"PB";"TEIXEIRA";86;15;17;118
2012;"TENORIO (PB)";"PB";"TENORIO";12;1;3;16
2012;"TRIUNFO (PB)";"PB";"TRIUNFO";11;4;4;19
2012;"UIRAUNA (PB)";"PB";"UIRAUNA";66;9;6;81
2012;"UMBUZEIRO (PB)";"PB";"UMBUZEIRO";58;24;24;106
2012;"VARZEA (PB)";"PB";"VARZEA";14;5;4;23
2012;"VIEIROPOLIS (PB)";"PB";"VIEIROPOLIS";13;3;10;26
2012;"VISTA SERRANA (PB)";"PB";"VISTA SERRANA";15;1;4;20
2012;"ZABELE (PB)";"PB";"ZABELE";9;2;2;13
2012;"ABREU E LIMA (PE)";"PE";"ABREU E LIMA";520;53;361;934
2012;"AFOGADOS DA INGAZEIRA (PE)";"PE";"AFOGADOS DA INGAZEIRA";351;38;52;441
2012;"AFRANIO (PE)";"PE";"AFRANIO";143;7;13;163
2012;"AGRESTINA (PE)";"PE";"AGRESTINA";158;40;23;221
2012;"AGUA PRETA (PE)";"PE";"AGUA PRETA";153;42;46;241
2012;"AGUAS BELAS (PE)";"PE";"AGUAS BELAS";269;62;34;365
2012;"ALAGOINHA (PE)";"PE";"ALAGOINHA";104;35;11;150
2012;"ALIANCA (PE)";"PE";"ALIANCA";152;16;108;276
2012;"ALTINHO (PE)";"PE";"ALTINHO";70;49;26;145
2012;"AMARAJI (PE)";"PE";"AMARAJI";85;26;37;148
2012;"ANGELIM (PE)";"PE";"ANGELIM";47;15;5;67
2012;"ARACOIABA (PE)";"PE";"ARACOIABA";63;8;77;148
2012;"ARARIPINA (PE)";"PE";"ARARIPINA";1229;40;61;1330
2012;"ARCOVERDE (PE)";"PE";"ARCOVERDE";1005;132;104;1241
2012;"BARRA DE GUABIRABA (PE)";"PE";"BARRA DE GUABIRABA";59;20;9;88
2012;"BARREIROS (PE)";"PE";"BARREIROS";260;26;43;329
2012;"BELEM DE MARIA (PE)";"PE";"BELEM DE MARIA";73;42;13;128
2012;"BELEM DE SAO FRANCISCO (PE)";"PE";"BELEM DE SAO FRANCISCO";95;9;10;114
2012;"BELO JARDIM (PE)";"PE";"BELO JARDIM";633;205;74;912
2012;"BETANIA (PE)";"PE";"BETANIA";47;3;8;58
2012;"BEZERROS (PE)";"PE";"BEZERROS";703;111;48;862
2012;"BODOCO (PE)";"PE";"BODOCO";198;2;10;210
2012;"BOM CONSELHO (PE)";"PE";"BOM CONSELHO";269;40;36;345
2012;"BOM JARDIM (PE)";"PE";"BOM JARDIM";165;226;37;428
2012;"BONITO (PE)";"PE";"BONITO";338;72;31;441
2012;"BREJAO (PE)";"PE";"BREJAO";59;13;8;80
2012;"BREJINHO (PE)";"PE";"BREJINHO";35;4;7;46
2012;"BREJO DA MADRE DE DEUS (PE)";"PE";"BREJO DA MADRE DE DEUS";202;314;10;526
2012;"BUENOS AIRES (PE)";"PE";"BUENOS AIRES";58;5;15;78
2012;"BUIQUE (PE)";"PE";"BUIQUE";254;61;35;350
2012;"CABO DE SANTO AGOSTINHO (PE)";"PE";"CABO DE SANTO AGOSTINHO";1271;269;440;1980
2012;"CABROBO (PE)";"PE";"CABROBO";218;6;26;250
2012;"CACHOEIRINHA (PE)";"PE";"CACHOEIRINHA";136;58;10;204
2012;"CAETES (PE)";"PE";"CAETES";240;39;14;293
2012;"CALCADO (PE)";"PE";"CALCADO";53;8;19;80
2012;"CALUMBI (PE)";"PE";"CALUMBI";58;5;4;67
2012;"CAMARAGIBE (PE)";"PE";"CAMARAGIBE";727;260;174;1161
2012;"CAMOCIM DE SAO FELIX (PE)";"PE";"CAMOCIM DE SAO FELIX";129;34;7;170
2012;"CAMUTANGA (PE)";"PE";"CAMUTANGA";81;1;14;96
2012;"CANHOTINHO (PE)";"PE";"CANHOTINHO";203;66;6;275
2012;"CAPOEIRAS (PE)";"PE";"CAPOEIRAS";209;33;6;248
2012;"CARNAIBA (PE)";"PE";"CARNAIBA";104;21;24;149
2012;"CARNAUBEIRA DA PENHA (PE)";"PE";"CARNAUBEIRA DA PENHA";40;5;2;47
2012;"CARPINA (PE)";"PE";"CARPINA";861;110;141;1112
2012;"CARUARU (PE)";"PE";"CARUARU";4088;697;509;5294
2012;"CASINHAS (PE)";"PE";"CASINHAS";49;133;11;193
2012;"CATENDE (PE)";"PE";"CATENDE";174;66;57;297
2012;"CEDRO (PE)";"PE";"CEDRO";37;5;10;52
2012;"CHA DE ALEGRIA (PE)";"PE";"CHA DE ALEGRIA";51;15;27;93
2012;"CHA GRANDE (PE)";"PE";"CHA GRANDE";219;32;22;273
2012;"CONDADO (PE)";"PE";"CONDADO";130;4;65;199
2012;"CORRENTES (PE)";"PE";"CORRENTES";69;24;8;101
2012;"CORTES (PE)";"PE";"CORTES";155;40;30;225
2012;"CUMARU (PE)";"PE";"CUMARU";109;69;16;194
2012;"CUPIRA (PE)";"PE";"CUPIRA";242;73;18;333
2012;"CUSTODIA (PE)";"PE";"CUSTODIA";304;48;19;371
2012;"DORMENTES (PE)";"PE";"DORMENTES";169;7;11;187
2012;"ESCADA (PE)";"PE";"ESCADA";363;72;144;579
2012;"EXU (PE)";"PE";"EXU";301;5;25;331
2012;"FEIRA NOVA (PE)";"PE";"FEIRA NOVA";190;34;11;235
2012;"FERNANDO DE NORONHA (PE)";"PE";"FERNANDO DE NORONHA";17;23;7;47
2012;"FERREIROS (PE)";"PE";"FERREIROS";62;1;44;107
2012;"FLORES (PE)";"PE";"FLORES";76;15;5;96
2012;"FLORESTA (PE)";"PE";"FLORESTA";442;7;14;463
2012;"FREI MIGUELINHO (PE)";"PE";"FREI MIGUELINHO";141;134;18;293
2012;"GAMELEIRA (PE)";"PE";"GAMELEIRA";83;15;45;143
2012;"GARANHUNS (PE)";"PE";"GARANHUNS";1698;244;104;2046
2012;"GLORIA DO GOITA (PE)";"PE";"GLORIA DO GOITA";150;44;30;224
2012;"GOIANA (PE)";"PE";"GOIANA";706;108;130;944
2012;"GRANITO (PE)";"PE";"GRANITO";23;2;13;38
2012;"GRAVATA (PE)";"PE";"GRAVATA";868;95;65;1028
2012;"IATI (PE)";"PE";"IATI";46;30;22;98
2012;"IBIMIRIM (PE)";"PE";"IBIMIRIM";184;29;12;225
2012;"IBIRAJUBA (PE)";"PE";"IBIRAJUBA";48;6;5;59
2012;"IGARASSU (PE)";"PE";"IGARASSU";820;85;667;1572
2012;"IGUARACI (PE)";"PE";"IGUARACI";104;16;22;142
2012;"ILHA DE ITAMARACA (PE)";"PE";"ILHA DE ITAMARACA";85;14;14;113
2012;"INAJA (PE)";"PE";"INAJA";55;7;7;69
2012;"INGAZEIRA (PE)";"PE";"INGAZEIRA";20;6;4;30
2012;"IPOJUCA (PE)";"PE";"IPOJUCA";625;248;186;1059
2012;"IPUBI (PE)";"PE";"IPUBI";226;12;29;267
2012;"ITACURUBA (PE)";"PE";"ITACURUBA";18;2;5;25
2012;"ITAIBA (PE)";"PE";"ITAIBA";96;33;7;136
2012;"ITAMBE (PE)";"PE";"ITAMBE";366;21;104;491
2012;"ITAPETIM (PE)";"PE";"ITAPETIM";62;2;6;70
2012;"ITAPISSUMA (PE)";"PE";"ITAPISSUMA";80;32;24;136
2012;"ITAQUITINGA (PE)";"PE";"ITAQUITINGA";40;5;28;73
2012;"JABOATAO DOS GUARARAPES (PE)";"PE";"JABOATAO DOS GUARARAPES";5221;877;2019;8117
2012;"JAQUEIRA (PE)";"PE";"JAQUEIRA";58;7;21;86
2012;"JATAUBA (PE)";"PE";"JATAUBA";86;129;8;223
2012;"JATOBA (PE)";"PE";"JATOBA";34;10;9;53
2012;"JOAO ALFREDO (PE)";"PE";"JOAO ALFREDO";189;507;12;708
2012;"JOAQUIM NABUCO (PE)";"PE";"JOAQUIM NABUCO";85;15;43;143
2012;"JUCATI (PE)";"PE";"JUCATI";122;15;17;154
2012;"JUPI (PE)";"PE";"JUPI";152;27;22;201
2012;"JUREMA (PE)";"PE";"JUREMA";72;23;11;106
2012;"LAGOA DO CARRO (PE)";"PE";"LAGOA DO CARRO";92;13;12;117
2012;"LAGOA DO ITAENGA (PE)";"PE";"LAGOA DO ITAENGA";351;30;59;440
2012;"LAGOA DO OURO (PE)";"PE";"LAGOA DO OURO";43;23;11;77
2012;"LAGOA DOS GATOS (PE)";"PE";"LAGOA DOS GATOS";96;24;7;127
2012;"LAGOA GRANDE (PE)";"PE";"LAGOA GRANDE";95;11;10;116
2012;"LAJEDO (PE)";"PE";"LAJEDO";494;71;42;607
2012;"LIMOEIRO (PE)";"PE";"LIMOEIRO";461;115;43;619
2012;"MACAPARANA (PE)";"PE";"MACAPARANA";166;11;39;216
2012;"MACHADOS (PE)";"PE";"MACHADOS";113;27;10;150
2012;"MANARI (PE)";"PE";"MANARI";43;5;6;54
2012;"MARAIAL (PE)";"PE";"MARAIAL";130;10;16;156
2012;"MIRANDIBA (PE)";"PE";"MIRANDIBA";111;5;2;118
2012;"MOREILANDIA (PE)";"PE";"MOREILANDIA";47;5;6;58
2012;"MORENO (PE)";"PE";"MORENO";547;152;238;937
2012;"NAZARE DA MATA (PE)";"PE";"NAZARE DA MATA";221;23;51;295
2012;"OLINDA (PE)";"PE";"OLINDA";3020;350;1381;4751
2012;"OROBO (PE)";"PE";"OROBO";138;151;53;342
2012;"OROCO (PE)";"PE";"OROCO";59;2;7;68
2012;"OURICURI (PE)";"PE";"OURICURI";577;20;77;674
2012;"PALMARES (PE)";"PE";"PALMARES";535;69;174;778
2012;"PALMEIRINA (PE)";"PE";"PALMEIRINA";27;15;3;45
2012;"PANELAS (PE)";"PE";"PANELAS";86;51;17;154
2012;"PARANATAMA (PE)";"PE";"PARANATAMA";72;22;15;109
2012;"PARNAMIRIM (PE)";"PE";"PARNAMIRIM";151;8;14;173
2012;"PASSIRA (PE)";"PE";"PASSIRA";224;76;25;325
2012;"PAUDALHO (PE)";"PE";"PAUDALHO";558;27;55;640
2012;"PAULISTA (PE)";"PE";"PAULISTA";1338;280;299;1917
2012;"PEDRA (PE)";"PE";"PEDRA";124;31;13;168
2012;"PESQUEIRA (PE)";"PE";"PESQUEIRA";643;70;110;823
2012;"PETROLANDIA (PE)";"PE";"PETROLANDIA";244;7;38;289
2012;"PETROLINA (PE)";"PE";"PETROLINA";2984;240;330;3554
2012;"POCAO (PE)";"PE";"POCAO";43;24;9;76
2012;"POMBOS (PE)";"PE";"POMBOS";516;41;40;597
2012;"PRIMAVERA (PE)";"PE";"PRIMAVERA";69;12;35;116
2012;"QUIPAPA (PE)";"PE";"QUIPAPA";87;24;41;152
2012;"QUIXABA (PE)";"PE";"QUIXABA";31;5;4;40
2012;"RECIFE (PE)";"PE";"RECIFE";18820;2395;4107;25322
2012;"RIACHO DAS ALMAS (PE)";"PE";"RIACHO DAS ALMAS";250;72;25;347
2012;"RIBEIRAO (PE)";"PE";"RIBEIRAO";267;40;93;400
2012;"RIO FORMOSO (PE)";"PE";"RIO FORMOSO";111;25;62;198
2012;"SAIRE (PE)";"PE";"SAIRE";97;8;21;126
2012;"SALGADINHO (PE)";"PE";"SALGADINHO";18;28;4;50
2012;"SALGUEIRO (PE)";"PE";"SALGUEIRO";489;38;54;581
2012;"SALOA (PE)";"PE";"SALOA";60;24;5;89
2012;"SANHARO (PE)";"PE";"SANHARO";102;19;25;146
2012;"SANTA CRUZ (PE)";"PE";"SANTA CRUZ";125;4;14;143
2012;"SANTA CRUZ DA BAIXA VERDE (PE)";"PE";"SANTA CRUZ DA BAIXA VERDE";194;8;4;206
2012;"SANTA CRUZ DO CAPIBARIBE (PE)";"PE";"SANTA CRUZ DO CAPIBARIBE";731;380;53;1164
2012;"SANTA FILOMENA (PE)";"PE";"SANTA FILOMENA";77;0;19;96
2012;"SANTA MARIA DA BOA VISTA (PE)";"PE";"SANTA MARIA DA BOA VISTA";193;7;35;235
2012;"SANTA MARIA DO CAMBUCA (PE)";"PE";"SANTA MARIA DO CAMBUCA";164;105;21;290
2012;"SANTA TEREZINHA (PE)";"PE";"SANTA TEREZINHA";62;8;7;77
2012;"SAO BENEDITO DO SUL (PE)";"PE";"SAO BENEDITO DO SUL";33;7;15;55
2012;"SAO BENTO DO UNA (PE)";"PE";"SAO BENTO DO UNA";766;59;79;904
2012;"SAO CAITANO (PE)";"PE";"SAO CAITANO";261;147;34;442
2012;"SAO JOAO (PE)";"PE";"SAO JOAO";92;35;13;140
2012;"SAO JOAQUIM DO MONTE (PE)";"PE";"SAO JOAQUIM DO MONTE";67;22;17;106
2012;"SAO JOSE DA COROA GRANDE (PE)";"PE";"SAO JOSE DA COROA GRANDE";65;12;20;97
2012;"SAO JOSE DO BELMONTE (PE)";"PE";"SAO JOSE DO BELMONTE";271;20;26;317
2012;"SAO JOSE DO EGITO (PE)";"PE";"SAO JOSE DO EGITO";432;40;59;531
2012;"SAO LOURENCO DA MATA (PE)";"PE";"SAO LOURENCO DA MATA";374;57;393;824
2012;"SAO VICENTE FERRER (PE)";"PE";"SAO VICENTE FERRER";152;11;16;179
2012;"SERRA TALHADA (PE)";"PE";"SERRA TALHADA";1463;58;52;1573
2012;"SERRITA (PE)";"PE";"SERRITA";100;6;10;116
2012;"SERTANIA (PE)";"PE";"SERTANIA";358;39;42;439
2012;"SIRINHAEM (PE)";"PE";"SIRINHAEM";194;11;70;275
2012;"SOLIDAO (PE)";"PE";"SOLIDAO";21;3;5;29
2012;"SURUBIM (PE)";"PE";"SURUBIM";685;563;56;1304
2012;"TABIRA (PE)";"PE";"TABIRA";222;25;21;268
2012;"TACAIMBO (PE)";"PE";"TACAIMBO";68;22;16;106
2012;"TACARATU (PE)";"PE";"TACARATU";52;11;7;70
2012;"TAMANDARE (PE)";"PE";"TAMANDARE";64;21;17;102
2012;"TAQUARITINGA DO NORTE (PE)";"PE";"TAQUARITINGA DO NORTE";179;88;20;287
2012;"TEREZINHA (PE)";"PE";"TEREZINHA";18;4;4;26
2012;"TERRA NOVA (PE)";"PE";"TERRA NOVA";83;1;6;90
2012;"TIMBAUBA (PE)";"PE";"TIMBAUBA";703;37;110;850
2012;"TORITAMA (PE)";"PE";"TORITAMA";219;72;26;317
2012;"TRACUNHAEM (PE)";"PE";"TRACUNHAEM";50;20;18;88
2012;"TRINDADE (PE)";"PE";"TRINDADE";347;22;11;380
2012;"TRIUNFO (PE)";"PE";"TRIUNFO";190;15;10;215
2012;"TUPANATINGA (PE)";"PE";"TUPANATINGA";126;31;7;164
2012;"TUPARETAMA (PE)";"PE";"TUPARETAMA";107;22;17;146
2012;"VENTUROSA (PE)";"PE";"VENTUROSA";134;34;11;179
2012;"VERDEJANTE (PE)";"PE";"VERDEJANTE";66;6;17;89
2012;"VERTENTE DO LERIO (PE)";"PE";"VERTENTE DO LERIO";72;77;13;162
2012;"VERTENTES (PE)";"PE";"VERTENTES";156;83;21;260
2012;"VICENCIA (PE)";"PE";"VICENCIA";234;10;65;309
2012;"VITORIA DE SANTO ANTAO (PE)";"PE";"VITORIA DE SANTO ANTAO";2156;119;289;2564
2012;"XEXEU (PE)";"PE";"XEXEU";55;7;38;100
2012;"ACAUA (PI)";"PI";"ACAUA";26;5;5;36
2012;"AGRICOLANDIA (PI)";"PI";"AGRICOLANDIA";14;2;7;23
2012;"AGUA BRANCA (PI)";"PI";"AGUA BRANCA";128;12;8;148
2012;"ALAGOINHA DO PIAUI (PI)";"PI";"ALAGOINHA DO PIAUI";33;1;4;38
2012;"ALEGRETE DO PIAUI (PI)";"PI";"ALEGRETE DO PIAUI";13;1;3;17
2012;"ALTO LONGA (PI)";"PI";"ALTO LONGA";35;3;15;53
2012;"ALTOS (PI)";"PI";"ALTOS";222;5;30;257
2012;"ALVORADA DO GURGUEIA (PI)";"PI";"ALVORADA DO GURGUEIA";12;3;6;21
2012;"AMARANTE (PI)";"PI";"AMARANTE";66;11;13;90
2012;"ANGICAL DO PIAUI (PI)";"PI";"ANGICAL DO PIAUI";12;2;2;16
2012;"ANISIO DE ABREU (PI)";"PI";"ANISIO DE ABREU";28;8;9;45
2012;"ANTONIO ALMEIDA (PI)";"PI";"ANTONIO ALMEIDA";19;2;4;25
2012;"AROAZES (PI)";"PI";"AROAZES";13;3;9;25
2012;"AROEIRAS DO ITAIM (PI)";"PI";"AROEIRAS DO ITAIM";10;1;9;20
2012;"ARRAIAL (PI)";"PI";"ARRAIAL";6;1;3;10
2012;"ASSUNCAO DO PIAUI (PI)";"PI";"ASSUNCAO DO PIAUI";6;0;1;7
2012;"AVELINO LOPES (PI)";"PI";"AVELINO LOPES";14;5;2;21
2012;"BAIXA GRANDE DO RIBEIRO (PI)";"PI";"BAIXA GRANDE DO RIBEIRO";55;4;10;69
2012;"BARRA D ALCANTARA (PI)";"PI";"BARRA D ALCANTARA";15;0;2;17
2012;"BARRAS (PI)";"PI";"BARRAS";116;10;51;177
2012;"BARREIRAS DO PIAUI (PI)";"PI";"BARREIRAS DO PIAUI";5;0;2;7
2012;"BARRO DURO (PI)";"PI";"BARRO DURO";44;4;2;50
2012;"BATALHA (PI)";"PI";"BATALHA";63;1;13;77
2012;"BELA VISTA DO PIAUI (PI)";"PI";"BELA VISTA DO PIAUI";10;1;3;14
2012;"BELEM DO PIAUI (PI)";"PI";"BELEM DO PIAUI";4;0;1;5
2012;"BENEDITINOS (PI)";"PI";"BENEDITINOS";28;1;6;35
2012;"BERTOLINIA (PI)";"PI";"BERTOLINIA";14;6;5;25
2012;"BETANIA DO PIAUI (PI)";"PI";"BETANIA DO PIAUI";16;6;3;25
2012;"BOA HORA (PI)";"PI";"BOA HORA";11;0;5;16
2012;"BOCAINA (PI)";"PI";"BOCAINA";7;5;2;14
2012;"BOM JESUS (PI)";"PI";"BOM JESUS";196;2;13;211
2012;"BOM PRINCIPIO DO PIAUI (PI)";"PI";"BOM PRINCIPIO DO PIAUI";7;4;5;16
2012;"BONFIM DO PIAUI (PI)";"PI";"BONFIM DO PIAUI";18;4;5;27
2012;"BOQUEIRAO DO PIAUI (PI)";"PI";"BOQUEIRAO DO PIAUI";10;0;4;14
2012;"BRASILEIRA (PI)";"PI";"BRASILEIRA";13;2;5;20
2012;"BREJO DO PIAUI (PI)";"PI";"BREJO DO PIAUI";5;4;1;10
2012;"BURITI DOS LOPES (PI)";"PI";"BURITI DOS LOPES";26;7;14;47
2012;"BURITI DOS MONTES (PI)";"PI";"BURITI DOS MONTES";15;4;4;23
2012;"CABECEIRAS DO PIAUI (PI)";"PI";"CABECEIRAS DO PIAUI";10;2;13;25
2012;"CAJAZEIRAS DO PIAUI (PI)";"PI";"CAJAZEIRAS DO PIAUI";3;0;2;5
2012;"CAJUEIRO DA PRAIA (PI)";"PI";"CAJUEIRO DA PRAIA";8;1;7;16
2012;"CALDEIRAO GRANDE DO PIAUI (PI)";"PI";"CALDEIRAO GRANDE DO PIAUI";8;4;5;17
2012;"CAMPINAS DO PIAUI (PI)";"PI";"CAMPINAS DO PIAUI";3;0;3;6
2012;"CAMPO ALEGRE DO FIDALGO (PI)";"PI";"CAMPO ALEGRE DO FIDALGO";5;4;2;11
2012;"CAMPO GRANDE DO PIAUI (PI)";"PI";"CAMPO GRANDE DO PIAUI";30;7;2;39
2012;"CAMPO LARGO DO PIAUI (PI)";"PI";"CAMPO LARGO DO PIAUI";5;2;1;8
2012;"CAMPO MAIOR (PI)";"PI";"CAMPO MAIOR";389;26;67;482
2012;"CANAVIEIRA (PI)";"PI";"CANAVIEIRA";0;0;1;1
2012;"CANTO DO BURITI (PI)";"PI";"CANTO DO BURITI";90;15;9;114
2012;"CAPITAO DE CAMPOS (PI)";"PI";"CAPITAO DE CAMPOS";21;3;7;31
2012;"CAPITAO GERVASIO OLIVEIRA (PI)";"PI";"CAPITAO GERVASIO OLIVEIRA";3;0;3;6
2012;"CARACOL (PI)";"PI";"CARACOL";34;3;1;38
2012;"CARAUBAS DO PIAUI (PI)";"PI";"CARAUBAS DO PIAUI";11;2;3;16
2012;"CARIDADE DO PIAUI (PI)";"PI";"CARIDADE DO PIAUI";4;2;3;9
2012;"CASTELO DO PIAUI (PI)";"PI";"CASTELO DO PIAUI";63;7;11;81
2012;"CAXINGO (PI)";"PI";"CAXINGO";8;1;5;14
2012;"COCAL (PI)";"PI";"COCAL";49;7;10;66
2012;"COCAL DE TELHA (PI)";"PI";"COCAL DE TELHA";10;1;2;13
2012;"COCAL DOS ALVES (PI)";"PI";"COCAL DOS ALVES";2;5;1;8
2012;"COIVARAS (PI)";"PI";"COIVARAS";7;1;5;13
2012;"COLONIA DO GURGUEIA (PI)";"PI";"COLONIA DO GURGUEIA";4;6;1;11
2012;"COLONIA DO PIAUI (PI)";"PI";"COLONIA DO PIAUI";9;4;4;17
2012;"CONCEICAO DO CANINDE (PI)";"PI";"CONCEICAO DO CANINDE";10;2;2;14
2012;"CORONEL JOSE DIAS (PI)";"PI";"CORONEL JOSE DIAS";3;2;2;7
2012;"CORRENTE (PI)";"PI";"CORRENTE";83;6;5;94
2012;"CRISTALANDIA DO PIAUI (PI)";"PI";"CRISTALANDIA DO PIAUI";5;1;2;8
2012;"CRISTINO CASTRO (PI)";"PI";"CRISTINO CASTRO";35;3;8;46
2012;"CURIMATA (PI)";"PI";"CURIMATA";16;1;2;19
2012;"CURRAIS (PI)";"PI";"CURRAIS";0;1;1;2
2012;"CURRAL NOVO DO PIAUI (PI)";"PI";"CURRAL NOVO DO PIAUI";0;4;3;7
2012;"CURRALINHOS (PI)";"PI";"CURRALINHOS";4;0;2;6
2012;"DEMERVAL LOBAO (PI)";"PI";"DEMERVAL LOBAO";57;3;4;64
2012;"DIRCEU ARCOVERDE (PI)";"PI";"DIRCEU ARCOVERDE";7;5;2;14
2012;"DOM EXPEDITO LOPES (PI)";"PI";"DOM EXPEDITO LOPES";62;9;4;75
2012;"DOM INOCENCIO (PI)";"PI";"DOM INOCENCIO";16;5;2;23
2012;"DOMINGOS MOURAO (PI)";"PI";"DOMINGOS MOURAO";1;0;2;3
2012;"ELESBAO VELOSO (PI)";"PI";"ELESBAO VELOSO";64;1;8;73
2012;"ELISEU MARTINS (PI)";"PI";"ELISEU MARTINS";7;1;2;10
2012;"ESPERANTINA (PI)";"PI";"ESPERANTINA";177;15;35;227
2012;"FARTURA DO PIAUI (PI)";"PI";"FARTURA DO PIAUI";3;1;2;6
2012;"FLORES DO PIAUI (PI)";"PI";"FLORES DO PIAUI";6;3;2;11
2012;"FLORESTA DO PIAUI (PI)";"PI";"FLORESTA DO PIAUI";4;6;2;12
2012;"FLORIANO (PI)";"PI";"FLORIANO";1037;73;57;1167
2012;"FRANCINOPOLIS (PI)";"PI";"FRANCINOPOLIS";12;7;1;20
2012;"FRANCISCO AYRES (PI)";"PI";"FRANCISCO AYRES";8;10;5;23
2012;"FRANCISCO MACEDO (PI)";"PI";"FRANCISCO MACEDO";13;2;6;21
2012;"FRANCISCO SANTOS (PI)";"PI";"FRANCISCO SANTOS";63;8;9;80
2012;"FRONTEIRAS (PI)";"PI";"FRONTEIRAS";63;9;5;77
2012;"GEMINIANO (PI)";"PI";"GEMINIANO";23;8;9;40
2012;"GILBUES (PI)";"PI";"GILBUES";7;3;7;17
2012;"GUADALUPE (PI)";"PI";"GUADALUPE";77;12;7;96
2012;"GUARIBAS (PI)";"PI";"GUARIBAS";2;0;1;3
2012;"HUGO NAPOLEAO (PI)";"PI";"HUGO NAPOLEAO";5;1;2;8
2012;"ILHA GRANDE (PI)";"PI";"ILHA GRANDE";13;4;2;19
2012;"INHUMA (PI)";"PI";"INHUMA";75;8;12;95
2012;"IPIRANGA DO PIAUI (PI)";"PI";"IPIRANGA DO PIAUI";45;12;7;64
2012;"ISAIAS COELHO (PI)";"PI";"ISAIAS COELHO";10;0;6;16
2012;"ITAINOPOLIS (PI)";"PI";"ITAINOPOLIS";33;18;9;60
2012;"ITAUEIRA (PI)";"PI";"ITAUEIRA";42;9;2;53
2012;"JACOBINA DO PIAUI (PI)";"PI";"JACOBINA DO PIAUI";33;2;1;36
2012;"JAICOS (PI)";"PI";"JAICOS";97;7;6;110
2012;"JARDIM DO MULATO (PI)";"PI";"JARDIM DO MULATO";5;1;2;8
2012;"JATOBA DO PIAUI (PI)";"PI";"JATOBA DO PIAUI";29;0;8;37
2012;"JERUMENHA (PI)";"PI";"JERUMENHA";9;1;1;11
2012;"JOAO COSTA (PI)";"PI";"JOAO COSTA";3;0;1;4
2012;"JOAQUIM PIRES (PI)";"PI";"JOAQUIM PIRES";24;2;7;33
2012;"JOCA MARQUES (PI)";"PI";"JOCA MARQUES";4;0;3;7
2012;"JOSE DE FREITAS (PI)";"PI";"JOSE DE FREITAS";89;9;26;124
2012;"JUAZEIRO DO PIAUI (PI)";"PI";"JUAZEIRO DO PIAUI";12;1;2;15
2012;"JULIO BORGES (PI)";"PI";"JULIO BORGES";2;1;2;5
2012;"JUREMA (PI)";"PI";"JUREMA";5;3;4;12
2012;"LAGOA ALEGRE (PI)";"PI";"LAGOA ALEGRE";10;2;8;20
2012;"LAGOA DE SAO FRANCISCO (PI)";"PI";"LAGOA DE SAO FRANCISCO";8;1;1;10
2012;"LAGOA DO BARRO DO PIAUI (PI)";"PI";"LAGOA DO BARRO DO PIAUI";3;2;6;11
2012;"LAGOA DO PIAUI (PI)";"PI";"LAGOA DO PIAUI";9;0;0;9
2012;"LAGOA DO SITIO (PI)";"PI";"LAGOA DO SITIO";10;1;2;13
2012;"LAGOINHA DO PIAUI (PI)";"PI";"LAGOINHA DO PIAUI";6;2;4;12
2012;"LANDRI SALES (PI)";"PI";"LANDRI SALES";8;4;1;13
2012;"LUIS CORREIA (PI)";"PI";"LUIS CORREIA";37;10;27;74
2012;"LUZILANDIA (PI)";"PI";"LUZILANDIA";38;2;17;57
2012;"MADEIRO (PI)";"PI";"MADEIRO";6;3;2;11
2012;"MANOEL EMIDIO (PI)";"PI";"MANOEL EMIDIO";10;3;3;16
2012;"MARCOLANDIA (PI)";"PI";"MARCOLANDIA";95;21;4;120
2012;"MARCOS PARENTE (PI)";"PI";"MARCOS PARENTE";6;7;0;13
2012;"MASSAPE DO PIAUI (PI)";"PI";"MASSAPE DO PIAUI";7;1;2;10
2012;"MATIAS OLIMPIO (PI)";"PI";"MATIAS OLIMPIO";18;6;6;30
2012;"MIGUEL ALVES (PI)";"PI";"MIGUEL ALVES";36;3;15;54
2012;"MIGUEL LEAO (PI)";"PI";"MIGUEL LEAO";2;0;1;3
2012;"MILTON BRANDAO (PI)";"PI";"MILTON BRANDAO";6;1;2;9
2012;"MONSENHOR GIL (PI)";"PI";"MONSENHOR GIL";22;4;6;32
2012;"MONSENHOR HIPOLITO (PI)";"PI";"MONSENHOR HIPOLITO";18;9;3;30
2012;"MONTE ALEGRE DO PIAUI (PI)";"PI";"MONTE ALEGRE DO PIAUI";9;0;3;12
2012;"MORRO CABECA NO TEMPO (PI)";"PI";"MORRO CABECA NO TEMPO";1;0;2;3
2012;"MORRO DO CHAPEU DO PIAUI (PI)";"PI";"MORRO DO CHAPEU DO PIAUI";6;1;5;12
2012;"MURICI DOS PORTELAS (PI)";"PI";"MURICI DOS PORTELAS";6;0;3;9
2012;"NAZARE DO PIAUI (PI)";"PI";"NAZARE DO PIAUI";17;17;2;36
2012;"NAZARIA (PI)";"PI";"NAZARIA";6;0;4;10
2012;"NOSSA SENHORA DE NAZARE (PI)";"PI";"NOSSA SENHORA DE NAZARE";11;0;4;15
2012;"NOSSA SENHORA DOS REMEDIOS (PI)";"PI";"NOSSA SENHORA DOS REMEDIOS";6;5;5;16
2012;"NOVA SANTA RITA (PI)";"PI";"NOVA SANTA RITA";1;3;2;6
2012;"NOVO ORIENTE DO PIAUI (PI)";"PI";"NOVO ORIENTE DO PIAUI";17;3;9;29
2012;"NOVO SANTO ANTONIO (PI)";"PI";"NOVO SANTO ANTONIO";9;2;4;15
2012;"OEIRAS (PI)";"PI";"OEIRAS";311;40;41;392
2012;"OLHO D AGUA DO PIAUI (PI)";"PI";"OLHO D AGUA DO PIAUI";4;1;2;7
2012;"PADRE MARCOS (PI)";"PI";"PADRE MARCOS";12;7;3;22
2012;"PAES LANDIM (PI)";"PI";"PAES LANDIM";4;2;1;7
2012;"PAJEU DO PIAUI (PI)";"PI";"PAJEU DO PIAUI";10;2;4;16
2012;"PALMEIRA DO PIAUI (PI)";"PI";"PALMEIRA DO PIAUI";27;3;1;31
2012;"PALMEIRAIS (PI)";"PI";"PALMEIRAIS";11;3;8;22
2012;"PAQUETA (PI)";"PI";"PAQUETA";8;8;4;20
2012;"PARNAGUA (PI)";"PI";"PARNAGUA";8;1;1;10
2012;"PARNAIBA (PI)";"PI";"PARNAIBA";978;108;233;1319
2012;"PASSAGEM FRANCA DO PIAUI (PI)";"PI";"PASSAGEM FRANCA DO PIAUI";3;1;3;7
2012;"PATOS DO PIAUI (PI)";"PI";"PATOS DO PIAUI";17;3;6;26
2012;"PAU D ARCO DO PIAUI (PI)";"PI";"PAU D ARCO DO PIAUI";4;0;5;9
2012;"PAULISTANA (PI)";"PI";"PAULISTANA";148;9;19;176
2012;"PAVUSSU (PI)";"PI";"PAVUSSU";4;2;0;6
2012;"PEDRO II (PI)";"PI";"PEDRO II";98;14;10;122
2012;"PEDRO LAURENTINO (PI)";"PI";"PEDRO LAURENTINO";5;0;1;6
2012;"PICOS (PI)";"PI";"PICOS";1552;125;88;1765
2012;"PIMENTEIRAS (PI)";"PI";"PIMENTEIRAS";35;8;2;45
2012;"PIO IX (PI)";"PI";"PIO IX";45;9;9;63
2012;"PIRACURUCA (PI)";"PI";"PIRACURUCA";198;12;37;247
2012;"PIRIPIRI (PI)";"PI";"PIRIPIRI";331;41;120;492
2012;"PORTO (PI)";"PI";"PORTO";5;4;1;10
2012;"PORTO ALEGRE DO PIAUI (PI)";"PI";"PORTO ALEGRE DO PIAUI";5;3;2;10
2012;"PRATA DO PIAUI (PI)";"PI";"PRATA DO PIAUI";8;1;2;11
2012;"QUEIMADA NOVA (PI)";"PI";"QUEIMADA NOVA";8;3;5;16
2012;"REDENCAO DO GURGUEIA (PI)";"PI";"REDENCAO DO GURGUEIA";12;0;12;24
2012;"REGENERACAO (PI)";"PI";"REGENERACAO";77;9;10;96
2012;"RIACHO FRIO (PI)";"PI";"RIACHO FRIO";2;1;2;5
2012;"RIBEIRA DO PIAUI (PI)";"PI";"RIBEIRA DO PIAUI";5;2;2;9
2012;"RIBEIRO GONCALVES (PI)";"PI";"RIBEIRO GONCALVES";18;0;2;20
2012;"RIO GRANDE DO PIAUI (PI)";"PI";"RIO GRANDE DO PIAUI";21;7;3;31
2012;"SANTA CRUZ DO PIAUI (PI)";"PI";"SANTA CRUZ DO PIAUI";15;14;2;31
2012;"SANTA CRUZ DOS MILAGRES (PI)";"PI";"SANTA CRUZ DOS MILAGRES";3;1;3;7
2012;"SANTA FILOMENA (PI)";"PI";"SANTA FILOMENA";11;1;2;14
2012;"SANTA LUZ (PI)";"PI";"SANTA LUZ";7;1;2;10
2012;"SANTA ROSA DO PIAUI (PI)";"PI";"SANTA ROSA DO PIAUI";7;7;9;23
2012;"SANTANA DO PIAUI (PI)";"PI";"SANTANA DO PIAUI";18;11;10;39
2012;"SANTO ANTONIO DE LISBOA (PI)";"PI";"SANTO ANTONIO DE LISBOA";40;11;4;55
2012;"SANTO ANTONIO DOS MILAGRES (PI)";"PI";"SANTO ANTONIO DOS MILAGRES";3;3;2;8
2012;"SANTO INACIO DO PIAUI (PI)";"PI";"SANTO INACIO DO PIAUI";4;3;1;8
2012;"SAO BRAZ DO PIAUI (PI)";"PI";"SAO BRAZ DO PIAUI";7;1;3;11
2012;"SAO FELIX DO PIAUI (PI)";"PI";"SAO FELIX DO PIAUI";4;2;1;7
2012;"SAO FRANCISCO DE ASSIS DO PIAU (PI)";"PI";"SAO FRANCISCO DE ASSIS DO PIAU";1;0;1;2
2012;"SAO FRANCISCO DO PIAUI (PI)";"PI";"SAO FRANCISCO DO PIAUI";6;3;7;16
2012;"SAO GONCALO DO GURGUEIA (PI)";"PI";"SAO GONCALO DO GURGUEIA";1;1;1;3
2012;"SAO GONCALO DO PIAUI (PI)";"PI";"SAO GONCALO DO PIAUI";10;3;5;18
2012;"SAO JOAO DA CANABRAVA (PI)";"PI";"SAO JOAO DA CANABRAVA";14;8;5;27
2012;"SAO JOAO DA FRONTEIRA (PI)";"PI";"SAO JOAO DA FRONTEIRA";3;1;5;9
2012;"SAO JOAO DA SERRA (PI)";"PI";"SAO JOAO DA SERRA";8;0;1;9
2012;"SAO JOAO DA VARJOTA (PI)";"PI";"SAO JOAO DA VARJOTA";1;6;2;9
2012;"SAO JOAO DO ARRAIAL (PI)";"PI";"SAO JOAO DO ARRAIAL";7;2;3;12
2012;"SAO JOAO DO PIAUI (PI)";"PI";"SAO JOAO DO PIAUI";92;13;12;117
2012;"SAO JOSE DO DIVINO (PI)";"PI";"SAO JOSE DO DIVINO";10;3;2;15
2012;"SAO JOSE DO PEIXE (PI)";"PI";"SAO JOSE DO PEIXE";2;2;2;6
2012;"SAO JOSE DO PIAUI (PI)";"PI";"SAO JOSE DO PIAUI";29;7;4;40
2012;"SAO JULIAO (PI)";"PI";"SAO JULIAO";18;9;3;30
2012;"SAO LOURENCO DO PIAUI (PI)";"PI";"SAO LOURENCO DO PIAUI";1;1;3;5
2012;"SAO LUIS DO PIAUI (PI)";"PI";"SAO LUIS DO PIAUI";10;4;1;15
2012;"SAO MIGUEL DA BAIXA GRANDE (PI)";"PI";"SAO MIGUEL DA BAIXA GRANDE";8;2;2;12
2012;"SAO MIGUEL DO FIDALGO (PI)";"PI";"SAO MIGUEL DO FIDALGO";1;1;2;4
2012;"SAO MIGUEL DO TAPUIO (PI)";"PI";"SAO MIGUEL DO TAPUIO";24;3;14;41
2012;"SAO PEDRO DO PIAUI (PI)";"PI";"SAO PEDRO DO PIAUI";35;1;6;42
2012;"SAO RAIMUNDO NONATO (PI)";"PI";"SAO RAIMUNDO NONATO";221;22;33;276
2012;"SEBASTIAO BARROS (PI)";"PI";"SEBASTIAO BARROS";2;2;1;5
2012;"SEBASTIAO LEAL (PI)";"PI";"SEBASTIAO LEAL";20;1;2;23
2012;"SIGEFREDO PACHECO (PI)";"PI";"SIGEFREDO PACHECO";27;6;2;35
2012;"SIMOES (PI)";"PI";"SIMOES";48;6;5;59
2012;"SIMPLICIO MENDES (PI)";"PI";"SIMPLICIO MENDES";51;7;7;65
2012;"SOCORRO DO PIAUI (PI)";"PI";"SOCORRO DO PIAUI";2;1;1;4
2012;"SUSSUAPARA (PI)";"PI";"SUSSUAPARA";29;16;5;50
2012;"TAMBORIL DO PIAUI (PI)";"PI";"TAMBORIL DO PIAUI";2;1;1;4
2012;"TANQUE DO PIAUI (PI)";"PI";"TANQUE DO PIAUI";8;2;4;14
2012;"TERESINA (PI)";"PI";"TERESINA";10095;953;2574;13622
2012;"UNIAO (PI)";"PI";"UNIAO";107;30;38;175
2012;"URUCUI (PI)";"PI";"URUCUI";137;10;12;159
2012;"VALENCA DO PIAUI (PI)";"PI";"VALENCA DO PIAUI";122;24;23;169
2012;"VARZEA BRANCA (PI)";"PI";"VARZEA BRANCA";9;2;6;17
2012;"VARZEA GRANDE (PI)";"PI";"VARZEA GRANDE";9;4;3;16
2012;"VERA MENDES (PI)";"PI";"VERA MENDES";7;5;0;12
2012;"VILA NOVA DO PIAUI (PI)";"PI";"VILA NOVA DO PIAUI";12;6;4;22
2012;"WALL FERRAZ (PI)";"PI";"WALL FERRAZ";9;10;5;24
2012;"ABATIA (PR)";"PR";"ABATIA";118;3;38;159
2012;"ADRIANOPOLIS (PR)";"PR";"ADRIANOPOLIS";125;8;17;150
2012;"AGUDOS DO SUL (PR)";"PR";"AGUDOS DO SUL";347;10;21;378
2012;"ALMIRANTE TAMANDARE (PR)";"PR";"ALMIRANTE TAMANDARE";1397;88;238;1723
2012;"ALTAMIRA DO PARANA (PR)";"PR";"ALTAMIRA DO PARANA";49;3;9;61
2012;"ALTO PARAISO (PR)";"PR";"ALTO PARAISO";43;8;10;61
2012;"ALTO PARANA (PR)";"PR";"ALTO PARANA";265;11;80;356
2012;"ALTO PIQUIRI (PR)";"PR";"ALTO PIQUIRI";189;7;38;234
2012;"ALTONIA (PR)";"PR";"ALTONIA";413;20;41;474
2012;"ALVORADA DO SUL (PR)";"PR";"ALVORADA DO SUL";287;7;47;341
2012;"AMAPORA (PR)";"PR";"AMAPORA";75;3;50;128
2012;"AMPERE (PR)";"PR";"AMPERE";445;13;37;495
2012;"ANAHY (PR)";"PR";"ANAHY";81;3;5;89
2012;"ANDIRA (PR)";"PR";"ANDIRA";530;17;82;629
2012;"ANGULO (PR)";"PR";"ANGULO";71;3;6;80
2012;"ANTONINA (PR)";"PR";"ANTONINA";96;15;31;142
2012;"ANTONIO OLINTO (PR)";"PR";"ANTONIO OLINTO";141;6;34;181
2012;"APUCARANA (PR)";"PR";"APUCARANA";2379;316;277;2972
2012;"ARAPONGAS (PR)";"PR";"ARAPONGAS";3269;219;106;3594
2012;"ARAPOTI (PR)";"PR";"ARAPOTI";527;36;60;623
2012;"ARAPUA (PR)";"PR";"ARAPUA";88;4;23;115
2012;"ARARUNA (PR)";"PR";"ARARUNA";375;16;28;419
2012;"ARAUCARIA (PR)";"PR";"ARAUCARIA";2885;342;706;3933
2012;"ARIRANHA DO IVAI (PR)";"PR";"ARIRANHA DO IVAI";53;2;13;68
2012;"ASSAI (PR)";"PR";"ASSAI";473;24;47;544
2012;"ASSIS CHATEAUBRIAND (PR)";"PR";"ASSIS CHATEAUBRIAND";1130;36;65;1231
2012;"ASTORGA (PR)";"PR";"ASTORGA";652;40;88;780
2012;"ATALAIA (PR)";"PR";"ATALAIA";108;11;25;144
2012;"BALSA NOVA (PR)";"PR";"BALSA NOVA";355;12;52;419
2012;"BANDEIRANTES (PR)";"PR";"BANDEIRANTES";792;48;100;940
2012;"BARBOSA FERRAZ (PR)";"PR";"BARBOSA FERRAZ";184;6;26;216
2012;"BARRA DO JACARE (PR)";"PR";"BARRA DO JACARE";48;6;8;62
2012;"BARRACAO (PR)";"PR";"BARRACAO";214;20;46;280
2012;"BELA VISTA DO CAROBA (PR)";"PR";"BELA VISTA DO CAROBA";55;2;15;72
2012;"BELA VISTA DO PARAISO (PR)";"PR";"BELA VISTA DO PARAISO";402;24;52;478
2012;"BITURUNA (PR)";"PR";"BITURUNA";415;21;116;552
2012;"BOA ESPERANCA (PR)";"PR";"BOA ESPERANCA";181;5;12;198
2012;"BOA ESPERANCA DO IGUACU (PR)";"PR";"BOA ESPERANCA DO IGUACU";61;2;11;74
2012;"BOA VENTURA DE SAO ROQUE (PR)";"PR";"BOA VENTURA DE SAO ROQUE";172;10;30;212
2012;"BOA VISTA DA APARECIDA (PR)";"PR";"BOA VISTA DA APARECIDA";153;10;18;181
2012;"BOCAIUVA DO SUL (PR)";"PR";"BOCAIUVA DO SUL";284;11;22;317
2012;"BOM JESUS DO SUL (PR)";"PR";"BOM JESUS DO SUL";47;4;10;61
2012;"BOM SUCESSO (PR)";"PR";"BOM SUCESSO";107;4;53;164
2012;"BOM SUCESSO DO SUL (PR)";"PR";"BOM SUCESSO DO SUL";105;8;6;119
2012;"BORRAZOPOLIS (PR)";"PR";"BORRAZOPOLIS";258;8;7;273
2012;"BRAGANEY (PR)";"PR";"BRAGANEY";165;6;22;193
2012;"BRASILANDIA DO SUL (PR)";"PR";"BRASILANDIA DO SUL";71;5;6;82
2012;"CAFEARA (PR)";"PR";"CAFEARA";35;5;16;56
2012;"CAFELANDIA (PR)";"PR";"CAFELANDIA";542;19;47;608
2012;"CAFEZAL DO SUL (PR)";"PR";"CAFEZAL DO SUL";83;1;25;109
2012;"CALIFORNIA (PR)";"PR";"CALIFORNIA";251;13;17;281
2012;"CAMBARA (PR)";"PR";"CAMBARA";798;31;88;917
2012;"CAMBE (PR)";"PR";"CAMBE";1848;245;142;2235
2012;"CAMBIRA (PR)";"PR";"CAMBIRA";246;4;22;272
2012;"CAMPINA DA LAGOA (PR)";"PR";"CAMPINA DA LAGOA";389;22;36;447
2012;"CAMPINA DO SIMAO (PR)";"PR";"CAMPINA DO SIMAO";78;3;20;101
2012;"CAMPINA GRANDE DO SUL (PR)";"PR";"CAMPINA GRANDE DO SUL";841;90;72;1003
2012;"CAMPO BONITO (PR)";"PR";"CAMPO BONITO";99;10;10;119
2012;"CAMPO DO TENENTE (PR)";"PR";"CAMPO DO TENENTE";158;9;38;205
2012;"CAMPO LARGO (PR)";"PR";"CAMPO LARGO";2279;290;482;3051
2012;"CAMPO MAGRO (PR)";"PR";"CAMPO MAGRO";443;67;20;530
2012;"CAMPO MOURAO (PR)";"PR";"CAMPO MOURAO";2137;106;559;2802
2012;"CANDIDO DE ABREU (PR)";"PR";"CANDIDO DE ABREU";218;10;46;274
2012;"CANDOI (PR)";"PR";"CANDOI";377;11;106;494
2012;"CANTAGALO (PR)";"PR";"CANTAGALO";257;7;42;306
2012;"CAPANEMA (PR)";"PR";"CAPANEMA";430;12;56;498
2012;"CAPITAO LEONIDAS MARQUES (PR)";"PR";"CAPITAO LEONIDAS MARQUES";554;15;35;604
2012;"CARAMBEI (PR)";"PR";"CARAMBEI";622;35;57;714
2012;"CARLOPOLIS (PR)";"PR";"CARLOPOLIS";276;21;52;349
2012;"CASCAVEL (PR)";"PR";"CASCAVEL";7628;359;899;8886
2012;"CASTRO (PR)";"PR";"CASTRO";1739;199;245;2183
2012;"CATANDUVAS (PR)";"PR";"CATANDUVAS";200;12;35;247
2012;"CENTENARIO DO SUL (PR)";"PR";"CENTENARIO DO SUL";125;30;62;217
2012;"CERRO AZUL (PR)";"PR";"CERRO AZUL";419;15;52;486
2012;"CEU AZUL (PR)";"PR";"CEU AZUL";323;14;46;383
2012;"CHOPINZINHO (PR)";"PR";"CHOPINZINHO";554;20;68;642
2012;"CIANORTE (PR)";"PR";"CIANORTE";1604;95;205;1904
2012;"CIDADE GAUCHA (PR)";"PR";"CIDADE GAUCHA";276;16;77;369
2012;"CLEVELANDIA (PR)";"PR";"CLEVELANDIA";533;35;41;609
2012;"COLOMBO (PR)";"PR";"COLOMBO";4310;305;501;5116
2012;"COLORADO (PR)";"PR";"COLORADO";549;40;113;702
2012;"CONGONHINHAS (PR)";"PR";"CONGONHINHAS";117;4;30;151
2012;"CONSELHEIRO MAIRINCK (PR)";"PR";"CONSELHEIRO MAIRINCK";43;3;8;54
2012;"CONTENDA (PR)";"PR";"CONTENDA";693;18;44;755
2012;"CORBELIA (PR)";"PR";"CORBELIA";738;21;43;802
2012;"CORNELIO PROCOPIO (PR)";"PR";"CORNELIO PROCOPIO";1041;109;121;1271
2012;"CORONEL DOMINGOS SOARES (PR)";"PR";"CORONEL DOMINGOS SOARES";130;8;26;164
2012;"CORONEL VIVIDA (PR)";"PR";"CORONEL VIVIDA";682;18;106;806
2012;"CORUMBATAI DO SUL (PR)";"PR";"CORUMBATAI DO SUL";58;2;21;81
2012;"CRUZ MACHADO (PR)";"PR";"CRUZ MACHADO";514;15;70;599
2012;"CRUZEIRO DO IGUACU (PR)";"PR";"CRUZEIRO DO IGUACU";71;2;12;85
2012;"CRUZEIRO DO OESTE (PR)";"PR";"CRUZEIRO DO OESTE";471;18;64;553
2012;"CRUZEIRO DO SUL (PR)";"PR";"CRUZEIRO DO SUL";69;8;18;95
2012;"CRUZMALTINA (PR)";"PR";"CRUZMALTINA";83;3;7;93
2012;"CURITIBA (PR)";"PR";"CURITIBA";39765;3866;7719;51350
2012;"CURIUVA (PR)";"PR";"CURIUVA";243;20;80;343
2012;"DIAMANTE D OESTE (PR)";"PR";"DIAMANTE D OESTE";76;6;18;100
2012;"DIAMANTE DO NORTE (PR)";"PR";"DIAMANTE DO NORTE";63;5;25;93
2012;"DIAMANTE DO SUL (PR)";"PR";"DIAMANTE DO SUL";41;1;9;51
2012;"DOIS VIZINHOS (PR)";"PR";"DOIS VIZINHOS";1034;56;92;1182
2012;"DOURADINA (PR)";"PR";"DOURADINA";394;9;13;416
2012;"DOUTOR CAMARGO (PR)";"PR";"DOUTOR CAMARGO";178;3;51;232
2012;"DOUTOR ULYSSES (PR)";"PR";"DOUTOR ULYSSES";50;3;21;74
2012;"ENEAS MARQUES (PR)";"PR";"ENEAS MARQUES";159;8;22;189
2012;"ENGENHEIRO BELTRAO (PR)";"PR";"ENGENHEIRO BELTRAO";475;13;84;572
2012;"ENTRE RIOS DO OESTE (PR)";"PR";"ENTRE RIOS DO OESTE";123;4;7;134
2012;"ESPERANCA NOVA (PR)";"PR";"ESPERANCA NOVA";23;3;3;29
2012;"ESPIGAO ALTO DO IGUACU (PR)";"PR";"ESPIGAO ALTO DO IGUACU";67;6;9;82
2012;"FAROL (PR)";"PR";"FAROL";88;0;10;98
2012;"FAXINAL (PR)";"PR";"FAXINAL";397;17;39;453
2012;"FAZENDA RIO GRANDE (PR)";"PR";"FAZENDA RIO GRANDE";1106;73;234;1413
2012;"FENIX (PR)";"PR";"FENIX";102;4;11;117
2012;"FERNANDES PINHEIRO (PR)";"PR";"FERNANDES PINHEIRO";100;3;23;126
2012;"FIGUEIRA (PR)";"PR";"FIGUEIRA";139;9;28;176
2012;"FLOR DA SERRA DO SUL (PR)";"PR";"FLOR DA SERRA DO SUL";101;3;21;125
2012;"FLORAI (PR)";"PR";"FLORAI";141;6;24;171
2012;"FLORESTA (PR)";"PR";"FLORESTA";250;17;25;292
2012;"FLORESTOPOLIS (PR)";"PR";"FLORESTOPOLIS";186;14;99;299
2012;"FLORIDA (PR)";"PR";"FLORIDA";66;9;20;95
2012;"FORMOSA DO OESTE (PR)";"PR";"FORMOSA DO OESTE";208;16;17;241
2012;"FOZ DO IGUACU (PR)";"PR";"FOZ DO IGUACU";3309;1062;1016;5387
2012;"FOZ DO JORDAO (PR)";"PR";"FOZ DO JORDAO";72;4;13;89
2012;"FRANCISCO ALVES (PR)";"PR";"FRANCISCO ALVES";165;2;24;191
2012;"FRANCISCO BELTRAO (PR)";"PR";"FRANCISCO BELTRAO";2013;136;205;2354
2012;"GENERAL CARNEIRO (PR)";"PR";"GENERAL CARNEIRO";394;15;62;471
2012;"GODOY MOREIRA (PR)";"PR";"GODOY MOREIRA";52;4;11;67
2012;"GOIOERE (PR)";"PR";"GOIOERE";672;39;52;763
2012;"GOIOXIM (PR)";"PR";"GOIOXIM";102;14;28;144
2012;"GRANDES RIOS (PR)";"PR";"GRANDES RIOS";101;10;9;120
2012;"GUAIRA (PR)";"PR";"GUAIRA";1096;40;93;1229
2012;"GUAIRACA (PR)";"PR";"GUAIRACA";131;5;33;169
2012;"GUAMIRANGA (PR)";"PR";"GUAMIRANGA";156;10;26;192
2012;"GUAPIRAMA (PR)";"PR";"GUAPIRAMA";112;3;19;134
2012;"GUAPOREMA (PR)";"PR";"GUAPOREMA";54;2;8;64
2012;"GUARACI (PR)";"PR";"GUARACI";101;3;30;134
2012;"GUARANIACU (PR)";"PR";"GUARANIACU";411;32;53;496
2012;"GUARAPUAVA (PR)";"PR";"GUARAPUAVA";4389;430;430;5249
2012;"GUARAQUECABA (PR)";"PR";"GUARAQUECABA";28;2;9;39
2012;"GUARATUBA (PR)";"PR";"GUARATUBA";339;28;52;419
2012;"HONORIO SERPA (PR)";"PR";"HONORIO SERPA";109;4;32;145
2012;"IBAITI (PR)";"PR";"IBAITI";545;31;155;731
2012;"IBEMA (PR)";"PR";"IBEMA";151;6;14;171
2012;"IBIPORA (PR)";"PR";"IBIPORA";1028;48;141;1217
2012;"ICARAIMA (PR)";"PR";"ICARAIMA";128;6;29;163
2012;"IGUARACU (PR)";"PR";"IGUARACU";82;6;6;94
2012;"IGUATU (PR)";"PR";"IGUATU";38;1;6;45
2012;"IMBAU (PR)";"PR";"IMBAU";205;19;27;251
2012;"IMBITUVA (PR)";"PR";"IMBITUVA";712;32;50;794
2012;"INACIO MARTINS (PR)";"PR";"INACIO MARTINS";260;31;33;324
2012;"INAJA (PR)";"PR";"INAJA";34;3;19;56
2012;"INDIANOPOLIS (PR)";"PR";"INDIANOPOLIS";187;2;9;198
2012;"IPIRANGA (PR)";"PR";"IPIRANGA";315;28;45;388
2012;"IPORA (PR)";"PR";"IPORA";360;12;37;409
2012;"IRACEMA DO OESTE (PR)";"PR";"IRACEMA DO OESTE";73;4;5;82
2012;"IRATI (PR)";"PR";"IRATI";1502;92;133;1727
2012;"IRETAMA (PR)";"PR";"IRETAMA";182;3;35;220
2012;"ITAGUAJE (PR)";"PR";"ITAGUAJE";67;9;34;110
2012;"ITAIPULANDIA (PR)";"PR";"ITAIPULANDIA";211;21;30;262
2012;"ITAMBARACA (PR)";"PR";"ITAMBARACA";142;8;23;173
2012;"ITAMBE (PR)";"PR";"ITAMBE";179;5;26;210
2012;"ITAPEJARA D OESTE (PR)";"PR";"ITAPEJARA D OESTE";302;8;29;339
2012;"ITAPERUCU (PR)";"PR";"ITAPERUCU";615;59;60;734
2012;"ITAUNA DO SUL (PR)";"PR";"ITAUNA DO SUL";45;4;7;56
2012;"IVAI (PR)";"PR";"IVAI";325;8;35;368
2012;"IVAIPORA (PR)";"PR";"IVAIPORA";818;35;91;944
2012;"IVATE (PR)";"PR";"IVATE";197;11;62;270
2012;"IVATUBA (PR)";"PR";"IVATUBA";53;4;6;63
2012;"JABOTI (PR)";"PR";"JABOTI";82;5;12;99
2012;"JACAREZINHO (PR)";"PR";"JACAREZINHO";562;85;138;785
2012;"JAGUAPITA (PR)";"PR";"JAGUAPITA";318;22;49;389
2012;"JAGUARIAIVA (PR)";"PR";"JAGUARIAIVA";721;52;105;878
2012;"JANDAIA DO SUL (PR)";"PR";"JANDAIA DO SUL";622;36;93;751
2012;"JANIOPOLIS (PR)";"PR";"JANIOPOLIS";143;4;21;168
2012;"JAPIRA (PR)";"PR";"JAPIRA";45;1;12;58
2012;"JAPURA (PR)";"PR";"JAPURA";257;6;19;282
2012;"JARDIM ALEGRE (PR)";"PR";"JARDIM ALEGRE";221;9;28;258
2012;"JARDIM OLINDA (PR)";"PR";"JARDIM OLINDA";39;2;5;46
2012;"JATAIZINHO (PR)";"PR";"JATAIZINHO";334;27;20;381
2012;"JESUITAS (PR)";"PR";"JESUITAS";273;12;24;309
2012;"JOAQUIM TAVORA (PR)";"PR";"JOAQUIM TAVORA";238;13;27;278
2012;"JUNDIAI DO SUL (PR)";"PR";"JUNDIAI DO SUL";29;3;19;51
2012;"JURANDA (PR)";"PR";"JURANDA";303;3;12;318
2012;"JUSSARA (PR)";"PR";"JUSSARA";174;5;30;209
2012;"KALORE (PR)";"PR";"KALORE";146;10;17;173
2012;"LAPA (PR)";"PR";"LAPA";1218;116;162;1496
2012;"LARANJAL (PR)";"PR";"LARANJAL";55;5;17;77
2012;"LARANJEIRAS DO SUL (PR)";"PR";"LARANJEIRAS DO SUL";736;34;74;844
2012;"LEOPOLIS (PR)";"PR";"LEOPOLIS";81;5;3;89
2012;"LIDIANOPOLIS (PR)";"PR";"LIDIANOPOLIS";76;5;21;102
2012;"LINDOESTE (PR)";"PR";"LINDOESTE";93;10;23;126
2012;"LOANDA (PR)";"PR";"LOANDA";419;14;58;491
2012;"LOBATO (PR)";"PR";"LOBATO";182;5;29;216
2012;"LONDRINA (PR)";"PR";"LONDRINA";9004;752;1980;11736
2012;"LUIZIANA (PR)";"PR";"LUIZIANA";162;7;14;183
2012;"LUNARDELLI (PR)";"PR";"LUNARDELLI";92;8;7;107
2012;"LUPIONOPOLIS (PR)";"PR";"LUPIONOPOLIS";105;34;91;230
2012;"MALLET (PR)";"PR";"MALLET";345;12;32;389
2012;"MAMBORE (PR)";"PR";"MAMBORE";547;7;34;588
2012;"MANDAGUACU (PR)";"PR";"MANDAGUACU";441;20;44;505
2012;"MANDAGUARI (PR)";"PR";"MANDAGUARI";731;42;55;828
2012;"MANDIRITUBA (PR)";"PR";"MANDIRITUBA";1003;33;62;1098
2012;"MANFRINOPOLIS (PR)";"PR";"MANFRINOPOLIS";35;5;17;57
2012;"MANGUEIRINHA (PR)";"PR";"MANGUEIRINHA";474;25;58;557
2012;"MANOEL RIBAS (PR)";"PR";"MANOEL RIBAS";328;12;31;371
2012;"MARECHAL CANDIDO RONDON (PR)";"PR";"MARECHAL CANDIDO RONDON";1415;64;157;1636
2012;"MARIA HELENA (PR)";"PR";"MARIA HELENA";108;5;24;137
2012;"MARIALVA (PR)";"PR";"MARIALVA";858;46;74;978
2012;"MARILANDIA DO SUL (PR)";"PR";"MARILANDIA DO SUL";242;12;26;280
2012;"MARILENA (PR)";"PR";"MARILENA";110;8;30;148
2012;"MARILUZ (PR)";"PR";"MARILUZ";178;16;65;259
2012;"MARINGA (PR)";"PR";"MARINGA";9036;513;927;10476
2012;"MARIOPOLIS (PR)";"PR";"MARIOPOLIS";220;15;31;266
2012;"MARIPA (PR)";"PR";"MARIPA";309;9;12;330
2012;"MARMELEIRO (PR)";"PR";"MARMELEIRO";336;20;44;400
2012;"MARQUINHO (PR)";"PR";"MARQUINHO";59;8;15;82
2012;"MARUMBI (PR)";"PR";"MARUMBI";92;4;15;111
2012;"MATELANDIA (PR)";"PR";"MATELANDIA";533;8;50;591
2012;"MATINHOS (PR)";"PR";"MATINHOS";308;32;24;364
2012;"MATO RICO (PR)";"PR";"MATO RICO";48;3;9;60
2012;"MAUA DA SERRA (PR)";"PR";"MAUA DA SERRA";194;8;25;227
2012;"MEDIANEIRA (PR)";"PR";"MEDIANEIRA";1221;54;92;1367
2012;"MERCEDES (PR)";"PR";"MERCEDES";224;7;27;258
2012;"MIRADOR (PR)";"PR";"MIRADOR";13;0;9;22
2012;"MIRASELVA (PR)";"PR";"MIRASELVA";35;6;23;64
2012;"MISSAL (PR)";"PR";"MISSAL";351;23;31;405
2012;"MOREIRA SALES (PR)";"PR";"MOREIRA SALES";189;10;73;272
2012;"MORRETES (PR)";"PR";"MORRETES";200;16;39;255
2012;"MUNHOZ DE MELLO (PR)";"PR";"MUNHOZ DE MELLO";66;5;9;80
2012;"NOSSA SENHORA DAS GRACAS (PR)";"PR";"NOSSA SENHORA DAS GRACAS";30;8;34;72
2012;"NOVA ALIANCA DO IVAI (PR)";"PR";"NOVA ALIANCA DO IVAI";20;4;4;28
2012;"NOVA AMERICA DA COLINA (PR)";"PR";"NOVA AMERICA DA COLINA";117;5;12;134
2012;"NOVA AURORA (PR)";"PR";"NOVA AURORA";410;12;41;463
2012;"NOVA CANTU (PR)";"PR";"NOVA CANTU";116;0;24;140
2012;"NOVA ESPERANCA (PR)";"PR";"NOVA ESPERANCA";801;34;68;903
2012;"NOVA ESPERANCA DO SUDOESTE (PR)";"PR";"NOVA ESPERANCA DO SUDOESTE";113;13;21;147
2012;"NOVA FATIMA (PR)";"PR";"NOVA FATIMA";252;2;37;291
2012;"NOVA LARANJEIRAS (PR)";"PR";"NOVA LARANJEIRAS";155;6;28;189
2012;"NOVA LONDRINA (PR)";"PR";"NOVA LONDRINA";383;16;39;438
2012;"NOVA OLIMPIA (PR)";"PR";"NOVA OLIMPIA";97;3;17;117
2012;"NOVA PRATA DO IGUACU (PR)";"PR";"NOVA PRATA DO IGUACU";227;7;27;261
2012;"NOVA SANTA BARBARA (PR)";"PR";"NOVA SANTA BARBARA";127;10;7;144
2012;"NOVA SANTA ROSA (PR)";"PR";"NOVA SANTA ROSA";328;11;15;354
2012;"NOVA TEBAS (PR)";"PR";"NOVA TEBAS";107;7;21;135
2012;"NOVO ITACOLOMI (PR)";"PR";"NOVO ITACOLOMI";90;2;8;100
2012;"ORTIGUEIRA (PR)";"PR";"ORTIGUEIRA";331;26;72;429
2012;"OURIZONA (PR)";"PR";"OURIZONA";77;4;17;98
2012;"OURO VERDE DO OESTE (PR)";"PR";"OURO VERDE DO OESTE";146;2;12;160
2012;"PAICANDU (PR)";"PR";"PAICANDU";480;30;57;567
2012;"PALMAS (PR)";"PR";"PALMAS";890;66;90;1046
2012;"PALMEIRA (PR)";"PR";"PALMEIRA";896;40;76;1012
2012;"PALMITAL (PR)";"PR";"PALMITAL";249;11;51;311
2012;"PALOTINA (PR)";"PR";"PALOTINA";1176;28;107;1311
2012;"PARAISO DO NORTE (PR)";"PR";"PARAISO DO NORTE";252;13;53;318
2012;"PARANACITY (PR)";"PR";"PARANACITY";238;19;44;301
2012;"PARANAGUA (PR)";"PR";"PARANAGUA";1709;161;153;2023
2012;"PARANAPOEMA (PR)";"PR";"PARANAPOEMA";68;5;19;92
2012;"PARANAVAI (PR)";"PR";"PARANAVAI";1958;109;210;2277
2012;"PATO BRAGADO (PR)";"PR";"PATO BRAGADO";138;5;12;155
2012;"PATO BRANCO (PR)";"PR";"PATO BRANCO";2065;149;396;2610
2012;"PAULA FREITAS (PR)";"PR";"PAULA FREITAS";137;3;18;158
2012;"PAULO FRONTIN (PR)";"PR";"PAULO FRONTIN";190;2;12;204
2012;"PEABIRU (PR)";"PR";"PEABIRU";291;15;26;332
2012;"PEROBAL (PR)";"PR";"PEROBAL";104;4;28;136
2012;"PEROLA (PR)";"PR";"PEROLA";210;12;14;236
2012;"PEROLA D OESTE (PR)";"PR";"PEROLA D OESTE";177;5;20;202
2012;"PIEN (PR)";"PR";"PIEN";407;20;18;445
2012;"PINHAIS (PR)";"PR";"PINHAIS";2270;208;458;2936
2012;"PINHAL DO SAO BENTO (PR)";"PR";"PINHAL DO SAO BENTO";39;3;10;52
2012;"PINHALAO (PR)";"PR";"PINHALAO";104;7;18;129
2012;"PINHAO (PR)";"PR";"PINHAO";506;34;102;642
2012;"PIRAI DO SUL (PR)";"PR";"PIRAI DO SUL";437;38;85;560
2012;"PIRAQUARA (PR)";"PR";"PIRAQUARA";590;84;197;871
2012;"PITANGA (PR)";"PR";"PITANGA";804;32;115;951
2012;"PITANGUEIRAS (PR)";"PR";"PITANGUEIRAS";61;3;26;90
2012;"PLANALTINA DO PARANA (PR)";"PR";"PLANALTINA DO PARANA";104;6;18;128
2012;"PLANALTO (PR)";"PR";"PLANALTO";293;16;28;337
2012;"PONTA GROSSA (PR)";"PR";"PONTA GROSSA";6112;616;1045;7773
2012;"PONTAL DO PARANA (PR)";"PR";"PONTAL DO PARANA";248;13;44;305
2012;"PORECATU (PR)";"PR";"PORECATU";302;30;133;465
2012;"PORTO AMAZONAS (PR)";"PR";"PORTO AMAZONAS";78;8;11;97
2012;"PORTO BARREIRO (PR)";"PR";"PORTO BARREIRO";59;5;21;85
2012;"PORTO RICO (PR)";"PR";"PORTO RICO";25;0;7;32
2012;"PORTO VITORIA (PR)";"PR";"PORTO VITORIA";166;3;10;179
2012;"PRADO FERREIRA (PR)";"PR";"PRADO FERREIRA";90;4;14;108
2012;"PRANCHITA (PR)";"PR";"PRANCHITA";231;7;12;250
2012;"PRESIDENTE CASTELO BRANCO (PR)";"PR";"PRESIDENTE CASTELO BRANCO";103;4;23;130
2012;"PRIMEIRO DE MAIO (PR)";"PR";"PRIMEIRO DE MAIO";316;15;26;357
2012;"PRUDENTOPOLIS (PR)";"PR";"PRUDENTOPOLIS";1211;43;108;1362
2012;"QUARTO CENTENARIO (PR)";"PR";"QUARTO CENTENARIO";132;4;6;142
2012;"QUATIGUA (PR)";"PR";"QUATIGUA";362;9;18;389
2012;"QUATRO BARRAS (PR)";"PR";"QUATRO BARRAS";579;46;135;760
2012;"QUATRO PONTES (PR)";"PR";"QUATRO PONTES";171;4;4;179
2012;"QUEDAS DO IGUACU (PR)";"PR";"QUEDAS DO IGUACU";698;30;135;863
2012;"QUERENCIA DO NORTE (PR)";"PR";"QUERENCIA DO NORTE";205;6;29;240
2012;"QUINTA DO SOL (PR)";"PR";"QUINTA DO SOL";113;4;20;137
2012;"QUITANDINHA (PR)";"PR";"QUITANDINHA";492;8;69;569
2012;"RAMILANDIA (PR)";"PR";"RAMILANDIA";54;2;14;70
2012;"RANCHO ALEGRE (PR)";"PR";"RANCHO ALEGRE";106;4;14;124
2012;"RANCHO ALEGRE D OESTE (PR)";"PR";"RANCHO ALEGRE D OESTE";82;2;9;93
2012;"REALEZA (PR)";"PR";"REALEZA";572;21;35;628
2012;"REBOUCAS (PR)";"PR";"REBOUCAS";269;12;43;324
2012;"RENASCENCA (PR)";"PR";"RENASCENCA";228;9;31;268
2012;"RESERVA (PR)";"PR";"RESERVA";585;25;69;679
2012;"RESERVA DO IGUACU (PR)";"PR";"RESERVA DO IGUACU";76;11;20;107
2012;"RIBEIRAO CLARO (PR)";"PR";"RIBEIRAO CLARO";209;31;31;271
2012;"RIBEIRAO DO PINHAL (PR)";"PR";"RIBEIRAO DO PINHAL";204;31;41;276
2012;"RIO AZUL (PR)";"PR";"RIO AZUL";251;13;53;317
2012;"RIO BOM (PR)";"PR";"RIO BOM";72;5;7;84
2012;"RIO BONITO DO IGUACU (PR)";"PR";"RIO BONITO DO IGUACU";252;7;69;328
2012;"RIO BRANCO DO IVAI (PR)";"PR";"RIO BRANCO DO IVAI";38;4;13;55
2012;"RIO BRANCO DO SUL (PR)";"PR";"RIO BRANCO DO SUL";675;82;124;881
2012;"RIO NEGRO (PR)";"PR";"RIO NEGRO";897;67;57;1021
2012;"ROLANDIA (PR)";"PR";"ROLANDIA";1651;108;119;1878
2012;"RONCADOR (PR)";"PR";"RONCADOR";314;5;32;351
2012;"RONDON (PR)";"PR";"RONDON";268;15;62;345
2012;"ROSARIO DO IVAI (PR)";"PR";"ROSARIO DO IVAI";81;7;22;110
2012;"SABAUDIA (PR)";"PR";"SABAUDIA";188;9;18;215
2012;"SALGADO FILHO (PR)";"PR";"SALGADO FILHO";78;4;22;104
2012;"SALTO DO ITARARE (PR)";"PR";"SALTO DO ITARARE";96;4;15;115
2012;"SALTO DO LONTRA (PR)";"PR";"SALTO DO LONTRA";257;10;28;295
2012;"SANTA AMELIA (PR)";"PR";"SANTA AMELIA";93;4;17;114
2012;"SANTA CECILIA DO PAVAO (PR)";"PR";"SANTA CECILIA DO PAVAO";77;6;12;95
2012;"SANTA CRUZ DO MONTE CASTELO (PR)";"PR";"SANTA CRUZ DO MONTE CASTELO";197;9;35;241
2012;"SANTA FE (PR)";"PR";"SANTA FE";236;9;28;273
2012;"SANTA HELENA (PR)";"PR";"SANTA HELENA";601;47;106;754
2012;"SANTA INES (PR)";"PR";"SANTA INES";15;6;6;27
2012;"SANTA ISABEL DO IVAI (PR)";"PR";"SANTA ISABEL DO IVAI";183;12;34;229
2012;"SANTA IZABEL DO OESTE (PR)";"PR";"SANTA IZABEL DO OESTE";201;21;30;252
2012;"SANTA LUCIA (PR)";"PR";"SANTA LUCIA";104;1;8;113
2012;"SANTA MARIA DO OESTE (PR)";"PR";"SANTA MARIA DO OESTE";207;5;22;234
2012;"SANTA MARIANA (PR)";"PR";"SANTA MARIANA";287;22;46;355
2012;"SANTA MONICA (PR)";"PR";"SANTA MONICA";54;3;11;68
2012;"SANTA TEREZA DO OESTE (PR)";"PR";"SANTA TEREZA DO OESTE";220;11;16;247
2012;"SANTA TEREZINHA DE ITAIPU (PR)";"PR";"SANTA TEREZINHA DE ITAIPU";448;48;60;556
2012;"SANTANA DO ITARARE (PR)";"PR";"SANTANA DO ITARARE";81;3;16;100
2012;"SANTO ANTONIO DA PLATINA (PR)";"PR";"SANTO ANTONIO DA PLATINA";646;62;228;936
2012;"SANTO ANTONIO DO CAIUA (PR)";"PR";"SANTO ANTONIO DO CAIUA";22;2;12;36
2012;"SANTO ANTONIO DO PARAISO (PR)";"PR";"SANTO ANTONIO DO PARAISO";75;6;9;90
2012;"SANTO ANTONIO DO SUDOESTE (PR)";"PR";"SANTO ANTONIO DO SUDOESTE";366;12;40;418
2012;"SANTO INACIO (PR)";"PR";"SANTO INACIO";93;6;17;116
2012;"SAO CARLOS DO IVAI (PR)";"PR";"SAO CARLOS DO IVAI";223;9;24;256
2012;"SAO JERONIMO DA SERRA (PR)";"PR";"SAO JERONIMO DA SERRA";157;5;21;183
2012;"SAO JOAO (PR)";"PR";"SAO JOAO";336;13;36;385
2012;"SAO JOAO DO CAIUA (PR)";"PR";"SAO JOAO DO CAIUA";63;2;31;96
2012;"SAO JOAO DO IVAI (PR)";"PR";"SAO JOAO DO IVAI";314;12;27;353
2012;"SAO JOAO DO TRIUNFO (PR)";"PR";"SAO JOAO DO TRIUNFO";225;10;32;267
2012;"SAO JORGE D OESTE (PR)";"PR";"SAO JORGE D OESTE";205;14;32;251
2012;"SAO JORGE DO IVAI (PR)";"PR";"SAO JORGE DO IVAI";269;5;15;289
2012;"SAO JORGE DO PATROCINIO (PR)";"PR";"SAO JORGE DO PATROCINIO";128;4;12;144
2012;"SAO JOSE DA BOA VISTA (PR)";"PR";"SAO JOSE DA BOA VISTA";84;5;17;106
2012;"SAO JOSE DAS PALMEIRAS (PR)";"PR";"SAO JOSE DAS PALMEIRAS";67;8;25;100
2012;"SAO JOSE DOS PINHAIS (PR)";"PR";"SAO JOSE DOS PINHAIS";7151;666;800;8617
2012;"SAO MANOEL DO PARANA (PR)";"PR";"SAO MANOEL DO PARANA";38;2;8;48
2012;"SAO MATEUS DO SUL (PR)";"PR";"SAO MATEUS DO SUL";925;85;140;1150
2012;"SAO MIGUEL DO IGUACU (PR)";"PR";"SAO MIGUEL DO IGUACU";833;33;78;944
2012;"SAO PEDRO DO IGUACU (PR)";"PR";"SAO PEDRO DO IGUACU";170;9;27;206
2012;"SAO PEDRO DO IVAI (PR)";"PR";"SAO PEDRO DO IVAI";322;10;46;378
2012;"SAO PEDRO DO PARANA (PR)";"PR";"SAO PEDRO DO PARANA";34;5;4;43
2012;"SAO SEBASTIAO DA AMOREIRA (PR)";"PR";"SAO SEBASTIAO DA AMOREIRA";187;5;40;232
2012;"SAO TOME (PR)";"PR";"SAO TOME";125;11;27;163
2012;"SAPOPEMA (PR)";"PR";"SAPOPEMA";102;4;12;118
2012;"SARANDI (PR)";"PR";"SARANDI";986;76;148;1210
2012;"SAUDADE DO IGUACU (PR)";"PR";"SAUDADE DO IGUACU";72;16;19;107
2012;"SENGES (PR)";"PR";"SENGES";486;31;67;584
2012;"SERRANOPOLIS DO IGUACU (PR)";"PR";"SERRANOPOLIS DO IGUACU";144;13;9;166
2012;"SERTANEJA (PR)";"PR";"SERTANEJA";203;10;26;239
2012;"SERTANOPOLIS (PR)";"PR";"SERTANOPOLIS";583;16;54;653
2012;"SIQUEIRA CAMPOS (PR)";"PR";"SIQUEIRA CAMPOS";372;18;48;438
2012;"SULINA (PR)";"PR";"SULINA";89;4;10;103
2012;"TAMARANA (PR)";"PR";"TAMARANA";280;12;36;328
2012;"TAMBOARA (PR)";"PR";"TAMBOARA";84;7;14;105
2012;"TAPEJARA (PR)";"PR";"TAPEJARA";370;11;86;467
2012;"TAPIRA (PR)";"PR";"TAPIRA";144;6;25;175
2012;"TEIXEIRA SOARES (PR)";"PR";"TEIXEIRA SOARES";209;11;69;289
2012;"TELEMACO BORBA (PR)";"PR";"TELEMACO BORBA";1024;212;198;1434
2012;"TERRA BOA (PR)";"PR";"TERRA BOA";320;15;80;415
2012;"TERRA RICA (PR)";"PR";"TERRA RICA";345;12;72;429
2012;"TERRA ROXA (PR)";"PR";"TERRA ROXA";502;14;43;559
2012;"TIBAGI (PR)";"PR";"TIBAGI";318;32;47;397
2012;"TIJUCAS DO SUL (PR)";"PR";"TIJUCAS DO SUL";449;13;35;497
2012;"TOLEDO (PR)";"PR";"TOLEDO";2934;215;254;3403
2012;"TOMAZINA (PR)";"PR";"TOMAZINA";101;10;20;131
2012;"TRES BARRAS DO PARANA (PR)";"PR";"TRES BARRAS DO PARANA";291;5;27;323
2012;"TUNAS DO PARANA (PR)";"PR";"TUNAS DO PARANA";92;11;32;135
2012;"TUNEIRAS DO OESTE (PR)";"PR";"TUNEIRAS DO OESTE";124;6;42;172
2012;"TUPASSI (PR)";"PR";"TUPASSI";330;13;35;378
2012;"TURVO (PR)";"PR";"TURVO";392;15;57;464
2012;"UBIRATA (PR)";"PR";"UBIRATA";701;29;47;777
2012;"UMUARAMA (PR)";"PR";"UMUARAMA";2592;77;260;2929
2012;"UNIAO DA VITORIA (PR)";"PR";"UNIAO DA VITORIA";1424;55;70;1549
2012;"UNIFLOR (PR)";"PR";"UNIFLOR";39;7;12;58
2012;"URAI (PR)";"PR";"URAI";292;21;23;336
2012;"VENTANIA (PR)";"PR";"VENTANIA";171;18;30;219
2012;"VERA CRUZ DO OESTE (PR)";"PR";"VERA CRUZ DO OESTE";250;6;12;268
2012;"VERE (PR)";"PR";"VERE";206;15;22;243
2012;"VIRMOND (PR)";"PR";"VIRMOND";112;1;18;131
2012;"VITORINO (PR)";"PR";"VITORINO";213;5;21;239
2012;"WENCESLAU BRAZ (PR)";"PR";"WENCESLAU BRAZ";411;26;83;520
2012;"XAMBRE (PR)";"PR";"XAMBRE";147;9;12;168
2012;"ANGRA DOS REIS (RJ)";"RJ";"ANGRA DOS REIS";1050;187;348;1585
2012;"APERIBE (RJ)";"RJ";"APERIBE";114;15;10;139
2012;"ARARUAMA (RJ)";"RJ";"ARARUAMA";1772;292;105;2169
2012;"AREAL (RJ)";"RJ";"AREAL";148;34;38;220
2012;"ARMACAO DE BUZIOS (RJ)";"RJ";"ARMACAO DE BUZIOS";295;287;49;631
2012;"ARRAIAL DO CABO (RJ)";"RJ";"ARRAIAL DO CABO";121;47;12;180
2012;"BARRA DO PIRAI (RJ)";"RJ";"BARRA DO PIRAI";1452;175;263;1890
2012;"BARRA MANSA (RJ)";"RJ";"BARRA MANSA";2056;191;608;2855
2012;"BELFORD ROXO (RJ)";"RJ";"BELFORD ROXO";1586;309;819;2714
2012;"BOM JARDIM (RJ)";"RJ";"BOM JARDIM";587;38;36;661
2012;"BOM JESUS DO ITABAPOANA (RJ)";"RJ";"BOM JESUS DO ITABAPOANA";333;60;57;450
2012;"CABO FRIO (RJ)";"RJ";"CABO FRIO";3287;331;443;4061
2012;"CACHOEIRAS DE MACACU (RJ)";"RJ";"CACHOEIRAS DE MACACU";810;145;43;998
2012;"CAMBUCI (RJ)";"RJ";"CAMBUCI";93;21;16;130
2012;"CAMPOS DOS GOYTACAZES (RJ)";"RJ";"CAMPOS DOS GOYTACAZES";6523;910;1218;8651
2012;"CANTAGALO (RJ)";"RJ";"CANTAGALO";180;32;39;251
2012;"CARAPEBUS (RJ)";"RJ";"CARAPEBUS";86;23;7;116
2012;"CARDOSO MOREIRA (RJ)";"RJ";"CARDOSO MOREIRA";161;25;32;218
2012;"CARMO (RJ)";"RJ";"CARMO";126;23;31;180
2012;"CASIMIRO DE ABREU (RJ)";"RJ";"CASIMIRO DE ABREU";515;105;39;659
2012;"COMENDADOR LEVY GASPARIAN (RJ)";"RJ";"COMENDADOR LEVY GASPARIAN";143;32;19;194
2012;"CONCEICAO DE MACABU (RJ)";"RJ";"CONCEICAO DE MACABU";164;38;50;252
2012;"CORDEIRO (RJ)";"RJ";"CORDEIRO";284;38;48;370
2012;"DUAS BARRAS (RJ)";"RJ";"DUAS BARRAS";115;27;6;148
2012;"DUQUE DE CAXIAS (RJ)";"RJ";"DUQUE DE CAXIAS";8602;897;3723;13222
2012;"ENGENHEIRO PAULO DE FRONTIN (RJ)";"RJ";"ENGENHEIRO PAULO DE FRONTIN";136;27;16;179
2012;"GUAPIMIRIM (RJ)";"RJ";"GUAPIMIRIM";333;65;41;439
2012;"IGUABA GRANDE (RJ)";"RJ";"IGUABA GRANDE";161;61;22;244
2012;"ITABORAI (RJ)";"RJ";"ITABORAI";2985;814;432;4231
2012;"ITAGUAI (RJ)";"RJ";"ITAGUAI";1527;268;297;2092
2012;"ITALVA (RJ)";"RJ";"ITALVA";194;24;26;244
2012;"ITAOCARA (RJ)";"RJ";"ITAOCARA";314;47;30;391
2012;"ITAPERUNA (RJ)";"RJ";"ITAPERUNA";1276;119;108;1503
2012;"ITATIAIA (RJ)";"RJ";"ITATIAIA";151;74;45;270
2012;"JAPERI (RJ)";"RJ";"JAPERI";445;53;59;557
2012;"LAJE DO MURIAE (RJ)";"RJ";"LAJE DO MURIAE";44;6;13;63
2012;"MACAE (RJ)";"RJ";"MACAE";2875;796;874;4545
2012;"MACUCO (RJ)";"RJ";"MACUCO";147;13;11;171
2012;"MAGE (RJ)";"RJ";"MAGE";1558;385;200;2143
2012;"MANGARATIBA (RJ)";"RJ";"MANGARATIBA";136;124;157;417
2012;"MARICA (RJ)";"RJ";"MARICA";949;315;352;1616
2012;"MENDES (RJ)";"RJ";"MENDES";211;46;40;297
2012;"MESQUITA (RJ)";"RJ";"MESQUITA";679;102;712;1493
2012;"MIGUEL PEREIRA (RJ)";"RJ";"MIGUEL PEREIRA";328;82;30;440
2012;"MIRACEMA (RJ)";"RJ";"MIRACEMA";233;25;31;289
2012;"NATIVIDADE (RJ)";"RJ";"NATIVIDADE";88;14;30;132
2012;"NILOPOLIS (RJ)";"RJ";"NILOPOLIS";649;142;318;1109
2012;"NITEROI (RJ)";"RJ";"NITEROI";2396;1230;2739;6365
2012;"NOVA FRIBURGO (RJ)";"RJ";"NOVA FRIBURGO";3430;236;316;3982
2012;"NOVA IGUACU (RJ)";"RJ";"NOVA IGUACU";5645;1324;1588;8557
2012;"PARACAMBI (RJ)";"RJ";"PARACAMBI";689;81;133;903
2012;"PARAIBA DO SUL (RJ)";"RJ";"PARAIBA DO SUL";569;89;111;769
2012;"PARATI (RJ)";"RJ";"PARATI";182;58;28;268
2012;"PATY DO ALFERES (RJ)";"RJ";"PATY DO ALFERES";458;64;38;560
2012;"PETROPOLIS (RJ)";"RJ";"PETROPOLIS";2978;607;875;4460
2012;"PINHEIRAL (RJ)";"RJ";"PINHEIRAL";189;42;101;332
2012;"PIRAI (RJ)";"RJ";"PIRAI";441;63;56;560
2012;"PORCIUNCULA (RJ)";"RJ";"PORCIUNCULA";78;14;17;109
2012;"PORTO REAL (RJ)";"RJ";"PORTO REAL";360;51;19;430
2012;"QUATIS (RJ)";"RJ";"QUATIS";189;69;29;287
2012;"QUEIMADOS (RJ)";"RJ";"QUEIMADOS";475;210;147;832
2012;"QUISSAMA (RJ)";"RJ";"QUISSAMA";194;32;103;329
2012;"RESENDE (RJ)";"RJ";"RESENDE";1282;246;467;1995
2012;"RIO BONITO (RJ)";"RJ";"RIO BONITO";3526;376;152;4054
2012;"RIO CLARO (RJ)";"RJ";"RIO CLARO";89;16;18;123
2012;"RIO DAS FLORES (RJ)";"RJ";"RIO DAS FLORES";48;21;15;84
2012;"RIO DAS OSTRAS (RJ)";"RJ";"RIO DAS OSTRAS";928;727;90;1745
2012;"RIO DE JANEIRO (RJ)";"RJ";"RIO DE JANEIRO";36701;16903;16738;70342
2012;"SANTA MARIA MADALENA (RJ)";"RJ";"SANTA MARIA MADALENA";61;22;3;86
2012;"SANTO ANTONIO DE PADUA (RJ)";"RJ";"SANTO ANTONIO DE PADUA";600;92;31;723
2012;"SAO FIDELIS (RJ)";"RJ";"SAO FIDELIS";416;29;57;502
2012;"SAO FRANCISCO DE ITABAPOANA (RJ)";"RJ";"SAO FRANCISCO DE ITABAPOANA";373;77;59;509
2012;"SAO GONCALO (RJ)";"RJ";"SAO GONCALO";3779;1718;3185;8682
2012;"SAO JOAO DA BARRA (RJ)";"RJ";"SAO JOAO DA BARRA";528;97;56;681
2012;"SAO JOAO DE MERITI (RJ)";"RJ";"SAO JOAO DE MERITI";3387;494;1384;5265
2012;"SAO JOSE DE UBA (RJ)";"RJ";"SAO JOSE DE UBA";41;10;7;58
2012;"SAO JOSE DO VALE DO RIO PRETO (RJ)";"RJ";"SAO JOSE DO VALE DO RIO PRETO";600;35;20;655
2012;"SAO PEDRO DA ALDEIA (RJ)";"RJ";"SAO PEDRO DA ALDEIA";723;90;64;877
2012;"SAO SEBASTIAO DO ALTO (RJ)";"RJ";"SAO SEBASTIAO DO ALTO";96;23;5;124
2012;"SAPUCAIA (RJ)";"RJ";"SAPUCAIA";123;19;13;155
2012;"SAQUAREMA (RJ)";"RJ";"SAQUAREMA";692;136;101;929
2012;"SEROPEDICA (RJ)";"RJ";"SEROPEDICA";988;62;225;1275
2012;"SILVA JARDIM (RJ)";"RJ";"SILVA JARDIM";269;51;35;355
2012;"SUMIDOURO (RJ)";"RJ";"SUMIDOURO";250;12;10;272
2012;"TANGUA (RJ)";"RJ";"TANGUA";245;57;150;452
2012;"TERESOPOLIS (RJ)";"RJ";"TERESOPOLIS";2009;275;308;2592
2012;"TRAJANO DE MORAIS (RJ)";"RJ";"TRAJANO DE MORAIS";64;17;12;93
2012;"TRES RIOS (RJ)";"RJ";"TRES RIOS";921;107;206;1234
2012;"VALENCA (RJ)";"RJ";"VALENCA";343;95;78;516
2012;"VARRE SAI (RJ)";"RJ";"VARRE SAI";67;13;5;85
2012;"VASSOURAS (RJ)";"RJ";"VASSOURAS";500;73;86;659
2012;"VOLTA REDONDA (RJ)";"RJ";"VOLTA REDONDA";2284;350;615;3249
2012;"ACARI (RN)";"RN";"ACARI";93;10;8;111
2012;"AFONSO BEZERRA (RN)";"RN";"AFONSO BEZERRA";23;3;6;32
2012;"AGUA NOVA (RN)";"RN";"AGUA NOVA";6;11;2;19
2012;"ALEXANDRIA (RN)";"RN";"ALEXANDRIA";57;32;12;101
2012;"ALMINO AFONSO (RN)";"RN";"ALMINO AFONSO";16;9;1;26
2012;"ALTO DO RODRIGUES (RN)";"RN";"ALTO DO RODRIGUES";148;15;22;185
2012;"ANGICOS (RN)";"RN";"ANGICOS";109;11;10;130
2012;"ANTONIO MARTINS (RN)";"RN";"ANTONIO MARTINS";13;10;2;25
2012;"APODI (RN)";"RN";"APODI";265;18;23;306
2012;"AREIA BRANCA (RN)";"RN";"AREIA BRANCA";117;40;55;212
2012;"ARES (RN)";"RN";"ARES";53;9;27;89
2012;"ASSU (RN)";"RN";"ASSU";554;53;73;680
2012;"BAIA FORMOSA (RN)";"RN";"BAIA FORMOSA";51;2;19;72
2012;"BARAUNA (RN)";"RN";"BARAUNA";159;23;15;197
2012;"BARCELONA (RN)";"RN";"BARCELONA";25;2;2;29
2012;"BENTO FERNANDES (RN)";"RN";"BENTO FERNANDES";16;6;7;29
2012;"BOA SAUDE (RN)";"RN";"BOA SAUDE";49;4;6;59
2012;"BODO (RN)";"RN";"BODO";7;4;1;12
2012;"BOM JESUS (RN)";"RN";"BOM JESUS";44;2;7;53
2012;"BREJINHO (RN)";"RN";"BREJINHO";65;12;12;89
2012;"CAICARA DO NORTE (RN)";"RN";"CAICARA DO NORTE";15;1;4;20
2012;"CAICARA DO RIO DO VENTO (RN)";"RN";"CAICARA DO RIO DO VENTO";17;4;2;23
2012;"CAICO (RN)";"RN";"CAICO";1573;90;47;1710
2012;"CAMPO GRANDE (RN)";"RN";"CAMPO GRANDE";43;8;4;55
2012;"CAMPO REDONDO (RN)";"RN";"CAMPO REDONDO";40;14;9;63
2012;"CANGUARETAMA (RN)";"RN";"CANGUARETAMA";136;26;64;226
2012;"CARAUBAS (RN)";"RN";"CARAUBAS";142;21;10;173
2012;"CARNAUBA DOS DANTAS (RN)";"RN";"CARNAUBA DOS DANTAS";200;10;7;217
2012;"CARNAUBAIS (RN)";"RN";"CARNAUBAIS";42;19;13;74
2012;"CEARA MIRIM (RN)";"RN";"CEARA MIRIM";290;37;113;440
2012;"CERRO CORA (RN)";"RN";"CERRO CORA";82;8;7;97
2012;"CORONEL EZEQUIEL (RN)";"RN";"CORONEL EZEQUIEL";35;7;5;47
2012;"CORONEL JOAO PESSOA (RN)";"RN";"CORONEL JOAO PESSOA";8;2;1;11
2012;"CRUZETA (RN)";"RN";"CRUZETA";72;10;6;88
2012;"CURRAIS NOVOS (RN)";"RN";"CURRAIS NOVOS";607;53;55;715
2012;"DOUTOR SEVERIANO (RN)";"RN";"DOUTOR SEVERIANO";15;7;8;30
2012;"ENCANTO (RN)";"RN";"ENCANTO";14;10;8;32
2012;"EQUADOR (RN)";"RN";"EQUADOR";98;4;2;104
2012;"ESPIRITO SANTO (RN)";"RN";"ESPIRITO SANTO";22;3;13;38
2012;"EXTREMOZ (RN)";"RN";"EXTREMOZ";49;20;31;100
2012;"FELIPE GUERRA (RN)";"RN";"FELIPE GUERRA";14;6;5;25
2012;"FERNANDO PEDROZA (RN)";"RN";"FERNANDO PEDROZA";20;2;2;24
2012;"FLORANIA (RN)";"RN";"FLORANIA";51;9;2;62
2012;"FRANCISCO DANTAS (RN)";"RN";"FRANCISCO DANTAS";9;4;2;15
2012;"FRUTUOSO GOMES (RN)";"RN";"FRUTUOSO GOMES";18;11;2;31
2012;"GALINHOS (RN)";"RN";"GALINHOS";8;3;3;14
2012;"GOIANINHA (RN)";"RN";"GOIANINHA";155;39;59;253
2012;"GOVERNADOR DIX SEPT ROSADO (RN)";"RN";"GOVERNADOR DIX SEPT ROSADO";127;24;17;168
2012;"GROSSOS (RN)";"RN";"GROSSOS";51;3;10;64
2012;"GUAMARE (RN)";"RN";"GUAMARE";86;20;32;138
2012;"IELMO MARINHO (RN)";"RN";"IELMO MARINHO";46;4;23;73
2012;"IPANGUACU (RN)";"RN";"IPANGUACU";79;22;53;154
2012;"IPUEIRA (RN)";"RN";"IPUEIRA";12;6;6;24
2012;"ITAJA (RN)";"RN";"ITAJA";100;3;4;107
2012;"ITAU (RN)";"RN";"ITAU";26;7;2;35
2012;"JACANA (RN)";"RN";"JACANA";111;38;19;168
2012;"JANDAIRA (RN)";"RN";"JANDAIRA";43;0;11;54
2012;"JANDUIS (RN)";"RN";"JANDUIS";15;3;3;21
2012;"JAPI (RN)";"RN";"JAPI";39;7;8;54
2012;"JARDIM DE ANGICOS (RN)";"RN";"JARDIM DE ANGICOS";7;0;1;8
2012;"JARDIM DE PIRANHAS (RN)";"RN";"JARDIM DE PIRANHAS";91;20;8;119
2012;"JARDIM DO SERIDO (RN)";"RN";"JARDIM DO SERIDO";138;21;49;208
2012;"JOAO CAMARA (RN)";"RN";"JOAO CAMARA";298;17;30;345
2012;"JOAO DIAS (RN)";"RN";"JOAO DIAS";4;1;1;6
2012;"JOSE DA PENHA (RN)";"RN";"JOSE DA PENHA";24;13;2;39
2012;"JUCURUTU (RN)";"RN";"JUCURUTU";115;33;7;155
2012;"JUNDIA (RN)";"RN";"JUNDIA";9;5;9;23
2012;"LAGOA DANTA (RN)";"RN";"LAGOA DANTA";34;6;11;51
2012;"LAGOA DE PEDRAS (RN)";"RN";"LAGOA DE PEDRAS";24;4;10;38
2012;"LAGOA DE VELHOS (RN)";"RN";"LAGOA DE VELHOS";19;2;1;22
2012;"LAGOA NOVA (RN)";"RN";"LAGOA NOVA";77;5;8;90
2012;"LAGOA SALGADA (RN)";"RN";"LAGOA SALGADA";62;7;4;73
2012;"LAJES (RN)";"RN";"LAJES";54;4;9;67
2012;"LAJES PINTADAS (RN)";"RN";"LAJES PINTADAS";21;10;3;34
2012;"LUCRECIA (RN)";"RN";"LUCRECIA";17;7;2;26
2012;"LUIS GOMES (RN)";"RN";"LUIS GOMES";33;33;6;72
2012;"MACAIBA (RN)";"RN";"MACAIBA";724;93;73;890
2012;"MACAU (RN)";"RN";"MACAU";195;31;55;281
2012;"MAJOR SALES (RN)";"RN";"MAJOR SALES";13;12;2;27
2012;"MARCELINO VIEIRA (RN)";"RN";"MARCELINO VIEIRA";15;12;2;29
2012;"MARTINS (RN)";"RN";"MARTINS";36;10;6;52
2012;"MAXARANGUAPE (RN)";"RN";"MAXARANGUAPE";23;6;9;38
2012;"MESSIAS TARGINO (RN)";"RN";"MESSIAS TARGINO";31;8;2;41
2012;"MONTANHAS (RN)";"RN";"MONTANHAS";44;5;15;64
2012;"MONTE ALEGRE (RN)";"RN";"MONTE ALEGRE";88;16;12;116
2012;"MONTE DAS GAMELEIRAS (RN)";"RN";"MONTE DAS GAMELEIRAS";9;3;7;19
2012;"MOSSORO (RN)";"RN";"MOSSORO";3592;279;258;4129
2012;"NATAL (RN)";"RN";"NATAL";6358;1177;2411;9946
2012;"NISIA FLORESTA (RN)";"RN";"NISIA FLORESTA";80;36;42;158
2012;"NOVA CRUZ (RN)";"RN";"NOVA CRUZ";354;30;56;440
2012;"OLHO D AGUA DO BORGES (RN)";"RN";"OLHO D AGUA DO BORGES";19;3;1;23
2012;"OURO BRANCO (RN)";"RN";"OURO BRANCO";42;5;5;52
2012;"PARANA (RN)";"RN";"PARANA";13;11;3;27
2012;"PARAU (RN)";"RN";"PARAU";14;9;2;25
2012;"PARAZINHO (RN)";"RN";"PARAZINHO";20;6;12;38
2012;"PARELHAS (RN)";"RN";"PARELHAS";391;26;33;450
2012;"PARNAMIRIM (RN)";"RN";"PARNAMIRIM";1858;350;368;2576
2012;"PASSA E FICA (RN)";"RN";"PASSA E FICA";106;34;24;164
2012;"PASSAGEM (RN)";"RN";"PASSAGEM";17;7;3;27
2012;"PATU (RN)";"RN";"PATU";74;20;3;97
2012;"PAU DOS FERROS (RN)";"RN";"PAU DOS FERROS";385;45;30;460
2012;"PEDRA GRANDE (RN)";"RN";"PEDRA GRANDE";11;1;6;18
2012;"PEDRA PRETA (RN)";"RN";"PEDRA PRETA";28;2;9;39
2012;"PEDRO AVELINO (RN)";"RN";"PEDRO AVELINO";30;4;3;37
2012;"PEDRO VELHO (RN)";"RN";"PEDRO VELHO";42;5;12;59
2012;"PENDENCIAS (RN)";"RN";"PENDENCIAS";56;13;14;83
2012;"PILOES (RN)";"RN";"PILOES";7;7;2;16
2012;"POCO BRANCO (RN)";"RN";"POCO BRANCO";28;3;8;39
2012;"PORTALEGRE (RN)";"RN";"PORTALEGRE";40;8;4;52
2012;"PORTO DO MANGUE (RN)";"RN";"PORTO DO MANGUE";43;13;10;66
2012;"PUREZA (RN)";"RN";"PUREZA";62;5;14;81
2012;"RAFAEL FERNANDES (RN)";"RN";"RAFAEL FERNANDES";13;5;2;20
2012;"RAFAEL GODEIRO (RN)";"RN";"RAFAEL GODEIRO";10;1;1;12
2012;"RIACHO DA CRUZ (RN)";"RN";"RIACHO DA CRUZ";7;3;1;11
2012;"RIACHO DE SANTANA (RN)";"RN";"RIACHO DE SANTANA";4;9;3;16
2012;"RIACHUELO (RN)";"RN";"RIACHUELO";27;2;4;33
2012;"RIO DO FOGO (RN)";"RN";"RIO DO FOGO";32;5;7;44
2012;"RODOLFO FERNANDES (RN)";"RN";"RODOLFO FERNANDES";11;6;1;18
2012;"RUY BARBOSA (RN)";"RN";"RUY BARBOSA";13;1;3;17
2012;"SANTA CRUZ (RN)";"RN";"SANTA CRUZ";407;24;29;460
2012;"SANTA MARIA (RN)";"RN";"SANTA MARIA";55;4;6;65
2012;"SANTANA DO MATOS (RN)";"RN";"SANTANA DO MATOS";70;14;8;92
2012;"SANTANA DO SERIDO (RN)";"RN";"SANTANA DO SERIDO";17;4;1;22
2012;"SANTO ANTONIO (RN)";"RN";"SANTO ANTONIO";88;39;21;148
2012;"SAO BENTO DO NORTE (RN)";"RN";"SAO BENTO DO NORTE";6;0;6;12
2012;"SAO BENTO DO TRAIRI (RN)";"RN";"SAO BENTO DO TRAIRI";18;1;2;21
2012;"SAO FERNANDO (RN)";"RN";"SAO FERNANDO";12;11;3;26
2012;"SAO FRANCISCO DO OESTE (RN)";"RN";"SAO FRANCISCO DO OESTE";18;4;2;24
2012;"SAO GONCALO DO AMARANTE (RN)";"RN";"SAO GONCALO DO AMARANTE";366;105;250;721
2012;"SAO JOAO DO SABUGI (RN)";"RN";"SAO JOAO DO SABUGI";44;20;2;66
2012;"SAO JOSE DE MIPIBU (RN)";"RN";"SAO JOSE DE MIPIBU";240;33;57;330
2012;"SAO JOSE DO CAMPESTRE (RN)";"RN";"SAO JOSE DO CAMPESTRE";70;4;13;87
2012;"SAO JOSE DO SERIDO (RN)";"RN";"SAO JOSE DO SERIDO";27;8;2;37
2012;"SAO MIGUEL (RN)";"RN";"SAO MIGUEL";165;34;21;220
2012;"SAO MIGUEL DO GOSTOSO (RN)";"RN";"SAO MIGUEL DO GOSTOSO";19;8;11;38
2012;"SAO PAULO DO POTENGI (RN)";"RN";"SAO PAULO DO POTENGI";115;10;16;141
2012;"SAO PEDRO (RN)";"RN";"SAO PEDRO";30;2;5;37
2012;"SAO RAFAEL (RN)";"RN";"SAO RAFAEL";28;11;3;42
2012;"SAO TOME (RN)";"RN";"SAO TOME";57;5;25;87
2012;"SAO VICENTE (RN)";"RN";"SAO VICENTE";46;5;5;56
2012;"SENADOR ELOI DE SOUZA (RN)";"RN";"SENADOR ELOI DE SOUZA";14;3;7;24
2012;"SENADOR GEORGINO AVELINO (RN)";"RN";"SENADOR GEORGINO AVELINO";10;2;3;15
2012;"SERRA CAIADA (RN)";"RN";"SERRA CAIADA";34;5;10;49
2012;"SERRA DE SAO BENTO (RN)";"RN";"SERRA DE SAO BENTO";26;6;3;35
2012;"SERRA DO MEL (RN)";"RN";"SERRA DO MEL";76;10;10;96
2012;"SERRA NEGRA DO NORTE (RN)";"RN";"SERRA NEGRA DO NORTE";73;16;4;93
2012;"SERRINHA (RN)";"RN";"SERRINHA";25;15;8;48
2012;"SERRINHA DOS PINTOS (RN)";"RN";"SERRINHA DOS PINTOS";26;8;2;36
2012;"SEVERIANO MELO (RN)";"RN";"SEVERIANO MELO";26;5;6;37
2012;"SITIO NOVO (RN)";"RN";"SITIO NOVO";19;4;1;24
2012;"TABOLEIRO GRANDE (RN)";"RN";"TABOLEIRO GRANDE";6;8;2;16
2012;"TAIPU (RN)";"RN";"TAIPU";59;3;13;75
2012;"TANGARA (RN)";"RN";"TANGARA";111;8;26;145
2012;"TENENTE ANANIAS (RN)";"RN";"TENENTE ANANIAS";37;12;3;52
2012;"TENENTE LAURENTINO CRUZ (RN)";"RN";"TENENTE LAURENTINO CRUZ";42;6;5;53
2012;"TIBAU (RN)";"RN";"TIBAU";24;9;12;45
2012;"TIBAU DO SUL (RN)";"RN";"TIBAU DO SUL";42;37;12;91
2012;"TIMBAUBA DOS BATISTAS (RN)";"RN";"TIMBAUBA DOS BATISTAS";18;7;2;27
2012;"TOUROS (RN)";"RN";"TOUROS";158;32;42;232
2012;"TRIUNFO POTIGUAR (RN)";"RN";"TRIUNFO POTIGUAR";11;8;1;20
2012;"UMARIZAL (RN)";"RN";"UMARIZAL";54;26;3;83
2012;"UPANEMA (RN)";"RN";"UPANEMA";57;11;10;78
2012;"VARZEA (RN)";"RN";"VARZEA";10;4;7;21
2012;"VENHA VER (RN)";"RN";"VENHA VER";17;8;2;27
2012;"VERA CRUZ (RN)";"RN";"VERA CRUZ";136;6;25;167
2012;"VICOSA (RN)";"RN";"VICOSA";3;1;1;5
2012;"VILA FLOR (RN)";"RN";"VILA FLOR";11;1;3;15
2012;"ALTA FLORESTA D OESTE (RO)";"RO";"ALTA FLORESTA D OESTE";545;15;46;606
2012;"ALTO ALEGRE DOS PARECIS (RO)";"RO";"ALTO ALEGRE DOS PARECIS";117;10;20;147
2012;"ALTO PARAISO (RO)";"RO";"ALTO PARAISO";252;5;54;311
2012;"ALVORADA D OESTE (RO)";"RO";"ALVORADA D OESTE";257;7;62;326
2012;"ARIQUEMES (RO)";"RO";"ARIQUEMES";2125;31;179;2335
2012;"BURITIS (RO)";"RO";"BURITIS";437;6;31;474
2012;"CABIXI (RO)";"RO";"CABIXI";72;2;15;89
2012;"CACAULANDIA (RO)";"RO";"CACAULANDIA";61;2;15;78
2012;"CACOAL (RO)";"RO";"CACOAL";1519;55;286;1860
2012;"CAMPO NOVO DE RONDONIA (RO)";"RO";"CAMPO NOVO DE RONDONIA";58;3;18;79
2012;"CANDEIAS DO JAMARI (RO)";"RO";"CANDEIAS DO JAMARI";156;3;20;179
2012;"CASTANHEIRAS (RO)";"RO";"CASTANHEIRAS";30;1;12;43
2012;"CEREJEIRAS (RO)";"RO";"CEREJEIRAS";315;7;47;369
2012;"CHUPINGUAIA (RO)";"RO";"CHUPINGUAIA";125;6;31;162
2012;"COLORADO DO OESTE (RO)";"RO";"COLORADO DO OESTE";373;9;46;428
2012;"CORUMBIARA (RO)";"RO";"CORUMBIARA";71;6;12;89
2012;"COSTA MARQUES (RO)";"RO";"COSTA MARQUES";86;4;15;105
2012;"CUJUBIM (RO)";"RO";"CUJUBIM";184;6;18;208
2012;"ESPIGAO D OESTE (RO)";"RO";"ESPIGAO D OESTE";523;5;86;614
2012;"GOVERNADOR JORGE TEIXEIRA (RO)";"RO";"GOVERNADOR JORGE TEIXEIRA";55;1;14;70
2012;"GUAJARA MIRIM (RO)";"RO";"GUAJARA MIRIM";854;12;44;910
2012;"ITAPUA DO OESTE (RO)";"RO";"ITAPUA DO OESTE";114;3;45;162
2012;"JARU (RO)";"RO";"JARU";1004;21;181;1206
2012;"JI PARANA (RO)";"RO";"JI PARANA";2601;78;565;3244
2012;"MACHADINHO D OESTE (RO)";"RO";"MACHADINHO D OESTE";329;7;48;384
2012;"MINISTRO ANDREAZZA (RO)";"RO";"MINISTRO ANDREAZZA";165;3;14;182
2012;"MIRANTE DA SERRA (RO)";"RO";"MIRANTE DA SERRA";179;6;26;211
2012;"MONTE NEGRO (RO)";"RO";"MONTE NEGRO";249;11;54;314
2012;"NOVA BRASILANDIA D OESTE (RO)";"RO";"NOVA BRASILANDIA D OESTE";233;8;45;286
2012;"NOVA DO MAMORE (RO)";"RO";"NOVA DO MAMORE";228;2;26;256
2012;"NOVA UNIAO (RO)";"RO";"NOVA UNIAO";50;1;17;68
2012;"NOVO HORIZONTE DO OESTE (RO)";"RO";"NOVO HORIZONTE DO OESTE";88;0;15;103
2012;"OURO PRETO DO OESTE (RO)";"RO";"OURO PRETO DO OESTE";742;27;103;872
2012;"PARECIS (RO)";"RO";"PARECIS";27;2;15;44
2012;"PIMENTA BUENO (RO)";"RO";"PIMENTA BUENO";972;28;71;1071
2012;"PIMENTEIRAS DO OESTE (RO)";"RO";"PIMENTEIRAS DO OESTE";11;1;11;23
2012;"PORTO VELHO (RO)";"RO";"PORTO VELHO";6191;417;1601;8209
2012;"PRESIDENTE MEDICI (RO)";"RO";"PRESIDENTE MEDICI";304;6;40;350
2012;"PRIMAVERA DE RONDONIA (RO)";"RO";"PRIMAVERA DE RONDONIA";29;3;11;43
2012;"RIO CRESPO (RO)";"RO";"RIO CRESPO";46;1;18;65
2012;"ROLIM DE MOURA (RO)";"RO";"ROLIM DE MOURA";1094;35;111;1240
2012;"SANTA LUZIA D OESTE (RO)";"RO";"SANTA LUZIA D OESTE";139;4;40;183
2012;"SAO FELIPE D OESTE (RO)";"RO";"SAO FELIPE D OESTE";69;2;22;93
2012;"SAO FRANCISCO DO GUAPORE (RO)";"RO";"SAO FRANCISCO DO GUAPORE";243;3;53;299
2012;"SAO MIGUEL DO GUAPORE (RO)";"RO";"SAO MIGUEL DO GUAPORE";255;9;62;326
2012;"SERINGUEIRAS (RO)";"RO";"SERINGUEIRAS";187;5;24;216
2012;"TEIXEIROPOLIS (RO)";"RO";"TEIXEIROPOLIS";33;0;11;44
2012;"THEOBROMA (RO)";"RO";"THEOBROMA";69;2;19;90
2012;"URUPA (RO)";"RO";"URUPA";100;2;60;162
2012;"VALE DO ANARI (RO)";"RO";"VALE DO ANARI";76;3;14;93
2012;"VALE DO PARAISO (RO)";"RO";"VALE DO PARAISO";59;0;15;74
2012;"VILHENA (RO)";"RO";"VILHENA";1535;57;163;1755
2012;"ALTO ALEGRE (RR)";"RR";"ALTO ALEGRE";50;5;7;62
2012;"AMAJARI (RR)";"RR";"AMAJARI";19;5;2;26
2012;"BOA VISTA (RR)";"RR";"BOA VISTA";3068;394;641;4103
2012;"BONFIM (RR)";"RR";"BONFIM";14;1;1;16
2012;"CANTA (RR)";"RR";"CANTA";29;5;11;45
2012;"CARACARAI (RR)";"RR";"CARACARAI";96;6;7;109
2012;"CAROEBE (RR)";"RR";"CAROEBE";32;5;25;62
2012;"IRACEMA (RR)";"RR";"IRACEMA";22;16;1;39
2012;"MUCAJAI (RR)";"RR";"MUCAJAI";97;34;33;164
2012;"NORMANDIA (RR)";"RR";"NORMANDIA";11;0;1;12
2012;"PACARAIMA (RR)";"RR";"PACARAIMA";42;3;6;51
2012;"RORAINOPOLIS (RR)";"RR";"RORAINOPOLIS";101;19;13;133
2012;"SAO JOAO DA BALIZA (RR)";"RR";"SAO JOAO DA BALIZA";41;9;4;54
2012;"SAO LUIZ (RR)";"RR";"SAO LUIZ";33;4;4;41
2012;"UIRAMUTA (RR)";"RR";"UIRAMUTA";1;0;0;1
2012;"ACEGUA (RS)";"RS";"ACEGUA";62;17;14;93
2012;"AGUA SANTA (RS)";"RS";"AGUA SANTA";152;9;15;176
2012;"AGUDO (RS)";"RS";"AGUDO";300;12;59;371
2012;"AJURICABA (RS)";"RS";"AJURICABA";374;19;33;426
2012;"ALECRIM (RS)";"RS";"ALECRIM";82;5;26;113
2012;"ALEGRETE (RS)";"RS";"ALEGRETE";961;51;225;1237
2012;"ALEGRIA (RS)";"RS";"ALEGRIA";79;4;20;103
2012;"ALMIRANTE TAMANDARE DO SUL (RS)";"RS";"ALMIRANTE TAMANDARE DO SUL";80;10;3;93
2012;"ALPESTRE (RS)";"RS";"ALPESTRE";130;16;54;200
2012;"ALTO ALEGRE (RS)";"RS";"ALTO ALEGRE";88;6;7;101
2012;"ALTO FELIZ (RS)";"RS";"ALTO FELIZ";87;11;10;108
2012;"ALVORADA (RS)";"RS";"ALVORADA";1732;192;602;2526
2012;"AMARAL FERRADOR (RS)";"RS";"AMARAL FERRADOR";130;11;24;165
2012;"AMETISTA DO SUL (RS)";"RS";"AMETISTA DO SUL";63;5;54;122
2012;"ANDRE DA ROCHA (RS)";"RS";"ANDRE DA ROCHA";52;4;3;59
2012;"ANTA GORDA (RS)";"RS";"ANTA GORDA";235;21;16;272
2012;"ANTONIO PRADO (RS)";"RS";"ANTONIO PRADO";640;18;45;703
2012;"ARAMBARE (RS)";"RS";"ARAMBARE";67;6;11;84
2012;"ARARICA (RS)";"RS";"ARARICA";105;7;13;125
2012;"ARATIBA (RS)";"RS";"ARATIBA";163;31;27;221
2012;"ARROIO DO MEIO (RS)";"RS";"ARROIO DO MEIO";505;39;50;594
2012;"ARROIO DO PADRE (RS)";"RS";"ARROIO DO PADRE";79;7;13;99
2012;"ARROIO DO SAL (RS)";"RS";"ARROIO DO SAL";115;9;12;136
2012;"ARROIO DO TIGRE (RS)";"RS";"ARROIO DO TIGRE";283;24;37;344
2012;"ARROIO DOS RATOS (RS)";"RS";"ARROIO DOS RATOS";217;11;65;293
2012;"ARROIO GRANDE (RS)";"RS";"ARROIO GRANDE";247;18;59;324
2012;"ARVOREZINHA (RS)";"RS";"ARVOREZINHA";464;39;33;536
2012;"AUGUSTO PESTANA (RS)";"RS";"AUGUSTO PESTANA";414;14;32;460
2012;"AUREA (RS)";"RS";"AUREA";134;5;9;148
2012;"BAGE (RS)";"RS";"BAGE";1155;183;339;1677
2012;"BALNEARIO PINHAL (RS)";"RS";"BALNEARIO PINHAL";102;8;21;131
2012;"BARAO (RS)";"RS";"BARAO";186;30;42;258
2012;"BARAO DE COTEGIPE (RS)";"RS";"BARAO DE COTEGIPE";232;15;14;261
2012;"BARAO DO TRIUNFO (RS)";"RS";"BARAO DO TRIUNFO";116;22;33;171
2012;"BARRA DO GUARITA (RS)";"RS";"BARRA DO GUARITA";24;7;6;37
2012;"BARRA DO QUARAI (RS)";"RS";"BARRA DO QUARAI";29;3;14;46
2012;"BARRA DO RIBEIRO (RS)";"RS";"BARRA DO RIBEIRO";158;9;51;218
2012;"BARRA DO RIO AZUL (RS)";"RS";"BARRA DO RIO AZUL";39;9;11;59
2012;"BARRA FUNDA (RS)";"RS";"BARRA FUNDA";167;5;14;186
2012;"BARRACAO (RS)";"RS";"BARRACAO";145;7;19;171
2012;"BARROS CASSAL (RS)";"RS";"BARROS CASSAL";160;17;50;227
2012;"BENJAMIN CONSTANT DO SUL (RS)";"RS";"BENJAMIN CONSTANT DO SUL";25;4;9;38
2012;"BENTO GONCALVES (RS)";"RS";"BENTO GONCALVES";3330;271;322;3923
2012;"BOA VISTA DAS MISSOES (RS)";"RS";"BOA VISTA DAS MISSOES";95;5;14;114
2012;"BOA VISTA DO BURICA (RS)";"RS";"BOA VISTA DO BURICA";226;13;21;260
2012;"BOA VISTA DO CADEADO (RS)";"RS";"BOA VISTA DO CADEADO";93;2;19;114
2012;"BOA VISTA DO INCRA (RS)";"RS";"BOA VISTA DO INCRA";62;2;7;71
2012;"BOA VISTA DO SUL (RS)";"RS";"BOA VISTA DO SUL";316;7;11;334
2012;"BOM JESUS (RS)";"RS";"BOM JESUS";254;30;50;334
2012;"BOM PRINCIPIO (RS)";"RS";"BOM PRINCIPIO";443;27;32;502
2012;"BOM PROGRESSO (RS)";"RS";"BOM PROGRESSO";43;10;5;58
2012;"BOM RETIRO DO SUL (RS)";"RS";"BOM RETIRO DO SUL";189;18;31;238
2012;"BOQUEIRAO DO LEAO (RS)";"RS";"BOQUEIRAO DO LEAO";163;8;18;189
2012;"BOSSOROCA (RS)";"RS";"BOSSOROCA";175;3;24;202
2012;"BOZANO (RS)";"RS";"BOZANO";140;5;7;152
2012;"BRAGA (RS)";"RS";"BRAGA";68;2;14;84
2012;"BROCHIER (RS)";"RS";"BROCHIER";271;13;23;307
2012;"BUTIA (RS)";"RS";"BUTIA";439;23;107;569
2012;"CACAPAVA DO SUL (RS)";"RS";"CACAPAVA DO SUL";597;57;109;763
2012;"CACEQUI (RS)";"RS";"CACEQUI";134;18;23;175
2012;"CACHOEIRA DO SUL (RS)";"RS";"CACHOEIRA DO SUL";1198;96;225;1519
2012;"CACHOEIRINHA (RS)";"RS";"CACHOEIRINHA";2245;238;521;3004
2012;"CACIQUE DOBLE (RS)";"RS";"CACIQUE DOBLE";118;4;14;136
2012;"CAIBATE (RS)";"RS";"CAIBATE";129;8;4;141
2012;"CAICARA (RS)";"RS";"CAICARA";76;9;22;107
2012;"CAMAQUA (RS)";"RS";"CAMAQUA";1283;64;223;1570
2012;"CAMARGO (RS)";"RS";"CAMARGO";156;7;16;179
2012;"CAMBARA DO SUL (RS)";"RS";"CAMBARA DO SUL";263;10;32;305
2012;"CAMPESTRE DA SERRA (RS)";"RS";"CAMPESTRE DA SERRA";154;4;15;173
2012;"CAMPINA DAS MISSOES (RS)";"RS";"CAMPINA DAS MISSOES";145;11;31;187
2012;"CAMPINAS DO SUL (RS)";"RS";"CAMPINAS DO SUL";189;11;25;225
2012;"CAMPO BOM (RS)";"RS";"CAMPO BOM";750;84;99;933
2012;"CAMPO NOVO (RS)";"RS";"CAMPO NOVO";152;13;26;191
2012;"CAMPOS BORGES (RS)";"RS";"CAMPOS BORGES";136;12;14;162
2012;"CANDELARIA (RS)";"RS";"CANDELARIA";411;24;79;514
2012;"CANDIDO GODOI (RS)";"RS";"CANDIDO GODOI";225;12;20;257
2012;"CANDIOTA (RS)";"RS";"CANDIOTA";145;33;40;218
2012;"CANELA (RS)";"RS";"CANELA";538;84;117;739
2012;"CANGUCU (RS)";"RS";"CANGUCU";1065;102;185;1352
2012;"CANOAS (RS)";"RS";"CANOAS";4479;441;957;5877
2012;"CANUDOS DO VALE (RS)";"RS";"CANUDOS DO VALE";24;12;2;38
2012;"CAPAO BONITO DO SUL (RS)";"RS";"CAPAO BONITO DO SUL";43;2;7;52
2012;"CAPAO DA CANOA (RS)";"RS";"CAPAO DA CANOA";447;65;92;604
2012;"CAPAO DO CIPO (RS)";"RS";"CAPAO DO CIPO";93;7;10;110
2012;"CAPAO DO LEAO (RS)";"RS";"CAPAO DO LEAO";523;18;27;568
2012;"CAPELA DE SANTANA (RS)";"RS";"CAPELA DE SANTANA";205;15;12;232
2012;"CAPITAO (RS)";"RS";"CAPITAO";66;9;7;82
2012;"CAPIVARI DO SUL (RS)";"RS";"CAPIVARI DO SUL";136;12;6;154
2012;"CARAA (RS)";"RS";"CARAA";106;3;18;127
2012;"CARAZINHO (RS)";"RS";"CARAZINHO";1390;84;197;1671
2012;"CARLOS BARBOSA (RS)";"RS";"CARLOS BARBOSA";809;52;115;976
2012;"CARLOS GOMES (RS)";"RS";"CARLOS GOMES";30;4;7;41
2012;"CASCA (RS)";"RS";"CASCA";388;21;27;436
2012;"CASEIROS (RS)";"RS";"CASEIROS";143;7;13;163
2012;"CATUIPE (RS)";"RS";"CATUIPE";353;8;30;391
2012;"CAXIAS DO SUL (RS)";"RS";"CAXIAS DO SUL";8769;1364;1683;11816
2012;"CENTENARIO (RS)";"RS";"CENTENARIO";86;7;12;105
2012;"CERRITO (RS)";"RS";"CERRITO";198;9;12;219
2012;"CERRO BRANCO (RS)";"RS";"CERRO BRANCO";60;7;18;85
2012;"CERRO GRANDE (RS)";"RS";"CERRO GRANDE";39;2;12;53
2012;"CERRO GRANDE DO SUL (RS)";"RS";"CERRO GRANDE DO SUL";233;19;19;271
2012;"CERRO LARGO (RS)";"RS";"CERRO LARGO";363;10;39;412
2012;"CHAPADA (RS)";"RS";"CHAPADA";323;40;28;391
2012;"CHARQUEADAS (RS)";"RS";"CHARQUEADAS";359;69;98;526
2012;"CHARRUA (RS)";"RS";"CHARRUA";95;3;10;108
2012;"CHIAPETTA (RS)";"RS";"CHIAPETTA";138;8;13;159
2012;"CHUI (RS)";"RS";"CHUI";114;13;9;136
2012;"CHUVISCA (RS)";"RS";"CHUVISCA";113;7;30;150
2012;"CIDREIRA (RS)";"RS";"CIDREIRA";111;11;30;152
2012;"CIRIACO (RS)";"RS";"CIRIACO";147;14;15;176
2012;"COLINAS (RS)";"RS";"COLINAS";67;8;10;85
2012;"COLORADO (RS)";"RS";"COLORADO";208;15;11;234
2012;"CONDOR (RS)";"RS";"CONDOR";239;16;26;281
2012;"CONSTANTINA (RS)";"RS";"CONSTANTINA";306;20;79;405
2012;"COQUEIRO BAIXO (RS)";"RS";"COQUEIRO BAIXO";17;6;1;24
2012;"COQUEIROS DO SUL (RS)";"RS";"COQUEIROS DO SUL";113;4;11;128
2012;"CORONEL BARROS (RS)";"RS";"CORONEL BARROS";99;0;10;109
2012;"CORONEL BICACO (RS)";"RS";"CORONEL BICACO";206;18;19;243
2012;"CORONEL PILAR (RS)";"RS";"CORONEL PILAR";204;9;10;223
2012;"COTIPORA (RS)";"RS";"COTIPORA";218;9;13;240
2012;"COXILHA (RS)";"RS";"COXILHA";110;7;14;131
2012;"CRISSIUMAL (RS)";"RS";"CRISSIUMAL";323;21;47;391
2012;"CRISTAL (RS)";"RS";"CRISTAL";191;11;35;237
2012;"CRISTAL DO SUL (RS)";"RS";"CRISTAL DO SUL";37;5;19;61
2012;"CRUZ ALTA (RS)";"RS";"CRUZ ALTA";1181;91;116;1388
2012;"CRUZALTENSE (RS)";"RS";"CRUZALTENSE";59;7;7;73
2012;"CRUZEIRO DO SUL (RS)";"RS";"CRUZEIRO DO SUL";407;13;18;438
2012;"DAVID CANABARRO (RS)";"RS";"DAVID CANABARRO";170;8;24;202
2012;"DERRUBADAS (RS)";"RS";"DERRUBADAS";81;12;9;102
2012;"DEZESSEIS DE NOVEMBRO (RS)";"RS";"DEZESSEIS DE NOVEMBRO";57;3;6;66
2012;"DILERMANDO DE AGUIAR (RS)";"RS";"DILERMANDO DE AGUIAR";46;1;27;74
2012;"DOIS IRMAOS (RS)";"RS";"DOIS IRMAOS";457;27;112;596
2012;"DOIS IRMAOS DAS MISSOES (RS)";"RS";"DOIS IRMAOS DAS MISSOES";65;9;5;79
2012;"DOIS LAJEADOS (RS)";"RS";"DOIS LAJEADOS";125;2;17;144
2012;"DOM FELICIANO (RS)";"RS";"DOM FELICIANO";234;14;76;324
2012;"DOM PEDRITO (RS)";"RS";"DOM PEDRITO";580;33;46;659
2012;"DOM PEDRO DE ALCANTARA (RS)";"RS";"DOM PEDRO DE ALCANTARA";87;3;5;95
2012;"DONA FRANCISCA (RS)";"RS";"DONA FRANCISCA";51;1;10;62
2012;"DOUTOR MAURICIO CARDOSO (RS)";"RS";"DOUTOR MAURICIO CARDOSO";188;13;16;217
2012;"DOUTOR RICARDO (RS)";"RS";"DOUTOR RICARDO";64;8;7;79
2012;"ELDORADO DO SUL (RS)";"RS";"ELDORADO DO SUL";505;38;46;589
2012;"ENCANTADO (RS)";"RS";"ENCANTADO";723;49;127;899
2012;"ENCRUZILHADA DO SUL (RS)";"RS";"ENCRUZILHADA DO SUL";373;22;169;564
2012;"ENGENHO VELHO (RS)";"RS";"ENGENHO VELHO";34;1;14;49
2012;"ENTRE IJUIS (RS)";"RS";"ENTRE IJUIS";309;10;28;347
2012;"ENTRE RIOS DO SUL (RS)";"RS";"ENTRE RIOS DO SUL";54;14;19;87
2012;"EREBANGO (RS)";"RS";"EREBANGO";111;2;7;120
2012;"ERECHIM (RS)";"RS";"ERECHIM";2012;284;488;2784
2012;"ERNESTINA (RS)";"RS";"ERNESTINA";150;23;17;190
2012;"ERVAL GRANDE (RS)";"RS";"ERVAL GRANDE";110;24;18;152
2012;"ERVAL SECO (RS)";"RS";"ERVAL SECO";151;7;34;192
2012;"ESMERALDA (RS)";"RS";"ESMERALDA";79;4;11;94
2012;"ESPERANCA DO SUL (RS)";"RS";"ESPERANCA DO SUL";44;3;10;57
2012;"ESPUMOSO (RS)";"RS";"ESPUMOSO";662;30;71;763
2012;"ESTACAO (RS)";"RS";"ESTACAO";206;16;11;233
2012;"ESTANCIA VELHA (RS)";"RS";"ESTANCIA VELHA";788;68;112;968
2012;"ESTEIO (RS)";"RS";"ESTEIO";1135;136;306;1577
2012;"ESTRELA (RS)";"RS";"ESTRELA";1063;39;71;1173
2012;"ESTRELA VELHA (RS)";"RS";"ESTRELA VELHA";115;7;15;137
2012;"EUGENIO DE CASTRO (RS)";"RS";"EUGENIO DE CASTRO";93;9;10;112
2012;"FAGUNDES VARELA (RS)";"RS";"FAGUNDES VARELA";109;4;17;130
2012;"FARROUPILHA (RS)";"RS";"FARROUPILHA";2071;231;179;2481
2012;"FAXINAL DO SOTURNO (RS)";"RS";"FAXINAL DO SOTURNO";134;6;9;149
2012;"FAXINALZINHO (RS)";"RS";"FAXINALZINHO";51;9;11;71
2012;"FAZENDA VILANOVA (RS)";"RS";"FAZENDA VILANOVA";150;12;17;179
2012;"FELIZ (RS)";"RS";"FELIZ";429;32;85;546
2012;"FLORES DA CUNHA (RS)";"RS";"FLORES DA CUNHA";1462;73;110;1645
2012;"FLORIANO PEIXOTO (RS)";"RS";"FLORIANO PEIXOTO";70;16;15;101
2012;"FONTOURA XAVIER (RS)";"RS";"FONTOURA XAVIER";203;20;39;262
2012;"FORMIGUEIRO (RS)";"RS";"FORMIGUEIRO";150;5;25;180
2012;"FORQUETINHA (RS)";"RS";"FORQUETINHA";72;4;4;80
2012;"FORTALEZA DOS VALOS (RS)";"RS";"FORTALEZA DOS VALOS";235;6;20;261
2012;"FREDERICO WESTPHALEN (RS)";"RS";"FREDERICO WESTPHALEN";720;37;97;854
2012;"GARIBALDI (RS)";"RS";"GARIBALDI";1374;75;121;1570
2012;"GARRUCHOS (RS)";"RS";"GARRUCHOS";44;10;16;70
2012;"GAURAMA (RS)";"RS";"GAURAMA";192;18;20;230
2012;"GENERAL CAMARA (RS)";"RS";"GENERAL CAMARA";90;7;20;117
2012;"GENTIL (RS)";"RS";"GENTIL";92;9;19;120
2012;"GETULIO VARGAS (RS)";"RS";"GETULIO VARGAS";496;26;33;555
2012;"GIRUA (RS)";"RS";"GIRUA";538;37;48;623
2012;"GLORINHA (RS)";"RS";"GLORINHA";206;29;13;248
2012;"GRAMADO (RS)";"RS";"GRAMADO";654;146;142;942
2012;"GRAMADO DOS LOUREIROS (RS)";"RS";"GRAMADO DOS LOUREIROS";32;2;11;45
2012;"GRAMADO XAVIER (RS)";"RS";"GRAMADO XAVIER";57;5;5;67
2012;"GRAVATAI (RS)";"RS";"GRAVATAI";3316;522;596;4434
2012;"GUABIJU (RS)";"RS";"GUABIJU";45;6;10;61
2012;"GUAIBA (RS)";"RS";"GUAIBA";994;180;401;1575
2012;"GUAPORE (RS)";"RS";"GUAPORE";477;40;75;592
2012;"GUARANI DAS MISSOES (RS)";"RS";"GUARANI DAS MISSOES";239;7;20;266
2012;"HARMONIA (RS)";"RS";"HARMONIA";220;6;11;237
2012;"HERVAL (RS)";"RS";"HERVAL";111;13;10;134
2012;"HERVEIRAS (RS)";"RS";"HERVEIRAS";56;1;2;59
2012;"HORIZONTINA (RS)";"RS";"HORIZONTINA";350;31;53;434
2012;"HULHA NEGRA (RS)";"RS";"HULHA NEGRA";56;7;33;96
2012;"HUMAITA (RS)";"RS";"HUMAITA";122;6;10;138
2012;"IBARAMA (RS)";"RS";"IBARAMA";96;5;19;120
2012;"IBIACA (RS)";"RS";"IBIACA";260;11;21;292
2012;"IBIRAIARAS (RS)";"RS";"IBIRAIARAS";445;10;23;478
2012;"IBIRAPUITA (RS)";"RS";"IBIRAPUITA";132;11;41;184
2012;"IBIRUBA (RS)";"RS";"IBIRUBA";891;60;77;1028
2012;"IGREJINHA (RS)";"RS";"IGREJINHA";425;39;98;562
2012;"IJUI (RS)";"RS";"IJUI";1865;118;131;2114
2012;"ILOPOLIS (RS)";"RS";"ILOPOLIS";199;5;8;212
2012;"IMBE (RS)";"RS";"IMBE";260;20;49;329
2012;"IMIGRANTE (RS)";"RS";"IMIGRANTE";93;19;17;129
2012;"INDEPENDENCIA (RS)";"RS";"INDEPENDENCIA";213;19;39;271
2012;"INHACORA (RS)";"RS";"INHACORA";64;6;8;78
2012;"IPE (RS)";"RS";"IPE";285;28;23;336
2012;"IPIRANGA DO SUL (RS)";"RS";"IPIRANGA DO SUL";117;10;14;141
2012;"IRAI (RS)";"RS";"IRAI";126;6;23;155
2012;"ITAARA (RS)";"RS";"ITAARA";112;5;20;137
2012;"ITACURUBI (RS)";"RS";"ITACURUBI";37;6;9;52
2012;"ITAPUCA (RS)";"RS";"ITAPUCA";52;4;8;64
2012;"ITAQUI (RS)";"RS";"ITAQUI";636;23;71;730
2012;"ITATI (RS)";"RS";"ITATI";77;5;11;93
2012;"ITATIBA DO SUL (RS)";"RS";"ITATIBA DO SUL";76;14;8;98
2012;"IVORA (RS)";"RS";"IVORA";66;3;5;74
2012;"IVOTI (RS)";"RS";"IVOTI";544;40;102;686
2012;"JABOTICABA (RS)";"RS";"JABOTICABA";68;4;16;88
2012;"JACUIZINHO (RS)";"RS";"JACUIZINHO";55;4;16;75
2012;"JACUTINGA (RS)";"RS";"JACUTINGA";111;9;7;127
2012;"JAGUARAO (RS)";"RS";"JAGUARAO";302;18;48;368
2012;"JAGUARI (RS)";"RS";"JAGUARI";248;20;56;324
2012;"JAQUIRANA (RS)";"RS";"JAQUIRANA";136;10;12;158
2012;"JARI (RS)";"RS";"JARI";64;6;12;82
2012;"JOIA (RS)";"RS";"JOIA";289;14;42;345
2012;"JULIO DE CASTILHOS (RS)";"RS";"JULIO DE CASTILHOS";598;24;61;683
2012;"LAGOA BONITA DO SUL (RS)";"RS";"LAGOA BONITA DO SUL";45;7;12;64
2012;"LAGOA DOS TRES CANTOS (RS)";"RS";"LAGOA DOS TRES CANTOS";87;7;4;98
2012;"LAGOA VERMELHA (RS)";"RS";"LAGOA VERMELHA";688;56;87;831
2012;"LAGOAO (RS)";"RS";"LAGOAO";73;5;32;110
2012;"LAJEADO (RS)";"RS";"LAJEADO";2053;166;259;2478
2012;"LAJEADO DO BUGRE (RS)";"RS";"LAJEADO DO BUGRE";24;2;10;36
2012;"LAVRAS DO SUL (RS)";"RS";"LAVRAS DO SUL";83;11;22;116
2012;"LIBERATO SALZANO (RS)";"RS";"LIBERATO SALZANO";117;9;30;156
2012;"LINDOLFO COLLOR (RS)";"RS";"LINDOLFO COLLOR";122;12;15;149
2012;"LINHA NOVA (RS)";"RS";"LINHA NOVA";70;8;5;83
2012;"MACAMBARA (RS)";"RS";"MACAMBARA";42;2;34;78
2012;"MACHADINHO (RS)";"RS";"MACHADINHO";113;7;26;146
2012;"MAMPITUBA (RS)";"RS";"MAMPITUBA";31;3;14;48
2012;"MANOEL VIANA (RS)";"RS";"MANOEL VIANA";147;6;14;167
2012;"MAQUINE (RS)";"RS";"MAQUINE";244;14;13;271
2012;"MARATA (RS)";"RS";"MARATA";118;11;21;150
2012;"MARAU (RS)";"RS";"MARAU";1068;83;157;1308
2012;"MARCELINO RAMOS (RS)";"RS";"MARCELINO RAMOS";136;17;28;181
2012;"MARIANA PIMENTEL (RS)";"RS";"MARIANA PIMENTEL";130;7;25;162
2012;"MARIANO MORO (RS)";"RS";"MARIANO MORO";68;11;8;87
2012;"MARQUES DE SOUZA (RS)";"RS";"MARQUES DE SOUZA";139;12;42;193
2012;"MATA (RS)";"RS";"MATA";95;5;22;122
2012;"MATO CASTELHANO (RS)";"RS";"MATO CASTELHANO";119;13;20;152
2012;"MATO LEITAO (RS)";"RS";"MATO LEITAO";123;7;9;139
2012;"MATO QUEIMADO (RS)";"RS";"MATO QUEIMADO";70;7;5;82
2012;"MAXIMILIANO DE ALMEIDA (RS)";"RS";"MAXIMILIANO DE ALMEIDA";139;11;102;252
2012;"MINAS DO LEAO (RS)";"RS";"MINAS DO LEAO";114;10;28;152
2012;"MIRAGUAI (RS)";"RS";"MIRAGUAI";100;4;28;132
2012;"MONTAURI (RS)";"RS";"MONTAURI";57;5;7;69
2012;"MONTE ALEGRE DOS CAMPOS (RS)";"RS";"MONTE ALEGRE DOS CAMPOS";78;2;29;109
2012;"MONTE BELO DO SUL (RS)";"RS";"MONTE BELO DO SUL";224;8;21;253
2012;"MONTENEGRO (RS)";"RS";"MONTENEGRO";1288;148;201;1637
2012;"MORMACO (RS)";"RS";"MORMACO";87;5;9;101
2012;"MORRINHOS DO SUL (RS)";"RS";"MORRINHOS DO SUL";138;1;6;145
2012;"MORRO REDONDO (RS)";"RS";"MORRO REDONDO";220;4;17;241
2012;"MORRO REUTER (RS)";"RS";"MORRO REUTER";166;10;19;195
2012;"MOSTARDAS (RS)";"RS";"MOSTARDAS";300;12;60;372
2012;"MUCUM (RS)";"RS";"MUCUM";83;9;16;108
2012;"MUITOS CAPOES (RS)";"RS";"MUITOS CAPOES";82;4;7;93
2012;"MULITERNO (RS)";"RS";"MULITERNO";105;4;8;117
2012;"NAO ME TOQUE (RS)";"RS";"NAO ME TOQUE";549;42;60;651
2012;"NICOLAU VERGUEIRO (RS)";"RS";"NICOLAU VERGUEIRO";88;6;12;106
2012;"NONOAI (RS)";"RS";"NONOAI";223;17;61;301
2012;"NOVA ALVORADA (RS)";"RS";"NOVA ALVORADA";154;7;16;177
2012;"NOVA ARACA (RS)";"RS";"NOVA ARACA";166;19;33;218
2012;"NOVA BASSANO (RS)";"RS";"NOVA BASSANO";501;41;60;602
2012;"NOVA BOA VISTA (RS)";"RS";"NOVA BOA VISTA";70;8;12;90
2012;"NOVA BRESCIA (RS)";"RS";"NOVA BRESCIA";119;14;12;145
2012;"NOVA CANDELARIA (RS)";"RS";"NOVA CANDELARIA";71;7;7;85
2012;"NOVA ESPERANCA DO SUL (RS)";"RS";"NOVA ESPERANCA DO SUL";82;7;26;115
2012;"NOVA HARTZ (RS)";"RS";"NOVA HARTZ";149;20;75;244
2012;"NOVA PADUA (RS)";"RS";"NOVA PADUA";312;3;6;321
2012;"NOVA PALMA (RS)";"RS";"NOVA PALMA";247;10;33;290
2012;"NOVA PETROPOLIS (RS)";"RS";"NOVA PETROPOLIS";528;35;71;634
2012;"NOVA PRATA (RS)";"RS";"NOVA PRATA";620;20;61;701
2012;"NOVA RAMADA (RS)";"RS";"NOVA RAMADA";109;7;10;126
2012;"NOVA ROMA DO SUL (RS)";"RS";"NOVA ROMA DO SUL";287;9;23;319
2012;"NOVA SANTA RITA (RS)";"RS";"NOVA SANTA RITA";821;49;52;922
2012;"NOVO BARREIRO (RS)";"RS";"NOVO BARREIRO";130;9;14;153
2012;"NOVO CABRAIS (RS)";"RS";"NOVO CABRAIS";86;1;9;96
2012;"NOVO HAMBURGO (RS)";"RS";"NOVO HAMBURGO";3098;295;403;3796
2012;"NOVO MACHADO (RS)";"RS";"NOVO MACHADO";151;19;11;181
2012;"NOVO TIRADENTES (RS)";"RS";"NOVO TIRADENTES";35;4;8;47
2012;"NOVO XINGU (RS)";"RS";"NOVO XINGU";37;9;10;56
2012;"OSORIO (RS)";"RS";"OSORIO";964;56;103;1123
2012;"PAIM FILHO (RS)";"RS";"PAIM FILHO";119;4;23;146
2012;"PALMARES DO SUL (RS)";"RS";"PALMARES DO SUL";176;20;32;228
2012;"PALMEIRA DAS MISSOES (RS)";"RS";"PALMEIRA DAS MISSOES";900;23;94;1017
2012;"PALMITINHO (RS)";"RS";"PALMITINHO";171;12;40;223
2012;"PANAMBI (RS)";"RS";"PANAMBI";995;63;119;1177
2012;"PANTANO GRANDE (RS)";"RS";"PANTANO GRANDE";301;6;27;334
2012;"PARAI (RS)";"RS";"PARAI";513;7;18;538
2012;"PARAISO DO SUL (RS)";"RS";"PARAISO DO SUL";91;6;16;113
2012;"PARECI NOVO (RS)";"RS";"PARECI NOVO";433;8;19;460
2012;"PAROBE (RS)";"RS";"PAROBE";529;64;149;742
2012;"PASSA SETE (RS)";"RS";"PASSA SETE";81;2;29;112
2012;"PASSO DO SOBRADO (RS)";"RS";"PASSO DO SOBRADO";132;7;47;186
2012;"PASSO FUNDO (RS)";"RS";"PASSO FUNDO";3390;227;382;3999
2012;"PAULO BENTO (RS)";"RS";"PAULO BENTO";81;14;9;104
2012;"PAVERAMA (RS)";"RS";"PAVERAMA";205;33;39;277
2012;"PEDRAS ALTAS (RS)";"RS";"PEDRAS ALTAS";18;16;2;36
2012;"PEDRO OSORIO (RS)";"RS";"PEDRO OSORIO";104;7;31;142
2012;"PEJUCARA (RS)";"RS";"PEJUCARA";223;3;18;244
2012;"PELOTAS (RS)";"RS";"PELOTAS";5326;344;1089;6759
2012;"PICADA CAFE (RS)";"RS";"PICADA CAFE";116;24;58;198
2012;"PINHAL (RS)";"RS";"PINHAL";83;2;9;94
2012;"PINHAL DA SERRA (RS)";"RS";"PINHAL DA SERRA";43;10;14;67
2012;"PINHAL GRANDE (RS)";"RS";"PINHAL GRANDE";112;12;26;150
2012;"PINHEIRINHO DO VALE (RS)";"RS";"PINHEIRINHO DO VALE";57;4;23;84
2012;"PINHEIRO MACHADO (RS)";"RS";"PINHEIRO MACHADO";141;9;56;206
2012;"PINTO BANDEIRA (RS)";"RS";"PINTO BANDEIRA";11;0;0;11
2012;"PIRAPO (RS)";"RS";"PIRAPO";45;7;9;61
2012;"PIRATINI (RS)";"RS";"PIRATINI";242;34;111;387
2012;"PLANALTO (RS)";"RS";"PLANALTO";209;9;34;252
2012;"POCO DAS ANTAS (RS)";"RS";"POCO DAS ANTAS";95;9;17;121
2012;"PONTAO (RS)";"RS";"PONTAO";110;4;23;137
2012;"PONTE PRETA (RS)";"RS";"PONTE PRETA";63;7;8;78
2012;"PORTAO (RS)";"RS";"PORTAO";1867;105;101;2073
2012;"PORTO ALEGRE (RS)";"RS";"PORTO ALEGRE";15605;2239;4776;22620
2012;"PORTO LUCENA (RS)";"RS";"PORTO LUCENA";90;12;18;120
2012;"PORTO MAUA (RS)";"RS";"PORTO MAUA";56;4;6;66
2012;"PORTO VERA CRUZ (RS)";"RS";"PORTO VERA CRUZ";13;3;8;24
2012;"PORTO XAVIER (RS)";"RS";"PORTO XAVIER";188;15;34;237
2012;"POUSO NOVO (RS)";"RS";"POUSO NOVO";39;6;5;50
2012;"PRESIDENTE LUCENA (RS)";"RS";"PRESIDENTE LUCENA";155;4;18;177
2012;"PROGRESSO (RS)";"RS";"PROGRESSO";107;13;22;142
2012;"PROTASIO ALVES (RS)";"RS";"PROTASIO ALVES";50;7;6;63
2012;"PUTINGA (RS)";"RS";"PUTINGA";102;13;11;126
2012;"QUARAI (RS)";"RS";"QUARAI";176;17;47;240
2012;"QUATRO IRMAOS (RS)";"RS";"QUATRO IRMAOS";56;11;5;72
2012;"QUEVEDOS (RS)";"RS";"QUEVEDOS";36;5;7;48
2012;"QUINZE DE NOVEMBRO (RS)";"RS";"QUINZE DE NOVEMBRO";187;22;21;230
2012;"REDENTORA (RS)";"RS";"REDENTORA";97;17;16;130
2012;"RELVADO (RS)";"RS";"RELVADO";43;13;3;59
2012;"RESTINGA SECA (RS)";"RS";"RESTINGA SECA";313;10;58;381
2012;"RIO DOS INDIOS (RS)";"RS";"RIO DOS INDIOS";69;4;26;99
2012;"RIO GRANDE (RS)";"RS";"RIO GRANDE";2210;202;695;3107
2012;"RIO PARDO (RS)";"RS";"RIO PARDO";462;40;71;573
2012;"RIOZINHO (RS)";"RS";"RIOZINHO";54;7;28;89
2012;"ROCA SALES (RS)";"RS";"ROCA SALES";171;19;40;230
2012;"RODEIO BONITO (RS)";"RS";"RODEIO BONITO";127;7;27;161
2012;"ROLADOR (RS)";"RS";"ROLADOR";60;4;6;70
2012;"ROLANTE (RS)";"RS";"ROLANTE";259;30;75;364
2012;"RONDA ALTA (RS)";"RS";"RONDA ALTA";280;16;27;323
2012;"RONDINHA (RS)";"RS";"RONDINHA";194;10;18;222
2012;"ROQUE GONZALES (RS)";"RS";"ROQUE GONZALES";135;4;21;160
2012;"ROSARIO DO SUL (RS)";"RS";"ROSARIO DO SUL";494;37;80;611
2012;"SAGRADA FAMILIA (RS)";"RS";"SAGRADA FAMILIA";38;5;8;51
2012;"SALDANHA MARINHO (RS)";"RS";"SALDANHA MARINHO";156;10;5;171
2012;"SALTO DO JACUI (RS)";"RS";"SALTO DO JACUI";207;20;33;260
2012;"SALVADOR DAS MISSOES (RS)";"RS";"SALVADOR DAS MISSOES";110;2;4;116
2012;"SALVADOR DO SUL (RS)";"RS";"SALVADOR DO SUL";280;30;26;336
2012;"SANANDUVA (RS)";"RS";"SANANDUVA";609;26;51;686
2012;"SANTA BARBARA DO SUL (RS)";"RS";"SANTA BARBARA DO SUL";355;20;37;412
2012;"SANTA CECILIA DO SUL (RS)";"RS";"SANTA CECILIA DO SUL";61;5;13;79
2012;"SANTA CLARA DO SUL (RS)";"RS";"SANTA CLARA DO SUL";131;22;11;164
2012;"SANTA CRUZ DO SUL (RS)";"RS";"SANTA CRUZ DO SUL";2192;165;602;2959
2012;"SANTA MARGARIDA DO SUL (RS)";"RS";"SANTA MARGARIDA DO SUL";43;3;3;49
2012;"SANTA MARIA (RS)";"RS";"SANTA MARIA";3397;376;961;4734
2012;"SANTA MARIA DO HERVAL (RS)";"RS";"SANTA MARIA DO HERVAL";221;15;52;288
2012;"SANTA ROSA (RS)";"RS";"SANTA ROSA";1525;92;164;1781
2012;"SANTA TEREZA (RS)";"RS";"SANTA TEREZA";88;4;4;96
2012;"SANTA VITORIA DO PALMAR (RS)";"RS";"SANTA VITORIA DO PALMAR";551;9;61;621
2012;"SANTANA DA BOA VISTA (RS)";"RS";"SANTANA DA BOA VISTA";79;12;40;131
2012;"SANTANA DO LIVRAMENTO (RS)";"RS";"SANTANA DO LIVRAMENTO";749;81;201;1031
2012;"SANTIAGO (RS)";"RS";"SANTIAGO";840;78;97;1015
2012;"SANTO ANGELO (RS)";"RS";"SANTO ANGELO";1261;90;114;1465
2012;"SANTO ANTONIO DA PATRULHA (RS)";"RS";"SANTO ANTONIO DA PATRULHA";917;48;170;1135
2012;"SANTO ANTONIO DAS MISSOES (RS)";"RS";"SANTO ANTONIO DAS MISSOES";173;36;31;240
2012;"SANTO ANTONIO DO PALMA (RS)";"RS";"SANTO ANTONIO DO PALMA";55;3;7;65
2012;"SANTO ANTONIO DO PLANALTO (RS)";"RS";"SANTO ANTONIO DO PLANALTO";93;4;8;105
2012;"SANTO AUGUSTO (RS)";"RS";"SANTO AUGUSTO";506;41;32;579
2012;"SANTO CRISTO (RS)";"RS";"SANTO CRISTO";456;21;48;525
2012;"SANTO EXPEDITO DO SUL (RS)";"RS";"SANTO EXPEDITO DO SUL";92;3;11;106
2012;"SAO BORJA (RS)";"RS";"SAO BORJA";1113;61;103;1277
2012;"SAO DOMINGOS DO SUL (RS)";"RS";"SAO DOMINGOS DO SUL";96;8;4;108
2012;"SAO FRANCISCO DE ASSIS (RS)";"RS";"SAO FRANCISCO DE ASSIS";295;17;95;407
2012;"SAO FRANCISCO DE PAULA (RS)";"RS";"SAO FRANCISCO DE PAULA";510;33;66;609
2012;"SAO GABRIEL (RS)";"RS";"SAO GABRIEL";872;30;114;1016
2012;"SAO JERONIMO (RS)";"RS";"SAO JERONIMO";269;23;111;403
2012;"SAO JOAO DA URTIGA (RS)";"RS";"SAO JOAO DA URTIGA";151;4;22;177
2012;"SAO JOAO DO POLESINE (RS)";"RS";"SAO JOAO DO POLESINE";70;1;7;78
2012;"SAO JORGE (RS)";"RS";"SAO JORGE";140;4;20;164
2012;"SAO JOSE DAS MISSOES (RS)";"RS";"SAO JOSE DAS MISSOES";45;2;10;57
2012;"SAO JOSE DO HERVAL (RS)";"RS";"SAO JOSE DO HERVAL";73;3;16;92
2012;"SAO JOSE DO HORTENCIO (RS)";"RS";"SAO JOSE DO HORTENCIO";185;8;28;221
2012;"SAO JOSE DO INHACORA (RS)";"RS";"SAO JOSE DO INHACORA";40;5;7;52
2012;"SAO JOSE DO NORTE (RS)";"RS";"SAO JOSE DO NORTE";339;9;71;419
2012;"SAO JOSE DO OURO (RS)";"RS";"SAO JOSE DO OURO";313;5;38;356
2012;"SAO JOSE DO SUL (RS)";"RS";"SAO JOSE DO SUL";138;12;8;158
2012;"SAO JOSE DOS AUSENTES (RS)";"RS";"SAO JOSE DOS AUSENTES";104;9;12;125
2012;"SAO LEOPOLDO (RS)";"RS";"SAO LEOPOLDO";2104;252;546;2902
2012;"SAO LOURENCO DO SUL (RS)";"RS";"SAO LOURENCO DO SUL";906;50;146;1102
2012;"SAO LUIZ GONZAGA (RS)";"RS";"SAO LUIZ GONZAGA";600;59;77;736
2012;"SAO MARCOS (RS)";"RS";"SAO MARCOS";710;22;121;853
2012;"SAO MARTINHO (RS)";"RS";"SAO MARTINHO";189;12;21;222
2012;"SAO MARTINHO DA SERRA (RS)";"RS";"SAO MARTINHO DA SERRA";41;3;4;48
2012;"SAO MIGUEL DAS MISSOES (RS)";"RS";"SAO MIGUEL DAS MISSOES";224;21;34;279
2012;"SAO NICOLAU (RS)";"RS";"SAO NICOLAU";72;12;12;96
2012;"SAO PAULO DAS MISSOES (RS)";"RS";"SAO PAULO DAS MISSOES";109;9;28;146
2012;"SAO PEDRO DA SERRA (RS)";"RS";"SAO PEDRO DA SERRA";105;10;11;126
2012;"SAO PEDRO DAS MISSOES (RS)";"RS";"SAO PEDRO DAS MISSOES";37;6;6;49
2012;"SAO PEDRO DO BUTIA (RS)";"RS";"SAO PEDRO DO BUTIA";113;1;11;125
2012;"SAO PEDRO DO SUL (RS)";"RS";"SAO PEDRO DO SUL";294;47;39;380
2012;"SAO SEBASTIAO DO CAI (RS)";"RS";"SAO SEBASTIAO DO CAI";756;28;64;848
2012;"SAO SEPE (RS)";"RS";"SAO SEPE";425;44;100;569
2012;"SAO VALENTIM (RS)";"RS";"SAO VALENTIM";60;13;14;87
2012;"SAO VALENTIM DO SUL (RS)";"RS";"SAO VALENTIM DO SUL";78;3;8;89
2012;"SAO VALERIO DO SUL (RS)";"RS";"SAO VALERIO DO SUL";41;3;8;52
2012;"SAO VENDELINO (RS)";"RS";"SAO VENDELINO";84;13;9;106
2012;"SAO VICENTE DO SUL (RS)";"RS";"SAO VICENTE DO SUL";131;6;44;181
2012;"SAPIRANGA (RS)";"RS";"SAPIRANGA";859;107;163;1129
2012;"SAPUCAIA DO SUL (RS)";"RS";"SAPUCAIA DO SUL";1631;131;128;1890
2012;"SARANDI (RS)";"RS";"SARANDI";597;50;70;717
2012;"SEBERI (RS)";"RS";"SEBERI";273;11;42;326
2012;"SEDE NOVA (RS)";"RS";"SEDE NOVA";80;12;12;104
2012;"SEGREDO (RS)";"RS";"SEGREDO";155;2;42;199
2012;"SELBACH (RS)";"RS";"SELBACH";314;10;22;346
2012;"SENADOR SALGADO FILHO (RS)";"RS";"SENADOR SALGADO FILHO";121;7;9;137
2012;"SENTINELA DO SUL (RS)";"RS";"SENTINELA DO SUL";138;2;15;155
2012;"SERAFINA CORREA (RS)";"RS";"SERAFINA CORREA";323;44;57;424
2012;"SERIO (RS)";"RS";"SERIO";55;8;4;67
2012;"SERTAO (RS)";"RS";"SERTAO";241;12;28;281
2012;"SERTAO SANTANA (RS)";"RS";"SERTAO SANTANA";161;9;25;195
2012;"SETE DE SETEMBRO (RS)";"RS";"SETE DE SETEMBRO";69;3;10;82
2012;"SEVERIANO DE ALMEIDA (RS)";"RS";"SEVERIANO DE ALMEIDA";97;18;11;126
2012;"SILVEIRA MARTINS (RS)";"RS";"SILVEIRA MARTINS";134;1;7;142
2012;"SINIMBU (RS)";"RS";"SINIMBU";134;2;5;141
2012;"SOBRADINHO (RS)";"RS";"SOBRADINHO";304;15;58;377
2012;"SOLEDADE (RS)";"RS";"SOLEDADE";569;31;115;715
2012;"TABAI (RS)";"RS";"TABAI";212;22;14;248
2012;"TAPEJARA (RS)";"RS";"TAPEJARA";775;28;88;891
2012;"TAPERA (RS)";"RS";"TAPERA";361;23;27;411
2012;"TAPES (RS)";"RS";"TAPES";286;19;35;340
2012;"TAQUARA (RS)";"RS";"TAQUARA";766;57;254;1077
2012;"TAQUARI (RS)";"RS";"TAQUARI";448;33;142;623
2012;"TAQUARUCU DO SUL (RS)";"RS";"TAQUARUCU DO SUL";75;1;14;90
2012;"TAVARES (RS)";"RS";"TAVARES";137;4;23;164
2012;"TENENTE PORTELA (RS)";"RS";"TENENTE PORTELA";271;14;48;333
2012;"TERRA DE AREIA (RS)";"RS";"TERRA DE AREIA";312;10;34;356
2012;"TEUTONIA (RS)";"RS";"TEUTONIA";690;33;93;816
2012;"TIO HUGO (RS)";"RS";"TIO HUGO";112;6;11;129
2012;"TIRADENTES DO SUL (RS)";"RS";"TIRADENTES DO SUL";91;6;12;109
2012;"TOROPI (RS)";"RS";"TOROPI";57;4;22;83
2012;"TORRES (RS)";"RS";"TORRES";436;31;62;529
2012;"TRAMANDAI (RS)";"RS";"TRAMANDAI";647;61;134;842
2012;"TRAVESSEIRO (RS)";"RS";"TRAVESSEIRO";46;8;12;66
2012;"TRES ARROIOS (RS)";"RS";"TRES ARROIOS";96;12;3;111
2012;"TRES CACHOEIRAS (RS)";"RS";"TRES CACHOEIRAS";625;11;19;655
2012;"TRES COROAS (RS)";"RS";"TRES COROAS";272;32;66;370
2012;"TRES DE MAIO (RS)";"RS";"TRES DE MAIO";707;44;75;826
2012;"TRES FORQUILHAS (RS)";"RS";"TRES FORQUILHAS";93;3;4;100
2012;"TRES PALMEIRAS (RS)";"RS";"TRES PALMEIRAS";71;5;25;101
2012;"TRES PASSOS (RS)";"RS";"TRES PASSOS";420;25;122;567
2012;"TRINDADE DO SUL (RS)";"RS";"TRINDADE DO SUL";116;15;23;154
2012;"TRIUNFO (RS)";"RS";"TRIUNFO";555;131;228;914
2012;"TUCUNDUVA (RS)";"RS";"TUCUNDUVA";229;13;14;256
2012;"TUNAS (RS)";"RS";"TUNAS";51;5;19;75
2012;"TUPANCI DO SUL (RS)";"RS";"TUPANCI DO SUL";53;3;16;72
2012;"TUPANCIRETA (RS)";"RS";"TUPANCIRETA";534;50;52;636
2012;"TUPANDI (RS)";"RS";"TUPANDI";111;22;32;165
2012;"TUPARENDI (RS)";"RS";"TUPARENDI";259;11;25;295
2012;"TURUCU (RS)";"RS";"TURUCU";91;6;13;110
2012;"UBIRETAMA (RS)";"RS";"UBIRETAMA";86;10;3;99
2012;"UNIAO DA SERRA (RS)";"RS";"UNIAO DA SERRA";62;3;16;81
2012;"UNISTALDA (RS)";"RS";"UNISTALDA";30;12;18;60
2012;"URUGUAIANA (RS)";"RS";"URUGUAIANA";1755;87;167;2009
2012;"VACARIA (RS)";"RS";"VACARIA";1671;143;480;2294
2012;"VALE DO SOL (RS)";"RS";"VALE DO SOL";193;11;41;245
2012;"VALE REAL (RS)";"RS";"VALE REAL";213;11;8;232
2012;"VALE VERDE (RS)";"RS";"VALE VERDE";59;5;5;69
2012;"VANINI (RS)";"RS";"VANINI";91;12;11;114
2012;"VENANCIO AIRES (RS)";"RS";"VENANCIO AIRES";1164;80;172;1416
2012;"VERA CRUZ (RS)";"RS";"VERA CRUZ";393;26;107;526
2012;"VERANOPOLIS (RS)";"RS";"VERANOPOLIS";944;41;63;1048
2012;"VESPASIANO CORREA (RS)";"RS";"VESPASIANO CORREA";104;6;12;122
2012;"VIADUTOS (RS)";"RS";"VIADUTOS";128;10;23;161
2012;"VIAMAO (RS)";"RS";"VIAMAO";2093;305;660;3058
2012;"VICENTE DUTRA (RS)";"RS";"VICENTE DUTRA";52;2;16;70
2012;"VICTOR GRAEFF (RS)";"RS";"VICTOR GRAEFF";157;13;6;176
2012;"VILA FLORES (RS)";"RS";"VILA FLORES";176;11;14;201
2012;"VILA LANGARO (RS)";"RS";"VILA LANGARO";107;5;12;124
2012;"VILA MARIA (RS)";"RS";"VILA MARIA";248;9;38;295
2012;"VILA NOVA DO SUL (RS)";"RS";"VILA NOVA DO SUL";94;9;12;115
2012;"VISTA ALEGRE (RS)";"RS";"VISTA ALEGRE";66;5;9;80
2012;"VISTA ALEGRE DO PRATA (RS)";"RS";"VISTA ALEGRE DO PRATA";42;9;2;53
2012;"VISTA GAUCHA (RS)";"RS";"VISTA GAUCHA";64;2;11;77
2012;"VITORIA DAS MISSOES (RS)";"RS";"VITORIA DAS MISSOES";99;0;16;115
2012;"WESTFALIA (RS)";"RS";"WESTFALIA";127;18;14;159
2012;"XANGRI LA (RS)";"RS";"XANGRI LA";182;17;11;210
2012;"ABDON BATISTA (SC)";"SC";"ABDON BATISTA";66;4;10;80
2012;"ABELARDO LUZ (SC)";"SC";"ABELARDO LUZ";382;14;84;480
2012;"AGROLANDIA (SC)";"SC";"AGROLANDIA";239;18;14;271
2012;"AGRONOMICA (SC)";"SC";"AGRONOMICA";162;7;16;185
2012;"AGUA DOCE (SC)";"SC";"AGUA DOCE";197;25;25;247
2012;"AGUAS DE CHAPECO (SC)";"SC";"AGUAS DE CHAPECO";81;8;24;113
2012;"AGUAS FRIAS (SC)";"SC";"AGUAS FRIAS";49;5;5;59
2012;"AGUAS MORNAS (SC)";"SC";"AGUAS MORNAS";275;6;19;300
2012;"ALFREDO WAGNER (SC)";"SC";"ALFREDO WAGNER";253;24;15;292
2012;"ALTO BELA VISTA (SC)";"SC";"ALTO BELA VISTA";57;8;7;72
2012;"ANCHIETA (SC)";"SC";"ANCHIETA";218;17;17;252
2012;"ANGELINA (SC)";"SC";"ANGELINA";214;20;13;247
2012;"ANITA GARIBALDI (SC)";"SC";"ANITA GARIBALDI";127;10;25;162
2012;"ANITAPOLIS (SC)";"SC";"ANITAPOLIS";100;8;12;120
2012;"ANTONIO CARLOS (SC)";"SC";"ANTONIO CARLOS";559;8;12;579
2012;"APIUNA (SC)";"SC";"APIUNA";170;23;22;215
2012;"ARABUTA (SC)";"SC";"ARABUTA";113;11;36;160
2012;"ARAQUARI (SC)";"SC";"ARAQUARI";576;47;46;669
2012;"ARARANGUA (SC)";"SC";"ARARANGUA";1309;65;177;1551
2012;"ARMAZEM (SC)";"SC";"ARMAZEM";258;14;15;287
2012;"ARROIO TRINTA (SC)";"SC";"ARROIO TRINTA";168;17;12;197
2012;"ARVOREDO (SC)";"SC";"ARVOREDO";38;18;6;62
2012;"ASCURRA (SC)";"SC";"ASCURRA";235;23;30;288
2012;"ATALANTA (SC)";"SC";"ATALANTA";92;2;6;100
2012;"AURORA (SC)";"SC";"AURORA";183;4;11;198
2012;"BALNEARIO ARROIO DO SILVA (SC)";"SC";"BALNEARIO ARROIO DO SILVA";111;6;13;130
2012;"BALNEARIO BARRA DO SUL (SC)";"SC";"BALNEARIO BARRA DO SUL";143;12;5;160
2012;"BALNEARIO CAMBORIU (SC)";"SC";"BALNEARIO CAMBORIU";975;255;301;1531
2012;"BALNEARIO DE PICARRAS (SC)";"SC";"BALNEARIO DE PICARRAS";313;29;36;378
2012;"BALNEARIO GAIVOTA (SC)";"SC";"BALNEARIO GAIVOTA";160;9;18;187
2012;"BANDEIRANTE (SC)";"SC";"BANDEIRANTE";45;3;12;60
2012;"BARRA BONITA (SC)";"SC";"BARRA BONITA";35;5;10;50
2012;"BARRA VELHA (SC)";"SC";"BARRA VELHA";451;36;35;522
2012;"BELA VISTA DO TOLDO (SC)";"SC";"BELA VISTA DO TOLDO";92;8;42;142
2012;"BELMONTE (SC)";"SC";"BELMONTE";56;8;10;74
2012;"BENEDITO NOVO (SC)";"SC";"BENEDITO NOVO";300;36;25;361
2012;"BIGUACU (SC)";"SC";"BIGUACU";1061;62;125;1248
2012;"BLUMENAU (SC)";"SC";"BLUMENAU";5271;398;764;6433
2012;"BOCAINA DO SUL (SC)";"SC";"BOCAINA DO SUL";56;3;17;76
2012;"BOM JARDIM DA SERRA (SC)";"SC";"BOM JARDIM DA SERRA";96;11;24;131
2012;"BOM JESUS (SC)";"SC";"BOM JESUS";58;3;8;69
2012;"BOM JESUS DO OESTE (SC)";"SC";"BOM JESUS DO OESTE";52;5;6;63
2012;"BOM RETIRO (SC)";"SC";"BOM RETIRO";171;18;32;221
2012;"BOMBINHAS (SC)";"SC";"BOMBINHAS";139;55;23;217
2012;"BOTUVERA (SC)";"SC";"BOTUVERA";222;7;15;244
2012;"BRACO DO NORTE (SC)";"SC";"BRACO DO NORTE";1075;49;62;1186
2012;"BRACO DO TROMBUDO (SC)";"SC";"BRACO DO TROMBUDO";125;7;3;135
2012;"BRUNOPOLIS (SC)";"SC";"BRUNOPOLIS";83;6;10;99
2012;"BRUSQUE (SC)";"SC";"BRUSQUE";2383;152;170;2705
2012;"CACADOR (SC)";"SC";"CACADOR";1972;111;749;2832
2012;"CAIBI (SC)";"SC";"CAIBI";176;5;25;206
2012;"CALMON (SC)";"SC";"CALMON";33;8;23;64
2012;"CAMBORIU (SC)";"SC";"CAMBORIU";1068;47;30;1145
2012;"CAMPO ALEGRE (SC)";"SC";"CAMPO ALEGRE";405;14;14;433
2012;"CAMPO BELO DO SUL (SC)";"SC";"CAMPO BELO DO SUL";179;11;30;220
2012;"CAMPO ERE (SC)";"SC";"CAMPO ERE";246;10;26;282
2012;"CAMPOS NOVOS (SC)";"SC";"CAMPOS NOVOS";970;77;99;1146
2012;"CANELINHA (SC)";"SC";"CANELINHA";529;20;9;558
2012;"CANOINHAS (SC)";"SC";"CANOINHAS";1253;53;136;1442
2012;"CAPAO ALTO (SC)";"SC";"CAPAO ALTO";64;5;14;83
2012;"CAPINZAL (SC)";"SC";"CAPINZAL";412;31;46;489
2012;"CAPIVARI DE BAIXO (SC)";"SC";"CAPIVARI DE BAIXO";365;17;27;409
2012;"CATANDUVAS (SC)";"SC";"CATANDUVAS";315;28;46;389
2012;"CAXAMBU DO SUL (SC)";"SC";"CAXAMBU DO SUL";101;4;16;121
2012;"CELSO RAMOS (SC)";"SC";"CELSO RAMOS";59;6;5;70
2012;"CERRO NEGRO (SC)";"SC";"CERRO NEGRO";47;6;19;72
2012;"CHAPADAO DO LAGEADO (SC)";"SC";"CHAPADAO DO LAGEADO";48;5;9;62
2012;"CHAPECO (SC)";"SC";"CHAPECO";4191;279;357;4827
2012;"COCAL DO SUL (SC)";"SC";"COCAL DO SUL";304;20;24;348
2012;"CONCORDIA (SC)";"SC";"CONCORDIA";2285;134;191;2610
2012;"CORDILHEIRA ALTA (SC)";"SC";"CORDILHEIRA ALTA";278;15;5;298
2012;"CORONEL FREITAS (SC)";"SC";"CORONEL FREITAS";245;11;26;282
2012;"CORONEL MARTINS (SC)";"SC";"CORONEL MARTINS";44;8;15;67
2012;"CORREIA PINTO (SC)";"SC";"CORREIA PINTO";358;40;57;455
2012;"CORUPA (SC)";"SC";"CORUPA";373;7;38;418
2012;"CRICIUMA (SC)";"SC";"CRICIUMA";3644;291;402;4337
2012;"CUNHA PORA (SC)";"SC";"CUNHA PORA";373;12;45;430
2012;"CUNHATAI (SC)";"SC";"CUNHATAI";31;3;8;42
2012;"CURITIBANOS (SC)";"SC";"CURITIBANOS";940;59;105;1104
2012;"DESCANSO (SC)";"SC";"DESCANSO";203;13;28;244
2012;"DIONISIO CERQUEIRA (SC)";"SC";"DIONISIO CERQUEIRA";143;19;18;180
2012;"DONA EMMA (SC)";"SC";"DONA EMMA";119;16;10;145
2012;"DOUTOR PEDRINHO (SC)";"SC";"DOUTOR PEDRINHO";126;7;6;139
2012;"ENTRE RIOS (SC)";"SC";"ENTRE RIOS";32;4;16;52
2012;"ERMO (SC)";"SC";"ERMO";69;3;6;78
2012;"ERVAL VELHO (SC)";"SC";"ERVAL VELHO";105;5;22;132
2012;"FAXINAL DOS GUEDES (SC)";"SC";"FAXINAL DOS GUEDES";396;21;33;450
2012;"FLOR DO SERTAO (SC)";"SC";"FLOR DO SERTAO";21;9;16;46
2012;"FLORIANOPOLIS (SC)";"SC";"FLORIANOPOLIS";3483;872;1914;6269
2012;"FORMOSA DO SUL (SC)";"SC";"FORMOSA DO SUL";68;8;12;88
2012;"FORQUILHINHA (SC)";"SC";"FORQUILHINHA";525;21;35;581
2012;"FRAIBURGO (SC)";"SC";"FRAIBURGO";830;44;207;1081
2012;"FREI ROGERIO (SC)";"SC";"FREI ROGERIO";71;13;12;96
2012;"GALVAO (SC)";"SC";"GALVAO";84;4;19;107
2012;"GAROPABA (SC)";"SC";"GAROPABA";238;26;36;300
2012;"GARUVA (SC)";"SC";"GARUVA";456;33;27;516
2012;"GASPAR (SC)";"SC";"GASPAR";1277;65;78;1420
2012;"GOVERNADOR CELSO RAMOS (SC)";"SC";"GOVERNADOR CELSO RAMOS";157;18;15;190
2012;"GRAO PARA (SC)";"SC";"GRAO PARA";259;7;12;278
2012;"GRAVATAL (SC)";"SC";"GRAVATAL";280;12;19;311
2012;"GUABIRUBA (SC)";"SC";"GUABIRUBA";327;14;20;361
2012;"GUARACIABA (SC)";"SC";"GUARACIABA";227;14;37;278
2012;"GUARAMIRIM (SC)";"SC";"GUARAMIRIM";1059;31;27;1117
2012;"GUARUJA DO SUL (SC)";"SC";"GUARUJA DO SUL";159;10;16;185
2012;"GUATAMBU (SC)";"SC";"GUATAMBU";88;10;22;120
2012;"HERVAL D OESTE (SC)";"SC";"HERVAL D OESTE";313;29;58;400
2012;"IBIAM (SC)";"SC";"IBIAM";66;3;14;83
2012;"IBICARE (SC)";"SC";"IBICARE";137;9;9;155
2012;"IBIRAMA (SC)";"SC";"IBIRAMA";441;50;70;561
2012;"ICARA (SC)";"SC";"ICARA";1831;87;126;2044
2012;"ILHOTA (SC)";"SC";"ILHOTA";333;26;21;380
2012;"IMARUI (SC)";"SC";"IMARUI";126;23;30;179
2012;"IMBITUBA (SC)";"SC";"IMBITUBA";619;75;79;773
2012;"IMBUIA (SC)";"SC";"IMBUIA";189;7;24;220
2012;"INDAIAL (SC)";"SC";"INDAIAL";1365;81;116;1562
2012;"IOMERE (SC)";"SC";"IOMERE";152;7;8;167
2012;"IPIRA (SC)";"SC";"IPIRA";112;8;17;137
2012;"IPORA DO OESTE (SC)";"SC";"IPORA DO OESTE";250;20;56;326
2012;"IPUACU (SC)";"SC";"IPUACU";106;10;22;138
2012;"IPUMIRIM (SC)";"SC";"IPUMIRIM";244;38;27;309
2012;"IRACEMINHA (SC)";"SC";"IRACEMINHA";98;5;21;124
2012;"IRANI (SC)";"SC";"IRANI";325;26;49;400
2012;"IRATI (SC)";"SC";"IRATI";28;7;8;43
2012;"IRINEOPOLIS (SC)";"SC";"IRINEOPOLIS";242;9;11;262
2012;"ITA (SC)";"SC";"ITA";93;16;32;141
2012;"ITAIOPOLIS (SC)";"SC";"ITAIOPOLIS";568;27;80;675
2012;"ITAJAI (SC)";"SC";"ITAJAI";4178;274;348;4800
2012;"ITAPEMA (SC)";"SC";"ITAPEMA";545;52;41;638
2012;"ITAPIRANGA (SC)";"SC";"ITAPIRANGA";309;17;57;383
2012;"ITAPOA (SC)";"SC";"ITAPOA";189;7;11;207
2012;"ITUPORANGA (SC)";"SC";"ITUPORANGA";661;33;46;740
2012;"JABORA (SC)";"SC";"JABORA";125;15;24;164
2012;"JACINTO MACHADO (SC)";"SC";"JACINTO MACHADO";388;16;36;440
2012;"JAGUARUNA (SC)";"SC";"JAGUARUNA";451;21;48;520
2012;"JARAGUA DO SUL (SC)";"SC";"JARAGUA DO SUL";2453;211;355;3019
2012;"JARDINOPOLIS (SC)";"SC";"JARDINOPOLIS";18;4;2;24
2012;"JOACABA (SC)";"SC";"JOACABA";869;78;36;983
2012;"JOINVILLE (SC)";"SC";"JOINVILLE";8140;681;859;9680
2012;"JOSE BOITEUX (SC)";"SC";"JOSE BOITEUX";117;24;7;148
2012;"JUPIA (SC)";"SC";"JUPIA";42;5;7;54
2012;"LACERDOPOLIS (SC)";"SC";"LACERDOPOLIS";103;7;5;115
2012;"LAGEADO GRANDE (SC)";"SC";"LAGEADO GRANDE";37;2;5;44
2012;"LAGES (SC)";"SC";"LAGES";3352;243;363;3958
2012;"LAGUNA (SC)";"SC";"LAGUNA";590;95;103;788
2012;"LAURENTINO (SC)";"SC";"LAURENTINO";319;6;4;329
2012;"LAURO MULLER (SC)";"SC";"LAURO MULLER";464;25;44;533
2012;"LEBON REGIS (SC)";"SC";"LEBON REGIS";214;22;43;279
2012;"LEOBERTO LEAL (SC)";"SC";"LEOBERTO LEAL";116;12;6;134
2012;"LINDOIA DO SUL (SC)";"SC";"LINDOIA DO SUL";151;15;42;208
2012;"LONTRAS (SC)";"SC";"LONTRAS";304;19;33;356
2012;"LUIZ ALVES (SC)";"SC";"LUIZ ALVES";446;6;19;471
2012;"LUZERNA (SC)";"SC";"LUZERNA";135;11;18;164
2012;"MACIEIRA (SC)";"SC";"MACIEIRA";65;8;13;86
2012;"MAFRA (SC)";"SC";"MAFRA";1339;90;152;1581
2012;"MAJOR GERCINO (SC)";"SC";"MAJOR GERCINO";128;8;10;146
2012;"MAJOR VIEIRA (SC)";"SC";"MAJOR VIEIRA";199;3;13;215
2012;"MARACAJA (SC)";"SC";"MARACAJA";220;2;13;235
2012;"MARAVILHA (SC)";"SC";"MARAVILHA";712;51;67;830
2012;"MAREMA (SC)";"SC";"MAREMA";56;10;6;72
2012;"MASSARANDUBA (SC)";"SC";"MASSARANDUBA";527;22;37;586
2012;"MATOS COSTA (SC)";"SC";"MATOS COSTA";46;6;10;62
2012;"MELEIRO (SC)";"SC";"MELEIRO";270;3;19;292
2012;"MIRIM DOCE (SC)";"SC";"MIRIM DOCE";55;3;11;69
2012;"MODELO (SC)";"SC";"MODELO";117;8;8;133
2012;"MONDAI (SC)";"SC";"MONDAI";191;11;50;252
2012;"MONTE CARLO (SC)";"SC";"MONTE CARLO";163;15;98;276
2012;"MONTE CASTELO (SC)";"SC";"MONTE CASTELO";164;11;21;196
2012;"MORRO DA FUMACA (SC)";"SC";"MORRO DA FUMACA";838;25;28;891
2012;"MORRO GRANDE (SC)";"SC";"MORRO GRANDE";117;2;7;126
2012;"NAVEGANTES (SC)";"SC";"NAVEGANTES";723;81;56;860
2012;"NOVA ERECHIM (SC)";"SC";"NOVA ERECHIM";108;7;10;125
2012;"NOVA ITABERABA (SC)";"SC";"NOVA ITABERABA";90;3;16;109
2012;"NOVA TRENTO (SC)";"SC";"NOVA TRENTO";279;30;32;341
2012;"NOVA VENEZA (SC)";"SC";"NOVA VENEZA";424;30;31;485
2012;"NOVO HORIZONTE (SC)";"SC";"NOVO HORIZONTE";66;9;13;88
2012;"ORLEANS (SC)";"SC";"ORLEANS";850;23;42;915
2012;"OTACILIO COSTA (SC)";"SC";"OTACILIO COSTA";401;52;43;496
2012;"OURO (SC)";"SC";"OURO";244;28;28;300
2012;"OURO VERDE (SC)";"SC";"OURO VERDE";87;3;10;100
2012;"PAIAL (SC)";"SC";"PAIAL";14;4;21;39
2012;"PAINEL (SC)";"SC";"PAINEL";34;3;9;46
2012;"PALHOCA (SC)";"SC";"PALHOCA";2188;138;394;2720
2012;"PALMA SOLA (SC)";"SC";"PALMA SOLA";190;8;27;225
2012;"PALMEIRA (SC)";"SC";"PALMEIRA";106;6;4;116
2012;"PALMITOS (SC)";"SC";"PALMITOS";354;36;51;441
2012;"PAPANDUVA (SC)";"SC";"PAPANDUVA";517;16;76;609
2012;"PARAISO (SC)";"SC";"PARAISO";74;6;8;88
2012;"PASSO DE TORRES (SC)";"SC";"PASSO DE TORRES";127;5;14;146
2012;"PASSOS MAIA (SC)";"SC";"PASSOS MAIA";106;1;27;134
2012;"PAULO LOPES (SC)";"SC";"PAULO LOPES";238;15;12;265
2012;"PEDRAS GRANDES (SC)";"SC";"PEDRAS GRANDES";238;15;13;266
2012;"PENHA (SC)";"SC";"PENHA";330;24;43;397
2012;"PERITIBA (SC)";"SC";"PERITIBA";81;7;14;102
2012;"PETROLANDIA (SC)";"SC";"PETROLANDIA";161;13;27;201
2012;"PINHALZINHO (SC)";"SC";"PINHALZINHO";454;16;56;526
2012;"PINHEIRO PRETO (SC)";"SC";"PINHEIRO PRETO";279;9;17;305
2012;"PIRATUBA (SC)";"SC";"PIRATUBA";100;13;29;142
2012;"PLANALTO ALEGRE (SC)";"SC";"PLANALTO ALEGRE";57;5;4;66
2012;"POMERODE (SC)";"SC";"POMERODE";650;28;98;776
2012;"PONTE ALTA (SC)";"SC";"PONTE ALTA";121;6;13;140
2012;"PONTE ALTA DO NORTE (SC)";"SC";"PONTE ALTA DO NORTE";87;4;12;103
2012;"PONTE SERRADA (SC)";"SC";"PONTE SERRADA";323;41;83;447
2012;"PORTO BELO (SC)";"SC";"PORTO BELO";234;18;28;280
2012;"PORTO UNIAO (SC)";"SC";"PORTO UNIAO";582;24;37;643
2012;"POUSO REDONDO (SC)";"SC";"POUSO REDONDO";475;24;35;534
2012;"PRAIA GRANDE (SC)";"SC";"PRAIA GRANDE";211;13;21;245
2012;"PRESIDENTE CASTELO BRANCO (SC)";"SC";"PRESIDENTE CASTELO BRANCO";59;5;7;71
2012;"PRESIDENTE GETULIO (SC)";"SC";"PRESIDENTE GETULIO";336;42;63;441
2012;"PRESIDENTE NEREU (SC)";"SC";"PRESIDENTE NEREU";35;9;7;51
2012;"PRINCESA (SC)";"SC";"PRINCESA";58;3;12;73
2012;"QUILOMBO (SC)";"SC";"QUILOMBO";211;30;46;287
2012;"RANCHO QUEIMADO (SC)";"SC";"RANCHO QUEIMADO";128;4;6;138
2012;"RIO DAS ANTAS (SC)";"SC";"RIO DAS ANTAS";186;5;25;216
2012;"RIO DO CAMPO (SC)";"SC";"RIO DO CAMPO";175;11;18;204
2012;"RIO DO OESTE (SC)";"SC";"RIO DO OESTE";200;13;22;235
2012;"RIO DO SUL (SC)";"SC";"RIO DO SUL";1487;90;116;1693
2012;"RIO DOS CEDROS (SC)";"SC";"RIO DOS CEDROS";243;26;28;297
2012;"RIO FORTUNA (SC)";"SC";"RIO FORTUNA";269;8;16;293
2012;"RIO NEGRINHO (SC)";"SC";"RIO NEGRINHO";998;72;74;1144
2012;"RIO RUFINO (SC)";"SC";"RIO RUFINO";58;8;16;82
2012;"RIQUEZA (SC)";"SC";"RIQUEZA";123;5;22;150
2012;"RODEIO (SC)";"SC";"RODEIO";250;15;16;281
2012;"ROMELANDIA (SC)";"SC";"ROMELANDIA";90;10;25;125
2012;"SALETE (SC)";"SC";"SALETE";161;12;19;192
2012;"SALTINHO (SC)";"SC";"SALTINHO";46;6;13;65
2012;"SALTO VELOSO (SC)";"SC";"SALTO VELOSO";150;4;7;161
2012;"SANGAO (SC)";"SC";"SANGAO";472;12;16;500
2012;"SANTA CECILIA (SC)";"SC";"SANTA CECILIA";378;36;50;464
2012;"SANTA HELENA (SC)";"SC";"SANTA HELENA";54;12;12;78
2012;"SANTA ROSA DE LIMA (SC)";"SC";"SANTA ROSA DE LIMA";110;7;11;128
2012;"SANTA ROSA DO SUL (SC)";"SC";"SANTA ROSA DO SUL";266;15;19;300
2012;"SANTA TEREZINHA (SC)";"SC";"SANTA TEREZINHA";176;18;27;221
2012;"SANTA TEREZINHA DO PROGRESSO (SC)";"SC";"SANTA TEREZINHA DO PROGRESSO";47;6;10;63
2012;"SANTIAGO DO SUL (SC)";"SC";"SANTIAGO DO SUL";51;6;4;61
2012;"SANTO AMARO DA IMPERATRIZ (SC)";"SC";"SANTO AMARO DA IMPERATRIZ";628;31;71;730
2012;"SAO BENTO DO SUL (SC)";"SC";"SAO BENTO DO SUL";1554;128;159;1841
2012;"SAO BERNARDINO (SC)";"SC";"SAO BERNARDINO";41;4;21;66
2012;"SAO BONIFACIO (SC)";"SC";"SAO BONIFACIO";116;6;11;133
2012;"SAO CARLOS (SC)";"SC";"SAO CARLOS";193;23;43;259
2012;"SAO CRISTOVAO DO SUL (SC)";"SC";"SAO CRISTOVAO DO SUL";226;5;14;245
2012;"SAO DOMINGOS (SC)";"SC";"SAO DOMINGOS";300;28;37;365
2012;"SAO FRANCISCO DO SUL (SC)";"SC";"SAO FRANCISCO DO SUL";581;68;88;737
2012;"SAO JOAO BATISTA (SC)";"SC";"SAO JOAO BATISTA";601;23;43;667
2012;"SAO JOAO DO ITAPERIU (SC)";"SC";"SAO JOAO DO ITAPERIU";210;4;7;221
2012;"SAO JOAO DO OESTE (SC)";"SC";"SAO JOAO DO OESTE";149;9;15;173
2012;"SAO JOAO DO SUL (SC)";"SC";"SAO JOAO DO SUL";214;3;14;231
2012;"SAO JOAQUIM (SC)";"SC";"SAO JOAQUIM";846;81;170;1097
2012;"SAO JOSE (SC)";"SC";"SAO JOSE";3594;263;206;4063
2012;"SAO JOSE DO CEDRO (SC)";"SC";"SAO JOSE DO CEDRO";410;17;70;497
2012;"SAO JOSE DO CERRITO (SC)";"SC";"SAO JOSE DO CERRITO";180;9;45;234
2012;"SAO LOURENCO D OESTE (SC)";"SC";"SAO LOURENCO D OESTE";798;48;65;911
2012;"SAO LUDGERO (SC)";"SC";"SAO LUDGERO";537;13;24;574
2012;"SAO MARTINHO (SC)";"SC";"SAO MARTINHO";142;9;9;160
2012;"SAO MIGUEL D OESTE (SC)";"SC";"SAO MIGUEL D OESTE";1007;62;99;1168
2012;"SAO MIGUEL DA BOA VISTA (SC)";"SC";"SAO MIGUEL DA BOA VISTA";16;2;12;30
2012;"SAO PEDRO DE ALCANTARA (SC)";"SC";"SAO PEDRO DE ALCANTARA";125;7;4;136
2012;"SAUDADES (SC)";"SC";"SAUDADES";209;7;27;243
2012;"SCHROEDER (SC)";"SC";"SCHROEDER";204;6;18;228
2012;"SEARA (SC)";"SC";"SEARA";376;48;67;491
2012;"SERRA ALTA (SC)";"SC";"SERRA ALTA";71;9;13;93
2012;"SIDEROPOLIS (SC)";"SC";"SIDEROPOLIS";402;26;74;502
2012;"SOMBRIO (SC)";"SC";"SOMBRIO";690;55;41;786
2012;"SUL BRASIL (SC)";"SC";"SUL BRASIL";46;4;12;62
2012;"TAIO (SC)";"SC";"TAIO";546;24;55;625
2012;"TANGARA (SC)";"SC";"TANGARA";405;13;43;461
2012;"TIGRINHOS (SC)";"SC";"TIGRINHOS";30;2;16;48
2012;"TIJUCAS (SC)";"SC";"TIJUCAS";884;46;49;979
2012;"TIMBE DO SUL (SC)";"SC";"TIMBE DO SUL";160;16;16;192
2012;"TIMBO (SC)";"SC";"TIMBO";652;47;47;746
2012;"TIMBO GRANDE (SC)";"SC";"TIMBO GRANDE";165;8;18;191
2012;"TRES BARRAS (SC)";"SC";"TRES BARRAS";277;30;55;362
2012;"TREVISO (SC)";"SC";"TREVISO";111;8;6;125
2012;"TREZE DE MAIO (SC)";"SC";"TREZE DE MAIO";394;8;18;420
2012;"TREZE TILIAS (SC)";"SC";"TREZE TILIAS";278;14;27;319
2012;"TROMBUDO CENTRAL (SC)";"SC";"TROMBUDO CENTRAL";211;16;21;248
2012;"TUBARAO (SC)";"SC";"TUBARAO";2411;86;382;2879
2012;"TUNAPOLIS (SC)";"SC";"TUNAPOLIS";96;14;17;127
2012;"TURVO (SC)";"SC";"TURVO";441;22;54;517
2012;"UNIAO DO OESTE (SC)";"SC";"UNIAO DO OESTE";44;3;16;63
2012;"URUBICI (SC)";"SC";"URUBICI";257;16;47;320
2012;"URUPEMA (SC)";"SC";"URUPEMA";66;10;11;87
2012;"URUSSANGA (SC)";"SC";"URUSSANGA";431;39;80;550
2012;"VARGEAO (SC)";"SC";"VARGEAO";132;3;13;148
2012;"VARGEM (SC)";"SC";"VARGEM";51;4;14;69
2012;"VARGEM BONITA (SC)";"SC";"VARGEM BONITA";145;11;23;179
2012;"VIDAL RAMOS (SC)";"SC";"VIDAL RAMOS";162;18;16;196
2012;"VIDEIRA (SC)";"SC";"VIDEIRA";1636;109;145;1890
2012;"VITOR MEIRELES (SC)";"SC";"VITOR MEIRELES";92;17;19;128
2012;"WITMARSUM (SC)";"SC";"WITMARSUM";113;10;15;138
2012;"XANXERE (SC)";"SC";"XANXERE";1224;118;118;1460
2012;"XAVANTINA (SC)";"SC";"XAVANTINA";154;15;6;175
2012;"XAXIM (SC)";"SC";"XAXIM";668;47;129;844
2012;"ZORTEA (SC)";"SC";"ZORTEA";37;10;4;51
2012;"AMPARO DE SAO FRANCISCO (SE)";"SE";"AMPARO DE SAO FRANCISCO";7;9;4;20
2012;"AQUIDABA (SE)";"SE";"AQUIDABA";116;13;53;182
2012;"ARACAJU (SE)";"SE";"ARACAJU";5602;987;1987;8576
2012;"ARAUA (SE)";"SE";"ARAUA";46;16;16;78
2012;"AREIA BRANCA (SE)";"SE";"AREIA BRANCA";130;10;17;157
2012;"BARRA DOS COQUEIROS (SE)";"SE";"BARRA DOS COQUEIROS";68;19;21;108
2012;"BOQUIM (SE)";"SE";"BOQUIM";196;16;25;237
2012;"BREJO GRANDE (SE)";"SE";"BREJO GRANDE";6;4;6;16
2012;"CAMPO DO BRITO (SE)";"SE";"CAMPO DO BRITO";311;18;70;399
2012;"CANHOBA (SE)";"SE";"CANHOBA";7;3;5;15
2012;"CANINDE DE SAO FRANCISCO (SE)";"SE";"CANINDE DE SAO FRANCISCO";166;73;26;265
2012;"CAPELA (SE)";"SE";"CAPELA";129;32;61;222
2012;"CARIRA (SE)";"SE";"CARIRA";210;30;97;337
2012;"CARMOPOLIS (SE)";"SE";"CARMOPOLIS";93;42;79;214
2012;"CEDRO DE SAO JOAO (SE)";"SE";"CEDRO DE SAO JOAO";18;5;4;27
2012;"CRISTINAPOLIS (SE)";"SE";"CRISTINAPOLIS";68;19;31;118
2012;"CUMBE (SE)";"SE";"CUMBE";28;8;17;53
2012;"DIVINA PASTORA (SE)";"SE";"DIVINA PASTORA";7;5;9;21
2012;"ESTANCIA (SE)";"SE";"ESTANCIA";480;171;232;883
2012;"FEIRA NOVA (SE)";"SE";"FEIRA NOVA";12;9;4;25
2012;"FREI PAULO (SE)";"SE";"FREI PAULO";112;23;29;164
2012;"GARARU (SE)";"SE";"GARARU";38;10;21;69
2012;"GENERAL MAYNARD (SE)";"SE";"GENERAL MAYNARD";9;10;13;32
2012;"GRACCHO CARDOSO (SE)";"SE";"GRACCHO CARDOSO";19;8;4;31
2012;"ILHA DAS FLORES (SE)";"SE";"ILHA DAS FLORES";11;8;9;28
2012;"INDIAROBA (SE)";"SE";"INDIAROBA";38;17;18;73
2012;"ITABAIANA (SE)";"SE";"ITABAIANA";2907;130;130;3167
2012;"ITABAIANINHA (SE)";"SE";"ITABAIANINHA";565;61;50;676
2012;"ITABI (SE)";"SE";"ITABI";18;4;6;28
2012;"ITAPORANGA D AJUDA (SE)";"SE";"ITAPORANGA D AJUDA";220;29;53;302
2012;"JAPARATUBA (SE)";"SE";"JAPARATUBA";43;23;43;109
2012;"JAPOATA (SE)";"SE";"JAPOATA";46;9;28;83
2012;"LAGARTO (SE)";"SE";"LAGARTO";946;127;187;1260
2012;"LARANJEIRAS (SE)";"SE";"LARANJEIRAS";114;43;42;199
2012;"MACAMBIRA (SE)";"SE";"MACAMBIRA";46;11;10;67
2012;"MALHADA DOS BOIS (SE)";"SE";"MALHADA DOS BOIS";9;7;6;22
2012;"MALHADOR (SE)";"SE";"MALHADOR";204;23;48;275
2012;"MARUIM (SE)";"SE";"MARUIM";48;26;32;106
2012;"MOITA BONITA (SE)";"SE";"MOITA BONITA";402;18;17;437
2012;"MONTE ALEGRE DE SERGIPE (SE)";"SE";"MONTE ALEGRE DE SERGIPE";111;19;21;151
2012;"MURIBECA (SE)";"SE";"MURIBECA";59;5;26;90
2012;"NEOPOLIS (SE)";"SE";"NEOPOLIS";43;17;20;80
2012;"NOSSA SENHORA APARECIDA (SE)";"SE";"NOSSA SENHORA APARECIDA";125;21;16;162
2012;"NOSSA SENHORA DA GLORIA (SE)";"SE";"NOSSA SENHORA DA GLORIA";411;44;104;559
2012;"NOSSA SENHORA DAS DORES (SE)";"SE";"NOSSA SENHORA DAS DORES";222;14;60;296
2012;"NOSSA SENHORA DE LOURDES (SE)";"SE";"NOSSA SENHORA DE LOURDES";21;2;7;30
2012;"NOSSA SENHORA DO SOCORRO (SE)";"SE";"NOSSA SENHORA DO SOCORRO";766;96;145;1007
2012;"PACATUBA (SE)";"SE";"PACATUBA";442;6;38;486
2012;"PEDRA MOLE (SE)";"SE";"PEDRA MOLE";5;3;5;13
2012;"PEDRINHAS (SE)";"SE";"PEDRINHAS";55;4;7;66
2012;"PINHAO (SE)";"SE";"PINHAO";26;14;4;44
2012;"PIRAMBU (SE)";"SE";"PIRAMBU";20;4;16;40
2012;"POCO REDONDO (SE)";"SE";"POCO REDONDO";130;41;51;222
2012;"POCO VERDE (SE)";"SE";"POCO VERDE";89;61;152;302
2012;"PORTO DA FOLHA (SE)";"SE";"PORTO DA FOLHA";96;30;31;157
2012;"PROPRIA (SE)";"SE";"PROPRIA";221;34;52;307
2012;"RIACHAO DO DANTAS (SE)";"SE";"RIACHAO DO DANTAS";28;7;16;51
2012;"RIACHUELO (SE)";"SE";"RIACHUELO";36;15;10;61
2012;"RIBEIROPOLIS (SE)";"SE";"RIBEIROPOLIS";262;42;55;359
2012;"ROSARIO DO CATETE (SE)";"SE";"ROSARIO DO CATETE";31;19;13;63
2012;"SALGADO (SE)";"SE";"SALGADO";107;18;104;229
2012;"SANTA LUZIA DO ITANHY (SE)";"SE";"SANTA LUZIA DO ITANHY";16;10;12;38
2012;"SANTA ROSA DE LIMA (SE)";"SE";"SANTA ROSA DE LIMA";17;5;8;30
2012;"SANTANA DO SAO FRANCISCO (SE)";"SE";"SANTANA DO SAO FRANCISCO";9;3;8;20
2012;"SANTO AMARO DAS BROTAS (SE)";"SE";"SANTO AMARO DAS BROTAS";24;5;15;44
2012;"SAO CRISTOVAO (SE)";"SE";"SAO CRISTOVAO";364;83;181;628
2012;"SAO DOMINGOS (SE)";"SE";"SAO DOMINGOS";115;10;23;148
2012;"SAO FRANCISCO (SE)";"SE";"SAO FRANCISCO";13;3;24;40
2012;"SAO MIGUEL DO ALEIXO (SE)";"SE";"SAO MIGUEL DO ALEIXO";41;4;7;52
2012;"SIMAO DIAS (SE)";"SE";"SIMAO DIAS";232;48;190;470
2012;"SIRIRI (SE)";"SE";"SIRIRI";32;13;37;82
2012;"TELHA (SE)";"SE";"TELHA";8;6;2;16
2012;"TOBIAS BARRETO (SE)";"SE";"TOBIAS BARRETO";251;60;154;465
2012;"TOMAR DO GERU (SE)";"SE";"TOMAR DO GERU";45;5;18;68
2012;"UMBAUBA (SE)";"SE";"UMBAUBA";276;33;33;342
2012;"ADAMANTINA (SP)";"SP";"ADAMANTINA";686;61;79;826
2012;"ADOLFO (SP)";"SP";"ADOLFO";72;3;26;101
2012;"AGUAI (SP)";"SP";"AGUAI";790;76;128;994
2012;"AGUAS DA PRATA (SP)";"SP";"AGUAS DA PRATA";109;17;12;138
2012;"AGUAS DE LINDOIA (SP)";"SP";"AGUAS DE LINDOIA";180;74;60;314
2012;"AGUAS DE SANTA BARBARA (SP)";"SP";"AGUAS DE SANTA BARBARA";90;15;19;124
2012;"AGUAS DE SAO PEDRO (SP)";"SP";"AGUAS DE SAO PEDRO";31;5;3;39
2012;"AGUDOS (SP)";"SP";"AGUDOS";570;91;94;755
2012;"ALAMBARI (SP)";"SP";"ALAMBARI";99;14;6;119
2012;"ALFREDO MARCONDES (SP)";"SP";"ALFREDO MARCONDES";61;8;8;77
2012;"ALTAIR (SP)";"SP";"ALTAIR";65;5;32;102
2012;"ALTINOPOLIS (SP)";"SP";"ALTINOPOLIS";339;47;102;488
2012;"ALTO ALEGRE (SP)";"SP";"ALTO ALEGRE";96;4;44;144
2012;"ALUMINIO (SP)";"SP";"ALUMINIO";231;31;33;295
2012;"ALVARES FLORENCE (SP)";"SP";"ALVARES FLORENCE";49;5;15;69
2012;"ALVARES MACHADO (SP)";"SP";"ALVARES MACHADO";414;30;37;481
2012;"ALVARO DE CARVALHO (SP)";"SP";"ALVARO DE CARVALHO";14;4;25;43
2012;"ALVINLANDIA (SP)";"SP";"ALVINLANDIA";44;4;20;68
2012;"AMERICANA (SP)";"SP";"AMERICANA";3545;534;769;4848
2012;"AMERICO BRASILIENSE (SP)";"SP";"AMERICO BRASILIENSE";669;58;227;954
2012;"AMERICO DE CAMPOS (SP)";"SP";"AMERICO DE CAMPOS";140;6;27;173
2012;"AMPARO (SP)";"SP";"AMPARO";1318;219;137;1674
2012;"ANALANDIA (SP)";"SP";"ANALANDIA";76;11;13;100
2012;"ANDRADINA (SP)";"SP";"ANDRADINA";1268;74;128;1470
2012;"ANGATUBA (SP)";"SP";"ANGATUBA";378;48;94;520
2012;"ANHEMBI (SP)";"SP";"ANHEMBI";81;21;16;118
2012;"ANHUMAS (SP)";"SP";"ANHUMAS";74;8;7;89
2012;"APARECIDA (SP)";"SP";"APARECIDA";833;75;525;1433
2012;"APARECIDA D OESTE (SP)";"SP";"APARECIDA D OESTE";105;9;25;139
2012;"APIAI (SP)";"SP";"APIAI";339;40;59;438
2012;"ARACARIGUAMA (SP)";"SP";"ARACARIGUAMA";596;69;49;714
2012;"ARACATUBA (SP)";"SP";"ARACATUBA";3541;266;726;4533
2012;"ARACOIABA DA SERRA (SP)";"SP";"ARACOIABA DA SERRA";498;74;24;596
2012;"ARAMINA (SP)";"SP";"ARAMINA";54;9;23;86
2012;"ARANDU (SP)";"SP";"ARANDU";50;10;24;84
2012;"ARAPEI (SP)";"SP";"ARAPEI";33;8;13;54
2012;"ARARAQUARA (SP)";"SP";"ARARAQUARA";3507;414;1053;4974
2012;"ARARAS (SP)";"SP";"ARARAS";2233;243;295;2771
2012;"ARCO IRIS (SP)";"SP";"ARCO IRIS";62;4;8;74
2012;"AREALVA (SP)";"SP";"AREALVA";157;8;26;191
2012;"AREIAS (SP)";"SP";"AREIAS";43;6;5;54
2012;"AREIOPOLIS (SP)";"SP";"AREIOPOLIS";117;31;97;245
2012;"ARIRANHA (SP)";"SP";"ARIRANHA";273;27;151;451
2012;"ARTUR NOGUEIRA (SP)";"SP";"ARTUR NOGUEIRA";990;92;139;1221
2012;"ARUJA (SP)";"SP";"ARUJA";2787;280;335;3402
2012;"ASPASIA (SP)";"SP";"ASPASIA";31;6;5;42
2012;"ASSIS (SP)";"SP";"ASSIS";1736;188;351;2275
2012;"ATIBAIA (SP)";"SP";"ATIBAIA";2411;339;324;3074
2012;"AURIFLAMA (SP)";"SP";"AURIFLAMA";336;24;43;403
2012;"AVAI (SP)";"SP";"AVAI";67;9;18;94
2012;"AVANHANDAVA (SP)";"SP";"AVANHANDAVA";134;8;43;185
2012;"AVARE (SP)";"SP";"AVARE";1261;152;259;1672
2012;"BADY BASSITT (SP)";"SP";"BADY BASSITT";403;48;69;520
2012;"BALBINOS (SP)";"SP";"BALBINOS";20;3;8;31
2012;"BALSAMO (SP)";"SP";"BALSAMO";180;4;21;205
2012;"BANANAL (SP)";"SP";"BANANAL";122;18;31;171
2012;"BARAO DE ANTONINA (SP)";"SP";"BARAO DE ANTONINA";21;2;14;37
2012;"BARBOSA (SP)";"SP";"BARBOSA";117;5;36;158
2012;"BARIRI (SP)";"SP";"BARIRI";785;76;94;955
2012;"BARRA BONITA (SP)";"SP";"BARRA BONITA";1174;92;214;1480
2012;"BARRA DO CHAPEU (SP)";"SP";"BARRA DO CHAPEU";38;4;12;54
2012;"BARRA DO TURVO (SP)";"SP";"BARRA DO TURVO";56;15;44;115
2012;"BARRETOS (SP)";"SP";"BARRETOS";1909;213;557;2679
2012;"BARRINHA (SP)";"SP";"BARRINHA";452;33;160;645
2012;"BARUERI (SP)";"SP";"BARUERI";6418;717;1182;8317
2012;"BASTOS (SP)";"SP";"BASTOS";722;22;73;817
2012;"BATATAIS (SP)";"SP";"BATATAIS";1116;129;162;1407
2012;"BAURU (SP)";"SP";"BAURU";5397;472;1117;6986
2012;"BEBEDOURO (SP)";"SP";"BEBEDOURO";1586;141;260;1987
2012;"BENTO DE ABREU (SP)";"SP";"BENTO DE ABREU";70;10;11;91
2012;"BERNARDINO DE CAMPOS (SP)";"SP";"BERNARDINO DE CAMPOS";317;26;40;383
2012;"BERTIOGA (SP)";"SP";"BERTIOGA";508;52;108;668
2012;"BILAC (SP)";"SP";"BILAC";149;9;25;183
2012;"BIRIGUI (SP)";"SP";"BIRIGUI";1699;90;201;1990
2012;"BIRITIBA MIRIM (SP)";"SP";"BIRITIBA MIRIM";365;33;21;419
2012;"BOA ESPERANCA DO SUL (SP)";"SP";"BOA ESPERANCA DO SUL";345;38;102;485
2012;"BOCAINA (SP)";"SP";"BOCAINA";214;40;34;288
2012;"BOFETE (SP)";"SP";"BOFETE";185;45;49;279
2012;"BOITUVA (SP)";"SP";"BOITUVA";1156;125;140;1421
2012;"BOM JESUS DOS PERDOES (SP)";"SP";"BOM JESUS DOS PERDOES";496;73;61;630
2012;"BOM SUCESSO DE ITARARE (SP)";"SP";"BOM SUCESSO DE ITARARE";72;11;12;95
2012;"BORA (SP)";"SP";"BORA";47;1;6;54
2012;"BORACEIA (SP)";"SP";"BORACEIA";216;11;21;248
2012;"BORBOREMA (SP)";"SP";"BORBOREMA";328;19;73;420
2012;"BOREBI (SP)";"SP";"BOREBI";49;11;8;68
2012;"BOTUCATU (SP)";"SP";"BOTUCATU";1678;274;476;2428
2012;"BRAGANCA PAULISTA (SP)";"SP";"BRAGANCA PAULISTA";2651;355;352;3358
2012;"BRAUNA (SP)";"SP";"BRAUNA";74;4;80;158
2012;"BREJO ALEGRE (SP)";"SP";"BREJO ALEGRE";167;1;20;188
2012;"BRODOWSKI (SP)";"SP";"BRODOWSKI";553;30;40;623
2012;"BROTAS (SP)";"SP";"BROTAS";504;56;164;724
2012;"BURI (SP)";"SP";"BURI";405;33;62;500
2012;"BURITAMA (SP)";"SP";"BURITAMA";339;26;55;420
2012;"BURITIZAL (SP)";"SP";"BURITIZAL";105;13;35;153
2012;"CABRALIA PAULISTA (SP)";"SP";"CABRALIA PAULISTA";131;6;12;149
2012;"CABREUVA (SP)";"SP";"CABREUVA";959;122;71;1152
2012;"CACAPAVA (SP)";"SP";"CACAPAVA";1060;270;154;1484
2012;"CACHOEIRA PAULISTA (SP)";"SP";"CACHOEIRA PAULISTA";360;83;27;470
2012;"CACONDE (SP)";"SP";"CACONDE";225;42;76;343
2012;"CAFELANDIA (SP)";"SP";"CAFELANDIA";280;14;75;369
2012;"CAIABU (SP)";"SP";"CAIABU";39;9;43;91
2012;"CAIEIRAS (SP)";"SP";"CAIEIRAS";1179;228;472;1879
2012;"CAIUA (SP)";"SP";"CAIUA";61;11;23;95
2012;"CAJAMAR (SP)";"SP";"CAJAMAR";1541;193;265;1999
2012;"CAJATI (SP)";"SP";"CAJATI";515;79;84;678
2012;"CAJOBI (SP)";"SP";"CAJOBI";273;9;89;371
2012;"CAJURU (SP)";"SP";"CAJURU";462;23;94;579
2012;"CAMPINA DO MONTE ALEGRE (SP)";"SP";"CAMPINA DO MONTE ALEGRE";69;15;25;109
2012;"CAMPINAS (SP)";"SP";"CAMPINAS";20280;3675;5091;29046
2012;"CAMPO LIMPO PAULISTA (SP)";"SP";"CAMPO LIMPO PAULISTA";607;104;32;743
2012;"CAMPOS DO JORDAO (SP)";"SP";"CAMPOS DO JORDAO";592;160;59;811
2012;"CAMPOS NOVOS PAULISTA (SP)";"SP";"CAMPOS NOVOS PAULISTA";81;4;27;112
2012;"CANANEIA (SP)";"SP";"CANANEIA";88;9;13;110
2012;"CANAS (SP)";"SP";"CANAS";85;6;9;100
2012;"CANDIDO MOTA (SP)";"SP";"CANDIDO MOTA";831;47;65;943
2012;"CANDIDO RODRIGUES (SP)";"SP";"CANDIDO RODRIGUES";108;8;8;124
2012;"CANITAR (SP)";"SP";"CANITAR";47;17;17;81
2012;"CAPAO BONITO (SP)";"SP";"CAPAO BONITO";884;102;178;1164
2012;"CAPELA DO ALTO (SP)";"SP";"CAPELA DO ALTO";444;47;32;523
2012;"CAPIVARI (SP)";"SP";"CAPIVARI";1173;102;192;1467
2012;"CARAGUATATUBA (SP)";"SP";"CARAGUATATUBA";1630;160;122;1912
2012;"CARAPICUIBA (SP)";"SP";"CARAPICUIBA";3786;784;944;5514
2012;"CARDOSO (SP)";"SP";"CARDOSO";159;16;43;218
2012;"CASA BRANCA (SP)";"SP";"CASA BRANCA";556;64;89;709
2012;"CASSIA DOS COQUEIROS (SP)";"SP";"CASSIA DOS COQUEIROS";23;4;12;39
2012;"CASTILHO (SP)";"SP";"CASTILHO";233;35;101;369
2012;"CATANDUVA (SP)";"SP";"CATANDUVA";3048;250;510;3808
2012;"CATIGUA (SP)";"SP";"CATIGUA";98;11;32;141
2012;"CEDRAL (SP)";"SP";"CEDRAL";219;16;16;251
2012;"CERQUEIRA CESAR (SP)";"SP";"CERQUEIRA CESAR";331;51;124;506
2012;"CERQUILHO (SP)";"SP";"CERQUILHO";885;98;87;1070
2012;"CESARIO LANGE (SP)";"SP";"CESARIO LANGE";372;59;50;481
2012;"CHARQUEADA (SP)";"SP";"CHARQUEADA";433;32;91;556
2012;"CHAVANTES (SP)";"SP";"CHAVANTES";143;28;48;219
2012;"CLEMENTINA (SP)";"SP";"CLEMENTINA";236;13;59;308
2012;"COLINA (SP)";"SP";"COLINA";394;37;82;513
2012;"COLOMBIA (SP)";"SP";"COLOMBIA";120;33;68;221
2012;"CONCHAL (SP)";"SP";"CONCHAL";741;52;239;1032
2012;"CONCHAS (SP)";"SP";"CONCHAS";348;37;33;418
2012;"CORDEIROPOLIS (SP)";"SP";"CORDEIROPOLIS";668;69;32;769
2012;"COROADOS (SP)";"SP";"COROADOS";80;4;19;103
2012;"CORONEL MACEDO (SP)";"SP";"CORONEL MACEDO";51;10;24;85
2012;"CORUMBATAI (SP)";"SP";"CORUMBATAI";148;19;13;180
2012;"COSMOPOLIS (SP)";"SP";"COSMOPOLIS";862;261;269;1392
2012;"COSMORAMA (SP)";"SP";"COSMORAMA";178;12;40;230
2012;"COTIA (SP)";"SP";"COTIA";3182;838;763;4783
2012;"CRAVINHOS (SP)";"SP";"CRAVINHOS";915;44;181;1140
2012;"CRISTAIS PAULISTA (SP)";"SP";"CRISTAIS PAULISTA";122;7;26;155
2012;"CRUZALIA (SP)";"SP";"CRUZALIA";69;8;4;81
2012;"CRUZEIRO (SP)";"SP";"CRUZEIRO";689;129;42;860
2012;"CUBATAO (SP)";"SP";"CUBATAO";2927;382;432;3741
2012;"CUNHA (SP)";"SP";"CUNHA";258;36;33;327
2012;"DESCALVADO (SP)";"SP";"DESCALVADO";920;86;191;1197
2012;"DIADEMA (SP)";"SP";"DIADEMA";4354;770;593;5717
2012;"DIRCE REIS (SP)";"SP";"DIRCE REIS";58;5;9;72
2012;"DIVINOLANDIA (SP)";"SP";"DIVINOLANDIA";413;22;37;472
2012;"DOBRADA (SP)";"SP";"DOBRADA";60;11;76;147
2012;"DOIS CORREGOS (SP)";"SP";"DOIS CORREGOS";678;68;135;881
2012;"DOLCINOPOLIS (SP)";"SP";"DOLCINOPOLIS";28;3;7;38
2012;"DOURADO (SP)";"SP";"DOURADO";188;28;53;269
2012;"DRACENA (SP)";"SP";"DRACENA";1013;53;128;1194
2012;"DUARTINA (SP)";"SP";"DUARTINA";251;28;65;344
2012;"DUMONT (SP)";"SP";"DUMONT";287;8;55;350
2012;"ECHAPORA (SP)";"SP";"ECHAPORA";130;1;17;148
2012;"ELDORADO (SP)";"SP";"ELDORADO";230;15;42;287
2012;"ELIAS FAUSTO (SP)";"SP";"ELIAS FAUSTO";342;17;70;429
2012;"ELISIARIO (SP)";"SP";"ELISIARIO";56;5;8;69
2012;"EMBAUBA (SP)";"SP";"EMBAUBA";73;5;26;104
2012;"EMBU (SP)";"SP";"EMBU";2504;644;760;3908
2012;"EMBU GUACU (SP)";"SP";"EMBU GUACU";2136;208;277;2621
2012;"EMILIANOPOLIS (SP)";"SP";"EMILIANOPOLIS";53;4;17;74
2012;"ENGENHEIRO COELHO (SP)";"SP";"ENGENHEIRO COELHO";357;42;144;543
2012;"ESPIRITO SANTO DO PINHAL (SP)";"SP";"ESPIRITO SANTO DO PINHAL";621;114;82;817
2012;"ESPIRITO SANTO DO TURVO (SP)";"SP";"ESPIRITO SANTO DO TURVO";156;21;36;213
2012;"ESTIVA GERBI (SP)";"SP";"ESTIVA GERBI";268;15;26;309
2012;"ESTRELA D OESTE (SP)";"SP";"ESTRELA D OESTE";267;7;22;296
2012;"ESTRELA DO NORTE (SP)";"SP";"ESTRELA DO NORTE";22;2;8;32
2012;"EUCLIDES DA CUNHA PAULISTA (SP)";"SP";"EUCLIDES DA CUNHA PAULISTA";88;6;42;136
2012;"FARTURA (SP)";"SP";"FARTURA";262;23;33;318
2012;"FERNANDO PRESTES (SP)";"SP";"FERNANDO PRESTES";206;8;17;231
2012;"FERNANDOPOLIS (SP)";"SP";"FERNANDOPOLIS";1418;82;179;1679
2012;"FERNAO (SP)";"SP";"FERNAO";27;4;8;39
2012;"FERRAZ DE VASCONCELOS (SP)";"SP";"FERRAZ DE VASCONCELOS";1825;265;307;2397
2012;"FLORA RICA (SP)";"SP";"FLORA RICA";18;1;10;29
2012;"FLOREAL (SP)";"SP";"FLOREAL";60;10;7;77
2012;"FLORIDA PAULISTA (SP)";"SP";"FLORIDA PAULISTA";298;16;110;424
2012;"FLORINEA (SP)";"SP";"FLORINEA";40;6;8;54
2012;"FRANCA (SP)";"SP";"FRANCA";3206;368;576;4150
2012;"FRANCISCO MORATO (SP)";"SP";"FRANCISCO MORATO";583;198;192;973
2012;"FRANCO DA ROCHA (SP)";"SP";"FRANCO DA ROCHA";877;201;169;1247
2012;"GABRIEL MONTEIRO (SP)";"SP";"GABRIEL MONTEIRO";53;1;12;66
2012;"GALIA (SP)";"SP";"GALIA";141;14;36;191
2012;"GARCA (SP)";"SP";"GARCA";726;67;112;905
2012;"GASTAO VIDIGAL (SP)";"SP";"GASTAO VIDIGAL";58;9;52;119
2012;"GAVIAO PEIXOTO (SP)";"SP";"GAVIAO PEIXOTO";50;9;22;81
2012;"GENERAL SALGADO (SP)";"SP";"GENERAL SALGADO";291;17;96;404
2012;"GETULINA (SP)";"SP";"GETULINA";146;5;62;213
2012;"GLICERIO (SP)";"SP";"GLICERIO";112;4;27;143
2012;"GUAICARA (SP)";"SP";"GUAICARA";102;9;26;137
2012;"GUAIMBE (SP)";"SP";"GUAIMBE";125;1;27;153
2012;"GUAIRA (SP)";"SP";"GUAIRA";1148;73;186;1407
2012;"GUAPIACU (SP)";"SP";"GUAPIACU";407;26;68;501
2012;"GUAPIARA (SP)";"SP";"GUAPIARA";311;38;49;398
2012;"GUARA (SP)";"SP";"GUARA";204;32;159;395
2012;"GUARACAI (SP)";"SP";"GUARACAI";308;23;31;362
2012;"GUARACI (SP)";"SP";"GUARACI";182;19;68;269
2012;"GUARANI D OESTE (SP)";"SP";"GUARANI D OESTE";22;4;5;31
2012;"GUARANTA (SP)";"SP";"GUARANTA";92;5;41;138
2012;"GUARARAPES (SP)";"SP";"GUARARAPES";707;45;136;888
2012;"GUARAREMA (SP)";"SP";"GUARAREMA";505;85;58;648
2012;"GUARATINGUETA (SP)";"SP";"GUARATINGUETA";1119;333;169;1621
2012;"GUAREI (SP)";"SP";"GUAREI";260;24;57;341
2012;"GUARIBA (SP)";"SP";"GUARIBA";867;65;264;1196
2012;"GUARUJA (SP)";"SP";"GUARUJA";2061;396;406;2863
2012;"GUARULHOS (SP)";"SP";"GUARULHOS";20917;3920;3661;28498
2012;"GUATAPARA (SP)";"SP";"GUATAPARA";185;15;45;245
2012;"GUZOLANDIA (SP)";"SP";"GUZOLANDIA";60;4;36;100
2012;"HERCULANDIA (SP)";"SP";"HERCULANDIA";424;3;23;450
2012;"HOLAMBRA (SP)";"SP";"HOLAMBRA";361;34;73;468
2012;"HORTOLANDIA (SP)";"SP";"HORTOLANDIA";1703;375;340;2418
2012;"IACANGA (SP)";"SP";"IACANGA";207;23;31;261
2012;"IACRI (SP)";"SP";"IACRI";122;3;16;141
2012;"IARAS (SP)";"SP";"IARAS";47;13;38;98
2012;"IBATE (SP)";"SP";"IBATE";594;120;210;924
2012;"IBIRA (SP)";"SP";"IBIRA";170;14;52;236
2012;"IBIRAREMA (SP)";"SP";"IBIRAREMA";143;13;25;181
2012;"IBITINGA (SP)";"SP";"IBITINGA";838;81;161;1080
2012;"IBIUNA (SP)";"SP";"IBIUNA";1913;156;114;2183
2012;"ICEM (SP)";"SP";"ICEM";182;7;60;249
2012;"IEPE (SP)";"SP";"IEPE";157;14;26;197
2012;"IGARACU DO TIETE (SP)";"SP";"IGARACU DO TIETE";334;32;85;451
2012;"IGARAPAVA (SP)";"SP";"IGARAPAVA";367;48;107;522
2012;"IGARATA (SP)";"SP";"IGARATA";154;29;12;195
2012;"IGUAPE (SP)";"SP";"IGUAPE";221;45;27;293
2012;"ILHA COMPRIDA (SP)";"SP";"ILHA COMPRIDA";153;17;68;238
2012;"ILHA SOLTEIRA (SP)";"SP";"ILHA SOLTEIRA";247;36;84;367
2012;"ILHABELA (SP)";"SP";"ILHABELA";321;67;54;442
2012;"INDAIATUBA (SP)";"SP";"INDAIATUBA";2990;550;263;3803
2012;"INDIANA (SP)";"SP";"INDIANA";117;9;15;141
2012;"INDIAPORA (SP)";"SP";"INDIAPORA";56;2;19;77
2012;"INUBIA PAULISTA (SP)";"SP";"INUBIA PAULISTA";56;7;13;76
2012;"IPAUSSU (SP)";"SP";"IPAUSSU";187;28;49;264
2012;"IPERO (SP)";"SP";"IPERO";226;27;28;281
2012;"IPEUNA (SP)";"SP";"IPEUNA";172;30;32;234
2012;"IPIGUA (SP)";"SP";"IPIGUA";25;2;9;36
2012;"IPORANGA (SP)";"SP";"IPORANGA";25;7;9;41
2012;"IPUA (SP)";"SP";"IPUA";268;21;81;370
2012;"IRACEMAPOLIS (SP)";"SP";"IRACEMAPOLIS";538;51;113;702
2012;"IRAPUA (SP)";"SP";"IRAPUA";134;7;83;224
2012;"IRAPURU (SP)";"SP";"IRAPURU";107;13;25;145
2012;"ITABERA (SP)";"SP";"ITABERA";245;29;28;302
2012;"ITAI (SP)";"SP";"ITAI";487;67;149;703
2012;"ITAJOBI (SP)";"SP";"ITAJOBI";497;14;45;556
2012;"ITAJU (SP)";"SP";"ITAJU";70;3;19;92
2012;"ITANHAEM (SP)";"SP";"ITANHAEM";786;202;106;1094
2012;"ITAOCA (SP)";"SP";"ITAOCA";27;8;8;43
2012;"ITAPECERICA DA SERRA (SP)";"SP";"ITAPECERICA DA SERRA";2728;650;650;4028
2012;"ITAPETININGA (SP)";"SP";"ITAPETININGA";2639;394;377;3410
2012;"ITAPEVA (SP)";"SP";"ITAPEVA";1805;290;370;2465
2012;"ITAPEVI (SP)";"SP";"ITAPEVI";1764;293;167;2224
2012;"ITAPIRA (SP)";"SP";"ITAPIRA";1643;125;209;1977
2012;"ITAPIRAPUA PAULISTA (SP)";"SP";"ITAPIRAPUA PAULISTA";36;15;12;63
2012;"ITAPOLIS (SP)";"SP";"ITAPOLIS";1238;100;185;1523
2012;"ITAPORANGA (SP)";"SP";"ITAPORANGA";217;19;70;306
2012;"ITAPUI (SP)";"SP";"ITAPUI";363;37;65;465
2012;"ITAPURA (SP)";"SP";"ITAPURA";29;5;13;47
2012;"ITAQUAQUECETUBA (SP)";"SP";"ITAQUAQUECETUBA";3489;410;441;4340
2012;"ITARARE (SP)";"SP";"ITARARE";922;90;263;1275
2012;"ITARIRI (SP)";"SP";"ITARIRI";315;26;22;363
2012;"ITATIBA (SP)";"SP";"ITATIBA";2641;241;371;3253
2012;"ITATINGA (SP)";"SP";"ITATINGA";206;38;99;343
2012;"ITIRAPINA (SP)";"SP";"ITIRAPINA";260;37;55;352
2012;"ITIRAPUA (SP)";"SP";"ITIRAPUA";77;6;19;102
2012;"ITOBI (SP)";"SP";"ITOBI";142;19;73;234
2012;"ITU (SP)";"SP";"ITU";2934;418;591;3943
2012;"ITUPEVA (SP)";"SP";"ITUPEVA";1031;109;106;1246
2012;"ITUVERAVA (SP)";"SP";"ITUVERAVA";640;41;126;807
2012;"JABORANDI (SP)";"SP";"JABORANDI";169;9;44;222
2012;"JABOTICABAL (SP)";"SP";"JABOTICABAL";1847;114;246;2207
2012;"JACAREI (SP)";"SP";"JACAREI";2626;584;360;3570
2012;"JACI (SP)";"SP";"JACI";196;9;28;233
2012;"JACUPIRANGA (SP)";"SP";"JACUPIRANGA";383;36;369;788
2012;"JAGUARIUNA (SP)";"SP";"JAGUARIUNA";1047;95;188;1330
2012;"JALES (SP)";"SP";"JALES";1194;39;74;1307
2012;"JAMBEIRO (SP)";"SP";"JAMBEIRO";121;37;13;171
2012;"JANDIRA (SP)";"SP";"JANDIRA";1207;270;163;1640
2012;"JARDINOPOLIS (SP)";"SP";"JARDINOPOLIS";903;99;119;1121
2012;"JARINU (SP)";"SP";"JARINU";608;50;51;709
2012;"JAU (SP)";"SP";"JAU";2418;293;429;3140
2012;"JERIQUARA (SP)";"SP";"JERIQUARA";46;4;13;63
2012;"JOANOPOLIS (SP)";"SP";"JOANOPOLIS";365;23;19;407
2012;"JOAO RAMALHO (SP)";"SP";"JOAO RAMALHO";30;9;18;57
2012;"JOSE BONIFACIO (SP)";"SP";"JOSE BONIFACIO";863;60;106;1029
2012;"JULIO MESQUITA (SP)";"SP";"JULIO MESQUITA";41;7;29;77
2012;"JUMIRIM (SP)";"SP";"JUMIRIM";95;11;6;112
2012;"JUNDIAI (SP)";"SP";"JUNDIAI";8045;842;1148;10035
2012;"JUNQUEIROPOLIS (SP)";"SP";"JUNQUEIROPOLIS";431;29;184;644
2012;"JUQUIA (SP)";"SP";"JUQUIA";385;29;18;432
2012;"JUQUITIBA (SP)";"SP";"JUQUITIBA";662;79;102;843
2012;"LAGOINHA (SP)";"SP";"LAGOINHA";130;15;20;165
2012;"LARANJAL PAULISTA (SP)";"SP";"LARANJAL PAULISTA";639;49;188;876
2012;"LAVINIA (SP)";"SP";"LAVINIA";72;6;13;91
2012;"LAVRINHAS (SP)";"SP";"LAVRINHAS";84;24;14;122
2012;"LEME (SP)";"SP";"LEME";2467;149;501;3117
2012;"LENCOIS PAULISTA (SP)";"SP";"LENCOIS PAULISTA";1358;178;267;1803
2012;"LIMEIRA (SP)";"SP";"LIMEIRA";4854;809;614;6277
2012;"LINDOIA (SP)";"SP";"LINDOIA";151;24;19;194
2012;"LINS (SP)";"SP";"LINS";1457;119;171;1747
2012;"LORENA (SP)";"SP";"LORENA";867;182;35;1084
2012;"LOURDES (SP)";"SP";"LOURDES";26;5;14;45
2012;"LOUVEIRA (SP)";"SP";"LOUVEIRA";928;118;54;1100
2012;"LUCELIA (SP)";"SP";"LUCELIA";375;29;183;587
2012;"LUCIANOPOLIS (SP)";"SP";"LUCIANOPOLIS";46;8;12;66
2012;"LUIS ANTONIO (SP)";"SP";"LUIS ANTONIO";282;27;161;470
2012;"LUIZIANIA (SP)";"SP";"LUIZIANIA";59;3;26;88
2012;"LUPERCIO (SP)";"SP";"LUPERCIO";58;4;32;94
2012;"LUTECIA (SP)";"SP";"LUTECIA";42;8;11;61
2012;"MACATUBA (SP)";"SP";"MACATUBA";470;29;79;578
2012;"MACAUBAL (SP)";"SP";"MACAUBAL";139;17;23;179
2012;"MACEDONIA (SP)";"SP";"MACEDONIA";45;4;13;62
2012;"MAGDA (SP)";"SP";"MAGDA";101;12;10;123
2012;"MAIRINQUE (SP)";"SP";"MAIRINQUE";587;88;106;781
2012;"MAIRIPORA (SP)";"SP";"MAIRIPORA";1945;298;147;2390
2012;"MANDURI (SP)";"SP";"MANDURI";198;31;69;298
2012;"MARABA PAULISTA (SP)";"SP";"MARABA PAULISTA";33;4;16;53
2012;"MARACAI (SP)";"SP";"MARACAI";309;65;52;426
2012;"MARAPOAMA (SP)";"SP";"MARAPOAMA";131;12;9;152
2012;"MARIAPOLIS (SP)";"SP";"MARIAPOLIS";39;0;24;63
2012;"MARILIA (SP)";"SP";"MARILIA";3085;282;487;3854
2012;"MARINOPOLIS (SP)";"SP";"MARINOPOLIS";75;5;6;86
2012;"MARTINOPOLIS (SP)";"SP";"MARTINOPOLIS";416;43;92;551
2012;"MATAO (SP)";"SP";"MATAO";1573;87;310;1970
2012;"MAUA (SP)";"SP";"MAUA";3613;1048;1197;5858
2012;"MENDONCA (SP)";"SP";"MENDONCA";107;4;26;137
2012;"MERIDIANO (SP)";"SP";"MERIDIANO";152;12;18;182
2012;"MESOPOLIS (SP)";"SP";"MESOPOLIS";12;4;12;28
2012;"MIGUELOPOLIS (SP)";"SP";"MIGUELOPOLIS";312;14;102;428
2012;"MINEIROS DO TIETE (SP)";"SP";"MINEIROS DO TIETE";243;15;39;297
2012;"MIRA ESTRELA (SP)";"SP";"MIRA ESTRELA";37;3;25;65
2012;"MIRACATU (SP)";"SP";"MIRACATU";617;83;34;734
2012;"MIRANDOPOLIS (SP)";"SP";"MIRANDOPOLIS";537;43;159;739
2012;"MIRANTE DO PARANAPANEMA (SP)";"SP";"MIRANTE DO PARANAPANEMA";227;51;73;351
2012;"MIRASSOL (SP)";"SP";"MIRASSOL";1241;51;67;1359
2012;"MIRASSOLANDIA (SP)";"SP";"MIRASSOLANDIA";46;11;11;68
2012;"MOCOCA (SP)";"SP";"MOCOCA";1117;112;311;1540
2012;"MOGI DAS CRUZES (SP)";"SP";"MOGI DAS CRUZES";5965;838;1195;7998
2012;"MOGI GUACU (SP)";"SP";"MOGI GUACU";2363;394;412;3169
2012;"MOGI MIRIM (SP)";"SP";"MOGI MIRIM";1922;206;561;2689
2012;"MOMBUCA (SP)";"SP";"MOMBUCA";86;4;19;109
2012;"MONCOES (SP)";"SP";"MONCOES";76;11;12;99
2012;"MONGAGUA (SP)";"SP";"MONGAGUA";539;96;59;694
2012;"MONTE ALEGRE DO SUL (SP)";"SP";"MONTE ALEGRE DO SUL";226;37;32;295
2012;"MONTE ALTO (SP)";"SP";"MONTE ALTO";1438;72;109;1619
2012;"MONTE APRAZIVEL (SP)";"SP";"MONTE APRAZIVEL";596;48;181;825
2012;"MONTE AZUL PAULISTA (SP)";"SP";"MONTE AZUL PAULISTA";487;31;139;657
2012;"MONTE CASTELO (SP)";"SP";"MONTE CASTELO";74;6;12;92
2012;"MONTE MOR (SP)";"SP";"MONTE MOR";693;78;116;887
2012;"MONTEIRO LOBATO (SP)";"SP";"MONTEIRO LOBATO";195;42;20;257
2012;"MORRO AGUDO (SP)";"SP";"MORRO AGUDO";665;42;165;872
2012;"MORUNGABA (SP)";"SP";"MORUNGABA";361;54;30;445
2012;"MOTUCA (SP)";"SP";"MOTUCA";127;6;31;164
2012;"MUNICIPIO NAO INFORMADO (SP)";"SP";"MUNICIPIO NAO INFORMADO";0;0;0;0
2012;"MURUTINGA DO SUL (SP)";"SP";"MURUTINGA DO SUL";92;8;10;110
2012;"NANTES (SP)";"SP";"NANTES";18;12;19;49
2012;"NARANDIBA (SP)";"SP";"NARANDIBA";88;6;19;113
2012;"NATIVIDADE DA SERRA (SP)";"SP";"NATIVIDADE DA SERRA";83;35;8;126
2012;"NAZARE PAULISTA (SP)";"SP";"NAZARE PAULISTA";632;22;23;677
2012;"NEVES PAULISTA (SP)";"SP";"NEVES PAULISTA";183;13;32;228
2012;"NHANDEARA (SP)";"SP";"NHANDEARA";190;16;41;247
2012;"NIPOA (SP)";"SP";"NIPOA";116;10;26;152
2012;"NOVA ALIANCA (SP)";"SP";"NOVA ALIANCA";127;15;20;162
2012;"NOVA CAMPINA (SP)";"SP";"NOVA CAMPINA";69;15;17;101
2012;"NOVA CANAA PAULISTA (SP)";"SP";"NOVA CANAA PAULISTA";30;5;6;41
2012;"NOVA CASTILHO (SP)";"SP";"NOVA CASTILHO";17;3;8;28
2012;"NOVA EUROPA (SP)";"SP";"NOVA EUROPA";172;11;121;304
2012;"NOVA GRANADA (SP)";"SP";"NOVA GRANADA";321;43;96;460
2012;"NOVA GUATAPORANGA (SP)";"SP";"NOVA GUATAPORANGA";37;5;14;56
2012;"NOVA INDEPENDENCIA (SP)";"SP";"NOVA INDEPENDENCIA";40;11;11;62
2012;"NOVA LUZITANIA (SP)";"SP";"NOVA LUZITANIA";34;2;24;60
2012;"NOVA ODESSA (SP)";"SP";"NOVA ODESSA";847;118;120;1085
2012;"NOVAIS (SP)";"SP";"NOVAIS";94;8;31;133
2012;"NOVO HORIZONTE (SP)";"SP";"NOVO HORIZONTE";1045;29;238;1312
2012;"NUPORANGA (SP)";"SP";"NUPORANGA";202;19;54;275
2012;"OCAUCU (SP)";"SP";"OCAUCU";107;7;16;130
2012;"OLEO (SP)";"SP";"OLEO";24;11;7;42
2012;"OLIMPIA (SP)";"SP";"OLIMPIA";959;116;205;1280
2012;"ONDA VERDE (SP)";"SP";"ONDA VERDE";90;5;22;117
2012;"ORIENTE (SP)";"SP";"ORIENTE";77;8;18;103
2012;"ORINDIUVA (SP)";"SP";"ORINDIUVA";215;11;101;327
2012;"ORLANDIA (SP)";"SP";"ORLANDIA";927;55;276;1258
2012;"OSASCO (SP)";"SP";"OSASCO";10247;2037;2530;14814
2012;"OSCAR BRESSANE (SP)";"SP";"OSCAR BRESSANE";58;5;4;67
2012;"OSVALDO CRUZ (SP)";"SP";"OSVALDO CRUZ";561;31;99;691
2012;"OURINHOS (SP)";"SP";"OURINHOS";2163;144;598;2905
2012;"OURO VERDE (SP)";"SP";"OURO VERDE";124;4;60;188
2012;"OUROESTE (SP)";"SP";"OUROESTE";147;10;36;193
2012;"PACAEMBU (SP)";"SP";"PACAEMBU";178;21;41;240
2012;"PALESTINA (SP)";"SP";"PALESTINA";156;18;45;219
2012;"PALMARES PAULISTA (SP)";"SP";"PALMARES PAULISTA";79;10;104;193
2012;"PALMEIRA D OESTE (SP)";"SP";"PALMEIRA D OESTE";241;8;33;282
2012;"PALMITAL (SP)";"SP";"PALMITAL";603;40;54;697
2012;"PANORAMA (SP)";"SP";"PANORAMA";331;14;18;363
2012;"PARAGUACU PAULISTA (SP)";"SP";"PARAGUACU PAULISTA";794;157;93;1044
2012;"PARAIBUNA (SP)";"SP";"PARAIBUNA";233;75;55;363
2012;"PARAISO (SP)";"SP";"PARAISO";184;13;60;257
2012;"PARANAPANEMA (SP)";"SP";"PARANAPANEMA";550;29;70;649
2012;"PARANAPUA (SP)";"SP";"PARANAPUA";80;8;12;100
2012;"PARAPUA (SP)";"SP";"PARAPUA";309;9;49;367
2012;"PARDINHO (SP)";"SP";"PARDINHO";137;18;25;180
2012;"PARIQUERA ACU (SP)";"SP";"PARIQUERA ACU";404;26;19;449
2012;"PARISI (SP)";"SP";"PARISI";24;6;10;40
2012;"PATROCINIO PAULISTA (SP)";"SP";"PATROCINIO PAULISTA";266;15;54;335
2012;"PAULICEIA (SP)";"SP";"PAULICEIA";292;11;27;330
2012;"PAULINIA (SP)";"SP";"PAULINIA";1909;230;475;2614
2012;"PAULISTANIA (SP)";"SP";"PAULISTANIA";21;6;8;35
2012;"PAULO DE FARIA (SP)";"SP";"PAULO DE FARIA";98;15;43;156
2012;"PEDERNEIRAS (SP)";"SP";"PEDERNEIRAS";1038;101;208;1347
2012;"PEDRA BELA (SP)";"SP";"PEDRA BELA";192;11;16;219
2012;"PEDRANOPOLIS (SP)";"SP";"PEDRANOPOLIS";52;3;15;70
2012;"PEDREGULHO (SP)";"SP";"PEDREGULHO";265;32;102;399
2012;"PEDREIRA (SP)";"SP";"PEDREIRA";735;113;71;919
2012;"PEDRINHAS PAULISTA (SP)";"SP";"PEDRINHAS PAULISTA";147;6;12;165
2012;"PEDRO DE TOLEDO (SP)";"SP";"PEDRO DE TOLEDO";139;21;8;168
2012;"PENAPOLIS (SP)";"SP";"PENAPOLIS";1326;70;252;1648
2012;"PEREIRA BARRETO (SP)";"SP";"PEREIRA BARRETO";342;44;92;478
2012;"PEREIRAS (SP)";"SP";"PEREIRAS";240;13;27;280
2012;"PERUIBE (SP)";"SP";"PERUIBE";609;192;99;900
2012;"PIACATU (SP)";"SP";"PIACATU";84;2;18;104
2012;"PIEDADE (SP)";"SP";"PIEDADE";1353;132;92;1577
2012;"PILAR DO SUL (SP)";"SP";"PILAR DO SUL";1041;67;76;1184
2012;"PINDAMONHANGABA (SP)";"SP";"PINDAMONHANGABA";1900;421;199;2520
2012;"PINDORAMA (SP)";"SP";"PINDORAMA";290;26;56;372
2012;"PINHALZINHO (SP)";"SP";"PINHALZINHO";399;35;11;445
2012;"PIQUEROBI (SP)";"SP";"PIQUEROBI";34;5;8;47
2012;"PIQUETE (SP)";"SP";"PIQUETE";167;44;17;228
2012;"PIRACAIA (SP)";"SP";"PIRACAIA";499;85;34;618
2012;"PIRACICABA (SP)";"SP";"PIRACICABA";7460;853;1394;9707
2012;"PIRAJU (SP)";"SP";"PIRAJU";456;70;72;598
2012;"PIRAJUI (SP)";"SP";"PIRAJUI";311;22;83;416
2012;"PIRANGI (SP)";"SP";"PIRANGI";384;17;64;465
2012;"PIRAPORA DO BOM JESUS (SP)";"SP";"PIRAPORA DO BOM JESUS";232;32;14;278
2012;"PIRAPOZINHO (SP)";"SP";"PIRAPOZINHO";433;33;90;556
2012;"PIRASSUNUNGA (SP)";"SP";"PIRASSUNUNGA";1044;148;234;1426
2012;"PIRATININGA (SP)";"SP";"PIRATININGA";244;27;41;312
2012;"PITANGUEIRAS (SP)";"SP";"PITANGUEIRAS";928;50;254;1232
2012;"PLANALTO (SP)";"SP";"PLANALTO";78;11;27;116
2012;"PLATINA (SP)";"SP";"PLATINA";50;16;13;79
2012;"POA (SP)";"SP";"POA";1038;201;286;1525
2012;"POLONI (SP)";"SP";"POLONI";169;6;52;227
2012;"POMPEIA (SP)";"SP";"POMPEIA";270;17;49;336
2012;"PONGAI (SP)";"SP";"PONGAI";60;6;14;80
2012;"PONTAL (SP)";"SP";"PONTAL";921;35;482;1438
2012;"PONTALINDA (SP)";"SP";"PONTALINDA";29;5;21;55
2012;"PONTES GESTAL (SP)";"SP";"PONTES GESTAL";106;3;28;137
2012;"POPULINA (SP)";"SP";"POPULINA";53;6;16;75
2012;"PORANGABA (SP)";"SP";"PORANGABA";136;13;15;164
2012;"PORTO FELIZ (SP)";"SP";"PORTO FELIZ";1314;95;185;1594
2012;"PORTO FERREIRA (SP)";"SP";"PORTO FERREIRA";1119;93;152;1364
2012;"POTIM (SP)";"SP";"POTIM";97;54;25;176
2012;"POTIRENDABA (SP)";"SP";"POTIRENDABA";514;19;72;605
2012;"PRACINHA (SP)";"SP";"PRACINHA";11;1;15;27
2012;"PRADOPOLIS (SP)";"SP";"PRADOPOLIS";399;22;216;637
2012;"PRAIA GRANDE (SP)";"SP";"PRAIA GRANDE";2165;312;227;2704
2012;"PRATANIA (SP)";"SP";"PRATANIA";99;16;46;161
2012;"PRESIDENTE ALVES (SP)";"SP";"PRESIDENTE ALVES";61;5;42;108
2012;"PRESIDENTE BERNARDES (SP)";"SP";"PRESIDENTE BERNARDES";229;30;39;298
2012;"PRESIDENTE EPITACIO (SP)";"SP";"PRESIDENTE EPITACIO";499;78;148;725
2012;"PRESIDENTE PRUDENTE (SP)";"SP";"PRESIDENTE PRUDENTE";3821;339;855;5015
2012;"PRESIDENTE VENCESLAU (SP)";"SP";"PRESIDENTE VENCESLAU";664;55;61;780
2012;"PROMISSAO (SP)";"SP";"PROMISSAO";705;85;149;939
2012;"QUADRA (SP)";"SP";"QUADRA";63;8;14;85
2012;"QUATA (SP)";"SP";"QUATA";223;15;63;301
2012;"QUEIROZ (SP)";"SP";"QUEIROZ";24;6;8;38
2012;"QUELUZ (SP)";"SP";"QUELUZ";110;34;6;150
2012;"QUINTANA (SP)";"SP";"QUINTANA";122;10;22;154
2012;"RAFARD (SP)";"SP";"RAFARD";262;20;29;311
2012;"RANCHARIA (SP)";"SP";"RANCHARIA";576;75;81;732
2012;"REDENCAO DA SERRA (SP)";"SP";"REDENCAO DA SERRA";75;20;32;127
2012;"REGENTE FEIJO (SP)";"SP";"REGENTE FEIJO";381;40;35;456
2012;"REGINOPOLIS (SP)";"SP";"REGINOPOLIS";74;7;20;101
2012;"REGISTRO (SP)";"SP";"REGISTRO";1216;90;281;1587
2012;"RESTINGA (SP)";"SP";"RESTINGA";60;11;22;93
2012;"RIBEIRA (SP)";"SP";"RIBEIRA";24;7;6;37
2012;"RIBEIRAO BONITO (SP)";"SP";"RIBEIRAO BONITO";299;37;84;420
2012;"RIBEIRAO BRANCO (SP)";"SP";"RIBEIRAO BRANCO";163;27;44;234
2012;"RIBEIRAO CORRENTE (SP)";"SP";"RIBEIRAO CORRENTE";66;7;34;107
2012;"RIBEIRAO DO SUL (SP)";"SP";"RIBEIRAO DO SUL";122;12;13;147
2012;"RIBEIRAO DOS INDIOS (SP)";"SP";"RIBEIRAO DOS INDIOS";21;3;13;37
2012;"RIBEIRAO GRANDE (SP)";"SP";"RIBEIRAO GRANDE";66;26;17;109
2012;"RIBEIRAO PIRES (SP)";"SP";"RIBEIRAO PIRES";4081;545;487;5113
2012;"RIBEIRAO PRETO (SP)";"SP";"RIBEIRAO PRETO";10539;962;2083;13584
2012;"RIFAINA (SP)";"SP";"RIFAINA";33;6;12;51
2012;"RINCAO (SP)";"SP";"RINCAO";269;16;50;335
2012;"RINOPOLIS (SP)";"SP";"RINOPOLIS";179;7;50;236
2012;"RIO CLARO (SP)";"SP";"RIO CLARO";3251;352;447;4050
2012;"RIO DAS PEDRAS (SP)";"SP";"RIO DAS PEDRAS";668;79;162;909
2012;"RIO GRANDE DA SERRA (SP)";"SP";"RIO GRANDE DA SERRA";571;164;77;812
2012;"RIOLANDIA (SP)";"SP";"RIOLANDIA";85;10;47;142
2012;"RIVERSUL (SP)";"SP";"RIVERSUL";64;25;27;116
2012;"ROSANA (SP)";"SP";"ROSANA";173;17;60;250
2012;"ROSEIRA (SP)";"SP";"ROSEIRA";132;51;16;199
2012;"RUBIACEA (SP)";"SP";"RUBIACEA";28;3;10;41
2012;"RUBINEIA (SP)";"SP";"RUBINEIA";25;9;10;44
2012;"SABINO (SP)";"SP";"SABINO";61;7;16;84
2012;"SAGRES (SP)";"SP";"SAGRES";22;1;6;29
2012;"SALES (SP)";"SP";"SALES";83;2;31;116
2012;"SALES OLIVEIRA (SP)";"SP";"SALES OLIVEIRA";260;15;42;317
2012;"SALESOPOLIS (SP)";"SP";"SALESOPOLIS";848;78;40;966
2012;"SALMOURAO (SP)";"SP";"SALMOURAO";33;3;34;70
2012;"SALTINHO (SP)";"SP";"SALTINHO";349;11;5;365
2012;"SALTO (SP)";"SP";"SALTO";2219;257;199;2675
2012;"SALTO DE PIRAPORA (SP)";"SP";"SALTO DE PIRAPORA";689;62;53;804
2012;"SALTO GRANDE (SP)";"SP";"SALTO GRANDE";145;15;28;188
2012;"SANDOVALINA (SP)";"SP";"SANDOVALINA";39;4;16;59
2012;"SANTA ADELIA (SP)";"SP";"SANTA ADELIA";611;32;86;729
2012;"SANTA ALBERTINA (SP)";"SP";"SANTA ALBERTINA";130;6;28;164
2012;"SANTA BARBARA D OESTE (SP)";"SP";"SANTA BARBARA D OESTE";2420;426;295;3141
2012;"SANTA BRANCA (SP)";"SP";"SANTA BRANCA";143;47;32;222
2012;"SANTA CLARA D OESTE (SP)";"SP";"SANTA CLARA D OESTE";27;5;4;36
2012;"SANTA CRUZ DA CONCEICAO (SP)";"SP";"SANTA CRUZ DA CONCEICAO";135;18;15;168
2012;"SANTA CRUZ DA ESPERANCA (SP)";"SP";"SANTA CRUZ DA ESPERANCA";27;2;5;34
2012;"SANTA CRUZ DAS PALMEIRAS (SP)";"SP";"SANTA CRUZ DAS PALMEIRAS";594;48;193;835
2012;"SANTA CRUZ DO RIO PARDO (SP)";"SP";"SANTA CRUZ DO RIO PARDO";1286;103;102;1491
2012;"SANTA ERNESTINA (SP)";"SP";"SANTA ERNESTINA";84;20;58;162
2012;"SANTA FE DO SUL (SP)";"SP";"SANTA FE DO SUL";636;26;42;704
2012;"SANTA GERTRUDES (SP)";"SP";"SANTA GERTRUDES";625;55;25;705
2012;"SANTA ISABEL (SP)";"SP";"SANTA ISABEL";1281;97;108;1486
2012;"SANTA LUCIA (SP)";"SP";"SANTA LUCIA";126;24;46;196
2012;"SANTA MARIA DA SERRA (SP)";"SP";"SANTA MARIA DA SERRA";281;30;23;334
2012;"SANTA MERCEDES (SP)";"SP";"SANTA MERCEDES";60;7;10;77
2012;"SANTA RITA D OESTE (SP)";"SP";"SANTA RITA D OESTE";28;1;7;36
2012;"SANTA RITA DO PASSA QUATRO (SP)";"SP";"SANTA RITA DO PASSA QUATRO";585;64;47;696
2012;"SANTA ROSA DE VITERBO (SP)";"SP";"SANTA ROSA DE VITERBO";421;43;98;562
2012;"SANTA SALETE (SP)";"SP";"SANTA SALETE";39;6;8;53
2012;"SANTANA DA PONTE PENSA (SP)";"SP";"SANTANA DA PONTE PENSA";28;3;4;35
2012;"SANTANA DE PARNAIBA (SP)";"SP";"SANTANA DE PARNAIBA";1853;460;180;2493
2012;"SANTO ANASTACIO (SP)";"SP";"SANTO ANASTACIO";477;31;63;571
2012;"SANTO ANDRE (SP)";"SP";"SANTO ANDRE";10148;1826;1699;13673
2012;"SANTO ANTONIO DA ALEGRIA (SP)";"SP";"SANTO ANTONIO DA ALEGRIA";95;7;26;128
2012;"SANTO ANTONIO DE POSSE (SP)";"SP";"SANTO ANTONIO DE POSSE";777;59;135;971
2012;"SANTO ANTONIO DO ARACANGUA (SP)";"SP";"SANTO ANTONIO DO ARACANGUA";207;28;86;321
2012;"SANTO ANTONIO DO JARDIM (SP)";"SP";"SANTO ANTONIO DO JARDIM";200;12;13;225
2012;"SANTO ANTONIO DO PINHAL (SP)";"SP";"SANTO ANTONIO DO PINHAL";146;21;8;175
2012;"SANTO EXPEDITO (SP)";"SP";"SANTO EXPEDITO";27;3;11;41
2012;"SANTOPOLIS DO AGUAPEI (SP)";"SP";"SANTOPOLIS DO AGUAPEI";70;2;28;100
2012;"SANTOS (SP)";"SP";"SANTOS";5793;860;652;7305
2012;"SAO BENTO DO SAPUCAI (SP)";"SP";"SAO BENTO DO SAPUCAI";126;40;13;179
2012;"SAO BERNARDO DO CAMPO (SP)";"SP";"SAO BERNARDO DO CAMPO";12673;2389;3773;18835
2012;"SAO CAETANO DO SUL (SP)";"SP";"SAO CAETANO DO SUL";2839;624;604;4067
2012;"SAO CARLOS (SP)";"SP";"SAO CARLOS";3680;427;426;4533
2012;"SAO FRANCISCO (SP)";"SP";"SAO FRANCISCO";33;6;28;67
2012;"SAO JOAO DA BOA VISTA (SP)";"SP";"SAO JOAO DA BOA VISTA";1920;240;99;2259
2012;"SAO JOAO DAS DUAS PONTES (SP)";"SP";"SAO JOAO DAS DUAS PONTES";15;8;5;28
2012;"SAO JOAO DE IRACEMA (SP)";"SP";"SAO JOAO DE IRACEMA";42;5;10;57
2012;"SAO JOAO DO PAU D ALHO (SP)";"SP";"SAO JOAO DO PAU D ALHO";39;6;5;50
2012;"SAO JOAQUIM DA BARRA (SP)";"SP";"SAO JOAQUIM DA BARRA";803;64;170;1037
2012;"SAO JOSE DA BELA VISTA (SP)";"SP";"SAO JOSE DA BELA VISTA";75;11;46;132
2012;"SAO JOSE DO BARREIRO (SP)";"SP";"SAO JOSE DO BARREIRO";41;16;7;64
2012;"SAO JOSE DO RIO PARDO (SP)";"SP";"SAO JOSE DO RIO PARDO";1202;71;126;1399
2012;"SAO JOSE DO RIO PRETO (SP)";"SP";"SAO JOSE DO RIO PRETO";8105;615;1492;10212
2012;"SAO JOSE DOS CAMPOS (SP)";"SP";"SAO JOSE DOS CAMPOS";6872;1834;1603;10309
2012;"SAO LOURENCO DA SERRA (SP)";"SP";"SAO LOURENCO DA SERRA";326;25;28;379
2012;"SAO LUIZ DO PARAITINGA (SP)";"SP";"SAO LUIZ DO PARAITINGA";161;32;28;221
2012;"SAO MANUEL (SP)";"SP";"SAO MANUEL";781;123;204;1108
2012;"SAO MIGUEL ARCANJO (SP)";"SP";"SAO MIGUEL ARCANJO";673;91;69;833
2012;"SAO PAULO (SP)";"SP";"SAO PAULO";118528;32311;40932;191771
2012;"SAO PEDRO (SP)";"SP";"SAO PEDRO";561;85;78;724
2012;"SAO PEDRO DO TURVO (SP)";"SP";"SAO PEDRO DO TURVO";158;18;40;216
2012;"SAO ROQUE (SP)";"SP";"SAO ROQUE";1098;219;205;1522
2012;"SAO SEBASTIAO (SP)";"SP";"SAO SEBASTIAO";606;128;199;933
2012;"SAO SEBASTIAO DA GRAMA (SP)";"SP";"SAO SEBASTIAO DA GRAMA";236;27;32;295
2012;"SAO SIMAO (SP)";"SP";"SAO SIMAO";354;19;40;413
2012;"SAO VICENTE (SP)";"SP";"SAO VICENTE";1870;648;954;3472
2012;"SARAPUI (SP)";"SP";"SARAPUI";163;21;15;199
2012;"SARUTAIA (SP)";"SP";"SARUTAIA";46;9;25;80
2012;"SEBASTIANOPOLIS DO SUL (SP)";"SP";"SEBASTIANOPOLIS DO SUL";220;6;15;241
2012;"SERRA AZUL (SP)";"SP";"SERRA AZUL";144;11;106;261
2012;"SERRA NEGRA (SP)";"SP";"SERRA NEGRA";427;59;24;510
2012;"SERRANA (SP)";"SP";"SERRANA";620;108;210;938
2012;"SERTAOZINHO (SP)";"SP";"SERTAOZINHO";2667;158;514;3339
2012;"SETE BARRAS (SP)";"SP";"SETE BARRAS";204;13;33;250
2012;"SEVERINIA (SP)";"SP";"SEVERINIA";316;19;215;550
2012;"SILVEIRAS (SP)";"SP";"SILVEIRAS";87;23;6;116
2012;"SOCORRO (SP)";"SP";"SOCORRO";862;140;45;1047
2012;"SOROCABA (SP)";"SP";"SOROCABA";7739;1286;1634;10659
2012;"SUD MENNUCCI (SP)";"SP";"SUD MENNUCCI";128;13;49;190
2012;"SUMARE (SP)";"SP";"SUMARE";2469;558;581;3608
2012;"SUZANAPOLIS (SP)";"SP";"SUZANAPOLIS";61;7;15;83
2012;"SUZANO (SP)";"SP";"SUZANO";2787;708;560;4055
2012;"TABAPUA (SP)";"SP";"TABAPUA";157;13;54;224
2012;"TABATINGA (SP)";"SP";"TABATINGA";339;20;157;516
2012;"TABOAO DA SERRA (SP)";"SP";"TABOAO DA SERRA";2777;862;605;4244
2012;"TACIBA (SP)";"SP";"TACIBA";83;10;24;117
2012;"TAGUAI (SP)";"SP";"TAGUAI";181;9;27;217
2012;"TAIACU (SP)";"SP";"TAIACU";146;7;25;178
2012;"TAIUVA (SP)";"SP";"TAIUVA";159;11;27;197
2012;"TAMBAU (SP)";"SP";"TAMBAU";533;47;56;636
2012;"TANABI (SP)";"SP";"TANABI";502;62;110;674
2012;"TAPIRAI (SP)";"SP";"TAPIRAI";174;12;13;199
2012;"TAPIRATIBA (SP)";"SP";"TAPIRATIBA";384;20;68;472
2012;"TAQUARAL (SP)";"SP";"TAQUARAL";61;9;20;90
2012;"TAQUARITINGA (SP)";"SP";"TAQUARITINGA";1485;93;324;1902
2012;"TAQUARITUBA (SP)";"SP";"TAQUARITUBA";629;61;85;775
2012;"TAQUARIVAI (SP)";"SP";"TAQUARIVAI";55;10;14;79
2012;"TARABAI (SP)";"SP";"TARABAI";98;7;26;131
2012;"TARUMA (SP)";"SP";"TARUMA";350;23;171;544
2012;"TATUI (SP)";"SP";"TATUI";2095;178;768;3041
2012;"TAUBATE (SP)";"SP";"TAUBATE";3232;806;847;4885
2012;"TEJUPA (SP)";"SP";"TEJUPA";54;20;8;82
2012;"TEODORO SAMPAIO (SP)";"SP";"TEODORO SAMPAIO";269;32;335;636
2012;"TERRA ROXA (SP)";"SP";"TERRA ROXA";164;16;64;244
2012;"TIETE (SP)";"SP";"TIETE";1220;56;167;1443
2012;"TIMBURI (SP)";"SP";"TIMBURI";26;6;5;37
2012;"TORRE DE PEDRA (SP)";"SP";"TORRE DE PEDRA";41;8;7;56
2012;"TORRINHA (SP)";"SP";"TORRINHA";403;20;48;471
2012;"TRABIJU (SP)";"SP";"TRABIJU";45;16;9;70
2012;"TREMEMBE (SP)";"SP";"TREMEMBE";415;67;14;496
2012;"TRES FRONTEIRAS (SP)";"SP";"TRES FRONTEIRAS";64;8;12;84
2012;"TUIUTI (SP)";"SP";"TUIUTI";104;22;12;138
2012;"TUPA (SP)";"SP";"TUPA";1424;58;238;1720
2012;"TUPI PAULISTA (SP)";"SP";"TUPI PAULISTA";313;25;29;367
2012;"TURIUBA (SP)";"SP";"TURIUBA";20;0;9;29
2012;"TURMALINA (SP)";"SP";"TURMALINA";21;2;10;33
2012;"UBARANA (SP)";"SP";"UBARANA";120;5;35;160
2012;"UBATUBA (SP)";"SP";"UBATUBA";679;97;73;849
2012;"UBIRAJARA (SP)";"SP";"UBIRAJARA";90;8;29;127
2012;"UCHOA (SP)";"SP";"UCHOA";159;13;44;216
2012;"UNIAO PAULISTA (SP)";"SP";"UNIAO PAULISTA";46;6;8;60
2012;"URANIA (SP)";"SP";"URANIA";154;17;33;204
2012;"URU (SP)";"SP";"URU";10;9;10;29
2012;"URUPES (SP)";"SP";"URUPES";360;22;51;433
2012;"VALENTIM GENTIL (SP)";"SP";"VALENTIM GENTIL";278;18;32;328
2012;"VALINHOS (SP)";"SP";"VALINHOS";2120;489;2008;4617
2012;"VALPARAISO (SP)";"SP";"VALPARAISO";447;31;142;620
2012;"VARGEM (SP)";"SP";"VARGEM";306;20;17;343
2012;"VARGEM GRANDE DO SUL (SP)";"SP";"VARGEM GRANDE DO SUL";1122;84;206;1412
2012;"VARGEM GRANDE PAULISTA (SP)";"SP";"VARGEM GRANDE PAULISTA";965;109;87;1161
2012;"VARZEA PAULISTA (SP)";"SP";"VARZEA PAULISTA";1099;382;272;1753
2012;"VERA CRUZ (SP)";"SP";"VERA CRUZ";136;24;28;188
2012;"VINHEDO (SP)";"SP";"VINHEDO";1570;170;124;1864
2012;"VIRADOURO (SP)";"SP";"VIRADOURO";355;23;72;450
2012;"VISTA ALEGRE DO ALTO (SP)";"SP";"VISTA ALEGRE DO ALTO";367;30;125;522
2012;"VITORIA BRASIL (SP)";"SP";"VITORIA BRASIL";21;2;9;32
2012;"VOTORANTIM (SP)";"SP";"VOTORANTIM";1273;312;285;1870
2012;"VOTUPORANGA (SP)";"SP";"VOTUPORANGA";1992;136;227;2355
2012;"ZACARIAS (SP)";"SP";"ZACARIAS";47;5;17;69
2012;"ABREULANDIA (TO)";"TO";"ABREULANDIA";12;1;1;14
2012;"AGUIARNOPOLIS (TO)";"TO";"AGUIARNOPOLIS";68;9;15;92
2012;"ALIANCA DO TOCANTINS (TO)";"TO";"ALIANCA DO TOCANTINS";67;7;8;82
2012;"ALMAS (TO)";"TO";"ALMAS";63;0;6;69
2012;"ALVORADA (TO)";"TO";"ALVORADA";160;1;5;166
2012;"ANANAS (TO)";"TO";"ANANAS";69;2;25;96
2012;"ANGICO (TO)";"TO";"ANGICO";15;3;5;23
2012;"APARECIDA DO RIO NEGRO (TO)";"TO";"APARECIDA DO RIO NEGRO";54;12;2;68
2012;"ARAGOMINAS (TO)";"TO";"ARAGOMINAS";70;2;14;86
2012;"ARAGUACEMA (TO)";"TO";"ARAGUACEMA";25;1;6;32
2012;"ARAGUACU (TO)";"TO";"ARAGUACU";92;8;7;107
2012;"ARAGUAINA (TO)";"TO";"ARAGUAINA";3676;135;550;4361
2012;"ARAGUANA (TO)";"TO";"ARAGUANA";144;6;35;185
2012;"ARAGUATINS (TO)";"TO";"ARAGUATINS";330;43;61;434
2012;"ARAPOEMA (TO)";"TO";"ARAPOEMA";42;5;10;57
2012;"ARRAIAS (TO)";"TO";"ARRAIAS";45;1;4;50
2012;"AUGUSTINOPOLIS (TO)";"TO";"AUGUSTINOPOLIS";193;36;30;259
2012;"AURORA DO TOCANTINS (TO)";"TO";"AURORA DO TOCANTINS";8;0;3;11
2012;"AXIXA DO TOCANTINS (TO)";"TO";"AXIXA DO TOCANTINS";42;19;8;69
2012;"BABACULANDIA (TO)";"TO";"BABACULANDIA";409;13;20;442
2012;"BANDEIRANTES DO TOCANTINS (TO)";"TO";"BANDEIRANTES DO TOCANTINS";21;3;2;26
2012;"BARRA DO OURO (TO)";"TO";"BARRA DO OURO";10;2;0;12
2012;"BARROLANDIA (TO)";"TO";"BARROLANDIA";50;4;4;58
2012;"BERNARDO SAYAO (TO)";"TO";"BERNARDO SAYAO";33;1;7;41
2012;"BOM JESUS DO TOCANTINS (TO)";"TO";"BOM JESUS DO TOCANTINS";5;1;1;7
2012;"BRASILANDIA DO TOCANTINS (TO)";"TO";"BRASILANDIA DO TOCANTINS";14;3;2;19
2012;"BREJINHO DE NAZARE (TO)";"TO";"BREJINHO DE NAZARE";41;1;13;55
2012;"BURITI DO TOCANTINS (TO)";"TO";"BURITI DO TOCANTINS";53;11;6;70
2012;"CACHOEIRINHA (TO)";"TO";"CACHOEIRINHA";5;0;1;6
2012;"CAMPOS LINDOS (TO)";"TO";"CAMPOS LINDOS";57;0;4;61
2012;"CARIRI DO TOCANTINS (TO)";"TO";"CARIRI DO TOCANTINS";32;4;8;44
2012;"CARMOLANDIA (TO)";"TO";"CARMOLANDIA";335;24;132;491
2012;"CARRASCO BONITO (TO)";"TO";"CARRASCO BONITO";4;5;1;10
2012;"CASEARA (TO)";"TO";"CASEARA";20;2;3;25
2012;"CENTENARIO (TO)";"TO";"CENTENARIO";4;0;2;6
2012;"CHAPADA DA NATIVIDADE (TO)";"TO";"CHAPADA DA NATIVIDADE";14;1;7;22
2012;"CHAPADA DE AREIA (TO)";"TO";"CHAPADA DE AREIA";2;1;1;4
2012;"COLINAS DO TOCANTINS (TO)";"TO";"COLINAS DO TOCANTINS";499;10;56;565
2012;"COLMEIA (TO)";"TO";"COLMEIA";116;7;14;137
2012;"COMBINADO (TO)";"TO";"COMBINADO";16;1;7;24
2012;"CONCEICAO DO TOCANTINS (TO)";"TO";"CONCEICAO DO TOCANTINS";15;1;1;17
2012;"COUTO DE MAGALHAES (TO)";"TO";"COUTO DE MAGALHAES";10;4;7;21
2012;"CRISTALANDIA (TO)";"TO";"CRISTALANDIA";93;1;2;96
2012;"CRIXAS DO TOCANTINS (TO)";"TO";"CRIXAS DO TOCANTINS";7;1;1;9
2012;"DARCINOPOLIS (TO)";"TO";"DARCINOPOLIS";84;8;7;99
2012;"DIANOPOLIS (TO)";"TO";"DIANOPOLIS";160;11;37;208
2012;"DIVINOPOLIS DO TOCANTINS (TO)";"TO";"DIVINOPOLIS DO TOCANTINS";61;3;4;68
2012;"DOIS IRMAOS DO TOCANTINS (TO)";"TO";"DOIS IRMAOS DO TOCANTINS";32;7;8;47
2012;"DUERE (TO)";"TO";"DUERE";35;2;4;41
2012;"ESPERANTINA (TO)";"TO";"ESPERANTINA";18;14;8;40
2012;"FATIMA (TO)";"TO";"FATIMA";42;2;4;48
2012;"FIGUEIROPOLIS (TO)";"TO";"FIGUEIROPOLIS";56;4;4;64
2012;"FILADELFIA (TO)";"TO";"FILADELFIA";53;9;7;69
2012;"FORMOSO DO ARAGUAIA (TO)";"TO";"FORMOSO DO ARAGUAIA";214;8;21;243
2012;"FORTALEZA DO TABOCAO (TO)";"TO";"FORTALEZA DO TABOCAO";24;6;3;33
2012;"GOIANORTE (TO)";"TO";"GOIANORTE";36;4;7;47
2012;"GOIATINS (TO)";"TO";"GOIATINS";66;6;11;83
2012;"GUARAI (TO)";"TO";"GUARAI";368;9;34;411
2012;"GURUPI (TO)";"TO";"GURUPI";1542;38;219;1799
2012;"IPUEIRAS (TO)";"TO";"IPUEIRAS";6;0;3;9
2012;"ITACAJA (TO)";"TO";"ITACAJA";32;2;1;35
2012;"ITAGUATINS (TO)";"TO";"ITAGUATINS";41;4;21;66
2012;"ITAPIRATINS (TO)";"TO";"ITAPIRATINS";22;2;7;31
2012;"ITAPORA DO TOCANTINS (TO)";"TO";"ITAPORA DO TOCANTINS";15;3;5;23
2012;"JAU DO TOCANTINS (TO)";"TO";"JAU DO TOCANTINS";15;1;6;22
2012;"JUARINA (TO)";"TO";"JUARINA";12;2;4;18
2012;"LAGOA DA CONFUSAO (TO)";"TO";"LAGOA DA CONFUSAO";109;5;8;122
2012;"LAGOA DO TOCANTINS (TO)";"TO";"LAGOA DO TOCANTINS";7;0;5;12
2012;"LAJEADO (TO)";"TO";"LAJEADO";26;1;8;35
2012;"LAVANDEIRA (TO)";"TO";"LAVANDEIRA";2;0;0;2
2012;"LIZARDA (TO)";"TO";"LIZARDA";13;1;1;15
2012;"LUZINOPOLIS (TO)";"TO";"LUZINOPOLIS";10;2;0;12
2012;"MARIANOPOLIS DO TOCANTINS (TO)";"TO";"MARIANOPOLIS DO TOCANTINS";36;0;4;40
2012;"MATEIROS (TO)";"TO";"MATEIROS";23;0;4;27
2012;"MAURILANDIA DO TOCANTINS (TO)";"TO";"MAURILANDIA DO TOCANTINS";9;7;2;18
2012;"MIRACEMA DO TOCANTINS (TO)";"TO";"MIRACEMA DO TOCANTINS";187;19;34;240
2012;"MIRANORTE (TO)";"TO";"MIRANORTE";222;10;14;246
2012;"MONTE DO CARMO (TO)";"TO";"MONTE DO CARMO";19;3;6;28
2012;"MONTE SANTO DO TOCANTINS (TO)";"TO";"MONTE SANTO DO TOCANTINS";20;3;2;25
2012;"MURICILANDIA (TO)";"TO";"MURICILANDIA";11;1;1;13
2012;"NATIVIDADE (TO)";"TO";"NATIVIDADE";73;3;7;83
2012;"NAZARE (TO)";"TO";"NAZARE";20;5;4;29
2012;"NOVA OLINDA (TO)";"TO";"NOVA OLINDA";89;3;23;115
2012;"NOVA ROSALANDIA (TO)";"TO";"NOVA ROSALANDIA";16;1;2;19
2012;"NOVO ACORDO (TO)";"TO";"NOVO ACORDO";23;0;4;27
2012;"NOVO ALEGRE (TO)";"TO";"NOVO ALEGRE";8;2;4;14
2012;"NOVO JARDIM (TO)";"TO";"NOVO JARDIM";14;0;3;17
2012;"OLIVEIRA DE FATIMA (TO)";"TO";"OLIVEIRA DE FATIMA";9;0;3;12
2012;"PALMAS (TO)";"TO";"PALMAS";4524;294;1361;6179
2012;"PALMEIRANTE (TO)";"TO";"PALMEIRANTE";13;3;2;18
2012;"PALMEIRAS DO TOCANTINS (TO)";"TO";"PALMEIRAS DO TOCANTINS";35;8;7;50
2012;"PALMEIROPOLIS (TO)";"TO";"PALMEIROPOLIS";99;2;13;114
2012;"PARAISO DO TOCANTINS (TO)";"TO";"PARAISO DO TOCANTINS";1162;29;111;1302
2012;"PARANA (TO)";"TO";"PARANA";21;4;1;26
2012;"PAU D ARCO (TO)";"TO";"PAU D ARCO";19;1;3;23
2012;"PEDRO AFONSO (TO)";"TO";"PEDRO AFONSO";194;5;48;247
2012;"PEIXE (TO)";"TO";"PEIXE";65;8;39;112
2012;"PEQUIZEIRO (TO)";"TO";"PEQUIZEIRO";30;1;6;37
2012;"PINDORAMA DO TOCANTINS (TO)";"TO";"PINDORAMA DO TOCANTINS";21;0;5;26
2012;"PIRAQUE (TO)";"TO";"PIRAQUE";3;0;7;10
2012;"PIUM (TO)";"TO";"PIUM";45;2;8;55
2012;"PONTE ALTA DO BOM JESUS (TO)";"TO";"PONTE ALTA DO BOM JESUS";12;2;1;15
2012;"PONTE ALTA DO TOCANTINS (TO)";"TO";"PONTE ALTA DO TOCANTINS";27;2;4;33
2012;"PORTO ALEGRE DO TOCANTINS (TO)";"TO";"PORTO ALEGRE DO TOCANTINS";6;0;6;12
2012;"PORTO NACIONAL (TO)";"TO";"PORTO NACIONAL";636;46;95;777
2012;"PRAIA NORTE (TO)";"TO";"PRAIA NORTE";7;7;2;16
2012;"PRESIDENTE KENNEDY (TO)";"TO";"PRESIDENTE KENNEDY";35;2;2;39
2012;"PUGMIL (TO)";"TO";"PUGMIL";17;2;1;20
2012;"RECURSOLANDIA (TO)";"TO";"RECURSOLANDIA";11;0;1;12
2012;"RIACHINHO (TO)";"TO";"RIACHINHO";160;18;123;301
2012;"RIO DA CONCEICAO (TO)";"TO";"RIO DA CONCEICAO";5;1;1;7
2012;"RIO DOS BOIS (TO)";"TO";"RIO DOS BOIS";7;0;2;9
2012;"RIO SONO (TO)";"TO";"RIO SONO";18;1;6;25
2012;"SAMPAIO (TO)";"TO";"SAMPAIO";71;2;4;77
2012;"SANDOLANDIA (TO)";"TO";"SANDOLANDIA";15;6;1;22
2012;"SANTA FE DO ARAGUAIA (TO)";"TO";"SANTA FE DO ARAGUAIA";60;10;11;81
2012;"SANTA MARIA DO TOCANTINS (TO)";"TO";"SANTA MARIA DO TOCANTINS";12;4;2;18
2012;"SANTA RITA DO TOCANTINS (TO)";"TO";"SANTA RITA DO TOCANTINS";10;2;3;15
2012;"SANTA ROSA DO TOCANTINS (TO)";"TO";"SANTA ROSA DO TOCANTINS";27;0;3;30
2012;"SANTA TEREZA DO TOCANTINS (TO)";"TO";"SANTA TEREZA DO TOCANTINS";17;1;3;21
2012;"SANTA TEREZINHA DO TOCANTINS (TO)";"TO";"SANTA TEREZINHA DO TOCANTINS";11;4;2;17
2012;"SAO BENTO DO TOCANTINS (TO)";"TO";"SAO BENTO DO TOCANTINS";21;3;9;33
2012;"SAO FELIX DO TOCANTINS (TO)";"TO";"SAO FELIX DO TOCANTINS";6;0;0;6
2012;"SAO MIGUEL DO TOCANTINS (TO)";"TO";"SAO MIGUEL DO TOCANTINS";119;20;46;185
2012;"SAO SALVADOR DO TOCANTINS (TO)";"TO";"SAO SALVADOR DO TOCANTINS";21;4;4;29
2012;"SAO SEBASTIAO DO TOCANTINS (TO)";"TO";"SAO SEBASTIAO DO TOCANTINS";11;2;3;16
2012;"SAO VALERIO DA NATIVIDADE (TO)";"TO";"SAO VALERIO DA NATIVIDADE";45;1;5;51
2012;"SILVANOPOLIS (TO)";"TO";"SILVANOPOLIS";35;1;3;39
2012;"SITIO NOVO DO TOCANTINS (TO)";"TO";"SITIO NOVO DO TOCANTINS";50;6;15;71
2012;"SUCUPIRA (TO)";"TO";"SUCUPIRA";11;0;5;16
2012;"TAGUATINGA (TO)";"TO";"TAGUATINGA";85;7;17;109
2012;"TAIPAS DO TOCANTINS (TO)";"TO";"TAIPAS DO TOCANTINS";7;1;1;9
2012;"TALISMA (TO)";"TO";"TALISMA";13;6;1;20
2012;"TOCANTINIA (TO)";"TO";"TOCANTINIA";25;1;4;30
2012;"TOCANTINOPOLIS (TO)";"TO";"TOCANTINOPOLIS";1319;210;316;1845
2012;"TUPIRAMA (TO)";"TO";"TUPIRAMA";18;2;2;22
2012;"TUPIRATINS (TO)";"TO";"TUPIRATINS";8;0;4;12
2012;"WANDERLANDIA (TO)";"TO";"WANDERLANDIA";79;4;7;90
2012;"XAMBIOA (TO)";"TO";"XAMBIOA";123;4;20;147
