"ano";"chave";"UF";"MUNICIPIO";"CAMINHAO";"MICRO_ONIBUS";"ONIBUS";"total"
2007;"ACRELANDIA (AC)";"AC";"ACRELANDIA";77;1;16;94
2007;"ASSIS BRASIL (AC)";"AC";"ASSIS BRASIL";12;0;1;13
2007;"BRASILEIA (AC)";"AC";"BRASILEIA";109;0;5;114
2007;"BUJARI (AC)";"AC";"BUJARI";47;3;2;52
2007;"CAPIXABA (AC)";"AC";"CAPIXABA";32;1;4;37
2007;"CRUZEIRO DO SUL (AC)";"AC";"CRUZEIRO DO SUL";298;25;24;347
2007;"EPITACIOLANDIA (AC)";"AC";"EPITACIOLANDIA";88;1;8;97
2007;"FEIJO (AC)";"AC";"FEIJO";45;1;0;46
2007;"JORDAO (AC)";"AC";"JORDAO";0;0;0;0
2007;"MANCIO LIMA (AC)";"AC";"MANCIO LIMA";26;1;4;31
2007;"MANOEL URBANO (AC)";"AC";"MANOEL URBANO";6;0;0;6
2007;"MARECHAL THAUMATURGO (AC)";"AC";"MARECHAL THAUMATURGO";2;0;0;2
2007;"PLACIDO DE CASTRO (AC)";"AC";"PLACIDO DE CASTRO";66;1;1;68
2007;"PORTO ACRE (AC)";"AC";"PORTO ACRE";63;3;17;83
2007;"PORTO WALTER (AC)";"AC";"PORTO WALTER";0;0;0;0
2007;"RIO BRANCO (AC)";"AC";"RIO BRANCO";2767;94;368;3229
2007;"RODRIGUES ALVES (AC)";"AC";"RODRIGUES ALVES";4;0;0;4
2007;"SANTA ROSA (AC)";"AC";"SANTA ROSA";1;0;0;1
2007;"SENA MADUREIRA (AC)";"AC";"SENA MADUREIRA";53;1;1;55
2007;"SENADOR GUIOMARD (AC)";"AC";"SENADOR GUIOMARD";152;0;7;159
2007;"TARAUACA (AC)";"AC";"TARAUACA";54;0;2;56
2007;"XAPURI (AC)";"AC";"XAPURI";30;0;0;30
2007;"AGUA BRANCA (AL)";"AL";"AGUA BRANCA";33;7;1;41
2007;"ANADIA (AL)";"AL";"ANADIA";17;34;18;69
2007;"ARAPIRACA (AL)";"AL";"ARAPIRACA";2136;298;203;2637
2007;"ATALAIA (AL)";"AL";"ATALAIA";187;40;72;299
2007;"BARRA DE SANTO ANTONIO (AL)";"AL";"BARRA DE SANTO ANTONIO";22;5;8;35
2007;"BARRA DE SAO MIGUEL (AL)";"AL";"BARRA DE SAO MIGUEL";16;3;4;23
2007;"BATALHA (AL)";"AL";"BATALHA";65;10;2;77
2007;"BELEM (AL)";"AL";"BELEM";7;12;2;21
2007;"BELO MONTE (AL)";"AL";"BELO MONTE";18;2;0;20
2007;"BOCA DA MATA (AL)";"AL";"BOCA DA MATA";189;55;71;315
2007;"BRANQUINHA (AL)";"AL";"BRANQUINHA";9;19;7;35
2007;"CACIMBINHAS (AL)";"AL";"CACIMBINHAS";28;14;5;47
2007;"CAJUEIRO (AL)";"AL";"CAJUEIRO";94;10;35;139
2007;"CAMPESTRE (AL)";"AL";"CAMPESTRE";3;20;6;29
2007;"CAMPO ALEGRE (AL)";"AL";"CAMPO ALEGRE";115;90;101;306
2007;"CAMPO GRANDE (AL)";"AL";"CAMPO GRANDE";32;9;3;44
2007;"CANAPI (AL)";"AL";"CANAPI";16;15;6;37
2007;"CAPELA (AL)";"AL";"CAPELA";53;5;13;71
2007;"CARNEIROS (AL)";"AL";"CARNEIROS";20;1;0;21
2007;"CHA PRETA (AL)";"AL";"CHA PRETA";17;4;1;22
2007;"COITE DO NOIA (AL)";"AL";"COITE DO NOIA";18;3;14;35
2007;"COLONIA LEOPOLDINA (AL)";"AL";"COLONIA LEOPOLDINA";33;14;10;57
2007;"COQUEIRO SECO (AL)";"AL";"COQUEIRO SECO";5;1;3;9
2007;"CORURIPE (AL)";"AL";"CORURIPE";267;32;118;417
2007;"CRAIBAS (AL)";"AL";"CRAIBAS";50;22;14;86
2007;"DELMIRO GOUVEIA (AL)";"AL";"DELMIRO GOUVEIA";332;230;24;586
2007;"DOIS RIACHOS (AL)";"AL";"DOIS RIACHOS";38;4;2;44
2007;"ESTRELA DE ALAGOAS (AL)";"AL";"ESTRELA DE ALAGOAS";21;25;10;56
2007;"FEIRA GRANDE (AL)";"AL";"FEIRA GRANDE";24;0;14;38
2007;"FELIZ DESERTO (AL)";"AL";"FELIZ DESERTO";3;6;2;11
2007;"FLEXEIRAS (AL)";"AL";"FLEXEIRAS";20;12;17;49
2007;"GIRAU DO PONCIANO (AL)";"AL";"GIRAU DO PONCIANO";61;18;25;104
2007;"IBATEGUARA (AL)";"AL";"IBATEGUARA";22;50;5;77
2007;"IGACI (AL)";"AL";"IGACI";46;32;15;93
2007;"IGREJA NOVA (AL)";"AL";"IGREJA NOVA";55;12;42;109
2007;"INHAPI (AL)";"AL";"INHAPI";30;3;1;34
2007;"JACARE DOS HOMENS (AL)";"AL";"JACARE DOS HOMENS";26;2;3;31
2007;"JACUIPE (AL)";"AL";"JACUIPE";3;5;6;14
2007;"JAPARATINGA (AL)";"AL";"JAPARATINGA";13;10;3;26
2007;"JARAMATAIA (AL)";"AL";"JARAMATAIA";11;5;2;18
2007;"JEQUIA DA PRAIA (AL)";"AL";"JEQUIA DA PRAIA";5;10;10;25
2007;"JOAQUIM GOMES (AL)";"AL";"JOAQUIM GOMES";62;25;34;121
2007;"JUNDIA (AL)";"AL";"JUNDIA";5;4;7;16
2007;"JUNQUEIRO (AL)";"AL";"JUNQUEIRO";109;20;60;189
2007;"LAGOA DA CANOA (AL)";"AL";"LAGOA DA CANOA";37;10;13;60
2007;"LIMOEIRO DE ANADIA (AL)";"AL";"LIMOEIRO DE ANADIA";41;9;19;69
2007;"MACEIO (AL)";"AL";"MACEIO";4241;652;1283;6176
2007;"MAJOR ISIDORO (AL)";"AL";"MAJOR ISIDORO";39;18;5;62
2007;"MAR VERMELHO (AL)";"AL";"MAR VERMELHO";5;1;4;10
2007;"MARAGOGI (AL)";"AL";"MARAGOGI";20;59;12;91
2007;"MARAVILHA (AL)";"AL";"MARAVILHA";25;9;4;38
2007;"MARECHAL DEODORO (AL)";"AL";"MARECHAL DEODORO";160;67;50;277
2007;"MARIBONDO (AL)";"AL";"MARIBONDO";29;18;6;53
2007;"MATA GRANDE (AL)";"AL";"MATA GRANDE";41;15;1;57
2007;"MATRIZ DE CAMARAGIBE (AL)";"AL";"MATRIZ DE CAMARAGIBE";88;32;65;185
2007;"MESSIAS (AL)";"AL";"MESSIAS";46;22;51;119
2007;"MINADOR DO NEGRAO (AL)";"AL";"MINADOR DO NEGRAO";20;6;2;28
2007;"MONTEIROPOLIS (AL)";"AL";"MONTEIROPOLIS";6;2;1;9
2007;"MURICI (AL)";"AL";"MURICI";94;23;39;156
2007;"NOVO LINO (AL)";"AL";"NOVO LINO";45;20;16;81
2007;"OLHO D AGUA DAS FLORES (AL)";"AL";"OLHO D AGUA DAS FLORES";139;21;5;165
2007;"OLHO D AGUA DO CASADO (AL)";"AL";"OLHO D AGUA DO CASADO";14;11;2;27
2007;"OLHO D AGUA GRANDE (AL)";"AL";"OLHO D AGUA GRANDE";6;0;6;12
2007;"OLIVENCA (AL)";"AL";"OLIVENCA";11;5;4;20
2007;"OURO BRANCO (AL)";"AL";"OURO BRANCO";22;23;12;57
2007;"PALESTINA (AL)";"AL";"PALESTINA";3;4;2;9
2007;"PALMEIRA DOS INDIOS (AL)";"AL";"PALMEIRA DOS INDIOS";407;79;23;509
2007;"PAO DE ACUCAR (AL)";"AL";"PAO DE ACUCAR";43;11;4;58
2007;"PARICONHA (AL)";"AL";"PARICONHA";10;6;3;19
2007;"PARIPUEIRA (AL)";"AL";"PARIPUEIRA";34;3;7;44
2007;"PASSO DE CAMARAGIBE (AL)";"AL";"PASSO DE CAMARAGIBE";23;4;7;34
2007;"PAULO JACINTO (AL)";"AL";"PAULO JACINTO";8;4;3;15
2007;"PENEDO (AL)";"AL";"PENEDO";215;60;118;393
2007;"PIACABUCU (AL)";"AL";"PIACABUCU";15;17;7;39
2007;"PILAR (AL)";"AL";"PILAR";125;41;53;219
2007;"PINDOBA (AL)";"AL";"PINDOBA";10;1;1;12
2007;"PIRANHAS (AL)";"AL";"PIRANHAS";30;25;4;59
2007;"POCO DAS TRINCHEIRAS (AL)";"AL";"POCO DAS TRINCHEIRAS";33;11;10;54
2007;"PORTO CALVO (AL)";"AL";"PORTO CALVO";133;51;26;210
2007;"PORTO DE PEDRAS (AL)";"AL";"PORTO DE PEDRAS";5;7;2;14
2007;"PORTO REAL DO COLEGIO (AL)";"AL";"PORTO REAL DO COLEGIO";9;17;10;36
2007;"QUEBRANGULO (AL)";"AL";"QUEBRANGULO";12;4;3;19
2007;"RIO LARGO (AL)";"AL";"RIO LARGO";285;99;102;486
2007;"ROTEIRO (AL)";"AL";"ROTEIRO";14;12;5;31
2007;"SANTA LUZIA DO NORTE (AL)";"AL";"SANTA LUZIA DO NORTE";4;3;62;69
2007;"SANTANA DO IPANEMA (AL)";"AL";"SANTANA DO IPANEMA";247;53;12;312
2007;"SANTANA DO MUNDAU (AL)";"AL";"SANTANA DO MUNDAU";34;19;0;53
2007;"SAO BRAS (AL)";"AL";"SAO BRAS";1;1;2;4
2007;"SAO JOSE DA LAJE (AL)";"AL";"SAO JOSE DA LAJE";70;51;17;138
2007;"SAO JOSE DA TAPERA (AL)";"AL";"SAO JOSE DA TAPERA";56;6;6;68
2007;"SAO LUIS DO QUITUNDE (AL)";"AL";"SAO LUIS DO QUITUNDE";200;11;64;275
2007;"SAO MIGUEL DOS CAMPOS (AL)";"AL";"SAO MIGUEL DOS CAMPOS";429;117;134;680
2007;"SAO MIGUEL DOS MILAGRES (AL)";"AL";"SAO MIGUEL DOS MILAGRES";16;1;2;19
2007;"SAO SEBASTIAO (AL)";"AL";"SAO SEBASTIAO";89;24;65;178
2007;"SATUBA (AL)";"AL";"SATUBA";36;16;7;59
2007;"SENADOR RUI PALMEIRA (AL)";"AL";"SENADOR RUI PALMEIRA";18;4;5;27
2007;"TANQUE D ARCA (AL)";"AL";"TANQUE D ARCA";6;7;2;15
2007;"TAQUARANA (AL)";"AL";"TAQUARANA";29;18;15;62
2007;"TEOTONIO VILELA (AL)";"AL";"TEOTONIO VILELA";142;58;121;321
2007;"TRAIPU (AL)";"AL";"TRAIPU";37;6;5;48
2007;"UNIAO DOS PALMARES (AL)";"AL";"UNIAO DOS PALMARES";383;157;86;626
2007;"VICOSA (AL)";"AL";"VICOSA";98;12;19;129
2007;"ALVARAES (AM)";"AM";"ALVARAES";1;0;1;2
2007;"AMATURA (AM)";"AM";"AMATURA";1;0;0;1
2007;"ANAMA (AM)";"AM";"ANAMA";0;0;0;0
2007;"ANORI (AM)";"AM";"ANORI";1;0;0;1
2007;"APUI (AM)";"AM";"APUI";28;1;3;32
2007;"ATALAIA DO NORTE (AM)";"AM";"ATALAIA DO NORTE";1;0;0;1
2007;"AUTAZES (AM)";"AM";"AUTAZES";6;2;3;11
2007;"BARCELOS (AM)";"AM";"BARCELOS";5;1;0;6
2007;"BARREIRINHA (AM)";"AM";"BARREIRINHA";0;0;0;0
2007;"BENJAMIN CONSTANT (AM)";"AM";"BENJAMIN CONSTANT";3;1;1;5
2007;"BERURI (AM)";"AM";"BERURI";0;0;0;0
2007;"BOA VISTA DO RAMOS (AM)";"AM";"BOA VISTA DO RAMOS";1;0;0;1
2007;"BOCA DO ACRE (AM)";"AM";"BOCA DO ACRE";17;2;0;19
2007;"BORBA (AM)";"AM";"BORBA";3;0;0;3
2007;"CAAPIRANGA (AM)";"AM";"CAAPIRANGA";4;1;1;6
2007;"CANUTAMA (AM)";"AM";"CANUTAMA";0;0;0;0
2007;"CARAUARI (AM)";"AM";"CARAUARI";10;1;0;11
2007;"CAREIRO (AM)";"AM";"CAREIRO";30;8;27;65
2007;"CAREIRO DA VARZEA (AM)";"AM";"CAREIRO DA VARZEA";11;16;11;38
2007;"COARI (AM)";"AM";"COARI";64;3;2;69
2007;"CODAJAS (AM)";"AM";"CODAJAS";3;0;0;3
2007;"EIRUNEPE (AM)";"AM";"EIRUNEPE";15;0;0;15
2007;"ENVIRA (AM)";"AM";"ENVIRA";6;0;1;7
2007;"FONTE BOA (AM)";"AM";"FONTE BOA";12;0;0;12
2007;"GUAJARA (AM)";"AM";"GUAJARA";0;0;0;0
2007;"HUMAITA (AM)";"AM";"HUMAITA";72;1;7;80
2007;"IPIXUNA (AM)";"AM";"IPIXUNA";0;0;0;0
2007;"IRANDUBA (AM)";"AM";"IRANDUBA";92;5;30;127
2007;"ITACOATIARA (AM)";"AM";"ITACOATIARA";219;20;72;311
2007;"ITAMARATI (AM)";"AM";"ITAMARATI";2;0;0;2
2007;"ITAPIRANGA (AM)";"AM";"ITAPIRANGA";1;0;0;1
2007;"JAPURA (AM)";"AM";"JAPURA";3;0;0;3
2007;"JURUA (AM)";"AM";"JURUA";4;0;0;4
2007;"JUTAI (AM)";"AM";"JUTAI";1;0;0;1
2007;"LABREA (AM)";"AM";"LABREA";14;1;1;16
2007;"MANACAPURU (AM)";"AM";"MANACAPURU";151;17;62;230
2007;"MANAQUIRI (AM)";"AM";"MANAQUIRI";6;0;0;6
2007;"MANAUS (AM)";"AM";"MANAUS";11957;1928;4841;18726
2007;"MANICORE (AM)";"AM";"MANICORE";7;1;3;11
2007;"MARAA (AM)";"AM";"MARAA";0;0;0;0
2007;"MAUES (AM)";"AM";"MAUES";22;0;2;24
2007;"NHAMUNDA (AM)";"AM";"NHAMUNDA";3;0;0;3
2007;"NOVA OLINDA DO NORTE (AM)";"AM";"NOVA OLINDA DO NORTE";7;2;3;12
2007;"NOVO AIRAO (AM)";"AM";"NOVO AIRAO";9;0;2;11
2007;"NOVO ARIPUANA (AM)";"AM";"NOVO ARIPUANA";7;0;4;11
2007;"PARINTINS (AM)";"AM";"PARINTINS";89;2;8;99
2007;"PAUINI (AM)";"AM";"PAUINI";2;1;0;3
2007;"PRESIDENTE FIGUEIREDO (AM)";"AM";"PRESIDENTE FIGUEIREDO";144;16;35;195
2007;"RIO PRETO DA EVA (AM)";"AM";"RIO PRETO DA EVA";47;7;18;72
2007;"SANTA ISABEL DO RIO NEGRO (AM)";"AM";"SANTA ISABEL DO RIO NEGRO";5;2;3;10
2007;"SANTO ANTONIO DO ICA (AM)";"AM";"SANTO ANTONIO DO ICA";5;0;0;5
2007;"SAO GABRIEL DA CACHOEIRA (AM)";"AM";"SAO GABRIEL DA CACHOEIRA";55;7;9;71
2007;"SAO PAULO DE OLIVENCA (AM)";"AM";"SAO PAULO DE OLIVENCA";3;0;0;3
2007;"SAO SEBASTIAO DO UATUMA (AM)";"AM";"SAO SEBASTIAO DO UATUMA";1;0;0;1
2007;"SILVES (AM)";"AM";"SILVES";5;1;1;7
2007;"TABATINGA (AM)";"AM";"TABATINGA";30;2;0;32
2007;"TAPAUA (AM)";"AM";"TAPAUA";1;0;1;2
2007;"TEFE (AM)";"AM";"TEFE";28;6;2;36
2007;"TONANTINS (AM)";"AM";"TONANTINS";0;1;0;1
2007;"UARINI (AM)";"AM";"UARINI";1;0;0;1
2007;"URUCARA (AM)";"AM";"URUCARA";11;1;1;13
2007;"URUCURITUBA (AM)";"AM";"URUCURITUBA";2;0;0;2
2007;"AMAPA (AP)";"AP";"AMAPA";8;1;0;9
2007;"AMAPARI (AP)";"AP";"AMAPARI";10;0;1;11
2007;"CALCOENE (AP)";"AP";"CALCOENE";1;0;1;2
2007;"CUTIAS (AP)";"AP";"CUTIAS";1;0;0;1
2007;"FERREIRA GOMES (AP)";"AP";"FERREIRA GOMES";1;0;0;1
2007;"ITAUBAL (AP)";"AP";"ITAUBAL";1;0;2;3
2007;"LARANJAL DO JARI (AP)";"AP";"LARANJAL DO JARI";44;4;6;54
2007;"MACAPA (AP)";"AP";"MACAPA";2051;165;421;2637
2007;"MAZAGAO (AP)";"AP";"MAZAGAO";32;2;6;40
2007;"OIAPOQUE (AP)";"AP";"OIAPOQUE";41;3;2;46
2007;"PORTO GRANDE (AP)";"AP";"PORTO GRANDE";14;0;5;19
2007;"PRACUUBA (AP)";"AP";"PRACUUBA";2;0;0;2
2007;"SANTANA (AP)";"AP";"SANTANA";411;23;37;471
2007;"SERRA DO NAVIO (AP)";"AP";"SERRA DO NAVIO";0;2;1;3
2007;"TARTARUGALZINHO (AP)";"AP";"TARTARUGALZINHO";6;0;0;6
2007;"VITORIA DO JARI (AP)";"AP";"VITORIA DO JARI";4;0;1;5
2007;"ABAIRA (BA)";"BA";"ABAIRA";40;7;13;60
2007;"ABARE (BA)";"BA";"ABARE";27;4;10;41
2007;"ACAJUTIBA (BA)";"BA";"ACAJUTIBA";34;8;10;52
2007;"ADUSTINA (BA)";"BA";"ADUSTINA";9;5;1;15
2007;"AGUA FRIA (BA)";"BA";"AGUA FRIA";9;8;19;36
2007;"AIQUARA (BA)";"BA";"AIQUARA";6;3;1;10
2007;"ALAGOINHAS (BA)";"BA";"ALAGOINHAS";879;123;287;1289
2007;"ALCOBACA (BA)";"BA";"ALCOBACA";23;3;6;32
2007;"ALMADINA (BA)";"BA";"ALMADINA";12;1;2;15
2007;"AMARGOSA (BA)";"BA";"AMARGOSA";198;27;42;267
2007;"AMELIA RODRIGUES (BA)";"BA";"AMELIA RODRIGUES";119;36;22;177
2007;"AMERICA DOURADA (BA)";"BA";"AMERICA DOURADA";17;4;2;23
2007;"ANAGE (BA)";"BA";"ANAGE";40;25;27;92
2007;"ANDARAI (BA)";"BA";"ANDARAI";14;2;2;18
2007;"ANDORINHA (BA)";"BA";"ANDORINHA";44;6;23;73
2007;"ANGICAL (BA)";"BA";"ANGICAL";16;6;11;33
2007;"ANGUERA (BA)";"BA";"ANGUERA";11;4;7;22
2007;"ANTAS (BA)";"BA";"ANTAS";19;5;6;30
2007;"ANTONIO CARDOSO (BA)";"BA";"ANTONIO CARDOSO";0;17;6;23
2007;"ANTONIO GONCALVES (BA)";"BA";"ANTONIO GONCALVES";13;3;5;21
2007;"APORA (BA)";"BA";"APORA";21;11;14;46
2007;"APUAREMA (BA)";"BA";"APUAREMA";19;2;8;29
2007;"ARACAS (BA)";"BA";"ARACAS";42;13;21;76
2007;"ARACATU (BA)";"BA";"ARACATU";45;10;12;67
2007;"ARACI (BA)";"BA";"ARACI";120;7;38;165
2007;"ARAMARI (BA)";"BA";"ARAMARI";19;3;4;26
2007;"ARATACA (BA)";"BA";"ARATACA";14;0;1;15
2007;"ARATUIPE (BA)";"BA";"ARATUIPE";18;0;9;27
2007;"AURELINO LEAL (BA)";"BA";"AURELINO LEAL";37;3;7;47
2007;"BAIANOPOLIS (BA)";"BA";"BAIANOPOLIS";33;5;15;53
2007;"BAIXA GRANDE (BA)";"BA";"BAIXA GRANDE";47;17;25;89
2007;"BANZAE (BA)";"BA";"BANZAE";13;1;19;33
2007;"BARRA (BA)";"BA";"BARRA";29;7;12;48
2007;"BARRA DA ESTIVA (BA)";"BA";"BARRA DA ESTIVA";133;19;32;184
2007;"BARRA DO CHOCA (BA)";"BA";"BARRA DO CHOCA";80;68;17;165
2007;"BARRA DO MENDES (BA)";"BA";"BARRA DO MENDES";45;7;4;56
2007;"BARRA DO ROCHA (BA)";"BA";"BARRA DO ROCHA";7;2;0;9
2007;"BARREIRAS (BA)";"BA";"BARREIRAS";1747;76;231;2054
2007;"BARRO ALTO (BA)";"BA";"BARRO ALTO";30;5;7;42
2007;"BARRO PRETO (BA)";"BA";"BARRO PRETO";16;1;6;23
2007;"BARROCAS (BA)";"BA";"BARROCAS";52;1;12;65
2007;"BELMONTE (BA)";"BA";"BELMONTE";35;1;5;41
2007;"BELO CAMPO (BA)";"BA";"BELO CAMPO";47;6;14;67
2007;"BIRITINGA (BA)";"BA";"BIRITINGA";22;8;20;50
2007;"BOA NOVA (BA)";"BA";"BOA NOVA";18;7;15;40
2007;"BOA VISTA DO TUPIM (BA)";"BA";"BOA VISTA DO TUPIM";41;5;6;52
2007;"BOM JESUS DA LAPA (BA)";"BA";"BOM JESUS DA LAPA";317;27;70;414
2007;"BOM JESUS DA SERRA (BA)";"BA";"BOM JESUS DA SERRA";11;15;11;37
2007;"BONINAL (BA)";"BA";"BONINAL";50;10;16;76
2007;"BONITO (BA)";"BA";"BONITO";35;2;5;42
2007;"BOQUIRA (BA)";"BA";"BOQUIRA";66;6;31;103
2007;"BOTUPORA (BA)";"BA";"BOTUPORA";22;3;18;43
2007;"BREJOES (BA)";"BA";"BREJOES";56;3;19;78
2007;"BREJOLANDIA (BA)";"BA";"BREJOLANDIA";18;4;12;34
2007;"BROTAS DE MACAUBAS (BA)";"BA";"BROTAS DE MACAUBAS";16;7;8;31
2007;"BRUMADO (BA)";"BA";"BRUMADO";844;121;165;1130
2007;"BUERAREMA (BA)";"BA";"BUERAREMA";97;4;17;118
2007;"BURITIRAMA (BA)";"BA";"BURITIRAMA";10;1;11;22
2007;"CAATIBA (BA)";"BA";"CAATIBA";7;3;0;10
2007;"CABACEIRAS DO PARAGUACU (BA)";"BA";"CABACEIRAS DO PARAGUACU";30;6;20;56
2007;"CACHOEIRA (BA)";"BA";"CACHOEIRA";68;68;56;192
2007;"CACULE (BA)";"BA";"CACULE";204;15;21;240
2007;"CAEM (BA)";"BA";"CAEM";14;4;10;28
2007;"CAETANOS (BA)";"BA";"CAETANOS";23;6;7;36
2007;"CAETITE (BA)";"BA";"CAETITE";356;34;49;439
2007;"CAFARNAUM (BA)";"BA";"CAFARNAUM";33;1;8;42
2007;"CAIRU (BA)";"BA";"CAIRU";8;3;2;13
2007;"CALDEIRAO GRANDE (BA)";"BA";"CALDEIRAO GRANDE";19;0;7;26
2007;"CAMACAN (BA)";"BA";"CAMACAN";174;15;31;220
2007;"CAMACARI (BA)";"BA";"CAMACARI";1293;263;854;2410
2007;"CAMAMU (BA)";"BA";"CAMAMU";89;20;17;126
2007;"CAMPO ALEGRE DE LOURDES (BA)";"BA";"CAMPO ALEGRE DE LOURDES";37;5;3;45
2007;"CAMPO FORMOSO (BA)";"BA";"CAMPO FORMOSO";151;14;56;221
2007;"CANAPOLIS (BA)";"BA";"CANAPOLIS";8;10;12;30
2007;"CANARANA (BA)";"BA";"CANARANA";80;4;4;88
2007;"CANAVIEIRAS (BA)";"BA";"CANAVIEIRAS";54;8;12;74
2007;"CANDEAL (BA)";"BA";"CANDEAL";17;12;2;31
2007;"CANDEIAS (BA)";"BA";"CANDEIAS";533;172;203;908
2007;"CANDIBA (BA)";"BA";"CANDIBA";35;0;12;47
2007;"CANDIDO SALES (BA)";"BA";"CANDIDO SALES";269;15;28;312
2007;"CANSANCAO (BA)";"BA";"CANSANCAO";97;16;23;136
2007;"CANUDOS (BA)";"BA";"CANUDOS";30;2;20;52
2007;"CAPELA DO ALTO ALEGRE (BA)";"BA";"CAPELA DO ALTO ALEGRE";37;10;16;63
2007;"CAPIM GROSSO (BA)";"BA";"CAPIM GROSSO";380;16;35;431
2007;"CARAIBAS (BA)";"BA";"CARAIBAS";23;11;11;45
2007;"CARAVELAS (BA)";"BA";"CARAVELAS";19;6;28;53
2007;"CARDEAL DA SILVA (BA)";"BA";"CARDEAL DA SILVA";15;5;3;23
2007;"CARINHANHA (BA)";"BA";"CARINHANHA";99;5;22;126
2007;"CASA NOVA (BA)";"BA";"CASA NOVA";226;118;107;451
2007;"CASTRO ALVES (BA)";"BA";"CASTRO ALVES";122;9;45;176
2007;"CATOLANDIA (BA)";"BA";"CATOLANDIA";3;3;2;8
2007;"CATU (BA)";"BA";"CATU";274;78;67;419
2007;"CATURAMA (BA)";"BA";"CATURAMA";11;2;9;22
2007;"CENTRAL (BA)";"BA";"CENTRAL";65;7;6;78
2007;"CHORROCHO (BA)";"BA";"CHORROCHO";10;1;3;14
2007;"CICERO DANTAS (BA)";"BA";"CICERO DANTAS";74;11;22;107
2007;"CIPO (BA)";"BA";"CIPO";36;2;4;42
2007;"COARACI (BA)";"BA";"COARACI";73;2;12;87
2007;"COCOS (BA)";"BA";"COCOS";52;2;22;76
2007;"CONCEICAO DA FEIRA (BA)";"BA";"CONCEICAO DA FEIRA";180;67;11;258
2007;"CONCEICAO DO ALMEIDA (BA)";"BA";"CONCEICAO DO ALMEIDA";77;25;11;113
2007;"CONCEICAO DO COITE (BA)";"BA";"CONCEICAO DO COITE";314;43;61;418
2007;"CONCEICAO DO JACUIPE (BA)";"BA";"CONCEICAO DO JACUIPE";150;99;6;255
2007;"CONDE (BA)";"BA";"CONDE";40;7;5;52
2007;"CONDEUBA (BA)";"BA";"CONDEUBA";82;20;31;133
2007;"CONTENDAS DO SINCORA (BA)";"BA";"CONTENDAS DO SINCORA";7;5;3;15
2007;"CORACAO DE MARIA (BA)";"BA";"CORACAO DE MARIA";82;13;29;124
2007;"CORDEIROS (BA)";"BA";"CORDEIROS";20;5;10;35
2007;"CORIBE (BA)";"BA";"CORIBE";29;11;11;51
2007;"CORONEL JOAO SA (BA)";"BA";"CORONEL JOAO SA";14;1;23;38
2007;"CORRENTINA (BA)";"BA";"CORRENTINA";88;12;45;145
2007;"COTEGIPE (BA)";"BA";"COTEGIPE";19;6;7;32
2007;"CRAVOLANDIA (BA)";"BA";"CRAVOLANDIA";15;1;3;19
2007;"CRISOPOLIS (BA)";"BA";"CRISOPOLIS";44;8;15;67
2007;"CRISTOPOLIS (BA)";"BA";"CRISTOPOLIS";44;4;14;62
2007;"CRUZ DAS ALMAS (BA)";"BA";"CRUZ DAS ALMAS";728;135;43;906
2007;"CURACA (BA)";"BA";"CURACA";41;18;20;79
2007;"DARIO MEIRA (BA)";"BA";"DARIO MEIRA";9;6;7;22
2007;"DIAS D AVILA (BA)";"BA";"DIAS D AVILA";491;40;297;828
2007;"DOM BASILIO (BA)";"BA";"DOM BASILIO";173;4;13;190
2007;"DOM MACEDO COSTA (BA)";"BA";"DOM MACEDO COSTA";10;5;4;19
2007;"ELISIO MEDRADO (BA)";"BA";"ELISIO MEDRADO";14;8;8;30
2007;"ENCRUZILHADA (BA)";"BA";"ENCRUZILHADA";52;19;13;84
2007;"ENTRE RIOS (BA)";"BA";"ENTRE RIOS";158;53;54;265
2007;"ERICO CARDOSO (BA)";"BA";"ERICO CARDOSO";23;2;10;35
2007;"ESPLANADA (BA)";"BA";"ESPLANADA";92;25;41;158
2007;"EUCLIDES DA CUNHA (BA)";"BA";"EUCLIDES DA CUNHA";196;13;88;297
2007;"EUNAPOLIS (BA)";"BA";"EUNAPOLIS";938;52;216;1206
2007;"FATIMA (BA)";"BA";"FATIMA";10;3;10;23
2007;"FEIRA DA MATA (BA)";"BA";"FEIRA DA MATA";18;5;4;27
2007;"FEIRA DE SANTANA (BA)";"BA";"FEIRA DE SANTANA";6079;655;864;7598
2007;"FILADELFIA (BA)";"BA";"FILADELFIA";64;4;12;80
2007;"FIRMINO ALVES (BA)";"BA";"FIRMINO ALVES";8;0;1;9
2007;"FLORESTA AZUL (BA)";"BA";"FLORESTA AZUL";24;1;0;25
2007;"FORMOSA DO RIO PRETO (BA)";"BA";"FORMOSA DO RIO PRETO";64;2;9;75
2007;"GANDU (BA)";"BA";"GANDU";198;8;15;221
2007;"GAVIAO (BA)";"BA";"GAVIAO";12;4;3;19
2007;"GENTIO DO OURO (BA)";"BA";"GENTIO DO OURO";8;0;1;9
2007;"GLORIA (BA)";"BA";"GLORIA";38;17;28;83
2007;"GONGOGI (BA)";"BA";"GONGOGI";7;1;1;9
2007;"GOVERNADOR MANGABEIRA (BA)";"BA";"GOVERNADOR MANGABEIRA";123;21;27;171
2007;"GUAJERU (BA)";"BA";"GUAJERU";10;17;7;34
2007;"GUANAMBI (BA)";"BA";"GUANAMBI";910;52;113;1075
2007;"GUARATINGA (BA)";"BA";"GUARATINGA";51;4;19;74
2007;"HELIOPOLIS (BA)";"BA";"HELIOPOLIS";14;3;2;19
2007;"IACU (BA)";"BA";"IACU";94;11;15;120
2007;"IBIASSUCE (BA)";"BA";"IBIASSUCE";44;11;4;59
2007;"IBICARAI (BA)";"BA";"IBICARAI";101;7;16;124
2007;"IBICOARA (BA)";"BA";"IBICOARA";129;12;38;179
2007;"IBICUI (BA)";"BA";"IBICUI";32;4;7;43
2007;"IBIPEBA (BA)";"BA";"IBIPEBA";29;6;3;38
2007;"IBIPITANGA (BA)";"BA";"IBIPITANGA";46;10;21;77
2007;"IBIQUERA (BA)";"BA";"IBIQUERA";4;2;0;6
2007;"IBIRAPITANGA (BA)";"BA";"IBIRAPITANGA";33;1;5;39
2007;"IBIRAPUA (BA)";"BA";"IBIRAPUA";30;3;3;36
2007;"IBIRATAIA (BA)";"BA";"IBIRATAIA";62;18;4;84
2007;"IBITIARA (BA)";"BA";"IBITIARA";59;13;23;95
2007;"IBITITA (BA)";"BA";"IBITITA";32;1;6;39
2007;"IBOTIRAMA (BA)";"BA";"IBOTIRAMA";144;29;18;191
2007;"ICHU (BA)";"BA";"ICHU";12;6;5;23
2007;"IGAPORA (BA)";"BA";"IGAPORA";79;14;10;103
2007;"IGRAPIUNA (BA)";"BA";"IGRAPIUNA";27;14;15;56
2007;"IGUAI (BA)";"BA";"IGUAI";41;14;22;77
2007;"ILHEUS (BA)";"BA";"ILHEUS";470;97;249;816
2007;"INHAMBUPE (BA)";"BA";"INHAMBUPE";116;60;55;231
2007;"IPECAETA (BA)";"BA";"IPECAETA";4;5;30;39
2007;"IPIAU (BA)";"BA";"IPIAU";294;18;17;329
2007;"IPIRA (BA)";"BA";"IPIRA";282;25;62;369
2007;"IPUPIARA (BA)";"BA";"IPUPIARA";26;9;1;36
2007;"IRAJUBA (BA)";"BA";"IRAJUBA";19;4;14;37
2007;"IRAMAIA (BA)";"BA";"IRAMAIA";16;1;7;24
2007;"IRAQUARA (BA)";"BA";"IRAQUARA";83;10;12;105
2007;"IRARA (BA)";"BA";"IRARA";96;29;44;169
2007;"IRECE (BA)";"BA";"IRECE";536;29;39;604
2007;"ITABELA (BA)";"BA";"ITABELA";197;8;38;243
2007;"ITABERABA (BA)";"BA";"ITABERABA";335;36;38;409
2007;"ITABUNA (BA)";"BA";"ITABUNA";1380;46;549;1975
2007;"ITACARE (BA)";"BA";"ITACARE";10;16;2;28
2007;"ITAETE (BA)";"BA";"ITAETE";47;4;11;62
2007;"ITAGI (BA)";"BA";"ITAGI";25;2;2;29
2007;"ITAGIBA (BA)";"BA";"ITAGIBA";16;10;7;33
2007;"ITAGIMIRIM (BA)";"BA";"ITAGIMIRIM";39;1;3;43
2007;"ITAGUACU DA BAHIA (BA)";"BA";"ITAGUACU DA BAHIA";17;0;6;23
2007;"ITAJU DO COLONIA (BA)";"BA";"ITAJU DO COLONIA";7;0;4;11
2007;"ITAJUIPE (BA)";"BA";"ITAJUIPE";57;3;10;70
2007;"ITAMARAJU (BA)";"BA";"ITAMARAJU";326;8;108;442
2007;"ITAMARI (BA)";"BA";"ITAMARI";29;1;1;31
2007;"ITAMBE (BA)";"BA";"ITAMBE";46;12;5;63
2007;"ITANAGRA (BA)";"BA";"ITANAGRA";14;0;1;15
2007;"ITANHEM (BA)";"BA";"ITANHEM";31;3;10;44
2007;"ITAPARICA (BA)";"BA";"ITAPARICA";20;29;25;74
2007;"ITAPE (BA)";"BA";"ITAPE";11;0;0;11
2007;"ITAPEBI (BA)";"BA";"ITAPEBI";41;1;6;48
2007;"ITAPETINGA (BA)";"BA";"ITAPETINGA";429;32;67;528
2007;"ITAPICURU (BA)";"BA";"ITAPICURU";22;12;24;58
2007;"ITAPITANGA (BA)";"BA";"ITAPITANGA";9;3;0;12
2007;"ITAQUARA (BA)";"BA";"ITAQUARA";29;1;0;30
2007;"ITARANTIM (BA)";"BA";"ITARANTIM";58;3;2;63
2007;"ITATIM (BA)";"BA";"ITATIM";101;15;17;133
2007;"ITIRUCU (BA)";"BA";"ITIRUCU";94;5;7;106
2007;"ITIUBA (BA)";"BA";"ITIUBA";49;18;43;110
2007;"ITORORO (BA)";"BA";"ITORORO";71;10;15;96
2007;"ITUACU (BA)";"BA";"ITUACU";97;5;11;113
2007;"ITUBERA (BA)";"BA";"ITUBERA";107;11;15;133
2007;"IUIU (BA)";"BA";"IUIU";22;3;1;26
2007;"JABORANDI (BA)";"BA";"JABORANDI";33;1;15;49
2007;"JACARACI (BA)";"BA";"JACARACI";25;8;16;49
2007;"JACOBINA (BA)";"BA";"JACOBINA";589;54;129;772
2007;"JAGUAQUARA (BA)";"BA";"JAGUAQUARA";401;7;40;448
2007;"JAGUARARI (BA)";"BA";"JAGUARARI";119;30;43;192
2007;"JAGUARIPE (BA)";"BA";"JAGUARIPE";32;6;7;45
2007;"JANDAIRA (BA)";"BA";"JANDAIRA";13;0;6;19
2007;"JEQUIE (BA)";"BA";"JEQUIE";1201;52;224;1477
2007;"JEREMOABO (BA)";"BA";"JEREMOABO";76;14;23;113
2007;"JIQUIRICA (BA)";"BA";"JIQUIRICA";24;13;13;50
2007;"JITAUNA (BA)";"BA";"JITAUNA";25;5;3;33
2007;"JOAO DOURADO (BA)";"BA";"JOAO DOURADO";66;10;9;85
2007;"JUAZEIRO (BA)";"BA";"JUAZEIRO";2242;443;594;3279
2007;"JUCURUCU (BA)";"BA";"JUCURUCU";11;0;2;13
2007;"JUSSARA (BA)";"BA";"JUSSARA";33;6;15;54
2007;"JUSSARI (BA)";"BA";"JUSSARI";11;1;1;13
2007;"JUSSIAPE (BA)";"BA";"JUSSIAPE";40;6;3;49
2007;"LAFAIETE COUTINHO (BA)";"BA";"LAFAIETE COUTINHO";8;0;2;10
2007;"LAGEDO DO TABOCAL (BA)";"BA";"LAGEDO DO TABOCAL";19;1;6;26
2007;"LAGOA REAL (BA)";"BA";"LAGOA REAL";23;3;10;36
2007;"LAJE (BA)";"BA";"LAJE";91;28;18;137
2007;"LAJEDAO (BA)";"BA";"LAJEDAO";5;0;6;11
2007;"LAJEDINHO (BA)";"BA";"LAJEDINHO";8;2;2;12
2007;"LAMARAO (BA)";"BA";"LAMARAO";2;0;1;3
2007;"LAPAO (BA)";"BA";"LAPAO";80;6;23;109
2007;"LAURO DE FREITAS (BA)";"BA";"LAURO DE FREITAS";1491;327;319;2137
2007;"LENCOIS (BA)";"BA";"LENCOIS";16;9;1;26
2007;"LICINIO DE ALMEIDA (BA)";"BA";"LICINIO DE ALMEIDA";84;8;10;102
2007;"LIVRAMENTO DO BRUMADO (BA)";"BA";"LIVRAMENTO DO BRUMADO";259;35;52;346
2007;"LUIZ EDUARDO MAGALHAES (BA)";"BA";"LUIZ EDUARDO MAGALHAES";740;29;52;821
2007;"MACAJUBA (BA)";"BA";"MACAJUBA";12;12;18;42
2007;"MACAUBAS (BA)";"BA";"MACAUBAS";142;13;216;371
2007;"MACURURE (BA)";"BA";"MACURURE";9;3;2;14
2007;"MADRE DE DEUS (BA)";"BA";"MADRE DE DEUS";58;19;29;106
2007;"MAETINGA (BA)";"BA";"MAETINGA";18;7;8;33
2007;"MAIQUINIQUE (BA)";"BA";"MAIQUINIQUE";35;3;6;44
2007;"MAIRI (BA)";"BA";"MAIRI";43;11;25;79
2007;"MALHADA (BA)";"BA";"MALHADA";18;3;5;26
2007;"MALHADA DAS PEDRAS (BA)";"BA";"MALHADA DAS PEDRAS";50;18;14;82
2007;"MANOEL VITORINO (BA)";"BA";"MANOEL VITORINO";35;7;8;50
2007;"MANSIDAO (BA)";"BA";"MANSIDAO";3;0;0;3
2007;"MARACANI (BA)";"BA";"MARACANI";71;3;10;84
2007;"MARACAS (BA)";"BA";"MARACAS";133;7;29;169
2007;"MARAGOGIPE (BA)";"BA";"MARAGOGIPE";99;14;16;129
2007;"MARAU (BA)";"BA";"MARAU";5;0;0;5
2007;"MARCIONILIO SOUZA (BA)";"BA";"MARCIONILIO SOUZA";13;7;9;29
2007;"MASCOTE (BA)";"BA";"MASCOTE";36;2;5;43
2007;"MATA DE SAO JOAO (BA)";"BA";"MATA DE SAO JOAO";160;40;40;240
2007;"MATINA (BA)";"BA";"MATINA";12;2;11;25
2007;"MEDEIROS NETO (BA)";"BA";"MEDEIROS NETO";67;9;10;86
2007;"MIGUEL CALMON (BA)";"BA";"MIGUEL CALMON";83;5;24;112
2007;"MILAGRES (BA)";"BA";"MILAGRES";109;4;10;123
2007;"MIRANGABA (BA)";"BA";"MIRANGABA";27;9;13;49
2007;"MIRANTE (BA)";"BA";"MIRANTE";23;10;12;45
2007;"MONTE SANTO (BA)";"BA";"MONTE SANTO";88;9;62;159
2007;"MORPARA (BA)";"BA";"MORPARA";6;2;1;9
2007;"MORRO DO CHAPEU (BA)";"BA";"MORRO DO CHAPEU";82;20;11;113
2007;"MORTUGABA (BA)";"BA";"MORTUGABA";43;6;7;56
2007;"MUCUGE (BA)";"BA";"MUCUGE";65;7;22;94
2007;"MUCURI (BA)";"BA";"MUCURI";68;21;32;121
2007;"MULUNGU DO MORRO (BA)";"BA";"MULUNGU DO MORRO";27;1;0;28
2007;"MUNDO NOVO (BA)";"BA";"MUNDO NOVO";40;7;21;68
2007;"MUNIZ FERREIRA (BA)";"BA";"MUNIZ FERREIRA";39;53;5;97
2007;"MUQUEM DO SAO FRANCISCO (BA)";"BA";"MUQUEM DO SAO FRANCISCO";11;8;9;28
2007;"MURITIBA (BA)";"BA";"MURITIBA";257;24;21;302
2007;"MUTUIPE (BA)";"BA";"MUTUIPE";99;38;24;161
2007;"NAZARE (BA)";"BA";"NAZARE";170;34;21;225
2007;"NILO PECANHA (BA)";"BA";"NILO PECANHA";26;13;8;47
2007;"NORDESTINA (BA)";"BA";"NORDESTINA";18;5;11;34
2007;"NOVA CANAA (BA)";"BA";"NOVA CANAA";37;1;7;45
2007;"NOVA FATIMA (BA)";"BA";"NOVA FATIMA";38;2;3;43
2007;"NOVA IBIA (BA)";"BA";"NOVA IBIA";13;0;4;17
2007;"NOVA ITARANA (BA)";"BA";"NOVA ITARANA";16;4;4;24
2007;"NOVA REDENCAO (BA)";"BA";"NOVA REDENCAO";10;3;3;16
2007;"NOVA SOURE (BA)";"BA";"NOVA SOURE";32;5;10;47
2007;"NOVA VICOSA (BA)";"BA";"NOVA VICOSA";80;16;29;125
2007;"NOVO HORIZONTE (BA)";"BA";"NOVO HORIZONTE";24;4;6;34
2007;"NOVO TRIUNFO (BA)";"BA";"NOVO TRIUNFO";4;1;1;6
2007;"OLINDINA (BA)";"BA";"OLINDINA";70;16;32;118
2007;"OLIVEIRA DOS BREJINHOS (BA)";"BA";"OLIVEIRA DOS BREJINHOS";49;15;15;79
2007;"OURICANGAS (BA)";"BA";"OURICANGAS";20;6;16;42
2007;"OUROLANDIA (BA)";"BA";"OUROLANDIA";28;10;4;42
2007;"PALMAS DE MONTE ALTO (BA)";"BA";"PALMAS DE MONTE ALTO";39;3;16;58
2007;"PALMEIRAS (BA)";"BA";"PALMEIRAS";22;10;2;34
2007;"PARAMIRIM (BA)";"BA";"PARAMIRIM";114;3;43;160
2007;"PARATINGA (BA)";"BA";"PARATINGA";29;14;34;77
2007;"PARIPIRANGA (BA)";"BA";"PARIPIRANGA";58;3;24;85
2007;"PAU BRASIL (BA)";"BA";"PAU BRASIL";25;4;12;41
2007;"PAULO AFONSO (BA)";"BA";"PAULO AFONSO";705;198;212;1115
2007;"PE DE SERRA (BA)";"BA";"PE DE SERRA";19;2;8;29
2007;"PEDRAO (BA)";"BA";"PEDRAO";12;5;4;21
2007;"PEDRO ALEXANDRE (BA)";"BA";"PEDRO ALEXANDRE";1;1;3;5
2007;"PIATA (BA)";"BA";"PIATA";71;15;21;107
2007;"PILAO ARCADO (BA)";"BA";"PILAO ARCADO";26;12;1;39
2007;"PINDAI (BA)";"BA";"PINDAI";30;6;14;50
2007;"PINDOBACU (BA)";"BA";"PINDOBACU";32;13;18;63
2007;"PINTADAS (BA)";"BA";"PINTADAS";33;10;25;68
2007;"PIRAI DO NORTE (BA)";"BA";"PIRAI DO NORTE";7;1;0;8
2007;"PIRIPA (BA)";"BA";"PIRIPA";47;15;13;75
2007;"PIRITIBA (BA)";"BA";"PIRITIBA";41;10;13;64
2007;"PLANALTINO (BA)";"BA";"PLANALTINO";8;0;5;13
2007;"PLANALTO (BA)";"BA";"PLANALTO";88;9;31;128
2007;"POCOES (BA)";"BA";"POCOES";232;90;53;375
2007;"POJUCA (BA)";"BA";"POJUCA";266;45;64;375
2007;"PONTO NOVO (BA)";"BA";"PONTO NOVO";43;3;13;59
2007;"PORTO SEGURO (BA)";"BA";"PORTO SEGURO";488;152;489;1129
2007;"POTIRIGUA (BA)";"BA";"POTIRIGUA";24;3;3;30
2007;"PRADO (BA)";"BA";"PRADO";40;10;14;64
2007;"PRESIDENTE DUTRA (BA)";"BA";"PRESIDENTE DUTRA";37;4;3;44
2007;"PRESIDENTE JANIO QUADROS (BA)";"BA";"PRESIDENTE JANIO QUADROS";17;10;5;32
2007;"PRESIDENTE TANCREDO NEVES (BA)";"BA";"PRESIDENTE TANCREDO NEVES";57;25;8;90
2007;"QUEIMADAS (BA)";"BA";"QUEIMADAS";62;6;54;122
2007;"QUIJINGUE (BA)";"BA";"QUIJINGUE";33;8;33;74
2007;"QUIXABEIRA (BA)";"BA";"QUIXABEIRA";24;2;9;35
2007;"RAFAEL JAMBEIRO (BA)";"BA";"RAFAEL JAMBEIRO";33;12;30;75
2007;"REMANSO (BA)";"BA";"REMANSO";153;27;12;192
2007;"RETIROLANDIA (BA)";"BA";"RETIROLANDIA";39;2;6;47
2007;"RIACHAO DAS NEVES (BA)";"BA";"RIACHAO DAS NEVES";26;16;11;53
2007;"RIACHAO DO JACUIPE (BA)";"BA";"RIACHAO DO JACUIPE";167;16;27;210
2007;"RIACHO DE SANTANA (BA)";"BA";"RIACHO DE SANTANA";155;16;36;207
2007;"RIBEIRA DO AMPARO (BA)";"BA";"RIBEIRA DO AMPARO";6;6;19;31
2007;"RIBEIRA DO POMBAL (BA)";"BA";"RIBEIRA DO POMBAL";182;37;84;303
2007;"RIBEIRAO DO LARGO (BA)";"BA";"RIBEIRAO DO LARGO";16;10;4;30
2007;"RIO DE CONTAS (BA)";"BA";"RIO DE CONTAS";53;10;13;76
2007;"RIO DO ANTONIO (BA)";"BA";"RIO DO ANTONIO";42;12;3;57
2007;"RIO DO PIRES (BA)";"BA";"RIO DO PIRES";34;7;10;51
2007;"RIO REAL (BA)";"BA";"RIO REAL";122;6;35;163
2007;"RODELAS (BA)";"BA";"RODELAS";15;3;1;19
2007;"RUY BARBOSA (BA)";"BA";"RUY BARBOSA";77;17;12;106
2007;"SALINAS DA MARGARIDA (BA)";"BA";"SALINAS DA MARGARIDA";15;2;3;20
2007;"SALVADOR (BA)";"BA";"SALVADOR";11932;2816;6105;20853
2007;"SANTA BARBARA (BA)";"BA";"SANTA BARBARA";26;5;22;53
2007;"SANTA BRIGIDA (BA)";"BA";"SANTA BRIGIDA";12;8;11;31
2007;"SANTA CRUZ CABRALIA (BA)";"BA";"SANTA CRUZ CABRALIA";55;13;12;80
2007;"SANTA CRUZ DA VITORIA (BA)";"BA";"SANTA CRUZ DA VITORIA";8;4;1;13
2007;"SANTA INES (BA)";"BA";"SANTA INES";41;5;3;49
2007;"SANTA LUZIA (BA)";"BA";"SANTA LUZIA";24;2;3;29
2007;"SANTA MARIA DA VITORIA (BA)";"BA";"SANTA MARIA DA VITORIA";244;23;32;299
2007;"SANTA RITA DE CASSIA (BA)";"BA";"SANTA RITA DE CASSIA";45;3;8;56
2007;"SANTA TERESINHA (BA)";"BA";"SANTA TERESINHA";22;1;12;35
2007;"SANTALUZ (BA)";"BA";"SANTALUZ";132;8;27;167
2007;"SANTANA (BA)";"BA";"SANTANA";113;10;39;162
2007;"SANTANOPOLIS (BA)";"BA";"SANTANOPOLIS";13;7;6;26
2007;"SANTO AMARO (BA)";"BA";"SANTO AMARO";167;72;285;524
2007;"SANTO ANTONIO DE JESUS (BA)";"BA";"SANTO ANTONIO DE JESUS";1723;110;119;1952
2007;"SANTO ESTEVAO (BA)";"BA";"SANTO ESTEVAO";177;62;27;266
2007;"SAO DESIDERIO (BA)";"BA";"SAO DESIDERIO";149;6;27;182
2007;"SAO DOMINGOS (BA)";"BA";"SAO DOMINGOS";27;0;7;34
2007;"SAO FELIPE (BA)";"BA";"SAO FELIPE";132;18;26;176
2007;"SAO FELIX (BA)";"BA";"SAO FELIX";41;19;11;71
2007;"SAO FELIX DO CORIBE (BA)";"BA";"SAO FELIX DO CORIBE";78;9;13;100
2007;"SAO FRANCISCO DO CONDE (BA)";"BA";"SAO FRANCISCO DO CONDE";84;49;53;186
2007;"SAO GABRIEL (BA)";"BA";"SAO GABRIEL";22;5;4;31
2007;"SAO GONCALO DOS CAMPOS (BA)";"BA";"SAO GONCALO DOS CAMPOS";58;119;22;199
2007;"SAO JOSE DA VITORIA (BA)";"BA";"SAO JOSE DA VITORIA";6;0;3;9
2007;"SAO JOSE DO JACUIPE (BA)";"BA";"SAO JOSE DO JACUIPE";49;6;3;58
2007;"SAO MIGUEL DAS MATAS (BA)";"BA";"SAO MIGUEL DAS MATAS";30;3;2;35
2007;"SAO SEBASTIAO DO PASSE (BA)";"BA";"SAO SEBASTIAO DO PASSE";133;72;99;304
2007;"SAPEACU (BA)";"BA";"SAPEACU";72;37;20;129
2007;"SATIRO DIAS (BA)";"BA";"SATIRO DIAS";12;9;7;28
2007;"SAUBARA (BA)";"BA";"SAUBARA";12;8;1;21
2007;"SAUDE (BA)";"BA";"SAUDE";22;8;7;37
2007;"SEABRA (BA)";"BA";"SEABRA";231;59;79;369
2007;"SEBASTIAO LARANJEIRAS (BA)";"BA";"SEBASTIAO LARANJEIRAS";7;3;14;24
2007;"SENHOR DO BONFIM (BA)";"BA";"SENHOR DO BONFIM";445;77;137;659
2007;"SENTO SE (BA)";"BA";"SENTO SE";37;2;13;52
2007;"SERRA DO RAMALHO (BA)";"BA";"SERRA DO RAMALHO";30;16;13;59
2007;"SERRA DOURADA (BA)";"BA";"SERRA DOURADA";32;5;17;54
2007;"SERRA PRETA (BA)";"BA";"SERRA PRETA";22;10;29;61
2007;"SERRINHA (BA)";"BA";"SERRINHA";445;52;113;610
2007;"SERROLANDIA (BA)";"BA";"SERROLANDIA";34;16;10;60
2007;"SIMOES FILHO (BA)";"BA";"SIMOES FILHO";1747;267;510;2524
2007;"SITIO DO MATO (BA)";"BA";"SITIO DO MATO";16;8;12;36
2007;"SITIO DO QUINTO (BA)";"BA";"SITIO DO QUINTO";8;2;6;16
2007;"SOBRADINHO (BA)";"BA";"SOBRADINHO";71;10;11;92
2007;"SOUTO SOARES (BA)";"BA";"SOUTO SOARES";59;1;18;78
2007;"TABOCAS DO BREJO VELHO (BA)";"BA";"TABOCAS DO BREJO VELHO";14;2;9;25
2007;"TANHACU (BA)";"BA";"TANHACU";91;16;17;124
2007;"TANQUE NOVO (BA)";"BA";"TANQUE NOVO";196;5;26;227
2007;"TANQUINHO (BA)";"BA";"TANQUINHO";16;7;6;29
2007;"TAPEROA (BA)";"BA";"TAPEROA";81;20;8;109
2007;"TAPIRAMUTA (BA)";"BA";"TAPIRAMUTA";26;3;2;31
2007;"TEIXEIRA DE FREITAS (BA)";"BA";"TEIXEIRA DE FREITAS";960;47;228;1235
2007;"TEODORO SAMPAIO (BA)";"BA";"TEODORO SAMPAIO";9;7;8;24
2007;"TEOFILANDIA (BA)";"BA";"TEOFILANDIA";83;9;13;105
2007;"TEOLANDIA (BA)";"BA";"TEOLANDIA";86;11;5;102
2007;"TERRA NOVA (BA)";"BA";"TERRA NOVA";7;4;14;25
2007;"TREMEDAL (BA)";"BA";"TREMEDAL";22;6;14;42
2007;"TUCANO (BA)";"BA";"TUCANO";195;20;70;285
2007;"UAUA (BA)";"BA";"UAUA";63;4;12;79
2007;"UBAIRA (BA)";"BA";"UBAIRA";72;10;25;107
2007;"UBAITABA (BA)";"BA";"UBAITABA";133;6;11;150
2007;"UBATA (BA)";"BA";"UBATA";172;11;6;189
2007;"UIBAI (BA)";"BA";"UIBAI";35;1;1;37
2007;"UMBURANAS (BA)";"BA";"UMBURANAS";19;8;10;37
2007;"UNA (BA)";"BA";"UNA";36;3;12;51
2007;"URANDI (BA)";"BA";"URANDI";62;8;18;88
2007;"URUCUCA (BA)";"BA";"URUCUCA";74;2;5;81
2007;"UTINGA (BA)";"BA";"UTINGA";39;5;6;50
2007;"VALENCA (BA)";"BA";"VALENCA";491;76;57;624
2007;"VALENTE (BA)";"BA";"VALENTE";91;7;15;113
2007;"VARZEA DA ROCA (BA)";"BA";"VARZEA DA ROCA";28;12;9;49
2007;"VARZEA DO POCO (BA)";"BA";"VARZEA DO POCO";44;9;9;62
2007;"VARZEA NOVA (BA)";"BA";"VARZEA NOVA";47;4;9;60
2007;"VARZEDO (BA)";"BA";"VARZEDO";44;7;6;57
2007;"VERA CRUZ (BA)";"BA";"VERA CRUZ";101;107;21;229
2007;"VEREDA (BA)";"BA";"VEREDA";7;1;1;9
2007;"VITORIA DA CONQUISTA (BA)";"BA";"VITORIA DA CONQUISTA";2699;298;911;3908
2007;"WAGNER (BA)";"BA";"WAGNER";12;2;6;20
2007;"WANDERLEY (BA)";"BA";"WANDERLEY";30;3;12;45
2007;"WENCESLAU GUIMARAES (BA)";"BA";"WENCESLAU GUIMARAES";77;8;7;92
2007;"XIQUE XIQUE (BA)";"BA";"XIQUE XIQUE";81;5;9;95
2007;"ABAIARA (CE)";"CE";"ABAIARA";6;17;4;27
2007;"ACARAPE (CE)";"CE";"ACARAPE";76;22;29;127
2007;"ACARAU (CE)";"CE";"ACARAU";126;11;31;168
2007;"ACOPIARA (CE)";"CE";"ACOPIARA";204;9;20;233
2007;"AIUABA (CE)";"CE";"AIUABA";13;2;0;15
2007;"ALCANTARAS (CE)";"CE";"ALCANTARAS";30;0;3;33
2007;"ALTANEIRA (CE)";"CE";"ALTANEIRA";11;5;2;18
2007;"ALTO SANTO (CE)";"CE";"ALTO SANTO";91;5;9;105
2007;"AMONTADA (CE)";"CE";"AMONTADA";109;6;6;121
2007;"ANTONINA DO NORTE (CE)";"CE";"ANTONINA DO NORTE";24;1;1;26
2007;"APUIARES (CE)";"CE";"APUIARES";53;6;0;59
2007;"AQUIRAZ (CE)";"CE";"AQUIRAZ";307;60;36;403
2007;"ARACATI (CE)";"CE";"ARACATI";324;35;63;422
2007;"ARACOIABA (CE)";"CE";"ARACOIABA";79;7;10;96
2007;"ARARENDA (CE)";"CE";"ARARENDA";17;4;1;22
2007;"ARARIPE (CE)";"CE";"ARARIPE";46;33;7;86
2007;"ARATUBA (CE)";"CE";"ARATUBA";37;3;5;45
2007;"ARNEIROZ (CE)";"CE";"ARNEIROZ";23;4;0;27
2007;"ASSARE (CE)";"CE";"ASSARE";59;11;0;70
2007;"AURORA (CE)";"CE";"AURORA";61;18;4;83
2007;"BAIXIO (CE)";"CE";"BAIXIO";4;5;2;11
2007;"BANABUIU (CE)";"CE";"BANABUIU";62;8;11;81
2007;"BARBALHA (CE)";"CE";"BARBALHA";196;40;42;278
2007;"BARREIRA (CE)";"CE";"BARREIRA";76;4;7;87
2007;"BARRO (CE)";"CE";"BARRO";38;12;9;59
2007;"BARROQUINHA (CE)";"CE";"BARROQUINHA";14;5;0;19
2007;"BATURITE (CE)";"CE";"BATURITE";160;24;20;204
2007;"BEBERIBE (CE)";"CE";"BEBERIBE";118;36;30;184
2007;"BELA CRUZ (CE)";"CE";"BELA CRUZ";61;6;8;75
2007;"BOA VIAGEM (CE)";"CE";"BOA VIAGEM";291;10;28;329
2007;"BREJO SANTO (CE)";"CE";"BREJO SANTO";219;47;19;285
2007;"CAMOCIM (CE)";"CE";"CAMOCIM";110;20;12;142
2007;"CAMPOS SALES (CE)";"CE";"CAMPOS SALES";147;26;21;194
2007;"CANINDE (CE)";"CE";"CANINDE";363;13;54;430
2007;"CAPISTRANO (CE)";"CE";"CAPISTRANO";35;5;11;51
2007;"CARIDADE (CE)";"CE";"CARIDADE";42;6;8;56
2007;"CARIRE (CE)";"CE";"CARIRE";28;7;3;38
2007;"CARIRIACU (CE)";"CE";"CARIRIACU";42;5;4;51
2007;"CARIUS (CE)";"CE";"CARIUS";37;11;1;49
2007;"CARNAUBAL (CE)";"CE";"CARNAUBAL";50;19;6;75
2007;"CASCAVEL (CE)";"CE";"CASCAVEL";309;32;56;397
2007;"CATARINA (CE)";"CE";"CATARINA";32;4;0;36
2007;"CATUNDA (CE)";"CE";"CATUNDA";20;7;2;29
2007;"CAUCAIA (CE)";"CE";"CAUCAIA";852;91;284;1227
2007;"CEDRO (CE)";"CE";"CEDRO";70;19;21;110
2007;"CHAVAL (CE)";"CE";"CHAVAL";19;4;3;26
2007;"CHORO (CE)";"CE";"CHORO";27;4;9;40
2007;"CHOROZINHO (CE)";"CE";"CHOROZINHO";76;6;27;109
2007;"COREAU (CE)";"CE";"COREAU";65;8;11;84
2007;"CRATEUS (CE)";"CE";"CRATEUS";208;13;33;254
2007;"CRATO (CE)";"CE";"CRATO";640;50;61;751
2007;"CROATA (CE)";"CE";"CROATA";32;4;2;38
2007;"CRUZ (CE)";"CE";"CRUZ";86;18;31;135
2007;"DEPUTADO IRAPUAN PINHEIRO (CE)";"CE";"DEPUTADO IRAPUAN PINHEIRO";17;3;2;22
2007;"ERERE (CE)";"CE";"ERERE";2;2;0;4
2007;"EUSEBIO (CE)";"CE";"EUSEBIO";640;18;38;696
2007;"FARIAS BRITO (CE)";"CE";"FARIAS BRITO";55;22;3;80
2007;"FORQUILHA (CE)";"CE";"FORQUILHA";76;18;15;109
2007;"FORTALEZA (CE)";"CE";"FORTALEZA";16666;2255;4872;23793
2007;"FORTIM (CE)";"CE";"FORTIM";18;27;5;50
2007;"FRECHEIRINHA (CE)";"CE";"FRECHEIRINHA";53;13;17;83
2007;"GENERAL SAMPAIO (CE)";"CE";"GENERAL SAMPAIO";23;1;1;25
2007;"GRACA (CE)";"CE";"GRACA";15;5;4;24
2007;"GRANJA (CE)";"CE";"GRANJA";124;17;11;152
2007;"GRANJEIRO (CE)";"CE";"GRANJEIRO";6;1;0;7
2007;"GROAIRAS (CE)";"CE";"GROAIRAS";38;19;7;64
2007;"GUAIUBA (CE)";"CE";"GUAIUBA";46;25;6;77
2007;"GUARACIABA DO NORTE (CE)";"CE";"GUARACIABA DO NORTE";222;3;15;240
2007;"GUARAMIRANGA (CE)";"CE";"GUARAMIRANGA";17;1;1;19
2007;"HIDROLANDIA (CE)";"CE";"HIDROLANDIA";95;12;7;114
2007;"HORIZONTE (CE)";"CE";"HORIZONTE";260;35;54;349
2007;"IBARETAMA (CE)";"CE";"IBARETAMA";42;6;13;61
2007;"IBIAPINA (CE)";"CE";"IBIAPINA";102;11;10;123
2007;"IBICUITINGA (CE)";"CE";"IBICUITINGA";45;2;7;54
2007;"ICAPUI (CE)";"CE";"ICAPUI";56;16;32;104
2007;"ICO (CE)";"CE";"ICO";210;43;37;290
2007;"IGUATU (CE)";"CE";"IGUATU";688;47;69;804
2007;"INDEPENDENCIA (CE)";"CE";"INDEPENDENCIA";130;4;9;143
2007;"IPAPORANGA (CE)";"CE";"IPAPORANGA";16;0;0;16
2007;"IPAUMIRIM (CE)";"CE";"IPAUMIRIM";149;26;21;196
2007;"IPU (CE)";"CE";"IPU";236;20;22;278
2007;"IPUEIRAS (CE)";"CE";"IPUEIRAS";47;8;2;57
2007;"IRACEMA (CE)";"CE";"IRACEMA";50;8;6;64
2007;"IRAUCUBA (CE)";"CE";"IRAUCUBA";67;7;7;81
2007;"ITAICABA (CE)";"CE";"ITAICABA";26;4;7;37
2007;"ITAITINGA (CE)";"CE";"ITAITINGA";166;32;19;217
2007;"ITAPAGE (CE)";"CE";"ITAPAGE";199;17;11;227
2007;"ITAPIPOCA (CE)";"CE";"ITAPIPOCA";476;22;18;516
2007;"ITAPIUNA (CE)";"CE";"ITAPIUNA";43;6;12;61
2007;"ITAREMA (CE)";"CE";"ITAREMA";89;13;18;120
2007;"ITATIRA (CE)";"CE";"ITATIRA";73;2;5;80
2007;"JAGUARETAMA (CE)";"CE";"JAGUARETAMA";61;2;4;67
2007;"JAGUARIBARA (CE)";"CE";"JAGUARIBARA";57;6;5;68
2007;"JAGUARIBE (CE)";"CE";"JAGUARIBE";245;11;17;273
2007;"JAGUARUANA (CE)";"CE";"JAGUARUANA";158;8;6;172
2007;"JARDIM (CE)";"CE";"JARDIM";43;27;6;76
2007;"JATI (CE)";"CE";"JATI";11;4;0;15
2007;"JIJOCA DE JERICOACOARA (CE)";"CE";"JIJOCA DE JERICOACOARA";37;9;3;49
2007;"JUAZEIRO DO NORTE (CE)";"CE";"JUAZEIRO DO NORTE";1157;110;180;1447
2007;"JUCAS (CE)";"CE";"JUCAS";35;5;12;52
2007;"LAVRAS DA MANGABEIRA (CE)";"CE";"LAVRAS DA MANGABEIRA";53;8;12;73
2007;"LIMOEIRO DO NORTE (CE)";"CE";"LIMOEIRO DO NORTE";510;17;78;605
2007;"MADALENA (CE)";"CE";"MADALENA";58;4;8;70
2007;"MARACANAU (CE)";"CE";"MARACANAU";819;140;160;1119
2007;"MARANGUAPE (CE)";"CE";"MARANGUAPE";423;44;106;573
2007;"MARCO (CE)";"CE";"MARCO";140;4;11;155
2007;"MARTINOPOLE (CE)";"CE";"MARTINOPOLE";14;3;1;18
2007;"MASSAPE (CE)";"CE";"MASSAPE";60;5;29;94
2007;"MAURITI (CE)";"CE";"MAURITI";42;25;9;76
2007;"MERUOCA (CE)";"CE";"MERUOCA";23;2;4;29
2007;"MILAGRES (CE)";"CE";"MILAGRES";60;18;12;90
2007;"MILHA (CE)";"CE";"MILHA";42;1;7;50
2007;"MIRAIMA (CE)";"CE";"MIRAIMA";25;2;2;29
2007;"MISSAO VELHA (CE)";"CE";"MISSAO VELHA";87;27;6;120
2007;"MOMBACA (CE)";"CE";"MOMBACA";147;5;3;155
2007;"MONSENHOR TABOSA (CE)";"CE";"MONSENHOR TABOSA";37;3;1;41
2007;"MORADA NOVA (CE)";"CE";"MORADA NOVA";300;33;50;383
2007;"MORAUJO (CE)";"CE";"MORAUJO";10;2;4;16
2007;"MORRINHOS (CE)";"CE";"MORRINHOS";42;7;6;55
2007;"MUCAMBO (CE)";"CE";"MUCAMBO";24;13;4;41
2007;"MULUNGU (CE)";"CE";"MULUNGU";43;4;1;48
2007;"NOVA OLINDA (CE)";"CE";"NOVA OLINDA";62;19;2;83
2007;"NOVA RUSSAS (CE)";"CE";"NOVA RUSSAS";151;10;5;166
2007;"NOVO ORIENTE (CE)";"CE";"NOVO ORIENTE";46;3;6;55
2007;"OCARA (CE)";"CE";"OCARA";83;20;18;121
2007;"OROS (CE)";"CE";"OROS";77;13;11;101
2007;"PACAJUS (CE)";"CE";"PACAJUS";438;46;38;522
2007;"PACATUBA (CE)";"CE";"PACATUBA";105;66;5;176
2007;"PACOTI (CE)";"CE";"PACOTI";72;4;6;82
2007;"PACUJA (CE)";"CE";"PACUJA";25;4;12;41
2007;"PALHANO (CE)";"CE";"PALHANO";36;8;8;52
2007;"PALMACIA (CE)";"CE";"PALMACIA";37;17;8;62
2007;"PARACURU (CE)";"CE";"PARACURU";143;11;9;163
2007;"PARAIPABA (CE)";"CE";"PARAIPABA";117;7;10;134
2007;"PARAMBU (CE)";"CE";"PARAMBU";129;2;1;132
2007;"PARAMOTI (CE)";"CE";"PARAMOTI";32;2;4;38
2007;"PEDRA BRANCA (CE)";"CE";"PEDRA BRANCA";165;13;9;187
2007;"PENAFORTE (CE)";"CE";"PENAFORTE";15;10;12;37
2007;"PENTECOSTE (CE)";"CE";"PENTECOSTE";146;6;5;157
2007;"PEREIRO (CE)";"CE";"PEREIRO";63;10;7;80
2007;"PINDORETAMA (CE)";"CE";"PINDORETAMA";97;14;3;114
2007;"PIQUET CARNEIRO (CE)";"CE";"PIQUET CARNEIRO";21;2;4;27
2007;"PIRES FERREIRA (CE)";"CE";"PIRES FERREIRA";16;2;1;19
2007;"PORANGA (CE)";"CE";"PORANGA";9;2;0;11
2007;"PORTEIRAS (CE)";"CE";"PORTEIRAS";16;25;5;46
2007;"POTENGI (CE)";"CE";"POTENGI";16;3;0;19
2007;"POTIRETAMA (CE)";"CE";"POTIRETAMA";21;1;5;27
2007;"QUITERIANOPOLIS (CE)";"CE";"QUITERIANOPOLIS";25;8;2;35
2007;"QUIXADA (CE)";"CE";"QUIXADA";441;40;47;528
2007;"QUIXELO (CE)";"CE";"QUIXELO";25;5;16;46
2007;"QUIXERAMOBIM (CE)";"CE";"QUIXERAMOBIM";308;26;59;393
2007;"QUIXERE (CE)";"CE";"QUIXERE";130;7;34;171
2007;"REDENCAO (CE)";"CE";"REDENCAO";160;20;22;202
2007;"RERIUTABA (CE)";"CE";"RERIUTABA";57;13;15;85
2007;"RUSSAS (CE)";"CE";"RUSSAS";517;23;59;599
2007;"SABOEIRO (CE)";"CE";"SABOEIRO";25;7;3;35
2007;"SALITRE (CE)";"CE";"SALITRE";31;2;15;48
2007;"SANTA QUITERIA (CE)";"CE";"SANTA QUITERIA";183;21;7;211
2007;"SANTANA DO ACARAU (CE)";"CE";"SANTANA DO ACARAU";89;16;11;116
2007;"SANTANA DO CARIRI (CE)";"CE";"SANTANA DO CARIRI";46;8;2;56
2007;"SAO BENEDITO (CE)";"CE";"SAO BENEDITO";309;52;31;392
2007;"SAO GONCALO DO AMARANTE (CE)";"CE";"SAO GONCALO DO AMARANTE";163;34;18;215
2007;"SAO JOAO DO JAGUARIBE (CE)";"CE";"SAO JOAO DO JAGUARIBE";35;7;8;50
2007;"SAO LUIS DO CURU (CE)";"CE";"SAO LUIS DO CURU";40;5;9;54
2007;"SENADOR POMPEU (CE)";"CE";"SENADOR POMPEU";110;6;20;136
2007;"SENADOR SA (CE)";"CE";"SENADOR SA";18;2;6;26
2007;"SOBRAL (CE)";"CE";"SOBRAL";1118;140;168;1426
2007;"SOLONOPOLE (CE)";"CE";"SOLONOPOLE";54;2;7;63
2007;"TABULEIRO DO NORTE (CE)";"CE";"TABULEIRO DO NORTE";256;28;29;313
2007;"TAMBORIL (CE)";"CE";"TAMBORIL";49;7;11;67
2007;"TARRAFAS (CE)";"CE";"TARRAFAS";13;6;3;22
2007;"TAUA (CE)";"CE";"TAUA";276;14;23;313
2007;"TEJUCUOCA (CE)";"CE";"TEJUCUOCA";59;4;4;67
2007;"TIANGUA (CE)";"CE";"TIANGUA";890;60;58;1008
2007;"TRAIRI (CE)";"CE";"TRAIRI";130;9;16;155
2007;"TURURU (CE)";"CE";"TURURU";30;1;2;33
2007;"UBAJARA (CE)";"CE";"UBAJARA";171;12;15;198
2007;"UMARI (CE)";"CE";"UMARI";4;2;2;8
2007;"UMIRIM (CE)";"CE";"UMIRIM";38;37;9;84
2007;"URUBURETAMA (CE)";"CE";"URUBURETAMA";56;6;8;70
2007;"URUOCA (CE)";"CE";"URUOCA";30;6;8;44
2007;"VARJOTA (CE)";"CE";"VARJOTA";76;21;4;101
2007;"VARZEA ALEGRE (CE)";"CE";"VARZEA ALEGRE";139;24;23;186
2007;"VICOSA DO CEARA (CE)";"CE";"VICOSA DO CEARA";220;16;11;247
2007;"BRASILIA (DF)";"DF";"BRASILIA";16573;5091;6675;28339
2007;"AFONSO CLAUDIO (ES)";"ES";"AFONSO CLAUDIO";397;17;100;514
2007;"AGUA DOCE DO NORTE (ES)";"ES";"AGUA DOCE DO NORTE";69;5;19;93
2007;"AGUIA BRANCA (ES)";"ES";"AGUIA BRANCA";104;2;18;124
2007;"ALEGRE (ES)";"ES";"ALEGRE";148;14;12;174
2007;"ALFREDO CHAVES (ES)";"ES";"ALFREDO CHAVES";370;16;23;409
2007;"ALTO RIO NOVO (ES)";"ES";"ALTO RIO NOVO";76;12;12;100
2007;"ANCHIETA (ES)";"ES";"ANCHIETA";205;41;34;280
2007;"APIACA (ES)";"ES";"APIACA";55;8;2;65
2007;"ARACRUZ (ES)";"ES";"ARACRUZ";930;107;330;1367
2007;"ATILIO VIVACQUA (ES)";"ES";"ATILIO VIVACQUA";149;7;13;169
2007;"BAIXO GUANDU (ES)";"ES";"BAIXO GUANDU";472;13;85;570
2007;"BARRA DE SAO FRANCISCO (ES)";"ES";"BARRA DE SAO FRANCISCO";407;12;76;495
2007;"BOA ESPERANCA (ES)";"ES";"BOA ESPERANCA";174;7;27;208
2007;"BOM JESUS DO NORTE (ES)";"ES";"BOM JESUS DO NORTE";172;24;20;216
2007;"BREJETUBA (ES)";"ES";"BREJETUBA";128;4;22;154
2007;"CACHOEIRO DE ITAPEMIRIM (ES)";"ES";"CACHOEIRO DE ITAPEMIRIM";4376;157;2024;6557
2007;"CARIACICA (ES)";"ES";"CARIACICA";4121;401;1522;6044
2007;"CASTELO (ES)";"ES";"CASTELO";1101;40;51;1192
2007;"COLATINA (ES)";"ES";"COLATINA";1974;82;411;2467
2007;"CONCEICAO DA BARRA (ES)";"ES";"CONCEICAO DA BARRA";166;12;85;263
2007;"CONCEICAO DO CASTELO (ES)";"ES";"CONCEICAO DO CASTELO";166;18;41;225
2007;"DIVINO DE SAO LOURENCO (ES)";"ES";"DIVINO DE SAO LOURENCO";35;4;5;44
2007;"DOMINGOS MARTINS (ES)";"ES";"DOMINGOS MARTINS";741;49;57;847
2007;"DORES DO RIO PRETO (ES)";"ES";"DORES DO RIO PRETO";98;2;15;115
2007;"ECOPORANGA (ES)";"ES";"ECOPORANGA";119;16;51;186
2007;"FUNDAO (ES)";"ES";"FUNDAO";246;25;36;307
2007;"GOVERNADOR LINDENBERG (ES)";"ES";"GOVERNADOR LINDENBERG";152;7;3;162
2007;"GUACUI (ES)";"ES";"GUACUI";316;33;28;377
2007;"GUARAPARI (ES)";"ES";"GUARAPARI";840;149;174;1163
2007;"IBATIBA (ES)";"ES";"IBATIBA";268;20;24;312
2007;"IBIRACU (ES)";"ES";"IBIRACU";354;23;37;414
2007;"IBITIRAMA (ES)";"ES";"IBITIRAMA";67;3;5;75
2007;"ICONHA (ES)";"ES";"ICONHA";679;19;41;739
2007;"IRUPI (ES)";"ES";"IRUPI";104;13;14;131
2007;"ITAGUACU (ES)";"ES";"ITAGUACU";189;9;50;248
2007;"ITAPEMIRIM (ES)";"ES";"ITAPEMIRIM";346;27;42;415
2007;"ITARANA (ES)";"ES";"ITARANA";249;23;25;297
2007;"IUNA (ES)";"ES";"IUNA";311;18;57;386
2007;"JAGUARE (ES)";"ES";"JAGUARE";336;10;55;401
2007;"JERONIMO MONTEIRO (ES)";"ES";"JERONIMO MONTEIRO";53;11;10;74
2007;"JOAO NEIVA (ES)";"ES";"JOAO NEIVA";264;13;24;301
2007;"LARANJA DA TERRA (ES)";"ES";"LARANJA DA TERRA";205;7;22;234
2007;"LINHARES (ES)";"ES";"LINHARES";2364;67;299;2730
2007;"MANTENOPOLIS (ES)";"ES";"MANTENOPOLIS";95;8;19;122
2007;"MARATAIZES (ES)";"ES";"MARATAIZES";539;25;36;600
2007;"MARECHAL FLORIANO (ES)";"ES";"MARECHAL FLORIANO";517;18;11;546
2007;"MARILANDIA (ES)";"ES";"MARILANDIA";294;8;20;322
2007;"MIMOSO DO SUL (ES)";"ES";"MIMOSO DO SUL";193;14;42;249
2007;"MONTANHA (ES)";"ES";"MONTANHA";146;9;24;179
2007;"MUCURICI (ES)";"ES";"MUCURICI";55;6;24;85
2007;"MUNIZ FREIRE (ES)";"ES";"MUNIZ FREIRE";123;20;28;171
2007;"MUQUI (ES)";"ES";"MUQUI";115;12;18;145
2007;"NOVA VENECIA (ES)";"ES";"NOVA VENECIA";685;21;124;830
2007;"PANCAS (ES)";"ES";"PANCAS";203;12;5;220
2007;"PEDRO CANARIO (ES)";"ES";"PEDRO CANARIO";324;28;203;555
2007;"PINHEIROS (ES)";"ES";"PINHEIROS";216;14;90;320
2007;"PIUMA (ES)";"ES";"PIUMA";154;37;9;200
2007;"PONTO BELO (ES)";"ES";"PONTO BELO";33;5;12;50
2007;"PRESIDENTE KENNEDY (ES)";"ES";"PRESIDENTE KENNEDY";227;26;18;271
2007;"RIO BANANAL (ES)";"ES";"RIO BANANAL";420;10;26;456
2007;"RIO NOVO DO SUL (ES)";"ES";"RIO NOVO DO SUL";232;4;18;254
2007;"SANTA LEOPOLDINA (ES)";"ES";"SANTA LEOPOLDINA";252;21;20;293
2007;"SANTA MARIA DE JETIBA (ES)";"ES";"SANTA MARIA DE JETIBA";1301;45;40;1386
2007;"SANTA TERESA (ES)";"ES";"SANTA TERESA";549;25;52;626
2007;"SAO DOMINGOS DO NORTE (ES)";"ES";"SAO DOMINGOS DO NORTE";155;3;16;174
2007;"SAO GABRIEL DA PALHA (ES)";"ES";"SAO GABRIEL DA PALHA";484;10;69;563
2007;"SAO JOSE DO CALCADO (ES)";"ES";"SAO JOSE DO CALCADO";67;3;14;84
2007;"SAO MATEUS (ES)";"ES";"SAO MATEUS";835;85;258;1178
2007;"SAO ROQUE DO CANAA (ES)";"ES";"SAO ROQUE DO CANAA";231;15;9;255
2007;"SERRA (ES)";"ES";"SERRA";6071;333;1694;8098
2007;"SOORETAMA (ES)";"ES";"SOORETAMA";239;9;41;289
2007;"VARGEM ALTA (ES)";"ES";"VARGEM ALTA";341;10;41;392
2007;"VENDA NOVA DO IMIGRANTE (ES)";"ES";"VENDA NOVA DO IMIGRANTE";626;11;89;726
2007;"VIANA (ES)";"ES";"VIANA";813;37;178;1028
2007;"VILA PAVAO (ES)";"ES";"VILA PAVAO";109;6;13;128
2007;"VILA VALERIO (ES)";"ES";"VILA VALERIO";252;5;18;275
2007;"VILA VELHA (ES)";"ES";"VILA VELHA";3358;629;652;4639
2007;"VITORIA (ES)";"ES";"VITORIA";3015;794;947;4756
2007;"ABADIA DE GOIAS (GO)";"GO";"ABADIA DE GOIAS";40;1;3;44
2007;"ABADIANIA (GO)";"GO";"ABADIANIA";179;16;13;208
2007;"ACREUNA (GO)";"GO";"ACREUNA";317;3;55;375
2007;"ADELANDIA (GO)";"GO";"ADELANDIA";22;0;2;24
2007;"AGUA FRIA DE GOIAS (GO)";"GO";"AGUA FRIA DE GOIAS";27;7;7;41
2007;"AGUA LIMPA (GO)";"GO";"AGUA LIMPA";11;6;1;18
2007;"AGUAS LINDAS DE GOIAS (GO)";"GO";"AGUAS LINDAS DE GOIAS";370;112;259;741
2007;"ALEXANIA (GO)";"GO";"ALEXANIA";282;25;15;322
2007;"ALOANDIA (GO)";"GO";"ALOANDIA";21;2;2;25
2007;"ALTO HORIZONTE (GO)";"GO";"ALTO HORIZONTE";13;4;5;22
2007;"ALTO PARAISO DE GOIAS (GO)";"GO";"ALTO PARAISO DE GOIAS";37;6;6;49
2007;"ALVORADA DO NORTE (GO)";"GO";"ALVORADA DO NORTE";103;3;4;110
2007;"AMARALINA (GO)";"GO";"AMARALINA";6;1;6;13
2007;"AMERICANO DO BRASIL (GO)";"GO";"AMERICANO DO BRASIL";43;4;9;56
2007;"AMORINOPOLIS (GO)";"GO";"AMORINOPOLIS";19;0;7;26
2007;"ANAPOLIS (GO)";"GO";"ANAPOLIS";7776;218;1091;9085
2007;"ANHANGUERA (GO)";"GO";"ANHANGUERA";10;2;1;13
2007;"ANICUNS (GO)";"GO";"ANICUNS";254;13;67;334
2007;"APARECIDA DE GOIANIA (GO)";"GO";"APARECIDA DE GOIANIA";3249;169;403;3821
2007;"APARECIDA DO RIO DOCE (GO)";"GO";"APARECIDA DO RIO DOCE";44;1;6;51
2007;"APORE (GO)";"GO";"APORE";43;5;5;53
2007;"ARACU (GO)";"GO";"ARACU";16;2;3;21
2007;"ARAGARCAS (GO)";"GO";"ARAGARCAS";500;6;25;531
2007;"ARAGOIANIA (GO)";"GO";"ARAGOIANIA";38;0;4;42
2007;"ARAGUAPAZ (GO)";"GO";"ARAGUAPAZ";83;0;6;89
2007;"ARENOPOLIS (GO)";"GO";"ARENOPOLIS";8;3;3;14
2007;"ARUANA (GO)";"GO";"ARUANA";15;2;5;22
2007;"AURILANDIA (GO)";"GO";"AURILANDIA";13;3;1;17
2007;"AVELINOPOLIS (GO)";"GO";"AVELINOPOLIS";23;1;0;24
2007;"BALIZA (GO)";"GO";"BALIZA";4;1;2;7
2007;"BARRO ALTO (GO)";"GO";"BARRO ALTO";72;5;15;92
2007;"BELA VISTA DE GOIAS (GO)";"GO";"BELA VISTA DE GOIAS";233;7;30;270
2007;"BOM JARDIM DE GOIAS (GO)";"GO";"BOM JARDIM DE GOIAS";77;5;10;92
2007;"BOM JESUS DE GOIAS (GO)";"GO";"BOM JESUS DE GOIAS";360;17;73;450
2007;"BONFINOPOLIS (GO)";"GO";"BONFINOPOLIS";33;3;9;45
2007;"BONOPOLIS (GO)";"GO";"BONOPOLIS";11;1;2;14
2007;"BRAZABRANTES (GO)";"GO";"BRAZABRANTES";34;3;3;40
2007;"BRITANIA (GO)";"GO";"BRITANIA";51;2;6;59
2007;"BURITI ALEGRE (GO)";"GO";"BURITI ALEGRE";156;6;5;167
2007;"BURITI DE GOIAS (GO)";"GO";"BURITI DE GOIAS";11;8;2;21
2007;"BURITINOPOLIS (GO)";"GO";"BURITINOPOLIS";13;1;3;17
2007;"CABECEIRAS (GO)";"GO";"CABECEIRAS";49;2;16;67
2007;"CACHOEIRA ALTA (GO)";"GO";"CACHOEIRA ALTA";113;7;14;134
2007;"CACHOEIRA DE GOIAS (GO)";"GO";"CACHOEIRA DE GOIAS";4;1;0;5
2007;"CACHOEIRA DOURADA (GO)";"GO";"CACHOEIRA DOURADA";82;9;17;108
2007;"CACU (GO)";"GO";"CACU";150;3;18;171
2007;"CAIAPONIA (GO)";"GO";"CAIAPONIA";106;1;5;112
2007;"CALDAS NOVAS (GO)";"GO";"CALDAS NOVAS";502;41;62;605
2007;"CALDAZINHA (GO)";"GO";"CALDAZINHA";20;0;2;22
2007;"CAMPESTRE DE GOIAS (GO)";"GO";"CAMPESTRE DE GOIAS";21;2;2;25
2007;"CAMPINACU (GO)";"GO";"CAMPINACU";8;3;3;14
2007;"CAMPINORTE (GO)";"GO";"CAMPINORTE";97;1;11;109
2007;"CAMPO ALEGRE DE GOIAS (GO)";"GO";"CAMPO ALEGRE DE GOIAS";87;4;12;103
2007;"CAMPO LIMPO DE GOIAS (GO)";"GO";"CAMPO LIMPO DE GOIAS";57;0;3;60
2007;"CAMPOS BELOS (GO)";"GO";"CAMPOS BELOS";138;4;23;165
2007;"CAMPOS VERDES (GO)";"GO";"CAMPOS VERDES";26;4;1;31
2007;"CARMO DO RIO VERDE (GO)";"GO";"CARMO DO RIO VERDE";61;6;37;104
2007;"CASTELANDIA (GO)";"GO";"CASTELANDIA";37;2;7;46
2007;"CATALAO (GO)";"GO";"CATALAO";1400;71;207;1678
2007;"CATURAI (GO)";"GO";"CATURAI";29;3;5;37
2007;"CAVALCANTE (GO)";"GO";"CAVALCANTE";18;1;3;22
2007;"CERES (GO)";"GO";"CERES";457;15;24;496
2007;"CEZARINA (GO)";"GO";"CEZARINA";80;2;6;88
2007;"CHAPADAO DO CEU (GO)";"GO";"CHAPADAO DO CEU";124;5;9;138
2007;"CIDADE OCIDENTAL (GO)";"GO";"CIDADE OCIDENTAL";87;33;52;172
2007;"COCALZINHO DE GOIAS (GO)";"GO";"COCALZINHO DE GOIAS";113;13;15;141
2007;"COLINAS DO SUL (GO)";"GO";"COLINAS DO SUL";8;2;2;12
2007;"CORREGO DO OURO (GO)";"GO";"CORREGO DO OURO";15;0;1;16
2007;"CORUMBA DE GOIAS (GO)";"GO";"CORUMBA DE GOIAS";71;6;11;88
2007;"CORUMBAIBA (GO)";"GO";"CORUMBAIBA";107;5;8;120
2007;"CRISTALINA (GO)";"GO";"CRISTALINA";728;24;136;888
2007;"CRISTIANOPOLIS (GO)";"GO";"CRISTIANOPOLIS";31;5;1;37
2007;"CRIXAS (GO)";"GO";"CRIXAS";69;13;11;93
2007;"CROMINIA (GO)";"GO";"CROMINIA";25;1;2;28
2007;"CUMARI (GO)";"GO";"CUMARI";15;4;0;19
2007;"DAMIANOPOLIS (GO)";"GO";"DAMIANOPOLIS";6;0;3;9
2007;"DAMOLANDIA (GO)";"GO";"DAMOLANDIA";21;3;3;27
2007;"DAVINOPOLIS (GO)";"GO";"DAVINOPOLIS";26;3;5;34
2007;"DIORAMA (GO)";"GO";"DIORAMA";8;4;4;16
2007;"DIVINOPOLIS DE GOIAS (GO)";"GO";"DIVINOPOLIS DE GOIAS";20;0;5;25
2007;"DOVERLANDIA (GO)";"GO";"DOVERLANDIA";82;3;24;109
2007;"EDEALINA (GO)";"GO";"EDEALINA";51;1;6;58
2007;"EDEIA (GO)";"GO";"EDEIA";132;2;12;146
2007;"ESTRELA DO NORTE (GO)";"GO";"ESTRELA DO NORTE";21;4;1;26
2007;"FAINA (GO)";"GO";"FAINA";26;2;5;33
2007;"FAZENDA NOVA (GO)";"GO";"FAZENDA NOVA";30;2;7;39
2007;"FIRMINOPOLIS (GO)";"GO";"FIRMINOPOLIS";61;1;4;66
2007;"FLORES DE GOIAS (GO)";"GO";"FLORES DE GOIAS";24;6;4;34
2007;"FORMOSA (GO)";"GO";"FORMOSA";2193;79;465;2737
2007;"FORMOSO (GO)";"GO";"FORMOSO";34;1;4;39
2007;"GAMELEIRA DE GOIAS (GO)";"GO";"GAMELEIRA DE GOIAS";15;7;9;31
2007;"GOIANAPOLIS (GO)";"GO";"GOIANAPOLIS";146;5;9;160
2007;"GOIANDIRA (GO)";"GO";"GOIANDIRA";37;3;3;43
2007;"GOIANESIA (GO)";"GO";"GOIANESIA";726;21;135;882
2007;"GOIANIA (GO)";"GO";"GOIANIA";20965;1638;5323;27926
2007;"GOIANIRA (GO)";"GO";"GOIANIRA";148;1;58;207
2007;"GOIAS (GO)";"GO";"GOIAS";170;8;27;205
2007;"GOIATUBA (GO)";"GO";"GOIATUBA";507;18;49;574
2007;"GOUVELANDIA (GO)";"GO";"GOUVELANDIA";43;3;8;54
2007;"GUAPO (GO)";"GO";"GUAPO";107;9;4;120
2007;"GUARAITA (GO)";"GO";"GUARAITA";12;0;0;12
2007;"GUARANI DE GOIAS (GO)";"GO";"GUARANI DE GOIAS";6;1;7;14
2007;"GUARINOS (GO)";"GO";"GUARINOS";4;3;2;9
2007;"HEITORAI (GO)";"GO";"HEITORAI";13;0;2;15
2007;"HIDROLANDIA (GO)";"GO";"HIDROLANDIA";162;13;12;187
2007;"HIDROLINA (GO)";"GO";"HIDROLINA";14;0;3;17
2007;"IACIARA (GO)";"GO";"IACIARA";103;3;10;116
2007;"INACIOLANDIA (GO)";"GO";"INACIOLANDIA";42;7;5;54
2007;"INDIARA (GO)";"GO";"INDIARA";140;12;15;167
2007;"INHUMAS (GO)";"GO";"INHUMAS";843;24;146;1013
2007;"IPAMERI (GO)";"GO";"IPAMERI";215;24;60;299
2007;"IPIRANGA DE GOIAS (GO)";"GO";"IPIRANGA DE GOIAS";6;4;7;17
2007;"IPORA (GO)";"GO";"IPORA";311;12;33;356
2007;"ISRAELANDIA (GO)";"GO";"ISRAELANDIA";6;0;4;10
2007;"ITABERAI (GO)";"GO";"ITABERAI";473;12;40;525
2007;"ITAGUARI (GO)";"GO";"ITAGUARI";38;6;11;55
2007;"ITAGUARU (GO)";"GO";"ITAGUARU";53;5;6;64
2007;"ITAJA (GO)";"GO";"ITAJA";56;4;8;68
2007;"ITAPACI (GO)";"GO";"ITAPACI";149;11;49;209
2007;"ITAPIRAPUA (GO)";"GO";"ITAPIRAPUA";44;1;7;52
2007;"ITAPURANGA (GO)";"GO";"ITAPURANGA";240;12;51;303
2007;"ITARUMA (GO)";"GO";"ITARUMA";65;5;4;74
2007;"ITAUCU (GO)";"GO";"ITAUCU";69;5;11;85
2007;"ITUMBIARA (GO)";"GO";"ITUMBIARA";1946;146;149;2241
2007;"IVOLANDIA (GO)";"GO";"IVOLANDIA";6;2;3;11
2007;"JANDAIA (GO)";"GO";"JANDAIA";69;4;10;83
2007;"JARAGUA (GO)";"GO";"JARAGUA";246;12;27;285
2007;"JATAI (GO)";"GO";"JATAI";1535;42;125;1702
2007;"JAUPACI (GO)";"GO";"JAUPACI";16;3;5;24
2007;"JESUPOLIS (GO)";"GO";"JESUPOLIS";13;1;4;18
2007;"JOVIANIA (GO)";"GO";"JOVIANIA";119;4;7;130
2007;"JUSSARA (GO)";"GO";"JUSSARA";272;9;12;293
2007;"LAGOA SANTA (GO)";"GO";"LAGOA SANTA";9;3;3;15
2007;"LEOPOLDO DE BULHOES (GO)";"GO";"LEOPOLDO DE BULHOES";69;4;5;78
2007;"LUZIANIA (GO)";"GO";"LUZIANIA";1916;98;326;2340
2007;"MAIRIPOTABA (GO)";"GO";"MAIRIPOTABA";16;1;2;19
2007;"MAMBAI (GO)";"GO";"MAMBAI";51;2;7;60
2007;"MARA ROSA (GO)";"GO";"MARA ROSA";76;0;9;85
2007;"MARZAGAO (GO)";"GO";"MARZAGAO";21;2;1;24
2007;"MATRINCHA (GO)";"GO";"MATRINCHA";28;5;6;39
2007;"MAURILANDIA (GO)";"GO";"MAURILANDIA";261;8;61;330
2007;"MIMOSO DE GOIAS (GO)";"GO";"MIMOSO DE GOIAS";5;0;2;7
2007;"MINACU (GO)";"GO";"MINACU";258;21;23;302
2007;"MINEIROS (GO)";"GO";"MINEIROS";999;25;68;1092
2007;"MOIPORA (GO)";"GO";"MOIPORA";8;1;0;9
2007;"MONTE ALEGRE DE GOIAS (GO)";"GO";"MONTE ALEGRE DE GOIAS";13;0;4;17
2007;"MONTES CLAROS DE GOIAS (GO)";"GO";"MONTES CLAROS DE GOIAS";46;1;8;55
2007;"MONTIVIDIU (GO)";"GO";"MONTIVIDIU";223;2;34;259
2007;"MONTIVIDIU DO NORTE (GO)";"GO";"MONTIVIDIU DO NORTE";14;2;12;28
2007;"MORRINHOS (GO)";"GO";"MORRINHOS";574;24;59;657
2007;"MORRO AGUDO DE GOIAS (GO)";"GO";"MORRO AGUDO DE GOIAS";9;3;2;14
2007;"MOSSAMEDES (GO)";"GO";"MOSSAMEDES";24;4;2;30
2007;"MOZARLANDIA (GO)";"GO";"MOZARLANDIA";97;1;16;114
2007;"MUNDO NOVO (GO)";"GO";"MUNDO NOVO";18;4;6;28
2007;"MUTUNOPOLIS (GO)";"GO";"MUTUNOPOLIS";15;2;3;20
2007;"NAZARIO (GO)";"GO";"NAZARIO";96;0;8;104
2007;"NEROPOLIS (GO)";"GO";"NEROPOLIS";305;16;19;340
2007;"NIQUELANDIA (GO)";"GO";"NIQUELANDIA";444;42;92;578
2007;"NOVA AMERICA (GO)";"GO";"NOVA AMERICA";12;1;3;16
2007;"NOVA AURORA (GO)";"GO";"NOVA AURORA";17;3;3;23
2007;"NOVA CRIXAS (GO)";"GO";"NOVA CRIXAS";53;2;20;75
2007;"NOVA GLORIA (GO)";"GO";"NOVA GLORIA";55;5;19;79
2007;"NOVA IGUACU DE GOIAS (GO)";"GO";"NOVA IGUACU DE GOIAS";12;1;3;16
2007;"NOVA ROMA (GO)";"GO";"NOVA ROMA";3;1;2;6
2007;"NOVA VENEZA (GO)";"GO";"NOVA VENEZA";182;3;13;198
2007;"NOVO BRASIL (GO)";"GO";"NOVO BRASIL";17;1;1;19
2007;"NOVO GAMA (GO)";"GO";"NOVO GAMA";261;49;83;393
2007;"NOVO PLANALTO (GO)";"GO";"NOVO PLANALTO";28;2;1;31
2007;"ORIZONA (GO)";"GO";"ORIZONA";138;17;34;189
2007;"OURO VERDE DE GOIAS (GO)";"GO";"OURO VERDE DE GOIAS";70;0;7;77
2007;"OUVIDOR (GO)";"GO";"OUVIDOR";71;6;8;85
2007;"PADRE BERNARDO (GO)";"GO";"PADRE BERNARDO";231;7;34;272
2007;"PALESTINA DE GOIAS (GO)";"GO";"PALESTINA DE GOIAS";15;6;3;24
2007;"PALMEIRAS DE GOIAS (GO)";"GO";"PALMEIRAS DE GOIAS";220;8;33;261
2007;"PALMELO (GO)";"GO";"PALMELO";13;2;1;16
2007;"PALMINOPOLIS (GO)";"GO";"PALMINOPOLIS";21;1;2;24
2007;"PANAMA (GO)";"GO";"PANAMA";21;0;4;25
2007;"PARANAIGUARA (GO)";"GO";"PARANAIGUARA";80;5;6;91
2007;"PARAUNA (GO)";"GO";"PARAUNA";104;10;21;135
2007;"PEROLANDIA (GO)";"GO";"PEROLANDIA";19;0;8;27
2007;"PETROLINA DE GOIAS (GO)";"GO";"PETROLINA DE GOIAS";82;2;13;97
2007;"PILAR DE GOIAS (GO)";"GO";"PILAR DE GOIAS";8;3;2;13
2007;"PIRACANJUBA (GO)";"GO";"PIRACANJUBA";270;13;25;308
2007;"PIRANHAS (GO)";"GO";"PIRANHAS";156;4;21;181
2007;"PIRENOPOLIS (GO)";"GO";"PIRENOPOLIS";203;10;20;233
2007;"PIRES DO RIO (GO)";"GO";"PIRES DO RIO";386;16;23;425
2007;"PLANALTINA (GO)";"GO";"PLANALTINA";274;26;286;586
2007;"PONTALINA (GO)";"GO";"PONTALINA";192;6;23;221
2007;"PORANGATU (GO)";"GO";"PORANGATU";441;13;46;500
2007;"PORTEIRAO (GO)";"GO";"PORTEIRAO";71;6;8;85
2007;"PORTELANDIA (GO)";"GO";"PORTELANDIA";39;13;2;54
2007;"POSSE (GO)";"GO";"POSSE";394;24;50;468
2007;"PROFESSOR JAMIL (GO)";"GO";"PROFESSOR JAMIL";25;1;4;30
2007;"QUIRINOPOLIS (GO)";"GO";"QUIRINOPOLIS";675;13;43;731
2007;"RIALMA (GO)";"GO";"RIALMA";288;13;21;322
2007;"RIANAPOLIS (GO)";"GO";"RIANAPOLIS";70;2;5;77
2007;"RIO QUENTE (GO)";"GO";"RIO QUENTE";32;10;25;67
2007;"RIO VERDE (GO)";"GO";"RIO VERDE";2536;128;313;2977
2007;"RUBIATABA (GO)";"GO";"RUBIATABA";185;7;38;230
2007;"SANCLERLANDIA (GO)";"GO";"SANCLERLANDIA";58;4;5;67
2007;"SANTA BARBARA DE GOIAS (GO)";"GO";"SANTA BARBARA DE GOIAS";65;3;5;73
2007;"SANTA CRUZ DE GOIAS (GO)";"GO";"SANTA CRUZ DE GOIAS";4;1;2;7
2007;"SANTA FE DE GOIAS (GO)";"GO";"SANTA FE DE GOIAS";34;2;3;39
2007;"SANTA HELENA DE GOIAS (GO)";"GO";"SANTA HELENA DE GOIAS";633;23;125;781
2007;"SANTA ISABEL (GO)";"GO";"SANTA ISABEL";8;2;1;11
2007;"SANTA RITA DO ARAGUAIA (GO)";"GO";"SANTA RITA DO ARAGUAIA";117;4;2;123
2007;"SANTA RITA DO NOVO DESTINO (GO)";"GO";"SANTA RITA DO NOVO DESTINO";15;2;8;25
2007;"SANTA ROSA DE GOIAS (GO)";"GO";"SANTA ROSA DE GOIAS";17;3;2;22
2007;"SANTA TEREZA DE GOIAS (GO)";"GO";"SANTA TEREZA DE GOIAS";31;1;3;35
2007;"SANTA TEREZINHA DE GOIAS (GO)";"GO";"SANTA TEREZINHA DE GOIAS";54;4;16;74
2007;"SANTO ANTONIO DA BARRA (GO)";"GO";"SANTO ANTONIO DA BARRA";26;2;8;36
2007;"SANTO ANTONIO DE GOIAS (GO)";"GO";"SANTO ANTONIO DE GOIAS";37;3;11;51
2007;"SANTO ANTONIO DO DESCOBERTO (GO)";"GO";"SANTO ANTONIO DO DESCOBERTO";235;25;169;429
2007;"SAO DOMINGOS (GO)";"GO";"SAO DOMINGOS";25;3;9;37
2007;"SAO FRANCISCO DE GOIAS (GO)";"GO";"SAO FRANCISCO DE GOIAS";31;3;5;39
2007;"SAO JOAO D ALIANCA (GO)";"GO";"SAO JOAO D ALIANCA";93;3;9;105
2007;"SAO JOAO DA PARAUNA (GO)";"GO";"SAO JOAO DA PARAUNA";9;1;3;13
2007;"SAO LUIS DE MONTES BELOS (GO)";"GO";"SAO LUIS DE MONTES BELOS";291;12;55;358
2007;"SAO LUIZ DO NORTE (GO)";"GO";"SAO LUIZ DO NORTE";18;2;8;28
2007;"SAO MIGUEL DO ARAGUAIA (GO)";"GO";"SAO MIGUEL DO ARAGUAIA";235;4;30;269
2007;"SAO MIGUEL DO PASSA QUATRO (GO)";"GO";"SAO MIGUEL DO PASSA QUATRO";22;1;3;26
2007;"SAO PATRICIO (GO)";"GO";"SAO PATRICIO";6;0;2;8
2007;"SAO SIMAO (GO)";"GO";"SAO SIMAO";117;12;28;157
2007;"SENADOR CANEDO (GO)";"GO";"SENADOR CANEDO";415;18;24;457
2007;"SERRANOPOLIS (GO)";"GO";"SERRANOPOLIS";82;6;19;107
2007;"SILVANIA (GO)";"GO";"SILVANIA";233;5;29;267
2007;"SIMOLANDIA (GO)";"GO";"SIMOLANDIA";74;1;3;78
2007;"SITIO D ABADIA (GO)";"GO";"SITIO D ABADIA";5;0;5;10
2007;"TAQUARAL DE GOIAS (GO)";"GO";"TAQUARAL DE GOIAS";12;4;4;20
2007;"TERESINA DE GOIAS (GO)";"GO";"TERESINA DE GOIAS";8;1;1;10
2007;"TEREZOPOLIS DE GOIAS (GO)";"GO";"TEREZOPOLIS DE GOIAS";51;3;12;66
2007;"TRES RANCHOS (GO)";"GO";"TRES RANCHOS";26;7;2;35
2007;"TRINDADE (GO)";"GO";"TRINDADE";724;27;79;830
2007;"TROMBAS (GO)";"GO";"TROMBAS";21;3;7;31
2007;"TURVANIA (GO)";"GO";"TURVANIA";55;3;3;61
2007;"TURVELANDIA (GO)";"GO";"TURVELANDIA";33;2;16;51
2007;"UIRAPURU (GO)";"GO";"UIRAPURU";8;3;3;14
2007;"URUACU (GO)";"GO";"URUACU";350;10;40;400
2007;"URUANA (GO)";"GO";"URUANA";195;3;4;202
2007;"URUTAI (GO)";"GO";"URUTAI";12;0;5;17
2007;"VALPARAISO DE GOIAS (GO)";"GO";"VALPARAISO DE GOIAS";348;170;93;611
2007;"VARJAO (GO)";"GO";"VARJAO";32;0;5;37
2007;"VIANOPOLIS (GO)";"GO";"VIANOPOLIS";293;17;14;324
2007;"VICENTINOPOLIS (GO)";"GO";"VICENTINOPOLIS";132;4;17;153
2007;"VILA BOA (GO)";"GO";"VILA BOA";9;2;1;12
2007;"VILA PROPICIO (GO)";"GO";"VILA PROPICIO";8;3;11;22
2007;"ACAILANDIA (MA)";"MA";"ACAILANDIA";703;37;90;830
2007;"AFONSO CUNHA (MA)";"MA";"AFONSO CUNHA";1;1;0;2
2007;"AGUA DOCE DO MARANHAO (MA)";"MA";"AGUA DOCE DO MARANHAO";0;1;0;1
2007;"ALCANTARA (MA)";"MA";"ALCANTARA";19;5;7;31
2007;"ALDEIAS ALTAS (MA)";"MA";"ALDEIAS ALTAS";25;5;2;32
2007;"ALTAMIRA DO MARANHAO (MA)";"MA";"ALTAMIRA DO MARANHAO";14;3;1;18
2007;"ALTO ALEGRE DO MARANHAO (MA)";"MA";"ALTO ALEGRE DO MARANHAO";25;17;0;42
2007;"ALTO ALEGRE DO PINDARE (MA)";"MA";"ALTO ALEGRE DO PINDARE";19;6;2;27
2007;"ALTO PARNAIBA (MA)";"MA";"ALTO PARNAIBA";21;1;2;24
2007;"AMAPA DO MARANHAO (MA)";"MA";"AMAPA DO MARANHAO";6;1;1;8
2007;"AMARANTE DO MARANHAO (MA)";"MA";"AMARANTE DO MARANHAO";42;1;4;47
2007;"ANAJATUBA (MA)";"MA";"ANAJATUBA";17;2;3;22
2007;"ANAPURUS (MA)";"MA";"ANAPURUS";22;1;4;27
2007;"APICUM ACU (MA)";"MA";"APICUM ACU";5;4;0;9
2007;"ARAGUANA (MA)";"MA";"ARAGUANA";1;0;1;2
2007;"ARAIOSES (MA)";"MA";"ARAIOSES";11;3;8;22
2007;"ARAME (MA)";"MA";"ARAME";64;5;0;69
2007;"ARARI (MA)";"MA";"ARARI";48;6;3;57
2007;"AXIXA (MA)";"MA";"AXIXA";9;4;2;15
2007;"BACABAL (MA)";"MA";"BACABAL";546;65;43;654
2007;"BACABEIRA (MA)";"MA";"BACABEIRA";42;0;2;44
2007;"BACURI (MA)";"MA";"BACURI";4;2;2;8
2007;"BACURITUBA (MA)";"MA";"BACURITUBA";3;0;0;3
2007;"BALSAS (MA)";"MA";"BALSAS";809;27;41;877
2007;"BARAO DE GRAJAU (MA)";"MA";"BARAO DE GRAJAU";18;1;2;21
2007;"BARRA DO CORDA (MA)";"MA";"BARRA DO CORDA";307;7;9;323
2007;"BARREIRINHAS (MA)";"MA";"BARREIRINHAS";29;7;11;47
2007;"BELA VISTA DO MARANHAO (MA)";"MA";"BELA VISTA DO MARANHAO";19;1;0;20
2007;"BELAGUA (MA)";"MA";"BELAGUA";2;4;2;8
2007;"BENEDITO LEITE (MA)";"MA";"BENEDITO LEITE";0;0;0;0
2007;"BEQUIMAO (MA)";"MA";"BEQUIMAO";51;6;7;64
2007;"BERNARDO DO MEARIM (MA)";"MA";"BERNARDO DO MEARIM";13;2;0;15
2007;"BOA VISTA DO GURUPI (MA)";"MA";"BOA VISTA DO GURUPI";2;1;1;4
2007;"BOM JARDIM (MA)";"MA";"BOM JARDIM";57;4;3;64
2007;"BOM JESUS DAS SELVAS (MA)";"MA";"BOM JESUS DAS SELVAS";44;4;2;50
2007;"BOM LUGAR (MA)";"MA";"BOM LUGAR";24;6;7;37
2007;"BREJO (MA)";"MA";"BREJO";35;9;9;53
2007;"BREJO DE AREIA (MA)";"MA";"BREJO DE AREIA";15;3;1;19
2007;"BURITI (MA)";"MA";"BURITI";8;2;12;22
2007;"BURITI BRAVO (MA)";"MA";"BURITI BRAVO";18;0;0;18
2007;"BURITICUPU (MA)";"MA";"BURITICUPU";185;19;5;209
2007;"BURITIRANA (MA)";"MA";"BURITIRANA";8;0;0;8
2007;"CACHOEIRA GRANDE (MA)";"MA";"CACHOEIRA GRANDE";3;2;0;5
2007;"CAJAPIO (MA)";"MA";"CAJAPIO";5;0;2;7
2007;"CAJARI (MA)";"MA";"CAJARI";0;0;0;0
2007;"CAMPESTRE DO MARANHAO (MA)";"MA";"CAMPESTRE DO MARANHAO";7;3;0;10
2007;"CANDIDO MENDES (MA)";"MA";"CANDIDO MENDES";6;3;1;10
2007;"CANTANHEDE (MA)";"MA";"CANTANHEDE";13;2;0;15
2007;"CAPINZAL DO NORTE (MA)";"MA";"CAPINZAL DO NORTE";17;10;1;28
2007;"CAROLINA (MA)";"MA";"CAROLINA";40;1;2;43
2007;"CARUTAPERA (MA)";"MA";"CARUTAPERA";16;3;5;24
2007;"CAXIAS (MA)";"MA";"CAXIAS";441;27;53;521
2007;"CEDRAL (MA)";"MA";"CEDRAL";5;1;3;9
2007;"CENTRAL DO MARANHAO (MA)";"MA";"CENTRAL DO MARANHAO";5;0;0;5
2007;"CENTRO DO GUILHERME (MA)";"MA";"CENTRO DO GUILHERME";5;0;1;6
2007;"CENTRO NOVO DO MARANHAO (MA)";"MA";"CENTRO NOVO DO MARANHAO";12;0;3;15
2007;"CHAPADINHA (MA)";"MA";"CHAPADINHA";185;28;6;219
2007;"CIDELANDIA (MA)";"MA";"CIDELANDIA";18;4;5;27
2007;"CODO (MA)";"MA";"CODO";376;10;14;400
2007;"COELHO NETO (MA)";"MA";"COELHO NETO";64;5;7;76
2007;"COLINAS (MA)";"MA";"COLINAS";85;7;5;97
2007;"CONCEICAO DO LAGO ACU (MA)";"MA";"CONCEICAO DO LAGO ACU";5;4;0;9
2007;"COROATA (MA)";"MA";"COROATA";119;24;6;149
2007;"CURURUPU (MA)";"MA";"CURURUPU";14;4;5;23
2007;"DAVINOPOLIS (MA)";"MA";"DAVINOPOLIS";10;0;0;10
2007;"DOM PEDRO (MA)";"MA";"DOM PEDRO";209;6;18;233
2007;"DUQUE BACELAR (MA)";"MA";"DUQUE BACELAR";0;2;2;4
2007;"ESPERANTINOPOLIS (MA)";"MA";"ESPERANTINOPOLIS";38;6;0;44
2007;"ESTREITO (MA)";"MA";"ESTREITO";20;5;1;26
2007;"FEIRA NOVA DO MARANHAO (MA)";"MA";"FEIRA NOVA DO MARANHAO";1;1;0;2
2007;"FERNANDO FALCAO (MA)";"MA";"FERNANDO FALCAO";9;1;2;12
2007;"FORMOSA DA SERRA NEGRA (MA)";"MA";"FORMOSA DA SERRA NEGRA";11;0;0;11
2007;"FORTALEZA DOS NOGUEIRAS (MA)";"MA";"FORTALEZA DOS NOGUEIRAS";25;1;3;29
2007;"FORTUNA (MA)";"MA";"FORTUNA";17;2;0;19
2007;"GODOFREDO VIANA (MA)";"MA";"GODOFREDO VIANA";3;3;2;8
2007;"GONCALVES DIAS (MA)";"MA";"GONCALVES DIAS";15;2;2;19
2007;"GOVERNADOR ARCHER (MA)";"MA";"GOVERNADOR ARCHER";11;5;2;18
2007;"GOVERNADOR EDISON LOBAO (MA)";"MA";"GOVERNADOR EDISON LOBAO";16;2;2;20
2007;"GOVERNADOR EUGENIO BARROS (MA)";"MA";"GOVERNADOR EUGENIO BARROS";17;4;3;24
2007;"GOVERNADOR LUIZ ROCHA (MA)";"MA";"GOVERNADOR LUIZ ROCHA";9;2;2;13
2007;"GOVERNADOR NEWTON BELLO (MA)";"MA";"GOVERNADOR NEWTON BELLO";13;0;1;14
2007;"GOVERNADOR NUNES FREIRE (MA)";"MA";"GOVERNADOR NUNES FREIRE";23;4;0;27
2007;"GRACA ARANHA (MA)";"MA";"GRACA ARANHA";10;4;2;16
2007;"GRAJAU (MA)";"MA";"GRAJAU";223;3;8;234
2007;"GUIMARAES (MA)";"MA";"GUIMARAES";7;1;2;10
2007;"HUMBERTO DE CAMPOS (MA)";"MA";"HUMBERTO DE CAMPOS";7;5;0;12
2007;"ICATU (MA)";"MA";"ICATU";5;3;3;11
2007;"IGARAPE DO MEIO (MA)";"MA";"IGARAPE DO MEIO";10;2;5;17
2007;"IGARAPE GRANDE (MA)";"MA";"IGARAPE GRANDE";37;9;4;50
2007;"IMPERATRIZ (MA)";"MA";"IMPERATRIZ";1840;74;197;2111
2007;"ITAIPAVA DO GRAJAU (MA)";"MA";"ITAIPAVA DO GRAJAU";10;1;0;11
2007;"ITAPECURU MIRIM (MA)";"MA";"ITAPECURU MIRIM";187;12;20;219
2007;"ITINGA DO MARANHAO (MA)";"MA";"ITINGA DO MARANHAO";69;2;1;72
2007;"JATOBA (MA)";"MA";"JATOBA";2;2;0;4
2007;"JENIPAPO DOS VIEIRAS (MA)";"MA";"JENIPAPO DOS VIEIRAS";24;0;1;25
2007;"JOAO LISBOA (MA)";"MA";"JOAO LISBOA";48;1;3;52
2007;"JOSELANDIA (MA)";"MA";"JOSELANDIA";29;4;3;36
2007;"JUNCO DO MARANHAO (MA)";"MA";"JUNCO DO MARANHAO";5;12;0;17
2007;"LAGO DA PEDRA (MA)";"MA";"LAGO DA PEDRA";164;21;4;189
2007;"LAGO DO JUNCO (MA)";"MA";"LAGO DO JUNCO";12;1;3;16
2007;"LAGO DOS RODRIGUES (MA)";"MA";"LAGO DOS RODRIGUES";24;4;2;30
2007;"LAGO VERDE (MA)";"MA";"LAGO VERDE";14;0;3;17
2007;"LAGOA DO MATO (MA)";"MA";"LAGOA DO MATO";1;0;1;2
2007;"LAGOA GRANDE DO MARANHAO (MA)";"MA";"LAGOA GRANDE DO MARANHAO";15;1;0;16
2007;"LAJEADO NOVO (MA)";"MA";"LAJEADO NOVO";10;1;0;11
2007;"LIMA CAMPOS (MA)";"MA";"LIMA CAMPOS";44;9;2;55
2007;"LORETO (MA)";"MA";"LORETO";2;1;1;4
2007;"LUIS DOMINGUES (MA)";"MA";"LUIS DOMINGUES";0;1;1;2
2007;"MAGALHAES DE ALMEIDA (MA)";"MA";"MAGALHAES DE ALMEIDA";5;2;1;8
2007;"MARACACUME (MA)";"MA";"MARACACUME";35;21;1;57
2007;"MARAJA DO SENA (MA)";"MA";"MARAJA DO SENA";8;0;0;8
2007;"MARANHAOZINHO (MA)";"MA";"MARANHAOZINHO";10;0;1;11
2007;"MATA ROMA (MA)";"MA";"MATA ROMA";22;4;5;31
2007;"MATINHA (MA)";"MA";"MATINHA";20;7;0;27
2007;"MATOES (MA)";"MA";"MATOES";12;1;2;15
2007;"MATOES DO NORTE (MA)";"MA";"MATOES DO NORTE";5;3;1;9
2007;"MILAGRES DO MARANHAO (MA)";"MA";"MILAGRES DO MARANHAO";3;2;2;7
2007;"MIRADOR (MA)";"MA";"MIRADOR";11;0;1;12
2007;"MIRANDA DO NORTE (MA)";"MA";"MIRANDA DO NORTE";60;1;2;63
2007;"MIRINZAL (MA)";"MA";"MIRINZAL";20;1;4;25
2007;"MONCAO (MA)";"MA";"MONCAO";8;3;3;14
2007;"MONTES ALTOS (MA)";"MA";"MONTES ALTOS";20;0;1;21
2007;"MORROS (MA)";"MA";"MORROS";6;3;2;11
2007;"NINA RODRIGUES (MA)";"MA";"NINA RODRIGUES";4;3;1;8
2007;"NOVA COLINAS (MA)";"MA";"NOVA COLINAS";3;0;2;5
2007;"NOVA IORQUE (MA)";"MA";"NOVA IORQUE";5;0;0;5
2007;"NOVA OLINDA DO MARANHAO (MA)";"MA";"NOVA OLINDA DO MARANHAO";23;13;1;37
2007;"OLHO D AGUA DAS CUNHAS (MA)";"MA";"OLHO D AGUA DAS CUNHAS";51;8;5;64
2007;"OLINDA NOVA DO MARANHAO (MA)";"MA";"OLINDA NOVA DO MARANHAO";8;1;0;9
2007;"PACO DO LUMIAR (MA)";"MA";"PACO DO LUMIAR";224;79;56;359
2007;"PALMEIRANDIA (MA)";"MA";"PALMEIRANDIA";7;1;4;12
2007;"PARAIBANO (MA)";"MA";"PARAIBANO";21;3;2;26
2007;"PARNARAMA (MA)";"MA";"PARNARAMA";15;1;0;16
2007;"PASSAGEM FRANCA (MA)";"MA";"PASSAGEM FRANCA";15;1;1;17
2007;"PASTOS BONS (MA)";"MA";"PASTOS BONS";33;2;1;36
2007;"PAULINO NEVES (MA)";"MA";"PAULINO NEVES";0;0;0;0
2007;"PAULO RAMOS (MA)";"MA";"PAULO RAMOS";38;3;0;41
2007;"PEDREIRAS (MA)";"MA";"PEDREIRAS";226;33;23;282
2007;"PEDRO DO ROSARIO (MA)";"MA";"PEDRO DO ROSARIO";11;1;1;13
2007;"PENALVA (MA)";"MA";"PENALVA";7;3;2;12
2007;"PERI MIRIM (MA)";"MA";"PERI MIRIM";13;5;4;22
2007;"PERITORO (MA)";"MA";"PERITORO";26;30;4;60
2007;"PINDARE MIRIM (MA)";"MA";"PINDARE MIRIM";72;3;13;88
2007;"PINHEIRO (MA)";"MA";"PINHEIRO";252;19;38;309
2007;"PIO XII (MA)";"MA";"PIO XII";65;3;1;69
2007;"PIRAPEMAS (MA)";"MA";"PIRAPEMAS";9;4;1;14
2007;"POCAO DE PEDRAS (MA)";"MA";"POCAO DE PEDRAS";32;7;3;42
2007;"PORTO FRANCO (MA)";"MA";"PORTO FRANCO";21;1;3;25
2007;"PORTO RICO DO MARANHAO (MA)";"MA";"PORTO RICO DO MARANHAO";2;0;1;3
2007;"PRESIDENTE DUTRA (MA)";"MA";"PRESIDENTE DUTRA";206;11;7;224
2007;"PRESIDENTE JUSCELINO (MA)";"MA";"PRESIDENTE JUSCELINO";5;1;2;8
2007;"PRESIDENTE MEDICI (MA)";"MA";"PRESIDENTE MEDICI";5;6;0;11
2007;"PRESIDENTE SARNEY (MA)";"MA";"PRESIDENTE SARNEY";2;0;1;3
2007;"PRESIDENTE VARGAS (MA)";"MA";"PRESIDENTE VARGAS";13;4;1;18
2007;"PRIMEIRA CRUZ (MA)";"MA";"PRIMEIRA CRUZ";0;0;0;0
2007;"RAPOSA (MA)";"MA";"RAPOSA";31;0;23;54
2007;"RIACHAO (MA)";"MA";"RIACHAO";23;1;2;26
2007;"RIBAMAR FIQUENE (MA)";"MA";"RIBAMAR FIQUENE";7;1;1;9
2007;"ROSARIO (MA)";"MA";"ROSARIO";122;12;22;156
2007;"SAMBAIBA (MA)";"MA";"SAMBAIBA";9;0;0;9
2007;"SANTA FILOMENA DO MARANHAO (MA)";"MA";"SANTA FILOMENA DO MARANHAO";4;3;0;7
2007;"SANTA HELENA (MA)";"MA";"SANTA HELENA";45;2;2;49
2007;"SANTA INES (MA)";"MA";"SANTA INES";411;100;65;576
2007;"SANTA LUZIA (MA)";"MA";"SANTA LUZIA";170;56;9;235
2007;"SANTA LUZIA DO PARUA (MA)";"MA";"SANTA LUZIA DO PARUA";69;8;2;79
2007;"SANTA QUITERIA DO MARANHAO (MA)";"MA";"SANTA QUITERIA DO MARANHAO";15;0;4;19
2007;"SANTA RITA (MA)";"MA";"SANTA RITA";72;5;3;80
2007;"SANTANA DO MARANHAO (MA)";"MA";"SANTANA DO MARANHAO";5;1;2;8
2007;"SANTO AMARO DO MARANHAO (MA)";"MA";"SANTO AMARO DO MARANHAO";0;3;0;3
2007;"SANTO ANTONIO DOS LOPES (MA)";"MA";"SANTO ANTONIO DOS LOPES";51;6;0;57
2007;"SAO BENEDITO DO RIO PRETO (MA)";"MA";"SAO BENEDITO DO RIO PRETO";9;7;1;17
2007;"SAO BENTO (MA)";"MA";"SAO BENTO";53;11;6;70
2007;"SAO BERNARDO (MA)";"MA";"SAO BERNARDO";40;0;6;46
2007;"SAO DOMINGOS DO AZEITAO (MA)";"MA";"SAO DOMINGOS DO AZEITAO";11;0;1;12
2007;"SAO DOMINGOS DO MARANHAO (MA)";"MA";"SAO DOMINGOS DO MARANHAO";91;2;1;94
2007;"SAO FELIX DE BALSAS (MA)";"MA";"SAO FELIX DE BALSAS";1;0;0;1
2007;"SAO FRANCISCO DO BREJAO (MA)";"MA";"SAO FRANCISCO DO BREJAO";30;1;2;33
2007;"SAO FRANCISCO DO MARANHAO (MA)";"MA";"SAO FRANCISCO DO MARANHAO";2;0;0;2
2007;"SAO JOAO BATISTA (MA)";"MA";"SAO JOAO BATISTA";20;3;3;26
2007;"SAO JOAO DO CARU (MA)";"MA";"SAO JOAO DO CARU";11;1;0;12
2007;"SAO JOAO DO PARAISO (MA)";"MA";"SAO JOAO DO PARAISO";2;0;1;3
2007;"SAO JOAO DO SOTER (MA)";"MA";"SAO JOAO DO SOTER";7;1;0;8
2007;"SAO JOAO DOS PATOS (MA)";"MA";"SAO JOAO DOS PATOS";89;1;3;93
2007;"SAO JOSE DE RIBAMAR (MA)";"MA";"SAO JOSE DE RIBAMAR";325;106;45;476
2007;"SAO JOSE DOS BASILIOS (MA)";"MA";"SAO JOSE DOS BASILIOS";7;1;2;10
2007;"SAO LUIS (MA)";"MA";"SAO LUIS";5334;912;2473;8719
2007;"SAO LUIS GONZAGA DO MARANHAO (MA)";"MA";"SAO LUIS GONZAGA DO MARANHAO";18;4;1;23
2007;"SAO MATEUS DO MARANHAO (MA)";"MA";"SAO MATEUS DO MARANHAO";68;36;14;118
2007;"SAO PEDRO DA AGUA BRANCA (MA)";"MA";"SAO PEDRO DA AGUA BRANCA";12;0;0;12
2007;"SAO PEDRO DOS CRENTES (MA)";"MA";"SAO PEDRO DOS CRENTES";3;1;0;4
2007;"SAO RAIMUNDO DAS MANGABEIRAS (MA)";"MA";"SAO RAIMUNDO DAS MANGABEIRAS";56;1;30;87
2007;"SAO RAIMUNDO DO DOCA BEZERRA (MA)";"MA";"SAO RAIMUNDO DO DOCA BEZERRA";11;0;0;11
2007;"SAO ROBERTO (MA)";"MA";"SAO ROBERTO";3;2;0;5
2007;"SAO VICENTE FERRER (MA)";"MA";"SAO VICENTE FERRER";14;2;4;20
2007;"SATUBINHA (MA)";"MA";"SATUBINHA";13;2;0;15
2007;"SENADOR ALEXANDRE COSTA (MA)";"MA";"SENADOR ALEXANDRE COSTA";13;2;1;16
2007;"SENADOR LA ROCQUE (MA)";"MA";"SENADOR LA ROCQUE";23;0;1;24
2007;"SERRANO DO MARANHAO (MA)";"MA";"SERRANO DO MARANHAO";1;0;1;2
2007;"SITIO NOVO (MA)";"MA";"SITIO NOVO";14;0;1;15
2007;"SUCUPIRA DO NORTE (MA)";"MA";"SUCUPIRA DO NORTE";12;1;1;14
2007;"SUCUPIRA DO RIACHAO (MA)";"MA";"SUCUPIRA DO RIACHAO";2;1;1;4
2007;"TASSO FRAGOSO (MA)";"MA";"TASSO FRAGOSO";19;1;1;21
2007;"TIMBIRAS (MA)";"MA";"TIMBIRAS";19;6;0;25
2007;"TIMON (MA)";"MA";"TIMON";361;25;25;411
2007;"TRIZIDELA DO VALE (MA)";"MA";"TRIZIDELA DO VALE";76;8;3;87
2007;"TUFILANDIA (MA)";"MA";"TUFILANDIA";3;4;0;7
2007;"TUNTUM (MA)";"MA";"TUNTUM";59;3;3;65
2007;"TURIACU (MA)";"MA";"TURIACU";14;1;4;19
2007;"TURILANDIA (MA)";"MA";"TURILANDIA";7;4;1;12
2007;"TUTOIA (MA)";"MA";"TUTOIA";16;2;4;22
2007;"URBANO SANTOS (MA)";"MA";"URBANO SANTOS";25;3;2;30
2007;"VARGEM GRANDE (MA)";"MA";"VARGEM GRANDE";68;2;2;72
2007;"VIANA (MA)";"MA";"VIANA";95;3;3;101
2007;"VILA NOVA DOS MARTIRIOS (MA)";"MA";"VILA NOVA DOS MARTIRIOS";5;1;0;6
2007;"VITORIA DO MEARIM (MA)";"MA";"VITORIA DO MEARIM";44;2;3;49
2007;"VITORINO FREIRE (MA)";"MA";"VITORINO FREIRE";96;7;2;105
2007;"ZE DOCA (MA)";"MA";"ZE DOCA";118;14;11;143
2007;"ABADIA DOS DOURADOS (MG)";"MG";"ABADIA DOS DOURADOS";77;22;4;103
2007;"ABAETE (MG)";"MG";"ABAETE";389;12;124;525
2007;"ABRE CAMPO (MG)";"MG";"ABRE CAMPO";111;10;37;158
2007;"ACAIACA (MG)";"MG";"ACAIACA";18;6;6;30
2007;"ACUCENA (MG)";"MG";"ACUCENA";25;4;22;51
2007;"AGUA BOA (MG)";"MG";"AGUA BOA";48;2;17;67
2007;"AGUA COMPRIDA (MG)";"MG";"AGUA COMPRIDA";33;7;6;46
2007;"AGUANIL (MG)";"MG";"AGUANIL";31;4;6;41
2007;"AGUAS FORMOSAS (MG)";"MG";"AGUAS FORMOSAS";62;11;15;88
2007;"AGUAS VERMELHAS (MG)";"MG";"AGUAS VERMELHAS";59;6;9;74
2007;"AIMORES (MG)";"MG";"AIMORES";157;10;20;187
2007;"AIURUOCA (MG)";"MG";"AIURUOCA";69;10;9;88
2007;"ALAGOA (MG)";"MG";"ALAGOA";22;0;9;31
2007;"ALBERTINA (MG)";"MG";"ALBERTINA";34;8;5;47
2007;"ALEM PARAIBA (MG)";"MG";"ALEM PARAIBA";1123;58;65;1246
2007;"ALFENAS (MG)";"MG";"ALFENAS";889;60;226;1175
2007;"ALFREDO VASCONCELOS (MG)";"MG";"ALFREDO VASCONCELOS";120;9;19;148
2007;"ALMENARA (MG)";"MG";"ALMENARA";161;24;63;248
2007;"ALPERCATA (MG)";"MG";"ALPERCATA";48;1;4;53
2007;"ALPINOPOLIS (MG)";"MG";"ALPINOPOLIS";358;15;23;396
2007;"ALTEROSA (MG)";"MG";"ALTEROSA";189;18;23;230
2007;"ALTO CAPARAO (MG)";"MG";"ALTO CAPARAO";46;4;3;53
2007;"ALTO JEQUITIBA (MG)";"MG";"ALTO JEQUITIBA";53;4;7;64
2007;"ALTO RIO DOCE (MG)";"MG";"ALTO RIO DOCE";83;6;15;104
2007;"ALVARENGA (MG)";"MG";"ALVARENGA";20;0;8;28
2007;"ALVINOPOLIS (MG)";"MG";"ALVINOPOLIS";116;15;15;146
2007;"ALVORADA DE MINAS (MG)";"MG";"ALVORADA DE MINAS";6;3;7;16
2007;"AMPARO DA SERRA (MG)";"MG";"AMPARO DA SERRA";28;4;17;49
2007;"ANDRADAS (MG)";"MG";"ANDRADAS";845;59;63;967
2007;"ANDRELANDIA (MG)";"MG";"ANDRELANDIA";106;23;8;137
2007;"ANGELANDIA (MG)";"MG";"ANGELANDIA";39;2;11;52
2007;"ANTONIO CARLOS (MG)";"MG";"ANTONIO CARLOS";119;9;19;147
2007;"ANTONIO DIAS (MG)";"MG";"ANTONIO DIAS";66;9;37;112
2007;"ANTONIO PRADO DE MINAS (MG)";"MG";"ANTONIO PRADO DE MINAS";9;0;4;13
2007;"ARACAI (MG)";"MG";"ARACAI";13;3;3;19
2007;"ARACITABA (MG)";"MG";"ARACITABA";7;2;1;10
2007;"ARACUAI (MG)";"MG";"ARACUAI";147;8;50;205
2007;"ARAGUARI (MG)";"MG";"ARAGUARI";1733;238;133;2104
2007;"ARANTINA (MG)";"MG";"ARANTINA";20;1;2;23
2007;"ARAPONGA (MG)";"MG";"ARAPONGA";43;4;7;54
2007;"ARAPORA (MG)";"MG";"ARAPORA";149;12;80;241
2007;"ARAPUA (MG)";"MG";"ARAPUA";35;1;11;47
2007;"ARAUJOS (MG)";"MG";"ARAUJOS";92;5;6;103
2007;"ARAXA (MG)";"MG";"ARAXA";1275;101;216;1592
2007;"ARCEBURGO (MG)";"MG";"ARCEBURGO";83;16;29;128
2007;"ARCOS (MG)";"MG";"ARCOS";886;54;203;1143
2007;"AREADO (MG)";"MG";"AREADO";186;12;66;264
2007;"ARGIRITA (MG)";"MG";"ARGIRITA";17;3;2;22
2007;"ARICANDUVA (MG)";"MG";"ARICANDUVA";10;2;7;19
2007;"ARINOS (MG)";"MG";"ARINOS";126;9;34;169
2007;"ASTOLFO DUTRA (MG)";"MG";"ASTOLFO DUTRA";187;8;17;212
2007;"ATALEIA (MG)";"MG";"ATALEIA";58;8;17;83
2007;"AUGUSTO DE LIMA (MG)";"MG";"AUGUSTO DE LIMA";22;2;11;35
2007;"BAEPENDI (MG)";"MG";"BAEPENDI";295;24;18;337
2007;"BALDIM (MG)";"MG";"BALDIM";98;5;7;110
2007;"BAMBUI (MG)";"MG";"BAMBUI";348;18;72;438
2007;"BANDEIRA (MG)";"MG";"BANDEIRA";1;1;2;4
2007;"BANDEIRA DO SUL (MG)";"MG";"BANDEIRA DO SUL";127;15;6;148
2007;"BARAO DE COCAIS (MG)";"MG";"BARAO DE COCAIS";373;42;49;464
2007;"BARAO DE MONTE ALTO (MG)";"MG";"BARAO DE MONTE ALTO";16;2;6;24
2007;"BARBACENA (MG)";"MG";"BARBACENA";1282;221;166;1669
2007;"BARRA LONGA (MG)";"MG";"BARRA LONGA";44;5;5;54
2007;"BARROSO (MG)";"MG";"BARROSO";340;19;17;376
2007;"BELA VISTA DE MINAS (MG)";"MG";"BELA VISTA DE MINAS";114;10;7;131
2007;"BELMIRO BRAGA (MG)";"MG";"BELMIRO BRAGA";34;7;3;44
2007;"BELO HORIZONTE (MG)";"MG";"BELO HORIZONTE";26547;3887;7039;37473
2007;"BELO ORIENTE (MG)";"MG";"BELO ORIENTE";220;42;69;331
2007;"BELO VALE (MG)";"MG";"BELO VALE";80;10;17;107
2007;"BERILO (MG)";"MG";"BERILO";42;5;22;69
2007;"BERIZAL (MG)";"MG";"BERIZAL";15;2;5;22
2007;"BERTOPOLIS (MG)";"MG";"BERTOPOLIS";6;1;1;8
2007;"BETIM (MG)";"MG";"BETIM";3252;396;893;4541
2007;"BIAS FORTES (MG)";"MG";"BIAS FORTES";20;4;3;27
2007;"BICAS (MG)";"MG";"BICAS";192;24;19;235
2007;"BIQUINHAS (MG)";"MG";"BIQUINHAS";34;8;2;44
2007;"BOA ESPERANCA (MG)";"MG";"BOA ESPERANCA";496;31;114;641
2007;"BOCAINA DE MINAS (MG)";"MG";"BOCAINA DE MINAS";41;6;6;53
2007;"BOCAIUVA (MG)";"MG";"BOCAIUVA";306;23;103;432
2007;"BOM DESPACHO (MG)";"MG";"BOM DESPACHO";820;36;225;1081
2007;"BOM JARDIM DE MINAS (MG)";"MG";"BOM JARDIM DE MINAS";75;5;10;90
2007;"BOM JESUS DA PENHA (MG)";"MG";"BOM JESUS DA PENHA";92;4;6;102
2007;"BOM JESUS DO AMPARO (MG)";"MG";"BOM JESUS DO AMPARO";48;6;5;59
2007;"BOM JESUS DO GALHO (MG)";"MG";"BOM JESUS DO GALHO";71;5;10;86
2007;"BOM REPOUSO (MG)";"MG";"BOM REPOUSO";143;11;4;158
2007;"BOM SUCESSO (MG)";"MG";"BOM SUCESSO";193;11;35;239
2007;"BONFIM (MG)";"MG";"BONFIM";83;14;11;108
2007;"BONFINOPOLIS DE MINAS (MG)";"MG";"BONFINOPOLIS DE MINAS";68;1;21;90
2007;"BONITO DE MINAS (MG)";"MG";"BONITO DE MINAS";15;3;13;31
2007;"BORDA DA MATA (MG)";"MG";"BORDA DA MATA";225;14;53;292
2007;"BOTELHOS (MG)";"MG";"BOTELHOS";221;32;21;274
2007;"BOTUMIRIM (MG)";"MG";"BOTUMIRIM";12;1;5;18
2007;"BRAS PIRES (MG)";"MG";"BRAS PIRES";28;5;6;39
2007;"BRASILANDIA DE MINAS (MG)";"MG";"BRASILANDIA DE MINAS";164;6;60;230
2007;"BRASILIA DE MINAS (MG)";"MG";"BRASILIA DE MINAS";131;5;60;196
2007;"BRASOPOLIS (MG)";"MG";"BRASOPOLIS";166;21;23;210
2007;"BRAUNAS (MG)";"MG";"BRAUNAS";10;5;11;26
2007;"BRUMADINHO (MG)";"MG";"BRUMADINHO";687;78;203;968
2007;"BUENO BRANDAO (MG)";"MG";"BUENO BRANDAO";145;21;18;184
2007;"BUENOPOLIS (MG)";"MG";"BUENOPOLIS";83;3;23;109
2007;"BUGRE (MG)";"MG";"BUGRE";17;1;3;21
2007;"BURITIS (MG)";"MG";"BURITIS";223;6;71;300
2007;"BURITIZEIRO (MG)";"MG";"BURITIZEIRO";163;1;56;220
2007;"CABECEIRA GRANDE (MG)";"MG";"CABECEIRA GRANDE";23;3;9;35
2007;"CABO VERDE (MG)";"MG";"CABO VERDE";163;11;17;191
2007;"CACHOEIRA DA PRATA (MG)";"MG";"CACHOEIRA DA PRATA";39;3;2;44
2007;"CACHOEIRA DE MINAS (MG)";"MG";"CACHOEIRA DE MINAS";96;16;9;121
2007;"CACHOEIRA DE PAJEU (MG)";"MG";"CACHOEIRA DE PAJEU";29;6;12;47
2007;"CACHOEIRA DOURADA (MG)";"MG";"CACHOEIRA DOURADA";12;7;2;21
2007;"CAETANOPOLIS (MG)";"MG";"CAETANOPOLIS";93;13;30;136
2007;"CAETE (MG)";"MG";"CAETE";416;49;61;526
2007;"CAIANA (MG)";"MG";"CAIANA";26;4;6;36
2007;"CAJURI (MG)";"MG";"CAJURI";37;5;6;48
2007;"CALDAS (MG)";"MG";"CALDAS";223;13;26;262
2007;"CAMACHO (MG)";"MG";"CAMACHO";51;3;5;59
2007;"CAMANDUCAIA (MG)";"MG";"CAMANDUCAIA";414;29;32;475
2007;"CAMBUI (MG)";"MG";"CAMBUI";412;26;81;519
2007;"CAMBUQUIRA (MG)";"MG";"CAMBUQUIRA";100;16;11;127
2007;"CAMPANARIO (MG)";"MG";"CAMPANARIO";10;6;4;20
2007;"CAMPANHA (MG)";"MG";"CAMPANHA";191;17;20;228
2007;"CAMPESTRE (MG)";"MG";"CAMPESTRE";378;24;36;438
2007;"CAMPINA VERDE (MG)";"MG";"CAMPINA VERDE";232;17;32;281
2007;"CAMPO AZUL (MG)";"MG";"CAMPO AZUL";3;2;3;8
2007;"CAMPO BELO (MG)";"MG";"CAMPO BELO";976;45;103;1124
2007;"CAMPO DO MEIO (MG)";"MG";"CAMPO DO MEIO";106;12;47;165
2007;"CAMPO FLORIDO (MG)";"MG";"CAMPO FLORIDO";98;17;42;157
2007;"CAMPOS ALTOS (MG)";"MG";"CAMPOS ALTOS";273;13;45;331
2007;"CAMPOS GERAIS (MG)";"MG";"CAMPOS GERAIS";260;9;47;316
2007;"CANA VERDE (MG)";"MG";"CANA VERDE";51;5;6;62
2007;"CANAA (MG)";"MG";"CANAA";48;4;8;60
2007;"CANAPOLIS (MG)";"MG";"CANAPOLIS";167;7;95;269
2007;"CANDEIAS (MG)";"MG";"CANDEIAS";207;12;24;243
2007;"CANTAGALO (MG)";"MG";"CANTAGALO";12;1;6;19
2007;"CAPARAO (MG)";"MG";"CAPARAO";41;2;3;46
2007;"CAPELA NOVA (MG)";"MG";"CAPELA NOVA";12;11;3;26
2007;"CAPELINHA (MG)";"MG";"CAPELINHA";496;19;117;632
2007;"CAPETINGA (MG)";"MG";"CAPETINGA";147;8;24;179
2007;"CAPIM BRANCO (MG)";"MG";"CAPIM BRANCO";49;9;12;70
2007;"CAPINOPOLIS (MG)";"MG";"CAPINOPOLIS";212;19;57;288
2007;"CAPITAO ANDRADE (MG)";"MG";"CAPITAO ANDRADE";20;1;2;23
2007;"CAPITAO ENEAS (MG)";"MG";"CAPITAO ENEAS";46;2;16;64
2007;"CAPITOLIO (MG)";"MG";"CAPITOLIO";122;12;13;147
2007;"CAPUTIRA (MG)";"MG";"CAPUTIRA";93;1;19;113
2007;"CARAI (MG)";"MG";"CARAI";39;23;26;88
2007;"CARANAIBA (MG)";"MG";"CARANAIBA";14;4;8;26
2007;"CARANDAI (MG)";"MG";"CARANDAI";408;25;81;514
2007;"CARANGOLA (MG)";"MG";"CARANGOLA";305;27;41;373
2007;"CARATINGA (MG)";"MG";"CARATINGA";943;41;908;1892
2007;"CARBONITA (MG)";"MG";"CARBONITA";151;6;32;189
2007;"CAREACU (MG)";"MG";"CAREACU";65;6;3;74
2007;"CARLOS CHAGAS (MG)";"MG";"CARLOS CHAGAS";112;22;32;166
2007;"CARMESIA (MG)";"MG";"CARMESIA";45;0;1031;1076
2007;"CARMO DA CACHOEIRA (MG)";"MG";"CARMO DA CACHOEIRA";131;18;39;188
2007;"CARMO DA MATA (MG)";"MG";"CARMO DA MATA";112;10;25;147
2007;"CARMO DE MINAS (MG)";"MG";"CARMO DE MINAS";126;19;13;158
2007;"CARMO DO CAJURU (MG)";"MG";"CARMO DO CAJURU";255;19;52;326
2007;"CARMO DO PARANAIBA (MG)";"MG";"CARMO DO PARANAIBA";484;31;80;595
2007;"CARMO DO RIO CLARO (MG)";"MG";"CARMO DO RIO CLARO";255;14;55;324
2007;"CARMOPOLIS DE MINAS (MG)";"MG";"CARMOPOLIS DE MINAS";429;16;22;467
2007;"CARNEIRINHO (MG)";"MG";"CARNEIRINHO";139;22;56;217
2007;"CARRANCAS (MG)";"MG";"CARRANCAS";37;7;10;54
2007;"CARVALHOPOLIS (MG)";"MG";"CARVALHOPOLIS";30;10;4;44
2007;"CARVALHOS (MG)";"MG";"CARVALHOS";40;6;5;51
2007;"CASA GRANDE (MG)";"MG";"CASA GRANDE";20;2;1;23
2007;"CASCALHO RICO (MG)";"MG";"CASCALHO RICO";47;15;3;65
2007;"CASSIA (MG)";"MG";"CASSIA";349;18;26;393
2007;"CATAGUASES (MG)";"MG";"CATAGUASES";585;57;128;770
2007;"CATAS ALTAS (MG)";"MG";"CATAS ALTAS";112;7;5;124
2007;"CATAS ALTAS DA NORUEGA (MG)";"MG";"CATAS ALTAS DA NORUEGA";28;2;5;35
2007;"CATUJI (MG)";"MG";"CATUJI";27;7;8;42
2007;"CATUTI (MG)";"MG";"CATUTI";10;6;11;27
2007;"CAXAMBU (MG)";"MG";"CAXAMBU";196;24;17;237
2007;"CEDRO DO ABAETE (MG)";"MG";"CEDRO DO ABAETE";10;1;1;12
2007;"CENTRAL DE MINAS (MG)";"MG";"CENTRAL DE MINAS";67;5;9;81
2007;"CENTRALINA (MG)";"MG";"CENTRALINA";84;2;14;100
2007;"CHACARA (MG)";"MG";"CHACARA";23;5;2;30
2007;"CHALE (MG)";"MG";"CHALE";33;6;8;47
2007;"CHAPADA DO NORTE (MG)";"MG";"CHAPADA DO NORTE";27;6;13;46
2007;"CHAPADA GAUCHA (MG)";"MG";"CHAPADA GAUCHA";48;4;7;59
2007;"CHIADOR (MG)";"MG";"CHIADOR";32;7;3;42
2007;"CIPOTANEA (MG)";"MG";"CIPOTANEA";27;1;6;34
2007;"CLARAVAL (MG)";"MG";"CLARAVAL";157;4;33;194
2007;"CLARO DOS POCOES (MG)";"MG";"CLARO DOS POCOES";23;1;15;39
2007;"CLAUDIO (MG)";"MG";"CLAUDIO";601;24;45;670
2007;"COIMBRA (MG)";"MG";"COIMBRA";79;2;8;89
2007;"COLUNA (MG)";"MG";"COLUNA";25;1;10;36
2007;"COMENDADOR GOMES (MG)";"MG";"COMENDADOR GOMES";30;4;5;39
2007;"COMERCINHO (MG)";"MG";"COMERCINHO";16;4;9;29
2007;"CONCEICAO DA APARECIDA (MG)";"MG";"CONCEICAO DA APARECIDA";109;4;7;120
2007;"CONCEICAO DA BARRA DE MINAS (MG)";"MG";"CONCEICAO DA BARRA DE MINAS";28;7;4;39
2007;"CONCEICAO DAS ALAGOAS (MG)";"MG";"CONCEICAO DAS ALAGOAS";395;12;82;489
2007;"CONCEICAO DAS PEDRAS (MG)";"MG";"CONCEICAO DAS PEDRAS";16;6;2;24
2007;"CONCEICAO DE IPANEMA (MG)";"MG";"CONCEICAO DE IPANEMA";22;3;2;27
2007;"CONCEICAO DO MATO DENTRO (MG)";"MG";"CONCEICAO DO MATO DENTRO";77;8;83;168
2007;"CONCEICAO DO PARA (MG)";"MG";"CONCEICAO DO PARA";63;10;13;86
2007;"CONCEICAO DO RIO VERDE (MG)";"MG";"CONCEICAO DO RIO VERDE";184;26;14;224
2007;"CONCEICAO DOS OUROS (MG)";"MG";"CONCEICAO DOS OUROS";219;21;5;245
2007;"CONEGO MARINHO (MG)";"MG";"CONEGO MARINHO";7;2;7;16
2007;"CONFINS (MG)";"MG";"CONFINS";74;13;8;95
2007;"CONGONHAL (MG)";"MG";"CONGONHAL";164;7;12;183
2007;"CONGONHAS (MG)";"MG";"CONGONHAS";671;80;86;837
2007;"CONGONHAS DO NORTE (MG)";"MG";"CONGONHAS DO NORTE";24;3;3;30
2007;"CONQUISTA (MG)";"MG";"CONQUISTA";151;15;26;192
2007;"CONSELHEIRO LAFAIETE (MG)";"MG";"CONSELHEIRO LAFAIETE";969;163;435;1567
2007;"CONSELHEIRO PENA (MG)";"MG";"CONSELHEIRO PENA";163;4;44;211
2007;"CONSOLACAO (MG)";"MG";"CONSOLACAO";9;5;0;14
2007;"CONTAGEM (MG)";"MG";"CONTAGEM";9582;1002;1909;12493
2007;"COQUEIRAL (MG)";"MG";"COQUEIRAL";77;7;10;94
2007;"CORACAO DE JESUS (MG)";"MG";"CORACAO DE JESUS";118;2;69;189
2007;"CORDISBURGO (MG)";"MG";"CORDISBURGO";65;7;7;79
2007;"CORDISLANDIA (MG)";"MG";"CORDISLANDIA";42;3;2;47
2007;"CORINTO (MG)";"MG";"CORINTO";227;3;47;277
2007;"COROACI (MG)";"MG";"COROACI";34;4;8;46
2007;"COROMANDEL (MG)";"MG";"COROMANDEL";468;32;73;573
2007;"CORONEL FABRICIANO (MG)";"MG";"CORONEL FABRICIANO";893;116;406;1415
2007;"CORONEL MURTA (MG)";"MG";"CORONEL MURTA";12;0;8;20
2007;"CORONEL PACHECO (MG)";"MG";"CORONEL PACHECO";29;6;6;41
2007;"CORONEL XAVIER CHAVES (MG)";"MG";"CORONEL XAVIER CHAVES";67;2;2;71
2007;"CORREGO DANTA (MG)";"MG";"CORREGO DANTA";22;3;7;32
2007;"CORREGO DO BOM JESUS (MG)";"MG";"CORREGO DO BOM JESUS";26;6;6;38
2007;"CORREGO FUNDO (MG)";"MG";"CORREGO FUNDO";279;11;15;305
2007;"CORREGO NOVO (MG)";"MG";"CORREGO NOVO";9;3;6;18
2007;"COUTO DE MAGALHAES DE MINAS (MG)";"MG";"COUTO DE MAGALHAES DE MINAS";36;1;8;45
2007;"CRISOLITA (MG)";"MG";"CRISOLITA";4;5;8;17
2007;"CRISTAIS (MG)";"MG";"CRISTAIS";116;4;10;130
2007;"CRISTALIA (MG)";"MG";"CRISTALIA";15;1;12;28
2007;"CRISTIANO OTONI (MG)";"MG";"CRISTIANO OTONI";65;6;6;77
2007;"CRISTINA (MG)";"MG";"CRISTINA";73;16;6;95
2007;"CRUCILANDIA (MG)";"MG";"CRUCILANDIA";101;4;8;113
2007;"CRUZEIRO DA FORTALEZA (MG)";"MG";"CRUZEIRO DA FORTALEZA";49;5;7;61
2007;"CRUZILIA (MG)";"MG";"CRUZILIA";259;16;17;292
2007;"CUPARAQUE (MG)";"MG";"CUPARAQUE";26;4;3;33
2007;"CURRAL DE DENTRO (MG)";"MG";"CURRAL DE DENTRO";30;5;7;42
2007;"CURVELO (MG)";"MG";"CURVELO";915;25;1488;2428
2007;"DATAS (MG)";"MG";"DATAS";20;4;10;34
2007;"DELFIM MOREIRA (MG)";"MG";"DELFIM MOREIRA";71;5;15;91
2007;"DELFINOPOLIS (MG)";"MG";"DELFINOPOLIS";66;11;8;85
2007;"DELTA (MG)";"MG";"DELTA";385;21;112;518
2007;"DESCOBERTO (MG)";"MG";"DESCOBERTO";25;6;1;32
2007;"DESTERRO DE ENTRE RIOS (MG)";"MG";"DESTERRO DE ENTRE RIOS";84;9;15;108
2007;"DESTERRO DO MELO (MG)";"MG";"DESTERRO DO MELO";26;4;7;37
2007;"DIAMANTINA (MG)";"MG";"DIAMANTINA";246;45;263;554
2007;"DIOGO DE VASCONCELOS (MG)";"MG";"DIOGO DE VASCONCELOS";15;2;7;24
2007;"DIONISIO (MG)";"MG";"DIONISIO";35;3;10;48
2007;"DIVINESIA (MG)";"MG";"DIVINESIA";43;8;4;55
2007;"DIVINO (MG)";"MG";"DIVINO";195;13;36;244
2007;"DIVINO DAS LARANJEIRAS (MG)";"MG";"DIVINO DAS LARANJEIRAS";26;0;4;30
2007;"DIVINOLANDIA DE MINAS (MG)";"MG";"DIVINOLANDIA DE MINAS";43;5;14;62
2007;"DIVINOPOLIS (MG)";"MG";"DIVINOPOLIS";2792;195;611;3598
2007;"DIVISA ALEGRE (MG)";"MG";"DIVISA ALEGRE";29;2;5;36
2007;"DIVISA NOVA (MG)";"MG";"DIVISA NOVA";49;10;11;70
2007;"DIVISOPOLIS (MG)";"MG";"DIVISOPOLIS";12;9;4;25
2007;"DOM BOSCO (MG)";"MG";"DOM BOSCO";15;1;9;25
2007;"DOM CAVATI (MG)";"MG";"DOM CAVATI";98;2;5;105
2007;"DOM JOAQUIM (MG)";"MG";"DOM JOAQUIM";4;3;4;11
2007;"DOM SILVERIO (MG)";"MG";"DOM SILVERIO";41;7;4;52
2007;"DOM VICOSO (MG)";"MG";"DOM VICOSO";24;10;4;38
2007;"DONA EUZEBIA (MG)";"MG";"DONA EUZEBIA";242;4;2;248
2007;"DORES DE CAMPOS (MG)";"MG";"DORES DE CAMPOS";57;4;20;81
2007;"DORES DE GUANHAES (MG)";"MG";"DORES DE GUANHAES";37;2;18;57
2007;"DORES DO INDAIA (MG)";"MG";"DORES DO INDAIA";180;18;18;216
2007;"DORES DO TURVO (MG)";"MG";"DORES DO TURVO";31;3;12;46
2007;"DORESOPOLIS (MG)";"MG";"DORESOPOLIS";10;6;1;17
2007;"DOURADOQUARA (MG)";"MG";"DOURADOQUARA";27;8;1;36
2007;"DURANDE (MG)";"MG";"DURANDE";72;3;8;83
2007;"ELOI MENDES (MG)";"MG";"ELOI MENDES";447;34;23;504
2007;"ENGENHEIRO CALDAS (MG)";"MG";"ENGENHEIRO CALDAS";99;7;5;111
2007;"ENGENHEIRO NAVARRO (MG)";"MG";"ENGENHEIRO NAVARRO";33;1;14;48
2007;"ENTRE FOLHAS (MG)";"MG";"ENTRE FOLHAS";53;2;3;58
2007;"ENTRE RIOS DE MINAS (MG)";"MG";"ENTRE RIOS DE MINAS";233;13;50;296
2007;"ERVALIA (MG)";"MG";"ERVALIA";238;5;22;265
2007;"ESMERALDAS (MG)";"MG";"ESMERALDAS";312;24;194;530
2007;"ESPERA FELIZ (MG)";"MG";"ESPERA FELIZ";241;23;28;292
2007;"ESPINOSA (MG)";"MG";"ESPINOSA";257;9;36;302
2007;"ESPIRITO SANTO DO DOURADO (MG)";"MG";"ESPIRITO SANTO DO DOURADO";56;2;4;62
2007;"ESTIVA (MG)";"MG";"ESTIVA";226;14;17;257
2007;"ESTRELA DALVA (MG)";"MG";"ESTRELA DALVA";18;3;0;21
2007;"ESTRELA DO INDAIA (MG)";"MG";"ESTRELA DO INDAIA";32;2;2;36
2007;"ESTRELA DO SUL (MG)";"MG";"ESTRELA DO SUL";78;5;14;97
2007;"EUGENOPOLIS (MG)";"MG";"EUGENOPOLIS";57;10;16;83
2007;"EWBANK DA CAMARA (MG)";"MG";"EWBANK DA CAMARA";35;1;4;40
2007;"EXTREMA (MG)";"MG";"EXTREMA";370;49;43;462
2007;"FAMA (MG)";"MG";"FAMA";9;9;1;19
2007;"FARIA LEMOS (MG)";"MG";"FARIA LEMOS";21;6;0;27
2007;"FELICIO DOS SANTOS (MG)";"MG";"FELICIO DOS SANTOS";14;6;10;30
2007;"FELISBURGO (MG)";"MG";"FELISBURGO";11;4;5;20
2007;"FELIXLANDIA (MG)";"MG";"FELIXLANDIA";175;6;35;216
2007;"FERNANDES TOURINHO (MG)";"MG";"FERNANDES TOURINHO";10;7;7;24
2007;"FERROS (MG)";"MG";"FERROS";72;5;32;109
2007;"FERVEDOURO (MG)";"MG";"FERVEDOURO";77;6;7;90
2007;"FLORESTAL (MG)";"MG";"FLORESTAL";42;7;12;61
2007;"FORMIGA (MG)";"MG";"FORMIGA";1281;91;175;1547
2007;"FORMOSO (MG)";"MG";"FORMOSO";23;1;17;41
2007;"FORTALEZA DE MINAS (MG)";"MG";"FORTALEZA DE MINAS";48;13;4;65
2007;"FORTUNA DE MINAS (MG)";"MG";"FORTUNA DE MINAS";20;2;6;28
2007;"FRANCISCO BADARO (MG)";"MG";"FRANCISCO BADARO";25;2;13;40
2007;"FRANCISCO DUMONT (MG)";"MG";"FRANCISCO DUMONT";35;2;17;54
2007;"FRANCISCO SA (MG)";"MG";"FRANCISCO SA";98;8;49;155
2007;"FRANCISCOPOLIS (MG)";"MG";"FRANCISCOPOLIS";10;2;7;19
2007;"FREI GASPAR (MG)";"MG";"FREI GASPAR";13;5;5;23
2007;"FREI INOCENCIO (MG)";"MG";"FREI INOCENCIO";89;11;15;115
2007;"FREI LAGONEGRO (MG)";"MG";"FREI LAGONEGRO";2;4;3;9
2007;"FRONTEIRA (MG)";"MG";"FRONTEIRA";221;21;65;307
2007;"FRONTEIRA DOS VALES (MG)";"MG";"FRONTEIRA DOS VALES";6;3;0;9
2007;"FRUTA DE LEITE (MG)";"MG";"FRUTA DE LEITE";18;1;17;36
2007;"FRUTAL (MG)";"MG";"FRUTAL";1253;90;143;1486
2007;"FUNILANDIA (MG)";"MG";"FUNILANDIA";24;3;6;33
2007;"GALILEIA (MG)";"MG";"GALILEIA";60;1;6;67
2007;"GAMELEIRAS (MG)";"MG";"GAMELEIRAS";24;2;8;34
2007;"GLAUCILANDIA (MG)";"MG";"GLAUCILANDIA";0;2;3;5
2007;"GOIABEIRA (MG)";"MG";"GOIABEIRA";19;4;2;25
2007;"GOIANA (MG)";"MG";"GOIANA";15;2;4;21
2007;"GONCALVES (MG)";"MG";"GONCALVES";76;13;3;92
2007;"GONZAGA (MG)";"MG";"GONZAGA";21;4;9;34
2007;"GOUVEA (MG)";"MG";"GOUVEA";118;6;19;143
2007;"GOVERNADOR VALADARES (MG)";"MG";"GOVERNADOR VALADARES";2767;206;299;3272
2007;"GRAO MOGOL (MG)";"MG";"GRAO MOGOL";35;2;54;91
2007;"GRUPIARA (MG)";"MG";"GRUPIARA";9;0;2;11
2007;"GUANHAES (MG)";"MG";"GUANHAES";354;25;71;450
2007;"GUAPE (MG)";"MG";"GUAPE";130;12;39;181
2007;"GUARACIABA (MG)";"MG";"GUARACIABA";49;9;22;80
2007;"GUARACIAMA (MG)";"MG";"GUARACIAMA";20;3;15;38
2007;"GUARANESIA (MG)";"MG";"GUARANESIA";321;29;68;418
2007;"GUARANI (MG)";"MG";"GUARANI";83;8;7;98
2007;"GUARARA (MG)";"MG";"GUARARA";40;8;2;50
2007;"GUARDA MOR (MG)";"MG";"GUARDA MOR";72;10;12;94
2007;"GUAXUPE (MG)";"MG";"GUAXUPE";757;48;137;942
2007;"GUIDOVAL (MG)";"MG";"GUIDOVAL";97;1;3;101
2007;"GUIMARANIA (MG)";"MG";"GUIMARANIA";114;3;16;133
2007;"GUIRICEMA (MG)";"MG";"GUIRICEMA";170;6;15;191
2007;"GURINHATA (MG)";"MG";"GURINHATA";69;7;17;93
2007;"HELIODORA (MG)";"MG";"HELIODORA";65;6;7;78
2007;"IAPU (MG)";"MG";"IAPU";97;11;15;123
2007;"IBERTIOGA (MG)";"MG";"IBERTIOGA";31;7;2;40
2007;"IBIA (MG)";"MG";"IBIA";333;27;73;433
2007;"IBIAI (MG)";"MG";"IBIAI";41;2;5;48
2007;"IBIRACATU (MG)";"MG";"IBIRACATU";6;3;6;15
2007;"IBIRACI (MG)";"MG";"IBIRACI";324;22;24;370
2007;"IBIRITE (MG)";"MG";"IBIRITE";1021;122;211;1354
2007;"IBITIURA DE MINAS (MG)";"MG";"IBITIURA DE MINAS";66;2;3;71
2007;"IBITURUNA (MG)";"MG";"IBITURUNA";29;5;1;35
2007;"ICARAI DE MINAS (MG)";"MG";"ICARAI DE MINAS";14;4;2;20
2007;"IGARAPE (MG)";"MG";"IGARAPE";494;42;92;628
2007;"IGARATINGA (MG)";"MG";"IGARATINGA";320;3;14;337
2007;"IGUATAMA (MG)";"MG";"IGUATAMA";100;3;15;118
2007;"IJACI (MG)";"MG";"IJACI";81;4;10;95
2007;"ILICINEA (MG)";"MG";"ILICINEA";160;5;23;188
2007;"IMBE DE MINAS (MG)";"MG";"IMBE DE MINAS";30;2;5;37
2007;"INCONFIDENTES (MG)";"MG";"INCONFIDENTES";70;10;11;91
2007;"INDAIABIRA (MG)";"MG";"INDAIABIRA";27;4;14;45
2007;"INDIANOPOLIS (MG)";"MG";"INDIANOPOLIS";45;26;10;81
2007;"INGAI (MG)";"MG";"INGAI";17;8;4;29
2007;"INHAPIM (MG)";"MG";"INHAPIM";253;10;37;300
2007;"INHAUMA (MG)";"MG";"INHAUMA";64;3;11;78
2007;"INIMUTABA (MG)";"MG";"INIMUTABA";26;2;3;31
2007;"IPABA (MG)";"MG";"IPABA";59;9;18;86
2007;"IPANEMA (MG)";"MG";"IPANEMA";163;14;20;197
2007;"IPATINGA (MG)";"MG";"IPATINGA";2431;369;488;3288
2007;"IPIACU (MG)";"MG";"IPIACU";37;1;6;44
2007;"IPUIUNA (MG)";"MG";"IPUIUNA";294;13;10;317
2007;"IRAI DE MINAS (MG)";"MG";"IRAI DE MINAS";147;13;20;180
2007;"ITABIRA (MG)";"MG";"ITABIRA";1089;177;338;1604
2007;"ITABIRINHA DE MANTENA (MG)";"MG";"ITABIRINHA DE MANTENA";105;0;24;129
2007;"ITABIRITO (MG)";"MG";"ITABIRITO";692;119;212;1023
2007;"ITACAMBIRA (MG)";"MG";"ITACAMBIRA";9;0;5;14
2007;"ITACARAMBI (MG)";"MG";"ITACARAMBI";67;4;24;95
2007;"ITAGUARA (MG)";"MG";"ITAGUARA";306;8;31;345
2007;"ITAIPE (MG)";"MG";"ITAIPE";44;2;17;63
2007;"ITAJUBA (MG)";"MG";"ITAJUBA";747;72;90;909
2007;"ITAMARANDIBA (MG)";"MG";"ITAMARANDIBA";459;16;77;552
2007;"ITAMARATI DE MINAS (MG)";"MG";"ITAMARATI DE MINAS";78;5;11;94
2007;"ITAMBACURI (MG)";"MG";"ITAMBACURI";137;10;27;174
2007;"ITAMBE DO MATO DENTRO (MG)";"MG";"ITAMBE DO MATO DENTRO";13;4;2;19
2007;"ITAMOGI (MG)";"MG";"ITAMOGI";158;12;17;187
2007;"ITAMONTE (MG)";"MG";"ITAMONTE";265;20;23;308
2007;"ITANHANDU (MG)";"MG";"ITANHANDU";251;18;16;285
2007;"ITANHOMI (MG)";"MG";"ITANHOMI";82;10;13;105
2007;"ITAOBIM (MG)";"MG";"ITAOBIM";177;15;24;216
2007;"ITAPAGIPE (MG)";"MG";"ITAPAGIPE";194;8;23;225
2007;"ITAPECERICA (MG)";"MG";"ITAPECERICA";258;23;49;330
2007;"ITAPEVA (MG)";"MG";"ITAPEVA";202;9;8;219
2007;"ITATIAIUCU (MG)";"MG";"ITATIAIUCU";219;2;25;246
2007;"ITAU DE MINAS (MG)";"MG";"ITAU DE MINAS";231;17;29;277
2007;"ITAUNA (MG)";"MG";"ITAUNA";1152;144;207;1503
2007;"ITAVERAVA (MG)";"MG";"ITAVERAVA";29;0;7;36
2007;"ITINGA (MG)";"MG";"ITINGA";42;5;20;67
2007;"ITUETA (MG)";"MG";"ITUETA";38;1;10;49
2007;"ITUIUTABA (MG)";"MG";"ITUIUTABA";1095;128;194;1417
2007;"ITUMIRIM (MG)";"MG";"ITUMIRIM";46;12;3;61
2007;"ITURAMA (MG)";"MG";"ITURAMA";625;37;183;845
2007;"ITUTINGA (MG)";"MG";"ITUTINGA";53;19;0;72
2007;"JABOTICATUBAS (MG)";"MG";"JABOTICATUBAS";144;7;41;192
2007;"JACINTO (MG)";"MG";"JACINTO";15;4;13;32
2007;"JACUI (MG)";"MG";"JACUI";99;16;17;132
2007;"HARMONIA (RS)";"RS";"HARMONIA";182;5;9;196
2007;"HERVAL (RS)";"RS";"HERVAL";95;3;7;105
2007;"HERVEIRAS (RS)";"RS";"HERVEIRAS";41;2;2;45
2007;"HORIZONTINA (RS)";"RS";"HORIZONTINA";281;31;53;365
2007;"HULHA NEGRA (RS)";"RS";"HULHA NEGRA";29;8;23;60
2007;"HUMAITA (RS)";"RS";"HUMAITA";87;2;8;97
2007;"IBARAMA (RS)";"RS";"IBARAMA";88;2;14;104
2007;"IBIACA (RS)";"RS";"IBIACA";217;5;18;240
2007;"IBIRAIARAS (RS)";"RS";"IBIRAIARAS";388;5;24;417
2007;"IBIRAPUITA (RS)";"RS";"IBIRAPUITA";100;3;19;122
2007;"IBIRUBA (RS)";"RS";"IBIRUBA";746;32;52;830
2007;"IGREJINHA (RS)";"RS";"IGREJINHA";345;32;78;455
2007;"IJUI (RS)";"RS";"IJUI";1601;87;119;1807
2007;"ILOPOLIS (RS)";"RS";"ILOPOLIS";141;9;7;157
2007;"IMBE (RS)";"RS";"IMBE";175;18;41;234
2007;"IMIGRANTE (RS)";"RS";"IMIGRANTE";80;13;22;115
2007;"INDEPENDENCIA (RS)";"RS";"INDEPENDENCIA";155;18;29;202
2007;"INHACORA (RS)";"RS";"INHACORA";57;5;5;67
2007;"IPE (RS)";"RS";"IPE";216;14;22;252
2007;"IPIRANGA DO SUL (RS)";"RS";"IPIRANGA DO SUL";96;7;8;111
2007;"IRAI (RS)";"RS";"IRAI";97;9;17;123
2007;"ITAARA (RS)";"RS";"ITAARA";106;3;7;116
2007;"ITACURUBI (RS)";"RS";"ITACURUBI";25;7;8;40
2007;"ITAPUCA (RS)";"RS";"ITAPUCA";36;3;5;44
2007;"ITAQUI (RS)";"RS";"ITAQUI";557;16;55;628
2007;"ITATI (RS)";"RS";"ITATI";50;4;4;58
2007;"ITATIBA DO SUL (RS)";"RS";"ITATIBA DO SUL";73;11;5;89
2007;"IVORA (RS)";"RS";"IVORA";57;3;6;66
2007;"IVOTI (RS)";"RS";"IVOTI";448;40;93;581
2007;"JABOTICABA (RS)";"RS";"JABOTICABA";47;4;13;64
2007;"JACUIZINHO (RS)";"RS";"JACUIZINHO";31;4;6;41
2007;"JACUTINGA (RS)";"RS";"JACUTINGA";99;13;5;117
2007;"JAGUARAO (RS)";"RS";"JAGUARAO";277;15;33;325
2007;"JAGUARI (RS)";"RS";"JAGUARI";209;19;46;274
2007;"JAQUIRANA (RS)";"RS";"JAQUIRANA";136;3;8;147
2007;"JARI (RS)";"RS";"JARI";37;3;9;49
2007;"JOIA (RS)";"RS";"JOIA";241;8;27;276
2007;"JULIO DE CASTILHOS (RS)";"RS";"JULIO DE CASTILHOS";492;16;45;553
2007;"LAGOA BONITA DO SUL (RS)";"RS";"LAGOA BONITA DO SUL";42;4;20;66
2007;"LAGOA DOS TRES CANTOS (RS)";"RS";"LAGOA DOS TRES CANTOS";71;7;7;85
2007;"LAGOA VERMELHA (RS)";"RS";"LAGOA VERMELHA";555;28;69;652
2007;"LAGOAO (RS)";"RS";"LAGOAO";55;3;26;84
2007;"LAJEADO (RS)";"RS";"LAJEADO";1655;124;260;2039
2007;"LAJEADO DO BUGRE (RS)";"RS";"LAJEADO DO BUGRE";19;1;6;26
2007;"LAVRAS DO SUL (RS)";"RS";"LAVRAS DO SUL";66;9;18;93
2007;"LIBERATO SALZANO (RS)";"RS";"LIBERATO SALZANO";95;5;18;118
2007;"LINDOLFO COLLOR (RS)";"RS";"LINDOLFO COLLOR";100;11;16;127
2007;"LINHA NOVA (RS)";"RS";"LINHA NOVA";58;7;5;70
2007;"MACAMBARA (RS)";"RS";"MACAMBARA";28;3;18;49
2007;"MACHADINHO (RS)";"RS";"MACHADINHO";94;5;15;114
2007;"MAMPITUBA (RS)";"RS";"MAMPITUBA";22;1;7;30
2007;"MANOEL VIANA (RS)";"RS";"MANOEL VIANA";144;7;9;160
2007;"MAQUINE (RS)";"RS";"MAQUINE";232;10;9;251
2007;"MARATA (RS)";"RS";"MARATA";85;9;26;120
2007;"MARAU (RS)";"RS";"MARAU";843;59;131;1033
2007;"MARCELINO RAMOS (RS)";"RS";"MARCELINO RAMOS";106;17;17;140
2007;"MARIANA PIMENTEL (RS)";"RS";"MARIANA PIMENTEL";85;5;19;109
2007;"MARIANO MORO (RS)";"RS";"MARIANO MORO";60;11;5;76
2007;"MARQUES DE SOUZA (RS)";"RS";"MARQUES DE SOUZA";108;12;11;131
2007;"MATA (RS)";"RS";"MATA";86;3;14;103
2007;"MATO CASTELHANO (RS)";"RS";"MATO CASTELHANO";107;6;23;136
2007;"MATO LEITAO (RS)";"RS";"MATO LEITAO";258;6;9;273
2007;"MATO QUEIMADO (RS)";"RS";"MATO QUEIMADO";34;4;6;44
2007;"MAXIMILIANO DE ALMEIDA (RS)";"RS";"MAXIMILIANO DE ALMEIDA";117;8;33;158
2007;"MINAS DO LEAO (RS)";"RS";"MINAS DO LEAO";93;15;21;129
2007;"MIRAGUAI (RS)";"RS";"MIRAGUAI";55;2;15;72
2007;"MONTAURI (RS)";"RS";"MONTAURI";51;6;3;60
2007;"MONTE ALEGRE DOS CAMPOS (RS)";"RS";"MONTE ALEGRE DOS CAMPOS";57;4;25;86
2007;"MONTE BELO DO SUL (RS)";"RS";"MONTE BELO DO SUL";181;6;15;202
2007;"MONTENEGRO (RS)";"RS";"MONTENEGRO";1123;132;221;1476
2007;"MORMACO (RS)";"RS";"MORMACO";54;4;8;66
2007;"MORRINHOS DO SUL (RS)";"RS";"MORRINHOS DO SUL";129;2;7;138
2007;"MORRO REDONDO (RS)";"RS";"MORRO REDONDO";185;5;20;210
2007;"MORRO REUTER (RS)";"RS";"MORRO REUTER";124;11;32;167
2007;"MOSTARDAS (RS)";"RS";"MOSTARDAS";215;8;38;261
2007;"MUCUM (RS)";"RS";"MUCUM";82;10;23;115
2007;"MUITOS CAPOES (RS)";"RS";"MUITOS CAPOES";42;3;4;49
2007;"MULITERNO (RS)";"RS";"MULITERNO";76;4;4;84
2007;"NAO ME TOQUE (RS)";"RS";"NAO ME TOQUE";438;22;44;504
2007;"NICOLAU VERGUEIRO (RS)";"RS";"NICOLAU VERGUEIRO";70;5;11;86
2007;"NONOAI (RS)";"RS";"NONOAI";174;12;38;224
2007;"NOVA ALVORADA (RS)";"RS";"NOVA ALVORADA";102;3;8;113
2007;"JACUTINGA (MG)";"MG";"JACUTINGA";279;34;36;349
2007;"JAGUARACU (MG)";"MG";"JAGUARACU";33;2;3;38
2007;"JAIBA (MG)";"MG";"JAIBA";230;7;50;287
2007;"JAMPRUCA (MG)";"MG";"JAMPRUCA";9;3;15;27
2007;"JANAUBA (MG)";"MG";"JANAUBA";582;9;78;669
2007;"JANUARIA (MG)";"MG";"JANUARIA";246;12;55;313
2007;"JAPARAIBA (MG)";"MG";"JAPARAIBA";44;3;21;68
2007;"JAPONVAR (MG)";"MG";"JAPONVAR";5;1;9;15
2007;"JECEABA (MG)";"MG";"JECEABA";43;11;5;59
2007;"JENIPAPO DE MINAS (MG)";"MG";"JENIPAPO DE MINAS";16;4;10;30
2007;"JEQUERI (MG)";"MG";"JEQUERI";55;6;26;87
2007;"JEQUITAI (MG)";"MG";"JEQUITAI";57;3;7;67
2007;"JEQUITIBA (MG)";"MG";"JEQUITIBA";47;4;21;72
2007;"JEQUITINHONHA (MG)";"MG";"JEQUITINHONHA";53;15;12;80
2007;"JESUANIA (MG)";"MG";"JESUANIA";60;8;6;74
2007;"JOAIMA (MG)";"MG";"JOAIMA";48;5;17;70
2007;"JOANESIA (MG)";"MG";"JOANESIA";9;3;9;21
2007;"JOAO MONLEVADE (MG)";"MG";"JOAO MONLEVADE";909;98;186;1193
2007;"JOAO PINHEIRO (MG)";"MG";"JOAO PINHEIRO";686;15;150;851
2007;"JOAQUIM FELICIO (MG)";"MG";"JOAQUIM FELICIO";26;0;8;34
2007;"JORDANIA (MG)";"MG";"JORDANIA";14;8;8;30
2007;"JOSE GONCALVES DE MINAS (MG)";"MG";"JOSE GONCALVES DE MINAS";20;7;5;32
2007;"JOSE RAYDAN (MG)";"MG";"JOSE RAYDAN";15;2;8;25
2007;"JOSENOPOLIS (MG)";"MG";"JOSENOPOLIS";17;2;2;21
2007;"JUATUBA (MG)";"MG";"JUATUBA";161;21;170;352
2007;"JUIZ DE FORA (MG)";"MG";"JUIZ DE FORA";4287;446;1199;5932
2007;"JURAMENTO (MG)";"MG";"JURAMENTO";12;2;12;26
2007;"JURUAIA (MG)";"MG";"JURUAIA";48;10;11;69
2007;"JUVENILIA (MG)";"MG";"JUVENILIA";8;4;6;18
2007;"LADAINHA (MG)";"MG";"LADAINHA";40;9;18;67
2007;"LAGAMAR (MG)";"MG";"LAGAMAR";60;14;17;91
2007;"LAGOA DA PRATA (MG)";"MG";"LAGOA DA PRATA";615;36;149;800
2007;"LAGOA DOS PATOS (MG)";"MG";"LAGOA DOS PATOS";27;2;6;35
2007;"LAGOA DOURADA (MG)";"MG";"LAGOA DOURADA";297;9;31;337
2007;"LAGOA FORMOSA (MG)";"MG";"LAGOA FORMOSA";212;14;63;289
2007;"LAGOA GRANDE (MG)";"MG";"LAGOA GRANDE";82;2;45;129
2007;"LAGOA SANTA (MG)";"MG";"LAGOA SANTA";514;67;79;660
2007;"LAJINHA (MG)";"MG";"LAJINHA";178;9;25;212
2007;"LAMBARI (MG)";"MG";"LAMBARI";251;25;20;296
2007;"LAMIM (MG)";"MG";"LAMIM";34;2;4;40
2007;"LARANJAL (MG)";"MG";"LARANJAL";133;8;1;142
2007;"LASSANCE (MG)";"MG";"LASSANCE";32;1;5;38
2007;"LAVRAS (MG)";"MG";"LAVRAS";937;114;164;1215
2007;"LEANDRO FERREIRA (MG)";"MG";"LEANDRO FERREIRA";30;3;5;38
2007;"LEME DO PRADO (MG)";"MG";"LEME DO PRADO";21;4;9;34
2007;"LEOPOLDINA (MG)";"MG";"LEOPOLDINA";590;50;59;699
2007;"LIBERDADE (MG)";"MG";"LIBERDADE";61;8;6;75
2007;"LIMA DUARTE (MG)";"MG";"LIMA DUARTE";149;20;36;205
2007;"LIMEIRA DO OESTE (MG)";"MG";"LIMEIRA DO OESTE";100;12;36;148
2007;"LONTRA (MG)";"MG";"LONTRA";7;3;5;15
2007;"LUISBURGO (MG)";"MG";"LUISBURGO";20;3;19;42
2007;"LUISLANDIA (MG)";"MG";"LUISLANDIA";6;3;3;12
2007;"LUMINARIAS (MG)";"MG";"LUMINARIAS";81;5;25;111
2007;"LUZ (MG)";"MG";"LUZ";251;43;19;313
2007;"MACHACALIS (MG)";"MG";"MACHACALIS";21;2;5;28
2007;"MACHADO (MG)";"MG";"MACHADO";596;61;76;733
2007;"MADRE DE DEUS DE MINAS (MG)";"MG";"MADRE DE DEUS DE MINAS";59;4;4;67
2007;"MALACACHETA (MG)";"MG";"MALACACHETA";81;3;30;114
2007;"MAMONAS (MG)";"MG";"MAMONAS";59;2;6;67
2007;"MANGA (MG)";"MG";"MANGA";88;3;28;119
2007;"MANHUACU (MG)";"MG";"MANHUACU";1170;57;103;1330
2007;"MANHUMIRIM (MG)";"MG";"MANHUMIRIM";261;25;31;317
2007;"MANTENA (MG)";"MG";"MANTENA";534;26;69;629
2007;"MAR DE ESPANHA (MG)";"MG";"MAR DE ESPANHA";114;12;14;140
2007;"MARAVILHAS (MG)";"MG";"MARAVILHAS";148;6;5;159
2007;"MARIA DA FE (MG)";"MG";"MARIA DA FE";215;12;24;251
2007;"MARIANA (MG)";"MG";"MARIANA";472;101;191;764
2007;"MARILAC (MG)";"MG";"MARILAC";10;4;5;19
2007;"MARIO CAMPOS (MG)";"MG";"MARIO CAMPOS";168;10;11;189
2007;"MARIPA DE MINAS (MG)";"MG";"MARIPA DE MINAS";31;5;2;38
2007;"MARLIERIA (MG)";"MG";"MARLIERIA";29;5;3;37
2007;"MARMELOPOLIS (MG)";"MG";"MARMELOPOLIS";23;5;6;34
2007;"MARTINHO CAMPOS (MG)";"MG";"MARTINHO CAMPOS";306;17;61;384
2007;"MARTINS SOARES (MG)";"MG";"MARTINS SOARES";48;1;11;60
2007;"MATA VERDE (MG)";"MG";"MATA VERDE";12;7;3;22
2007;"MATERLANDIA (MG)";"MG";"MATERLANDIA";10;2;4;16
2007;"MATEUS LEME (MG)";"MG";"MATEUS LEME";380;47;66;493
2007;"MATHIAS LOBATO (MG)";"MG";"MATHIAS LOBATO";32;2;4;38
2007;"MATIAS BARBOSA (MG)";"MG";"MATIAS BARBOSA";345;15;30;390
2007;"MATIAS CARDOSO (MG)";"MG";"MATIAS CARDOSO";11;3;8;22
2007;"MATIPO (MG)";"MG";"MATIPO";215;21;22;258
2007;"MATO VERDE (MG)";"MG";"MATO VERDE";106;4;21;131
2007;"MATOZINHOS (MG)";"MG";"MATOZINHOS";252;47;79;378
2007;"MATUTINA (MG)";"MG";"MATUTINA";67;8;2;77
2007;"MEDEIROS (MG)";"MG";"MEDEIROS";32;9;2;43
2007;"MEDINA (MG)";"MG";"MEDINA";102;28;28;158
2007;"MENDES PIMENTEL (MG)";"MG";"MENDES PIMENTEL";27;1;9;37
2007;"MERCES (MG)";"MG";"MERCES";113;6;10;129
2007;"MESQUITA (MG)";"MG";"MESQUITA";17;4;3;24
2007;"MINAS NOVAS (MG)";"MG";"MINAS NOVAS";78;14;61;153
2007;"MINDURI (MG)";"MG";"MINDURI";49;8;2;59
2007;"MIRABELA (MG)";"MG";"MIRABELA";60;6;19;85
2007;"MIRADOURO (MG)";"MG";"MIRADOURO";87;4;25;116
2007;"MIRAI (MG)";"MG";"MIRAI";117;11;17;145
2007;"MIRAVANIA (MG)";"MG";"MIRAVANIA";8;1;6;15
2007;"MOEDA (MG)";"MG";"MOEDA";58;3;13;74
2007;"MOEMA (MG)";"MG";"MOEMA";125;9;107;241
2007;"MONJOLOS (MG)";"MG";"MONJOLOS";5;2;6;13
2007;"MONSENHOR PAULO (MG)";"MG";"MONSENHOR PAULO";133;11;6;150
2007;"MONTALVANIA (MG)";"MG";"MONTALVANIA";79;5;35;119
2007;"MONTE ALEGRE DE MINAS (MG)";"MG";"MONTE ALEGRE DE MINAS";418;12;30;460
2007;"MONTE AZUL (MG)";"MG";"MONTE AZUL";141;9;35;185
2007;"MONTE BELO (MG)";"MG";"MONTE BELO";217;22;43;282
2007;"MONTE CARMELO (MG)";"MG";"MONTE CARMELO";1057;53;103;1213
2007;"MONTE FORMOSO (MG)";"MG";"MONTE FORMOSO";10;3;9;22
2007;"MONTE SANTO DE MINAS (MG)";"MG";"MONTE SANTO DE MINAS";365;22;77;464
2007;"MONTE SIAO (MG)";"MG";"MONTE SIAO";187;31;29;247
2007;"MONTES CLAROS (MG)";"MG";"MONTES CLAROS";3529;163;844;4536
2007;"MONTEZUMA (MG)";"MG";"MONTEZUMA";16;6;13;35
2007;"MORADA NOVA DE MINAS (MG)";"MG";"MORADA NOVA DE MINAS";80;19;15;114
2007;"MORRO DA GARCA (MG)";"MG";"MORRO DA GARCA";37;2;16;55
2007;"MORRO DO PILAR (MG)";"MG";"MORRO DO PILAR";24;7;1;32
2007;"MUNHOZ (MG)";"MG";"MUNHOZ";80;6;7;93
2007;"MURIAE (MG)";"MG";"MURIAE";1106;61;139;1306
2007;"MUTUM (MG)";"MG";"MUTUM";138;16;30;184
2007;"MUZAMBINHO (MG)";"MG";"MUZAMBINHO";278;38;32;348
2007;"NACIP RAYDAN (MG)";"MG";"NACIP RAYDAN";6;0;3;9
2007;"NANUQUE (MG)";"MG";"NANUQUE";545;41;156;742
2007;"NAQUE (MG)";"MG";"NAQUE";27;3;19;49
2007;"NATALANDIA (MG)";"MG";"NATALANDIA";15;2;11;28
2007;"NATERCIA (MG)";"MG";"NATERCIA";73;6;14;93
2007;"NAZARENO (MG)";"MG";"NAZARENO";132;9;19;160
2007;"NEPOMUCENO (MG)";"MG";"NEPOMUCENO";364;15;44;423
2007;"NINHEIRA (MG)";"MG";"NINHEIRA";20;2;18;40
2007;"NOVA BELEM (MG)";"MG";"NOVA BELEM";31;2;8;41
2007;"NOVA ERA (MG)";"MG";"NOVA ERA";160;18;69;247
2007;"NOVA LIMA (MG)";"MG";"NOVA LIMA";845;232;132;1209
2007;"NOVA MODICA (MG)";"MG";"NOVA MODICA";14;2;13;29
2007;"NOVA PONTE (MG)";"MG";"NOVA PONTE";160;33;55;248
2007;"NOVA PORTEIRINHA (MG)";"MG";"NOVA PORTEIRINHA";20;2;11;33
2007;"NOVA RESENDE (MG)";"MG";"NOVA RESENDE";270;12;24;306
2007;"NOVA SERRANA (MG)";"MG";"NOVA SERRANA";313;35;45;393
2007;"NOVA UNIAO (MG)";"MG";"NOVA UNIAO";104;8;15;127
2007;"NOVO CRUZEIRO (MG)";"MG";"NOVO CRUZEIRO";93;21;66;180
2007;"NOVO ORIENTE DE MINAS (MG)";"MG";"NOVO ORIENTE DE MINAS";19;4;11;34
2007;"NOVORIZONTE (MG)";"MG";"NOVORIZONTE";33;2;9;44
2007;"OLARIA (MG)";"MG";"OLARIA";10;5;3;18
2007;"OLHOS D AGUA (MG)";"MG";"OLHOS D AGUA";34;7;22;63
2007;"OLIMPIO NORONHA (MG)";"MG";"OLIMPIO NORONHA";22;10;5;37
2007;"OLIVEIRA (MG)";"MG";"OLIVEIRA";649;37;60;746
2007;"OLIVEIRA FORTES (MG)";"MG";"OLIVEIRA FORTES";17;3;2;22
2007;"ONCA DE PITANGUI (MG)";"MG";"ONCA DE PITANGUI";22;6;7;35
2007;"ORATORIOS (MG)";"MG";"ORATORIOS";43;1;14;58
2007;"ORIZANIA (MG)";"MG";"ORIZANIA";41;5;7;53
2007;"OURO BRANCO (MG)";"MG";"OURO BRANCO";373;72;224;669
2007;"OURO FINO (MG)";"MG";"OURO FINO";421;37;68;526
2007;"OURO PRETO (MG)";"MG";"OURO PRETO";868;134;285;1287
2007;"OURO VERDE DE MINAS (MG)";"MG";"OURO VERDE DE MINAS";13;3;4;20
2007;"PADRE CARVALHO (MG)";"MG";"PADRE CARVALHO";8;2;13;23
2007;"PADRE PARAISO (MG)";"MG";"PADRE PARAISO";88;60;49;197
2007;"PAI PEDRO (MG)";"MG";"PAI PEDRO";11;5;18;34
2007;"PAINEIRAS (MG)";"MG";"PAINEIRAS";78;10;10;98
2007;"PAINS (MG)";"MG";"PAINS";191;14;20;225
2007;"PAIVA (MG)";"MG";"PAIVA";10;3;1;14
2007;"PALMA (MG)";"MG";"PALMA";69;3;4;76
2007;"PALMOPOLIS (MG)";"MG";"PALMOPOLIS";15;4;6;25
2007;"PAPAGAIOS (MG)";"MG";"PAPAGAIOS";487;7;49;543
2007;"PARA DE MINAS (MG)";"MG";"PARA DE MINAS";1619;94;176;1889
2007;"PARACATU (MG)";"MG";"PARACATU";1061;54;247;1362
2007;"PARAGUACU (MG)";"MG";"PARAGUACU";262;33;24;319
2007;"PARAISOPOLIS (MG)";"MG";"PARAISOPOLIS";338;34;24;396
2007;"PARAOPEBA (MG)";"MG";"PARAOPEBA";362;16;42;420
2007;"PASSA QUATRO (MG)";"MG";"PASSA QUATRO";291;19;23;333
2007;"PASSA TEMPO (MG)";"MG";"PASSA TEMPO";123;16;11;150
2007;"PASSA VINTE (MG)";"MG";"PASSA VINTE";15;10;6;31
2007;"PASSABEM (MG)";"MG";"PASSABEM";4;2;2;8
2007;"PASSOS (MG)";"MG";"PASSOS";1588;94;304;1986
2007;"PATIS (MG)";"MG";"PATIS";4;1;6;11
2007;"PATOS DE MINAS (MG)";"MG";"PATOS DE MINAS";2243;88;425;2756
2007;"PATROCINIO (MG)";"MG";"PATROCINIO";1314;69;405;1788
2007;"PATROCINIO DO MURIAE (MG)";"MG";"PATROCINIO DO MURIAE";55;4;2;61
2007;"PAULA CANDIDO (MG)";"MG";"PAULA CANDIDO";46;8;12;66
2007;"PAULISTAS (MG)";"MG";"PAULISTAS";11;2;7;20
2007;"PAVAO (MG)";"MG";"PAVAO";35;10;6;51
2007;"PECANHA (MG)";"MG";"PECANHA";118;5;43;166
2007;"PEDRA AZUL (MG)";"MG";"PEDRA AZUL";117;12;50;179
2007;"PEDRA BONITA (MG)";"MG";"PEDRA BONITA";22;7;9;38
2007;"PEDRA DO ANTA (MG)";"MG";"PEDRA DO ANTA";16;1;12;29
2007;"PEDRA DO INDAIA (MG)";"MG";"PEDRA DO INDAIA";51;5;4;60
2007;"PEDRA DOURADA (MG)";"MG";"PEDRA DOURADA";8;3;2;13
2007;"PEDRALVA (MG)";"MG";"PEDRALVA";112;13;18;143
2007;"PEDRAS DE MARIA DA CRUZ (MG)";"MG";"PEDRAS DE MARIA DA CRUZ";11;3;21;35
2007;"PEDRINOPOLIS (MG)";"MG";"PEDRINOPOLIS";53;9;6;68
2007;"PEDRO LEOPOLDO (MG)";"MG";"PEDRO LEOPOLDO";810;90;165;1065
2007;"PEDRO TEIXEIRA (MG)";"MG";"PEDRO TEIXEIRA";17;3;1;21
2007;"PEQUERI (MG)";"MG";"PEQUERI";59;4;3;66
2007;"PEQUI (MG)";"MG";"PEQUI";34;6;6;46
2007;"PERDIGAO (MG)";"MG";"PERDIGAO";95;12;3;110
2007;"PERDIZES (MG)";"MG";"PERDIZES";238;30;27;295
2007;"PERDOES (MG)";"MG";"PERDOES";426;24;46;496
2007;"PERIQUITO (MG)";"MG";"PERIQUITO";24;4;18;46
2007;"PESCADOR (MG)";"MG";"PESCADOR";11;6;3;20
2007;"PIAU (MG)";"MG";"PIAU";34;5;7;46
2007;"PIEDADE DE CARATINGA (MG)";"MG";"PIEDADE DE CARATINGA";99;7;5;111
2007;"PIEDADE DE PONTE NOVA (MG)";"MG";"PIEDADE DE PONTE NOVA";26;1;13;40
2007;"PIEDADE DO RIO GRANDE (MG)";"MG";"PIEDADE DO RIO GRANDE";41;2;7;50
2007;"PIEDADE DOS GERAIS (MG)";"MG";"PIEDADE DOS GERAIS";61;4;10;75
2007;"PIMENTA (MG)";"MG";"PIMENTA";174;5;16;195
2007;"PINGO D AGUA (MG)";"MG";"PINGO D AGUA";10;1;5;16
2007;"PINTOPOLIS (MG)";"MG";"PINTOPOLIS";10;2;2;14
2007;"PIRACEMA (MG)";"MG";"PIRACEMA";65;7;12;84
2007;"PIRAJUBA (MG)";"MG";"PIRAJUBA";107;12;7;126
2007;"PIRANGA (MG)";"MG";"PIRANGA";103;16;35;154
2007;"PIRANGUCU (MG)";"MG";"PIRANGUCU";27;16;32;75
2007;"PIRANGUINHO (MG)";"MG";"PIRANGUINHO";111;11;7;129
2007;"PIRAPETINGA (MG)";"MG";"PIRAPETINGA";280;14;22;316
2007;"PIRAPORA (MG)";"MG";"PIRAPORA";430;17;99;546
2007;"PIRAUBA (MG)";"MG";"PIRAUBA";101;12;6;119
2007;"PITANGUI (MG)";"MG";"PITANGUI";491;31;60;582
2007;"PIUI (MG)";"MG";"PIUI";549;29;49;627
2007;"PLANURA (MG)";"MG";"PLANURA";150;7;39;196
2007;"POCO FUNDO (MG)";"MG";"POCO FUNDO";207;36;13;256
2007;"POCOS DE CALDAS (MG)";"MG";"POCOS DE CALDAS";2403;371;345;3119
2007;"POCRANE (MG)";"MG";"POCRANE";56;4;7;67
2007;"POMPEU (MG)";"MG";"POMPEU";374;24;76;474
2007;"PONTE NOVA (MG)";"MG";"PONTE NOVA";818;29;101;948
2007;"PONTO CHIQUE (MG)";"MG";"PONTO CHIQUE";4;1;8;13
2007;"PONTO DOS VOLANTES (MG)";"MG";"PONTO DOS VOLANTES";14;4;22;40
2007;"PORTEIRINHA (MG)";"MG";"PORTEIRINHA";238;7;119;364
2007;"PORTO FIRME (MG)";"MG";"PORTO FIRME";48;4;10;62
2007;"POTE (MG)";"MG";"POTE";49;7;13;69
2007;"POUSO ALEGRE (MG)";"MG";"POUSO ALEGRE";1879;134;406;2419
2007;"POUSO ALTO (MG)";"MG";"POUSO ALTO";89;17;6;112
2007;"PRADOS (MG)";"MG";"PRADOS";63;7;5;75
2007;"PRATA (MG)";"MG";"PRATA";335;74;64;473
2007;"PRATAPOLIS (MG)";"MG";"PRATAPOLIS";146;15;10;171
2007;"PRATINHA (MG)";"MG";"PRATINHA";40;6;3;49
2007;"PRESIDENTE BERNARDES (MG)";"MG";"PRESIDENTE BERNARDES";17;3;8;28
2007;"PRESIDENTE JUSCELINO (MG)";"MG";"PRESIDENTE JUSCELINO";29;3;11;43
2007;"PRESIDENTE KUBITSCHEK (MG)";"MG";"PRESIDENTE KUBITSCHEK";14;6;4;24
2007;"PRESIDENTE OLEGARIO (MG)";"MG";"PRESIDENTE OLEGARIO";188;12;80;280
2007;"PRUDENTE DE MORAIS (MG)";"MG";"PRUDENTE DE MORAIS";94;5;11;110
2007;"QUARTEL GERAL (MG)";"MG";"QUARTEL GERAL";34;6;2;42
2007;"QUELUZITA (MG)";"MG";"QUELUZITA";18;4;2;24
2007;"RAPOSOS (MG)";"MG";"RAPOSOS";51;27;16;94
2007;"RAUL SOARES (MG)";"MG";"RAUL SOARES";148;19;30;197
2007;"RECREIO (MG)";"MG";"RECREIO";134;9;17;160
2007;"REDUTO (MG)";"MG";"REDUTO";41;4;2;47
2007;"RESENDE COSTA (MG)";"MG";"RESENDE COSTA";129;8;9;146
2007;"RESPLENDOR (MG)";"MG";"RESPLENDOR";169;15;29;213
2007;"RESSAQUINHA (MG)";"MG";"RESSAQUINHA";93;2;9;104
2007;"RIACHINHO (MG)";"MG";"RIACHINHO";42;3;15;60
2007;"RIACHO DOS MACHADOS (MG)";"MG";"RIACHO DOS MACHADOS";49;1;30;80
2007;"RIBEIRAO DAS NEVES (MG)";"MG";"RIBEIRAO DAS NEVES";1947;285;522;2754
2007;"RIBEIRAO VERMELHO (MG)";"MG";"RIBEIRAO VERMELHO";22;5;3;30
2007;"RIO ACIMA (MG)";"MG";"RIO ACIMA";101;13;13;127
2007;"RIO CASCA (MG)";"MG";"RIO CASCA";200;8;47;255
2007;"RIO DO PRADO (MG)";"MG";"RIO DO PRADO";6;7;5;18
2007;"RIO DOCE (MG)";"MG";"RIO DOCE";22;2;5;29
2007;"RIO ESPERA (MG)";"MG";"RIO ESPERA";26;0;4;30
2007;"RIO MANSO (MG)";"MG";"RIO MANSO";81;5;10;96
2007;"RIO NOVO (MG)";"MG";"RIO NOVO";93;5;18;116
2007;"RIO PARANAIBA (MG)";"MG";"RIO PARANAIBA";127;9;39;175
2007;"RIO PARDO DE MINAS (MG)";"MG";"RIO PARDO DE MINAS";160;4;85;249
2007;"RIO PIRACICABA (MG)";"MG";"RIO PIRACICABA";168;15;24;207
2007;"RIO POMBA (MG)";"MG";"RIO POMBA";181;21;23;225
2007;"RIO PRETO (MG)";"MG";"RIO PRETO";300;89;34;423
2007;"RIO VERMELHO (MG)";"MG";"RIO VERMELHO";49;18;35;102
2007;"RITAPOLIS (MG)";"MG";"RITAPOLIS";21;3;6;30
2007;"ROCHEDO DE MINAS (MG)";"MG";"ROCHEDO DE MINAS";17;4;2;23
2007;"RODEIRO (MG)";"MG";"RODEIRO";129;4;10;143
2007;"ROMARIA (MG)";"MG";"ROMARIA";40;6;4;50
2007;"ROSARIO DA LIMEIRA (MG)";"MG";"ROSARIO DA LIMEIRA";41;5;23;69
2007;"RUBELITA (MG)";"MG";"RUBELITA";9;3;10;22
2007;"RUBIM (MG)";"MG";"RUBIM";16;4;19;39
2007;"SABARA (MG)";"MG";"SABARA";467;162;264;893
2007;"SABINOPOLIS (MG)";"MG";"SABINOPOLIS";105;18;27;150
2007;"SACRAMENTO (MG)";"MG";"SACRAMENTO";402;46;43;491
2007;"SALINAS (MG)";"MG";"SALINAS";297;28;95;420
2007;"SALTO DA DIVISA (MG)";"MG";"SALTO DA DIVISA";4;3;5;12
2007;"SANTA BARBARA (MG)";"MG";"SANTA BARBARA";339;41;147;527
2007;"SANTA BARBARA DO LESTE (MG)";"MG";"SANTA BARBARA DO LESTE";137;6;4;147
2007;"SANTA BARBARA DO MONTE VERDE (MG)";"MG";"SANTA BARBARA DO MONTE VERDE";573;75;110;758
2007;"SANTA BARBARA DO TUGURIO (MG)";"MG";"SANTA BARBARA DO TUGURIO";36;3;6;45
2007;"SANTA CRUZ DE MINAS (MG)";"MG";"SANTA CRUZ DE MINAS";49;3;2;54
2007;"SANTA CRUZ DE SALINAS (MG)";"MG";"SANTA CRUZ DE SALINAS";8;2;18;28
2007;"SANTA CRUZ DO ESCALVADO (MG)";"MG";"SANTA CRUZ DO ESCALVADO";23;2;7;32
2007;"SANTA EFIGENIA DE MINAS (MG)";"MG";"SANTA EFIGENIA DE MINAS";15;4;3;22
2007;"SANTA FE DE MINAS (MG)";"MG";"SANTA FE DE MINAS";8;2;3;13
2007;"SANTA HELENA DE MINAS (MG)";"MG";"SANTA HELENA DE MINAS";9;2;5;16
2007;"SANTA JULIANA (MG)";"MG";"SANTA JULIANA";254;21;33;308
2007;"SANTA LUZIA (MG)";"MG";"SANTA LUZIA";1263;128;526;1917
2007;"SANTA MARGARIDA (MG)";"MG";"SANTA MARGARIDA";168;12;15;195
2007;"SANTA MARIA DE ITABIRA (MG)";"MG";"SANTA MARIA DE ITABIRA";74;11;24;109
2007;"SANTA MARIA DO SALTO (MG)";"MG";"SANTA MARIA DO SALTO";7;3;4;14
2007;"SANTA MARIA DO SUACUI (MG)";"MG";"SANTA MARIA DO SUACUI";58;3;25;86
2007;"SANTA RITA DE CALDAS (MG)";"MG";"SANTA RITA DE CALDAS";229;12;8;249
2007;"SANTA RITA DE JACUTINGA (MG)";"MG";"SANTA RITA DE JACUTINGA";38;3;3;44
2007;"SANTA RITA DE MINAS (MG)";"MG";"SANTA RITA DE MINAS";104;6;6;116
2007;"SANTA RITA DO IBITIPOCA (MG)";"MG";"SANTA RITA DO IBITIPOCA";35;3;1;39
2007;"SANTA RITA DO ITUETO (MG)";"MG";"SANTA RITA DO ITUETO";62;4;10;76
2007;"SANTA RITA DO SAPUCAI (MG)";"MG";"SANTA RITA DO SAPUCAI";334;38;57;429
2007;"SANTA ROSA DA SERRA (MG)";"MG";"SANTA ROSA DA SERRA";31;4;5;40
2007;"SANTA VITORIA (MG)";"MG";"SANTA VITORIA";214;10;23;247
2007;"SANTANA DA VARGEM (MG)";"MG";"SANTANA DA VARGEM";60;8;13;81
2007;"SANTANA DE CATAGUASES (MG)";"MG";"SANTANA DE CATAGUASES";34;11;6;51
2007;"SANTANA DE PIRAPAMA (MG)";"MG";"SANTANA DE PIRAPAMA";48;3;19;70
2007;"SANTANA DO DESERTO (MG)";"MG";"SANTANA DO DESERTO";50;3;5;58
2007;"SANTANA DO GARAMBEU (MG)";"MG";"SANTANA DO GARAMBEU";9;0;3;12
2007;"SANTANA DO JACARE (MG)";"MG";"SANTANA DO JACARE";29;5;3;37
2007;"SANTANA DO MANHUACU (MG)";"MG";"SANTANA DO MANHUACU";91;3;10;104
2007;"SANTANA DO PARAISO (MG)";"MG";"SANTANA DO PARAISO";80;9;26;115
2007;"SANTANA DO RIACHO (MG)";"MG";"SANTANA DO RIACHO";10;4;9;23
2007;"SANTANA DOS MONTES (MG)";"MG";"SANTANA DOS MONTES";23;6;6;35
2007;"SANTO ANTONIO DO AMPARO (MG)";"MG";"SANTO ANTONIO DO AMPARO";212;17;15;244
2007;"SANTO ANTONIO DO AVENTUREIRO (MG)";"MG";"SANTO ANTONIO DO AVENTUREIRO";45;3;3;51
2007;"SANTO ANTONIO DO GRAMA (MG)";"MG";"SANTO ANTONIO DO GRAMA";45;1;5;51
2007;"SANTO ANTONIO DO ITAMBE (MG)";"MG";"SANTO ANTONIO DO ITAMBE";9;4;6;19
2007;"SANTO ANTONIO DO JACINTO (MG)";"MG";"SANTO ANTONIO DO JACINTO";23;7;20;50
2007;"SANTO ANTONIO DO MONTE (MG)";"MG";"SANTO ANTONIO DO MONTE";392;24;81;497
2007;"SANTO ANTONIO DO RETIRO (MG)";"MG";"SANTO ANTONIO DO RETIRO";21;2;13;36
2007;"SANTO ANTONIO DO RIO ABAIXO (MG)";"MG";"SANTO ANTONIO DO RIO ABAIXO";8;4;3;15
2007;"SANTO HIPOLITO (MG)";"MG";"SANTO HIPOLITO";22;0;2;24
2007;"SANTOS DUMONT (MG)";"MG";"SANTOS DUMONT";360;40;98;498
2007;"SAO BENTO ABADE (MG)";"MG";"SAO BENTO ABADE";32;4;5;41
2007;"SAO BRAS DO SUACUI (MG)";"MG";"SAO BRAS DO SUACUI";28;1;6;35
2007;"SAO DOMINGOS DAS DORES (MG)";"MG";"SAO DOMINGOS DAS DORES";71;2;3;76
2007;"SAO DOMINGOS DO PRATA (MG)";"MG";"SAO DOMINGOS DO PRATA";163;8;43;214
2007;"SAO FELIX DE MINAS (MG)";"MG";"SAO FELIX DE MINAS";12;1;5;18
2007;"SAO FRANCISCO (MG)";"MG";"SAO FRANCISCO";157;4;68;229
2007;"SAO FRANCISCO DE PAULA (MG)";"MG";"SAO FRANCISCO DE PAULA";63;5;18;86
2007;"SAO FRANCISCO DE SALES (MG)";"MG";"SAO FRANCISCO DE SALES";64;6;16;86
2007;"SAO FRANCISCO DO GLORIA (MG)";"MG";"SAO FRANCISCO DO GLORIA";45;10;2;57
2007;"SAO GERALDO (MG)";"MG";"SAO GERALDO";100;6;5;111
2007;"SAO GERALDO DA PIEDADE (MG)";"MG";"SAO GERALDO DA PIEDADE";12;3;4;19
2007;"SAO GERALDO DO BAIXIO (MG)";"MG";"SAO GERALDO DO BAIXIO";13;3;5;21
2007;"SAO GONCALO DO ABAETE (MG)";"MG";"SAO GONCALO DO ABAETE";77;5;11;93
2007;"SAO GONCALO DO PARA (MG)";"MG";"SAO GONCALO DO PARA";144;7;9;160
2007;"SAO GONCALO DO RIO ABAIXO (MG)";"MG";"SAO GONCALO DO RIO ABAIXO";96;21;19;136
2007;"SAO GONCALO DO RIO PRETO (MG)";"MG";"SAO GONCALO DO RIO PRETO";18;4;4;26
2007;"SAO GONCALO DO SAPUCAI (MG)";"MG";"SAO GONCALO DO SAPUCAI";372;19;52;443
2007;"SAO GOTARDO (MG)";"MG";"SAO GOTARDO";682;39;123;844
2007;"SAO JOAO BATISTA DO GLORIA (MG)";"MG";"SAO JOAO BATISTA DO GLORIA";69;7;10;86
2007;"SAO JOAO DA LAGOA (MG)";"MG";"SAO JOAO DA LAGOA";30;2;8;40
2007;"SAO JOAO DA MATA (MG)";"MG";"SAO JOAO DA MATA";30;9;0;39
2007;"SAO JOAO DA PONTE (MG)";"MG";"SAO JOAO DA PONTE";39;5;30;74
2007;"SAO JOAO DAS MISSOES (MG)";"MG";"SAO JOAO DAS MISSOES";10;3;9;22
2007;"SAO JOAO DEL REI (MG)";"MG";"SAO JOAO DEL REI";920;92;178;1190
2007;"SAO JOAO DO MANHUACU (MG)";"MG";"SAO JOAO DO MANHUACU";103;6;17;126
2007;"SAO JOAO DO MANTENINHA (MG)";"MG";"SAO JOAO DO MANTENINHA";62;3;4;69
2007;"SAO JOAO DO ORIENTE (MG)";"MG";"SAO JOAO DO ORIENTE";82;8;4;94
2007;"SAO JOAO DO PACUI (MG)";"MG";"SAO JOAO DO PACUI";3;0;2;5
2007;"SAO JOAO DO PARAISO (MG)";"MG";"SAO JOAO DO PARAISO";112;5;51;168
2007;"SAO JOAO EVANGELISTA (MG)";"MG";"SAO JOAO EVANGELISTA";92;3;25;120
2007;"SAO JOAO NEPOMUCENO (MG)";"MG";"SAO JOAO NEPOMUCENO";227;21;33;281
2007;"SAO JOAQUIM DE BICAS (MG)";"MG";"SAO JOAQUIM DE BICAS";290;44;35;369
2007;"SAO JOSE DA BARRA (MG)";"MG";"SAO JOSE DA BARRA";69;6;24;99
2007;"SAO JOSE DA LAPA (MG)";"MG";"SAO JOSE DA LAPA";197;25;22;244
2007;"SAO JOSE DA SAFIRA (MG)";"MG";"SAO JOSE DA SAFIRA";1;2;1;4
2007;"SAO JOSE DA VARGINHA (MG)";"MG";"SAO JOSE DA VARGINHA";37;2;7;46
2007;"SAO JOSE DO ALEGRE (MG)";"MG";"SAO JOSE DO ALEGRE";34;6;4;44
2007;"SAO JOSE DO DIVINO (MG)";"MG";"SAO JOSE DO DIVINO";13;2;8;23
2007;"SAO JOSE DO GOIABAL (MG)";"MG";"SAO JOSE DO GOIABAL";42;9;47;98
2007;"SAO JOSE DO JACURI (MG)";"MG";"SAO JOSE DO JACURI";17;3;4;24
2007;"SAO JOSE DO MANTIMENTO (MG)";"MG";"SAO JOSE DO MANTIMENTO";16;2;4;22
2007;"SAO LOURENCO (MG)";"MG";"SAO LOURENCO";393;44;22;459
2007;"SAO MIGUEL DO ANTA (MG)";"MG";"SAO MIGUEL DO ANTA";71;3;7;81
2007;"SAO PEDRO DA UNIAO (MG)";"MG";"SAO PEDRO DA UNIAO";87;12;5;104
2007;"SAO PEDRO DO SUACUI (MG)";"MG";"SAO PEDRO DO SUACUI";20;3;6;29
2007;"SAO PEDRO DOS FERROS (MG)";"MG";"SAO PEDRO DOS FERROS";111;5;24;140
2007;"SAO ROMAO (MG)";"MG";"SAO ROMAO";20;1;10;31
2007;"SAO ROQUE DE MINAS (MG)";"MG";"SAO ROQUE DE MINAS";97;5;6;108
2007;"SAO SEBASTIAO DA BELA VISTA (MG)";"MG";"SAO SEBASTIAO DA BELA VISTA";26;3;10;39
2007;"SAO SEBASTIAO DA VARGEM ALEGRE (MG)";"MG";"SAO SEBASTIAO DA VARGEM ALEGRE";11;3;4;18
2007;"SAO SEBASTIAO DO ANTA (MG)";"MG";"SAO SEBASTIAO DO ANTA";31;2;3;36
2007;"SAO SEBASTIAO DO MARANHAO (MG)";"MG";"SAO SEBASTIAO DO MARANHAO";22;4;11;37
2007;"SAO SEBASTIAO DO OESTE (MG)";"MG";"SAO SEBASTIAO DO OESTE";87;8;12;107
2007;"SAO SEBASTIAO DO PARAISO (MG)";"MG";"SAO SEBASTIAO DO PARAISO";1237;58;135;1430
2007;"SAO SEBASTIAO DO RIO PRETO (MG)";"MG";"SAO SEBASTIAO DO RIO PRETO";8;2;3;13
2007;"SAO SEBASTIAO DO RIO VERDE (MG)";"MG";"SAO SEBASTIAO DO RIO VERDE";9;2;3;14
2007;"SAO TIAGO (MG)";"MG";"SAO TIAGO";94;9;8;111
2007;"SAO TOMAS DE AQUINO (MG)";"MG";"SAO TOMAS DE AQUINO";65;16;7;88
2007;"SAO TOME DAS LETRAS (MG)";"MG";"SAO TOME DAS LETRAS";92;7;11;110
2007;"SAO VICENTE DE MINAS (MG)";"MG";"SAO VICENTE DE MINAS";63;11;1;75
2007;"SAPUCAI MIRIM (MG)";"MG";"SAPUCAI MIRIM";160;26;11;197
2007;"SARDOA (MG)";"MG";"SARDOA";26;4;6;36
2007;"SARZEDO (MG)";"MG";"SARZEDO";254;21;28;303
2007;"SEM PEIXE (MG)";"MG";"SEM PEIXE";5;4;4;13
2007;"SENADOR AMARAL (MG)";"MG";"SENADOR AMARAL";79;12;5;96
2007;"SENADOR CORTES (MG)";"MG";"SENADOR CORTES";10;3;3;16
2007;"SENADOR FIRMINO (MG)";"MG";"SENADOR FIRMINO";61;8;10;79
2007;"SENADOR JOSE BENTO (MG)";"MG";"SENADOR JOSE BENTO";13;0;6;19
2007;"SENADOR MODESTINO GONCALVES (MG)";"MG";"SENADOR MODESTINO GONCALVES";16;7;4;27
2007;"SENHORA DE OLIVEIRA (MG)";"MG";"SENHORA DE OLIVEIRA";60;4;9;73
2007;"SENHORA DO PORTO (MG)";"MG";"SENHORA DO PORTO";18;3;9;30
2007;"SENHORA DOS REMEDIOS (MG)";"MG";"SENHORA DOS REMEDIOS";58;5;12;75
2007;"SERICITA (MG)";"MG";"SERICITA";51;3;4;58
2007;"SERITINGA (MG)";"MG";"SERITINGA";21;1;2;24
2007;"SERRA AZUL DE MINAS (MG)";"MG";"SERRA AZUL DE MINAS";11;2;7;20
2007;"SERRA DA SAUDADE (MG)";"MG";"SERRA DA SAUDADE";4;4;0;8
2007;"SERRA DO SALITRE (MG)";"MG";"SERRA DO SALITRE";172;3;53;228
2007;"SERRA DOS AIMORES (MG)";"MG";"SERRA DOS AIMORES";54;3;19;76
2007;"SERRANIA (MG)";"MG";"SERRANIA";108;12;7;127
2007;"SERRANOPOLIS DE MINAS (MG)";"MG";"SERRANOPOLIS DE MINAS";4;1;9;14
2007;"SERRANOS (MG)";"MG";"SERRANOS";9;2;1;12
2007;"SERRO (MG)";"MG";"SERRO";132;13;37;182
2007;"SETE LAGOAS (MG)";"MG";"SETE LAGOAS";2525;294;409;3228
2007;"SETUBINHA (MG)";"MG";"SETUBINHA";15;2;14;31
2007;"SILVEIRANIA (MG)";"MG";"SILVEIRANIA";6;2;4;12
2007;"SILVIANOPOLIS (MG)";"MG";"SILVIANOPOLIS";70;11;8;89
2007;"SIMAO PEREIRA (MG)";"MG";"SIMAO PEREIRA";59;4;2;65
2007;"SIMONESIA (MG)";"MG";"SIMONESIA";149;8;27;184
2007;"SOBRALIA (MG)";"MG";"SOBRALIA";27;4;6;37
2007;"SOLEDADE DE MINAS (MG)";"MG";"SOLEDADE DE MINAS";30;6;0;36
2007;"TABULEIRO (MG)";"MG";"TABULEIRO";47;4;6;57
2007;"TAIOBEIRAS (MG)";"MG";"TAIOBEIRAS";492;19;79;590
2007;"TAPARUBA (MG)";"MG";"TAPARUBA";18;2;5;25
2007;"TAPIRA (MG)";"MG";"TAPIRA";35;7;11;53
2007;"TAPIRAI (MG)";"MG";"TAPIRAI";9;2;2;13
2007;"TAQUARACU DE MINAS (MG)";"MG";"TAQUARACU DE MINAS";49;5;8;62
2007;"TARUMIRIM (MG)";"MG";"TARUMIRIM";109;8;20;137
2007;"TEIXEIRAS (MG)";"MG";"TEIXEIRAS";113;7;12;132
2007;"TEOFILO OTONI (MG)";"MG";"TEOFILO OTONI";1165;115;110;1390
2007;"TIMOTEO (MG)";"MG";"TIMOTEO";855;144;99;1098
2007;"TIRADENTES (MG)";"MG";"TIRADENTES";65;11;9;85
2007;"TIROS (MG)";"MG";"TIROS";129;13;6;148
2007;"TOCANTINS (MG)";"MG";"TOCANTINS";176;4;8;188
2007;"TOCOS DO MOJI (MG)";"MG";"TOCOS DO MOJI";34;8;6;48
2007;"TOLEDO (MG)";"MG";"TOLEDO";47;3;7;57
2007;"TOMBOS (MG)";"MG";"TOMBOS";88;15;15;118
2007;"TRES CORACOES (MG)";"MG";"TRES CORACOES";828;76;119;1023
2007;"TRES MARIAS (MG)";"MG";"TRES MARIAS";300;29;75;404
2007;"TRES PONTAS (MG)";"MG";"TRES PONTAS";707;53;119;879
2007;"TUMIRITINGA (MG)";"MG";"TUMIRITINGA";22;4;2;28
2007;"TUPACIGUARA (MG)";"MG";"TUPACIGUARA";383;40;50;473
2007;"TURMALINA (MG)";"MG";"TURMALINA";231;16;44;291
2007;"TURVOLANDIA (MG)";"MG";"TURVOLANDIA";73;14;3;90
2007;"UBA (MG)";"MG";"UBA";1400;52;91;1543
2007;"UBAI (MG)";"MG";"UBAI";22;4;13;39
2007;"UBAPORANGA (MG)";"MG";"UBAPORANGA";113;4;13;130
2007;"UBERABA (MG)";"MG";"UBERABA";3410;587;588;4585
2007;"UBERLANDIA (MG)";"MG";"UBERLANDIA";8598;778;1042;10418
2007;"UMBURATIBA (MG)";"MG";"UMBURATIBA";8;1;1;10
2007;"UNAI (MG)";"MG";"UNAI";1124;49;257;1430
2007;"UNIAO DE MINAS (MG)";"MG";"UNIAO DE MINAS";34;5;21;60
2007;"URUANA DE MINAS (MG)";"MG";"URUANA DE MINAS";12;1;8;21
2007;"URUCANIA (MG)";"MG";"URUCANIA";127;4;30;161
2007;"URUCUIA (MG)";"MG";"URUCUIA";44;3;16;63
2007;"VARGEM ALEGRE (MG)";"MG";"VARGEM ALEGRE";47;5;9;61
2007;"VARGEM BONITA (MG)";"MG";"VARGEM BONITA";15;4;3;22
2007;"VARGEM GRANDE DO RIO PARDO (MG)";"MG";"VARGEM GRANDE DO RIO PARDO";26;3;7;36
2007;"VARGINHA (MG)";"MG";"VARGINHA";1640;83;204;1927
2007;"VARJAO DE MINAS (MG)";"MG";"VARJAO DE MINAS";83;7;35;125
2007;"VARZEA DA PALMA (MG)";"MG";"VARZEA DA PALMA";381;12;56;449
2007;"VARZELANDIA (MG)";"MG";"VARZELANDIA";38;5;22;65
2007;"VAZANTE (MG)";"MG";"VAZANTE";276;28;77;381
2007;"VERDELANDIA (MG)";"MG";"VERDELANDIA";11;2;5;18
2007;"VEREDINHA (MG)";"MG";"VEREDINHA";25;4;14;43
2007;"VERISSIMO (MG)";"MG";"VERISSIMO";33;20;4;57
2007;"VERMELHO NOVO (MG)";"MG";"VERMELHO NOVO";51;4;16;71
2007;"VESPASIANO (MG)";"MG";"VESPASIANO";485;77;113;675
2007;"VICOSA (MG)";"MG";"VICOSA";543;90;145;778
2007;"VIEIRAS (MG)";"MG";"VIEIRAS";23;5;3;31
2007;"VIRGEM DA LAPA (MG)";"MG";"VIRGEM DA LAPA";42;7;17;66
2007;"VIRGINIA (MG)";"MG";"VIRGINIA";92;13;4;109
2007;"VIRGINOPOLIS (MG)";"MG";"VIRGINOPOLIS";79;6;11;96
2007;"VIRGOLANDIA (MG)";"MG";"VIRGOLANDIA";12;5;5;22
2007;"VISCONDE DO RIO BRANCO (MG)";"MG";"VISCONDE DO RIO BRANCO";762;34;61;857
2007;"VOLTA GRANDE (MG)";"MG";"VOLTA GRANDE";34;6;6;46
2007;"WENCESLAU BRAZ (MG)";"MG";"WENCESLAU BRAZ";41;5;4;50
2007;"AGUA CLARA (MS)";"MS";"AGUA CLARA";356;8;48;412
2007;"ALCINOPOLIS (MS)";"MS";"ALCINOPOLIS";63;7;11;81
2007;"AMAMBAI (MS)";"MS";"AMAMBAI";586;10;33;629
2007;"ANASTACIO (MS)";"MS";"ANASTACIO";277;10;15;302
2007;"ANAURILANDIA (MS)";"MS";"ANAURILANDIA";78;11;29;118
2007;"ANGELICA (MS)";"MS";"ANGELICA";157;3;34;194
2007;"ANTONIO JOAO (MS)";"MS";"ANTONIO JOAO";90;1;11;102
2007;"APARECIDA DO TABOADO (MS)";"MS";"APARECIDA DO TABOADO";300;21;38;359
2007;"AQUIDAUANA (MS)";"MS";"AQUIDAUANA";285;21;46;352
2007;"ARAL MOREIRA (MS)";"MS";"ARAL MOREIRA";150;9;14;173
2007;"BANDEIRANTES (MS)";"MS";"BANDEIRANTES";94;3;13;110
2007;"BATAGUASSU (MS)";"MS";"BATAGUASSU";475;14;124;613
2007;"BATAYPORA (MS)";"MS";"BATAYPORA";134;5;27;166
2007;"BELA VISTA (MS)";"MS";"BELA VISTA";162;16;23;201
2007;"BODOQUENA (MS)";"MS";"BODOQUENA";73;6;22;101
2007;"BONITO (MS)";"MS";"BONITO";200;38;41;279
2007;"BRASILANDIA (MS)";"MS";"BRASILANDIA";199;12;57;268
2007;"CAARAPO (MS)";"MS";"CAARAPO";397;10;64;471
2007;"CAMAPUA (MS)";"MS";"CAMAPUA";271;20;18;309
2007;"CAMPO GRANDE (MS)";"MS";"CAMPO GRANDE";10445;589;1416;12450
2007;"CARACOL (MS)";"MS";"CARACOL";28;11;5;44
2007;"CASSILANDIA (MS)";"MS";"CASSILANDIA";425;11;26;462
2007;"CHAPADAO DO SUL (MS)";"MS";"CHAPADAO DO SUL";528;9;46;583
2007;"CORGUINHO (MS)";"MS";"CORGUINHO";45;4;14;63
2007;"CORONEL SAPUCAIA (MS)";"MS";"CORONEL SAPUCAIA";210;1;13;224
2007;"CORUMBA (MS)";"MS";"CORUMBA";621;35;140;796
2007;"COSTA RICA (MS)";"MS";"COSTA RICA";388;6;36;430
2007;"COXIM (MS)";"MS";"COXIM";458;9;50;517
2007;"DEODAPOLIS (MS)";"MS";"DEODAPOLIS";184;9;48;241
2007;"DOIS IRMAOS DO BURITI (MS)";"MS";"DOIS IRMAOS DO BURITI";81;12;20;113
2007;"DOURADINA (MS)";"MS";"DOURADINA";188;2;13;203
2007;"DOURADOS (MS)";"MS";"DOURADOS";3098;142;234;3474
2007;"ELDORADO (MS)";"MS";"ELDORADO";230;5;18;253
2007;"FATIMA DO SUL (MS)";"MS";"FATIMA DO SUL";371;3;20;394
2007;"FIGUEIRAO (MS)";"MS";"FIGUEIRAO";20;13;4;37
2007;"GLORIA DE DOURADOS (MS)";"MS";"GLORIA DE DOURADOS";164;2;20;186
2007;"GUIA LOPES DA LAGUNA (MS)";"MS";"GUIA LOPES DA LAGUNA";111;10;25;146
2007;"IGUATEMI (MS)";"MS";"IGUATEMI";198;3;33;234
2007;"INOCENCIA (MS)";"MS";"INOCENCIA";148;2;18;168
2007;"ITAPORA (MS)";"MS";"ITAPORA";312;9;38;359
2007;"ITAQUIRAI (MS)";"MS";"ITAQUIRAI";155;5;55;215
2007;"IVINHEMA (MS)";"MS";"IVINHEMA";421;5;169;595
2007;"JAPORA (MS)";"MS";"JAPORA";9;3;8;20
2007;"JARAGUARI (MS)";"MS";"JARAGUARI";68;2;16;86
2007;"JARDIM (MS)";"MS";"JARDIM";362;17;24;403
2007;"JATEI (MS)";"MS";"JATEI";27;4;13;44
2007;"JUTI (MS)";"MS";"JUTI";38;3;13;54
2007;"LADARIO (MS)";"MS";"LADARIO";156;18;65;239
2007;"LAGUNA CARAPA (MS)";"MS";"LAGUNA CARAPA";137;2;19;158
2007;"MARACAJU (MS)";"MS";"MARACAJU";728;10;116;854
2007;"MIRANDA (MS)";"MS";"MIRANDA";240;18;46;304
2007;"MUNDO NOVO (MS)";"MS";"MUNDO NOVO";217;14;26;257
2007;"NAVIRAI (MS)";"MS";"NAVIRAI";697;22;131;850
2007;"NIOAQUE (MS)";"MS";"NIOAQUE";101;14;35;150
2007;"NOVA ALVORADA DO SUL (MS)";"MS";"NOVA ALVORADA DO SUL";238;13;72;323
2007;"NOVA ANDRADINA (MS)";"MS";"NOVA ANDRADINA";834;16;149;999
2007;"NOVO HORIZONTE DO SUL (MS)";"MS";"NOVO HORIZONTE DO SUL";60;2;13;75
2007;"PARANAIBA (MS)";"MS";"PARANAIBA";722;12;72;806
2007;"PARANHOS (MS)";"MS";"PARANHOS";77;3;15;95
2007;"PEDRO GOMES (MS)";"MS";"PEDRO GOMES";75;4;9;88
2007;"PONTA PORA (MS)";"MS";"PONTA PORA";1343;34;129;1506
2007;"PORTO MURTINHO (MS)";"MS";"PORTO MURTINHO";45;6;15;66
2007;"RIBAS DO RIO PARDO (MS)";"MS";"RIBAS DO RIO PARDO";475;14;43;532
2007;"RIO BRILHANTE (MS)";"MS";"RIO BRILHANTE";506;18;132;656
2007;"RIO NEGRO (MS)";"MS";"RIO NEGRO";44;5;7;56
2007;"RIO VERDE DE MATO GROSSO (MS)";"MS";"RIO VERDE DE MATO GROSSO";259;8;14;281
2007;"ROCHEDO (MS)";"MS";"ROCHEDO";30;4;7;41
2007;"SANTA RITA DO PARDO (MS)";"MS";"SANTA RITA DO PARDO";102;12;26;140
2007;"SAO GABRIEL DO OESTE (MS)";"MS";"SAO GABRIEL DO OESTE";700;18;35;753
2007;"SELVIRIA (MS)";"MS";"SELVIRIA";74;3;17;94
2007;"SETE QUEDAS (MS)";"MS";"SETE QUEDAS";189;4;18;211
2007;"SIDROLANDIA (MS)";"MS";"SIDROLANDIA";514;35;137;686
2007;"SONORA (MS)";"MS";"SONORA";184;9;70;263
2007;"TACURU (MS)";"MS";"TACURU";96;3;12;111
2007;"TAQUARUSSU (MS)";"MS";"TAQUARUSSU";42;1;9;52
2007;"TERENOS (MS)";"MS";"TERENOS";248;10;25;283
2007;"TRES LAGOAS (MS)";"MS";"TRES LAGOAS";1299;50;278;1627
2007;"VICENTINA (MS)";"MS";"VICENTINA";86;6;45;137
2007;"ACORIZAL (MT)";"MT";"ACORIZAL";14;1;2;17
2007;"AGUA BOA (MT)";"MT";"AGUA BOA";356;6;22;384
2007;"ALTA FLORESTA (MT)";"MT";"ALTA FLORESTA";998;7;63;1068
2007;"ALTO ARAGUAIA (MT)";"MT";"ALTO ARAGUAIA";85;4;16;105
2007;"ALTO BOA VISTA (MT)";"MT";"ALTO BOA VISTA";15;0;2;17
2007;"ALTO GARCAS (MT)";"MT";"ALTO GARCAS";224;3;26;253
2007;"ALTO PARAGUAI (MT)";"MT";"ALTO PARAGUAI";20;6;1;27
2007;"ALTO TAQUARI (MT)";"MT";"ALTO TAQUARI";120;6;8;134
2007;"APIACAS (MT)";"MT";"APIACAS";78;4;2;84
2007;"ARAGUAIANA (MT)";"MT";"ARAGUAIANA";11;0;1;12
2007;"ARAGUAINHA (MT)";"MT";"ARAGUAINHA";7;1;0;8
2007;"ARAPUTANGA (MT)";"MT";"ARAPUTANGA";219;7;18;244
2007;"ARENAPOLIS (MT)";"MT";"ARENAPOLIS";169;8;38;215
2007;"ARIPUANA (MT)";"MT";"ARIPUANA";245;9;15;269
2007;"BARAO DE MELGACO (MT)";"MT";"BARAO DE MELGACO";6;0;3;9
2007;"BARRA DO BUGRES (MT)";"MT";"BARRA DO BUGRES";445;13;113;571
2007;"BARRA DO GARCAS (MT)";"MT";"BARRA DO GARCAS";727;20;157;904
2007;"BOM JESUS DO ARAGUAIA (MT)";"MT";"BOM JESUS DO ARAGUAIA";13;0;5;18
2007;"BRASNORTE (MT)";"MT";"BRASNORTE";215;3;28;246
2007;"CACERES (MT)";"MT";"CACERES";696;39;235;970
2007;"CAMPINAPOLIS (MT)";"MT";"CAMPINAPOLIS";54;1;12;67
2007;"CAMPO NOVO DO PARECIS (MT)";"MT";"CAMPO NOVO DO PARECIS";567;13;79;659
2007;"CAMPO VERDE (MT)";"MT";"CAMPO VERDE";626;23;69;718
2007;"CAMPOS DE JULIO (MT)";"MT";"CAMPOS DE JULIO";121;5;10;136
2007;"CANABRAVA DO NORTE (MT)";"MT";"CANABRAVA DO NORTE";7;0;3;10
2007;"CANARANA (MT)";"MT";"CANARANA";407;2;23;432
2007;"CARLINDA (MT)";"MT";"CARLINDA";109;0;16;125
2007;"CASTANHEIRA (MT)";"MT";"CASTANHEIRA";90;2;10;102
2007;"CHAPADA DOS GUIMARAES (MT)";"MT";"CHAPADA DOS GUIMARAES";159;15;39;213
2007;"CLAUDIA (MT)";"MT";"CLAUDIA";363;3;15;381
2007;"COCALINHO (MT)";"MT";"COCALINHO";13;1;7;21
2007;"COLIDER (MT)";"MT";"COLIDER";680;17;66;763
2007;"COLNIZA (MT)";"MT";"COLNIZA";157;1;2;160
2007;"COMODORO (MT)";"MT";"COMODORO";330;7;47;384
2007;"CONFRESA (MT)";"MT";"CONFRESA";87;3;22;112
2007;"CONQUISTA D OESTE (MT)";"MT";"CONQUISTA D OESTE";31;1;8;40
2007;"COTRIGUACU (MT)";"MT";"COTRIGUACU";103;1;24;128
2007;"CUIABA (MT)";"MT";"CUIABA";6280;601;1601;8482
2007;"CURVELANDIA (MT)";"MT";"CURVELANDIA";50;0;11;61
2007;"DENISE (MT)";"MT";"DENISE";64;3;23;90
2007;"DIAMANTINO (MT)";"MT";"DIAMANTINO";380;15;50;445
2007;"DOM AQUINO (MT)";"MT";"DOM AQUINO";90;7;13;110
2007;"FELIZ NATAL (MT)";"MT";"FELIZ NATAL";161;4;14;179
2007;"FIGUEIROPOLIS D OESTE (MT)";"MT";"FIGUEIROPOLIS D OESTE";57;2;8;67
2007;"GAUCHA DO NORTE (MT)";"MT";"GAUCHA DO NORTE";33;4;4;41
2007;"GENERAL CARNEIRO (MT)";"MT";"GENERAL CARNEIRO";19;2;3;24
2007;"GLORIA D OESTE (MT)";"MT";"GLORIA D OESTE";34;3;6;43
2007;"GUARANTA DO NORTE (MT)";"MT";"GUARANTA DO NORTE";743;8;46;797
2007;"GUIRATINGA (MT)";"MT";"GUIRATINGA";119;6;6;131
2007;"INDIAVAI (MT)";"MT";"INDIAVAI";19;1;6;26
2007;"IPIRANGA DO NORTE (MT)";"MT";"IPIRANGA DO NORTE";31;1;2;34
2007;"ITANHANGA (MT)";"MT";"ITANHANGA";41;1;5;47
2007;"ITAUBA (MT)";"MT";"ITAUBA";91;5;7;103
2007;"ITIQUIRA (MT)";"MT";"ITIQUIRA";64;5;19;88
2007;"JACIARA (MT)";"MT";"JACIARA";447;28;93;568
2007;"JANGADA (MT)";"MT";"JANGADA";40;5;12;57
2007;"JAURU (MT)";"MT";"JAURU";133;2;24;159
2007;"JUARA (MT)";"MT";"JUARA";581;11;32;624
2007;"JUINA (MT)";"MT";"JUINA";729;5;39;773
2007;"JURUENA (MT)";"MT";"JURUENA";114;1;10;125
2007;"JUSCIMEIRA (MT)";"MT";"JUSCIMEIRA";97;5;39;141
2007;"LAMBARI D OESTE (MT)";"MT";"LAMBARI D OESTE";58;1;20;79
2007;"LUCAS DO RIO VERDE (MT)";"MT";"LUCAS DO RIO VERDE";1045;23;71;1139
2007;"LUCIARA (MT)";"MT";"LUCIARA";8;0;2;10
2007;"MARCELANDIA (MT)";"MT";"MARCELANDIA";309;7;10;326
2007;"MATUPA (MT)";"MT";"MATUPA";302;4;23;329
2007;"MIRASSOL D OESTE (MT)";"MT";"MIRASSOL D OESTE";593;6;54;653
2007;"NOBRES (MT)";"MT";"NOBRES";207;8;40;255
2007;"NORTELANDIA (MT)";"MT";"NORTELANDIA";88;5;14;107
2007;"NOSSA SENHORA DO LIVRAMENTO (MT)";"MT";"NOSSA SENHORA DO LIVRAMENTO";39;3;23;65
2007;"NOVA BANDEIRANTES (MT)";"MT";"NOVA BANDEIRANTES";99;1;14;114
2007;"NOVA BRASILANDIA (MT)";"MT";"NOVA BRASILANDIA";27;1;9;37
2007;"NOVA CANAA DO NORTE (MT)";"MT";"NOVA CANAA DO NORTE";162;1;23;186
2007;"NOVA GUARITA (MT)";"MT";"NOVA GUARITA";73;1;9;83
2007;"NOVA LACERDA (MT)";"MT";"NOVA LACERDA";42;1;15;58
2007;"NOVA MARILANDIA (MT)";"MT";"NOVA MARILANDIA";18;3;5;26
2007;"NOVA MARINGA (MT)";"MT";"NOVA MARINGA";61;0;7;68
2007;"NOVA MONTE VERDE (MT)";"MT";"NOVA MONTE VERDE";65;4;1;70
2007;"NOVA MUTUM (MT)";"MT";"NOVA MUTUM";628;9;30;667
2007;"NOVA NAZARE (MT)";"MT";"NOVA NAZARE";4;2;3;9
2007;"NOVA OLIMPIA (MT)";"MT";"NOVA OLIMPIA";219;17;70;306
2007;"NOVA SANTA HELENA (MT)";"MT";"NOVA SANTA HELENA";46;1;7;54
2007;"NOVA UBIRATA (MT)";"MT";"NOVA UBIRATA";93;7;9;109
2007;"NOVA XAVANTINA (MT)";"MT";"NOVA XAVANTINA";258;9;29;296
2007;"NOVO HORIZONTE DO NORTE (MT)";"MT";"NOVO HORIZONTE DO NORTE";35;0;11;46
2007;"NOVO MUNDO (MT)";"MT";"NOVO MUNDO";68;1;6;75
2007;"NOVO SANTO ANTONIO (MT)";"MT";"NOVO SANTO ANTONIO";2;0;2;4
2007;"NOVO SAO JOAQUIM (MT)";"MT";"NOVO SAO JOAQUIM";36;0;8;44
2007;"PARANAITA (MT)";"MT";"PARANAITA";156;3;17;176
2007;"PARANATINGA (MT)";"MT";"PARANATINGA";311;4;29;344
2007;"PEDRA PRETA (MT)";"MT";"PEDRA PRETA";230;9;25;264
2007;"PEIXOTO DE AZEVEDO (MT)";"MT";"PEIXOTO DE AZEVEDO";238;7;36;281
2007;"PLANALTO DA SERRA (MT)";"MT";"PLANALTO DA SERRA";10;1;3;14
2007;"POCONE (MT)";"MT";"POCONE";265;12;20;297
2007;"PONTAL DO ARAGUAIA (MT)";"MT";"PONTAL DO ARAGUAIA";9;0;0;9
2007;"PONTE BRANCA (MT)";"MT";"PONTE BRANCA";5;1;0;6
2007;"PONTES E LACERDA (MT)";"MT";"PONTES E LACERDA";707;16;66;789
2007;"PORTO ALEGRE DO NORTE (MT)";"MT";"PORTO ALEGRE DO NORTE";26;4;20;50
2007;"PORTO DOS GAUCHOS (MT)";"MT";"PORTO DOS GAUCHOS";91;4;6;101
2007;"PORTO ESPERIDIAO (MT)";"MT";"PORTO ESPERIDIAO";79;4;28;111
2007;"PORTO ESTRELA (MT)";"MT";"PORTO ESTRELA";12;2;4;18
2007;"POXOREO (MT)";"MT";"POXOREO";88;8;25;121
2007;"PRIMAVERA DO LESTE (MT)";"MT";"PRIMAVERA DO LESTE";1341;47;75;1463
2007;"QUERENCIA (MT)";"MT";"QUERENCIA";181;1;11;193
2007;"RESERVA DO CABACAL (MT)";"MT";"RESERVA DO CABACAL";22;0;5;27
2007;"RIBEIRAO CASCALHEIRA (MT)";"MT";"RIBEIRAO CASCALHEIRA";53;1;5;59
2007;"RIBEIRAOZINHO (MT)";"MT";"RIBEIRAOZINHO";6;1;6;13
2007;"RIO BRANCO (MT)";"MT";"RIO BRANCO";89;6;11;106
2007;"RONDOLANDIA (MT)";"MT";"RONDOLANDIA";6;0;4;10
2007;"RONDONOPOLIS (MT)";"MT";"RONDONOPOLIS";3153;111;299;3563
2007;"ROSARIO OESTE (MT)";"MT";"ROSARIO OESTE";104;5;15;124
2007;"SALTO DO CEU (MT)";"MT";"SALTO DO CEU";29;1;6;36
2007;"SANTA CARMEN (MT)";"MT";"SANTA CARMEN";119;4;6;129
2007;"SANTA CRUZ DO XINGU (MT)";"MT";"SANTA CRUZ DO XINGU";3;0;2;5
2007;"SANTA RITA DO TRIVELATO (MT)";"MT";"SANTA RITA DO TRIVELATO";33;1;6;40
2007;"SANTA TEREZINHA (MT)";"MT";"SANTA TEREZINHA";7;1;8;16
2007;"SANTO AFONSO (MT)";"MT";"SANTO AFONSO";25;1;4;30
2007;"SANTO ANTONIO DO LESTE (MT)";"MT";"SANTO ANTONIO DO LESTE";51;1;10;62
2007;"SANTO ANTONIO DO LEVERGER (MT)";"MT";"SANTO ANTONIO DO LEVERGER";47;9;10;66
2007;"SAO FELIX DO ARAGUAIA (MT)";"MT";"SAO FELIX DO ARAGUAIA";29;2;18;49
2007;"SAO JOSE DO POVO (MT)";"MT";"SAO JOSE DO POVO";19;2;5;26
2007;"SAO JOSE DO RIO CLARO (MT)";"MT";"SAO JOSE DO RIO CLARO";243;7;32;282
2007;"SAO JOSE DO XINGU (MT)";"MT";"SAO JOSE DO XINGU";6;0;4;10
2007;"SAO JOSE DOS QUATRO MARCOS (MT)";"MT";"SAO JOSE DOS QUATRO MARCOS";372;7;37;416
2007;"SAO PEDRO DA CIPA (MT)";"MT";"SAO PEDRO DA CIPA";20;3;16;39
2007;"SAPEZAL (MT)";"MT";"SAPEZAL";336;4;24;364
2007;"SERRA NOVA DOURADA (MT)";"MT";"SERRA NOVA DOURADA";5;0;1;6
2007;"SINOP (MT)";"MT";"SINOP";2509;30;111;2650
2007;"SORRISO (MT)";"MT";"SORRISO";1641;28;98;1767
2007;"TABAPORA (MT)";"MT";"TABAPORA";84;3;15;102
2007;"TANGARA DA SERRA (MT)";"MT";"TANGARA DA SERRA";1630;63;177;1870
2007;"TAPURAH (MT)";"MT";"TAPURAH";254;7;15;276
2007;"TERRA NOVA DO NORTE (MT)";"MT";"TERRA NOVA DO NORTE";226;7;19;252
2007;"TESOURO (MT)";"MT";"TESOURO";7;0;3;10
2007;"TORIXOREU (MT)";"MT";"TORIXOREU";12;1;3;16
2007;"UNIAO DO SUL (MT)";"MT";"UNIAO DO SUL";76;0;3;79
2007;"VALE DE SAO DOMINGOS (MT)";"MT";"VALE DE SAO DOMINGOS";15;1;7;23
2007;"VARZEA GRANDE (MT)";"MT";"VARZEA GRANDE";3479;196;374;4049
2007;"VERA (MT)";"MT";"VERA";244;4;14;262
2007;"VILA BELA DA SANTISSIMA TRINDA (MT)";"MT";"VILA BELA DA SANTISSIMA TRINDA";70;2;20;92
2007;"VILA RICA (MT)";"MT";"VILA RICA";166;3;17;186
2007;"ABAETETUBA (PA)";"PA";"ABAETETUBA";197;13;127;337
2007;"ABEL FIGUEIREDO (PA)";"PA";"ABEL FIGUEIREDO";28;5;3;36
2007;"ACARA (PA)";"PA";"ACARA";52;2;19;73
2007;"AFUA (PA)";"PA";"AFUA";2;0;0;2
2007;"AGUA AZUL DO NORTE (PA)";"PA";"AGUA AZUL DO NORTE";31;4;5;40
2007;"ALENQUER (PA)";"PA";"ALENQUER";97;2;26;125
2007;"ALMEIRIM (PA)";"PA";"ALMEIRIM";169;8;73;250
2007;"ALTAMIRA (PA)";"PA";"ALTAMIRA";757;94;42;893
2007;"ANAJAS (PA)";"PA";"ANAJAS";0;0;0;0
2007;"ANANINDEUA (PA)";"PA";"ANANINDEUA";3054;260;968;4282
2007;"ANAPU (PA)";"PA";"ANAPU";30;8;2;40
2007;"AUGUSTO CORREA (PA)";"PA";"AUGUSTO CORREA";29;3;30;62
2007;"AURORA DO PARA (PA)";"PA";"AURORA DO PARA";40;0;39;79
2007;"AVEIRO (PA)";"PA";"AVEIRO";2;0;0;2
2007;"BAGRE (PA)";"PA";"BAGRE";1;0;0;1
2007;"BAIAO (PA)";"PA";"BAIAO";26;0;3;29
2007;"BANNACH (PA)";"PA";"BANNACH";12;0;0;12
2007;"BARCARENA (PA)";"PA";"BARCARENA";553;133;445;1131
2007;"BELEM (PA)";"PA";"BELEM";6503;1042;2265;9810
2007;"BELTERRA (PA)";"PA";"BELTERRA";24;2;8;34
2007;"BENEVIDES (PA)";"PA";"BENEVIDES";325;14;69;408
2007;"BOM JESUS DO TOCANTINS (PA)";"PA";"BOM JESUS DO TOCANTINS";46;13;4;63
2007;"BONITO (PA)";"PA";"BONITO";21;0;26;47
2007;"BRAGANCA (PA)";"PA";"BRAGANCA";285;22;122;429
2007;"BRASIL NOVO (PA)";"PA";"BRASIL NOVO";92;26;2;120
2007;"BREJO GRANDE DO ARAGUAIA (PA)";"PA";"BREJO GRANDE DO ARAGUAIA";8;6;4;18
2007;"BREU BRANCO (PA)";"PA";"BREU BRANCO";205;9;36;250
2007;"BREVES (PA)";"PA";"BREVES";11;0;4;15
2007;"BUJARU (PA)";"PA";"BUJARU";24;2;5;31
2007;"CACHOEIRA DO ARARI (PA)";"PA";"CACHOEIRA DO ARARI";4;2;6;12
2007;"CACHOEIRA DO PIRIA (PA)";"PA";"CACHOEIRA DO PIRIA";16;2;10;28
2007;"CAMETA (PA)";"PA";"CAMETA";68;1;29;98
2007;"CANAA DOS CARAJAS (PA)";"PA";"CANAA DOS CARAJAS";147;35;64;246
2007;"CAPANEMA (PA)";"PA";"CAPANEMA";527;15;85;627
2007;"CAPITAO POCO (PA)";"PA";"CAPITAO POCO";248;11;42;301
2007;"CASTANHAL (PA)";"PA";"CASTANHAL";1865;113;246;2224
2007;"CHAVES (PA)";"PA";"CHAVES";0;0;0;0
2007;"COLARES (PA)";"PA";"COLARES";3;1;0;4
2007;"CONCEICAO DO ARAGUAIA (PA)";"PA";"CONCEICAO DO ARAGUAIA";265;19;57;341
2007;"CONCORDIA DO PARA (PA)";"PA";"CONCORDIA DO PARA";80;0;19;99
2007;"CUMARU DO NORTE (PA)";"PA";"CUMARU DO NORTE";9;0;4;13
2007;"CURIONOPOLIS (PA)";"PA";"CURIONOPOLIS";51;72;2;125
2007;"CURRALINHO (PA)";"PA";"CURRALINHO";1;0;1;2
2007;"CURUA (PA)";"PA";"CURUA";0;0;0;0
2007;"CURUCA (PA)";"PA";"CURUCA";41;3;10;54
2007;"DOM ELISEU (PA)";"PA";"DOM ELISEU";408;30;20;458
2007;"ELDORADO DOS CARAJAS (PA)";"PA";"ELDORADO DOS CARAJAS";87;18;4;109
2007;"FARO (PA)";"PA";"FARO";2;1;0;3
2007;"FLORESTA DO ARAGUAIA (PA)";"PA";"FLORESTA DO ARAGUAIA";57;2;2;61
2007;"GARRAFAO DO NORTE (PA)";"PA";"GARRAFAO DO NORTE";51;3;8;62
2007;"GOIANESIA DO PARA (PA)";"PA";"GOIANESIA DO PARA";222;9;18;249
2007;"GURUPA (PA)";"PA";"GURUPA";2;0;0;2
2007;"IGARAPE ACU (PA)";"PA";"IGARAPE ACU";97;45;43;185
2007;"IGARAPE MIRI (PA)";"PA";"IGARAPE MIRI";47;8;16;71
2007;"INHANGAPI (PA)";"PA";"INHANGAPI";21;0;20;41
2007;"IPIXUNA DO PARA (PA)";"PA";"IPIXUNA DO PARA";65;2;10;77
2007;"IRITUIA (PA)";"PA";"IRITUIA";42;3;26;71
2007;"ITAITUBA (PA)";"PA";"ITAITUBA";512;30;41;583
2007;"ITUPIRANGA (PA)";"PA";"ITUPIRANGA";105;69;12;186
2007;"JACAREACANGA (PA)";"PA";"JACAREACANGA";7;0;0;7
2007;"JACUNDA (PA)";"PA";"JACUNDA";488;15;28;531
2007;"JURUTI (PA)";"PA";"JURUTI";20;2;0;22
2007;"LIMOEIRO DO AJURU (PA)";"PA";"LIMOEIRO DO AJURU";0;0;0;0
2007;"MAE DO RIO (PA)";"PA";"MAE DO RIO";243;9;40;292
2007;"MAGALHAES BARATA (PA)";"PA";"MAGALHAES BARATA";9;1;4;14
2007;"MARABA (PA)";"PA";"MARABA";2409;149;314;2872
2007;"MARACANA (PA)";"PA";"MARACANA";13;10;8;31
2007;"MARAPANIM (PA)";"PA";"MARAPANIM";27;8;14;49
2007;"MARITUBA (PA)";"PA";"MARITUBA";486;60;160;706
2007;"MEDICILANDIA (PA)";"PA";"MEDICILANDIA";132;9;10;151
2007;"MELGACO (PA)";"PA";"MELGACO";1;0;0;1
2007;"MOCAJUBA (PA)";"PA";"MOCAJUBA";9;1;6;16
2007;"MOJU (PA)";"PA";"MOJU";98;6;86;190
2007;"MONTE ALEGRE (PA)";"PA";"MONTE ALEGRE";170;3;80;253
2007;"MUANA (PA)";"PA";"MUANA";0;1;0;1
2007;"NOVA ESPERANCA DO PIRIA (PA)";"PA";"NOVA ESPERANCA DO PIRIA";39;2;8;49
2007;"NOVA IPIXUNA (PA)";"PA";"NOVA IPIXUNA";111;2;19;132
2007;"NOVA TIMBOTEUA (PA)";"PA";"NOVA TIMBOTEUA";32;6;9;47
2007;"NOVO PROGRESSO (PA)";"PA";"NOVO PROGRESSO";79;1;7;87
2007;"NOVO REPARTIMENTO (PA)";"PA";"NOVO REPARTIMENTO";235;15;16;266
2007;"OBIDOS (PA)";"PA";"OBIDOS";119;0;23;142
2007;"OEIRAS DO PARA (PA)";"PA";"OEIRAS DO PARA";4;1;0;5
2007;"ORIXIMINA (PA)";"PA";"ORIXIMINA";210;6;14;230
2007;"OUREM (PA)";"PA";"OUREM";60;1;13;74
2007;"OURILANDIA DO NORTE (PA)";"PA";"OURILANDIA DO NORTE";71;2;5;78
2007;"PACAJA (PA)";"PA";"PACAJA";74;4;2;80
2007;"PALESTINA DO PARA (PA)";"PA";"PALESTINA DO PARA";13;8;1;22
2007;"PARAGOMINAS (PA)";"PA";"PARAGOMINAS";968;14;88;1070
2007;"PARAUAPEBAS (PA)";"PA";"PARAUAPEBAS";783;418;112;1313
2007;"PAU D ARCO (PA)";"PA";"PAU D ARCO";9;5;0;14
2007;"PEIXE BOI (PA)";"PA";"PEIXE BOI";17;0;10;27
2007;"PICARRA (PA)";"PA";"PICARRA";8;1;2;11
2007;"PLACAS (PA)";"PA";"PLACAS";27;1;1;29
2007;"PONTA DE PEDRAS (PA)";"PA";"PONTA DE PEDRAS";2;0;0;2
2007;"PORTEL (PA)";"PA";"PORTEL";11;0;0;11
2007;"PORTO DE MOZ (PA)";"PA";"PORTO DE MOZ";9;0;0;9
2007;"PRAINHA (PA)";"PA";"PRAINHA";11;0;1;12
2007;"PRIMAVERA (PA)";"PA";"PRIMAVERA";9;0;6;15
2007;"QUATIPURU (PA)";"PA";"QUATIPURU";3;1;12;16
2007;"REDENCAO (PA)";"PA";"REDENCAO";699;44;63;806
2007;"RIO MARIA (PA)";"PA";"RIO MARIA";163;39;11;213
2007;"RONDON DO PARA (PA)";"PA";"RONDON DO PARA";371;33;12;416
2007;"RUROPOLIS (PA)";"PA";"RUROPOLIS";113;3;8;124
2007;"SALINOPOLIS (PA)";"PA";"SALINOPOLIS";98;13;35;146
2007;"SALVATERRA (PA)";"PA";"SALVATERRA";16;13;13;42
2007;"SANTA BARBARA DO PARA (PA)";"PA";"SANTA BARBARA DO PARA";33;7;18;58
2007;"SANTA CRUZ DO ARARI (PA)";"PA";"SANTA CRUZ DO ARARI";1;0;0;1
2007;"SANTA ISABEL DO PARA (PA)";"PA";"SANTA ISABEL DO PARA";417;16;93;526
2007;"SANTA LUZIA DO PARA (PA)";"PA";"SANTA LUZIA DO PARA";73;6;27;106
2007;"SANTA MARIA DAS BARREIRAS (PA)";"PA";"SANTA MARIA DAS BARREIRAS";21;0;6;27
2007;"SANTA MARIA DO PARA (PA)";"PA";"SANTA MARIA DO PARA";166;23;35;224
2007;"SANTANA DO ARAGUAIA (PA)";"PA";"SANTANA DO ARAGUAIA";88;10;11;109
2007;"SANTAREM (PA)";"PA";"SANTAREM";1772;59;433;2264
2007;"SANTAREM NOVO (PA)";"PA";"SANTAREM NOVO";6;1;6;13
2007;"SANTO ANTONIO DO TAUA (PA)";"PA";"SANTO ANTONIO DO TAUA";73;28;75;176
2007;"SAO CAETANO DE ODIVELAS (PA)";"PA";"SAO CAETANO DE ODIVELAS";14;0;1;15
2007;"SAO DOMINGOS DO ARAGUAIA (PA)";"PA";"SAO DOMINGOS DO ARAGUAIA";90;22;13;125
2007;"SAO DOMINGOS DO CAPIM (PA)";"PA";"SAO DOMINGOS DO CAPIM";37;1;12;50
2007;"SAO FELIX DO XINGU (PA)";"PA";"SAO FELIX DO XINGU";104;3;8;115
2007;"SAO FRANCISCO DO PARA (PA)";"PA";"SAO FRANCISCO DO PARA";19;34;18;71
2007;"SAO GERALDO DO ARAGUAIA (PA)";"PA";"SAO GERALDO DO ARAGUAIA";77;7;11;95
2007;"SAO JOAO DA PONTA (PA)";"PA";"SAO JOAO DA PONTA";2;3;5;10
2007;"SAO JOAO DE PIRABAS (PA)";"PA";"SAO JOAO DE PIRABAS";14;7;5;26
2007;"SAO JOAO DO ARAGUAIA (PA)";"PA";"SAO JOAO DO ARAGUAIA";9;14;7;30
2007;"SAO MIGUEL DO GUAMA (PA)";"PA";"SAO MIGUEL DO GUAMA";291;14;54;359
2007;"SAO SEBASTIAO DA BOA VISTA (PA)";"PA";"SAO SEBASTIAO DA BOA VISTA";0;0;0;0
2007;"SAPUCAIA (PA)";"PA";"SAPUCAIA";17;2;3;22
2007;"SENADOR JOSE PORFIRIO (PA)";"PA";"SENADOR JOSE PORFIRIO";12;0;0;12
2007;"SOURE (PA)";"PA";"SOURE";23;2;7;32
2007;"TAILANDIA (PA)";"PA";"TAILANDIA";441;19;31;491
2007;"TERRA ALTA (PA)";"PA";"TERRA ALTA";12;10;11;33
2007;"TERRA SANTA (PA)";"PA";"TERRA SANTA";6;1;1;8
2007;"TOME ACU (PA)";"PA";"TOME ACU";303;7;59;369
2007;"TRACUATEUA (PA)";"PA";"TRACUATEUA";17;3;15;35
2007;"TRAIRAO (PA)";"PA";"TRAIRAO";58;1;1;60
2007;"TUCUMA (PA)";"PA";"TUCUMA";297;10;29;336
2007;"TUCURUI (PA)";"PA";"TUCURUI";558;72;110;740
2007;"ULIANOPOLIS (PA)";"PA";"ULIANOPOLIS";128;14;16;158
2007;"URUARA (PA)";"PA";"URUARA";320;6;11;337
2007;"VIGIA (PA)";"PA";"VIGIA";84;3;51;138
2007;"VISEU (PA)";"PA";"VISEU";38;4;20;62
2007;"VITORIA DO XINGU (PA)";"PA";"VITORIA DO XINGU";8;14;5;27
2007;"XINGUARA (PA)";"PA";"XINGUARA";529;27;66;622
2007;"AGUA BRANCA (PB)";"PB";"AGUA BRANCA";9;2;2;13
2007;"AGUIAR (PB)";"PB";"AGUIAR";5;2;1;8
2007;"ALAGOA GRANDE (PB)";"PB";"ALAGOA GRANDE";84;14;20;118
2007;"ALAGOA NOVA (PB)";"PB";"ALAGOA NOVA";81;52;8;141
2007;"ALAGOINHA (PB)";"PB";"ALAGOINHA";40;5;15;60
2007;"ALCANTIL (PB)";"PB";"ALCANTIL";28;12;7;47
2007;"ALGODAO DE JANDAIRA (PB)";"PB";"ALGODAO DE JANDAIRA";14;0;2;16
2007;"ALHANDRA (PB)";"PB";"ALHANDRA";72;14;11;97
2007;"AMPARO (PB)";"PB";"AMPARO";2;1;3;6
2007;"APARECIDA (PB)";"PB";"APARECIDA";26;3;4;33
2007;"ARACAGI (PB)";"PB";"ARACAGI";43;0;22;65
2007;"ARARA (PB)";"PB";"ARARA";33;3;11;47
2007;"ARARUNA (PB)";"PB";"ARARUNA";62;13;12;87
2007;"AREIA (PB)";"PB";"AREIA";95;11;10;116
2007;"AREIA DE BARAUNAS (PB)";"PB";"AREIA DE BARAUNAS";3;1;1;5
2007;"AREIAL (PB)";"PB";"AREIAL";13;3;3;19
2007;"AROEIRAS (PB)";"PB";"AROEIRAS";28;4;7;39
2007;"ASSUNCAO (PB)";"PB";"ASSUNCAO";9;6;3;18
2007;"BAIA DA TRAICAO (PB)";"PB";"BAIA DA TRAICAO";6;3;7;16
2007;"BANANEIRAS (PB)";"PB";"BANANEIRAS";58;6;22;86
2007;"BARAUNA (PB)";"PB";"BARAUNA";11;0;2;13
2007;"BARRA DE SANTA ROSA (PB)";"PB";"BARRA DE SANTA ROSA";44;3;8;55
2007;"BARRA DE SANTANA (PB)";"PB";"BARRA DE SANTANA";50;3;4;57
2007;"BARRA DE SAO MIGUEL (PB)";"PB";"BARRA DE SAO MIGUEL";1;0;1;2
2007;"BAYEUX (PB)";"PB";"BAYEUX";392;23;117;532
2007;"BELEM (PB)";"PB";"BELEM";81;9;10;100
2007;"BELEM DO BREJO DO CRUZ (PB)";"PB";"BELEM DO BREJO DO CRUZ";8;10;1;19
2007;"BERNARDINO BATISTA (PB)";"PB";"BERNARDINO BATISTA";1;0;1;2
2007;"BOA VENTURA (PB)";"PB";"BOA VENTURA";5;1;0;6
2007;"BOA VISTA (PB)";"PB";"BOA VISTA";75;4;9;88
2007;"BOM JESUS (PB)";"PB";"BOM JESUS";4;4;0;8
2007;"BOM SUCESSO (PB)";"PB";"BOM SUCESSO";4;1;3;8
2007;"BONITO DE SANTA FE (PB)";"PB";"BONITO DE SANTA FE";22;4;0;26
2007;"BOQUEIRAO (PB)";"PB";"BOQUEIRAO";138;2;13;153
2007;"BORBOREMA (PB)";"PB";"BORBOREMA";17;7;0;24
2007;"BREJO DO CRUZ (PB)";"PB";"BREJO DO CRUZ";42;9;3;54
2007;"BREJO DOS SANTOS (PB)";"PB";"BREJO DOS SANTOS";13;2;0;15
2007;"CAAPORA (PB)";"PB";"CAAPORA";14;8;2;24
2007;"CABACEIRAS (PB)";"PB";"CABACEIRAS";16;5;11;32
2007;"CABEDELO (PB)";"PB";"CABEDELO";257;16;18;291
2007;"CACHOEIRA DOS INDIOS (PB)";"PB";"CACHOEIRA DOS INDIOS";8;0;2;10
2007;"CACIMBA DE AREIA (PB)";"PB";"CACIMBA DE AREIA";5;0;3;8
2007;"CACIMBA DE DENTRO (PB)";"PB";"CACIMBA DE DENTRO";32;5;27;64
2007;"CACIMBAS (PB)";"PB";"CACIMBAS";2;2;2;6
2007;"CAICARA (PB)";"PB";"CAICARA";13;1;4;18
2007;"CAJAZEIRAS (PB)";"PB";"CAJAZEIRAS";422;17;35;474
2007;"CAJAZEIRINHAS (PB)";"PB";"CAJAZEIRINHAS";5;3;0;8
2007;"CALDAS BRANDAO (PB)";"PB";"CALDAS BRANDAO";13;3;4;20
2007;"CAMALAU (PB)";"PB";"CAMALAU";14;4;7;25
2007;"CAMPINA GRANDE (PB)";"PB";"CAMPINA GRANDE";3768;188;634;4590
2007;"CAPIM (PB)";"PB";"CAPIM";8;0;5;13
2007;"CARAUBAS (PB)";"PB";"CARAUBAS";5;3;1;9
2007;"CARRAPATEIRA (PB)";"PB";"CARRAPATEIRA";0;2;0;2
2007;"CASSERENGUE (PB)";"PB";"CASSERENGUE";15;0;12;27
2007;"CATINGUEIRA (PB)";"PB";"CATINGUEIRA";8;1;1;10
2007;"CATOLE DO ROCHA (PB)";"PB";"CATOLE DO ROCHA";208;21;12;241
2007;"CATURITE (PB)";"PB";"CATURITE";55;6;7;68
2007;"CONCEICAO (PB)";"PB";"CONCEICAO";59;9;6;74
2007;"CONDADO (PB)";"PB";"CONDADO";19;3;2;24
2007;"CONDE (PB)";"PB";"CONDE";45;8;6;59
2007;"CONGO (PB)";"PB";"CONGO";10;1;1;12
2007;"COREMAS (PB)";"PB";"COREMAS";30;4;4;38
2007;"COXIXOLA (PB)";"PB";"COXIXOLA";1;3;0;4
2007;"CRUZ DO ESPIRITO SANTO (PB)";"PB";"CRUZ DO ESPIRITO SANTO";17;4;8;29
2007;"CUBATI (PB)";"PB";"CUBATI";18;2;0;20
2007;"CUITE (PB)";"PB";"CUITE";68;1;7;76
2007;"CUITE DE MAMANGUAPE (PB)";"PB";"CUITE DE MAMANGUAPE";9;5;15;29
2007;"CUITEGI (PB)";"PB";"CUITEGI";10;0;1;11
2007;"CURRAL DE CIMA (PB)";"PB";"CURRAL DE CIMA";13;2;9;24
2007;"CURRAL VELHO (PB)";"PB";"CURRAL VELHO";4;0;2;6
2007;"DAMIAO (PB)";"PB";"DAMIAO";12;4;4;20
2007;"DESTERRO (PB)";"PB";"DESTERRO";23;4;2;29
2007;"DIAMANTE (PB)";"PB";"DIAMANTE";9;1;0;10
2007;"DONA INES (PB)";"PB";"DONA INES";14;2;12;28
2007;"DUAS ESTRADAS (PB)";"PB";"DUAS ESTRADAS";5;3;2;10
2007;"EMAS (PB)";"PB";"EMAS";2;1;2;5
2007;"ESPERANCA (PB)";"PB";"ESPERANCA";308;11;63;382
2007;"FAGUNDES (PB)";"PB";"FAGUNDES";26;3;12;41
2007;"FREI MARTINHO (PB)";"PB";"FREI MARTINHO";6;0;3;9
2007;"GADO BRAVO (PB)";"PB";"GADO BRAVO";22;3;4;29
2007;"GUARABIRA (PB)";"PB";"GUARABIRA";379;31;112;522
2007;"GURINHEM (PB)";"PB";"GURINHEM";26;2;15;43
2007;"GURJAO (PB)";"PB";"GURJAO";11;2;1;14
2007;"IBIARA (PB)";"PB";"IBIARA";6;2;1;9
2007;"IGARACY (PB)";"PB";"IGARACY";12;6;2;20
2007;"IMACULADA (PB)";"PB";"IMACULADA";10;2;1;13
2007;"INGA (PB)";"PB";"INGA";91;7;20;118
2007;"ITABAIANA (PB)";"PB";"ITABAIANA";155;9;29;193
2007;"ITAPORANGA (PB)";"PB";"ITAPORANGA";70;23;8;101
2007;"ITAPOROROCA (PB)";"PB";"ITAPOROROCA";61;3;11;75
2007;"ITATUBA (PB)";"PB";"ITATUBA";20;1;4;25
2007;"JACARAU (PB)";"PB";"JACARAU";33;3;8;44
2007;"JERICO (PB)";"PB";"JERICO";20;2;0;22
2007;"JOAO PESSOA (PB)";"PB";"JOAO PESSOA";3798;558;916;5272
2007;"JUAREZ TAVORA (PB)";"PB";"JUAREZ TAVORA";17;3;9;29
2007;"JUAZEIRINHO (PB)";"PB";"JUAZEIRINHO";44;12;4;60
2007;"JUNCO DO SERIDO (PB)";"PB";"JUNCO DO SERIDO";37;3;4;44
2007;"JURIPIRANGA (PB)";"PB";"JURIPIRANGA";27;3;13;43
2007;"JURU (PB)";"PB";"JURU";9;5;0;14
2007;"LAGOA (PB)";"PB";"LAGOA";12;2;3;17
2007;"LAGOA DE DENTRO (PB)";"PB";"LAGOA DE DENTRO";19;1;5;25
2007;"LAGOA SECA (PB)";"PB";"LAGOA SECA";123;28;12;163
2007;"LASTRO (PB)";"PB";"LASTRO";7;1;0;8
2007;"LIVRAMENTO (PB)";"PB";"LIVRAMENTO";31;3;1;35
2007;"LOGRADOURO (PB)";"PB";"LOGRADOURO";1;2;5;8
2007;"LUCENA (PB)";"PB";"LUCENA";15;1;7;23
2007;"MAE D AGUA (PB)";"PB";"MAE D AGUA";1;1;4;6
2007;"MALTA (PB)";"PB";"MALTA";5;3;2;10
2007;"MAMANGUAPE (PB)";"PB";"MAMANGUAPE";282;7;60;349
2007;"MANAIRA (PB)";"PB";"MANAIRA";10;1;1;12
2007;"MARCACAO (PB)";"PB";"MARCACAO";0;3;6;9
2007;"MARI (PB)";"PB";"MARI";66;4;29;99
2007;"MARIZOPOLIS (PB)";"PB";"MARIZOPOLIS";16;5;1;22
2007;"MASSARANDUBA (PB)";"PB";"MASSARANDUBA";16;2;5;23
2007;"MATARACA (PB)";"PB";"MATARACA";27;1;9;37
2007;"MATINHAS (PB)";"PB";"MATINHAS";6;1;1;8
2007;"MATO GROSSO (PB)";"PB";"MATO GROSSO";6;1;1;8
2007;"MATUREIA (PB)";"PB";"MATUREIA";13;5;2;20
2007;"MOGEIRO (PB)";"PB";"MOGEIRO";21;3;3;27
2007;"MONTADAS (PB)";"PB";"MONTADAS";15;0;5;20
2007;"MONTE HOREBE (PB)";"PB";"MONTE HOREBE";4;1;2;7
2007;"MONTEIRO (PB)";"PB";"MONTEIRO";188;49;33;270
2007;"MULUNGU (PB)";"PB";"MULUNGU";23;2;8;33
2007;"NATUBA (PB)";"PB";"NATUBA";12;1;0;13
2007;"NAZAREZINHO (PB)";"PB";"NAZAREZINHO";18;4;2;24
2007;"NOVA FLORESTA (PB)";"PB";"NOVA FLORESTA";25;4;5;34
2007;"NOVA OLINDA (PB)";"PB";"NOVA OLINDA";17;6;2;25
2007;"NOVA PALMEIRA (PB)";"PB";"NOVA PALMEIRA";13;1;2;16
2007;"OLHO D AGUA (PB)";"PB";"OLHO D AGUA";4;3;3;10
2007;"OLIVEDOS (PB)";"PB";"OLIVEDOS";23;2;6;31
2007;"OURO VELHO (PB)";"PB";"OURO VELHO";9;3;1;13
2007;"PARARI (PB)";"PB";"PARARI";1;1;0;2
2007;"PASSAGEM (PB)";"PB";"PASSAGEM";12;1;1;14
2007;"PATOS (PB)";"PB";"PATOS";681;65;43;789
2007;"PAULISTA (PB)";"PB";"PAULISTA";31;2;3;36
2007;"PEDRA BRANCA (PB)";"PB";"PEDRA BRANCA";3;0;2;5
2007;"PEDRA LAVRADA (PB)";"PB";"PEDRA LAVRADA";19;3;3;25
2007;"PEDRAS DE FOGO (PB)";"PB";"PEDRAS DE FOGO";190;13;51;254
2007;"PEDRO REGIS (PB)";"PB";"PEDRO REGIS";16;1;2;19
2007;"PIANCO (PB)";"PB";"PIANCO";66;10;2;78
2007;"PICUI (PB)";"PB";"PICUI";75;2;12;89
2007;"PILAR (PB)";"PB";"PILAR";13;1;9;23
2007;"PILOES (PB)";"PB";"PILOES";12;2;1;15
2007;"PILOEZINHOS (PB)";"PB";"PILOEZINHOS";10;3;3;16
2007;"PIRPIRITUBA (PB)";"PB";"PIRPIRITUBA";18;0;7;25
2007;"PITIMBU (PB)";"PB";"PITIMBU";13;8;4;25
2007;"POCINHOS (PB)";"PB";"POCINHOS";68;9;13;90
2007;"POCO DANTAS (PB)";"PB";"POCO DANTAS";2;2;1;5
2007;"POCO DE JOSE DE MOURA (PB)";"PB";"POCO DE JOSE DE MOURA";4;1;2;7
2007;"POMBAL (PB)";"PB";"POMBAL";214;14;9;237
2007;"PRATA (PB)";"PB";"PRATA";13;6;2;21
2007;"PRINCESA ISABEL (PB)";"PB";"PRINCESA ISABEL";75;38;2;115
2007;"PUXINANA (PB)";"PB";"PUXINANA";43;7;5;55
2007;"QUEIMADAS (PB)";"PB";"QUEIMADAS";329;79;80;488
2007;"QUIXABA (PB)";"PB";"QUIXABA";2;1;2;5
2007;"REMIGIO (PB)";"PB";"REMIGIO";153;4;11;168
2007;"RIACHAO (PB)";"PB";"RIACHAO";1;0;4;5
2007;"RIACHAO DO BACAMARTE (PB)";"PB";"RIACHAO DO BACAMARTE";3;0;3;6
2007;"RIACHAO DO POCO (PB)";"PB";"RIACHAO DO POCO";5;0;6;11
2007;"RIACHO DE SANTO ANTONIO (PB)";"PB";"RIACHO DE SANTO ANTONIO";8;5;2;15
2007;"RIACHO DOS CAVALOS (PB)";"PB";"RIACHO DOS CAVALOS";8;2;2;12
2007;"RIO TINTO (PB)";"PB";"RIO TINTO";53;3;15;71
2007;"SALGADINHO (PB)";"PB";"SALGADINHO";4;1;0;5
2007;"SALGADO DE SAO FELIX (PB)";"PB";"SALGADO DE SAO FELIX";12;3;0;15
2007;"SANTA CECILIA (PB)";"PB";"SANTA CECILIA";7;0;4;11
2007;"SANTA CRUZ (PB)";"PB";"SANTA CRUZ";6;5;5;16
2007;"SANTA HELENA (PB)";"PB";"SANTA HELENA";6;0;4;10
2007;"SANTA INES (PB)";"PB";"SANTA INES";13;1;0;14
2007;"SANTA LUZIA (PB)";"PB";"SANTA LUZIA";174;17;12;203
2007;"SANTA RITA (PB)";"PB";"SANTA RITA";453;41;179;673
2007;"SANTA TERESINHA (PB)";"PB";"SANTA TERESINHA";16;0;4;20
2007;"SANTANA DE MANGUEIRA (PB)";"PB";"SANTANA DE MANGUEIRA";3;0;0;3
2007;"SANTANA DOS GARROTES (PB)";"PB";"SANTANA DOS GARROTES";17;3;0;20
2007;"SANTAREM (PB)";"PB";"SANTAREM";3;0;0;3
2007;"SANTO ANDRE (PB)";"PB";"SANTO ANDRE";11;0;2;13
2007;"SAO BENTO (PB)";"PB";"SAO BENTO";191;14;14;219
2007;"SAO BENTO DE POMBAL (PB)";"PB";"SAO BENTO DE POMBAL";8;2;1;11
2007;"SAO DOMINGOS DE POMBAL (PB)";"PB";"SAO DOMINGOS DE POMBAL";3;0;2;5
2007;"SAO DOMINGOS DO CARIRI (PB)";"PB";"SAO DOMINGOS DO CARIRI";6;0;1;7
2007;"SAO FRANCISCO (PB)";"PB";"SAO FRANCISCO";8;0;3;11
2007;"SAO JOAO DO CARIRI (PB)";"PB";"SAO JOAO DO CARIRI";13;4;3;20
2007;"SAO JOAO DO RIO DO PEIXE (PB)";"PB";"SAO JOAO DO RIO DO PEIXE";25;0;9;34
2007;"SAO JOAO DO TIGRE (PB)";"PB";"SAO JOAO DO TIGRE";8;0;1;9
2007;"SAO JOSE DA LAGOA TAPADA (PB)";"PB";"SAO JOSE DA LAGOA TAPADA";9;0;2;11
2007;"SAO JOSE DE CAIANA (PB)";"PB";"SAO JOSE DE CAIANA";2;3;1;6
2007;"SAO JOSE DE ESPINHARAS (PB)";"PB";"SAO JOSE DE ESPINHARAS";9;1;1;11
2007;"SAO JOSE DE PIRANHAS (PB)";"PB";"SAO JOSE DE PIRANHAS";31;7;2;40
2007;"SAO JOSE DE PRINCESA (PB)";"PB";"SAO JOSE DE PRINCESA";3;1;0;4
2007;"SAO JOSE DO BONFIM (PB)";"PB";"SAO JOSE DO BONFIM";7;0;1;8
2007;"SAO JOSE DO BREJO DO CRUZ (PB)";"PB";"SAO JOSE DO BREJO DO CRUZ";0;1;0;1
2007;"SAO JOSE DO SABUGI (PB)";"PB";"SAO JOSE DO SABUGI";18;2;1;21
2007;"SAO JOSE DOS CORDEIROS (PB)";"PB";"SAO JOSE DOS CORDEIROS";4;2;2;8
2007;"SAO JOSE DOS RAMOS (PB)";"PB";"SAO JOSE DOS RAMOS";14;1;5;20
2007;"SAO MAMEDE (PB)";"PB";"SAO MAMEDE";12;1;1;14
2007;"SAO MIGUEL DE TAIPU (PB)";"PB";"SAO MIGUEL DE TAIPU";9;0;3;12
2007;"SAO SEBASTIAO DE LAGOA DE ROCA (PB)";"PB";"SAO SEBASTIAO DE LAGOA DE ROCA";31;12;4;47
2007;"SAO SEBASTIAO DO UMBUZEIRO (PB)";"PB";"SAO SEBASTIAO DO UMBUZEIRO";7;0;2;9
2007;"SAPE (PB)";"PB";"SAPE";284;11;63;358
2007;"SERIDO (PB)";"PB";"SERIDO";11;4;4;19
2007;"SERRA BRANCA (PB)";"PB";"SERRA BRANCA";48;16;6;70
2007;"SERRA DA RAIZ (PB)";"PB";"SERRA DA RAIZ";2;0;3;5
2007;"SERRA GRANDE (PB)";"PB";"SERRA GRANDE";3;0;1;4
2007;"SERRA REDONDA (PB)";"PB";"SERRA REDONDA";12;3;2;17
2007;"SERRARIA (PB)";"PB";"SERRARIA";12;3;3;18
2007;"SERTAOZINHO (PB)";"PB";"SERTAOZINHO";2;0;5;7
2007;"SOBRADO (PB)";"PB";"SOBRADO";19;1;3;23
2007;"SOLANEA (PB)";"PB";"SOLANEA";152;17;22;191
2007;"SOLEDADE (PB)";"PB";"SOLEDADE";95;8;8;111
2007;"SOSSEGO (PB)";"PB";"SOSSEGO";14;2;2;18
2007;"SOUSA (PB)";"PB";"SOUSA";518;14;38;570
2007;"SUME (PB)";"PB";"SUME";47;11;13;71
2007;"TACIMA (PB)";"PB";"TACIMA";23;2;12;37
2007;"TAPEROA (PB)";"PB";"TAPEROA";53;7;2;62
2007;"TAVARES (PB)";"PB";"TAVARES";21;8;2;31
2007;"TEIXEIRA (PB)";"PB";"TEIXEIRA";85;7;11;103
2007;"TENORIO (PB)";"PB";"TENORIO";11;0;3;14
2007;"TRIUNFO (PB)";"PB";"TRIUNFO";5;2;1;8
2007;"UIRAUNA (PB)";"PB";"UIRAUNA";44;5;3;52
2007;"UMBUZEIRO (PB)";"PB";"UMBUZEIRO";38;9;16;63
2007;"VARZEA (PB)";"PB";"VARZEA";5;5;1;11
2007;"VIEIROPOLIS (PB)";"PB";"VIEIROPOLIS";9;0;4;13
2007;"VISTA SERRANA (PB)";"PB";"VISTA SERRANA";14;0;3;17
2007;"ZABELE (PB)";"PB";"ZABELE";6;0;0;6
2007;"ABREU E LIMA (PE)";"PE";"ABREU E LIMA";376;28;257;661
2007;"AFOGADOS DA INGAZEIRA (PE)";"PE";"AFOGADOS DA INGAZEIRA";215;22;24;261
2007;"AFRANIO (PE)";"PE";"AFRANIO";63;6;3;72
2007;"AGRESTINA (PE)";"PE";"AGRESTINA";91;12;14;117
2007;"AGUA PRETA (PE)";"PE";"AGUA PRETA";114;36;29;179
2007;"AGUAS BELAS (PE)";"PE";"AGUAS BELAS";191;45;29;265
2007;"ALAGOINHA (PE)";"PE";"ALAGOINHA";65;10;7;82
2007;"ALIANCA (PE)";"PE";"ALIANCA";89;3;67;159
2007;"ALTINHO (PE)";"PE";"ALTINHO";52;7;15;74
2007;"AMARAJI (PE)";"PE";"AMARAJI";60;13;17;90
2007;"ANGELIM (PE)";"PE";"ANGELIM";30;3;2;35
2007;"ARACOIABA (PE)";"PE";"ARACOIABA";58;9;60;127
2007;"ARARIPINA (PE)";"PE";"ARARIPINA";874;20;44;938
2007;"ARCOVERDE (PE)";"PE";"ARCOVERDE";786;61;94;941
2007;"BARRA DE GUABIRABA (PE)";"PE";"BARRA DE GUABIRABA";46;9;7;62
2007;"BARREIROS (PE)";"PE";"BARREIROS";200;14;26;240
2007;"BELEM DE MARIA (PE)";"PE";"BELEM DE MARIA";73;10;6;89
2007;"BELEM DE SAO FRANCISCO (PE)";"PE";"BELEM DE SAO FRANCISCO";72;7;7;86
2007;"BELO JARDIM (PE)";"PE";"BELO JARDIM";465;76;44;585
2007;"BETANIA (PE)";"PE";"BETANIA";30;4;3;37
2007;"BEZERROS (PE)";"PE";"BEZERROS";507;45;40;592
2007;"BODOCO (PE)";"PE";"BODOCO";129;2;6;137
2007;"BOM CONSELHO (PE)";"PE";"BOM CONSELHO";257;29;18;304
2007;"BOM JARDIM (PE)";"PE";"BOM JARDIM";103;149;18;270
2007;"BONITO (PE)";"PE";"BONITO";222;21;17;260
2007;"BREJAO (PE)";"PE";"BREJAO";28;2;7;37
2007;"BREJINHO (PE)";"PE";"BREJINHO";17;1;3;21
2007;"BREJO DA MADRE DE DEUS (PE)";"PE";"BREJO DA MADRE DE DEUS";135;196;6;337
2007;"BUENOS AIRES (PE)";"PE";"BUENOS AIRES";41;2;5;48
2007;"BUIQUE (PE)";"PE";"BUIQUE";191;25;20;236
2007;"CABO DE SANTO AGOSTINHO (PE)";"PE";"CABO DE SANTO AGOSTINHO";888;113;250;1251
2007;"CABROBO (PE)";"PE";"CABROBO";189;8;6;203
2007;"CACHOEIRINHA (PE)";"PE";"CACHOEIRINHA";94;11;7;112
2007;"CAETES (PE)";"PE";"CAETES";177;22;8;207
2007;"CALCADO (PE)";"PE";"CALCADO";38;2;13;53
2007;"CALUMBI (PE)";"PE";"CALUMBI";41;2;2;45
2007;"CAMARAGIBE (PE)";"PE";"CAMARAGIBE";547;176;112;835
2007;"CAMOCIM DE SAO FELIX (PE)";"PE";"CAMOCIM DE SAO FELIX";109;13;4;126
2007;"CAMUTANGA (PE)";"PE";"CAMUTANGA";63;0;10;73
2007;"CANHOTINHO (PE)";"PE";"CANHOTINHO";154;14;7;175
2007;"CAPOEIRAS (PE)";"PE";"CAPOEIRAS";142;22;1;165
2007;"CARNAIBA (PE)";"PE";"CARNAIBA";41;8;3;52
2007;"CARNAUBEIRA DA PENHA (PE)";"PE";"CARNAUBEIRA DA PENHA";24;2;0;26
2007;"CARPINA (PE)";"PE";"CARPINA";709;74;82;865
2007;"CARUARU (PE)";"PE";"CARUARU";3154;406;401;3961
2007;"CASINHAS (PE)";"PE";"CASINHAS";22;121;6;149
2007;"CATENDE (PE)";"PE";"CATENDE";167;15;26;208
2007;"CEDRO (PE)";"PE";"CEDRO";29;4;7;40
2007;"CHA DE ALEGRIA (PE)";"PE";"CHA DE ALEGRIA";33;9;12;54
2007;"CHA GRANDE (PE)";"PE";"CHA GRANDE";196;26;13;235
2007;"CONDADO (PE)";"PE";"CONDADO";117;7;60;184
2007;"CORRENTES (PE)";"PE";"CORRENTES";58;21;4;83
2007;"CORTES (PE)";"PE";"CORTES";137;14;17;168
2007;"CUMARU (PE)";"PE";"CUMARU";66;34;4;104
2007;"CUPIRA (PE)";"PE";"CUPIRA";191;21;12;224
2007;"CUSTODIA (PE)";"PE";"CUSTODIA";211;17;9;237
2007;"DORMENTES (PE)";"PE";"DORMENTES";67;2;5;74
2007;"ESCADA (PE)";"PE";"ESCADA";268;31;97;396
2007;"EXU (PE)";"PE";"EXU";231;6;17;254
2007;"FEIRA NOVA (PE)";"PE";"FEIRA NOVA";130;15;6;151
2007;"FERNANDO DE NORONHA (PE)";"PE";"FERNANDO DE NORONHA";14;15;9;38
2007;"FERREIROS (PE)";"PE";"FERREIROS";39;2;23;64
2007;"FLORES (PE)";"PE";"FLORES";40;6;3;49
2007;"FLORESTA (PE)";"PE";"FLORESTA";293;2;2;297
2007;"FREI MIGUELINHO (PE)";"PE";"FREI MIGUELINHO";97;113;13;223
2007;"GAMELEIRA (PE)";"PE";"GAMELEIRA";58;9;32;99
2007;"GARANHUNS (PE)";"PE";"GARANHUNS";1443;105;76;1624
2007;"GLORIA DO GOITA (PE)";"PE";"GLORIA DO GOITA";113;18;18;149
2007;"GOIANA (PE)";"PE";"GOIANA";616;36;105;757
2007;"GRANITO (PE)";"PE";"GRANITO";14;0;0;14
2007;"GRAVATA (PE)";"PE";"GRAVATA";681;50;35;766
2007;"IATI (PE)";"PE";"IATI";28;13;16;57
2007;"IBIMIRIM (PE)";"PE";"IBIMIRIM";122;21;6;149
2007;"IBIRAJUBA (PE)";"PE";"IBIRAJUBA";38;1;3;42
2007;"IGARASSU (PE)";"PE";"IGARASSU";624;38;252;914
2007;"IGUARACI (PE)";"PE";"IGUARACI";64;10;12;86
2007;"ILHA DE ITAMARACA (PE)";"PE";"ILHA DE ITAMARACA";47;9;7;63
2007;"INAJA (PE)";"PE";"INAJA";35;2;3;40
2007;"INGAZEIRA (PE)";"PE";"INGAZEIRA";9;0;1;10
2007;"IPOJUCA (PE)";"PE";"IPOJUCA";411;139;115;665
2007;"IPUBI (PE)";"PE";"IPUBI";122;6;16;144
2007;"ITACURUBA (PE)";"PE";"ITACURUBA";12;1;3;16
2007;"ITAIBA (PE)";"PE";"ITAIBA";74;13;4;91
2007;"ITAMBE (PE)";"PE";"ITAMBE";285;6;71;362
2007;"ITAPETIM (PE)";"PE";"ITAPETIM";30;2;4;36
2007;"ITAPISSUMA (PE)";"PE";"ITAPISSUMA";56;45;6;107
2007;"ITAQUITINGA (PE)";"PE";"ITAQUITINGA";28;2;23;53
2007;"JABOATAO DOS GUARARAPES (PE)";"PE";"JABOATAO DOS GUARARAPES";3681;711;1412;5804
2007;"JAQUEIRA (PE)";"PE";"JAQUEIRA";56;1;8;65
2007;"JATAUBA (PE)";"PE";"JATAUBA";46;97;5;148
2007;"JATOBA (PE)";"PE";"JATOBA";18;2;5;25
2007;"JOAO ALFREDO (PE)";"PE";"JOAO ALFREDO";133;365;3;501
2007;"JOAQUIM NABUCO (PE)";"PE";"JOAQUIM NABUCO";99;12;28;139
2007;"JUCATI (PE)";"PE";"JUCATI";84;2;9;95
2007;"JUPI (PE)";"PE";"JUPI";114;6;10;130
2007;"JUREMA (PE)";"PE";"JUREMA";61;3;3;67
2007;"LAGOA DO CARRO (PE)";"PE";"LAGOA DO CARRO";55;9;9;73
2007;"LAGOA DO ITAENGA (PE)";"PE";"LAGOA DO ITAENGA";219;11;49;279
2007;"LAGOA DO OURO (PE)";"PE";"LAGOA DO OURO";30;17;3;50
2007;"LAGOA DOS GATOS (PE)";"PE";"LAGOA DOS GATOS";75;7;3;85
2007;"LAGOA GRANDE (PE)";"PE";"LAGOA GRANDE";59;5;11;75
2007;"LAJEDO (PE)";"PE";"LAJEDO";400;31;27;458
2007;"LIMOEIRO (PE)";"PE";"LIMOEIRO";358;72;37;467
2007;"MACAPARANA (PE)";"PE";"MACAPARANA";114;14;28;156
2007;"MACHADOS (PE)";"PE";"MACHADOS";65;17;5;87
2007;"MANARI (PE)";"PE";"MANARI";20;1;3;24
2007;"MARAIAL (PE)";"PE";"MARAIAL";116;2;12;130
2007;"MIRANDIBA (PE)";"PE";"MIRANDIBA";78;3;0;81
2007;"MOREILANDIA (PE)";"PE";"MOREILANDIA";27;0;3;30
2007;"MORENO (PE)";"PE";"MORENO";383;49;126;558
2007;"NAZARE DA MATA (PE)";"PE";"NAZARE DA MATA";165;8;29;202
2007;"OLINDA (PE)";"PE";"OLINDA";2094;282;981;3357
2007;"OROBO (PE)";"PE";"OROBO";68;116;16;200
2007;"OROCO (PE)";"PE";"OROCO";43;1;3;47
2007;"OURICURI (PE)";"PE";"OURICURI";430;15;46;491
2007;"PALMARES (PE)";"PE";"PALMARES";452;51;133;636
2007;"PALMEIRINA (PE)";"PE";"PALMEIRINA";13;5;1;19
2007;"PANELAS (PE)";"PE";"PANELAS";67;9;7;83
2007;"PARANATAMA (PE)";"PE";"PARANATAMA";32;8;8;48
2007;"PARNAMIRIM (PE)";"PE";"PARNAMIRIM";110;0;7;117
2007;"PASSIRA (PE)";"PE";"PASSIRA";158;36;14;208
2007;"PAUDALHO (PE)";"PE";"PAUDALHO";338;16;34;388
2007;"PAULISTA (PE)";"PE";"PAULISTA";1006;146;219;1371
2007;"PEDRA (PE)";"PE";"PEDRA";95;13;10;118
2007;"PESQUEIRA (PE)";"PE";"PESQUEIRA";421;37;70;528
2007;"PETROLANDIA (PE)";"PE";"PETROLANDIA";181;2;11;194
2007;"PETROLINA (PE)";"PE";"PETROLINA";2170;181;248;2599
2007;"POCAO (PE)";"PE";"POCAO";34;13;2;49
2007;"POMBOS (PE)";"PE";"POMBOS";249;21;14;284
2007;"PRIMAVERA (PE)";"PE";"PRIMAVERA";54;10;25;89
2007;"QUIPAPA (PE)";"PE";"QUIPAPA";63;9;16;88
2007;"QUIXABA (PE)";"PE";"QUIXABA";16;4;2;22
2007;"RECIFE (PE)";"PE";"RECIFE";12980;1360;2660;17000
2007;"RIACHO DAS ALMAS (PE)";"PE";"RIACHO DAS ALMAS";160;56;17;233
2007;"RIBEIRAO (PE)";"PE";"RIBEIRAO";222;29;60;311
2007;"RIO FORMOSO (PE)";"PE";"RIO FORMOSO";96;6;43;145
2007;"SAIRE (PE)";"PE";"SAIRE";57;6;19;82
2007;"SALGADINHO (PE)";"PE";"SALGADINHO";13;21;3;37
2007;"SALGUEIRO (PE)";"PE";"SALGUEIRO";384;20;39;443
2007;"SALOA (PE)";"PE";"SALOA";45;12;2;59
2007;"SANHARO (PE)";"PE";"SANHARO";59;10;18;87
2007;"SANTA CRUZ (PE)";"PE";"SANTA CRUZ";86;3;4;93
2007;"SANTA CRUZ DA BAIXA VERDE (PE)";"PE";"SANTA CRUZ DA BAIXA VERDE";159;1;2;162
2007;"SANTA CRUZ DO CAPIBARIBE (PE)";"PE";"SANTA CRUZ DO CAPIBARIBE";518;233;32;783
2007;"SANTA FILOMENA (PE)";"PE";"SANTA FILOMENA";27;0;10;37
2007;"SANTA MARIA DA BOA VISTA (PE)";"PE";"SANTA MARIA DA BOA VISTA";132;7;29;168
2007;"SANTA MARIA DO CAMBUCA (PE)";"PE";"SANTA MARIA DO CAMBUCA";100;82;8;190
2007;"SANTA TEREZINHA (PE)";"PE";"SANTA TEREZINHA";22;3;3;28
2007;"SAO BENEDITO DO SUL (PE)";"PE";"SAO BENEDITO DO SUL";25;2;5;32
2007;"SAO BENTO DO UNA (PE)";"PE";"SAO BENTO DO UNA";474;28;48;550
2007;"SAO CAITANO (PE)";"PE";"SAO CAITANO";192;37;28;257
2007;"SAO JOAO (PE)";"PE";"SAO JOAO";83;16;8;107
2007;"SAO JOAQUIM DO MONTE (PE)";"PE";"SAO JOAQUIM DO MONTE";55;10;13;78
2007;"SAO JOSE DA COROA GRANDE (PE)";"PE";"SAO JOSE DA COROA GRANDE";38;5;8;51
2007;"SAO JOSE DO BELMONTE (PE)";"PE";"SAO JOSE DO BELMONTE";191;8;14;213
2007;"SAO JOSE DO EGITO (PE)";"PE";"SAO JOSE DO EGITO";353;26;40;419
2007;"SAO LOURENCO DA MATA (PE)";"PE";"SAO LOURENCO DA MATA";249;17;253;519
2007;"SAO VICENTE FERRER (PE)";"PE";"SAO VICENTE FERRER";101;4;8;113
2007;"SERRA TALHADA (PE)";"PE";"SERRA TALHADA";1092;33;30;1155
2007;"SERRITA (PE)";"PE";"SERRITA";63;3;5;71
2007;"SERTANIA (PE)";"PE";"SERTANIA";289;16;23;328
2007;"SIRINHAEM (PE)";"PE";"SIRINHAEM";155;6;24;185
2007;"SOLIDAO (PE)";"PE";"SOLIDAO";15;0;1;16
2007;"SURUBIM (PE)";"PE";"SURUBIM";478;437;36;951
2007;"TABIRA (PE)";"PE";"TABIRA";111;11;11;133
2007;"TACAIMBO (PE)";"PE";"TACAIMBO";62;9;12;83
2007;"TACARATU (PE)";"PE";"TACARATU";26;7;3;36
2007;"TAMANDARE (PE)";"PE";"TAMANDARE";52;8;9;69
2007;"TAQUARITINGA DO NORTE (PE)";"PE";"TAQUARITINGA DO NORTE";112;59;5;176
2007;"TEREZINHA (PE)";"PE";"TEREZINHA";13;2;4;19
2007;"TERRA NOVA (PE)";"PE";"TERRA NOVA";74;0;4;78
2007;"TIMBAUBA (PE)";"PE";"TIMBAUBA";693;22;48;763
2007;"TORITAMA (PE)";"PE";"TORITAMA";162;41;11;214
2007;"TRACUNHAEM (PE)";"PE";"TRACUNHAEM";32;8;15;55
2007;"TRINDADE (PE)";"PE";"TRINDADE";217;7;9;233
2007;"TRIUNFO (PE)";"PE";"TRIUNFO";151;6;6;163
2007;"TUPANATINGA (PE)";"PE";"TUPANATINGA";100;8;2;110
2007;"TUPARETAMA (PE)";"PE";"TUPARETAMA";72;9;11;92
2007;"VENTUROSA (PE)";"PE";"VENTUROSA";96;17;5;118
2007;"VERDEJANTE (PE)";"PE";"VERDEJANTE";52;1;9;62
2007;"VERTENTE DO LERIO (PE)";"PE";"VERTENTE DO LERIO";43;53;4;100
2007;"VERTENTES (PE)";"PE";"VERTENTES";93;53;15;161
2007;"VICENCIA (PE)";"PE";"VICENCIA";210;7;46;263
2007;"VITORIA DE SANTO ANTAO (PE)";"PE";"VITORIA DE SANTO ANTAO";1679;67;207;1953
2007;"XEXEU (PE)";"PE";"XEXEU";49;3;20;72
2007;"ACAUA (PI)";"PI";"ACAUA";9;1;0;10
2007;"AGRICOLANDIA (PI)";"PI";"AGRICOLANDIA";10;0;6;16
2007;"AGUA BRANCA (PI)";"PI";"AGUA BRANCA";64;5;6;75
2007;"ALAGOINHA DO PIAUI (PI)";"PI";"ALAGOINHA DO PIAUI";8;2;2;12
2007;"ALEGRETE DO PIAUI (PI)";"PI";"ALEGRETE DO PIAUI";3;0;1;4
2007;"ALTO LONGA (PI)";"PI";"ALTO LONGA";15;3;2;20
2007;"ALTOS (PI)";"PI";"ALTOS";121;3;14;138
2007;"ALVORADA DO GURGUEIA (PI)";"PI";"ALVORADA DO GURGUEIA";10;2;3;15
2007;"AMARANTE (PI)";"PI";"AMARANTE";29;2;3;34
2007;"ANGICAL DO PIAUI (PI)";"PI";"ANGICAL DO PIAUI";12;0;1;13
2007;"ANISIO DE ABREU (PI)";"PI";"ANISIO DE ABREU";3;5;1;9
2007;"ANTONIO ALMEIDA (PI)";"PI";"ANTONIO ALMEIDA";11;1;1;13
2007;"AROAZES (PI)";"PI";"AROAZES";6;1;3;10
2007;"AROEIRAS DO ITAIM (PI)";"PI";"AROEIRAS DO ITAIM";5;0;2;7
2007;"ARRAIAL (PI)";"PI";"ARRAIAL";1;0;2;3
2007;"ASSUNCAO DO PIAUI (PI)";"PI";"ASSUNCAO DO PIAUI";3;0;0;3
2007;"AVELINO LOPES (PI)";"PI";"AVELINO LOPES";8;4;1;13
2007;"BAIXA GRANDE DO RIBEIRO (PI)";"PI";"BAIXA GRANDE DO RIBEIRO";6;0;0;6
2007;"BARRA D ALCANTARA (PI)";"PI";"BARRA D ALCANTARA";11;0;0;11
2007;"BARRAS (PI)";"PI";"BARRAS";81;7;15;103
2007;"BARREIRAS DO PIAUI (PI)";"PI";"BARREIRAS DO PIAUI";2;0;0;2
2007;"BARRO DURO (PI)";"PI";"BARRO DURO";32;2;1;35
2007;"BATALHA (PI)";"PI";"BATALHA";41;3;8;52
2007;"BELA VISTA DO PIAUI (PI)";"PI";"BELA VISTA DO PIAUI";2;1;0;3
2007;"BELEM DO PIAUI (PI)";"PI";"BELEM DO PIAUI";2;0;0;2
2007;"BENEDITINOS (PI)";"PI";"BENEDITINOS";12;1;7;20
2007;"BERTOLINIA (PI)";"PI";"BERTOLINIA";13;2;1;16
2007;"BETANIA DO PIAUI (PI)";"PI";"BETANIA DO PIAUI";4;4;1;9
2007;"BOA HORA (PI)";"PI";"BOA HORA";5;0;1;6
2007;"BOCAINA (PI)";"PI";"BOCAINA";5;7;2;14
2007;"BOM JESUS (PI)";"PI";"BOM JESUS";123;0;8;131
2007;"BOM PRINCIPIO DO PIAUI (PI)";"PI";"BOM PRINCIPIO DO PIAUI";4;5;2;11
2007;"BONFIM DO PIAUI (PI)";"PI";"BONFIM DO PIAUI";4;2;2;8
2007;"BOQUEIRAO DO PIAUI (PI)";"PI";"BOQUEIRAO DO PIAUI";5;0;0;5
2007;"BRASILEIRA (PI)";"PI";"BRASILEIRA";9;0;5;14
2007;"BREJO DO PIAUI (PI)";"PI";"BREJO DO PIAUI";2;1;0;3
2007;"BURITI DOS LOPES (PI)";"PI";"BURITI DOS LOPES";15;1;6;22
2007;"BURITI DOS MONTES (PI)";"PI";"BURITI DOS MONTES";7;1;0;8
2007;"CABECEIRAS DO PIAUI (PI)";"PI";"CABECEIRAS DO PIAUI";3;0;4;7
2007;"CAJAZEIRAS DO PIAUI (PI)";"PI";"CAJAZEIRAS DO PIAUI";0;0;0;0
2007;"CAJUEIRO DA PRAIA (PI)";"PI";"CAJUEIRO DA PRAIA";6;1;2;9
2007;"CALDEIRAO GRANDE DO PIAUI (PI)";"PI";"CALDEIRAO GRANDE DO PIAUI";3;1;1;5
2007;"CAMPINAS DO PIAUI (PI)";"PI";"CAMPINAS DO PIAUI";1;1;1;3
2007;"CAMPO ALEGRE DO FIDALGO (PI)";"PI";"CAMPO ALEGRE DO FIDALGO";2;1;0;3
2007;"CAMPO GRANDE DO PIAUI (PI)";"PI";"CAMPO GRANDE DO PIAUI";11;2;0;13
2007;"CAMPO LARGO DO PIAUI (PI)";"PI";"CAMPO LARGO DO PIAUI";0;2;0;2
2007;"CAMPO MAIOR (PI)";"PI";"CAMPO MAIOR";265;10;35;310
2007;"CANAVIEIRA (PI)";"PI";"CANAVIEIRA";0;0;0;0
2007;"CANTO DO BURITI (PI)";"PI";"CANTO DO BURITI";52;5;3;60
2007;"CAPITAO DE CAMPOS (PI)";"PI";"CAPITAO DE CAMPOS";10;2;7;19
2007;"CAPITAO GERVASIO OLIVEIRA (PI)";"PI";"CAPITAO GERVASIO OLIVEIRA";2;0;2;4
2007;"CARACOL (PI)";"PI";"CARACOL";15;2;0;17
2007;"CARAUBAS DO PIAUI (PI)";"PI";"CARAUBAS DO PIAUI";3;1;1;5
2007;"CARIDADE DO PIAUI (PI)";"PI";"CARIDADE DO PIAUI";4;0;1;5
2007;"CASTELO DO PIAUI (PI)";"PI";"CASTELO DO PIAUI";31;0;3;34
2007;"CAXINGO (PI)";"PI";"CAXINGO";5;1;1;7
2007;"COCAL (PI)";"PI";"COCAL";30;2;3;35
2007;"COCAL DE TELHA (PI)";"PI";"COCAL DE TELHA";2;1;0;3
2007;"COCAL DOS ALVES (PI)";"PI";"COCAL DOS ALVES";0;2;0;2
2007;"COIVARAS (PI)";"PI";"COIVARAS";4;0;3;7
2007;"COLONIA DO GURGUEIA (PI)";"PI";"COLONIA DO GURGUEIA";4;3;0;7
2007;"COLONIA DO PIAUI (PI)";"PI";"COLONIA DO PIAUI";7;1;0;8
2007;"CONCEICAO DO CANINDE (PI)";"PI";"CONCEICAO DO CANINDE";2;2;0;4
2007;"CORONEL JOSE DIAS (PI)";"PI";"CORONEL JOSE DIAS";3;0;0;3
2007;"CORRENTE (PI)";"PI";"CORRENTE";50;3;2;55
2007;"CRISTALANDIA DO PIAUI (PI)";"PI";"CRISTALANDIA DO PIAUI";1;0;1;2
2007;"CRISTINO CASTRO (PI)";"PI";"CRISTINO CASTRO";23;1;3;27
2007;"CURIMATA (PI)";"PI";"CURIMATA";5;0;1;6
2007;"CURRAIS (PI)";"PI";"CURRAIS";1;1;0;2
2007;"CURRAL NOVO DO PIAUI (PI)";"PI";"CURRAL NOVO DO PIAUI";0;1;0;1
2007;"CURRALINHOS (PI)";"PI";"CURRALINHOS";2;0;0;2
2007;"DEMERVAL LOBAO (PI)";"PI";"DEMERVAL LOBAO";29;3;2;34
2007;"DIRCEU ARCOVERDE (PI)";"PI";"DIRCEU ARCOVERDE";4;2;0;6
2007;"DOM EXPEDITO LOPES (PI)";"PI";"DOM EXPEDITO LOPES";72;2;2;76
2007;"DOM INOCENCIO (PI)";"PI";"DOM INOCENCIO";7;2;3;12
2007;"DOMINGOS MOURAO (PI)";"PI";"DOMINGOS MOURAO";2;0;0;2
2007;"ELESBAO VELOSO (PI)";"PI";"ELESBAO VELOSO";34;1;4;39
2007;"ELISEU MARTINS (PI)";"PI";"ELISEU MARTINS";7;1;1;9
2007;"ESPERANTINA (PI)";"PI";"ESPERANTINA";104;12;17;133
2007;"FARTURA DO PIAUI (PI)";"PI";"FARTURA DO PIAUI";3;0;0;3
2007;"FLORES DO PIAUI (PI)";"PI";"FLORES DO PIAUI";2;0;0;2
2007;"FLORESTA DO PIAUI (PI)";"PI";"FLORESTA DO PIAUI";0;1;0;1
2007;"FLORIANO (PI)";"PI";"FLORIANO";1017;58;28;1103
2007;"FRANCINOPOLIS (PI)";"PI";"FRANCINOPOLIS";8;4;0;12
2007;"FRANCISCO AYRES (PI)";"PI";"FRANCISCO AYRES";2;3;2;7
2007;"FRANCISCO MACEDO (PI)";"PI";"FRANCISCO MACEDO";2;1;1;4
2007;"FRANCISCO SANTOS (PI)";"PI";"FRANCISCO SANTOS";54;6;1;61
2007;"FRONTEIRAS (PI)";"PI";"FRONTEIRAS";48;10;9;67
2007;"GEMINIANO (PI)";"PI";"GEMINIANO";8;4;5;17
2007;"GILBUES (PI)";"PI";"GILBUES";5;1;3;9
2007;"GUADALUPE (PI)";"PI";"GUADALUPE";39;8;4;51
2007;"GUARIBAS (PI)";"PI";"GUARIBAS";1;0;0;1
2007;"HUGO NAPOLEAO (PI)";"PI";"HUGO NAPOLEAO";4;0;0;4
2007;"ILHA GRANDE (PI)";"PI";"ILHA GRANDE";5;3;1;9
2007;"INHUMA (PI)";"PI";"INHUMA";53;3;4;60
2007;"IPIRANGA DO PIAUI (PI)";"PI";"IPIRANGA DO PIAUI";32;7;3;42
2007;"ISAIAS COELHO (PI)";"PI";"ISAIAS COELHO";3;1;2;6
2007;"ITAINOPOLIS (PI)";"PI";"ITAINOPOLIS";15;10;4;29
2007;"ITAUEIRA (PI)";"PI";"ITAUEIRA";21;4;0;25
2007;"JACOBINA DO PIAUI (PI)";"PI";"JACOBINA DO PIAUI";9;1;0;10
2007;"JAICOS (PI)";"PI";"JAICOS";54;6;2;62
2007;"JARDIM DO MULATO (PI)";"PI";"JARDIM DO MULATO";3;1;0;4
2007;"JATOBA DO PIAUI (PI)";"PI";"JATOBA DO PIAUI";17;0;0;17
2007;"JERUMENHA (PI)";"PI";"JERUMENHA";9;1;0;10
2007;"JOAO COSTA (PI)";"PI";"JOAO COSTA";1;0;0;1
2007;"JOAQUIM PIRES (PI)";"PI";"JOAQUIM PIRES";8;0;0;8
2007;"JOCA MARQUES (PI)";"PI";"JOCA MARQUES";2;0;1;3
2007;"JOSE DE FREITAS (PI)";"PI";"JOSE DE FREITAS";46;2;10;58
2007;"JUAZEIRO DO PIAUI (PI)";"PI";"JUAZEIRO DO PIAUI";2;0;0;2
2007;"JULIO BORGES (PI)";"PI";"JULIO BORGES";1;1;0;2
2007;"JUREMA (PI)";"PI";"JUREMA";1;2;1;4
2007;"LAGOA ALEGRE (PI)";"PI";"LAGOA ALEGRE";1;1;2;4
2007;"LAGOA DE SAO FRANCISCO (PI)";"PI";"LAGOA DE SAO FRANCISCO";1;0;0;1
2007;"LAGOA DO BARRO DO PIAUI (PI)";"PI";"LAGOA DO BARRO DO PIAUI";1;1;4;6
2007;"LAGOA DO PIAUI (PI)";"PI";"LAGOA DO PIAUI";7;0;0;7
2007;"LAGOA DO SITIO (PI)";"PI";"LAGOA DO SITIO";9;1;1;11
2007;"LAGOINHA DO PIAUI (PI)";"PI";"LAGOINHA DO PIAUI";2;2;2;6
2007;"LANDRI SALES (PI)";"PI";"LANDRI SALES";2;1;0;3
2007;"LUIS CORREIA (PI)";"PI";"LUIS CORREIA";24;5;9;38
2007;"LUZILANDIA (PI)";"PI";"LUZILANDIA";14;2;6;22
2007;"MADEIRO (PI)";"PI";"MADEIRO";3;1;1;5
2007;"MANOEL EMIDIO (PI)";"PI";"MANOEL EMIDIO";3;1;2;6
2007;"MARCOLANDIA (PI)";"PI";"MARCOLANDIA";48;13;2;63
2007;"MARCOS PARENTE (PI)";"PI";"MARCOS PARENTE";2;7;0;9
2007;"MASSAPE DO PIAUI (PI)";"PI";"MASSAPE DO PIAUI";2;1;0;3
2007;"MATIAS OLIMPIO (PI)";"PI";"MATIAS OLIMPIO";9;5;4;18
2007;"MIGUEL ALVES (PI)";"PI";"MIGUEL ALVES";17;2;9;28
2007;"MIGUEL LEAO (PI)";"PI";"MIGUEL LEAO";2;1;0;3
2007;"MILTON BRANDAO (PI)";"PI";"MILTON BRANDAO";0;0;0;0
2007;"MONSENHOR GIL (PI)";"PI";"MONSENHOR GIL";8;1;1;10
2007;"MONSENHOR HIPOLITO (PI)";"PI";"MONSENHOR HIPOLITO";10;6;1;17
2007;"MONTE ALEGRE DO PIAUI (PI)";"PI";"MONTE ALEGRE DO PIAUI";5;1;2;8
2007;"MORRO CABECA NO TEMPO (PI)";"PI";"MORRO CABECA NO TEMPO";0;0;0;0
2007;"MORRO DO CHAPEU DO PIAUI (PI)";"PI";"MORRO DO CHAPEU DO PIAUI";2;0;1;3
2007;"MURICI DOS PORTELAS (PI)";"PI";"MURICI DOS PORTELAS";3;0;1;4
2007;"NAZARE DO PIAUI (PI)";"PI";"NAZARE DO PIAUI";9;7;1;17
2007;"NOSSA SENHORA DE NAZARE (PI)";"PI";"NOSSA SENHORA DE NAZARE";1;0;2;3
2007;"NOSSA SENHORA DOS REMEDIOS (PI)";"PI";"NOSSA SENHORA DOS REMEDIOS";0;1;0;1
2007;"NOVA SANTA RITA (PI)";"PI";"NOVA SANTA RITA";1;2;0;3
2007;"NOVO ORIENTE DO PIAUI (PI)";"PI";"NOVO ORIENTE DO PIAUI";7;2;3;12
2007;"NOVO SANTO ANTONIO (PI)";"PI";"NOVO SANTO ANTONIO";4;0;0;4
2007;"OEIRAS (PI)";"PI";"OEIRAS";203;20;19;242
2007;"OLHO D AGUA DO PIAUI (PI)";"PI";"OLHO D AGUA DO PIAUI";2;1;1;4
2007;"PADRE MARCOS (PI)";"PI";"PADRE MARCOS";6;3;1;10
2007;"PAES LANDIM (PI)";"PI";"PAES LANDIM";2;1;0;3
2007;"PAJEU DO PIAUI (PI)";"PI";"PAJEU DO PIAUI";2;1;0;3
2007;"PALMEIRA DO PIAUI (PI)";"PI";"PALMEIRA DO PIAUI";15;1;0;16
2007;"PALMEIRAIS (PI)";"PI";"PALMEIRAIS";11;3;1;15
2007;"PAQUETA (PI)";"PI";"PAQUETA";4;6;2;12
2007;"PARNAGUA (PI)";"PI";"PARNAGUA";4;0;0;4
2007;"PARNAIBA (PI)";"PI";"PARNAIBA";739;88;161;988
2007;"PASSAGEM FRANCA DO PIAUI (PI)";"PI";"PASSAGEM FRANCA DO PIAUI";1;0;0;1
2007;"PATOS DO PIAUI (PI)";"PI";"PATOS DO PIAUI";10;0;4;14
2007;"PAU D ARCO DO PIAUI (PI)";"PI";"PAU D ARCO DO PIAUI";3;0;2;5
2007;"PAULISTANA (PI)";"PI";"PAULISTANA";71;13;7;91
2007;"PAVUSSU (PI)";"PI";"PAVUSSU";1;3;0;4
2007;"PEDRO II (PI)";"PI";"PEDRO II";44;5;3;52
2007;"PEDRO LAURENTINO (PI)";"PI";"PEDRO LAURENTINO";1;0;0;1
2007;"PICOS (PI)";"PI";"PICOS";1312;96;48;1456
2007;"PIMENTEIRAS (PI)";"PI";"PIMENTEIRAS";18;3;1;22
2007;"PIO IX (PI)";"PI";"PIO IX";21;2;3;26
2007;"PIRACURUCA (PI)";"PI";"PIRACURUCA";128;6;19;153
2007;"PIRIPIRI (PI)";"PI";"PIRIPIRI";212;14;55;281
2007;"PORTO (PI)";"PI";"PORTO";2;2;0;4
2007;"PORTO ALEGRE DO PIAUI (PI)";"PI";"PORTO ALEGRE DO PIAUI";4;3;0;7
2007;"PRATA DO PIAUI (PI)";"PI";"PRATA DO PIAUI";2;1;1;4
2007;"QUEIMADA NOVA (PI)";"PI";"QUEIMADA NOVA";7;2;2;11
2007;"REDENCAO DO GURGUEIA (PI)";"PI";"REDENCAO DO GURGUEIA";5;0;5;10
2007;"REGENERACAO (PI)";"PI";"REGENERACAO";45;5;2;52
2007;"RIACHO FRIO (PI)";"PI";"RIACHO FRIO";1;1;0;2
2007;"RIBEIRA DO PIAUI (PI)";"PI";"RIBEIRA DO PIAUI";1;0;1;2
2007;"RIBEIRO GONCALVES (PI)";"PI";"RIBEIRO GONCALVES";8;0;0;8
2007;"RIO GRANDE DO PIAUI (PI)";"PI";"RIO GRANDE DO PIAUI";6;1;2;9
2007;"SANTA CRUZ DO PIAUI (PI)";"PI";"SANTA CRUZ DO PIAUI";11;6;0;17
2007;"SANTA CRUZ DOS MILAGRES (PI)";"PI";"SANTA CRUZ DOS MILAGRES";1;0;0;1
2007;"SANTA FILOMENA (PI)";"PI";"SANTA FILOMENA";5;1;1;7
2007;"SANTA LUZ (PI)";"PI";"SANTA LUZ";5;0;1;6
2007;"SANTA ROSA DO PIAUI (PI)";"PI";"SANTA ROSA DO PIAUI";3;2;3;8
2007;"SANTANA DO PIAUI (PI)";"PI";"SANTANA DO PIAUI";16;2;5;23
2007;"SANTO ANTONIO DE LISBOA (PI)";"PI";"SANTO ANTONIO DE LISBOA";19;8;4;31
2007;"SANTO ANTONIO DOS MILAGRES (PI)";"PI";"SANTO ANTONIO DOS MILAGRES";1;3;0;4
2007;"SANTO INACIO DO PIAUI (PI)";"PI";"SANTO INACIO DO PIAUI";2;3;0;5
2007;"SAO BRAZ DO PIAUI (PI)";"PI";"SAO BRAZ DO PIAUI";0;0;0;0
2007;"SAO FELIX DO PIAUI (PI)";"PI";"SAO FELIX DO PIAUI";4;1;1;6
2007;"SAO FRANCISCO DE ASSIS DO PIAU (PI)";"PI";"SAO FRANCISCO DE ASSIS DO PIAU";1;0;2;3
2007;"SAO FRANCISCO DO PIAUI (PI)";"PI";"SAO FRANCISCO DO PIAUI";3;0;4;7
2007;"SAO GONCALO DO GURGUEIA (PI)";"PI";"SAO GONCALO DO GURGUEIA";2;2;0;4
2007;"SAO GONCALO DO PIAUI (PI)";"PI";"SAO GONCALO DO PIAUI";6;5;6;17
2007;"SAO JOAO DA CANABRAVA (PI)";"PI";"SAO JOAO DA CANABRAVA";6;4;2;12
2007;"SAO JOAO DA FRONTEIRA (PI)";"PI";"SAO JOAO DA FRONTEIRA";1;1;3;5
2007;"SAO JOAO DA SERRA (PI)";"PI";"SAO JOAO DA SERRA";1;0;0;1
2007;"SAO JOAO DA VARJOTA (PI)";"PI";"SAO JOAO DA VARJOTA";1;0;1;2
2007;"SAO JOAO DO ARRAIAL (PI)";"PI";"SAO JOAO DO ARRAIAL";3;1;0;4
2007;"SAO JOAO DO PIAUI (PI)";"PI";"SAO JOAO DO PIAUI";52;6;4;62
2007;"SAO JOSE DO DIVINO (PI)";"PI";"SAO JOSE DO DIVINO";5;1;1;7
2007;"SAO JOSE DO PEIXE (PI)";"PI";"SAO JOSE DO PEIXE";1;1;0;2
2007;"SAO JOSE DO PIAUI (PI)";"PI";"SAO JOSE DO PIAUI";14;8;3;25
2007;"SAO JULIAO (PI)";"PI";"SAO JULIAO";7;4;1;12
2007;"SAO LOURENCO DO PIAUI (PI)";"PI";"SAO LOURENCO DO PIAUI";0;0;1;1
2007;"SAO LUIS DO PIAUI (PI)";"PI";"SAO LUIS DO PIAUI";4;3;0;7
2007;"SAO MIGUEL DA BAIXA GRANDE (PI)";"PI";"SAO MIGUEL DA BAIXA GRANDE";6;0;0;6
2007;"SAO MIGUEL DO FIDALGO (PI)";"PI";"SAO MIGUEL DO FIDALGO";2;1;1;4
2007;"SAO MIGUEL DO TAPUIO (PI)";"PI";"SAO MIGUEL DO TAPUIO";6;0;3;9
2007;"SAO PEDRO DO PIAUI (PI)";"PI";"SAO PEDRO DO PIAUI";24;0;1;25
2007;"SAO RAIMUNDO NONATO (PI)";"PI";"SAO RAIMUNDO NONATO";142;3;15;160
2007;"SEBASTIAO BARROS (PI)";"PI";"SEBASTIAO BARROS";0;2;0;2
2007;"SEBASTIAO LEAL (PI)";"PI";"SEBASTIAO LEAL";7;1;0;8
2007;"SIGEFREDO PACHECO (PI)";"PI";"SIGEFREDO PACHECO";17;3;0;20
2007;"SIMOES (PI)";"PI";"SIMOES";31;2;1;34
2007;"SIMPLICIO MENDES (PI)";"PI";"SIMPLICIO MENDES";28;6;4;38
2007;"SOCORRO DO PIAUI (PI)";"PI";"SOCORRO DO PIAUI";0;0;0;0
2007;"SUSSUAPARA (PI)";"PI";"SUSSUAPARA";13;9;1;23
2007;"TAMBORIL DO PIAUI (PI)";"PI";"TAMBORIL DO PIAUI";1;0;0;1
2007;"TANQUE DO PIAUI (PI)";"PI";"TANQUE DO PIAUI";5;0;2;7
2007;"TERESINA (PI)";"PI";"TERESINA";7549;716;1884;10149
2007;"UNIAO (PI)";"PI";"UNIAO";66;13;15;94
2007;"URUCUI (PI)";"PI";"URUCUI";81;3;3;87
2007;"VALENCA DO PIAUI (PI)";"PI";"VALENCA DO PIAUI";89;17;9;115
2007;"VARZEA BRANCA (PI)";"PI";"VARZEA BRANCA";3;0;5;8
2007;"VARZEA GRANDE (PI)";"PI";"VARZEA GRANDE";4;2;0;6
2007;"VERA MENDES (PI)";"PI";"VERA MENDES";3;4;0;7
2007;"VILA NOVA DO PIAUI (PI)";"PI";"VILA NOVA DO PIAUI";3;0;1;4
2007;"WALL FERRAZ (PI)";"PI";"WALL FERRAZ";3;4;0;7
2007;"ABATIA (PR)";"PR";"ABATIA";118;2;28;148
2007;"ADRIANOPOLIS (PR)";"PR";"ADRIANOPOLIS";75;3;16;94
2007;"AGUDOS DO SUL (PR)";"PR";"AGUDOS DO SUL";270;3;14;287
2007;"ALMIRANTE TAMANDARE (PR)";"PR";"ALMIRANTE TAMANDARE";973;70;191;1234
2007;"ALTAMIRA DO PARANA (PR)";"PR";"ALTAMIRA DO PARANA";36;4;9;49
2007;"ALTO PARANA (PR)";"PR";"ALTO PARANA";200;4;63;267
2007;"ALTO PIQUIRI (PR)";"PR";"ALTO PIQUIRI";169;5;30;204
2007;"ALTONIA (PR)";"PR";"ALTONIA";336;8;33;377
2007;"ALVORADA DO SUL (PR)";"PR";"ALVORADA DO SUL";242;7;45;294
2007;"AMAPORA (PR)";"PR";"AMAPORA";68;3;24;95
2007;"AMPERE (PR)";"PR";"AMPERE";313;10;19;342
2007;"ANAHY (PR)";"PR";"ANAHY";47;3;7;57
2007;"ANDIRA (PR)";"PR";"ANDIRA";463;15;63;541
2007;"ANGULO (PR)";"PR";"ANGULO";53;1;5;59
2007;"ANTONINA (PR)";"PR";"ANTONINA";84;12;24;120
2007;"ANTONIO OLINTO (PR)";"PR";"ANTONIO OLINTO";107;2;20;129
2007;"APUCARANA (PR)";"PR";"APUCARANA";2097;201;229;2527
2007;"ARAPONGAS (PR)";"PR";"ARAPONGAS";2801;133;88;3022
2007;"ARAPOTI (PR)";"PR";"ARAPOTI";401;24;59;484
2007;"ARAPUA (PR)";"PR";"ARAPUA";72;3;14;89
2007;"ARARUNA (PR)";"PR";"ARARUNA";319;4;22;345
2007;"ARAUCARIA (PR)";"PR";"ARAUCARIA";2656;199;445;3300
2007;"ARIRANHA DO IVAI (PR)";"PR";"ARIRANHA DO IVAI";29;3;12;44
2007;"ASSAI (PR)";"PR";"ASSAI";420;11;29;460
2007;"ASSIS CHATEAUBRIAND (PR)";"PR";"ASSIS CHATEAUBRIAND";966;22;59;1047
2007;"ASTORGA (PR)";"PR";"ASTORGA";537;24;70;631
2007;"ATALAIA (PR)";"PR";"ATALAIA";87;9;15;111
2007;"BALSA NOVA (PR)";"PR";"BALSA NOVA";226;7;23;256
2007;"BANDEIRANTES (PR)";"PR";"BANDEIRANTES";780;27;87;894
2007;"BARBOSA FERRAZ (PR)";"PR";"BARBOSA FERRAZ";144;8;18;170
2007;"BARRA DO JACARE (PR)";"PR";"BARRA DO JACARE";34;3;7;44
2007;"BARRACAO (PR)";"PR";"BARRACAO";178;16;31;225
2007;"BELA VISTA DO CAROBA (PR)";"PR";"BELA VISTA DO CAROBA";40;2;9;51
2007;"BELA VISTA DO PARAISO (PR)";"PR";"BELA VISTA DO PARAISO";332;14;48;394
2007;"BITURUNA (PR)";"PR";"BITURUNA";329;11;85;425
2007;"BOA ESPERANCA (PR)";"PR";"BOA ESPERANCA";151;4;13;168
2007;"BOA ESPERANCA DO IGUACU (PR)";"PR";"BOA ESPERANCA DO IGUACU";53;4;7;64
2007;"BOA VENTURA DE SAO ROQUE (PR)";"PR";"BOA VENTURA DE SAO ROQUE";137;4;20;161
2007;"BOA VISTA DA APARECIDA (PR)";"PR";"BOA VISTA DA APARECIDA";129;8;19;156
2007;"BOCAIUVA DO SUL (PR)";"PR";"BOCAIUVA DO SUL";205;6;12;223
2007;"BOM JESUS DO SUL (PR)";"PR";"BOM JESUS DO SUL";30;5;4;39
2007;"BOM SUCESSO (PR)";"PR";"BOM SUCESSO";85;2;29;116
2007;"BOM SUCESSO DO SUL (PR)";"PR";"BOM SUCESSO DO SUL";78;11;4;93
2007;"BORRAZOPOLIS (PR)";"PR";"BORRAZOPOLIS";205;3;7;215
2007;"BRAGANEY (PR)";"PR";"BRAGANEY";125;4;13;142
2007;"BRASILANDIA DO SUL (PR)";"PR";"BRASILANDIA DO SUL";47;2;6;55
2007;"CAFEARA (PR)";"PR";"CAFEARA";30;1;11;42
2007;"CAFELANDIA (PR)";"PR";"CAFELANDIA";396;11;32;439
2007;"CAFEZAL DO SUL (PR)";"PR";"CAFEZAL DO SUL";84;2;32;118
2007;"CALIFORNIA (PR)";"PR";"CALIFORNIA";198;2;15;215
2007;"CAMBARA (PR)";"PR";"CAMBARA";958;20;58;1036
2007;"CAMBE (PR)";"PR";"CAMBE";1559;140;202;1901
2007;"CAMBIRA (PR)";"PR";"CAMBIRA";204;2;13;219
2007;"CAMPINA DA LAGOA (PR)";"PR";"CAMPINA DA LAGOA";295;12;36;343
2007;"CAMPINA DO SIMAO (PR)";"PR";"CAMPINA DO SIMAO";72;4;19;95
2007;"CAMPINA GRANDE DO SUL (PR)";"PR";"CAMPINA GRANDE DO SUL";587;42;45;674
2007;"CAMPO BONITO (PR)";"PR";"CAMPO BONITO";81;3;8;92
2007;"CAMPO DO TENENTE (PR)";"PR";"CAMPO DO TENENTE";115;7;28;150
2007;"CAMPO LARGO (PR)";"PR";"CAMPO LARGO";1827;156;415;2398
2007;"CAMPO MAGRO (PR)";"PR";"CAMPO MAGRO";272;25;24;321
2007;"CAMPO MOURAO (PR)";"PR";"CAMPO MOURAO";1751;46;414;2211
2007;"CANDIDO DE ABREU (PR)";"PR";"CANDIDO DE ABREU";186;5;31;222
2007;"CANDOI (PR)";"PR";"CANDOI";308;4;72;384
2007;"CANTAGALO (PR)";"PR";"CANTAGALO";204;8;31;243
2007;"CAPANEMA (PR)";"PR";"CAPANEMA";343;8;42;393
2007;"CAPITAO LEONIDAS MARQUES (PR)";"PR";"CAPITAO LEONIDAS MARQUES";408;14;23;445
2007;"CARAMBEI (PR)";"PR";"CARAMBEI";463;24;52;539
2007;"CARLOPOLIS (PR)";"PR";"CARLOPOLIS";230;11;33;274
2007;"CASCAVEL (PR)";"PR";"CASCAVEL";6319;232;662;7213
2007;"CASTRO (PR)";"PR";"CASTRO";1387;72;188;1647
2007;"CATANDUVAS (PR)";"PR";"CATANDUVAS";173;7;23;203
2007;"CENTENARIO DO SUL (PR)";"PR";"CENTENARIO DO SUL";105;11;43;159
2007;"CERRO AZUL (PR)";"PR";"CERRO AZUL";310;10;47;367
2007;"CEU AZUL (PR)";"PR";"CEU AZUL";291;10;35;336
2007;"CHOPINZINHO (PR)";"PR";"CHOPINZINHO";424;15;63;502
2007;"CIANORTE (PR)";"PR";"CIANORTE";1261;37;158;1456
2007;"CIDADE GAUCHA (PR)";"PR";"CIDADE GAUCHA";206;7;73;286
2007;"CLEVELANDIA (PR)";"PR";"CLEVELANDIA";456;22;33;511
2007;"COLOMBO (PR)";"PR";"COLOMBO";3188;166;383;3737
2007;"COLORADO (PR)";"PR";"COLORADO";537;29;66;632
2007;"CONGONHINHAS (PR)";"PR";"CONGONHINHAS";99;5;21;125
2007;"CONSELHEIRO MAIRINCK (PR)";"PR";"CONSELHEIRO MAIRINCK";29;2;5;36
2007;"CONTENDA (PR)";"PR";"CONTENDA";578;11;42;631
2007;"CORBELIA (PR)";"PR";"CORBELIA";630;11;32;673
2007;"CORNELIO PROCOPIO (PR)";"PR";"CORNELIO PROCOPIO";889;68;99;1056
2007;"CORONEL DOMINGOS SOARES (PR)";"PR";"CORONEL DOMINGOS SOARES";93;4;21;118
2007;"CORONEL VIVIDA (PR)";"PR";"CORONEL VIVIDA";581;13;75;669
2007;"CORUMBATAI DO SUL (PR)";"PR";"CORUMBATAI DO SUL";38;1;23;62
2007;"CRUZ MACHADO (PR)";"PR";"CRUZ MACHADO";375;12;41;428
2007;"CRUZEIRO DO IGUACU (PR)";"PR";"CRUZEIRO DO IGUACU";57;2;11;70
2007;"CRUZEIRO DO OESTE (PR)";"PR";"CRUZEIRO DO OESTE";372;11;58;441
2007;"CRUZEIRO DO SUL (PR)";"PR";"CRUZEIRO DO SUL";67;3;16;86
2007;"CRUZMALTINA (PR)";"PR";"CRUZMALTINA";62;1;5;68
2007;"CURITIBA (PR)";"PR";"CURITIBA";33182;3191;5345;41718
2007;"CURIUVA (PR)";"PR";"CURIUVA";172;20;58;250
2007;"DIAMANTE D OESTE (PR)";"PR";"DIAMANTE D OESTE";55;8;12;75
2007;"DIAMANTE DO NORTE (PR)";"PR";"DIAMANTE DO NORTE";66;1;17;84
2007;"DIAMANTE DO SUL (PR)";"PR";"DIAMANTE DO SUL";38;2;4;44
2007;"DOIS VIZINHOS (PR)";"PR";"DOIS VIZINHOS";729;29;77;835
2007;"DOURADINA (PR)";"PR";"DOURADINA";173;5;8;186
2007;"DOUTOR CAMARGO (PR)";"PR";"DOUTOR CAMARGO";138;4;27;169
2007;"DOUTOR ULYSSES (PR)";"PR";"DOUTOR ULYSSES";36;2;5;43
2007;"ENEAS MARQUES (PR)";"PR";"ENEAS MARQUES";127;8;13;148
2007;"ENGENHEIRO BELTRAO (PR)";"PR";"ENGENHEIRO BELTRAO";397;6;57;460
2007;"ENTRE RIOS DO OESTE (PR)";"PR";"ENTRE RIOS DO OESTE";110;3;7;120
2007;"ESPERANCA NOVA (PR)";"PR";"ESPERANCA NOVA";23;3;4;30
2007;"ESPIGAO ALTO DO IGUACU (PR)";"PR";"ESPIGAO ALTO DO IGUACU";48;6;2;56
2007;"FAROL (PR)";"PR";"FAROL";57;0;9;66
2007;"FAXINAL (PR)";"PR";"FAXINAL";300;8;29;337
2007;"FAZENDA RIO GRANDE (PR)";"PR";"FAZENDA RIO GRANDE";686;34;183;903
2007;"FENIX (PR)";"PR";"FENIX";92;2;12;106
2007;"FERNANDES PINHEIRO (PR)";"PR";"FERNANDES PINHEIRO";70;3;14;87
2007;"FIGUEIRA (PR)";"PR";"FIGUEIRA";107;7;25;139
2007;"FLOR DA SERRA DO SUL (PR)";"PR";"FLOR DA SERRA DO SUL";89;2;21;112
2007;"FLORAI (PR)";"PR";"FLORAI";119;2;21;142
2007;"FLORESTA (PR)";"PR";"FLORESTA";201;6;19;226
2007;"FLORESTOPOLIS (PR)";"PR";"FLORESTOPOLIS";186;7;65;258
2007;"FLORIDA (PR)";"PR";"FLORIDA";42;9;8;59
2007;"FORMOSA DO OESTE (PR)";"PR";"FORMOSA DO OESTE";166;23;16;205
2007;"FOZ DO IGUACU (PR)";"PR";"FOZ DO IGUACU";2795;822;803;4420
2007;"FOZ DO JORDAO (PR)";"PR";"FOZ DO JORDAO";57;3;10;70
2007;"FRANCISCO ALVES (PR)";"PR";"FRANCISCO ALVES";145;2;19;166
2007;"FRANCISCO BELTRAO (PR)";"PR";"FRANCISCO BELTRAO";1570;72;156;1798
2007;"GENERAL CARNEIRO (PR)";"PR";"GENERAL CARNEIRO";376;8;42;426
2007;"GODOY MOREIRA (PR)";"PR";"GODOY MOREIRA";38;3;7;48
2007;"GOIOERE (PR)";"PR";"GOIOERE";647;20;64;731
2007;"GOIOXIM (PR)";"PR";"GOIOXIM";71;3;16;90
2007;"GRANDES RIOS (PR)";"PR";"GRANDES RIOS";68;5;7;80
2007;"GUAIRA (PR)";"PR";"GUAIRA";1115;24;57;1196
2007;"GUAIRACA (PR)";"PR";"GUAIRACA";122;2;21;145
2007;"GUAMIRANGA (PR)";"PR";"GUAMIRANGA";129;4;15;148
2007;"GUAPIRAMA (PR)";"PR";"GUAPIRAMA";90;5;18;113
2007;"GUAPOREMA (PR)";"PR";"GUAPOREMA";33;1;3;37
2007;"GUARACI (PR)";"PR";"GUARACI";74;3;20;97
2007;"GUARANIACU (PR)";"PR";"GUARANIACU";338;17;43;398
2007;"GUARAPUAVA (PR)";"PR";"GUARAPUAVA";3733;243;321;4297
2007;"GUARAQUECABA (PR)";"PR";"GUARAQUECABA";15;0;4;19
2007;"GUARATUBA (PR)";"PR";"GUARATUBA";209;19;38;266
2007;"HONORIO SERPA (PR)";"PR";"HONORIO SERPA";107;3;24;134
2007;"IBAITI (PR)";"PR";"IBAITI";437;16;140;593
2007;"IBEMA (PR)";"PR";"IBEMA";130;4;11;145
2007;"IBIPORA (PR)";"PR";"IBIPORA";769;25;97;891
2007;"ICARAIMA (PR)";"PR";"ICARAIMA";100;5;21;126
2007;"IGUARACU (PR)";"PR";"IGUARACU";60;0;10;70
2007;"IGUATU (PR)";"PR";"IGUATU";31;0;7;38
2007;"IMBAU (PR)";"PR";"IMBAU";163;10;25;198
2007;"IMBITUVA (PR)";"PR";"IMBITUVA";619;12;41;672
2007;"INACIO MARTINS (PR)";"PR";"INACIO MARTINS";195;10;22;227
2007;"INAJA (PR)";"PR";"INAJA";33;0;17;50
2007;"INDIANOPOLIS (PR)";"PR";"INDIANOPOLIS";108;1;7;116
2007;"IPIRANGA (PR)";"PR";"IPIRANGA";287;11;31;329
2007;"IPORA (PR)";"PR";"IPORA";302;9;31;342
2007;"IRACEMA DO OESTE (PR)";"PR";"IRACEMA DO OESTE";60;5;4;69
2007;"IRATI (PR)";"PR";"IRATI";1255;54;117;1426
2007;"IRETAMA (PR)";"PR";"IRETAMA";131;2;23;156
2007;"ITAGUAJE (PR)";"PR";"ITAGUAJE";70;5;20;95
2007;"ITAIPULANDIA (PR)";"PR";"ITAIPULANDIA";150;13;24;187
2007;"ITAMBARACA (PR)";"PR";"ITAMBARACA";127;4;25;156
2007;"ITAMBE (PR)";"PR";"ITAMBE";173;7;21;201
2007;"ITAPEJARA D OESTE (PR)";"PR";"ITAPEJARA D OESTE";242;5;17;264
2007;"ITAPERUCU (PR)";"PR";"ITAPERUCU";435;29;46;510
2007;"ITAUNA DO SUL (PR)";"PR";"ITAUNA DO SUL";38;2;7;47
2007;"IVAI (PR)";"PR";"IVAI";250;4;27;281
2007;"IVAIPORA (PR)";"PR";"IVAIPORA";691;17;82;790
2007;"IVATE (PR)";"PR";"IVATE";137;3;45;185
2007;"IVATUBA (PR)";"PR";"IVATUBA";47;1;7;55
2007;"JABOTI (PR)";"PR";"JABOTI";60;3;5;68
2007;"JACAREZINHO (PR)";"PR";"JACAREZINHO";455;47;105;607
2007;"JAGUAPITA (PR)";"PR";"JAGUAPITA";267;14;37;318
2007;"JAGUARIAIVA (PR)";"PR";"JAGUARIAIVA";589;36;92;717
2007;"JANDAIA DO SUL (PR)";"PR";"JANDAIA DO SUL";488;20;83;591
2007;"JANIOPOLIS (PR)";"PR";"JANIOPOLIS";104;4;14;122
2007;"JAPIRA (PR)";"PR";"JAPIRA";34;1;4;39
2007;"JAPURA (PR)";"PR";"JAPURA";182;3;15;200
2007;"JARDIM ALEGRE (PR)";"PR";"JARDIM ALEGRE";168;10;18;196
2007;"JARDIM OLINDA (PR)";"PR";"JARDIM OLINDA";36;1;6;43
2007;"JATAIZINHO (PR)";"PR";"JATAIZINHO";287;21;19;327
2007;"JESUITAS (PR)";"PR";"JESUITAS";215;8;19;242
2007;"JOAQUIM TAVORA (PR)";"PR";"JOAQUIM TAVORA";195;7;13;215
2007;"JUNDIAI DO SUL (PR)";"PR";"JUNDIAI DO SUL";20;2;10;32
2007;"JURANDA (PR)";"PR";"JURANDA";257;2;7;266
2007;"JUSSARA (PR)";"PR";"JUSSARA";154;3;26;183
2007;"KALORE (PR)";"PR";"KALORE";124;6;18;148
2007;"LAPA (PR)";"PR";"LAPA";1027;44;124;1195
2007;"LARANJAL (PR)";"PR";"LARANJAL";39;3;14;56
2007;"LARANJEIRAS DO SUL (PR)";"PR";"LARANJEIRAS DO SUL";556;16;62;634
2007;"LEOPOLIS (PR)";"PR";"LEOPOLIS";58;3;4;65
2007;"LIDIANOPOLIS (PR)";"PR";"LIDIANOPOLIS";64;8;16;88
2007;"LINDOESTE (PR)";"PR";"LINDOESTE";73;6;9;88
2007;"LOANDA (PR)";"PR";"LOANDA";352;11;45;408
2007;"LOBATO (PR)";"PR";"LOBATO";148;4;22;174
2007;"LONDRINA (PR)";"PR";"LONDRINA";7632;601;1560;9793
2007;"LUIZIANA (PR)";"PR";"LUIZIANA";118;2;13;133
2007;"LUNARDELLI (PR)";"PR";"LUNARDELLI";85;5;5;95
2007;"LUPIONOPOLIS (PR)";"PR";"LUPIONOPOLIS";83;2;70;155
2007;"MALLET (PR)";"PR";"MALLET";275;10;32;317
2007;"MAMBORE (PR)";"PR";"MAMBORE";467;4;28;499
2007;"MANDAGUACU (PR)";"PR";"MANDAGUACU";324;8;45;377
2007;"MANDAGUARI (PR)";"PR";"MANDAGUARI";623;20;51;694
2007;"MANDIRITUBA (PR)";"PR";"MANDIRITUBA";733;16;51;800
2007;"MANFRINOPOLIS (PR)";"PR";"MANFRINOPOLIS";23;4;15;42
2007;"MANGUEIRINHA (PR)";"PR";"MANGUEIRINHA";391;12;46;449
2007;"MANOEL RIBAS (PR)";"PR";"MANOEL RIBAS";247;7;20;274
2007;"MARECHAL CANDIDO RONDON (PR)";"PR";"MARECHAL CANDIDO RONDON";1224;44;102;1370
2007;"MARIA HELENA (PR)";"PR";"MARIA HELENA";81;2;18;101
2007;"MARIALVA (PR)";"PR";"MARIALVA";700;36;46;782
2007;"MARILANDIA DO SUL (PR)";"PR";"MARILANDIA DO SUL";196;9;9;214
2007;"MARILENA (PR)";"PR";"MARILENA";102;2;21;125
2007;"MARILUZ (PR)";"PR";"MARILUZ";163;5;42;210
2007;"MARINGA (PR)";"PR";"MARINGA";7050;320;742;8112
2007;"MARIOPOLIS (PR)";"PR";"MARIOPOLIS";161;8;21;190
2007;"MARIPA (PR)";"PR";"MARIPA";235;7;11;253
2007;"MARMELEIRO (PR)";"PR";"MARMELEIRO";265;11;40;316
2007;"MARQUINHO (PR)";"PR";"MARQUINHO";43;1;8;52
2007;"MARUMBI (PR)";"PR";"MARUMBI";76;4;13;93
2007;"MATELANDIA (PR)";"PR";"MATELANDIA";318;5;33;356
2007;"MATINHOS (PR)";"PR";"MATINHOS";198;20;21;239
2007;"MATO RICO (PR)";"PR";"MATO RICO";33;1;6;40
2007;"MAUA DA SERRA (PR)";"PR";"MAUA DA SERRA";173;2;17;192
2007;"MEDIANEIRA (PR)";"PR";"MEDIANEIRA";947;37;88;1072
2007;"MERCEDES (PR)";"PR";"MERCEDES";157;6;24;187
2007;"MIRADOR (PR)";"PR";"MIRADOR";14;1;7;22
2007;"MIRASELVA (PR)";"PR";"MIRASELVA";32;6;18;56
2007;"MISSAL (PR)";"PR";"MISSAL";258;14;26;298
2007;"MOREIRA SALES (PR)";"PR";"MOREIRA SALES";141;10;54;205
2007;"MORRETES (PR)";"PR";"MORRETES";132;8;22;162
2007;"MUNHOZ DE MELLO (PR)";"PR";"MUNHOZ DE MELLO";44;5;6;55
2007;"NOSSA SENHORA DAS GRACAS (PR)";"PR";"NOSSA SENHORA DAS GRACAS";19;4;23;46
2007;"NOVA ALIANCA DO IVAI (PR)";"PR";"NOVA ALIANCA DO IVAI";16;5;4;25
2007;"NOVA AMERICA DA COLINA (PR)";"PR";"NOVA AMERICA DA COLINA";93;4;10;107
2007;"NOVA AURORA (PR)";"PR";"NOVA AURORA";360;8;32;400
2007;"NOVA CANTU (PR)";"PR";"NOVA CANTU";99;1;21;121
2007;"NOVA ESPERANCA (PR)";"PR";"NOVA ESPERANCA";693;20;43;756
2007;"NOVA ESPERANCA DO SUDOESTE (PR)";"PR";"NOVA ESPERANCA DO SUDOESTE";60;6;12;78
2007;"NOVA FATIMA (PR)";"PR";"NOVA FATIMA";203;2;25;230
2007;"NOVA LARANJEIRAS (PR)";"PR";"NOVA LARANJEIRAS";118;3;25;146
2007;"NOVA LONDRINA (PR)";"PR";"NOVA LONDRINA";344;9;39;392
2007;"NOVA OLIMPIA (PR)";"PR";"NOVA OLIMPIA";72;5;22;99
2007;"NOVA PRATA DO IGUACU (PR)";"PR";"NOVA PRATA DO IGUACU";181;4;23;208
2007;"NOVA SANTA BARBARA (PR)";"PR";"NOVA SANTA BARBARA";103;6;4;113
2007;"NOVA SANTA ROSA (PR)";"PR";"NOVA SANTA ROSA";268;6;9;283
2007;"NOVA TEBAS (PR)";"PR";"NOVA TEBAS";77;4;9;90
2007;"NOVO ITACOLOMI (PR)";"PR";"NOVO ITACOLOMI";61;1;6;68
2007;"ORTIGUEIRA (PR)";"PR";"ORTIGUEIRA";243;11;56;310
2007;"OURIZONA (PR)";"PR";"OURIZONA";63;4;19;86
2007;"OURO VERDE DO OESTE (PR)";"PR";"OURO VERDE DO OESTE";121;3;9;133
2007;"PAICANDU (PR)";"PR";"PAICANDU";385;18;40;443
2007;"PALMAS (PR)";"PR";"PALMAS";776;42;57;875
2007;"PALMEIRA (PR)";"PR";"PALMEIRA";783;32;52;867
2007;"PALMITAL (PR)";"PR";"PALMITAL";189;10;35;234
2007;"PALOTINA (PR)";"PR";"PALOTINA";999;22;83;1104
2007;"PARAISO DO NORTE (PR)";"PR";"PARAISO DO NORTE";210;15;46;271
2007;"PARANACITY (PR)";"PR";"PARANACITY";169;10;39;218
2007;"PARANAGUA (PR)";"PR";"PARANAGUA";1417;113;128;1658
2007;"PARANAPOEMA (PR)";"PR";"PARANAPOEMA";40;2;13;55
2007;"PARANAVAI (PR)";"PR";"PARANAVAI";1602;55;147;1804
2007;"PATO BRAGADO (PR)";"PR";"PATO BRAGADO";116;1;13;130
2007;"PATO BRANCO (PR)";"PR";"PATO BRANCO";1552;97;301;1950
2007;"PAULA FREITAS (PR)";"PR";"PAULA FREITAS";112;2;15;129
2007;"PAULO FRONTIN (PR)";"PR";"PAULO FRONTIN";125;1;9;135
2007;"PEABIRU (PR)";"PR";"PEABIRU";265;13;14;292
2007;"PEROBAL (PR)";"PR";"PEROBAL";86;3;26;115
2007;"PEROLA (PR)";"PR";"PEROLA";176;5;12;193
2007;"PEROLA D OESTE (PR)";"PR";"PEROLA D OESTE";115;2;22;139
2007;"PIEN (PR)";"PR";"PIEN";295;16;14;325
2007;"PINHAIS (PR)";"PR";"PINHAIS";1553;103;216;1872
2007;"PINHAL DO SAO BENTO (PR)";"PR";"PINHAL DO SAO BENTO";28;1;8;37
2007;"PINHALAO (PR)";"PR";"PINHALAO";80;5;10;95
2007;"PINHAO (PR)";"PR";"PINHAO";374;4;65;443
2007;"PIRAI DO SUL (PR)";"PR";"PIRAI DO SUL";379;23;67;469
2007;"PIRAQUARA (PR)";"PR";"PIRAQUARA";363;55;123;541
2007;"PITANGA (PR)";"PR";"PITANGA";660;20;88;768
2007;"PITANGUEIRAS (PR)";"PR";"PITANGUEIRAS";54;4;19;77
2007;"PLANALTINA DO PARANA (PR)";"PR";"PLANALTINA DO PARANA";80;3;7;90
2007;"PLANALTO (PR)";"PR";"PLANALTO";270;9;24;303
2007;"PONTA GROSSA (PR)";"PR";"PONTA GROSSA";5046;388;886;6320
2007;"PONTAL DO PARANA (PR)";"PR";"PONTAL DO PARANA";139;11;34;184
2007;"PORECATU (PR)";"PR";"PORECATU";301;14;117;432
2007;"PORTO AMAZONAS (PR)";"PR";"PORTO AMAZONAS";48;7;8;63
2007;"PORTO BARREIRO (PR)";"PR";"PORTO BARREIRO";47;2;16;65
2007;"PORTO RICO (PR)";"PR";"PORTO RICO";17;0;6;23
2007;"PORTO VITORIA (PR)";"PR";"PORTO VITORIA";140;2;7;149
2007;"PRADO FERREIRA (PR)";"PR";"PRADO FERREIRA";70;1;10;81
2007;"PRANCHITA (PR)";"PR";"PRANCHITA";189;2;10;201
2007;"PRESIDENTE CASTELO BRANCO (PR)";"PR";"PRESIDENTE CASTELO BRANCO";69;4;19;92
2007;"PRIMEIRO DE MAIO (PR)";"PR";"PRIMEIRO DE MAIO";254;12;17;283
2007;"PRUDENTOPOLIS (PR)";"PR";"PRUDENTOPOLIS";901;16;90;1007
2007;"QUARTO CENTENARIO (PR)";"PR";"QUARTO CENTENARIO";119;5;9;133
2007;"QUATIGUA (PR)";"PR";"QUATIGUA";320;5;14;339
2007;"QUATRO BARRAS (PR)";"PR";"QUATRO BARRAS";517;30;121;668
2007;"QUATRO PONTES (PR)";"PR";"QUATRO PONTES";154;4;5;163
2007;"QUEDAS DO IGUACU (PR)";"PR";"QUEDAS DO IGUACU";500;14;105;619
2007;"QUERENCIA DO NORTE (PR)";"PR";"QUERENCIA DO NORTE";167;3;19;189
2007;"QUINTA DO SOL (PR)";"PR";"QUINTA DO SOL";103;3;14;120
2007;"QUITANDINHA (PR)";"PR";"QUITANDINHA";408;4;50;462
2007;"RAMILANDIA (PR)";"PR";"RAMILANDIA";41;2;8;51
2007;"RANCHO ALEGRE (PR)";"PR";"RANCHO ALEGRE";100;3;11;114
2007;"RANCHO ALEGRE D OESTE (PR)";"PR";"RANCHO ALEGRE D OESTE";73;2;7;82
2007;"REALEZA (PR)";"PR";"REALEZA";463;13;27;503
2007;"REBOUCAS (PR)";"PR";"REBOUCAS";204;7;30;241
2007;"RENASCENCA (PR)";"PR";"RENASCENCA";180;5;22;207
2007;"RESERVA (PR)";"PR";"RESERVA";425;12;42;479
2007;"RESERVA DO IGUACU (PR)";"PR";"RESERVA DO IGUACU";65;6;15;86
2007;"RIBEIRAO CLARO (PR)";"PR";"RIBEIRAO CLARO";149;18;20;187
2007;"RIBEIRAO DO PINHAL (PR)";"PR";"RIBEIRAO DO PINHAL";171;25;17;213
2007;"RIO AZUL (PR)";"PR";"RIO AZUL";218;5;35;258
2007;"RIO BOM (PR)";"PR";"RIO BOM";57;4;4;65
2007;"RIO BONITO DO IGUACU (PR)";"PR";"RIO BONITO DO IGUACU";182;5;53;240
2007;"RIO BRANCO DO IVAI (PR)";"PR";"RIO BRANCO DO IVAI";37;2;9;48
2007;"RIO BRANCO DO SUL (PR)";"PR";"RIO BRANCO DO SUL";560;58;75;693
2007;"RIO NEGRO (PR)";"PR";"RIO NEGRO";737;48;47;832
2007;"ROLANDIA (PR)";"PR";"ROLANDIA";1394;61;92;1547
2007;"RONCADOR (PR)";"PR";"RONCADOR";238;2;25;265
2007;"RONDON (PR)";"PR";"RONDON";254;9;49;312
2007;"ROSARIO DO IVAI (PR)";"PR";"ROSARIO DO IVAI";43;6;18;67
2007;"SABAUDIA (PR)";"PR";"SABAUDIA";126;5;11;142
2007;"SALGADO FILHO (PR)";"PR";"SALGADO FILHO";70;1;15;86
2007;"SALTO DO ITARARE (PR)";"PR";"SALTO DO ITARARE";80;4;17;101
2007;"SALTO DO LONTRA (PR)";"PR";"SALTO DO LONTRA";213;6;27;246
2007;"SANTA AMELIA (PR)";"PR";"SANTA AMELIA";67;3;10;80
2007;"SANTA CECILIA DO PAVAO (PR)";"PR";"SANTA CECILIA DO PAVAO";63;7;9;79
2007;"SANTA CRUZ DO MONTE CASTELO (PR)";"PR";"SANTA CRUZ DO MONTE CASTELO";177;6;20;203
2007;"SANTA FE (PR)";"PR";"SANTA FE";156;8;22;186
2007;"SANTA HELENA (PR)";"PR";"SANTA HELENA";527;26;77;630
2007;"SANTA INES (PR)";"PR";"SANTA INES";10;5;8;23
2007;"SANTA ISABEL DO IVAI (PR)";"PR";"SANTA ISABEL DO IVAI";159;8;20;187
2007;"SANTA IZABEL DO OESTE (PR)";"PR";"SANTA IZABEL DO OESTE";205;12;26;243
2007;"SANTA LUCIA (PR)";"PR";"SANTA LUCIA";79;1;8;88
2007;"SANTA MARIA DO OESTE (PR)";"PR";"SANTA MARIA DO OESTE";128;7;19;154
2007;"SANTA MARIANA (PR)";"PR";"SANTA MARIANA";249;12;36;297
2007;"SANTA MONICA (PR)";"PR";"SANTA MONICA";41;2;11;54
2007;"SANTA TEREZA DO OESTE (PR)";"PR";"SANTA TEREZA DO OESTE";152;11;10;173
2007;"SANTA TEREZINHA DE ITAIPU (PR)";"PR";"SANTA TEREZINHA DE ITAIPU";345;29;35;409
2007;"SANTANA DO ITARARE (PR)";"PR";"SANTANA DO ITARARE";80;3;14;97
2007;"SANTO ANTONIO DA PLATINA (PR)";"PR";"SANTO ANTONIO DA PLATINA";516;21;220;757
2007;"SANTO ANTONIO DO CAIUA (PR)";"PR";"SANTO ANTONIO DO CAIUA";16;2;8;26
2007;"SANTO ANTONIO DO PARAISO (PR)";"PR";"SANTO ANTONIO DO PARAISO";64;2;7;73
2007;"SANTO ANTONIO DO SUDOESTE (PR)";"PR";"SANTO ANTONIO DO SUDOESTE";292;11;37;340
2007;"SANTO INACIO (PR)";"PR";"SANTO INACIO";74;6;14;94
2007;"SAO CARLOS DO IVAI (PR)";"PR";"SAO CARLOS DO IVAI";197;8;25;230
2007;"SAO JERONIMO DA SERRA (PR)";"PR";"SAO JERONIMO DA SERRA";97;4;15;116
2007;"SAO JOAO (PR)";"PR";"SAO JOAO";276;9;31;316
2007;"SAO JOAO DO CAIUA (PR)";"PR";"SAO JOAO DO CAIUA";52;4;21;77
2007;"SAO JOAO DO IVAI (PR)";"PR";"SAO JOAO DO IVAI";237;8;39;284
2007;"SAO JOAO DO TRIUNFO (PR)";"PR";"SAO JOAO DO TRIUNFO";160;7;28;195
2007;"SAO JORGE D OESTE (PR)";"PR";"SAO JORGE D OESTE";159;9;24;192
2007;"SAO JORGE DO IVAI (PR)";"PR";"SAO JORGE DO IVAI";236;5;11;252
2007;"SAO JORGE DO PATROCINIO (PR)";"PR";"SAO JORGE DO PATROCINIO";88;5;12;105
2007;"SAO JOSE DA BOA VISTA (PR)";"PR";"SAO JOSE DA BOA VISTA";84;3;15;102
2007;"SAO JOSE DAS PALMEIRAS (PR)";"PR";"SAO JOSE DAS PALMEIRAS";52;8;10;70
2007;"SAO JOSE DOS PINHAIS (PR)";"PR";"SAO JOSE DOS PINHAIS";5105;375;524;6004
2007;"SAO MANOEL DO PARANA (PR)";"PR";"SAO MANOEL DO PARANA";31;2;7;40
2007;"SAO MATEUS DO SUL (PR)";"PR";"SAO MATEUS DO SUL";759;41;84;884
2007;"SAO MIGUEL DO IGUACU (PR)";"PR";"SAO MIGUEL DO IGUACU";706;14;69;789
2007;"SAO PEDRO DO IGUACU (PR)";"PR";"SAO PEDRO DO IGUACU";129;6;20;155
2007;"SAO PEDRO DO IVAI (PR)";"PR";"SAO PEDRO DO IVAI";253;4;39;296
2007;"SAO PEDRO DO PARANA (PR)";"PR";"SAO PEDRO DO PARANA";20;1;6;27
2007;"SAO SEBASTIAO DA AMOREIRA (PR)";"PR";"SAO SEBASTIAO DA AMOREIRA";175;5;19;199
2007;"SAO TOME (PR)";"PR";"SAO TOME";93;9;19;121
2007;"SAPOPEMA (PR)";"PR";"SAPOPEMA";64;2;9;75
2007;"SARANDI (PR)";"PR";"SARANDI";733;29;117;879
2007;"SAUDADE DO IGUACU (PR)";"PR";"SAUDADE DO IGUACU";62;9;15;86
2007;"SENGES (PR)";"PR";"SENGES";421;17;43;481
2007;"SERRANOPOLIS DO IGUACU (PR)";"PR";"SERRANOPOLIS DO IGUACU";116;13;9;138
2007;"SERTANEJA (PR)";"PR";"SERTANEJA";182;8;21;211
2007;"SERTANOPOLIS (PR)";"PR";"SERTANOPOLIS";471;5;41;517
2007;"SIQUEIRA CAMPOS (PR)";"PR";"SIQUEIRA CAMPOS";294;10;36;340
2007;"SULINA (PR)";"PR";"SULINA";74;6;11;91
2007;"TAMARANA (PR)";"PR";"TAMARANA";221;6;30;257
2007;"TAMBOARA (PR)";"PR";"TAMBOARA";56;4;8;68
2007;"TAPEJARA (PR)";"PR";"TAPEJARA";317;14;62;393
2007;"TAPIRA (PR)";"PR";"TAPIRA";110;5;9;124
2007;"TEIXEIRA SOARES (PR)";"PR";"TEIXEIRA SOARES";192;10;47;249
2007;"TELEMACO BORBA (PR)";"PR";"TELEMACO BORBA";985;179;224;1388
2007;"TERRA BOA (PR)";"PR";"TERRA BOA";265;9;57;331
2007;"TERRA RICA (PR)";"PR";"TERRA RICA";295;4;51;350
2007;"TERRA ROXA (PR)";"PR";"TERRA ROXA";386;11;33;430
2007;"TIBAGI (PR)";"PR";"TIBAGI";248;18;41;307
2007;"TIJUCAS DO SUL (PR)";"PR";"TIJUCAS DO SUL";319;7;22;348
2007;"TOLEDO (PR)";"PR";"TOLEDO";2387;146;224;2757
2007;"TOMAZINA (PR)";"PR";"TOMAZINA";61;6;14;81
2007;"TRES BARRAS DO PARANA (PR)";"PR";"TRES BARRAS DO PARANA";282;3;18;303
2007;"TUNAS DO PARANA (PR)";"PR";"TUNAS DO PARANA";69;7;16;92
2007;"TUNEIRAS DO OESTE (PR)";"PR";"TUNEIRAS DO OESTE";119;1;30;150
2007;"TUPASSI (PR)";"PR";"TUPASSI";286;8;18;312
2007;"TURVO (PR)";"PR";"TURVO";306;9;40;355
2007;"UBIRATA (PR)";"PR";"UBIRATA";553;25;41;619
2007;"UMUARAMA (PR)";"PR";"UMUARAMA";2073;43;189;2305
2007;"UNIAO DA VITORIA (PR)";"PR";"UNIAO DA VITORIA";1139;34;63;1236
2007;"UNIFLOR (PR)";"PR";"UNIFLOR";24;5;7;36
2007;"URAI (PR)";"PR";"URAI";254;18;22;294
2007;"VENTANIA (PR)";"PR";"VENTANIA";138;12;32;182
2007;"VERA CRUZ DO OESTE (PR)";"PR";"VERA CRUZ DO OESTE";208;7;10;225
2007;"VERE (PR)";"PR";"VERE";166;10;17;193
2007;"VILA ALTA (PR)";"PR";"VILA ALTA";36;6;11;53
2007;"VIRMOND (PR)";"PR";"VIRMOND";83;1;13;97
2007;"VITORINO (PR)";"PR";"VITORINO";185;4;20;209
2007;"WENCESLAU BRAZ (PR)";"PR";"WENCESLAU BRAZ";362;15;63;440
2007;"XAMBRE (PR)";"PR";"XAMBRE";74;5;8;87
2007;"ANGRA DOS REIS (RJ)";"RJ";"ANGRA DOS REIS";914;163;226;1303
2007;"APERIBE (RJ)";"RJ";"APERIBE";76;6;3;85
2007;"ARARUAMA (RJ)";"RJ";"ARARUAMA";1193;250;81;1524
2007;"AREAL (RJ)";"RJ";"AREAL";90;29;25;144
2007;"ARMACAO DE BUZIOS (RJ)";"RJ";"ARMACAO DE BUZIOS";164;196;24;384
2007;"ARRAIAL DO CABO (RJ)";"RJ";"ARRAIAL DO CABO";103;31;11;145
2007;"BARRA DO PIRAI (RJ)";"RJ";"BARRA DO PIRAI";2145;109;218;2472
2007;"BARRA MANSA (RJ)";"RJ";"BARRA MANSA";1531;103;437;2071
2007;"BELFORD ROXO (RJ)";"RJ";"BELFORD ROXO";868;225;523;1616
2007;"BOM JARDIM (RJ)";"RJ";"BOM JARDIM";361;20;25;406
2007;"BOM JESUS DO ITABAPOANA (RJ)";"RJ";"BOM JESUS DO ITABAPOANA";273;32;33;338
2007;"CABO FRIO (RJ)";"RJ";"CABO FRIO";2818;305;388;3511
2007;"CACHOEIRAS DE MACACU (RJ)";"RJ";"CACHOEIRAS DE MACACU";590;92;29;711
2007;"CAMBUCI (RJ)";"RJ";"CAMBUCI";65;8;11;84
2007;"CAMPOS DOS GOYTACAZES (RJ)";"RJ";"CAMPOS DOS GOYTACAZES";4855;391;837;6083
2007;"CANTAGALO (RJ)";"RJ";"CANTAGALO";118;21;29;168
2007;"CARAPEBUS (RJ)";"RJ";"CARAPEBUS";52;22;4;78
2007;"CARDOSO MOREIRA (RJ)";"RJ";"CARDOSO MOREIRA";123;8;20;151
2007;"CARMO (RJ)";"RJ";"CARMO";85;10;24;119
2007;"CASIMIRO DE ABREU (RJ)";"RJ";"CASIMIRO DE ABREU";460;65;30;555
2007;"COMENDADOR LEVY GASPARIAN (RJ)";"RJ";"COMENDADOR LEVY GASPARIAN";87;28;12;127
2007;"CONCEICAO DE MACABU (RJ)";"RJ";"CONCEICAO DE MACABU";149;28;54;231
2007;"CORDEIRO (RJ)";"RJ";"CORDEIRO";250;33;35;318
2007;"DUAS BARRAS (RJ)";"RJ";"DUAS BARRAS";56;13;5;74
2007;"DUQUE DE CAXIAS (RJ)";"RJ";"DUQUE DE CAXIAS";5688;710;2566;8964
2007;"ENGENHEIRO PAULO DE FRONTIN (RJ)";"RJ";"ENGENHEIRO PAULO DE FRONTIN";129;23;12;164
2007;"GUAPIMIRIM (RJ)";"RJ";"GUAPIMIRIM";222;41;30;293
2007;"IGUABA GRANDE (RJ)";"RJ";"IGUABA GRANDE";93;86;13;192
2007;"ITABORAI (RJ)";"RJ";"ITABORAI";2755;837;645;4237
2007;"ITAGUAI (RJ)";"RJ";"ITAGUAI";971;252;196;1419
2007;"ITALVA (RJ)";"RJ";"ITALVA";163;12;16;191
2007;"ITAOCARA (RJ)";"RJ";"ITAOCARA";243;28;19;290
2007;"ITAPERUNA (RJ)";"RJ";"ITAPERUNA";972;88;85;1145
2007;"ITATIAIA (RJ)";"RJ";"ITATIAIA";171;71;40;282
2007;"JAPERI (RJ)";"RJ";"JAPERI";156;30;27;213
2007;"LAJE DO MURIAE (RJ)";"RJ";"LAJE DO MURIAE";41;4;7;52
2007;"MACAE (RJ)";"RJ";"MACAE";2397;564;707;3668
2007;"MACUCO (RJ)";"RJ";"MACUCO";109;8;5;122
2007;"MAGE (RJ)";"RJ";"MAGE";853;292;142;1287
2007;"MANGARATIBA (RJ)";"RJ";"MANGARATIBA";107;93;89;289
2007;"MARICA (RJ)";"RJ";"MARICA";629;257;212;1098
2007;"MENDES (RJ)";"RJ";"MENDES";223;33;17;273
2007;"MESQUITA (RJ)";"RJ";"MESQUITA";294;96;489;879
2007;"MIGUEL PEREIRA (RJ)";"RJ";"MIGUEL PEREIRA";250;50;25;325
2007;"MIRACEMA (RJ)";"RJ";"MIRACEMA";190;11;19;220
2007;"NATIVIDADE (RJ)";"RJ";"NATIVIDADE";79;11;22;112
2007;"NILOPOLIS (RJ)";"RJ";"NILOPOLIS";484;125;280;889
2007;"NITEROI (RJ)";"RJ";"NITEROI";1763;1207;1679;4649
2007;"NOVA FRIBURGO (RJ)";"RJ";"NOVA FRIBURGO";3187;180;282;3649
2007;"NOVA IGUACU (RJ)";"RJ";"NOVA IGUACU";4631;948;1311;6890
2007;"PARACAMBI (RJ)";"RJ";"PARACAMBI";250;43;75;368
2007;"PARAIBA DO SUL (RJ)";"RJ";"PARAIBA DO SUL";369;56;77;502
2007;"PARATI (RJ)";"RJ";"PARATI";146;48;35;229
2007;"PATY DO ALFERES (RJ)";"RJ";"PATY DO ALFERES";382;44;28;454
2007;"PETROPOLIS (RJ)";"RJ";"PETROPOLIS";2970;480;620;4070
2007;"PINHEIRAL (RJ)";"RJ";"PINHEIRAL";117;19;23;159
2007;"PIRAI (RJ)";"RJ";"PIRAI";379;35;39;453
2007;"PORCIUNCULA (RJ)";"RJ";"PORCIUNCULA";71;7;10;88
2007;"PORTO REAL (RJ)";"RJ";"PORTO REAL";326;28;23;377
2007;"QUATIS (RJ)";"RJ";"QUATIS";214;79;36;329
2007;"QUEIMADOS (RJ)";"RJ";"QUEIMADOS";328;207;107;642
2007;"QUISSAMA (RJ)";"RJ";"QUISSAMA";178;19;66;263
2007;"RESENDE (RJ)";"RJ";"RESENDE";962;152;284;1398
2007;"RIO BONITO (RJ)";"RJ";"RIO BONITO";4352;434;141;4927
2007;"RIO CLARO (RJ)";"RJ";"RIO CLARO";61;6;5;72
2007;"RIO DAS FLORES (RJ)";"RJ";"RIO DAS FLORES";57;13;6;76
2007;"RIO DAS OSTRAS (RJ)";"RJ";"RIO DAS OSTRAS";674;340;52;1066
2007;"RIO DE JANEIRO (RJ)";"RJ";"RIO DE JANEIRO";27190;11943;12515;51648
2007;"SANTA MARIA MADALENA (RJ)";"RJ";"SANTA MARIA MADALENA";35;7;2;44
2007;"SANTO ANTONIO DE PADUA (RJ)";"RJ";"SANTO ANTONIO DE PADUA";484;65;16;565
2007;"SAO FIDELIS (RJ)";"RJ";"SAO FIDELIS";327;23;44;394
2007;"SAO FRANCISCO DE ITABAPOANA (RJ)";"RJ";"SAO FRANCISCO DE ITABAPOANA";213;27;26;266
2007;"SAO GONCALO (RJ)";"RJ";"SAO GONCALO";2188;1588;1887;5663
2007;"SAO JOAO DA BARRA (RJ)";"RJ";"SAO JOAO DA BARRA";229;35;27;291
2007;"SAO JOAO DE MERITI (RJ)";"RJ";"SAO JOAO DE MERITI";2307;378;1113;3798
2007;"SAO JOSE DE UBA (RJ)";"RJ";"SAO JOSE DE UBA";11;4;3;18
2007;"SAO JOSE DO VALE DO RIO PRETO (RJ)";"RJ";"SAO JOSE DO VALE DO RIO PRETO";470;29;14;513
2007;"SAO PEDRO DA ALDEIA (RJ)";"RJ";"SAO PEDRO DA ALDEIA";367;55;33;455
2007;"SAO SEBASTIAO DO ALTO (RJ)";"RJ";"SAO SEBASTIAO DO ALTO";71;3;2;76
2007;"SAPUCAIA (RJ)";"RJ";"SAPUCAIA";93;8;4;105
2007;"SAQUAREMA (RJ)";"RJ";"SAQUAREMA";417;83;62;562
2007;"SEROPEDICA (RJ)";"RJ";"SEROPEDICA";415;34;139;588
2007;"SILVA JARDIM (RJ)";"RJ";"SILVA JARDIM";247;31;19;297
2007;"SUMIDOURO (RJ)";"RJ";"SUMIDOURO";175;7;10;192
2007;"TANGUA (RJ)";"RJ";"TANGUA";180;17;7;204
2007;"TERESOPOLIS (RJ)";"RJ";"TERESOPOLIS";1505;193;273;1971
2007;"TRAJANO DE MORAIS (RJ)";"RJ";"TRAJANO DE MORAIS";38;3;6;47
2007;"TRES RIOS (RJ)";"RJ";"TRES RIOS";698;79;189;966
2007;"VALENCA (RJ)";"RJ";"VALENCA";261;47;56;364
2007;"VARRE SAI (RJ)";"RJ";"VARRE SAI";33;3;2;38
2007;"VASSOURAS (RJ)";"RJ";"VASSOURAS";343;47;87;477
2007;"VOLTA REDONDA (RJ)";"RJ";"VOLTA REDONDA";1956;224;532;2712
2007;"ACARI (RN)";"RN";"ACARI";75;7;4;86
2007;"AFONSO BEZERRA (RN)";"RN";"AFONSO BEZERRA";13;4;2;19
2007;"AGUA NOVA (RN)";"RN";"AGUA NOVA";3;4;1;8
2007;"ALEXANDRIA (RN)";"RN";"ALEXANDRIA";44;14;9;67
2007;"ALMINO AFONSO (RN)";"RN";"ALMINO AFONSO";10;5;0;15
2007;"ALTO DO RODRIGUES (RN)";"RN";"ALTO DO RODRIGUES";84;13;18;115
2007;"ANGICOS (RN)";"RN";"ANGICOS";76;10;10;96
2007;"ANTONIO MARTINS (RN)";"RN";"ANTONIO MARTINS";8;11;0;19
2007;"APODI (RN)";"RN";"APODI";165;12;13;190
2007;"AREIA BRANCA (RN)";"RN";"AREIA BRANCA";95;33;36;164
2007;"ARES (RN)";"RN";"ARES";75;5;16;96
2007;"ASSU (RN)";"RN";"ASSU";380;38;44;462
2007;"BAIA FORMOSA (RN)";"RN";"BAIA FORMOSA";36;1;11;48
2007;"BARAUNA (RN)";"RN";"BARAUNA";120;13;8;141
2007;"BARCELONA (RN)";"RN";"BARCELONA";18;2;1;21
2007;"BENTO FERNANDES (RN)";"RN";"BENTO FERNANDES";11;4;3;18
2007;"BOA SAUDE (RN)";"RN";"BOA SAUDE";36;7;4;47
2007;"BODO (RN)";"RN";"BODO";4;6;1;11
2007;"BOM JESUS (RN)";"RN";"BOM JESUS";43;2;2;47
2007;"BREJINHO (RN)";"RN";"BREJINHO";48;9;9;66
2007;"CAICARA DO NORTE (RN)";"RN";"CAICARA DO NORTE";12;0;1;13
2007;"CAICARA DO RIO DO VENTO (RN)";"RN";"CAICARA DO RIO DO VENTO";21;5;1;27
2007;"CAICO (RN)";"RN";"CAICO";1202;61;32;1295
2007;"CAMPO GRANDE (RN)";"RN";"CAMPO GRANDE";27;8;0;35
2007;"CAMPO REDONDO (RN)";"RN";"CAMPO REDONDO";30;8;5;43
2007;"CANGUARETAMA (RN)";"RN";"CANGUARETAMA";122;18;48;188
2007;"CARAUBAS (RN)";"RN";"CARAUBAS";96;16;7;119
2007;"CARNAUBA DOS DANTAS (RN)";"RN";"CARNAUBA DOS DANTAS";101;2;4;107
2007;"CARNAUBAIS (RN)";"RN";"CARNAUBAIS";33;17;8;58
2007;"CEARA MIRIM (RN)";"RN";"CEARA MIRIM";232;22;51;305
2007;"CERRO CORA (RN)";"RN";"CERRO CORA";64;6;3;73
2007;"CORONEL EZEQUIEL (RN)";"RN";"CORONEL EZEQUIEL";24;6;3;33
2007;"CORONEL JOAO PESSOA (RN)";"RN";"CORONEL JOAO PESSOA";8;3;0;11
2007;"CRUZETA (RN)";"RN";"CRUZETA";54;6;3;63
2007;"CURRAIS NOVOS (RN)";"RN";"CURRAIS NOVOS";509;28;37;574
2007;"DOUTOR SEVERIANO (RN)";"RN";"DOUTOR SEVERIANO";7;10;1;18
2007;"ENCANTO (RN)";"RN";"ENCANTO";10;4;1;15
2007;"EQUADOR (RN)";"RN";"EQUADOR";52;3;0;55
2007;"ESPIRITO SANTO (RN)";"RN";"ESPIRITO SANTO";14;2;9;25
2007;"ESPIRITO SANTO DO OESTE (RN)";"RN";"ESPIRITO SANTO DO OESTE";13;6;1;20
2007;"EXTREMOZ (RN)";"RN";"EXTREMOZ";41;15;49;105
2007;"FELIPE GUERRA (RN)";"RN";"FELIPE GUERRA";10;6;4;20
2007;"FERNANDO PEDROZA (RN)";"RN";"FERNANDO PEDROZA";11;3;1;15
2007;"FLORANIA (RN)";"RN";"FLORANIA";38;7;3;48
2007;"FRANCISCO DANTAS (RN)";"RN";"FRANCISCO DANTAS";6;1;1;8
2007;"FRUTUOSO GOMES (RN)";"RN";"FRUTUOSO GOMES";13;8;0;21
2007;"GALINHOS (RN)";"RN";"GALINHOS";6;3;2;11
2007;"GOIANINHA (RN)";"RN";"GOIANINHA";93;24;40;157
2007;"GOVERNADOR DIX SEPT ROSADO (RN)";"RN";"GOVERNADOR DIX SEPT ROSADO";95;6;10;111
2007;"GROSSOS (RN)";"RN";"GROSSOS";29;4;6;39
2007;"GUAMARE (RN)";"RN";"GUAMARE";38;13;18;69
2007;"IELMO MARINHO (RN)";"RN";"IELMO MARINHO";39;2;10;51
2007;"IPANGUACU (RN)";"RN";"IPANGUACU";48;12;43;103
2007;"IPUEIRA (RN)";"RN";"IPUEIRA";11;6;6;23
2007;"ITAJA (RN)";"RN";"ITAJA";52;4;5;61
2007;"ITAU (RN)";"RN";"ITAU";13;2;1;16
2007;"JACANA (RN)";"RN";"JACANA";75;23;9;107
2007;"JANDAIRA (RN)";"RN";"JANDAIRA";29;1;7;37
2007;"JANDUIS (RN)";"RN";"JANDUIS";10;2;0;12
2007;"JAPI (RN)";"RN";"JAPI";26;4;5;35
2007;"JARDIM DE ANGICOS (RN)";"RN";"JARDIM DE ANGICOS";4;1;1;6
2007;"JARDIM DE PIRANHAS (RN)";"RN";"JARDIM DE PIRANHAS";55;18;5;78
2007;"JARDIM DO SERIDO (RN)";"RN";"JARDIM DO SERIDO";119;11;44;174
2007;"JOAO CAMARA (RN)";"RN";"JOAO CAMARA";215;8;19;242
2007;"JOAO DIAS (RN)";"RN";"JOAO DIAS";2;2;0;4
2007;"JOSE DA PENHA (RN)";"RN";"JOSE DA PENHA";14;12;1;27
2007;"JUCURUTU (RN)";"RN";"JUCURUTU";95;16;7;118
2007;"JUNDIA (RN)";"RN";"JUNDIA";10;2;4;16
2007;"LAGOA DANTA (RN)";"RN";"LAGOA DANTA";23;3;9;35
2007;"LAGOA DE PEDRAS (RN)";"RN";"LAGOA DE PEDRAS";24;3;4;31
2007;"LAGOA DE VELHOS (RN)";"RN";"LAGOA DE VELHOS";12;0;0;12
2007;"LAGOA NOVA (RN)";"RN";"LAGOA NOVA";53;7;2;62
2007;"LAGOA SALGADA (RN)";"RN";"LAGOA SALGADA";40;3;4;47
2007;"LAJES (RN)";"RN";"LAJES";40;5;6;51
2007;"LAJES PINTADAS (RN)";"RN";"LAJES PINTADAS";15;5;4;24
2007;"LUCRECIA (RN)";"RN";"LUCRECIA";18;4;1;23
2007;"LUIS GOMES (RN)";"RN";"LUIS GOMES";17;13;2;32
2007;"MACAIBA (RN)";"RN";"MACAIBA";443;30;60;533
2007;"MACAU (RN)";"RN";"MACAU";107;26;38;171
2007;"MAJOR SALES (RN)";"RN";"MAJOR SALES";7;7;0;14
2007;"MARCELINO VIEIRA (RN)";"RN";"MARCELINO VIEIRA";12;8;1;21
2007;"MARTINS (RN)";"RN";"MARTINS";30;5;4;39
2007;"MAXARANGUAPE (RN)";"RN";"MAXARANGUAPE";10;3;4;17
2007;"MESSIAS TARGINO (RN)";"RN";"MESSIAS TARGINO";22;6;1;29
2007;"MONTANHAS (RN)";"RN";"MONTANHAS";30;3;9;42
2007;"MONTE ALEGRE (RN)";"RN";"MONTE ALEGRE";71;6;10;87
2007;"MONTE DAS GAMELEIRAS (RN)";"RN";"MONTE DAS GAMELEIRAS";5;2;6;13
2007;"MOSSORO (RN)";"RN";"MOSSORO";2650;194;132;2976
2007;"NATAL (RN)";"RN";"NATAL";5291;1024;1806;8121
2007;"NISIA FLORESTA (RN)";"RN";"NISIA FLORESTA";53;28;49;130
2007;"NOVA CRUZ (RN)";"RN";"NOVA CRUZ";234;17;36;287
2007;"OLHO D AGUA DO BORGES (RN)";"RN";"OLHO D AGUA DO BORGES";14;3;0;17
2007;"OURO BRANCO (RN)";"RN";"OURO BRANCO";36;3;8;47
2007;"PARANA (RN)";"RN";"PARANA";9;5;1;15
2007;"PARAZINHO (RN)";"RN";"PARAZINHO";13;1;5;19
2007;"PARELHAS (RN)";"RN";"PARELHAS";236;14;21;271
2007;"PARNAMIRIM (RN)";"RN";"PARNAMIRIM";1210;267;238;1715
2007;"PASSA E FICA (RN)";"RN";"PASSA E FICA";67;19;8;94
2007;"PASSAGEM (RN)";"RN";"PASSAGEM";15;8;2;25
2007;"PATU (RN)";"RN";"PATU";59;23;2;84
2007;"PAU DOS FERROS (RN)";"RN";"PAU DOS FERROS";284;34;17;335
2007;"PEDRA GRANDE (RN)";"RN";"PEDRA GRANDE";6;2;3;11
2007;"PEDRA PRETA (RN)";"RN";"PEDRA PRETA";17;3;5;25
2007;"PEDRO AVELINO (RN)";"RN";"PEDRO AVELINO";28;1;1;30
2007;"PEDRO VELHO (RN)";"RN";"PEDRO VELHO";38;3;7;48
2007;"PENDENCIAS (RN)";"RN";"PENDENCIAS";45;6;12;63
2007;"PILOES (RN)";"RN";"PILOES";0;2;0;2
2007;"POCO BRANCO (RN)";"RN";"POCO BRANCO";26;4;4;34
2007;"PORTALEGRE (RN)";"RN";"PORTALEGRE";28;5;1;34
2007;"PORTO DO MANGUE (RN)";"RN";"PORTO DO MANGUE";29;8;4;41
2007;"PUREZA (RN)";"RN";"PUREZA";40;2;8;50
2007;"RAFAEL FERNANDES (RN)";"RN";"RAFAEL FERNANDES";9;2;0;11
2007;"RAFAEL GODEIRO (RN)";"RN";"RAFAEL GODEIRO";8;2;0;10
2007;"RIACHO DA CRUZ (RN)";"RN";"RIACHO DA CRUZ";1;2;0;3
2007;"RIACHO DE SANTANA (RN)";"RN";"RIACHO DE SANTANA";3;4;1;8
2007;"RIACHUELO (RN)";"RN";"RIACHUELO";24;2;3;29
2007;"RIO DO FOGO (RN)";"RN";"RIO DO FOGO";18;1;4;23
2007;"RODOLFO FERNANDES (RN)";"RN";"RODOLFO FERNANDES";17;6;1;24
2007;"RUY BARBOSA (RN)";"RN";"RUY BARBOSA";14;1;1;16
2007;"SANTA CRUZ (RN)";"RN";"SANTA CRUZ";290;16;17;323
2007;"SANTA MARIA (RN)";"RN";"SANTA MARIA";29;0;3;32
2007;"SANTANA DO MATOS (RN)";"RN";"SANTANA DO MATOS";61;8;1;70
2007;"SANTANA DO SERIDO (RN)";"RN";"SANTANA DO SERIDO";16;2;0;18
2007;"SANTO ANTONIO (RN)";"RN";"SANTO ANTONIO";90;26;11;127
2007;"SAO BENTO DO NORTE (RN)";"RN";"SAO BENTO DO NORTE";8;2;1;11
2007;"SAO BENTO DO TRAIRI (RN)";"RN";"SAO BENTO DO TRAIRI";19;1;2;22
2007;"SAO FERNANDO (RN)";"RN";"SAO FERNANDO";6;7;1;14
2007;"SAO FRANCISCO DO OESTE (RN)";"RN";"SAO FRANCISCO DO OESTE";8;2;2;12
2007;"SAO GONCALO DO AMARANTE (RN)";"RN";"SAO GONCALO DO AMARANTE";214;66;95;375
2007;"SAO JOAO DO SABUGI (RN)";"RN";"SAO JOAO DO SABUGI";30;12;1;43
2007;"SAO JOSE DE MIPIBU (RN)";"RN";"SAO JOSE DE MIPIBU";174;35;31;240
2007;"SAO JOSE DO CAMPESTRE (RN)";"RN";"SAO JOSE DO CAMPESTRE";60;5;9;74
2007;"SAO JOSE DO SERIDO (RN)";"RN";"SAO JOSE DO SERIDO";22;8;1;31
2007;"SAO MIGUEL (RN)";"RN";"SAO MIGUEL";117;14;18;149
2007;"SAO MIGUEL DE TOUROS (RN)";"RN";"SAO MIGUEL DE TOUROS";14;3;6;23
2007;"SAO PAULO DO POTENGI (RN)";"RN";"SAO PAULO DO POTENGI";85;6;5;96
2007;"SAO PEDRO (RN)";"RN";"SAO PEDRO";27;3;4;34
2007;"SAO RAFAEL (RN)";"RN";"SAO RAFAEL";22;15;0;37
2007;"SAO TOME (RN)";"RN";"SAO TOME";42;3;16;61
2007;"SAO VICENTE (RN)";"RN";"SAO VICENTE";35;2;1;38
2007;"SENADOR ELOI DE SOUZA (RN)";"RN";"SENADOR ELOI DE SOUZA";9;5;4;18
2007;"SENADOR GEORGINO AVELINO (RN)";"RN";"SENADOR GEORGINO AVELINO";10;1;1;12
2007;"SERRA CAIADA (RN)";"RN";"SERRA CAIADA";27;4;5;36
2007;"SERRA DE SAO BENTO (RN)";"RN";"SERRA DE SAO BENTO";22;4;2;28
2007;"SERRA DO MEL (RN)";"RN";"SERRA DO MEL";43;9;5;57
2007;"SERRA NEGRA DO NORTE (RN)";"RN";"SERRA NEGRA DO NORTE";87;10;2;99
2007;"SERRINHA (RN)";"RN";"SERRINHA";19;11;2;32
2007;"SERRINHA DOS PINTOS (RN)";"RN";"SERRINHA DOS PINTOS";23;5;1;29
2007;"SEVERIANO MELO (RN)";"RN";"SEVERIANO MELO";21;2;5;28
2007;"SITIO NOVO (RN)";"RN";"SITIO NOVO";19;5;0;24
2007;"TABOLEIRO GRANDE (RN)";"RN";"TABOLEIRO GRANDE";5;3;1;9
2007;"TAIPU (RN)";"RN";"TAIPU";38;2;7;47
2007;"TANGARA (RN)";"RN";"TANGARA";69;2;16;87
2007;"TENENTE ANANIAS (RN)";"RN";"TENENTE ANANIAS";25;3;1;29
2007;"TENENTE LAURENTINO CRUZ (RN)";"RN";"TENENTE LAURENTINO CRUZ";36;9;2;47
2007;"TIBAU (RN)";"RN";"TIBAU";15;12;4;31
2007;"TIBAU DO SUL (RN)";"RN";"TIBAU DO SUL";30;38;7;75
2007;"TIMBAUBA DOS BATISTAS (RN)";"RN";"TIMBAUBA DOS BATISTAS";12;6;2;20
2007;"TOUROS (RN)";"RN";"TOUROS";131;19;25;175
2007;"TRIUNFO POTIGUAR (RN)";"RN";"TRIUNFO POTIGUAR";11;5;0;16
2007;"UMARIZAL (RN)";"RN";"UMARIZAL";52;15;1;68
2007;"UPANEMA (RN)";"RN";"UPANEMA";31;9;7;47
2007;"VARZEA (RN)";"RN";"VARZEA";8;6;5;19
2007;"VENHA VER (RN)";"RN";"VENHA VER";14;3;0;17
2007;"VERA CRUZ (RN)";"RN";"VERA CRUZ";87;4;15;106
2007;"VICOSA (RN)";"RN";"VICOSA";4;2;0;6
2007;"VILA FLOR (RN)";"RN";"VILA FLOR";8;1;1;10
2007;"ALTA FLORESTA D OESTE (RO)";"RO";"ALTA FLORESTA D OESTE";370;8;27;405
2007;"ALTO ALEGRE DOS PARECIS (RO)";"RO";"ALTO ALEGRE DOS PARECIS";74;3;7;84
2007;"ALTO PARAISO (RO)";"RO";"ALTO PARAISO";124;6;23;153
2007;"ALVORADA D OESTE (RO)";"RO";"ALVORADA D OESTE";208;5;30;243
2007;"ARIQUEMES (RO)";"RO";"ARIQUEMES";1634;23;138;1795
2007;"BURITIS (RO)";"RO";"BURITIS";251;3;11;265
2007;"CABIXI (RO)";"RO";"CABIXI";55;1;13;69
2007;"CACAULANDIA (RO)";"RO";"CACAULANDIA";24;1;9;34
2007;"CACOAL (RO)";"RO";"CACOAL";1286;33;154;1473
2007;"CAMPO NOVO DE RONDONIA (RO)";"RO";"CAMPO NOVO DE RONDONIA";31;0;6;37
2007;"CANDEIAS DO JAMARI (RO)";"RO";"CANDEIAS DO JAMARI";81;2;5;88
2007;"CASTANHEIRAS (RO)";"RO";"CASTANHEIRAS";21;2;4;27
2007;"CEREJEIRAS (RO)";"RO";"CEREJEIRAS";296;10;30;336
2007;"CHUPINGUAIA (RO)";"RO";"CHUPINGUAIA";67;1;12;80
2007;"COLORADO DO OESTE (RO)";"RO";"COLORADO DO OESTE";336;7;30;373
2007;"CORUMBIARA (RO)";"RO";"CORUMBIARA";35;4;5;44
2007;"COSTA MARQUES (RO)";"RO";"COSTA MARQUES";36;2;5;43
2007;"CUJUBIM (RO)";"RO";"CUJUBIM";60;1;5;66
2007;"ESPIGAO D OESTE (RO)";"RO";"ESPIGAO D OESTE";401;4;53;458
2007;"GOVERNADOR JORGE TEIXEIRA (RO)";"RO";"GOVERNADOR JORGE TEIXEIRA";28;0;7;35
2007;"GUAJARA MIRIM (RO)";"RO";"GUAJARA MIRIM";428;8;11;447
2007;"JAMARI (RO)";"RO";"JAMARI";50;0;9;59
2007;"JARU (RO)";"RO";"JARU";855;19;115;989
2007;"JI PARANA (RO)";"RO";"JI PARANA";2175;52;506;2733
2007;"MACHADINHO D OESTE (RO)";"RO";"MACHADINHO D OESTE";203;3;31;237
2007;"MINISTRO ANDREAZZA (RO)";"RO";"MINISTRO ANDREAZZA";103;1;12;116
2007;"MIRANTE DA SERRA (RO)";"RO";"MIRANTE DA SERRA";123;1;12;136
2007;"MONTE NEGRO (RO)";"RO";"MONTE NEGRO";168;1;35;204
2007;"NOVA BRASILANDIA D OESTE (RO)";"RO";"NOVA BRASILANDIA D OESTE";198;7;21;226
2007;"NOVA UNIAO (RO)";"RO";"NOVA UNIAO";20;1;2;23
2007;"NOVO HORIZONTE DO OESTE (RO)";"RO";"NOVO HORIZONTE DO OESTE";60;1;10;71
2007;"OURO PRETO DO OESTE (RO)";"RO";"OURO PRETO DO OESTE";634;19;88;741
2007;"PARECIS (RO)";"RO";"PARECIS";15;0;6;21
2007;"PIMENTA BUENO (RO)";"RO";"PIMENTA BUENO";743;19;50;812
2007;"PIMENTEIRAS DO OESTE (RO)";"RO";"PIMENTEIRAS DO OESTE";8;0;8;16
2007;"PORTO VELHO (RO)";"RO";"PORTO VELHO";3545;204;729;4478
2007;"PRESIDENTE MEDICI (RO)";"RO";"PRESIDENTE MEDICI";212;2;30;244
2007;"PRIMAVERA DE RONDONIA (RO)";"RO";"PRIMAVERA DE RONDONIA";26;1;6;33
2007;"RIO CRESPO (RO)";"RO";"RIO CRESPO";45;1;14;60
2007;"ROLIM DE MOURA (RO)";"RO";"ROLIM DE MOURA";1009;23;80;1112
2007;"SANTA LUZIA D OESTE (RO)";"RO";"SANTA LUZIA D OESTE";90;2;31;123
2007;"SAO FELIPE D OESTE (RO)";"RO";"SAO FELIPE D OESTE";28;1;11;40
2007;"SAO FRANCISCO DO GUAPORE (RO)";"RO";"SAO FRANCISCO DO GUAPORE";119;2;12;133
2007;"SAO MIGUEL DO GUAPORE (RO)";"RO";"SAO MIGUEL DO GUAPORE";185;3;18;206
2007;"SERINGUEIRAS (RO)";"RO";"SERINGUEIRAS";62;3;9;74
2007;"TEIXEIROPOLIS (RO)";"RO";"TEIXEIROPOLIS";16;0;5;21
2007;"THEOBROMA (RO)";"RO";"THEOBROMA";25;0;15;40
2007;"URUPA (RO)";"RO";"URUPA";88;2;22;112
2007;"VALE DO ANARI (RO)";"RO";"VALE DO ANARI";23;1;1;25
2007;"VALE DO PARAISO (RO)";"RO";"VALE DO PARAISO";35;0;2;37
2007;"VILA NOVA DO MAMORE (RO)";"RO";"VILA NOVA DO MAMORE";79;1;9;89
2007;"VILHENA (RO)";"RO";"VILHENA";1080;29;119;1228
2007;"ALTO ALEGRE (RR)";"RR";"ALTO ALEGRE";31;2;5;38
2007;"AMAJARI (RR)";"RR";"AMAJARI";9;3;0;12
2007;"BOA VISTA (RR)";"RR";"BOA VISTA";2350;232;397;2979
2007;"BONFIM (RR)";"RR";"BONFIM";7;0;0;7
2007;"CANTA (RR)";"RR";"CANTA";15;2;4;21
2007;"CARACARAI (RR)";"RR";"CARACARAI";43;2;0;45
2007;"CAROEBE (RR)";"RR";"CAROEBE";18;2;6;26
2007;"IRACEMA (RR)";"RR";"IRACEMA";16;8;0;24
2007;"MUCAJAI (RR)";"RR";"MUCAJAI";59;23;17;99
2007;"NORMANDIA (RR)";"RR";"NORMANDIA";9;0;0;9
2007;"PACARAIMA (RR)";"RR";"PACARAIMA";28;0;2;30
2007;"RORAINOPOLIS (RR)";"RR";"RORAINOPOLIS";48;6;6;60
2007;"SAO JOAO DA BALIZA (RR)";"RR";"SAO JOAO DA BALIZA";22;4;1;27
2007;"SAO LUIZ (RR)";"RR";"SAO LUIZ";26;1;1;28
2007;"UIRAMUTA (RR)";"RR";"UIRAMUTA";1;0;0;1
2007;"ACEGUA (RS)";"RS";"ACEGUA";52;11;10;73
2007;"AGUA SANTA (RS)";"RS";"AGUA SANTA";121;3;14;138
2007;"AGUDO (RS)";"RS";"AGUDO";268;10;51;329
2007;"AJURICABA (RS)";"RS";"AJURICABA";304;13;31;348
2007;"ALECRIM (RS)";"RS";"ALECRIM";75;6;21;102
2007;"ALEGRETE (RS)";"RS";"ALEGRETE";847;39;172;1058
2007;"ALEGRIA (RS)";"RS";"ALEGRIA";73;3;15;91
2007;"ALMIRANTE TAMANDARE DO SUL (RS)";"RS";"ALMIRANTE TAMANDARE DO SUL";62;5;1;68
2007;"ALPESTRE (RS)";"RS";"ALPESTRE";106;19;27;152
2007;"ALTO ALEGRE (RS)";"RS";"ALTO ALEGRE";63;4;7;74
2007;"ALTO FELIZ (RS)";"RS";"ALTO FELIZ";79;6;10;95
2007;"ALVORADA (RS)";"RS";"ALVORADA";1210;116;514;1840
2007;"AMARAL FERRADOR (RS)";"RS";"AMARAL FERRADOR";116;9;15;140
2007;"AMETISTA DO SUL (RS)";"RS";"AMETISTA DO SUL";44;1;20;65
2007;"ANDRE DA ROCHA (RS)";"RS";"ANDRE DA ROCHA";44;3;3;50
2007;"ANTA GORDA (RS)";"RS";"ANTA GORDA";175;11;21;207
2007;"ANTONIO PRADO (RS)";"RS";"ANTONIO PRADO";585;21;41;647
2007;"ARAMBARE (RS)";"RS";"ARAMBARE";30;5;7;42
2007;"ARARICA (RS)";"RS";"ARARICA";60;6;7;73
2007;"ARATIBA (RS)";"RS";"ARATIBA";132;19;24;175
2007;"ARROIO DO MEIO (RS)";"RS";"ARROIO DO MEIO";406;20;48;474
2007;"ARROIO DO PADRE (RS)";"RS";"ARROIO DO PADRE";78;8;10;96
2007;"ARROIO DO SAL (RS)";"RS";"ARROIO DO SAL";72;10;13;95
2007;"ARROIO DO TIGRE (RS)";"RS";"ARROIO DO TIGRE";246;23;30;299
2007;"ARROIO DOS RATOS (RS)";"RS";"ARROIO DOS RATOS";177;5;55;237
2007;"ARROIO GRANDE (RS)";"RS";"ARROIO GRANDE";205;17;32;254
2007;"ARVOREZINHA (RS)";"RS";"ARVOREZINHA";362;38;25;425
2007;"AUGUSTO PESTANA (RS)";"RS";"AUGUSTO PESTANA";308;13;21;342
2007;"AUREA (RS)";"RS";"AUREA";92;5;7;104
2007;"BAGE (RS)";"RS";"BAGE";1001;116;234;1351
2007;"BALNEARIO PINHAL (RS)";"RS";"BALNEARIO PINHAL";91;9;10;110
2007;"BARAO (RS)";"RS";"BARAO";154;21;28;203
2007;"BARAO DE COTEGIPE (RS)";"RS";"BARAO DE COTEGIPE";173;11;15;199
2007;"BARAO DO TRIUNFO (RS)";"RS";"BARAO DO TRIUNFO";109;15;23;147
2007;"BARRA DO GUARITA (RS)";"RS";"BARRA DO GUARITA";16;2;3;21
2007;"BARRA DO QUARAI (RS)";"RS";"BARRA DO QUARAI";33;3;12;48
2007;"BARRA DO RIBEIRO (RS)";"RS";"BARRA DO RIBEIRO";136;9;46;191
2007;"BARRA DO RIO AZUL (RS)";"RS";"BARRA DO RIO AZUL";38;8;8;54
2007;"BARRA FUNDA (RS)";"RS";"BARRA FUNDA";139;5;8;152
2007;"BARRACAO (RS)";"RS";"BARRACAO";105;8;12;125
2007;"BARROS CASSAL (RS)";"RS";"BARROS CASSAL";130;8;32;170
2007;"BENJAMIN CONSTANT DO SUL (RS)";"RS";"BENJAMIN CONSTANT DO SUL";23;4;4;31
2007;"BENTO GONCALVES (RS)";"RS";"BENTO GONCALVES";2851;181;288;3320
2007;"BOA VISTA DAS MISSOES (RS)";"RS";"BOA VISTA DAS MISSOES";71;4;9;84
2007;"BOA VISTA DO BURICA (RS)";"RS";"BOA VISTA DO BURICA";163;12;21;196
2007;"BOA VISTA DO CADEADO (RS)";"RS";"BOA VISTA DO CADEADO";46;2;17;65
2007;"BOA VISTA DO INCRA (RS)";"RS";"BOA VISTA DO INCRA";51;1;7;59
2007;"BOA VISTA DO SUL (RS)";"RS";"BOA VISTA DO SUL";288;5;7;300
2007;"BOM JESUS (RS)";"RS";"BOM JESUS";227;16;36;279
2007;"BOM PRINCIPIO (RS)";"RS";"BOM PRINCIPIO";330;27;30;387
2007;"BOM PROGRESSO (RS)";"RS";"BOM PROGRESSO";32;5;4;41
2007;"BOM RETIRO DO SUL (RS)";"RS";"BOM RETIRO DO SUL";142;7;26;175
2007;"BOQUEIRAO DO LEAO (RS)";"RS";"BOQUEIRAO DO LEAO";144;6;17;167
2007;"BOSSOROCA (RS)";"RS";"BOSSOROCA";138;4;13;155
2007;"BOZANO (RS)";"RS";"BOZANO";100;1;9;110
2007;"BRAGA (RS)";"RS";"BRAGA";54;0;8;62
2007;"BROCHIER (RS)";"RS";"BROCHIER";212;13;23;248
2007;"BUTIA (RS)";"RS";"BUTIA";307;12;77;396
2007;"CACAPAVA DO SUL (RS)";"RS";"CACAPAVA DO SUL";506;32;95;633
2007;"CACEQUI (RS)";"RS";"CACEQUI";120;10;20;150
2007;"CACHOEIRA DO SUL (RS)";"RS";"CACHOEIRA DO SUL";953;58;199;1210
2007;"CACHOEIRINHA (RS)";"RS";"CACHOEIRINHA";1852;188;360;2400
2007;"CACIQUE DOBLE (RS)";"RS";"CACIQUE DOBLE";83;3;10;96
2007;"CAIBATE (RS)";"RS";"CAIBATE";109;7;3;119
2007;"CAICARA (RS)";"RS";"CAICARA";67;7;14;88
2007;"CAMAQUA (RS)";"RS";"CAMAQUA";1191;42;195;1428
2007;"CAMARGO (RS)";"RS";"CAMARGO";94;7;12;113
2007;"CAMBARA DO SUL (RS)";"RS";"CAMBARA DO SUL";280;13;30;323
2007;"CAMPESTRE DA SERRA (RS)";"RS";"CAMPESTRE DA SERRA";136;5;6;147
2007;"CAMPINA DAS MISSOES (RS)";"RS";"CAMPINA DAS MISSOES";106;9;23;138
2007;"CAMPINAS DO SUL (RS)";"RS";"CAMPINAS DO SUL";181;14;22;217
2007;"CAMPO BOM (RS)";"RS";"CAMPO BOM";612;80;115;807
2007;"CAMPO NOVO (RS)";"RS";"CAMPO NOVO";138;8;15;161
2007;"CAMPOS BORGES (RS)";"RS";"CAMPOS BORGES";94;9;11;114
2007;"CANDELARIA (RS)";"RS";"CANDELARIA";344;18;68;430
2007;"CANDIDO GODOI (RS)";"RS";"CANDIDO GODOI";171;16;19;206
2007;"CANDIOTA (RS)";"RS";"CANDIOTA";96;25;25;146
2007;"CANELA (RS)";"RS";"CANELA";475;58;109;642
2007;"CANGUCU (RS)";"RS";"CANGUCU";919;37;123;1079
2007;"CANOAS (RS)";"RS";"CANOAS";3558;344;904;4806
2007;"CANUDOS DO VALE (RS)";"RS";"CANUDOS DO VALE";19;6;1;26
2007;"CAPAO BONITO DO SUL (RS)";"RS";"CAPAO BONITO DO SUL";32;2;3;37
2007;"CAPAO DA CANOA (RS)";"RS";"CAPAO DA CANOA";348;67;79;494
2007;"CAPAO DO CIPO (RS)";"RS";"CAPAO DO CIPO";55;5;5;65
2007;"CAPAO DO LEAO (RS)";"RS";"CAPAO DO LEAO";265;8;23;296
2007;"CAPELA DE SANTANA (RS)";"RS";"CAPELA DE SANTANA";108;9;31;148
2007;"CAPITAO (RS)";"RS";"CAPITAO";55;8;6;69
2007;"CAPIVARI DO SUL (RS)";"RS";"CAPIVARI DO SUL";94;9;4;107
2007;"CARAA (RS)";"RS";"CARAA";78;2;12;92
2007;"CARAZINHO (RS)";"RS";"CARAZINHO";1207;64;199;1470
2007;"CARLOS BARBOSA (RS)";"RS";"CARLOS BARBOSA";618;44;80;742
2007;"CARLOS GOMES (RS)";"RS";"CARLOS GOMES";20;2;6;28
2007;"CASCA (RS)";"RS";"CASCA";335;12;12;359
2007;"CASEIROS (RS)";"RS";"CASEIROS";112;7;12;131
2007;"CATUIPE (RS)";"RS";"CATUIPE";299;5;22;326
2007;"CAXIAS DO SUL (RS)";"RS";"CAXIAS DO SUL";7182;1122;1325;9629
2007;"CENTENARIO (RS)";"RS";"CENTENARIO";76;8;3;87
2007;"CERRITO (RS)";"RS";"CERRITO";97;3;7;107
2007;"CERRO BRANCO (RS)";"RS";"CERRO BRANCO";62;5;16;83
2007;"CERRO GRANDE (RS)";"RS";"CERRO GRANDE";40;1;8;49
2007;"CERRO GRANDE DO SUL (RS)";"RS";"CERRO GRANDE DO SUL";205;17;15;237
2007;"CERRO LARGO (RS)";"RS";"CERRO LARGO";257;10;40;307
2007;"CHAPADA (RS)";"RS";"CHAPADA";272;33;22;327
2007;"CHARQUEADAS (RS)";"RS";"CHARQUEADAS";286;57;60;403
2007;"CHARRUA (RS)";"RS";"CHARRUA";77;2;9;88
2007;"CHIAPETTA (RS)";"RS";"CHIAPETTA";104;5;11;120
2007;"CHUI (RS)";"RS";"CHUI";131;12;12;155
2007;"CHUVISCA (RS)";"RS";"CHUVISCA";91;2;22;115
2007;"CIDREIRA (RS)";"RS";"CIDREIRA";79;9;20;108
2007;"CIRIACO (RS)";"RS";"CIRIACO";123;13;17;153
2007;"COLINAS (RS)";"RS";"COLINAS";55;6;11;72
2007;"COLORADO (RS)";"RS";"COLORADO";183;12;12;207
2007;"CONDOR (RS)";"RS";"CONDOR";188;7;21;216
2007;"CONSTANTINA (RS)";"RS";"CONSTANTINA";226;12;64;302
2007;"COQUEIRO BAIXO (RS)";"RS";"COQUEIRO BAIXO";15;7;2;24
2007;"COQUEIROS DO SUL (RS)";"RS";"COQUEIROS DO SUL";92;3;10;105
2007;"CORONEL BARROS (RS)";"RS";"CORONEL BARROS";81;1;9;91
2007;"CORONEL BICACO (RS)";"RS";"CORONEL BICACO";155;14;11;180
2007;"CORONEL PILAR (RS)";"RS";"CORONEL PILAR";177;3;10;190
2007;"COTIPORA (RS)";"RS";"COTIPORA";162;9;8;179
2007;"COXILHA (RS)";"RS";"COXILHA";83;3;8;94
2007;"CRISSIUMAL (RS)";"RS";"CRISSIUMAL";237;21;45;303
2007;"CRISTAL (RS)";"RS";"CRISTAL";137;5;21;163
2007;"CRISTAL DO SUL (RS)";"RS";"CRISTAL DO SUL";17;2;14;33
2007;"CRUZ ALTA (RS)";"RS";"CRUZ ALTA";1103;56;115;1274
2007;"CRUZALTENSE (RS)";"RS";"CRUZALTENSE";49;2;8;59
2007;"CRUZEIRO DO SUL (RS)";"RS";"CRUZEIRO DO SUL";269;8;13;290
2007;"DAVID CANABARRO (RS)";"RS";"DAVID CANABARRO";143;4;23;170
2007;"DERRUBADAS (RS)";"RS";"DERRUBADAS";65;9;1;75
2007;"DEZESSEIS DE NOVEMBRO (RS)";"RS";"DEZESSEIS DE NOVEMBRO";39;3;5;47
2007;"DILERMANDO DE AGUIAR (RS)";"RS";"DILERMANDO DE AGUIAR";34;2;21;57
2007;"DOIS IRMAOS (RS)";"RS";"DOIS IRMAOS";373;17;114;504
2007;"DOIS IRMAOS DAS MISSOES (RS)";"RS";"DOIS IRMAOS DAS MISSOES";43;4;4;51
2007;"DOIS LAJEADOS (RS)";"RS";"DOIS LAJEADOS";106;3;17;126
2007;"DOM FELICIANO (RS)";"RS";"DOM FELICIANO";220;12;63;295
2007;"DOM PEDRITO (RS)";"RS";"DOM PEDRITO";500;24;30;554
2007;"DOM PEDRO DE ALCANTARA (RS)";"RS";"DOM PEDRO DE ALCANTARA";71;2;3;76
2007;"DONA FRANCISCA (RS)";"RS";"DONA FRANCISCA";36;1;6;43
2007;"DOUTOR MAURICIO CARDOSO (RS)";"RS";"DOUTOR MAURICIO CARDOSO";147;19;16;182
2007;"DOUTOR RICARDO (RS)";"RS";"DOUTOR RICARDO";47;3;8;58
2007;"ELDORADO DO SUL (RS)";"RS";"ELDORADO DO SUL";339;22;30;391
2007;"ENCANTADO (RS)";"RS";"ENCANTADO";527;32;93;652
2007;"ENCRUZILHADA DO SUL (RS)";"RS";"ENCRUZILHADA DO SUL";301;13;104;418
2007;"ENGENHO VELHO (RS)";"RS";"ENGENHO VELHO";20;4;9;33
2007;"ENTRE IJUIS (RS)";"RS";"ENTRE IJUIS";236;13;32;281
2007;"ENTRE RIOS DO SUL (RS)";"RS";"ENTRE RIOS DO SUL";41;10;10;61
2007;"EREBANGO (RS)";"RS";"EREBANGO";98;2;5;105
2007;"ERECHIM (RS)";"RS";"ERECHIM";1532;184;575;2291
2007;"ERNESTINA (RS)";"RS";"ERNESTINA";131;12;11;154
2007;"ERVAL GRANDE (RS)";"RS";"ERVAL GRANDE";93;16;11;120
2007;"ERVAL SECO (RS)";"RS";"ERVAL SECO";122;6;23;151
2007;"ESMERALDA (RS)";"RS";"ESMERALDA";61;2;12;75
2007;"ESPERANCA DO SUL (RS)";"RS";"ESPERANCA DO SUL";39;1;9;49
2007;"ESPUMOSO (RS)";"RS";"ESPUMOSO";515;25;65;605
2007;"ESTACAO (RS)";"RS";"ESTACAO";176;12;7;195
2007;"ESTANCIA VELHA (RS)";"RS";"ESTANCIA VELHA";659;55;122;836
2007;"ESTEIO (RS)";"RS";"ESTEIO";1070;104;215;1389
2007;"ESTRELA (RS)";"RS";"ESTRELA";712;43;87;842
2007;"ESTRELA VELHA (RS)";"RS";"ESTRELA VELHA";87;5;9;101
2007;"EUGENIO DE CASTRO (RS)";"RS";"EUGENIO DE CASTRO";78;7;7;92
2007;"FAGUNDES VARELA (RS)";"RS";"FAGUNDES VARELA";83;4;11;98
2007;"FARROUPILHA (RS)";"RS";"FARROUPILHA";1770;190;197;2157
2007;"FAXINAL DO SOTURNO (RS)";"RS";"FAXINAL DO SOTURNO";111;6;5;122
2007;"FAXINALZINHO (RS)";"RS";"FAXINALZINHO";55;6;8;69
2007;"FAZENDA VILANOVA (RS)";"RS";"FAZENDA VILANOVA";96;9;10;115
2007;"FELIZ (RS)";"RS";"FELIZ";357;27;79;463
2007;"FLORES DA CUNHA (RS)";"RS";"FLORES DA CUNHA";1212;58;96;1366
2007;"FLORIANO PEIXOTO (RS)";"RS";"FLORIANO PEIXOTO";53;11;11;75
2007;"FONTOURA XAVIER (RS)";"RS";"FONTOURA XAVIER";151;10;32;193
2007;"FORMIGUEIRO (RS)";"RS";"FORMIGUEIRO";101;3;19;123
2007;"FORQUETINHA (RS)";"RS";"FORQUETINHA";40;1;2;43
2007;"FORTALEZA DOS VALOS (RS)";"RS";"FORTALEZA DOS VALOS";222;2;16;240
2007;"FREDERICO WESTPHALEN (RS)";"RS";"FREDERICO WESTPHALEN";560;27;62;649
2007;"GARIBALDI (RS)";"RS";"GARIBALDI";1233;65;96;1394
2007;"GARRUCHOS (RS)";"RS";"GARRUCHOS";23;4;9;36
2007;"GAURAMA (RS)";"RS";"GAURAMA";153;11;10;174
2007;"GENERAL CAMARA (RS)";"RS";"GENERAL CAMARA";69;9;18;96
2007;"GENTIL (RS)";"RS";"GENTIL";84;5;14;103
2007;"GETULIO VARGAS (RS)";"RS";"GETULIO VARGAS";415;24;32;471
2007;"GIRUA (RS)";"RS";"GIRUA";439;23;34;496
2007;"GLORINHA (RS)";"RS";"GLORINHA";157;19;8;184
2007;"GRAMADO (RS)";"RS";"GRAMADO";590;100;104;794
2007;"GRAMADO DOS LOUREIROS (RS)";"RS";"GRAMADO DOS LOUREIROS";23;2;9;34
2007;"GRAMADO XAVIER (RS)";"RS";"GRAMADO XAVIER";54;3;6;63
2007;"GRAVATAI (RS)";"RS";"GRAVATAI";2590;365;499;3454
2007;"GUABIJU (RS)";"RS";"GUABIJU";44;5;7;56
2007;"GUAIBA (RS)";"RS";"GUAIBA";918;110;367;1395
2007;"GUAPORE (RS)";"RS";"GUAPORE";371;28;50;449
2007;"GUARANI DAS MISSOES (RS)";"RS";"GUARANI DAS MISSOES";181;5;14;200
2007;"NOVA ARACA (RS)";"RS";"NOVA ARACA";141;18;25;184
2007;"NOVA BASSANO (RS)";"RS";"NOVA BASSANO";392;22;30;444
2007;"NOVA BOA VISTA (RS)";"RS";"NOVA BOA VISTA";55;7;9;71
2007;"NOVA BRESCIA (RS)";"RS";"NOVA BRESCIA";87;15;6;108
2007;"NOVA CANDELARIA (RS)";"RS";"NOVA CANDELARIA";62;5;7;74
2007;"NOVA ESPERANCA DO SUL (RS)";"RS";"NOVA ESPERANCA DO SUL";46;8;16;70
2007;"NOVA HARTZ (RS)";"RS";"NOVA HARTZ";106;14;58;178
2007;"NOVA PADUA (RS)";"RS";"NOVA PADUA";268;3;6;277
2007;"NOVA PALMA (RS)";"RS";"NOVA PALMA";191;13;20;224
2007;"NOVA PETROPOLIS (RS)";"RS";"NOVA PETROPOLIS";446;44;72;562
2007;"NOVA PRATA (RS)";"RS";"NOVA PRATA";528;25;47;600
2007;"NOVA RAMADA (RS)";"RS";"NOVA RAMADA";75;4;6;85
2007;"NOVA ROMA DO SUL (RS)";"RS";"NOVA ROMA DO SUL";218;6;31;255
2007;"NOVA SANTA RITA (RS)";"RS";"NOVA SANTA RITA";434;44;43;521
2007;"NOVO BARREIRO (RS)";"RS";"NOVO BARREIRO";81;7;11;99
2007;"NOVO CABRAIS (RS)";"RS";"NOVO CABRAIS";63;2;5;70
2007;"NOVO HAMBURGO (RS)";"RS";"NOVO HAMBURGO";2394;238;463;3095
2007;"NOVO MACHADO (RS)";"RS";"NOVO MACHADO";125;19;8;152
2007;"NOVO TIRADENTES (RS)";"RS";"NOVO TIRADENTES";25;1;10;36
2007;"NOVO XINGU (RS)";"RS";"NOVO XINGU";27;9;7;43
2007;"OSORIO (RS)";"RS";"OSORIO";720;45;126;891
2007;"PAIM FILHO (RS)";"RS";"PAIM FILHO";99;5;17;121
2007;"PALMARES DO SUL (RS)";"RS";"PALMARES DO SUL";162;15;26;203
2007;"PALMEIRA DAS MISSOES (RS)";"RS";"PALMEIRA DAS MISSOES";776;26;64;866
2007;"PALMITINHO (RS)";"RS";"PALMITINHO";126;7;23;156
2007;"PANAMBI (RS)";"RS";"PANAMBI";820;43;104;967
2007;"PANTANO GRANDE (RS)";"RS";"PANTANO GRANDE";274;9;23;306
2007;"PARAI (RS)";"RS";"PARAI";315;7;21;343
2007;"PARAISO DO SUL (RS)";"RS";"PARAISO DO SUL";84;2;6;92
2007;"PARECI NOVO (RS)";"RS";"PARECI NOVO";379;7;22;408
2007;"PAROBE (RS)";"RS";"PAROBE";387;65;137;589
2007;"PASSA SETE (RS)";"RS";"PASSA SETE";57;1;21;79
2007;"PASSO DO SOBRADO (RS)";"RS";"PASSO DO SOBRADO";121;6;41;168
2007;"PASSO FUNDO (RS)";"RS";"PASSO FUNDO";2676;148;334;3158
2007;"PAULO BENTO (RS)";"RS";"PAULO BENTO";65;10;5;80
2007;"PAVERAMA (RS)";"RS";"PAVERAMA";156;22;40;218
2007;"PEDRAS ALTAS (RS)";"RS";"PEDRAS ALTAS";10;12;2;24
2007;"PEDRO OSORIO (RS)";"RS";"PEDRO OSORIO";92;7;24;123
2007;"PEJUCARA (RS)";"RS";"PEJUCARA";202;3;11;216
2007;"PELOTAS (RS)";"RS";"PELOTAS";4488;222;950;5660
2007;"PICADA CAFE (RS)";"RS";"PICADA CAFE";83;16;48;147
2007;"PINHAL (RS)";"RS";"PINHAL";59;2;9;70
2007;"PINHAL DA SERRA (RS)";"RS";"PINHAL DA SERRA";36;4;7;47
2007;"PINHAL GRANDE (RS)";"RS";"PINHAL GRANDE";78;10;13;101
2007;"PINHEIRINHO DO VALE (RS)";"RS";"PINHEIRINHO DO VALE";45;2;15;62
2007;"PINHEIRO MACHADO (RS)";"RS";"PINHEIRO MACHADO";136;10;30;176
2007;"PINTO BANDEIRA (RS)";"RS";"PINTO BANDEIRA";5;0;0;5
2007;"PIRAPO (RS)";"RS";"PIRAPO";24;7;7;38
2007;"PIRATINI (RS)";"RS";"PIRATINI";233;23;75;331
2007;"PLANALTO (RS)";"RS";"PLANALTO";167;5;28;200
2007;"POCO DAS ANTAS (RS)";"RS";"POCO DAS ANTAS";76;9;17;102
2007;"PONTAO (RS)";"RS";"PONTAO";74;4;17;95
2007;"PONTE PRETA (RS)";"RS";"PONTE PRETA";50;6;5;61
2007;"PORTAO (RS)";"RS";"PORTAO";1469;66;102;1637
2007;"PORTO ALEGRE (RS)";"RS";"PORTO ALEGRE";13028;1981;3817;18826
2007;"PORTO LUCENA (RS)";"RS";"PORTO LUCENA";69;7;16;92
2007;"PORTO MAUA (RS)";"RS";"PORTO MAUA";37;7;7;51
2007;"PORTO VERA CRUZ (RS)";"RS";"PORTO VERA CRUZ";6;2;4;12
2007;"PORTO XAVIER (RS)";"RS";"PORTO XAVIER";172;8;29;209
2007;"POUSO NOVO (RS)";"RS";"POUSO NOVO";26;4;5;35
2007;"PRESIDENTE LUCENA (RS)";"RS";"PRESIDENTE LUCENA";100;4;7;111
2007;"PROGRESSO (RS)";"RS";"PROGRESSO";89;8;20;117
2007;"PROTASIO ALVES (RS)";"RS";"PROTASIO ALVES";46;3;4;53
2007;"PUTINGA (RS)";"RS";"PUTINGA";84;4;10;98
2007;"QUARAI (RS)";"RS";"QUARAI";143;12;35;190
2007;"QUATRO IRMAOS (RS)";"RS";"QUATRO IRMAOS";45;10;3;58
2007;"QUEVEDOS (RS)";"RS";"QUEVEDOS";22;2;5;29
2007;"QUINZE DE NOVEMBRO (RS)";"RS";"QUINZE DE NOVEMBRO";153;12;16;181
2007;"REDENTORA (RS)";"RS";"REDENTORA";84;8;10;102
2007;"RELVADO (RS)";"RS";"RELVADO";38;7;4;49
2007;"RESTINGA SECA (RS)";"RS";"RESTINGA SECA";242;7;48;297
2007;"RIO DOS INDIOS (RS)";"RS";"RIO DOS INDIOS";45;2;26;73
2007;"RIO GRANDE (RS)";"RS";"RIO GRANDE";1696;106;421;2223
2007;"RIO PARDO (RS)";"RS";"RIO PARDO";370;30;66;466
2007;"RIOZINHO (RS)";"RS";"RIOZINHO";44;5;27;76
2007;"ROCA SALES (RS)";"RS";"ROCA SALES";139;17;38;194
2007;"RODEIO BONITO (RS)";"RS";"RODEIO BONITO";77;5;23;105
2007;"ROLADOR (RS)";"RS";"ROLADOR";37;3;8;48
2007;"ROLANTE (RS)";"RS";"ROLANTE";187;16;54;257
2007;"RONDA ALTA (RS)";"RS";"RONDA ALTA";221;13;24;258
2007;"RONDINHA (RS)";"RS";"RONDINHA";139;12;17;168
2007;"ROQUE GONZALES (RS)";"RS";"ROQUE GONZALES";101;2;22;125
2007;"ROSARIO DO SUL (RS)";"RS";"ROSARIO DO SUL";390;24;54;468
2007;"SAGRADA FAMILIA (RS)";"RS";"SAGRADA FAMILIA";19;4;8;31
2007;"SALDANHA MARINHO (RS)";"RS";"SALDANHA MARINHO";143;9;7;159
2007;"SALTO DO JACUI (RS)";"RS";"SALTO DO JACUI";166;14;21;201
2007;"SALVADOR DAS MISSOES (RS)";"RS";"SALVADOR DAS MISSOES";81;2;6;89
2007;"SALVADOR DO SUL (RS)";"RS";"SALVADOR DO SUL";218;21;29;268
2007;"SANANDUVA (RS)";"RS";"SANANDUVA";508;14;48;570
2007;"SANTA BARBARA DO SUL (RS)";"RS";"SANTA BARBARA DO SUL";304;19;39;362
2007;"SANTA CECILIA DO SUL (RS)";"RS";"SANTA CECILIA DO SUL";35;2;9;46
2007;"SANTA CLARA DO SUL (RS)";"RS";"SANTA CLARA DO SUL";109;20;12;141
2007;"SANTA CRUZ DO SUL (RS)";"RS";"SANTA CRUZ DO SUL";1615;134;525;2274
2007;"SANTA MARGARIDA DO SUL (RS)";"RS";"SANTA MARGARIDA DO SUL";39;6;1;46
2007;"SANTA MARIA (RS)";"RS";"SANTA MARIA";2625;284;916;3825
2007;"SANTA MARIA DO HERVAL (RS)";"RS";"SANTA MARIA DO HERVAL";159;8;48;215
2007;"SANTA ROSA (RS)";"RS";"SANTA ROSA";1243;82;148;1473
2007;"SANTA TEREZA (RS)";"RS";"SANTA TEREZA";72;4;4;80
2007;"SANTA VITORIA DO PALMAR (RS)";"RS";"SANTA VITORIA DO PALMAR";452;8;69;529
2007;"SANTANA DA BOA VISTA (RS)";"RS";"SANTANA DA BOA VISTA";59;6;34;99
2007;"SANTANA DO LIVRAMENTO (RS)";"RS";"SANTANA DO LIVRAMENTO";631;39;129;799
2007;"SANTIAGO (RS)";"RS";"SANTIAGO";661;46;95;802
2007;"SANTO ANGELO (RS)";"RS";"SANTO ANGELO";1030;71;91;1192
2007;"SANTO ANTONIO DA PATRULHA (RS)";"RS";"SANTO ANTONIO DA PATRULHA";676;32;141;849
2007;"SANTO ANTONIO DAS MISSOES (RS)";"RS";"SANTO ANTONIO DAS MISSOES";144;24;17;185
2007;"SANTO ANTONIO DO PALMA (RS)";"RS";"SANTO ANTONIO DO PALMA";42;3;7;52
2007;"SANTO ANTONIO DO PLANALTO (RS)";"RS";"SANTO ANTONIO DO PLANALTO";82;4;6;92
2007;"SANTO AUGUSTO (RS)";"RS";"SANTO AUGUSTO";431;25;25;481
2007;"SANTO CRISTO (RS)";"RS";"SANTO CRISTO";372;19;50;441
2007;"SANTO EXPEDITO DO SUL (RS)";"RS";"SANTO EXPEDITO DO SUL";75;3;9;87
2007;"SAO BORJA (RS)";"RS";"SAO BORJA";990;42;88;1120
2007;"SAO DOMINGOS DO SUL (RS)";"RS";"SAO DOMINGOS DO SUL";80;6;3;89
2007;"SAO FRANCISCO DE ASSIS (RS)";"RS";"SAO FRANCISCO DE ASSIS";251;9;68;328
2007;"SAO FRANCISCO DE PAULA (RS)";"RS";"SAO FRANCISCO DE PAULA";437;26;47;510
2007;"SAO GABRIEL (RS)";"RS";"SAO GABRIEL";762;17;85;864
2007;"SAO JERONIMO (RS)";"RS";"SAO JERONIMO";249;23;119;391
2007;"SAO JOAO DA URTIGA (RS)";"RS";"SAO JOAO DA URTIGA";127;7;16;150
2007;"SAO JOAO DO POLESINE (RS)";"RS";"SAO JOAO DO POLESINE";53;2;5;60
2007;"SAO JORGE (RS)";"RS";"SAO JORGE";122;7;17;146
2007;"SAO JOSE DAS MISSOES (RS)";"RS";"SAO JOSE DAS MISSOES";36;3;7;46
2007;"SAO JOSE DO HERVAL (RS)";"RS";"SAO JOSE DO HERVAL";59;2;9;70
2007;"SAO JOSE DO HORTENCIO (RS)";"RS";"SAO JOSE DO HORTENCIO";178;5;36;219
2007;"SAO JOSE DO INHACORA (RS)";"RS";"SAO JOSE DO INHACORA";30;4;5;39
2007;"SAO JOSE DO NORTE (RS)";"RS";"SAO JOSE DO NORTE";273;3;41;317
2007;"SAO JOSE DO OURO (RS)";"RS";"SAO JOSE DO OURO";253;8;27;288
2007;"SAO JOSE DO SUL (RS)";"RS";"SAO JOSE DO SUL";107;14;2;123
2007;"SAO JOSE DOS AUSENTES (RS)";"RS";"SAO JOSE DOS AUSENTES";76;6;10;92
2007;"SAO LEOPOLDO (RS)";"RS";"SAO LEOPOLDO";1627;188;508;2323
2007;"SAO LOURENCO DO SUL (RS)";"RS";"SAO LOURENCO DO SUL";865;30;128;1023
2007;"SAO LUIZ GONZAGA (RS)";"RS";"SAO LUIZ GONZAGA";504;41;66;611
2007;"SAO MARCOS (RS)";"RS";"SAO MARCOS";596;14;92;702
2007;"SAO MARTINHO (RS)";"RS";"SAO MARTINHO";156;12;12;180
2007;"SAO MARTINHO DA SERRA (RS)";"RS";"SAO MARTINHO DA SERRA";34;1;4;39
2007;"SAO MIGUEL DAS MISSOES (RS)";"RS";"SAO MIGUEL DAS MISSOES";174;17;30;221
2007;"SAO NICOLAU (RS)";"RS";"SAO NICOLAU";57;4;9;70
2007;"SAO PAULO DAS MISSOES (RS)";"RS";"SAO PAULO DAS MISSOES";98;5;21;124
2007;"SAO PEDRO DA SERRA (RS)";"RS";"SAO PEDRO DA SERRA";96;6;9;111
2007;"SAO PEDRO DAS MISSOES (RS)";"RS";"SAO PEDRO DAS MISSOES";23;4;5;32
2007;"SAO PEDRO DO BUTIA (RS)";"RS";"SAO PEDRO DO BUTIA";92;1;8;101
2007;"SAO PEDRO DO SUL (RS)";"RS";"SAO PEDRO DO SUL";241;27;43;311
2007;"SAO SEBASTIAO DO CAI (RS)";"RS";"SAO SEBASTIAO DO CAI";633;22;61;716
2007;"SAO SEPE (RS)";"RS";"SAO SEPE";378;20;72;470
2007;"SAO VALENTIM (RS)";"RS";"SAO VALENTIM";64;8;8;80
2007;"SAO VALENTIM DO SUL (RS)";"RS";"SAO VALENTIM DO SUL";66;3;9;78
2007;"SAO VALERIO DO SUL (RS)";"RS";"SAO VALERIO DO SUL";35;3;6;44
2007;"SAO VENDELINO (RS)";"RS";"SAO VENDELINO";74;9;3;86
2007;"SAO VICENTE DO SUL (RS)";"RS";"SAO VICENTE DO SUL";108;4;29;141
2007;"SAPIRANGA (RS)";"RS";"SAPIRANGA";738;95;154;987
2007;"SAPUCAIA DO SUL (RS)";"RS";"SAPUCAIA DO SUL";1373;128;169;1670
2007;"SARANDI (RS)";"RS";"SARANDI";516;18;54;588
2007;"SEBERI (RS)";"RS";"SEBERI";188;10;31;229
2007;"SEDE NOVA (RS)";"RS";"SEDE NOVA";51;7;9;67
2007;"SEGREDO (RS)";"RS";"SEGREDO";105;5;23;133
2007;"SELBACH (RS)";"RS";"SELBACH";245;7;15;267
2007;"SENADOR SALGADO FILHO (RS)";"RS";"SENADOR SALGADO FILHO";82;9;13;104
2007;"SENTINELA DO SUL (RS)";"RS";"SENTINELA DO SUL";97;5;12;114
2007;"SERAFINA CORREA (RS)";"RS";"SERAFINA CORREA";257;35;40;332
2007;"SERIO (RS)";"RS";"SERIO";47;7;5;59
2007;"SERTAO (RS)";"RS";"SERTAO";206;10;22;238
2007;"SERTAO SANTANA (RS)";"RS";"SERTAO SANTANA";152;11;18;181
2007;"SETE DE SETEMBRO (RS)";"RS";"SETE DE SETEMBRO";44;1;5;50
2007;"SEVERIANO DE ALMEIDA (RS)";"RS";"SEVERIANO DE ALMEIDA";75;12;12;99
2007;"SILVEIRA MARTINS (RS)";"RS";"SILVEIRA MARTINS";110;1;5;116
2007;"SINIMBU (RS)";"RS";"SINIMBU";116;2;5;123
2007;"SOBRADINHO (RS)";"RS";"SOBRADINHO";249;20;46;315
2007;"SOLEDADE (RS)";"RS";"SOLEDADE";409;16;89;514
2007;"TABAI (RS)";"RS";"TABAI";133;17;10;160
2007;"TAPEJARA (RS)";"RS";"TAPEJARA";586;16;59;661
2007;"TAPERA (RS)";"RS";"TAPERA";305;18;24;347
2007;"TAPES (RS)";"RS";"TAPES";255;12;25;292
2007;"TAQUARA (RS)";"RS";"TAQUARA";628;51;221;900
2007;"TAQUARI (RS)";"RS";"TAQUARI";390;35;115;540
2007;"TAQUARUCU DO SUL (RS)";"RS";"TAQUARUCU DO SUL";53;1;9;63
2007;"TAVARES (RS)";"RS";"TAVARES";83;3;7;93
2007;"TENENTE PORTELA (RS)";"RS";"TENENTE PORTELA";236;6;26;268
2007;"TERRA DE AREIA (RS)";"RS";"TERRA DE AREIA";278;15;22;315
2007;"TEUTONIA (RS)";"RS";"TEUTONIA";494;34;61;589
2007;"TIO HUGO (RS)";"RS";"TIO HUGO";69;5;9;83
2007;"TIRADENTES DO SUL (RS)";"RS";"TIRADENTES DO SUL";80;6;6;92
2007;"TOROPI (RS)";"RS";"TOROPI";41;3;14;58
2007;"TORRES (RS)";"RS";"TORRES";349;19;63;431
2007;"TRAMANDAI (RS)";"RS";"TRAMANDAI";528;51;136;715
2007;"TRAVESSEIRO (RS)";"RS";"TRAVESSEIRO";37;6;8;51
2007;"TRES ARROIOS (RS)";"RS";"TRES ARROIOS";71;8;3;82
2007;"TRES CACHOEIRAS (RS)";"RS";"TRES CACHOEIRAS";565;10;18;593
2007;"TRES COROAS (RS)";"RS";"TRES COROAS";196;25;48;269
2007;"TRES DE MAIO (RS)";"RS";"TRES DE MAIO";594;53;80;727
2007;"TRES FORQUILHAS (RS)";"RS";"TRES FORQUILHAS";79;3;2;84
2007;"TRES PALMEIRAS (RS)";"RS";"TRES PALMEIRAS";62;4;14;80
2007;"TRES PASSOS (RS)";"RS";"TRES PASSOS";360;25;115;500
2007;"TRINDADE DO SUL (RS)";"RS";"TRINDADE DO SUL";87;3;20;110
2007;"TRIUNFO (RS)";"RS";"TRIUNFO";370;85;127;582
2007;"TUCUNDUVA (RS)";"RS";"TUCUNDUVA";195;13;17;225
2007;"TUNAS (RS)";"RS";"TUNAS";34;4;13;51
2007;"TUPANCI DO SUL (RS)";"RS";"TUPANCI DO SUL";46;3;9;58
2007;"TUPANCIRETA (RS)";"RS";"TUPANCIRETA";452;25;42;519
2007;"TUPANDI (RS)";"RS";"TUPANDI";72;18;25;115
2007;"TUPARENDI (RS)";"RS";"TUPARENDI";192;9;23;224
2007;"TURUCU (RS)";"RS";"TURUCU";71;4;9;84
2007;"UBIRETAMA (RS)";"RS";"UBIRETAMA";58;4;5;67
2007;"UNIAO DA SERRA (RS)";"RS";"UNIAO DA SERRA";53;1;7;61
2007;"UNISTALDA (RS)";"RS";"UNISTALDA";24;4;9;37
2007;"URUGUAIANA (RS)";"RS";"URUGUAIANA";1659;64;155;1878
2007;"VACARIA (RS)";"RS";"VACARIA";1525;90;362;1977
2007;"VALE DO SOL (RS)";"RS";"VALE DO SOL";162;3;25;190
2007;"VALE REAL (RS)";"RS";"VALE REAL";224;9;13;246
2007;"VALE VERDE (RS)";"RS";"VALE VERDE";32;3;5;40
2007;"VANINI (RS)";"RS";"VANINI";81;11;13;105
2007;"VENANCIO AIRES (RS)";"RS";"VENANCIO AIRES";996;56;177;1229
2007;"VERA CRUZ (RS)";"RS";"VERA CRUZ";313;11;77;401
2007;"VERANOPOLIS (RS)";"RS";"VERANOPOLIS";806;42;70;918
2007;"VESPASIANO CORREA (RS)";"RS";"VESPASIANO CORREA";70;5;15;90
2007;"VIADUTOS (RS)";"RS";"VIADUTOS";113;8;17;138
2007;"VIAMAO (RS)";"RS";"VIAMAO";1552;221;472;2245
2007;"VICENTE DUTRA (RS)";"RS";"VICENTE DUTRA";43;0;14;57
2007;"VICTOR GRAEFF (RS)";"RS";"VICTOR GRAEFF";136;15;4;155
2007;"VILA FLORES (RS)";"RS";"VILA FLORES";153;11;12;176
2007;"VILA LANGARO (RS)";"RS";"VILA LANGARO";75;4;10;89
2007;"VILA MARIA (RS)";"RS";"VILA MARIA";203;6;34;243
2007;"VILA NOVA DO SUL (RS)";"RS";"VILA NOVA DO SUL";80;5;7;92
2007;"VISTA ALEGRE (RS)";"RS";"VISTA ALEGRE";46;1;12;59
2007;"VISTA ALEGRE DO PRATA (RS)";"RS";"VISTA ALEGRE DO PRATA";32;6;5;43
2007;"VISTA GAUCHA (RS)";"RS";"VISTA GAUCHA";45;2;11;58
2007;"VITORIA DAS MISSOES (RS)";"RS";"VITORIA DAS MISSOES";79;1;9;89
2007;"WESTFALIA (RS)";"RS";"WESTFALIA";98;17;9;124
2007;"XANGRI LA (RS)";"RS";"XANGRI LA";126;10;4;140
2007;"ABDON BATISTA (SC)";"SC";"ABDON BATISTA";46;6;8;60
2007;"ABELARDO LUZ (SC)";"SC";"ABELARDO LUZ";300;9;45;354
2007;"AGROLANDIA (SC)";"SC";"AGROLANDIA";184;10;15;209
2007;"AGRONOMICA (SC)";"SC";"AGRONOMICA";125;2;9;136
2007;"AGUA DOCE (SC)";"SC";"AGUA DOCE";149;13;12;174
2007;"AGUAS DE CHAPECO (SC)";"SC";"AGUAS DE CHAPECO";64;2;20;86
2007;"AGUAS FRIAS (SC)";"SC";"AGUAS FRIAS";31;1;4;36
2007;"AGUAS MORNAS (SC)";"SC";"AGUAS MORNAS";198;4;9;211
2007;"ALFREDO WAGNER (SC)";"SC";"ALFREDO WAGNER";203;18;9;230
2007;"ALTO BELA VISTA (SC)";"SC";"ALTO BELA VISTA";43;5;6;54
2007;"ANCHIETA (SC)";"SC";"ANCHIETA";133;14;14;161
2007;"ANGELINA (SC)";"SC";"ANGELINA";147;11;12;170
2007;"ANITA GARIBALDI (SC)";"SC";"ANITA GARIBALDI";121;8;18;147
2007;"ANITAPOLIS (SC)";"SC";"ANITAPOLIS";73;7;10;90
2007;"ANTONIO CARLOS (SC)";"SC";"ANTONIO CARLOS";498;7;6;511
2007;"APIUNA (SC)";"SC";"APIUNA";127;8;15;150
2007;"ARABUTA (SC)";"SC";"ARABUTA";82;7;22;111
2007;"ARAQUARI (SC)";"SC";"ARAQUARI";278;19;27;324
2007;"ARARANGUA (SC)";"SC";"ARARANGUA";1158;52;143;1353
2007;"ARMAZEM (SC)";"SC";"ARMAZEM";217;13;6;236
2007;"ARROIO TRINTA (SC)";"SC";"ARROIO TRINTA";138;6;9;153
2007;"ARVOREDO (SC)";"SC";"ARVOREDO";21;7;5;33
2007;"ASCURRA (SC)";"SC";"ASCURRA";165;14;26;205
2007;"ATALANTA (SC)";"SC";"ATALANTA";76;2;4;82
2007;"AURORA (SC)";"SC";"AURORA";153;7;6;166
2007;"BALNEARIO ARROIO DO SILVA (SC)";"SC";"BALNEARIO ARROIO DO SILVA";70;9;19;98
2007;"BALNEARIO CAMBORIU (SC)";"SC";"BALNEARIO CAMBORIU";808;180;175;1163
2007;"BALNEARIO GAIVOTA (SC)";"SC";"BALNEARIO GAIVOTA";128;5;8;141
2007;"BANDEIRANTE (SC)";"SC";"BANDEIRANTE";20;2;12;34
2007;"BARRA BONITA (SC)";"SC";"BARRA BONITA";28;3;7;38
2007;"BARRA DO SUL (SC)";"SC";"BARRA DO SUL";73;5;3;81
2007;"BARRA VELHA (SC)";"SC";"BARRA VELHA";240;22;19;281
2007;"BELA VISTA DO TOLDO (SC)";"SC";"BELA VISTA DO TOLDO";66;1;8;75
2007;"BELMONTE (SC)";"SC";"BELMONTE";47;2;4;53
2007;"BENEDITO NOVO (SC)";"SC";"BENEDITO NOVO";246;16;21;283
2007;"BIGUACU (SC)";"SC";"BIGUACU";754;45;143;942
2007;"BLUMENAU (SC)";"SC";"BLUMENAU";4142;343;682;5167
2007;"BOCAINA DO SUL (SC)";"SC";"BOCAINA DO SUL";37;6;14;57
2007;"BOM JARDIM DA SERRA (SC)";"SC";"BOM JARDIM DA SERRA";86;3;15;104
2007;"BOM JESUS (SC)";"SC";"BOM JESUS";55;1;7;63
2007;"BOM JESUS DO OESTE (SC)";"SC";"BOM JESUS DO OESTE";30;2;8;40
2007;"BOM RETIRO (SC)";"SC";"BOM RETIRO";135;13;22;170
2007;"BOMBINHAS (SC)";"SC";"BOMBINHAS";95;19;16;130
2007;"BOTUVERA (SC)";"SC";"BOTUVERA";174;5;7;186
2007;"BRACO DO NORTE (SC)";"SC";"BRACO DO NORTE";809;33;43;885
2007;"BRACO DO TROMBUDO (SC)";"SC";"BRACO DO TROMBUDO";103;6;3;112
2007;"BRUNOPOLIS (SC)";"SC";"BRUNOPOLIS";50;2;8;60
2007;"BRUSQUE (SC)";"SC";"BRUSQUE";1739;97;157;1993
2007;"CACADOR (SC)";"SC";"CACADOR";1765;90;758;2613
2007;"CAIBI (SC)";"SC";"CAIBI";148;3;23;174
2007;"CALMON (SC)";"SC";"CALMON";36;4;19;59
2007;"CAMBORIU (SC)";"SC";"CAMBORIU";724;29;39;792
2007;"CAMPO ALEGRE (SC)";"SC";"CAMPO ALEGRE";334;12;8;354
2007;"CAMPO BELO DO SUL (SC)";"SC";"CAMPO BELO DO SUL";163;7;21;191
2007;"CAMPO ERE (SC)";"SC";"CAMPO ERE";201;9;24;234
2007;"CAMPOS NOVOS (SC)";"SC";"CAMPOS NOVOS";813;41;72;926
2007;"CANELINHA (SC)";"SC";"CANELINHA";435;11;7;453
2007;"CANOINHAS (SC)";"SC";"CANOINHAS";1116;46;108;1270
2007;"CAPAO ALTO (SC)";"SC";"CAPAO ALTO";37;4;10;51
2007;"CAPINZAL (SC)";"SC";"CAPINZAL";358;27;27;412
2007;"CAPIVARI DE BAIXO (SC)";"SC";"CAPIVARI DE BAIXO";246;10;21;277
2007;"CATANDUVAS (SC)";"SC";"CATANDUVAS";274;14;28;316
2007;"CAXAMBU DO SUL (SC)";"SC";"CAXAMBU DO SUL";78;2;12;92
2007;"CELSO RAMOS (SC)";"SC";"CELSO RAMOS";42;5;3;50
2007;"CERRO NEGRO (SC)";"SC";"CERRO NEGRO";32;5;11;48
2007;"CHAPADAO DO LAGEADO (SC)";"SC";"CHAPADAO DO LAGEADO";32;2;6;40
2007;"CHAPECO (SC)";"SC";"CHAPECO";3208;167;280;3655
2007;"COCAL DO SUL (SC)";"SC";"COCAL DO SUL";224;13;12;249
2007;"CONCORDIA (SC)";"SC";"CONCORDIA";1722;95;152;1969
2007;"CORDILHEIRA ALTA (SC)";"SC";"CORDILHEIRA ALTA";192;7;2;201
2007;"CORONEL FREITAS (SC)";"SC";"CORONEL FREITAS";237;7;26;270
2007;"CORONEL MARTINS (SC)";"SC";"CORONEL MARTINS";35;7;10;52
2007;"CORREIA PINTO (SC)";"SC";"CORREIA PINTO";286;24;40;350
2007;"CORUPA (SC)";"SC";"CORUPA";309;8;29;346
2007;"CRICIUMA (SC)";"SC";"CRICIUMA";3026;279;367;3672
2007;"CUNHA PORA (SC)";"SC";"CUNHA PORA";282;14;42;338
2007;"CUNHATAI (SC)";"SC";"CUNHATAI";23;3;2;28
2007;"CURITIBANOS (SC)";"SC";"CURITIBANOS";856;31;85;972
2007;"DESCANSO (SC)";"SC";"DESCANSO";198;10;23;231
2007;"DIONISIO CERQUEIRA (SC)";"SC";"DIONISIO CERQUEIRA";118;9;20;147
2007;"DONA EMMA (SC)";"SC";"DONA EMMA";89;7;7;103
2007;"DOUTOR PEDRINHO (SC)";"SC";"DOUTOR PEDRINHO";106;6;8;120
2007;"ENTRE RIOS (SC)";"SC";"ENTRE RIOS";16;1;6;23
2007;"ERMO (SC)";"SC";"ERMO";54;0;4;58
2007;"ERVAL VELHO (SC)";"SC";"ERVAL VELHO";86;4;18;108
2007;"FAXINAL DOS GUEDES (SC)";"SC";"FAXINAL DOS GUEDES";319;13;25;357
2007;"FLOR DO SERTAO (SC)";"SC";"FLOR DO SERTAO";20;3;11;34
2007;"FLORIANOPOLIS (SC)";"SC";"FLORIANOPOLIS";3135;803;1468;5406
2007;"FORMOSA DO SUL (SC)";"SC";"FORMOSA DO SUL";44;3;14;61
2007;"FORQUILHINHA (SC)";"SC";"FORQUILHINHA";449;17;38;504
2007;"FRAIBURGO (SC)";"SC";"FRAIBURGO";717;42;194;953
2007;"FREI ROGERIO (SC)";"SC";"FREI ROGERIO";59;4;9;72
2007;"GALVAO (SC)";"SC";"GALVAO";77;2;9;88
2007;"GAROPABA (SC)";"SC";"GAROPABA";177;15;35;227
2007;"GARUVA (SC)";"SC";"GARUVA";259;16;15;290
2007;"GASPAR (SC)";"SC";"GASPAR";1045;46;65;1156
2007;"GOVERNADOR CELSO RAMOS (SC)";"SC";"GOVERNADOR CELSO RAMOS";134;16;8;158
2007;"GRAO PARA (SC)";"SC";"GRAO PARA";196;4;8;208
2007;"GRAVATAL (SC)";"SC";"GRAVATAL";190;7;13;210
2007;"GUABIRUBA (SC)";"SC";"GUABIRUBA";244;9;12;265
2007;"GUARACIABA (SC)";"SC";"GUARACIABA";185;6;33;224
2007;"GUARAMIRIM (SC)";"SC";"GUARAMIRIM";770;21;23;814
2007;"GUARUJA DO SUL (SC)";"SC";"GUARUJA DO SUL";157;6;14;177
2007;"GUATAMBU (SC)";"SC";"GUATAMBU";64;4;18;86
2007;"HERVAL D OESTE (SC)";"SC";"HERVAL D OESTE";252;26;47;325
2007;"IBIAM (SC)";"SC";"IBIAM";49;2;11;62
2007;"IBICARE (SC)";"SC";"IBICARE";115;9;7;131
2007;"IBIRAMA (SC)";"SC";"IBIRAMA";312;29;56;397
2007;"ICARA (SC)";"SC";"ICARA";1173;56;109;1338
2007;"ILHOTA (SC)";"SC";"ILHOTA";240;17;10;267
2007;"IMARUI (SC)";"SC";"IMARUI";87;15;20;122
2007;"IMBITUBA (SC)";"SC";"IMBITUBA";471;63;63;597
2007;"IMBUIA (SC)";"SC";"IMBUIA";146;5;13;164
2007;"INDAIAL (SC)";"SC";"INDAIAL";1030;45;75;1150
2007;"IOMERE (SC)";"SC";"IOMERE";115;9;6;130
2007;"IPIRA (SC)";"SC";"IPIRA";83;7;11;101
2007;"IPORA DO OESTE (SC)";"SC";"IPORA DO OESTE";187;7;32;226
2007;"IPUACU (SC)";"SC";"IPUACU";74;8;15;97
2007;"IPUMIRIM (SC)";"SC";"IPUMIRIM";184;6;19;209
2007;"IRACEMINHA (SC)";"SC";"IRACEMINHA";80;4;15;99
2007;"IRANI (SC)";"SC";"IRANI";228;17;43;288
2007;"IRATI (SC)";"SC";"IRATI";26;5;6;37
2007;"IRINEOPOLIS (SC)";"SC";"IRINEOPOLIS";178;3;8;189
2007;"ITA (SC)";"SC";"ITA";83;15;25;123
2007;"ITAIOPOLIS (SC)";"SC";"ITAIOPOLIS";439;14;52;505
2007;"ITAJAI (SC)";"SC";"ITAJAI";3505;271;298;4074
2007;"ITAPEMA (SC)";"SC";"ITAPEMA";382;40;41;463
2007;"ITAPIRANGA (SC)";"SC";"ITAPIRANGA";222;17;44;283
2007;"ITAPOA (SC)";"SC";"ITAPOA";109;6;4;119
2007;"ITUPORANGA (SC)";"SC";"ITUPORANGA";510;17;37;564
2007;"JABORA (SC)";"SC";"JABORA";101;9;16;126
2007;"JACINTO MACHADO (SC)";"SC";"JACINTO MACHADO";351;6;29;386
2007;"JAGUARUNA (SC)";"SC";"JAGUARUNA";361;10;30;401
2007;"JARAGUA DO SUL (SC)";"SC";"JARAGUA DO SUL";2029;171;262;2462
2007;"JARDINOPOLIS (SC)";"SC";"JARDINOPOLIS";15;3;3;21
2007;"JOACABA (SC)";"SC";"JOACABA";712;45;31;788
2007;"JOINVILLE (SC)";"SC";"JOINVILLE";6746;548;752;8046
2007;"JOSE BOITEUX (SC)";"SC";"JOSE BOITEUX";91;11;7;109
2007;"JUPIA (SC)";"SC";"JUPIA";33;3;6;42
2007;"LACERDOPOLIS (SC)";"SC";"LACERDOPOLIS";92;7;6;105
2007;"LAGEADO GRANDE (SC)";"SC";"LAGEADO GRANDE";27;1;5;33
2007;"LAGES (SC)";"SC";"LAGES";3218;183;313;3714
2007;"LAGUNA (SC)";"SC";"LAGUNA";457;60;76;593
2007;"LAURENTINO (SC)";"SC";"LAURENTINO";239;4;6;249
2007;"LAURO MULLER (SC)";"SC";"LAURO MULLER";348;18;30;396
2007;"LEBON REGIS (SC)";"SC";"LEBON REGIS";179;7;30;216
2007;"LEOBERTO LEAL (SC)";"SC";"LEOBERTO LEAL";99;6;5;110
2007;"LINDOIA DO SUL (SC)";"SC";"LINDOIA DO SUL";106;11;33;150
2007;"LONTRAS (SC)";"SC";"LONTRAS";243;15;18;276
2007;"LUIZ ALVES (SC)";"SC";"LUIZ ALVES";356;8;12;376
2007;"LUZERNA (SC)";"SC";"LUZERNA";105;8;16;129
2007;"MACIEIRA (SC)";"SC";"MACIEIRA";47;6;9;62
2007;"MAFRA (SC)";"SC";"MAFRA";1077;65;113;1255
2007;"MAJOR GERCINO (SC)";"SC";"MAJOR GERCINO";123;9;5;137
2007;"MAJOR VIEIRA (SC)";"SC";"MAJOR VIEIRA";146;5;8;159
2007;"MARACAJA (SC)";"SC";"MARACAJA";176;1;6;183
2007;"MARAVILHA (SC)";"SC";"MARAVILHA";465;45;51;561
2007;"MAREMA (SC)";"SC";"MAREMA";48;9;5;62
2007;"MASSARANDUBA (SC)";"SC";"MASSARANDUBA";434;12;27;473
2007;"MATOS COSTA (SC)";"SC";"MATOS COSTA";28;3;7;38
2007;"MELEIRO (SC)";"SC";"MELEIRO";196;3;16;215
2007;"MIRIM DOCE (SC)";"SC";"MIRIM DOCE";46;1;6;53
2007;"MODELO (SC)";"SC";"MODELO";84;7;8;99
2007;"MONDAI (SC)";"SC";"MONDAI";162;6;33;201
2007;"MONTE CARLO (SC)";"SC";"MONTE CARLO";161;11;75;247
2007;"MONTE CASTELO (SC)";"SC";"MONTE CASTELO";141;5;12;158
2007;"MORRO DA FUMACA (SC)";"SC";"MORRO DA FUMACA";694;25;27;746
2007;"MORRO GRANDE (SC)";"SC";"MORRO GRANDE";84;0;6;90
2007;"NAVEGANTES (SC)";"SC";"NAVEGANTES";503;55;40;598
2007;"NOVA ERECHIM (SC)";"SC";"NOVA ERECHIM";68;3;7;78
2007;"NOVA ITABERABA (SC)";"SC";"NOVA ITABERABA";57;3;12;72
2007;"NOVA TRENTO (SC)";"SC";"NOVA TRENTO";185;7;28;220
2007;"NOVA VENEZA (SC)";"SC";"NOVA VENEZA";362;24;15;401
2007;"NOVO HORIZONTE (SC)";"SC";"NOVO HORIZONTE";55;5;7;67
2007;"ORLEANS (SC)";"SC";"ORLEANS";732;9;40;781
2007;"OTACILIO COSTA (SC)";"SC";"OTACILIO COSTA";349;28;36;413
2007;"OURO (SC)";"SC";"OURO";201;19;26;246
2007;"OURO VERDE (SC)";"SC";"OURO VERDE";70;1;5;76
2007;"PAIAL (SC)";"SC";"PAIAL";8;2;14;24
2007;"PAINEL (SC)";"SC";"PAINEL";22;2;6;30
2007;"PALHOCA (SC)";"SC";"PALHOCA";1576;108;254;1938
2007;"PALMA SOLA (SC)";"SC";"PALMA SOLA";168;4;19;191
2007;"PALMEIRA (SC)";"SC";"PALMEIRA";66;5;1;72
2007;"PALMITOS (SC)";"SC";"PALMITOS";279;24;53;356
2007;"PAPANDUVA (SC)";"SC";"PAPANDUVA";440;18;57;515
2007;"PARAISO (SC)";"SC";"PARAISO";44;3;7;54
2007;"PASSO DE TORRES (SC)";"SC";"PASSO DE TORRES";98;6;13;117
2007;"PASSOS MAIA (SC)";"SC";"PASSOS MAIA";87;2;22;111
2007;"PAULO LOPES (SC)";"SC";"PAULO LOPES";209;8;9;226
2007;"PEDRAS GRANDES (SC)";"SC";"PEDRAS GRANDES";211;8;9;228
2007;"PENHA (SC)";"SC";"PENHA";278;18;29;325
2007;"PERITIBA (SC)";"SC";"PERITIBA";77;4;10;91
2007;"PETROLANDIA (SC)";"SC";"PETROLANDIA";127;5;21;153
2007;"PICARRAS (SC)";"SC";"PICARRAS";233;14;14;261
2007;"PINHALZINHO (SC)";"SC";"PINHALZINHO";344;11;36;391
2007;"PINHEIRO PRETO (SC)";"SC";"PINHEIRO PRETO";233;5;7;245
2007;"PIRATUBA (SC)";"SC";"PIRATUBA";66;9;21;96
2007;"PLANALTO ALEGRE (SC)";"SC";"PLANALTO ALEGRE";44;4;5;53
2007;"POMERODE (SC)";"SC";"POMERODE";481;26;91;598
2007;"PONTE ALTA (SC)";"SC";"PONTE ALTA";103;4;9;116
2007;"PONTE ALTA DO NORTE (SC)";"SC";"PONTE ALTA DO NORTE";56;2;12;70
2007;"PONTE SERRADA (SC)";"SC";"PONTE SERRADA";256;14;49;319
2007;"PORTO BELO (SC)";"SC";"PORTO BELO";165;16;18;199
2007;"PORTO UNIAO (SC)";"SC";"PORTO UNIAO";499;16;32;547
2007;"POUSO REDONDO (SC)";"SC";"POUSO REDONDO";346;13;25;384
2007;"PRAIA GRANDE (SC)";"SC";"PRAIA GRANDE";174;10;17;201
2007;"PRESIDENTE CASTELO BRANCO (SC)";"SC";"PRESIDENTE CASTELO BRANCO";33;3;7;43
2007;"PRESIDENTE GETULIO (SC)";"SC";"PRESIDENTE GETULIO";260;22;59;341
2007;"PRESIDENTE NEREU (SC)";"SC";"PRESIDENTE NEREU";18;5;4;27
2007;"PRINCESA (SC)";"SC";"PRINCESA";32;1;10;43
2007;"QUILOMBO (SC)";"SC";"QUILOMBO";173;10;29;212
2007;"RANCHO QUEIMADO (SC)";"SC";"RANCHO QUEIMADO";102;2;4;108
2007;"RIO DAS ANTAS (SC)";"SC";"RIO DAS ANTAS";173;7;20;200
2007;"RIO DO CAMPO (SC)";"SC";"RIO DO CAMPO";132;10;15;157
2007;"RIO DO OESTE (SC)";"SC";"RIO DO OESTE";141;11;16;168
2007;"RIO DO SUL (SC)";"SC";"RIO DO SUL";1231;60;106;1397
2007;"RIO DOS CEDROS (SC)";"SC";"RIO DOS CEDROS";203;15;23;241
2007;"RIO FORTUNA (SC)";"SC";"RIO FORTUNA";206;7;12;225
2007;"RIO NEGRINHO (SC)";"SC";"RIO NEGRINHO";833;43;62;938
2007;"RIO RUFINO (SC)";"SC";"RIO RUFINO";30;5;10;45
2007;"RIQUEZA (SC)";"SC";"RIQUEZA";79;1;17;97
2007;"RODEIO (SC)";"SC";"RODEIO";178;8;13;199
2007;"ROMELANDIA (SC)";"SC";"ROMELANDIA";78;4;17;99
2007;"SALETE (SC)";"SC";"SALETE";146;9;14;169
2007;"SALTINHO (SC)";"SC";"SALTINHO";35;1;17;53
2007;"SALTO VELOSO (SC)";"SC";"SALTO VELOSO";119;6;4;129
2007;"SANGAO (SC)";"SC";"SANGAO";348;6;11;365
2007;"SANTA CECILIA (SC)";"SC";"SANTA CECILIA";301;18;34;353
2007;"SANTA HELENA (SC)";"SC";"SANTA HELENA";46;10;7;63
2007;"SANTA ROSA DE LIMA (SC)";"SC";"SANTA ROSA DE LIMA";83;5;5;93
2007;"SANTA ROSA DO SUL (SC)";"SC";"SANTA ROSA DO SUL";228;8;12;248
2007;"SANTA TEREZINHA (SC)";"SC";"SANTA TEREZINHA";129;9;17;155
2007;"SANTA TEREZINHA DO PROGRESSO (SC)";"SC";"SANTA TEREZINHA DO PROGRESSO";41;1;12;54
2007;"SANTIAGO DO SUL (SC)";"SC";"SANTIAGO DO SUL";37;5;2;44
2007;"SANTO AMARO DA IMPERATRIZ (SC)";"SC";"SANTO AMARO DA IMPERATRIZ";482;21;65;568
2007;"SAO BENTO DO SUL (SC)";"SC";"SAO BENTO DO SUL";1192;107;130;1429
2007;"SAO BERNARDINO (SC)";"SC";"SAO BERNARDINO";30;2;20;52
2007;"SAO BONIFACIO (SC)";"SC";"SAO BONIFACIO";96;4;7;107
2007;"SAO CARLOS (SC)";"SC";"SAO CARLOS";170;13;34;217
2007;"SAO CRISTOVAO DO SUL (SC)";"SC";"SAO CRISTOVAO DO SUL";135;2;11;148
2007;"SAO DOMINGOS (SC)";"SC";"SAO DOMINGOS";232;13;30;275
2007;"SAO FRANCISCO DO SUL (SC)";"SC";"SAO FRANCISCO DO SUL";508;40;56;604
2007;"SAO JOAO BATISTA (SC)";"SC";"SAO JOAO BATISTA";462;11;33;506
2007;"SAO JOAO DO ITAPERIU (SC)";"SC";"SAO JOAO DO ITAPERIU";156;2;5;163
2007;"SAO JOAO DO OESTE (SC)";"SC";"SAO JOAO DO OESTE";129;7;8;144
2007;"SAO JOAO DO SUL (SC)";"SC";"SAO JOAO DO SUL";176;5;8;189
2007;"SAO JOAQUIM (SC)";"SC";"SAO JOAQUIM";664;37;151;852
2007;"SAO JOSE (SC)";"SC";"SAO JOSE";2966;221;195;3382
2007;"SAO JOSE DO CEDRO (SC)";"SC";"SAO JOSE DO CEDRO";334;12;76;422
2007;"SAO JOSE DO CERRITO (SC)";"SC";"SAO JOSE DO CERRITO";124;4;30;158
2007;"SAO LOURENCO D OESTE (SC)";"SC";"SAO LOURENCO D OESTE";666;25;50;741
2007;"SAO LUDGERO (SC)";"SC";"SAO LUDGERO";448;9;18;475
2007;"SAO MARTINHO (SC)";"SC";"SAO MARTINHO";113;8;5;126
2007;"SAO MIGUEL D OESTE (SC)";"SC";"SAO MIGUEL D OESTE";823;31;98;952
2007;"SAO MIGUEL DA BOA VISTA (SC)";"SC";"SAO MIGUEL DA BOA VISTA";14;3;6;23
2007;"SAO PEDRO DE ALCANTARA (SC)";"SC";"SAO PEDRO DE ALCANTARA";109;5;3;117
2007;"SAUDADES (SC)";"SC";"SAUDADES";131;9;33;173
2007;"SCHROEDER (SC)";"SC";"SCHROEDER";156;3;18;177
2007;"SEARA (SC)";"SC";"SEARA";328;30;56;414
2007;"SERRA ALTA (SC)";"SC";"SERRA ALTA";48;7;14;69
2007;"SIDEROPOLIS (SC)";"SC";"SIDEROPOLIS";364;20;54;438
2007;"SOMBRIO (SC)";"SC";"SOMBRIO";613;44;31;688
2007;"SUL BRASIL (SC)";"SC";"SUL BRASIL";32;5;7;44
2007;"TAIO (SC)";"SC";"TAIO";442;11;36;489
2007;"TANGARA (SC)";"SC";"TANGARA";341;6;31;378
2007;"TIGRINHOS (SC)";"SC";"TIGRINHOS";21;3;12;36
2007;"TIJUCAS (SC)";"SC";"TIJUCAS";675;31;41;747
2007;"TIMBE DO SUL (SC)";"SC";"TIMBE DO SUL";134;8;9;151
2007;"TIMBO (SC)";"SC";"TIMBO";535;37;51;623
2007;"TIMBO GRANDE (SC)";"SC";"TIMBO GRANDE";124;2;15;141
2007;"TRES BARRAS (SC)";"SC";"TRES BARRAS";221;22;41;284
2007;"TREVISO (SC)";"SC";"TREVISO";75;7;4;86
2007;"TREZE DE MAIO (SC)";"SC";"TREZE DE MAIO";356;6;13;375
2007;"TREZE TILIAS (SC)";"SC";"TREZE TILIAS";213;12;12;237
2007;"TROMBUDO CENTRAL (SC)";"SC";"TROMBUDO CENTRAL";200;9;10;219
2007;"TUBARAO (SC)";"SC";"TUBARAO";1996;70;371;2437
2007;"TUNAPOLIS (SC)";"SC";"TUNAPOLIS";66;6;23;95
2007;"TURVO (SC)";"SC";"TURVO";326;9;20;355
2007;"UNIAO DO OESTE (SC)";"SC";"UNIAO DO OESTE";48;2;10;60
2007;"URUBICI (SC)";"SC";"URUBICI";192;8;31;231
2007;"URUPEMA (SC)";"SC";"URUPEMA";42;5;6;53
2007;"URUSSANGA (SC)";"SC";"URUSSANGA";358;23;77;458
2007;"VARGEAO (SC)";"SC";"VARGEAO";99;1;9;109
2007;"VARGEM (SC)";"SC";"VARGEM";44;2;9;55
2007;"VARGEM BONITA (SC)";"SC";"VARGEM BONITA";134;10;27;171
2007;"VIDAL RAMOS (SC)";"SC";"VIDAL RAMOS";107;6;9;122
2007;"VIDEIRA (SC)";"SC";"VIDEIRA";1311;82;99;1492
2007;"VITOR MEIRELES (SC)";"SC";"VITOR MEIRELES";74;7;11;92
2007;"WITMARSUM (SC)";"SC";"WITMARSUM";74;8;6;88
2007;"XANXERE (SC)";"SC";"XANXERE";1074;80;106;1260
2007;"XAVANTINA (SC)";"SC";"XAVANTINA";136;13;4;153
2007;"XAXIM (SC)";"SC";"XAXIM";578;37;92;707
2007;"ZORTEA (SC)";"SC";"ZORTEA";34;4;2;40
2007;"AMPARO DE SAO FRANCISCO (SE)";"SE";"AMPARO DE SAO FRANCISCO";4;5;2;11
2007;"AQUIDABA (SE)";"SE";"AQUIDABA";95;7;32;134
2007;"ARACAJU (SE)";"SE";"ARACAJU";4427;742;1549;6718
2007;"ARAUA (SE)";"SE";"ARAUA";45;12;13;70
2007;"AREIA BRANCA (SE)";"SE";"AREIA BRANCA";109;8;15;132
2007;"BARRA DOS COQUEIROS (SE)";"SE";"BARRA DOS COQUEIROS";35;9;20;64
2007;"BOQUIM (SE)";"SE";"BOQUIM";163;12;22;197
2007;"BREJO GRANDE (SE)";"SE";"BREJO GRANDE";4;5;6;15
2007;"CAMPO DO BRITO (SE)";"SE";"CAMPO DO BRITO";236;20;42;298
2007;"CANHOBA (SE)";"SE";"CANHOBA";4;2;2;8
2007;"CANINDE DE SAO FRANCISCO (SE)";"SE";"CANINDE DE SAO FRANCISCO";109;18;16;143
2007;"CAPELA (SE)";"SE";"CAPELA";61;16;30;107
2007;"CARIRA (SE)";"SE";"CARIRA";186;41;47;274
2007;"CARMOPOLIS (SE)";"SE";"CARMOPOLIS";92;21;23;136
2007;"CEDRO DE SAO JOAO (SE)";"SE";"CEDRO DE SAO JOAO";17;5;2;24
2007;"CRISTINAPOLIS (SE)";"SE";"CRISTINAPOLIS";43;19;19;81
2007;"CUMBE (SE)";"SE";"CUMBE";16;6;3;25
2007;"DIVINA PASTORA (SE)";"SE";"DIVINA PASTORA";8;5;2;15
2007;"ESTANCIA (SE)";"SE";"ESTANCIA";323;113;116;552
2007;"FEIRA NOVA (SE)";"SE";"FEIRA NOVA";9;7;3;19
2007;"FREI PAULO (SE)";"SE";"FREI PAULO";76;21;23;120
2007;"GARARU (SE)";"SE";"GARARU";22;3;16;41
2007;"GENERAL MAYNARD (SE)";"SE";"GENERAL MAYNARD";12;19;19;50
2007;"GRACCHO CARDOSO (SE)";"SE";"GRACCHO CARDOSO";14;4;6;24
2007;"ILHA DAS FLORES (SE)";"SE";"ILHA DAS FLORES";8;5;4;17
2007;"INDIAROBA (SE)";"SE";"INDIAROBA";25;15;12;52
2007;"ITABAIANA (SE)";"SE";"ITABAIANA";2315;94;92;2501
2007;"ITABAIANINHA (SE)";"SE";"ITABAIANINHA";347;40;33;420
2007;"ITABI (SE)";"SE";"ITABI";16;2;4;22
2007;"ITAPORANGA D AJUDA (SE)";"SE";"ITAPORANGA D AJUDA";159;19;32;210
2007;"JAPARATUBA (SE)";"SE";"JAPARATUBA";34;21;36;91
2007;"JAPOATA (SE)";"SE";"JAPOATA";35;6;21;62
2007;"LAGARTO (SE)";"SE";"LAGARTO";717;130;129;976
2007;"LARANJEIRAS (SE)";"SE";"LARANJEIRAS";83;15;26;124
2007;"MACAMBIRA (SE)";"SE";"MACAMBIRA";33;12;8;53
2007;"MALHADA DOS BOIS (SE)";"SE";"MALHADA DOS BOIS";14;6;3;23
2007;"MALHADOR (SE)";"SE";"MALHADOR";126;21;32;179
2007;"MARUIM (SE)";"SE";"MARUIM";31;13;14;58
2007;"MOITA BONITA (SE)";"SE";"MOITA BONITA";308;22;9;339
2007;"MONTE ALEGRE DE SERGIPE (SE)";"SE";"MONTE ALEGRE DE SERGIPE";72;15;14;101
2007;"MURIBECA (SE)";"SE";"MURIBECA";14;8;21;43
2007;"NEOPOLIS (SE)";"SE";"NEOPOLIS";34;7;12;53
2007;"NOSSA SENHORA APARECIDA (SE)";"SE";"NOSSA SENHORA APARECIDA";96;12;8;116
2007;"NOSSA SENHORA DA GLORIA (SE)";"SE";"NOSSA SENHORA DA GLORIA";308;19;52;379
2007;"NOSSA SENHORA DAS DORES (SE)";"SE";"NOSSA SENHORA DAS DORES";113;16;38;167
2007;"NOSSA SENHORA DE LOURDES (SE)";"SE";"NOSSA SENHORA DE LOURDES";20;4;6;30
2007;"NOSSA SENHORA DO SOCORRO (SE)";"SE";"NOSSA SENHORA DO SOCORRO";546;40;96;682
2007;"PACATUBA (SE)";"SE";"PACATUBA";23;5;20;48
2007;"PEDRA MOLE (SE)";"SE";"PEDRA MOLE";8;1;3;12
2007;"PEDRINHAS (SE)";"SE";"PEDRINHAS";45;5;6;56
2007;"PINHAO (SE)";"SE";"PINHAO";17;20;1;38
2007;"PIRAMBU (SE)";"SE";"PIRAMBU";11;4;12;27
2007;"POCO REDONDO (SE)";"SE";"POCO REDONDO";74;12;29;115
2007;"POCO VERDE (SE)";"SE";"POCO VERDE";64;17;49;130
2007;"PORTO DA FOLHA (SE)";"SE";"PORTO DA FOLHA";57;16;26;99
2007;"PROPRIA (SE)";"SE";"PROPRIA";155;19;45;219
2007;"RIACHAO DO DANTAS (SE)";"SE";"RIACHAO DO DANTAS";15;5;14;34
2007;"RIACHUELO (SE)";"SE";"RIACHUELO";26;6;10;42
2007;"RIBEIROPOLIS (SE)";"SE";"RIBEIROPOLIS";229;40;33;302
2007;"ROSARIO DO CATETE (SE)";"SE";"ROSARIO DO CATETE";25;23;12;60
2007;"SALGADO (SE)";"SE";"SALGADO";83;18;40;141
2007;"SANTA LUZIA DO ITANHY (SE)";"SE";"SANTA LUZIA DO ITANHY";15;5;7;27
2007;"SANTA ROSA DE LIMA (SE)";"SE";"SANTA ROSA DE LIMA";12;4;6;22
2007;"SANTANA DO SAO FRANCISCO (SE)";"SE";"SANTANA DO SAO FRANCISCO";5;5;6;16
2007;"SANTO AMARO DAS BROTAS (SE)";"SE";"SANTO AMARO DAS BROTAS";12;4;6;22
2007;"SAO CRISTOVAO (SE)";"SE";"SAO CRISTOVAO";237;46;66;349
2007;"SAO DOMINGOS (SE)";"SE";"SAO DOMINGOS";93;14;9;116
2007;"SAO FRANCISCO (SE)";"SE";"SAO FRANCISCO";13;4;15;32
2007;"SAO MIGUEL DO ALEIXO (SE)";"SE";"SAO MIGUEL DO ALEIXO";33;7;10;50
2007;"SIMAO DIAS (SE)";"SE";"SIMAO DIAS";165;38;141;344
2007;"SIRIRI (SE)";"SE";"SIRIRI";26;9;19;54
2007;"TELHA (SE)";"SE";"TELHA";7;2;3;12
2007;"TOBIAS BARRETO (SE)";"SE";"TOBIAS BARRETO";172;51;93;316
2007;"TOMAR DO GERU (SE)";"SE";"TOMAR DO GERU";34;10;11;55
2007;"UMBAUBA (SE)";"SE";"UMBAUBA";211;33;22;266
2007;"ADAMANTINA (SP)";"SP";"ADAMANTINA";643;46;61;750
2007;"ADOLFO (SP)";"SP";"ADOLFO";59;4;20;83
2007;"AGUAI (SP)";"SP";"AGUAI";679;40;102;821
2007;"AGUAS DA PRATA (SP)";"SP";"AGUAS DA PRATA";110;13;6;129
2007;"AGUAS DE LINDOIA (SP)";"SP";"AGUAS DE LINDOIA";134;37;33;204
2007;"AGUAS DE SANTA BARBARA (SP)";"SP";"AGUAS DE SANTA BARBARA";96;7;13;116
2007;"AGUAS DE SAO PEDRO (SP)";"SP";"AGUAS DE SAO PEDRO";23;9;3;35
2007;"AGUDOS (SP)";"SP";"AGUDOS";450;35;58;543
2007;"ALAMBARI (SP)";"SP";"ALAMBARI";67;8;3;78
2007;"ALFREDO MARCONDES (SP)";"SP";"ALFREDO MARCONDES";50;6;8;64
2007;"ALTAIR (SP)";"SP";"ALTAIR";62;5;29;96
2007;"ALTINOPOLIS (SP)";"SP";"ALTINOPOLIS";309;18;76;403
2007;"ALTO ALEGRE (SP)";"SP";"ALTO ALEGRE";69;2;32;103
2007;"ALUMINIO (SP)";"SP";"ALUMINIO";183;24;43;250
2007;"ALVARES FLORENCE (SP)";"SP";"ALVARES FLORENCE";51;4;13;68
2007;"ALVARES MACHADO (SP)";"SP";"ALVARES MACHADO";370;11;30;411
2007;"ALVARO DE CARVALHO (SP)";"SP";"ALVARO DE CARVALHO";17;5;14;36
2007;"ALVINLANDIA (SP)";"SP";"ALVINLANDIA";29;2;9;40
2007;"AMERICANA (SP)";"SP";"AMERICANA";2814;360;748;3922
2007;"AMERICO BRASILIENSE (SP)";"SP";"AMERICO BRASILIENSE";573;36;208;817
2007;"AMERICO DE CAMPOS (SP)";"SP";"AMERICO DE CAMPOS";135;3;21;159
2007;"AMPARO (SP)";"SP";"AMPARO";1145;161;110;1416
2007;"ANALANDIA (SP)";"SP";"ANALANDIA";57;8;11;76
2007;"ANDRADINA (SP)";"SP";"ANDRADINA";830;34;102;966
2007;"ANGATUBA (SP)";"SP";"ANGATUBA";331;34;62;427
2007;"ANHEMBI (SP)";"SP";"ANHEMBI";58;13;8;79
2007;"ANHUMAS (SP)";"SP";"ANHUMAS";62;4;6;72
2007;"APARECIDA (SP)";"SP";"APARECIDA";769;44;537;1350
2007;"APARECIDA D OESTE (SP)";"SP";"APARECIDA D OESTE";93;7;19;119
2007;"APIAI (SP)";"SP";"APIAI";246;26;57;329
2007;"ARACARIGUAMA (SP)";"SP";"ARACARIGUAMA";376;35;38;449
2007;"ARACATUBA (SP)";"SP";"ARACATUBA";2818;180;547;3545
2007;"ARACOIABA DA SERRA (SP)";"SP";"ARACOIABA DA SERRA";342;43;13;398
2007;"ARAMINA (SP)";"SP";"ARAMINA";64;4;15;83
2007;"ARANDU (SP)";"SP";"ARANDU";41;7;10;58
2007;"ARAPEI (SP)";"SP";"ARAPEI";36;4;8;48
2007;"ARARAQUARA (SP)";"SP";"ARARAQUARA";2763;312;755;3830
2007;"ARARAS (SP)";"SP";"ARARAS";1897;174;201;2272
2007;"ARCO IRIS (SP)";"SP";"ARCO IRIS";44;4;9;57
2007;"AREALVA (SP)";"SP";"AREALVA";148;5;14;167
2007;"AREIAS (SP)";"SP";"AREIAS";38;3;3;44
2007;"AREIOPOLIS (SP)";"SP";"AREIOPOLIS";104;12;46;162
2007;"ARIRANHA (SP)";"SP";"ARIRANHA";240;19;97;356
2007;"ARTUR NOGUEIRA (SP)";"SP";"ARTUR NOGUEIRA";796;76;126;998
2007;"ARUJA (SP)";"SP";"ARUJA";1754;166;252;2172
2007;"ASPASIA (SP)";"SP";"ASPASIA";27;3;2;32
2007;"ASSIS (SP)";"SP";"ASSIS";1368;104;339;1811
2007;"ATIBAIA (SP)";"SP";"ATIBAIA";1735;210;223;2168
2007;"AURIFLAMA (SP)";"SP";"AURIFLAMA";283;10;32;325
2007;"AVAI (SP)";"SP";"AVAI";53;5;16;74
2007;"AVANHANDAVA (SP)";"SP";"AVANHANDAVA";113;7;30;150
2007;"AVARE (SP)";"SP";"AVARE";1029;86;228;1343
2007;"BADY BASSITT (SP)";"SP";"BADY BASSITT";257;18;29;304
2007;"BALBINOS (SP)";"SP";"BALBINOS";13;1;5;19
2007;"BALSAMO (SP)";"SP";"BALSAMO";149;3;12;164
2007;"BANANAL (SP)";"SP";"BANANAL";105;12;20;137
2007;"BARAO DE ANTONINA (SP)";"SP";"BARAO DE ANTONINA";19;2;10;31
2007;"BARBOSA (SP)";"SP";"BARBOSA";83;4;18;105
2007;"BARIRI (SP)";"SP";"BARIRI";693;26;74;793
2007;"BARRA BONITA (SP)";"SP";"BARRA BONITA";1062;60;180;1302
2007;"BARRA DO CHAPEU (SP)";"SP";"BARRA DO CHAPEU";27;3;6;36
2007;"BARRA DO TURVO (SP)";"SP";"BARRA DO TURVO";53;4;29;86
2007;"BARRETOS (SP)";"SP";"BARRETOS";1642;110;387;2139
2007;"BARRINHA (SP)";"SP";"BARRINHA";349;26;138;513
2007;"BARUERI (SP)";"SP";"BARUERI";3743;478;820;5041
2007;"BASTOS (SP)";"SP";"BASTOS";592;14;54;660
2007;"BATATAIS (SP)";"SP";"BATATAIS";954;47;132;1133
2007;"BAURU (SP)";"SP";"BAURU";4178;389;953;5520
2007;"BEBEDOURO (SP)";"SP";"BEBEDOURO";1496;97;201;1794
2007;"BENTO DE ABREU (SP)";"SP";"BENTO DE ABREU";88;5;13;106
2007;"BERNARDINO DE CAMPOS (SP)";"SP";"BERNARDINO DE CAMPOS";260;14;31;305
2007;"BERTIOGA (SP)";"SP";"BERTIOGA";366;41;59;466
2007;"BILAC (SP)";"SP";"BILAC";117;7;21;145
2007;"BIRIGUI (SP)";"SP";"BIRIGUI";1376;48;101;1525
2007;"BIRITIBA MIRIM (SP)";"SP";"BIRITIBA MIRIM";254;14;22;290
2007;"BOA ESPERANCA DO SUL (SP)";"SP";"BOA ESPERANCA DO SUL";354;19;72;445
2007;"BOCAINA (SP)";"SP";"BOCAINA";187;25;34;246
2007;"BOFETE (SP)";"SP";"BOFETE";137;10;35;182
2007;"BOITUVA (SP)";"SP";"BOITUVA";847;65;83;995
2007;"BOM JESUS DOS PERDOES (SP)";"SP";"BOM JESUS DOS PERDOES";293;37;21;351
2007;"BOM SUCESSO DE ITARARE (SP)";"SP";"BOM SUCESSO DE ITARARE";49;8;6;63
2007;"BORA (SP)";"SP";"BORA";20;0;4;24
2007;"BORACEIA (SP)";"SP";"BORACEIA";207;3;18;228
2007;"BORBOREMA (SP)";"SP";"BORBOREMA";259;8;51;318
2007;"BOREBI (SP)";"SP";"BOREBI";31;4;5;40
2007;"BOTUCATU (SP)";"SP";"BOTUCATU";1288;181;360;1829
2007;"BRAGANCA PAULISTA (SP)";"SP";"BRAGANCA PAULISTA";2096;196;217;2509
2007;"BRAUNA (SP)";"SP";"BRAUNA";63;1;38;102
2007;"BREJO ALEGRE (SP)";"SP";"BREJO ALEGRE";33;1;15;49
2007;"BRODOSQUI (SP)";"SP";"BRODOSQUI";425;15;33;473
2007;"BROTAS (SP)";"SP";"BROTAS";415;32;105;552
2007;"BURI (SP)";"SP";"BURI";303;19;39;361
2007;"BURITAMA (SP)";"SP";"BURITAMA";244;21;40;305
2007;"BURITIZAL (SP)";"SP";"BURITIZAL";92;8;31;131
2007;"CABRALIA PAULISTA (SP)";"SP";"CABRALIA PAULISTA";105;2;6;113
2007;"CABREUVA (SP)";"SP";"CABREUVA";830;76;60;966
2007;"CACAPAVA (SP)";"SP";"CACAPAVA";652;169;83;904
2007;"CACHOEIRA PAULISTA (SP)";"SP";"CACHOEIRA PAULISTA";269;36;11;316
2007;"CACONDE (SP)";"SP";"CACONDE";185;18;60;263
2007;"CAFELANDIA (SP)";"SP";"CAFELANDIA";229;9;49;287
2007;"CAIABU (SP)";"SP";"CAIABU";37;3;29;69
2007;"CAIEIRAS (SP)";"SP";"CAIEIRAS";716;137;390;1243
2007;"CAIUA (SP)";"SP";"CAIUA";51;6;11;68
2007;"CAJAMAR (SP)";"SP";"CAJAMAR";829;74;86;989
2007;"CAJATI (SP)";"SP";"CAJATI";323;33;51;407
2007;"CAJOBI (SP)";"SP";"CAJOBI";274;4;66;344
2007;"CAJURU (SP)";"SP";"CAJURU";395;11;88;494
2007;"CAMPINA DO MONTE ALEGRE (SP)";"SP";"CAMPINA DO MONTE ALEGRE";63;10;22;95
2007;"CAMPINAS (SP)";"SP";"CAMPINAS";14205;2604;3920;20729
2007;"CAMPO LIMPO PAULISTA (SP)";"SP";"CAMPO LIMPO PAULISTA";426;80;24;530
2007;"CAMPOS DO JORDAO (SP)";"SP";"CAMPOS DO JORDAO";497;124;38;659
2007;"CAMPOS NOVOS PAULISTA (SP)";"SP";"CAMPOS NOVOS PAULISTA";75;4;21;100
2007;"CANANEIA (SP)";"SP";"CANANEIA";57;2;9;68
2007;"CANAS (SP)";"SP";"CANAS";41;3;5;49
2007;"CANDIDO MOTA (SP)";"SP";"CANDIDO MOTA";677;17;48;742
2007;"CANDIDO RODRIGUES (SP)";"SP";"CANDIDO RODRIGUES";100;5;5;110
2007;"CANITAR (SP)";"SP";"CANITAR";47;7;21;75
2007;"CAPAO BONITO (SP)";"SP";"CAPAO BONITO";727;60;119;906
2007;"CAPELA DO ALTO (SP)";"SP";"CAPELA DO ALTO";316;20;27;363
2007;"CAPIVARI (SP)";"SP";"CAPIVARI";1001;52;158;1211
2007;"CARAGUATATUBA (SP)";"SP";"CARAGUATATUBA";994;99;90;1183
2007;"CARAPICUIBA (SP)";"SP";"CARAPICUIBA";2056;416;758;3230
2007;"CARDOSO (SP)";"SP";"CARDOSO";155;7;35;197
2007;"CASA BRANCA (SP)";"SP";"CASA BRANCA";417;41;66;524
2007;"CASSIA DOS COQUEIROS (SP)";"SP";"CASSIA DOS COQUEIROS";13;3;7;23
2007;"CASTILHO (SP)";"SP";"CASTILHO";177;17;72;266
2007;"CATANDUVA (SP)";"SP";"CATANDUVA";2587;162;406;3155
2007;"CATIGUA (SP)";"SP";"CATIGUA";103;5;27;135
2007;"CEDRAL (SP)";"SP";"CEDRAL";239;10;12;261
2007;"CERQUEIRA CESAR (SP)";"SP";"CERQUEIRA CESAR";253;27;67;347
2007;"CERQUILHO (SP)";"SP";"CERQUILHO";756;70;70;896
2007;"CESARIO LANGE (SP)";"SP";"CESARIO LANGE";261;29;29;319
2007;"CHARQUEADA (SP)";"SP";"CHARQUEADA";374;21;71;466
2007;"CHAVANTES (SP)";"SP";"CHAVANTES";133;9;35;177
2007;"CLEMENTINA (SP)";"SP";"CLEMENTINA";188;4;53;245
2007;"COLINA (SP)";"SP";"COLINA";350;7;64;421
2007;"COLOMBIA (SP)";"SP";"COLOMBIA";110;17;63;190
2007;"CONCHAL (SP)";"SP";"CONCHAL";621;25;156;802
2007;"CONCHAS (SP)";"SP";"CONCHAS";255;23;24;302
2007;"CORDEIROPOLIS (SP)";"SP";"CORDEIROPOLIS";543;46;28;617
2007;"COROADOS (SP)";"SP";"COROADOS";61;4;14;79
2007;"CORONEL MACEDO (SP)";"SP";"CORONEL MACEDO";52;6;23;81
2007;"CORUMBATAI (SP)";"SP";"CORUMBATAI";129;10;8;147
2007;"COSMOPOLIS (SP)";"SP";"COSMOPOLIS";598;136;212;946
2007;"COSMORAMA (SP)";"SP";"COSMORAMA";126;3;28;157
2007;"COTIA (SP)";"SP";"COTIA";1948;616;265;2829
2007;"CRAVINHOS (SP)";"SP";"CRAVINHOS";790;58;120;968
2007;"CRISTAIS PAULISTA (SP)";"SP";"CRISTAIS PAULISTA";80;2;17;99
2007;"CRUZALIA (SP)";"SP";"CRUZALIA";68;10;4;82
2007;"CRUZEIRO (SP)";"SP";"CRUZEIRO";550;60;37;647
2007;"CUBATAO (SP)";"SP";"CUBATAO";1994;297;319;2610
2007;"CUNHA (SP)";"SP";"CUNHA";209;23;20;252
2007;"DESCALVADO (SP)";"SP";"DESCALVADO";768;51;129;948
2007;"DIADEMA (SP)";"SP";"DIADEMA";3255;535;471;4261
2007;"DIRCE REIS (SP)";"SP";"DIRCE REIS";48;5;5;58
2007;"DIVINOLANDIA (SP)";"SP";"DIVINOLANDIA";379;16;23;418
2007;"DOBRADA (SP)";"SP";"DOBRADA";65;4;52;121
2007;"DOIS CORREGOS (SP)";"SP";"DOIS CORREGOS";562;33;103;698
2007;"DOLCINOPOLIS (SP)";"SP";"DOLCINOPOLIS";20;4;5;29
2007;"DOURADO (SP)";"SP";"DOURADO";159;13;39;211
2007;"DRACENA (SP)";"SP";"DRACENA";916;27;120;1063
2007;"DUARTINA (SP)";"SP";"DUARTINA";230;20;36;286
2007;"DUMONT (SP)";"SP";"DUMONT";258;10;44;312
2007;"ECHAPORA (SP)";"SP";"ECHAPORA";94;1;15;110
2007;"ELDORADO (SP)";"SP";"ELDORADO";172;5;43;220
2007;"ELIAS FAUSTO (SP)";"SP";"ELIAS FAUSTO";264;17;52;333
2007;"ELISIARIO (SP)";"SP";"ELISIARIO";54;3;5;62
2007;"EMBAUBA (SP)";"SP";"EMBAUBA";88;2;23;113
2007;"EMBU (SP)";"SP";"EMBU";1480;370;504;2354
2007;"EMBU GUACU (SP)";"SP";"EMBU GUACU";864;120;127;1111
2007;"EMILIANOPOLIS (SP)";"SP";"EMILIANOPOLIS";44;2;14;60
2007;"ENGENHEIRO COELHO (SP)";"SP";"ENGENHEIRO COELHO";264;23;106;393
2007;"ESPIRITO SANTO DO PINHAL (SP)";"SP";"ESPIRITO SANTO DO PINHAL";540;84;64;688
2007;"ESPIRITO SANTO DO TURVO (SP)";"SP";"ESPIRITO SANTO DO TURVO";126;14;35;175
2007;"ESTIVA GERBI (SP)";"SP";"ESTIVA GERBI";203;10;15;228
2007;"ESTRELA D OESTE (SP)";"SP";"ESTRELA D OESTE";240;6;14;260
2007;"ESTRELA DO NORTE (SP)";"SP";"ESTRELA DO NORTE";21;2;8;31
2007;"EUCLIDES DA CUNHA PAULISTA (SP)";"SP";"EUCLIDES DA CUNHA PAULISTA";75;4;30;109
2007;"FARTURA (SP)";"SP";"FARTURA";194;13;21;228
2007;"FERNANDO PRESTES (SP)";"SP";"FERNANDO PRESTES";197;8;10;215
2007;"FERNANDOPOLIS (SP)";"SP";"FERNANDOPOLIS";1110;40;139;1289
2007;"FERNAO (SP)";"SP";"FERNAO";15;1;4;20
2007;"FERRAZ DE VASCONCELOS (SP)";"SP";"FERRAZ DE VASCONCELOS";962;127;164;1253
2007;"FLORA RICA (SP)";"SP";"FLORA RICA";14;1;7;22
2007;"FLOREAL (SP)";"SP";"FLOREAL";41;9;5;55
2007;"FLORIDA PAULISTA (SP)";"SP";"FLORIDA PAULISTA";293;6;93;392
2007;"FLORINEA (SP)";"SP";"FLORINEA";36;4;6;46
2007;"FRANCA (SP)";"SP";"FRANCA";2493;246;433;3172
2007;"FRANCISCO MORATO (SP)";"SP";"FRANCISCO MORATO";373;104;119;596
2007;"FRANCO DA ROCHA (SP)";"SP";"FRANCO DA ROCHA";479;111;122;712
2007;"GABRIEL MONTEIRO (SP)";"SP";"GABRIEL MONTEIRO";45;2;9;56
2007;"GALIA (SP)";"SP";"GALIA";110;9;27;146
2007;"GARCA (SP)";"SP";"GARCA";622;37;97;756
2007;"GASTAO VIDIGAL (SP)";"SP";"GASTAO VIDIGAL";68;6;33;107
2007;"GAVIAO PEIXOTO (SP)";"SP";"GAVIAO PEIXOTO";46;6;20;72
2007;"GENERAL SALGADO (SP)";"SP";"GENERAL SALGADO";248;9;69;326
2007;"GETULINA (SP)";"SP";"GETULINA";131;3;51;185
2007;"GLICERIO (SP)";"SP";"GLICERIO";91;2;21;114
2007;"GUAICARA (SP)";"SP";"GUAICARA";55;5;20;80
2007;"GUAIMBE (SP)";"SP";"GUAIMBE";96;3;17;116
2007;"GUAIRA (SP)";"SP";"GUAIRA";942;23;111;1076
2007;"GUAPIACU (SP)";"SP";"GUAPIACU";376;10;73;459
2007;"GUAPIARA (SP)";"SP";"GUAPIARA";270;14;34;318
2007;"GUARA (SP)";"SP";"GUARA";197;17;125;339
2007;"GUARACAI (SP)";"SP";"GUARACAI";279;6;21;306
2007;"GUARACI (SP)";"SP";"GUARACI";122;4;52;178
2007;"GUARANI D OESTE (SP)";"SP";"GUARANI D OESTE";28;2;8;38
2007;"GUARANTA (SP)";"SP";"GUARANTA";81;4;31;116
2007;"GUARARAPES (SP)";"SP";"GUARARAPES";624;29;118;771
2007;"GUARAREMA (SP)";"SP";"GUARAREMA";247;33;35;315
2007;"GUARATINGUETA (SP)";"SP";"GUARATINGUETA";880;194;225;1299
2007;"GUAREI (SP)";"SP";"GUAREI";199;17;36;252
2007;"GUARIBA (SP)";"SP";"GUARIBA";766;35;225;1026
2007;"GUARUJA (SP)";"SP";"GUARUJA";1634;357;345;2336
2007;"GUARULHOS (SP)";"SP";"GUARULHOS";14783;2747;2606;20136
2007;"GUATAPARA (SP)";"SP";"GUATAPARA";118;6;39;163
2007;"GUZOLANDIA (SP)";"SP";"GUZOLANDIA";55;3;30;88
2007;"HERCULANDIA (SP)";"SP";"HERCULANDIA";348;4;20;372
2007;"HOLAMBRA (SP)";"SP";"HOLAMBRA";349;22;51;422
2007;"HORTOLANDIA (SP)";"SP";"HORTOLANDIA";1123;219;231;1573
2007;"IACANGA (SP)";"SP";"IACANGA";160;8;26;194
2007;"IACRI (SP)";"SP";"IACRI";125;2;13;140
2007;"IARAS (SP)";"SP";"IARAS";34;13;16;63
2007;"IBATE (SP)";"SP";"IBATE";444;45;217;706
2007;"IBIRA (SP)";"SP";"IBIRA";147;19;54;220
2007;"IBIRAREMA (SP)";"SP";"IBIRAREMA";128;5;27;160
2007;"IBITINGA (SP)";"SP";"IBITINGA";674;47;113;834
2007;"IBIUNA (SP)";"SP";"IBIUNA";1345;93;102;1540
2007;"ICEM (SP)";"SP";"ICEM";153;9;74;236
2007;"IEPE (SP)";"SP";"IEPE";127;4;24;155
2007;"IGARACU DO TIETE (SP)";"SP";"IGARACU DO TIETE";362;17;50;429
2007;"IGARAPAVA (SP)";"SP";"IGARAPAVA";656;35;105;796
2007;"IGARATA (SP)";"SP";"IGARATA";90;7;10;107
2007;"IGUAPE (SP)";"SP";"IGUAPE";178;20;32;230
2007;"ILHA COMPRIDA (SP)";"SP";"ILHA COMPRIDA";94;9;37;140
2007;"ILHA SOLTEIRA (SP)";"SP";"ILHA SOLTEIRA";209;21;61;291
2007;"ILHABELA (SP)";"SP";"ILHABELA";200;31;37;268
2007;"INDAIATUBA (SP)";"SP";"INDAIATUBA";2268;286;208;2762
2007;"INDIANA (SP)";"SP";"INDIANA";108;4;8;120
2007;"INDIAPORA (SP)";"SP";"INDIAPORA";54;4;10;68
2007;"INUBIA PAULISTA (SP)";"SP";"INUBIA PAULISTA";44;3;12;59
2007;"IPAUCU (SP)";"SP";"IPAUCU";142;14;38;194
2007;"IPERO (SP)";"SP";"IPERO";171;7;40;218
2007;"IPEUNA (SP)";"SP";"IPEUNA";111;14;17;142
2007;"IPIGUA (SP)";"SP";"IPIGUA";21;1;6;28
2007;"IPORANGA (SP)";"SP";"IPORANGA";23;3;8;34
2007;"IPUA (SP)";"SP";"IPUA";239;10;67;316
2007;"IRACEMAPOLIS (SP)";"SP";"IRACEMAPOLIS";479;32;77;588
2007;"IRAPUA (SP)";"SP";"IRAPUA";136;2;57;195
2007;"IRAPURU (SP)";"SP";"IRAPURU";106;14;23;143
2007;"ITABERA (SP)";"SP";"ITABERA";173;10;26;209
2007;"ITAI (SP)";"SP";"ITAI";401;25;89;515
2007;"ITAJOBI (SP)";"SP";"ITAJOBI";417;11;40;468
2007;"ITAJU (SP)";"SP";"ITAJU";63;1;13;77
2007;"ITANHAEM (SP)";"SP";"ITANHAEM";599;87;106;792
2007;"ITAOCA (SP)";"SP";"ITAOCA";13;7;6;26
2007;"ITAPECERICA DA SERRA (SP)";"SP";"ITAPECERICA DA SERRA";1458;426;347;2231
2007;"ITAPETININGA (SP)";"SP";"ITAPETININGA";2026;224;261;2511
2007;"ITAPEVA (SP)";"SP";"ITAPEVA";1550;150;285;1985
2007;"ITAPEVI (SP)";"SP";"ITAPEVI";1071;150;75;1296
2007;"ITAPIRA (SP)";"SP";"ITAPIRA";1395;90;174;1659
2007;"ITAPIRAPUA PAULISTA (SP)";"SP";"ITAPIRAPUA PAULISTA";29;8;6;43
2007;"ITAPOLIS (SP)";"SP";"ITAPOLIS";1128;30;151;1309
2007;"ITAPORANGA (SP)";"SP";"ITAPORANGA";183;9;37;229
2007;"ITAPUI (SP)";"SP";"ITAPUI";354;14;53;421
2007;"ITAPURA (SP)";"SP";"ITAPURA";20;3;8;31
2007;"ITAQUAQUECETUBA (SP)";"SP";"ITAQUAQUECETUBA";1509;215;358;2082
2007;"ITARARE (SP)";"SP";"ITARARE";810;49;243;1102
2007;"ITARIRI (SP)";"SP";"ITARIRI";246;12;15;273
2007;"ITATIBA (SP)";"SP";"ITATIBA";1910;135;177;2222
2007;"ITATINGA (SP)";"SP";"ITATINGA";161;20;73;254
2007;"ITIRAPINA (SP)";"SP";"ITIRAPINA";195;15;49;259
2007;"ITIRAPUA (SP)";"SP";"ITIRAPUA";52;5;20;77
2007;"ITOBI (SP)";"SP";"ITOBI";115;7;66;188
2007;"ITU (SP)";"SP";"ITU";2303;229;441;2973
2007;"ITUPEVA (SP)";"SP";"ITUPEVA";696;71;59;826
2007;"ITUVERAVA (SP)";"SP";"ITUVERAVA";626;35;116;777
2007;"JABORANDI (SP)";"SP";"JABORANDI";149;8;44;201
2007;"JABOTICABAL (SP)";"SP";"JABOTICABAL";1451;70;167;1688
2007;"JACAREI (SP)";"SP";"JACAREI";2055;388;267;2710
2007;"JACI (SP)";"SP";"JACI";152;6;12;170
2007;"JACUPIRANGA (SP)";"SP";"JACUPIRANGA";346;20;189;555
2007;"JAGUARIUNA (SP)";"SP";"JAGUARIUNA";916;70;117;1103
2007;"JALES (SP)";"SP";"JALES";996;29;53;1078
2007;"JAMBEIRO (SP)";"SP";"JAMBEIRO";32;13;7;52
2007;"JANDIRA (SP)";"SP";"JANDIRA";979;152;104;1235
2007;"JARDINOPOLIS (SP)";"SP";"JARDINOPOLIS";752;51;90;893
2007;"JARINU (SP)";"SP";"JARINU";431;23;37;491
2007;"JAU (SP)";"SP";"JAU";1838;203;259;2300
2007;"JERIQUARA (SP)";"SP";"JERIQUARA";39;3;8;50
2007;"JOANOPOLIS (SP)";"SP";"JOANOPOLIS";241;14;11;266
2007;"JOAO RAMALHO (SP)";"SP";"JOAO RAMALHO";26;5;25;56
2007;"JOSE BONIFACIO (SP)";"SP";"JOSE BONIFACIO";650;26;83;759
2007;"JULIO MESQUITA (SP)";"SP";"JULIO MESQUITA";38;1;15;54
2007;"JUMIRIM (SP)";"SP";"JUMIRIM";73;4;5;82
2007;"JUNDIAI (SP)";"SP";"JUNDIAI";5819;681;878;7378
2007;"JUNQUEIROPOLIS (SP)";"SP";"JUNQUEIROPOLIS";384;15;110;509
2007;"JUQUIA (SP)";"SP";"JUQUIA";341;11;18;370
2007;"JUQUITIBA (SP)";"SP";"JUQUITIBA";420;54;66;540
2007;"LAGOINHA (SP)";"SP";"LAGOINHA";67;9;13;89
2007;"LARANJAL PAULISTA (SP)";"SP";"LARANJAL PAULISTA";554;34;107;695
2007;"LAVINIA (SP)";"SP";"LAVINIA";76;7;10;93
2007;"LAVRINHAS (SP)";"SP";"LAVRINHAS";94;20;10;124
2007;"LEME (SP)";"SP";"LEME";1891;92;360;2343
2007;"LENCOIS PAULISTA (SP)";"SP";"LENCOIS PAULISTA";1160;89;182;1431
2007;"LIMEIRA (SP)";"SP";"LIMEIRA";3971;527;532;5030
2007;"LINDOIA (SP)";"SP";"LINDOIA";103;11;10;124
2007;"LINS (SP)";"SP";"LINS";1342;68;150;1560
2007;"LORENA (SP)";"SP";"LORENA";711;94;27;832
2007;"LOURDES (SP)";"SP";"LOURDES";21;4;10;35
2007;"LOUVEIRA (SP)";"SP";"LOUVEIRA";768;80;37;885
2007;"LUCELIA (SP)";"SP";"LUCELIA";375;28;138;541
2007;"LUCIANOPOLIS (SP)";"SP";"LUCIANOPOLIS";44;4;8;56
2007;"LUIS ANTONIO (SP)";"SP";"LUIS ANTONIO";251;21;113;385
2007;"LUIZIANIA (SP)";"SP";"LUIZIANIA";58;1;19;78
2007;"LUPERCIO (SP)";"SP";"LUPERCIO";57;3;27;87
2007;"LUTECIA (SP)";"SP";"LUTECIA";44;6;10;60
2007;"MACATUBA (SP)";"SP";"MACATUBA";534;21;64;619
2007;"MACAUBAL (SP)";"SP";"MACAUBAL";122;10;14;146
2007;"MACEDONIA (SP)";"SP";"MACEDONIA";40;3;9;52
2007;"MAGDA (SP)";"SP";"MAGDA";80;7;11;98
2007;"MAIRINQUE (SP)";"SP";"MAIRINQUE";417;67;79;563
2007;"MAIRIPORA (SP)";"SP";"MAIRIPORA";891;133;132;1156
2007;"MANDURI (SP)";"SP";"MANDURI";144;18;42;204
2007;"MARABA PAULISTA (SP)";"SP";"MARABA PAULISTA";27;2;12;41
2007;"MARACAI (SP)";"SP";"MARACAI";292;33;42;367
2007;"MARAPOAMA (SP)";"SP";"MARAPOAMA";128;10;13;151
2007;"MARIAPOLIS (SP)";"SP";"MARIAPOLIS";39;1;19;59
2007;"MARILIA (SP)";"SP";"MARILIA";2530;184;377;3091
2007;"MARINOPOLIS (SP)";"SP";"MARINOPOLIS";57;1;5;63
2007;"MARTINOPOLIS (SP)";"SP";"MARTINOPOLIS";353;21;64;438
2007;"MATAO (SP)";"SP";"MATAO";1311;54;217;1582
2007;"MAUA (SP)";"SP";"MAUA";2746;880;710;4336
2007;"MENDONCA (SP)";"SP";"MENDONCA";91;2;16;109
2007;"MERIDIANO (SP)";"SP";"MERIDIANO";54;1;12;67
2007;"MESOPOLIS (SP)";"SP";"MESOPOLIS";19;3;7;29
2007;"MIGUELOPOLIS (SP)";"SP";"MIGUELOPOLIS";294;8;87;389
2007;"MINEIROS DO TIETE (SP)";"SP";"MINEIROS DO TIETE";253;7;33;293
2007;"MIRA ESTRELA (SP)";"SP";"MIRA ESTRELA";26;5;18;49
2007;"MIRACATU (SP)";"SP";"MIRACATU";485;24;27;536
2007;"MIRANDOPOLIS (SP)";"SP";"MIRANDOPOLIS";491;24;135;650
2007;"MIRANTE DO PARANAPANEMA (SP)";"SP";"MIRANTE DO PARANAPANEMA";170;14;57;241
2007;"MIRASSOL (SP)";"SP";"MIRASSOL";916;39;54;1009
2007;"MIRASSOLANDIA (SP)";"SP";"MIRASSOLANDIA";26;7;9;42
2007;"MOCOCA (SP)";"SP";"MOCOCA";880;71;204;1155
2007;"MOGI DAS CRUZES (SP)";"SP";"MOGI DAS CRUZES";3806;515;917;5238
2007;"MOGI GUACU (SP)";"SP";"MOGI GUACU";1708;286;321;2315
2007;"MOGI MIRIM (SP)";"SP";"MOGI MIRIM";1643;160;402;2205
2007;"MOMBUCA (SP)";"SP";"MOMBUCA";77;6;14;97
2007;"MONCOES (SP)";"SP";"MONCOES";58;8;10;76
2007;"MONGAGUA (SP)";"SP";"MONGAGUA";352;39;39;430
2007;"MONTE ALEGRE DO SUL (SP)";"SP";"MONTE ALEGRE DO SUL";182;21;29;232
2007;"MONTE ALTO (SP)";"SP";"MONTE ALTO";1262;36;94;1392
2007;"MONTE APRAZIVEL (SP)";"SP";"MONTE APRAZIVEL";486;14;87;587
2007;"MONTE AZUL PAULISTA (SP)";"SP";"MONTE AZUL PAULISTA";471;22;97;590
2007;"MONTE CASTELO (SP)";"SP";"MONTE CASTELO";74;4;10;88
2007;"MONTE MOR (SP)";"SP";"MONTE MOR";535;68;132;735
2007;"MONTEIRO LOBATO (SP)";"SP";"MONTEIRO LOBATO";49;16;11;76
2007;"MORRO AGUDO (SP)";"SP";"MORRO AGUDO";647;20;145;812
2007;"MORUNGABA (SP)";"SP";"MORUNGABA";285;43;19;347
2007;"MOTUCA (SP)";"SP";"MOTUCA";166;7;55;228
2007;"MURUTINGA DO SUL (SP)";"SP";"MURUTINGA DO SUL";72;9;7;88
2007;"NANTES (SP)";"SP";"NANTES";16;1;18;35
2007;"NARANDIBA (SP)";"SP";"NARANDIBA";31;2;18;51
2007;"NATIVIDADE DA SERRA (SP)";"SP";"NATIVIDADE DA SERRA";54;15;9;78
2007;"NAZARE PAULISTA (SP)";"SP";"NAZARE PAULISTA";387;8;21;416
2007;"NEVES PAULISTA (SP)";"SP";"NEVES PAULISTA";180;6;27;213
2007;"NHANDEARA (SP)";"SP";"NHANDEARA";164;10;24;198
2007;"NIPOA (SP)";"SP";"NIPOA";100;3;13;116
2007;"NOVA ALIANCA (SP)";"SP";"NOVA ALIANCA";103;11;15;129
2007;"NOVA CAMPINA (SP)";"SP";"NOVA CAMPINA";63;8;11;82
2007;"NOVA CANAA PAULISTA (SP)";"SP";"NOVA CANAA PAULISTA";24;3;4;31
2007;"NOVA CASTILHO (SP)";"SP";"NOVA CASTILHO";12;2;7;21
2007;"NOVA EUROPA (SP)";"SP";"NOVA EUROPA";156;4;84;244
2007;"NOVA GRANADA (SP)";"SP";"NOVA GRANADA";269;11;75;355
2007;"NOVA GUATAPORANGA (SP)";"SP";"NOVA GUATAPORANGA";29;2;13;44
2007;"NOVA INDEPENDENCIA (SP)";"SP";"NOVA INDEPENDENCIA";27;4;8;39
2007;"NOVA LUZITANIA (SP)";"SP";"NOVA LUZITANIA";33;2;19;54
2007;"NOVA ODESSA (SP)";"SP";"NOVA ODESSA";704;94;102;900
2007;"NOVAIS (SP)";"SP";"NOVAIS";97;6;37;140
2007;"NOVO HORIZONTE (SP)";"SP";"NOVO HORIZONTE";869;21;170;1060
2007;"NUPORANGA (SP)";"SP";"NUPORANGA";173;7;33;213
2007;"OCAUCU (SP)";"SP";"OCAUCU";87;2;11;100
2007;"OLEO (SP)";"SP";"OLEO";20;9;5;34
2007;"OLIMPIA (SP)";"SP";"OLIMPIA";931;63;161;1155
2007;"ONDA VERDE (SP)";"SP";"ONDA VERDE";78;5;18;101
2007;"ORIENTE (SP)";"SP";"ORIENTE";62;3;18;83
2007;"ORINDIUVA (SP)";"SP";"ORINDIUVA";141;11;73;225
2007;"ORLANDIA (SP)";"SP";"ORLANDIA";815;33;239;1087
2007;"OSASCO (SP)";"SP";"OSASCO";6844;1219;2007;10070
2007;"OSCAR BRESSANE (SP)";"SP";"OSCAR BRESSANE";35;2;8;45
2007;"OSVALDO CRUZ (SP)";"SP";"OSVALDO CRUZ";530;20;91;641
2007;"OURINHOS (SP)";"SP";"OURINHOS";1790;86;297;2173
2007;"OURO VERDE (SP)";"SP";"OURO VERDE";121;1;41;163
2007;"OUROESTE (SP)";"SP";"OUROESTE";95;7;24;126
2007;"PACAEMBU (SP)";"SP";"PACAEMBU";171;20;41;232
2007;"PALESTINA (SP)";"SP";"PALESTINA";135;7;30;172
2007;"PALMARES PAULISTA (SP)";"SP";"PALMARES PAULISTA";71;6;70;147
2007;"PALMEIRA D OESTE (SP)";"SP";"PALMEIRA D OESTE";197;6;31;234
2007;"PALMITAL (SP)";"SP";"PALMITAL";566;27;58;651
2007;"PANORAMA (SP)";"SP";"PANORAMA";217;6;12;235
2007;"PARAGUACU PAULISTA (SP)";"SP";"PARAGUACU PAULISTA";542;57;86;685
2007;"PARAIBUNA (SP)";"SP";"PARAIBUNA";164;34;30;228
2007;"PARAISO (SP)";"SP";"PARAISO";177;5;44;226
2007;"PARANAPANEMA (SP)";"SP";"PARANAPANEMA";414;19;50;483
2007;"PARANAPUA (SP)";"SP";"PARANAPUA";65;5;8;78
2007;"PARAPUA (SP)";"SP";"PARAPUA";222;5;37;264
2007;"PARDINHO (SP)";"SP";"PARDINHO";119;10;15;144
2007;"PARIQUERA ACU (SP)";"SP";"PARIQUERA ACU";254;12;11;277
2007;"PARISI (SP)";"SP";"PARISI";25;4;8;37
2007;"PATROCINIO PAULISTA (SP)";"SP";"PATROCINIO PAULISTA";164;7;35;206
2007;"PAULICEIA (SP)";"SP";"PAULICEIA";169;6;16;191
2007;"PAULINIA (SP)";"SP";"PAULINIA";1468;109;227;1804
2007;"PAULISTANIA (SP)";"SP";"PAULISTANIA";20;6;5;31
2007;"PAULO DE FARIA (SP)";"SP";"PAULO DE FARIA";96;8;44;148
2007;"PEDERNEIRAS (SP)";"SP";"PEDERNEIRAS";772;58;173;1003
2007;"PEDRA BELA (SP)";"SP";"PEDRA BELA";112;4;13;129
2007;"PEDRANOPOLIS (SP)";"SP";"PEDRANOPOLIS";41;1;14;56
2007;"PEDREGULHO (SP)";"SP";"PEDREGULHO";222;15;81;318
2007;"PEDREIRA (SP)";"SP";"PEDREIRA";574;72;69;715
2007;"PEDRINHAS PAULISTA (SP)";"SP";"PEDRINHAS PAULISTA";133;2;11;146
2007;"PEDRO DE TOLEDO (SP)";"SP";"PEDRO DE TOLEDO";120;12;3;135
2007;"PENAPOLIS (SP)";"SP";"PENAPOLIS";1203;30;222;1455
2007;"PEREIRA BARRETO (SP)";"SP";"PEREIRA BARRETO";363;18;120;501
2007;"PEREIRAS (SP)";"SP";"PEREIRAS";204;10;23;237
2007;"PERUIBE (SP)";"SP";"PERUIBE";446;110;67;623
2007;"PIACATU (SP)";"SP";"PIACATU";74;1;11;86
2007;"PIEDADE (SP)";"SP";"PIEDADE";1085;80;69;1234
2007;"PILAR DO SUL (SP)";"SP";"PILAR DO SUL";611;36;53;700
2007;"PINDAMONHANGABA (SP)";"SP";"PINDAMONHANGABA";1129;177;165;1471
2007;"PINDORAMA (SP)";"SP";"PINDORAMA";206;10;53;269
2007;"PINHALZINHO (SP)";"SP";"PINHALZINHO";299;17;8;324
2007;"PIQUEROBI (SP)";"SP";"PIQUEROBI";26;6;5;37
2007;"PIQUETE (SP)";"SP";"PIQUETE";134;42;17;193
2007;"PIRACAIA (SP)";"SP";"PIRACAIA";390;46;26;462
2007;"PIRACICABA (SP)";"SP";"PIRACICABA";6042;621;1067;7730
2007;"PIRAJU (SP)";"SP";"PIRAJU";357;33;63;453
2007;"PIRAJUI (SP)";"SP";"PIRAJUI";289;13;53;355
2007;"PIRANGI (SP)";"SP";"PIRANGI";337;19;49;405
2007;"PIRAPORA DO BOM JESUS (SP)";"SP";"PIRAPORA DO BOM JESUS";174;12;12;198
2007;"PIRAPOZINHO (SP)";"SP";"PIRAPOZINHO";394;14;29;437
2007;"PIRASSUNUNGA (SP)";"SP";"PIRASSUNUNGA";883;117;219;1219
2007;"PIRATININGA (SP)";"SP";"PIRATININGA";192;15;23;230
2007;"PITANGUEIRAS (SP)";"SP";"PITANGUEIRAS";694;23;212;929
2007;"PLANALTO (SP)";"SP";"PLANALTO";79;6;20;105
2007;"PLATINA (SP)";"SP";"PLATINA";41;5;10;56
2007;"POA (SP)";"SP";"POA";645;90;78;813
2007;"POLONI (SP)";"SP";"POLONI";146;5;36;187
2007;"POMPEIA (SP)";"SP";"POMPEIA";231;10;43;284
2007;"PONGAI (SP)";"SP";"PONGAI";38;5;14;57
2007;"PONTAL (SP)";"SP";"PONTAL";781;25;371;1177
2007;"PONTALINDA (SP)";"SP";"PONTALINDA";34;3;21;58
2007;"PONTES GESTAL (SP)";"SP";"PONTES GESTAL";50;1;16;67
2007;"POPULINA (SP)";"SP";"POPULINA";61;3;19;83
2007;"PORANGABA (SP)";"SP";"PORANGABA";93;12;11;116
2007;"PORTO FELIZ (SP)";"SP";"PORTO FELIZ";1015;58;120;1193
2007;"PORTO FERREIRA (SP)";"SP";"PORTO FERREIRA";853;58;134;1045
2007;"POTIM (SP)";"SP";"POTIM";41;36;12;89
2007;"POTIRENDABA (SP)";"SP";"POTIRENDABA";360;13;49;422
2007;"PRACINHA (SP)";"SP";"PRACINHA";11;1;12;24
2007;"PRADOPOLIS (SP)";"SP";"PRADOPOLIS";338;18;131;487
2007;"PRAIA GRANDE (SP)";"SP";"PRAIA GRANDE";1441;212;208;1861
2007;"PRATANIA (SP)";"SP";"PRATANIA";93;7;24;124
2007;"PRESIDENTE ALVES (SP)";"SP";"PRESIDENTE ALVES";83;5;30;118
2007;"PRESIDENTE BERNARDES (SP)";"SP";"PRESIDENTE BERNARDES";202;14;25;241
2007;"PRESIDENTE EPITACIO (SP)";"SP";"PRESIDENTE EPITACIO";391;24;94;509
2007;"PRESIDENTE PRUDENTE (SP)";"SP";"PRESIDENTE PRUDENTE";3193;218;700;4111
2007;"PRESIDENTE VENCESLAU (SP)";"SP";"PRESIDENTE VENCESLAU";564;30;51;645
2007;"PROMISSAO (SP)";"SP";"PROMISSAO";646;32;145;823
2007;"QUADRA (SP)";"SP";"QUADRA";36;5;17;58
2007;"QUATA (SP)";"SP";"QUATA";165;13;54;232
2007;"QUEIROZ (SP)";"SP";"QUEIROZ";19;2;6;27
2007;"QUELUZ (SP)";"SP";"QUELUZ";104;16;7;127
2007;"QUINTANA (SP)";"SP";"QUINTANA";77;9;10;96
2007;"RAFARD (SP)";"SP";"RAFARD";226;17;20;263
2007;"RANCHARIA (SP)";"SP";"RANCHARIA";495;47;61;603
2007;"REDENCAO DA SERRA (SP)";"SP";"REDENCAO DA SERRA";44;13;14;71
2007;"REGENTE FEIJO (SP)";"SP";"REGENTE FEIJO";310;22;21;353
2007;"REGINOPOLIS (SP)";"SP";"REGINOPOLIS";69;4;15;88
2007;"REGISTRO (SP)";"SP";"REGISTRO";830;60;248;1138
2007;"RESTINGA (SP)";"SP";"RESTINGA";45;4;14;63
2007;"RIBEIRA (SP)";"SP";"RIBEIRA";21;4;4;29
2007;"RIBEIRAO BONITO (SP)";"SP";"RIBEIRAO BONITO";249;20;54;323
2007;"RIBEIRAO BRANCO (SP)";"SP";"RIBEIRAO BRANCO";124;16;23;163
2007;"RIBEIRAO CORRENTE (SP)";"SP";"RIBEIRAO CORRENTE";48;6;23;77
2007;"RIBEIRAO DO SUL (SP)";"SP";"RIBEIRAO DO SUL";97;7;12;116
2007;"RIBEIRAO DOS INDIOS (SP)";"SP";"RIBEIRAO DOS INDIOS";20;2;12;34
2007;"RIBEIRAO GRANDE (SP)";"SP";"RIBEIRAO GRANDE";71;12;12;95
2007;"RIBEIRAO PIRES (SP)";"SP";"RIBEIRAO PIRES";1226;279;273;1778
2007;"RIBEIRAO PRETO (SP)";"SP";"RIBEIRAO PRETO";7520;673;1281;9474
2007;"RIFAINA (SP)";"SP";"RIFAINA";34;2;6;42
2007;"RINCAO (SP)";"SP";"RINCAO";177;8;43;228
2007;"RINOPOLIS (SP)";"SP";"RINOPOLIS";177;6;49;232
2007;"RIO CLARO (SP)";"SP";"RIO CLARO";2620;229;392;3241
2007;"RIO DAS PEDRAS (SP)";"SP";"RIO DAS PEDRAS";616;42;157;815
2007;"RIO GRANDE DA SERRA (SP)";"SP";"RIO GRANDE DA SERRA";192;56;33;281
2007;"RIOLANDIA (SP)";"SP";"RIOLANDIA";83;4;44;131
2007;"RIVERSUL (SP)";"SP";"RIVERSUL";45;5;21;71
2007;"ROSANA (SP)";"SP";"ROSANA";133;9;41;183
2007;"ROSEIRA (SP)";"SP";"ROSEIRA";119;33;13;165
2007;"RUBIACEA (SP)";"SP";"RUBIACEA";27;1;12;40
2007;"RUBINEIA (SP)";"SP";"RUBINEIA";15;3;7;25
2007;"SABINO (SP)";"SP";"SABINO";55;5;8;68
2007;"SAGRES (SP)";"SP";"SAGRES";12;2;5;19
2007;"SALES (SP)";"SP";"SALES";67;4;18;89
2007;"SALES OLIVEIRA (SP)";"SP";"SALES OLIVEIRA";205;8;39;252
2007;"SALESOPOLIS (SP)";"SP";"SALESOPOLIS";499;31;35;565
2007;"SALMOURAO (SP)";"SP";"SALMOURAO";25;2;29;56
2007;"SALTINHO (SP)";"SP";"SALTINHO";288;10;4;302
2007;"SALTO (SP)";"SP";"SALTO";1552;169;179;1900
2007;"SALTO DE PIRAPORA (SP)";"SP";"SALTO DE PIRAPORA";491;30;55;576
2007;"SALTO GRANDE (SP)";"SP";"SALTO GRANDE";123;6;25;154
2007;"SANDOVALINA (SP)";"SP";"SANDOVALINA";26;3;7;36
2007;"SANTA ADELIA (SP)";"SP";"SANTA ADELIA";514;20;76;610
2007;"SANTA ALBERTINA (SP)";"SP";"SANTA ALBERTINA";80;6;19;105
2007;"SANTA BARBARA D OESTE (SP)";"SP";"SANTA BARBARA D OESTE";2083;296;245;2624
2007;"SANTA BRANCA (SP)";"SP";"SANTA BRANCA";94;20;34;148
2007;"SANTA CLARA D OESTE (SP)";"SP";"SANTA CLARA D OESTE";16;1;3;20
2007;"SANTA CRUZ DA CONCEICAO (SP)";"SP";"SANTA CRUZ DA CONCEICAO";113;7;11;131
2007;"SANTA CRUZ DA ESPERANCA (SP)";"SP";"SANTA CRUZ DA ESPERANCA";17;0;6;23
2007;"SANTA CRUZ DAS PALMEIRAS (SP)";"SP";"SANTA CRUZ DAS PALMEIRAS";627;25;204;856
2007;"SANTA CRUZ DO RIO PARDO (SP)";"SP";"SANTA CRUZ DO RIO PARDO";1022;66;64;1152
2007;"SANTA ERNESTINA (SP)";"SP";"SANTA ERNESTINA";85;4;42;131
2007;"SANTA FE DO SUL (SP)";"SP";"SANTA FE DO SUL";560;13;29;602
2007;"SANTA GERTRUDES (SP)";"SP";"SANTA GERTRUDES";440;36;21;497
2007;"SANTA ISABEL (SP)";"SP";"SANTA ISABEL";678;45;52;775
2007;"SANTA LUCIA (SP)";"SP";"SANTA LUCIA";111;15;46;172
2007;"SANTA MARIA DA SERRA (SP)";"SP";"SANTA MARIA DA SERRA";203;19;20;242
2007;"SANTA MERCEDES (SP)";"SP";"SANTA MERCEDES";37;5;8;50
2007;"SANTA RITA D OESTE (SP)";"SP";"SANTA RITA D OESTE";26;0;4;30
2007;"SANTA RITA DO PASSA QUATRO (SP)";"SP";"SANTA RITA DO PASSA QUATRO";505;43;41;589
2007;"SANTA ROSA DE VITERBO (SP)";"SP";"SANTA ROSA DE VITERBO";350;30;72;452
2007;"SANTA SALETE (SP)";"SP";"SANTA SALETE";36;4;5;45
2007;"SANTANA DA PONTE PENSA (SP)";"SP";"SANTANA DA PONTE PENSA";24;3;1;28
2007;"SANTANA DE PARNAIBA (SP)";"SP";"SANTANA DE PARNAIBA";1240;180;71;1491
2007;"SANTO ANASTACIO (SP)";"SP";"SANTO ANASTACIO";405;13;49;467
2007;"SANTO ANDRE (SP)";"SP";"SANTO ANDRE";7366;1479;1523;10368
2007;"SANTO ANTONIO DA ALEGRIA (SP)";"SP";"SANTO ANTONIO DA ALEGRIA";81;5;15;101
2007;"SANTO ANTONIO DE POSSE (SP)";"SP";"SANTO ANTONIO DE POSSE";579;31;81;691
2007;"SANTO ANTONIO DO ARACANGUA (SP)";"SP";"SANTO ANTONIO DO ARACANGUA";176;6;58;240
2007;"SANTO ANTONIO DO JARDIM (SP)";"SP";"SANTO ANTONIO DO JARDIM";170;11;10;191
2007;"SANTO ANTONIO DO PINHAL (SP)";"SP";"SANTO ANTONIO DO PINHAL";86;17;5;108
2007;"SANTO EXPEDITO (SP)";"SP";"SANTO EXPEDITO";23;1;5;29
2007;"SANTOPOLIS DO AGUAPEI (SP)";"SP";"SANTOPOLIS DO AGUAPEI";67;3;30;100
2007;"SANTOS (SP)";"SP";"SANTOS";4488;676;607;5771
2007;"SAO BENTO DO SAPUCAI (SP)";"SP";"SAO BENTO DO SAPUCAI";100;34;8;142
2007;"SAO BERNARDO DO CAMPO (SP)";"SP";"SAO BERNARDO DO CAMPO";9689;1666;2132;13487
2007;"SAO CAETANO DO SUL (SP)";"SP";"SAO CAETANO DO SUL";2534;471;412;3417
2007;"SAO CARLOS (SP)";"SP";"SAO CARLOS";3022;295;324;3641
2007;"SAO FRANCISCO (SP)";"SP";"SAO FRANCISCO";29;3;10;42
2007;"SAO JOAO DA BOA VISTA (SP)";"SP";"SAO JOAO DA BOA VISTA";1547;178;94;1819
2007;"SAO JOAO DAS DUAS PONTES (SP)";"SP";"SAO JOAO DAS DUAS PONTES";16;6;7;29
2007;"SAO JOAO DE IRACEMA (SP)";"SP";"SAO JOAO DE IRACEMA";23;2;12;37
2007;"SAO JOAO DO PAU D ALHO (SP)";"SP";"SAO JOAO DO PAU D ALHO";30;4;5;39
2007;"SAO JOAQUIM DA BARRA (SP)";"SP";"SAO JOAQUIM DA BARRA";755;31;162;948
2007;"SAO JOSE DA BELA VISTA (SP)";"SP";"SAO JOSE DA BELA VISTA";61;7;39;107
2007;"SAO JOSE DO BARREIRO (SP)";"SP";"SAO JOSE DO BARREIRO";27;10;5;42
2007;"SAO JOSE DO RIO PARDO (SP)";"SP";"SAO JOSE DO RIO PARDO";1043;57;111;1211
2007;"SAO JOSE DO RIO PRETO (SP)";"SP";"SAO JOSE DO RIO PRETO";5785;457;1015;7257
2007;"SAO JOSE DOS CAMPOS (SP)";"SP";"SAO JOSE DOS CAMPOS";5326;1289;1109;7724
2007;"SAO LOURENCO DA SERRA (SP)";"SP";"SAO LOURENCO DA SERRA";171;16;16;203
2007;"SAO LUIZ DO PARAITINGA (SP)";"SP";"SAO LUIZ DO PARAITINGA";112;12;22;146
2007;"SAO MANUEL (SP)";"SP";"SAO MANUEL";670;56;110;836
2007;"SAO MIGUEL ARCANJO (SP)";"SP";"SAO MIGUEL ARCANJO";571;48;44;663
2007;"SAO PAULO (SP)";"SP";"SAO PAULO";128955;27343;37550;193848
2007;"SAO PEDRO (SP)";"SP";"SAO PEDRO";484;55;65;604
2007;"SAO PEDRO DO TURVO (SP)";"SP";"SAO PEDRO DO TURVO";140;11;21;172
2007;"SAO ROQUE (SP)";"SP";"SAO ROQUE";795;123;176;1094
2007;"SAO SEBASTIAO (SP)";"SP";"SAO SEBASTIAO";452;50;126;628
2007;"SAO SEBASTIAO DA GRAMA (SP)";"SP";"SAO SEBASTIAO DA GRAMA";211;18;26;255
2007;"SAO SIMAO (SP)";"SP";"SAO SIMAO";280;13;33;326
2007;"SAO VICENTE (SP)";"SP";"SAO VICENTE";1452;636;739;2827
2007;"SARAPUI (SP)";"SP";"SARAPUI";121;7;9;137
2007;"SARUTAIA (SP)";"SP";"SARUTAIA";30;7;15;52
2007;"SEBASTIANOPOLIS DO SUL (SP)";"SP";"SEBASTIANOPOLIS DO SUL";115;3;17;135
2007;"SERRA AZUL (SP)";"SP";"SERRA AZUL";124;10;72;206
2007;"SERRA NEGRA (SP)";"SP";"SERRA NEGRA";335;36;26;397
2007;"SERRANA (SP)";"SP";"SERRANA";541;97;187;825
2007;"SERTAOZINHO (SP)";"SP";"SERTAOZINHO";2184;99;347;2630
2007;"SETE BARRAS (SP)";"SP";"SETE BARRAS";155;5;24;184
2007;"SEVERINIA (SP)";"SP";"SEVERINIA";326;9;131;466
2007;"SILVEIRAS (SP)";"SP";"SILVEIRAS";60;11;5;76
2007;"SOCORRO (SP)";"SP";"SOCORRO";628;78;37;743
2007;"SOROCABA (SP)";"SP";"SOROCABA";6195;924;1073;8192
2007;"SUD MENUCCI (SP)";"SP";"SUD MENUCCI";131;13;47;191
2007;"SUMARE (SP)";"SP";"SUMARE";1972;382;366;2720
2007;"SUZANO (SP)";"SP";"SUZANO";2178;289;341;2808
2007;"SUZANOPOLIS (SP)";"SP";"SUZANOPOLIS";46;7;13;66
2007;"TABAPUA (SP)";"SP";"TABAPUA";151;12;38;201
2007;"TABATINGA (SP)";"SP";"TABATINGA";338;10;100;448
2007;"TABOAO DA SERRA (SP)";"SP";"TABOAO DA SERRA";1695;507;454;2656
2007;"TACIBA (SP)";"SP";"TACIBA";73;2;12;87
2007;"TAGUAI (SP)";"SP";"TAGUAI";118;3;19;140
2007;"TAIACU (SP)";"SP";"TAIACU";131;3;16;150
2007;"TAIUVA (SP)";"SP";"TAIUVA";138;4;20;162
2007;"TAMBAU (SP)";"SP";"TAMBAU";459;28;39;526
2007;"TANABI (SP)";"SP";"TANABI";436;20;81;537
2007;"TAPIRAI (SP)";"SP";"TAPIRAI";126;6;9;141
2007;"TAPIRATIBA (SP)";"SP";"TAPIRATIBA";264;13;46;323
2007;"TAQUARAL (SP)";"SP";"TAQUARAL";47;4;18;69
2007;"TAQUARITINGA (SP)";"SP";"TAQUARITINGA";1367;49;264;1680
2007;"TAQUARITUBA (SP)";"SP";"TAQUARITUBA";514;22;57;593
2007;"TAQUARIVAI (SP)";"SP";"TAQUARIVAI";46;6;10;62
2007;"TARABAI (SP)";"SP";"TARABAI";80;4;27;111
2007;"TARUMA (SP)";"SP";"TARUMA";316;15;190;521
2007;"TATUI (SP)";"SP";"TATUI";1498;92;443;2033
2007;"TAUBATE (SP)";"SP";"TAUBATE";2441;574;630;3645
2007;"TEJUPA (SP)";"SP";"TEJUPA";42;6;6;54
2007;"TEODORO SAMPAIO (SP)";"SP";"TEODORO SAMPAIO";208;10;164;382
2007;"TERRA ROXA (SP)";"SP";"TERRA ROXA";173;9;52;234
2007;"TIETE (SP)";"SP";"TIETE";1063;35;132;1230
2007;"TIMBURI (SP)";"SP";"TIMBURI";24;3;6;33
2007;"TORRE DE PEDRA (SP)";"SP";"TORRE DE PEDRA";43;2;4;49
2007;"TORRINHA (SP)";"SP";"TORRINHA";348;13;36;397
2007;"TRABIJU (SP)";"SP";"TRABIJU";27;7;6;40
2007;"TREMEMBE (SP)";"SP";"TREMEMBE";307;51;12;370
2007;"TRES FRONTEIRAS (SP)";"SP";"TRES FRONTEIRAS";56;3;6;65
2007;"TUIUTI (SP)";"SP";"TUIUTI";66;16;13;95
2007;"TUPA (SP)";"SP";"TUPA";1209;39;171;1419
2007;"TUPI PAULISTA (SP)";"SP";"TUPI PAULISTA";280;7;24;311
2007;"TURIUBA (SP)";"SP";"TURIUBA";16;1;3;20
2007;"TURMALINA (SP)";"SP";"TURMALINA";26;3;9;38
2007;"UBARANA (SP)";"SP";"UBARANA";95;4;24;123
2007;"UBATUBA (SP)";"SP";"UBATUBA";542;64;53;659
2007;"UBIRAJARA (SP)";"SP";"UBIRAJARA";81;6;18;105
2007;"UCHOA (SP)";"SP";"UCHOA";135;6;29;170
2007;"UNIAO PAULISTA (SP)";"SP";"UNIAO PAULISTA";29;2;7;38
2007;"URANIA (SP)";"SP";"URANIA";134;10;25;169
2007;"URU (SP)";"SP";"URU";11;5;6;22
2007;"URUPES (SP)";"SP";"URUPES";325;12;45;382
2007;"VALENTIM GENTIL (SP)";"SP";"VALENTIM GENTIL";175;16;25;216
2007;"VALINHOS (SP)";"SP";"VALINHOS";1766;358;982;3106
2007;"VALPARAISO (SP)";"SP";"VALPARAISO";356;20;131;507
2007;"VARGEM (SP)";"SP";"VARGEM";202;10;13;225
2007;"VARGEM GRANDE DO SUL (SP)";"SP";"VARGEM GRANDE DO SUL";937;56;150;1143
2007;"VARGEM GRANDE PAULISTA (SP)";"SP";"VARGEM GRANDE PAULISTA";695;60;44;799
2007;"VARZEA PAULISTA (SP)";"SP";"VARZEA PAULISTA";803;239;158;1200
2007;"VERA CRUZ (SP)";"SP";"VERA CRUZ";127;16;25;168
2007;"VINHEDO (SP)";"SP";"VINHEDO";1046;116;77;1239
2007;"VIRADOURO (SP)";"SP";"VIRADOURO";350;12;70;432
2007;"VISTA ALEGRE DO ALTO (SP)";"SP";"VISTA ALEGRE DO ALTO";265;18;86;369
2007;"VITORIA BRASIL (SP)";"SP";"VITORIA BRASIL";14;0;9;23
2007;"VOTORANTIM (SP)";"SP";"VOTORANTIM";974;190;90;1254
2007;"VOTUPORANGA (SP)";"SP";"VOTUPORANGA";1495;54;135;1684
2007;"ZACARIAS (SP)";"SP";"ZACARIAS";31;6;11;48
2007;"ABREULANDIA (TO)";"TO";"ABREULANDIA";11;1;0;12
2007;"AGUIARNOPOLIS (TO)";"TO";"AGUIARNOPOLIS";26;2;3;31
2007;"ALIANCA DO TOCANTINS (TO)";"TO";"ALIANCA DO TOCANTINS";70;3;3;76
2007;"ALMAS (TO)";"TO";"ALMAS";34;0;2;36
2007;"ALVORADA (TO)";"TO";"ALVORADA";136;0;3;139
2007;"ANANAS (TO)";"TO";"ANANAS";38;8;12;58
2007;"ANGICO (TO)";"TO";"ANGICO";7;1;2;10
2007;"APARECIDA DO RIO NEGRO (TO)";"TO";"APARECIDA DO RIO NEGRO";39;11;2;52
2007;"ARAGOMINAS (TO)";"TO";"ARAGOMINAS";116;3;4;123
2007;"ARAGUACEMA (TO)";"TO";"ARAGUACEMA";19;1;5;25
2007;"ARAGUACU (TO)";"TO";"ARAGUACU";62;1;4;67
2007;"ARAGUAINA (TO)";"TO";"ARAGUAINA";2892;103;234;3229
2007;"ARAGUANA (TO)";"TO";"ARAGUANA";239;15;22;276
2007;"ARAGUATINS (TO)";"TO";"ARAGUATINS";346;51;55;452
2007;"ARAPOEMA (TO)";"TO";"ARAPOEMA";42;2;8;52
2007;"ARRAIAS (TO)";"TO";"ARRAIAS";31;1;5;37
2007;"AUGUSTINOPOLIS (TO)";"TO";"AUGUSTINOPOLIS";97;36;3;136
2007;"AURORA DO TOCANTINS (TO)";"TO";"AURORA DO TOCANTINS";2;0;2;4
2007;"AXIXA DO TOCANTINS (TO)";"TO";"AXIXA DO TOCANTINS";25;15;4;44
2007;"BABACULANDIA (TO)";"TO";"BABACULANDIA";392;18;10;420
2007;"BANDEIRANTES DO TOCANTINS (TO)";"TO";"BANDEIRANTES DO TOCANTINS";19;3;3;25
2007;"BARRA DO OURO (TO)";"TO";"BARRA DO OURO";1;0;0;1
2007;"BARROLANDIA (TO)";"TO";"BARROLANDIA";33;3;2;38
2007;"BERNARDO SAYAO (TO)";"TO";"BERNARDO SAYAO";28;2;7;37
2007;"BOM JESUS DO TOCANTINS (TO)";"TO";"BOM JESUS DO TOCANTINS";1;2;0;3
2007;"BRASILANDIA DO TOCANTINS (TO)";"TO";"BRASILANDIA DO TOCANTINS";11;1;1;13
2007;"BREJINHO DE NAZARE (TO)";"TO";"BREJINHO DE NAZARE";31;0;5;36
2007;"BURITI DO TOCANTINS (TO)";"TO";"BURITI DO TOCANTINS";14;12;1;27
2007;"CACHOEIRINHA (TO)";"TO";"CACHOEIRINHA";3;1;0;4
2007;"CAMPOS LINDOS (TO)";"TO";"CAMPOS LINDOS";28;0;1;29
2007;"CARIRI DO TOCANTINS (TO)";"TO";"CARIRI DO TOCANTINS";26;1;4;31
2007;"CARMOLANDIA (TO)";"TO";"CARMOLANDIA";619;63;118;800
2007;"CARRASCO BONITO (TO)";"TO";"CARRASCO BONITO";5;5;1;11
2007;"CASEARA (TO)";"TO";"CASEARA";20;2;2;24
2007;"CENTENARIO (TO)";"TO";"CENTENARIO";3;1;0;4
2007;"CHAPADA DA NATIVIDADE (TO)";"TO";"CHAPADA DA NATIVIDADE";14;0;2;16
2007;"CHAPADA DE AREIA (TO)";"TO";"CHAPADA DE AREIA";2;0;2;4
2007;"COLINAS DO TOCANTINS (TO)";"TO";"COLINAS DO TOCANTINS";427;11;35;473
2007;"COLMEIA (TO)";"TO";"COLMEIA";100;6;7;113
2007;"COMBINADO (TO)";"TO";"COMBINADO";14;1;4;19
2007;"CONCEICAO DO TOCANTINS (TO)";"TO";"CONCEICAO DO TOCANTINS";6;0;0;6
2007;"COUTO DE MAGALHAES (TO)";"TO";"COUTO DE MAGALHAES";5;7;2;14
2007;"CRISTALANDIA (TO)";"TO";"CRISTALANDIA";68;0;2;70
2007;"CRIXAS DO TOCANTINS (TO)";"TO";"CRIXAS DO TOCANTINS";6;2;0;8
2007;"DARCINOPOLIS (TO)";"TO";"DARCINOPOLIS";120;16;4;140
2007;"DIANOPOLIS (TO)";"TO";"DIANOPOLIS";102;3;23;128
2007;"DIVINOPOLIS DO TOCANTINS (TO)";"TO";"DIVINOPOLIS DO TOCANTINS";47;2;3;52
2007;"DOIS IRMAOS DO TOCANTINS (TO)";"TO";"DOIS IRMAOS DO TOCANTINS";29;2;1;32
2007;"DUERE (TO)";"TO";"DUERE";20;3;3;26
2007;"ESPERANTINA (TO)";"TO";"ESPERANTINA";13;10;2;25
2007;"FATIMA (TO)";"TO";"FATIMA";22;2;2;26
2007;"FIGUEIROPOLIS (TO)";"TO";"FIGUEIROPOLIS";45;3;2;50
2007;"FILADELFIA (TO)";"TO";"FILADELFIA";40;8;5;53
2007;"FORMOSO DO ARAGUAIA (TO)";"TO";"FORMOSO DO ARAGUAIA";124;8;15;147
2007;"FORTALEZA DO TABOCAO (TO)";"TO";"FORTALEZA DO TABOCAO";22;5;1;28
2007;"GOIANORTE (TO)";"TO";"GOIANORTE";15;1;3;19
2007;"GOIATINS (TO)";"TO";"GOIATINS";66;13;6;85
2007;"GUARAI (TO)";"TO";"GUARAI";287;9;16;312
2007;"GURUPI (TO)";"TO";"GURUPI";1185;24;144;1353
2007;"IPUEIRAS (TO)";"TO";"IPUEIRAS";2;0;2;4
2007;"ITACAJA (TO)";"TO";"ITACAJA";23;1;0;24
2007;"ITAGUATINS (TO)";"TO";"ITAGUATINS";34;4;2;40
2007;"ITAPIRATINS (TO)";"TO";"ITAPIRATINS";6;2;5;13
2007;"ITAPORA DO TOCANTINS (TO)";"TO";"ITAPORA DO TOCANTINS";10;3;2;15
2007;"JAU DO TOCANTINS (TO)";"TO";"JAU DO TOCANTINS";11;0;4;15
2007;"JUARINA (TO)";"TO";"JUARINA";8;1;1;10
2007;"LAGOA DA CONFUSAO (TO)";"TO";"LAGOA DA CONFUSAO";62;2;4;68
2007;"LAGOA DO TOCANTINS (TO)";"TO";"LAGOA DO TOCANTINS";5;1;2;8
2007;"LAJEADO (TO)";"TO";"LAJEADO";14;0;7;21
2007;"LAVANDEIRA (TO)";"TO";"LAVANDEIRA";3;1;1;5
2007;"LIZARDA (TO)";"TO";"LIZARDA";10;1;0;11
2007;"LUZINOPOLIS (TO)";"TO";"LUZINOPOLIS";5;2;0;7
2007;"MARIANOPOLIS DO TOCANTINS (TO)";"TO";"MARIANOPOLIS DO TOCANTINS";23;0;4;27
2007;"MATEIROS (TO)";"TO";"MATEIROS";12;0;2;14
2007;"MAURILANDIA DO TOCANTINS (TO)";"TO";"MAURILANDIA DO TOCANTINS";3;3;1;7
2007;"MIRACEMA DO TOCANTINS (TO)";"TO";"MIRACEMA DO TOCANTINS";139;10;30;179
2007;"MIRANORTE (TO)";"TO";"MIRANORTE";185;11;6;202
2007;"MONTE DO CARMO (TO)";"TO";"MONTE DO CARMO";7;1;2;10
2007;"MONTE SANTO DO TOCANTINS (TO)";"TO";"MONTE SANTO DO TOCANTINS";50;2;1;53
2007;"MURICILANDIA (TO)";"TO";"MURICILANDIA";14;2;1;17
2007;"NATIVIDADE (TO)";"TO";"NATIVIDADE";40;2;1;43
2007;"NAZARE (TO)";"TO";"NAZARE";14;4;1;19
2007;"NOVA OLINDA (TO)";"TO";"NOVA OLINDA";65;4;5;74
2007;"NOVA ROSALANDIA (TO)";"TO";"NOVA ROSALANDIA";16;0;3;19
2007;"NOVO ACORDO (TO)";"TO";"NOVO ACORDO";14;0;1;15
2007;"NOVO ALEGRE (TO)";"TO";"NOVO ALEGRE";5;2;1;8
2007;"NOVO JARDIM (TO)";"TO";"NOVO JARDIM";8;0;2;10
2007;"OLIVEIRA DE FATIMA (TO)";"TO";"OLIVEIRA DE FATIMA";5;0;2;7
2007;"PALMAS (TO)";"TO";"PALMAS";2698;243;482;3423
2007;"PALMEIRANTE (TO)";"TO";"PALMEIRANTE";5;4;1;10
2007;"PALMEIRAS DO TOCANTINS (TO)";"TO";"PALMEIRAS DO TOCANTINS";24;6;1;31
2007;"PALMEIROPOLIS (TO)";"TO";"PALMEIROPOLIS";59;2;10;71
2007;"PARAISO DO TOCANTINS (TO)";"TO";"PARAISO DO TOCANTINS";846;18;85;949
2007;"PARANA (TO)";"TO";"PARANA";13;2;1;16
2007;"PAU D ARCO (TO)";"TO";"PAU D ARCO";8;0;1;9
2007;"PEDRO AFONSO (TO)";"TO";"PEDRO AFONSO";81;1;8;90
2007;"PEIXE (TO)";"TO";"PEIXE";34;5;63;102
2007;"PEQUIZEIRO (TO)";"TO";"PEQUIZEIRO";16;0;4;20
2007;"PINDORAMA DO TOCANTINS (TO)";"TO";"PINDORAMA DO TOCANTINS";21;0;2;23
2007;"PIRAQUE (TO)";"TO";"PIRAQUE";4;0;5;9
2007;"PIUM (TO)";"TO";"PIUM";30;3;6;39
2007;"PONTE ALTA DO BOM JESUS (TO)";"TO";"PONTE ALTA DO BOM JESUS";8;0;0;8
2007;"PONTE ALTA DO TOCANTINS (TO)";"TO";"PONTE ALTA DO TOCANTINS";21;2;1;24
2007;"PORTO ALEGRE DO TOCANTINS (TO)";"TO";"PORTO ALEGRE DO TOCANTINS";7;0;1;8
2007;"PORTO NACIONAL (TO)";"TO";"PORTO NACIONAL";494;20;84;598
2007;"PRAIA NORTE (TO)";"TO";"PRAIA NORTE";6;5;1;12
2007;"PRESIDENTE KENNEDY (TO)";"TO";"PRESIDENTE KENNEDY";23;3;1;27
2007;"PUGMIL (TO)";"TO";"PUGMIL";7;1;1;9
2007;"RECURSOLANDIA (TO)";"TO";"RECURSOLANDIA";7;0;0;7
2007;"RIACHINHO (TO)";"TO";"RIACHINHO";68;2;10;80
2007;"RIO DA CONCEICAO (TO)";"TO";"RIO DA CONCEICAO";5;1;1;7
2007;"RIO DOS BOIS (TO)";"TO";"RIO DOS BOIS";4;1;3;8
2007;"RIO SONO (TO)";"TO";"RIO SONO";11;1;4;16
2007;"SAMPAIO (TO)";"TO";"SAMPAIO";94;3;2;99
2007;"SANDOLANDIA (TO)";"TO";"SANDOLANDIA";6;2;1;9
2007;"SANTA FE DO ARAGUAIA (TO)";"TO";"SANTA FE DO ARAGUAIA";83;32;12;127
2007;"SANTA MARIA DO TOCANTINS (TO)";"TO";"SANTA MARIA DO TOCANTINS";10;2;0;12
2007;"SANTA RITA DO TOCANTINS (TO)";"TO";"SANTA RITA DO TOCANTINS";6;3;1;10
2007;"SANTA ROSA DO TOCANTINS (TO)";"TO";"SANTA ROSA DO TOCANTINS";16;0;2;18
2007;"SANTA TEREZA DO TOCANTINS (TO)";"TO";"SANTA TEREZA DO TOCANTINS";8;1;0;9
2007;"SANTA TEREZINHA DO TOCANTINS (TO)";"TO";"SANTA TEREZINHA DO TOCANTINS";4;2;2;8
2007;"SAO BENTO DO TOCANTINS (TO)";"TO";"SAO BENTO DO TOCANTINS";9;5;8;22
2007;"SAO FELIX DO TOCANTINS (TO)";"TO";"SAO FELIX DO TOCANTINS";1;1;0;2
2007;"SAO MIGUEL DO TOCANTINS (TO)";"TO";"SAO MIGUEL DO TOCANTINS";80;28;30;138
2007;"SAO SALVADOR DO TOCANTINS (TO)";"TO";"SAO SALVADOR DO TOCANTINS";32;0;2;34
2007;"SAO SEBASTIAO DO TOCANTINS (TO)";"TO";"SAO SEBASTIAO DO TOCANTINS";4;2;1;7
2007;"SAO VALERIO DA NATIVIDADE (TO)";"TO";"SAO VALERIO DA NATIVIDADE";29;1;4;34
2007;"SILVANOPOLIS (TO)";"TO";"SILVANOPOLIS";19;0;0;19
2007;"SITIO NOVO DO TOCANTINS (TO)";"TO";"SITIO NOVO DO TOCANTINS";37;9;10;56
2007;"SUCUPIRA (TO)";"TO";"SUCUPIRA";7;0;5;12
2007;"TAGUATINGA (TO)";"TO";"TAGUATINGA";44;5;9;58
2007;"TAIPAS DO TOCANTINS (TO)";"TO";"TAIPAS DO TOCANTINS";4;0;0;4
2007;"TALISMA (TO)";"TO";"TALISMA";9;5;0;14
2007;"TOCANTINIA (TO)";"TO";"TOCANTINIA";19;0;2;21
2007;"TOCANTINOPOLIS (TO)";"TO";"TOCANTINOPOLIS";1673;284;233;2190
2007;"TUPIRAMA (TO)";"TO";"TUPIRAMA";7;2;1;10
2007;"TUPIRATINS (TO)";"TO";"TUPIRATINS";7;0;2;9
2007;"WANDERLANDIA (TO)";"TO";"WANDERLANDIA";35;4;5;44
2007;"XAMBIOA (TO)";"TO";"XAMBIOA";53;4;4;61
2007;"MUNICIPIO NAO INFORMADO (SP)";"SP";"MUNICIPIO NAO INFORMADO";0;0;0;0
