"ano";"chave";"UF";"MUNICIPIO";"CAMINHAO";"MICRO_ONIBUS";"ONIBUS";"total"
2008;"ACRELANDIA (AC)";"AC";"ACRELANDIA";97;1;16;114
2008;"ASSIS BRASIL (AC)";"AC";"ASSIS BRASIL";11;0;2;13
2008;"BRASILEIA (AC)";"AC";"BRASILEIA";127;0;7;134
2008;"BUJARI (AC)";"AC";"BUJARI";59;3;2;64
2008;"CAPIXABA (AC)";"AC";"CAPIXABA";42;1;5;48
2008;"CRUZEIRO DO SUL (AC)";"AC";"CRUZEIRO DO SUL";356;24;27;407
2008;"EPITACIOLANDIA (AC)";"AC";"EPITACIOLANDIA";95;1;8;104
2008;"FEIJO (AC)";"AC";"FEIJO";49;1;1;51
2008;"JORDAO (AC)";"AC";"JORDAO";0;0;0;0
2008;"MANCIO LIMA (AC)";"AC";"MANCIO LIMA";28;1;5;34
2008;"MANOEL URBANO (AC)";"AC";"MANOEL URBANO";9;0;0;9
2008;"MARECHAL THAUMATURGO (AC)";"AC";"MARECHAL THAUMATURGO";3;0;0;3
2008;"PLACIDO DE CASTRO (AC)";"AC";"PLACIDO DE CASTRO";81;1;3;85
2008;"PORTO ACRE (AC)";"AC";"PORTO ACRE";70;3;21;94
2008;"PORTO WALTER (AC)";"AC";"PORTO WALTER";0;0;0;0
2008;"RIO BRANCO (AC)";"AC";"RIO BRANCO";2941;103;375;3419
2008;"RODRIGUES ALVES (AC)";"AC";"RODRIGUES ALVES";4;0;0;4
2008;"SANTA ROSA (AC)";"AC";"SANTA ROSA";1;0;0;1
2008;"SENA MADUREIRA (AC)";"AC";"SENA MADUREIRA";65;2;2;69
2008;"SENADOR GUIOMARD (AC)";"AC";"SENADOR GUIOMARD";191;2;12;205
2008;"TARAUACA (AC)";"AC";"TARAUACA";73;0;2;75
2008;"XAPURI (AC)";"AC";"XAPURI";36;0;1;37
2008;"AGUA BRANCA (AL)";"AL";"AGUA BRANCA";32;26;2;60
2008;"ANADIA (AL)";"AL";"ANADIA";19;35;21;75
2008;"ARAPIRACA (AL)";"AL";"ARAPIRACA";2200;338;213;2751
2008;"ATALAIA (AL)";"AL";"ATALAIA";170;44;74;288
2008;"BARRA DE SANTO ANTONIO (AL)";"AL";"BARRA DE SANTO ANTONIO";21;9;8;38
2008;"BARRA DE SAO MIGUEL (AL)";"AL";"BARRA DE SAO MIGUEL";16;2;4;22
2008;"BATALHA (AL)";"AL";"BATALHA";59;11;1;71
2008;"BELEM (AL)";"AL";"BELEM";6;17;1;24
2008;"BELO MONTE (AL)";"AL";"BELO MONTE";19;2;0;21
2008;"BOCA DA MATA (AL)";"AL";"BOCA DA MATA";195;60;80;335
2008;"BRANQUINHA (AL)";"AL";"BRANQUINHA";8;20;5;33
2008;"CACIMBINHAS (AL)";"AL";"CACIMBINHAS";31;16;4;51
2008;"CAJUEIRO (AL)";"AL";"CAJUEIRO";88;12;36;136
2008;"CAMPESTRE (AL)";"AL";"CAMPESTRE";4;39;6;49
2008;"CAMPO ALEGRE (AL)";"AL";"CAMPO ALEGRE";114;103;101;318
2008;"CAMPO GRANDE (AL)";"AL";"CAMPO GRANDE";34;10;3;47
2008;"CANAPI (AL)";"AL";"CANAPI";21;16;9;46
2008;"CAPELA (AL)";"AL";"CAPELA";51;6;16;73
2008;"CARNEIROS (AL)";"AL";"CARNEIROS";22;1;0;23
2008;"CHA PRETA (AL)";"AL";"CHA PRETA";19;5;1;25
2008;"COITE DO NOIA (AL)";"AL";"COITE DO NOIA";20;4;12;36
2008;"COLONIA LEOPOLDINA (AL)";"AL";"COLONIA LEOPOLDINA";36;15;11;62
2008;"COQUEIRO SECO (AL)";"AL";"COQUEIRO SECO";5;2;2;9
2008;"CORURIPE (AL)";"AL";"CORURIPE";269;38;128;435
2008;"CRAIBAS (AL)";"AL";"CRAIBAS";58;18;12;88
2008;"DELMIRO GOUVEIA (AL)";"AL";"DELMIRO GOUVEIA";350;232;22;604
2008;"DOIS RIACHOS (AL)";"AL";"DOIS RIACHOS";39;7;2;48
2008;"ESTRELA DE ALAGOAS (AL)";"AL";"ESTRELA DE ALAGOAS";20;33;9;62
2008;"FEIRA GRANDE (AL)";"AL";"FEIRA GRANDE";21;0;15;36
2008;"FELIZ DESERTO (AL)";"AL";"FELIZ DESERTO";3;6;3;12
2008;"FLEXEIRAS (AL)";"AL";"FLEXEIRAS";20;12;24;56
2008;"GIRAU DO PONCIANO (AL)";"AL";"GIRAU DO PONCIANO";65;20;28;113
2008;"IBATEGUARA (AL)";"AL";"IBATEGUARA";27;59;6;92
2008;"IGACI (AL)";"AL";"IGACI";47;38;19;104
2008;"IGREJA NOVA (AL)";"AL";"IGREJA NOVA";55;16;51;122
2008;"INHAPI (AL)";"AL";"INHAPI";27;4;0;31
2008;"JACARE DOS HOMENS (AL)";"AL";"JACARE DOS HOMENS";24;2;4;30
2008;"JACUIPE (AL)";"AL";"JACUIPE";4;7;6;17
2008;"JAPARATINGA (AL)";"AL";"JAPARATINGA";10;12;3;25
2008;"JARAMATAIA (AL)";"AL";"JARAMATAIA";14;7;2;23
2008;"JEQUIA DA PRAIA (AL)";"AL";"JEQUIA DA PRAIA";11;7;13;31
2008;"JOAQUIM GOMES (AL)";"AL";"JOAQUIM GOMES";74;29;36;139
2008;"JUNDIA (AL)";"AL";"JUNDIA";8;4;8;20
2008;"JUNQUEIRO (AL)";"AL";"JUNQUEIRO";117;22;65;204
2008;"LAGOA DA CANOA (AL)";"AL";"LAGOA DA CANOA";41;9;14;64
2008;"LIMOEIRO DE ANADIA (AL)";"AL";"LIMOEIRO DE ANADIA";43;9;20;72
2008;"MACEIO (AL)";"AL";"MACEIO";4450;691;1297;6438
2008;"MAJOR ISIDORO (AL)";"AL";"MAJOR ISIDORO";44;16;6;66
2008;"MAR VERMELHO (AL)";"AL";"MAR VERMELHO";5;1;4;10
2008;"MARAGOGI (AL)";"AL";"MARAGOGI";24;64;16;104
2008;"MARAVILHA (AL)";"AL";"MARAVILHA";26;12;5;43
2008;"MARECHAL DEODORO (AL)";"AL";"MARECHAL DEODORO";164;67;53;284
2008;"MARIBONDO (AL)";"AL";"MARIBONDO";37;17;8;62
2008;"MATA GRANDE (AL)";"AL";"MATA GRANDE";40;17;2;59
2008;"MATRIZ DE CAMARAGIBE (AL)";"AL";"MATRIZ DE CAMARAGIBE";98;31;72;201
2008;"MESSIAS (AL)";"AL";"MESSIAS";47;30;55;132
2008;"MINADOR DO NEGRAO (AL)";"AL";"MINADOR DO NEGRAO";20;9;3;32
2008;"MONTEIROPOLIS (AL)";"AL";"MONTEIROPOLIS";6;2;2;10
2008;"MURICI (AL)";"AL";"MURICI";91;24;39;154
2008;"NOVO LINO (AL)";"AL";"NOVO LINO";43;19;21;83
2008;"OLHO D AGUA DAS FLORES (AL)";"AL";"OLHO D AGUA DAS FLORES";91;28;5;124
2008;"OLHO D AGUA DO CASADO (AL)";"AL";"OLHO D AGUA DO CASADO";14;10;5;29
2008;"OLHO D AGUA GRANDE (AL)";"AL";"OLHO D AGUA GRANDE";9;1;8;18
2008;"OLIVENCA (AL)";"AL";"OLIVENCA";12;6;4;22
2008;"OURO BRANCO (AL)";"AL";"OURO BRANCO";31;23;13;67
2008;"PALESTINA (AL)";"AL";"PALESTINA";5;5;1;11
2008;"PALMEIRA DOS INDIOS (AL)";"AL";"PALMEIRA DOS INDIOS";430;88;26;544
2008;"PAO DE ACUCAR (AL)";"AL";"PAO DE ACUCAR";44;13;3;60
2008;"PARICONHA (AL)";"AL";"PARICONHA";11;8;3;22
2008;"PARIPUEIRA (AL)";"AL";"PARIPUEIRA";35;2;8;45
2008;"PASSO DE CAMARAGIBE (AL)";"AL";"PASSO DE CAMARAGIBE";23;4;14;41
2008;"PAULO JACINTO (AL)";"AL";"PAULO JACINTO";9;5;4;18
2008;"PENEDO (AL)";"AL";"PENEDO";215;60;120;395
2008;"PIACABUCU (AL)";"AL";"PIACABUCU";18;22;8;48
2008;"PILAR (AL)";"AL";"PILAR";124;51;59;234
2008;"PINDOBA (AL)";"AL";"PINDOBA";10;1;1;12
2008;"PIRANHAS (AL)";"AL";"PIRANHAS";26;32;4;62
2008;"POCO DAS TRINCHEIRAS (AL)";"AL";"POCO DAS TRINCHEIRAS";31;16;12;59
2008;"PORTO CALVO (AL)";"AL";"PORTO CALVO";143;75;35;253
2008;"PORTO DE PEDRAS (AL)";"AL";"PORTO DE PEDRAS";6;9;3;18
2008;"PORTO REAL DO COLEGIO (AL)";"AL";"PORTO REAL DO COLEGIO";11;21;12;44
2008;"QUEBRANGULO (AL)";"AL";"QUEBRANGULO";13;4;2;19
2008;"RIO LARGO (AL)";"AL";"RIO LARGO";308;111;114;533
2008;"ROTEIRO (AL)";"AL";"ROTEIRO";13;13;5;31
2008;"SANTA LUZIA DO NORTE (AL)";"AL";"SANTA LUZIA DO NORTE";6;3;60;69
2008;"SANTANA DO IPANEMA (AL)";"AL";"SANTANA DO IPANEMA";265;59;18;342
2008;"SANTANA DO MUNDAU (AL)";"AL";"SANTANA DO MUNDAU";42;19;0;61
2008;"SAO BRAS (AL)";"AL";"SAO BRAS";1;1;2;4
2008;"SAO JOSE DA LAJE (AL)";"AL";"SAO JOSE DA LAJE";69;57;35;161
2008;"SAO JOSE DA TAPERA (AL)";"AL";"SAO JOSE DA TAPERA";57;8;7;72
2008;"SAO LUIS DO QUITUNDE (AL)";"AL";"SAO LUIS DO QUITUNDE";212;14;76;302
2008;"SAO MIGUEL DOS CAMPOS (AL)";"AL";"SAO MIGUEL DOS CAMPOS";421;126;142;689
2008;"SAO MIGUEL DOS MILAGRES (AL)";"AL";"SAO MIGUEL DOS MILAGRES";15;1;4;20
2008;"SAO SEBASTIAO (AL)";"AL";"SAO SEBASTIAO";93;27;63;183
2008;"SATUBA (AL)";"AL";"SATUBA";42;15;9;66
2008;"SENADOR RUI PALMEIRA (AL)";"AL";"SENADOR RUI PALMEIRA";21;4;5;30
2008;"TANQUE D ARCA (AL)";"AL";"TANQUE D ARCA";8;7;2;17
2008;"TAQUARANA (AL)";"AL";"TAQUARANA";36;18;15;69
2008;"TEOTONIO VILELA (AL)";"AL";"TEOTONIO VILELA";154;62;127;343
2008;"TRAIPU (AL)";"AL";"TRAIPU";40;7;5;52
2008;"UNIAO DOS PALMARES (AL)";"AL";"UNIAO DOS PALMARES";382;172;94;648
2008;"VICOSA (AL)";"AL";"VICOSA";106;10;25;141
2008;"ALVARAES (AM)";"AM";"ALVARAES";1;0;1;2
2008;"AMATURA (AM)";"AM";"AMATURA";1;0;0;1
2008;"ANAMA (AM)";"AM";"ANAMA";0;0;2;2
2008;"ANORI (AM)";"AM";"ANORI";1;0;1;2
2008;"APUI (AM)";"AM";"APUI";34;2;5;41
2008;"ATALAIA DO NORTE (AM)";"AM";"ATALAIA DO NORTE";1;0;1;2
2008;"AUTAZES (AM)";"AM";"AUTAZES";7;3;3;13
2008;"BARCELOS (AM)";"AM";"BARCELOS";4;1;0;5
2008;"BARREIRINHA (AM)";"AM";"BARREIRINHA";1;0;0;1
2008;"BENJAMIN CONSTANT (AM)";"AM";"BENJAMIN CONSTANT";9;2;1;12
2008;"BERURI (AM)";"AM";"BERURI";0;0;0;0
2008;"BOA VISTA DO RAMOS (AM)";"AM";"BOA VISTA DO RAMOS";1;0;0;1
2008;"BOCA DO ACRE (AM)";"AM";"BOCA DO ACRE";17;2;0;19
2008;"BORBA (AM)";"AM";"BORBA";2;0;0;2
2008;"CAAPIRANGA (AM)";"AM";"CAAPIRANGA";4;1;1;6
2008;"CANUTAMA (AM)";"AM";"CANUTAMA";0;0;0;0
2008;"CARAUARI (AM)";"AM";"CARAUARI";11;1;0;12
2008;"CAREIRO (AM)";"AM";"CAREIRO";30;11;29;70
2008;"CAREIRO DA VARZEA (AM)";"AM";"CAREIRO DA VARZEA";9;18;13;40
2008;"COARI (AM)";"AM";"COARI";70;3;2;75
2008;"CODAJAS (AM)";"AM";"CODAJAS";3;0;2;5
2008;"EIRUNEPE (AM)";"AM";"EIRUNEPE";15;0;0;15
2008;"ENVIRA (AM)";"AM";"ENVIRA";8;0;1;9
2008;"FONTE BOA (AM)";"AM";"FONTE BOA";12;0;0;12
2008;"GUAJARA (AM)";"AM";"GUAJARA";0;0;0;0
2008;"HUMAITA (AM)";"AM";"HUMAITA";83;1;7;91
2008;"IPIXUNA (AM)";"AM";"IPIXUNA";1;0;0;1
2008;"IRANDUBA (AM)";"AM";"IRANDUBA";108;8;33;149
2008;"ITACOATIARA (AM)";"AM";"ITACOATIARA";234;20;74;328
2008;"ITAMARATI (AM)";"AM";"ITAMARATI";2;0;0;2
2008;"ITAPIRANGA (AM)";"AM";"ITAPIRANGA";1;1;0;2
2008;"JAPURA (AM)";"AM";"JAPURA";3;0;0;3
2008;"JURUA (AM)";"AM";"JURUA";4;0;0;4
2008;"JUTAI (AM)";"AM";"JUTAI";2;0;0;2
2008;"LABREA (AM)";"AM";"LABREA";10;1;1;12
2008;"MANACAPURU (AM)";"AM";"MANACAPURU";182;21;49;252
2008;"MANAQUIRI (AM)";"AM";"MANAQUIRI";6;0;1;7
2008;"MANAUS (AM)";"AM";"MANAUS";12986;2042;5335;20363
2008;"MANICORE (AM)";"AM";"MANICORE";10;1;3;14
2008;"MARAA (AM)";"AM";"MARAA";0;0;0;0
2008;"MAUES (AM)";"AM";"MAUES";24;0;4;28
2008;"NHAMUNDA (AM)";"AM";"NHAMUNDA";4;0;0;4
2008;"NOVA OLINDA DO NORTE (AM)";"AM";"NOVA OLINDA DO NORTE";9;4;3;16
2008;"NOVO AIRAO (AM)";"AM";"NOVO AIRAO";11;2;12;25
2008;"NOVO ARIPUANA (AM)";"AM";"NOVO ARIPUANA";8;1;4;13
2008;"PARINTINS (AM)";"AM";"PARINTINS";99;2;8;109
2008;"PAUINI (AM)";"AM";"PAUINI";2;1;0;3
2008;"PRESIDENTE FIGUEIREDO (AM)";"AM";"PRESIDENTE FIGUEIREDO";157;24;37;218
2008;"RIO PRETO DA EVA (AM)";"AM";"RIO PRETO DA EVA";49;6;19;74
2008;"SANTA ISABEL DO RIO NEGRO (AM)";"AM";"SANTA ISABEL DO RIO NEGRO";5;2;3;10
2008;"SANTO ANTONIO DO ICA (AM)";"AM";"SANTO ANTONIO DO ICA";5;0;0;5
2008;"SAO GABRIEL DA CACHOEIRA (AM)";"AM";"SAO GABRIEL DA CACHOEIRA";54;7;12;73
2008;"SAO PAULO DE OLIVENCA (AM)";"AM";"SAO PAULO DE OLIVENCA";3;0;0;3
2008;"SAO SEBASTIAO DO UATUMA (AM)";"AM";"SAO SEBASTIAO DO UATUMA";3;0;0;3
2008;"SILVES (AM)";"AM";"SILVES";5;1;1;7
2008;"TABATINGA (AM)";"AM";"TABATINGA";34;2;0;36
2008;"TAPAUA (AM)";"AM";"TAPAUA";1;0;1;2
2008;"TEFE (AM)";"AM";"TEFE";33;6;4;43
2008;"TONANTINS (AM)";"AM";"TONANTINS";1;1;0;2
2008;"UARINI (AM)";"AM";"UARINI";1;0;0;1
2008;"URUCARA (AM)";"AM";"URUCARA";11;1;1;13
2008;"URUCURITUBA (AM)";"AM";"URUCURITUBA";2;0;0;2
2008;"AMAPA (AP)";"AP";"AMAPA";7;2;0;9
2008;"AMAPARI (AP)";"AP";"AMAPARI";10;0;1;11
2008;"CALCOENE (AP)";"AP";"CALCOENE";1;0;1;2
2008;"CUTIAS (AP)";"AP";"CUTIAS";1;1;0;2
2008;"FERREIRA GOMES (AP)";"AP";"FERREIRA GOMES";1;0;0;1
2008;"ITAUBAL (AP)";"AP";"ITAUBAL";1;0;2;3
2008;"LARANJAL DO JARI (AP)";"AP";"LARANJAL DO JARI";48;5;6;59
2008;"MACAPA (AP)";"AP";"MACAPA";2156;203;447;2806
2008;"MAZAGAO (AP)";"AP";"MAZAGAO";36;3;8;47
2008;"OIAPOQUE (AP)";"AP";"OIAPOQUE";35;4;2;41
2008;"PORTO GRANDE (AP)";"AP";"PORTO GRANDE";13;0;5;18
2008;"PRACUUBA (AP)";"AP";"PRACUUBA";2;0;0;2
2008;"SANTANA (AP)";"AP";"SANTANA";436;25;43;504
2008;"SERRA DO NAVIO (AP)";"AP";"SERRA DO NAVIO";0;3;1;4
2008;"TARTARUGALZINHO (AP)";"AP";"TARTARUGALZINHO";5;0;0;5
2008;"VITORIA DO JARI (AP)";"AP";"VITORIA DO JARI";4;0;1;5
2008;"ABAIRA (BA)";"BA";"ABAIRA";38;6;14;58
2008;"ABARE (BA)";"BA";"ABARE";33;4;10;47
2008;"ACAJUTIBA (BA)";"BA";"ACAJUTIBA";37;8;10;55
2008;"ADUSTINA (BA)";"BA";"ADUSTINA";6;6;1;13
2008;"AGUA FRIA (BA)";"BA";"AGUA FRIA";9;8;19;36
2008;"AIQUARA (BA)";"BA";"AIQUARA";5;3;2;10
2008;"ALAGOINHAS (BA)";"BA";"ALAGOINHAS";890;154;327;1371
2008;"ALCOBACA (BA)";"BA";"ALCOBACA";22;4;10;36
2008;"ALMADINA (BA)";"BA";"ALMADINA";14;1;3;18
2008;"AMARGOSA (BA)";"BA";"AMARGOSA";207;33;41;281
2008;"AMELIA RODRIGUES (BA)";"BA";"AMELIA RODRIGUES";124;45;21;190
2008;"AMERICA DOURADA (BA)";"BA";"AMERICA DOURADA";18;5;3;26
2008;"ANAGE (BA)";"BA";"ANAGE";42;29;26;97
2008;"ANDARAI (BA)";"BA";"ANDARAI";15;2;3;20
2008;"ANDORINHA (BA)";"BA";"ANDORINHA";52;7;25;84
2008;"ANGICAL (BA)";"BA";"ANGICAL";24;7;14;45
2008;"ANGUERA (BA)";"BA";"ANGUERA";13;5;5;23
2008;"ANTAS (BA)";"BA";"ANTAS";21;6;5;32
2008;"ANTONIO CARDOSO (BA)";"BA";"ANTONIO CARDOSO";1;15;6;22
2008;"ANTONIO GONCALVES (BA)";"BA";"ANTONIO GONCALVES";16;4;4;24
2008;"APORA (BA)";"BA";"APORA";24;14;16;54
2008;"APUAREMA (BA)";"BA";"APUAREMA";22;2;7;31
2008;"ARACAS (BA)";"BA";"ARACAS";51;17;19;87
2008;"ARACATU (BA)";"BA";"ARACATU";50;11;13;74
2008;"ARACI (BA)";"BA";"ARACI";138;7;39;184
2008;"ARAMARI (BA)";"BA";"ARAMARI";19;3;5;27
2008;"ARATACA (BA)";"BA";"ARATACA";16;0;2;18
2008;"ARATUIPE (BA)";"BA";"ARATUIPE";21;1;9;31
2008;"AURELINO LEAL (BA)";"BA";"AURELINO LEAL";37;3;11;51
2008;"BAIANOPOLIS (BA)";"BA";"BAIANOPOLIS";39;4;16;59
2008;"BAIXA GRANDE (BA)";"BA";"BAIXA GRANDE";53;23;28;104
2008;"BANZAE (BA)";"BA";"BANZAE";15;1;16;32
2008;"BARRA (BA)";"BA";"BARRA";33;6;16;55
2008;"BARRA DA ESTIVA (BA)";"BA";"BARRA DA ESTIVA";135;20;36;191
2008;"BARRA DO CHOCA (BA)";"BA";"BARRA DO CHOCA";82;89;19;190
2008;"BARRA DO MENDES (BA)";"BA";"BARRA DO MENDES";49;10;4;63
2008;"BARRA DO ROCHA (BA)";"BA";"BARRA DO ROCHA";4;3;0;7
2008;"BARREIRAS (BA)";"BA";"BARREIRAS";1885;85;242;2212
2008;"BARRO ALTO (BA)";"BA";"BARRO ALTO";31;8;7;46
2008;"BARRO PRETO (BA)";"BA";"BARRO PRETO";10;1;7;18
2008;"BARROCAS (BA)";"BA";"BARROCAS";52;1;12;65
2008;"BELMONTE (BA)";"BA";"BELMONTE";36;1;6;43
2008;"BELO CAMPO (BA)";"BA";"BELO CAMPO";59;6;15;80
2008;"BIRITINGA (BA)";"BA";"BIRITINGA";17;10;22;49
2008;"BOA NOVA (BA)";"BA";"BOA NOVA";18;8;14;40
2008;"BOA VISTA DO TUPIM (BA)";"BA";"BOA VISTA DO TUPIM";41;6;7;54
2008;"BOM JESUS DA LAPA (BA)";"BA";"BOM JESUS DA LAPA";354;32;71;457
2008;"BOM JESUS DA SERRA (BA)";"BA";"BOM JESUS DA SERRA";12;19;10;41
2008;"BONINAL (BA)";"BA";"BONINAL";50;8;16;74
2008;"BONITO (BA)";"BA";"BONITO";39;4;5;48
2008;"BOQUIRA (BA)";"BA";"BOQUIRA";79;6;37;122
2008;"BOTUPORA (BA)";"BA";"BOTUPORA";24;3;20;47
2008;"BREJOES (BA)";"BA";"BREJOES";60;2;20;82
2008;"BREJOLANDIA (BA)";"BA";"BREJOLANDIA";21;4;12;37
2008;"BROTAS DE MACAUBAS (BA)";"BA";"BROTAS DE MACAUBAS";18;8;7;33
2008;"BRUMADO (BA)";"BA";"BRUMADO";882;127;179;1188
2008;"BUERAREMA (BA)";"BA";"BUERAREMA";98;5;19;122
2008;"BURITIRAMA (BA)";"BA";"BURITIRAMA";11;2;11;24
2008;"CAATIBA (BA)";"BA";"CAATIBA";9;3;0;12
2008;"CABACEIRAS DO PARAGUACU (BA)";"BA";"CABACEIRAS DO PARAGUACU";35;12;23;70
2008;"CACHOEIRA (BA)";"BA";"CACHOEIRA";74;75;58;207
2008;"CACULE (BA)";"BA";"CACULE";223;15;31;269
2008;"CAEM (BA)";"BA";"CAEM";14;4;10;28
2008;"CAETANOS (BA)";"BA";"CAETANOS";25;6;7;38
2008;"CAETITE (BA)";"BA";"CAETITE";367;44;57;468
2008;"CAFARNAUM (BA)";"BA";"CAFARNAUM";34;3;9;46
2008;"CAIRU (BA)";"BA";"CAIRU";7;3;2;12
2008;"CALDEIRAO GRANDE (BA)";"BA";"CALDEIRAO GRANDE";19;0;7;26
2008;"CAMACAN (BA)";"BA";"CAMACAN";180;20;33;233
2008;"CAMACARI (BA)";"BA";"CAMACARI";1488;286;913;2687
2008;"CAMAMU (BA)";"BA";"CAMAMU";94;31;18;143
2008;"CAMPO ALEGRE DE LOURDES (BA)";"BA";"CAMPO ALEGRE DE LOURDES";39;5;3;47
2008;"CAMPO FORMOSO (BA)";"BA";"CAMPO FORMOSO";155;17;56;228
2008;"CANAPOLIS (BA)";"BA";"CANAPOLIS";8;12;12;32
2008;"CANARANA (BA)";"BA";"CANARANA";93;4;5;102
2008;"CANAVIEIRAS (BA)";"BA";"CANAVIEIRAS";62;8;12;82
2008;"CANDEAL (BA)";"BA";"CANDEAL";16;14;2;32
2008;"CANDEIAS (BA)";"BA";"CANDEIAS";640;201;221;1062
2008;"CANDIBA (BA)";"BA";"CANDIBA";41;0;13;54
2008;"CANDIDO SALES (BA)";"BA";"CANDIDO SALES";269;17;30;316
2008;"CANSANCAO (BA)";"BA";"CANSANCAO";96;18;25;139
2008;"CANUDOS (BA)";"BA";"CANUDOS";30;2;25;57
2008;"CAPELA DO ALTO ALEGRE (BA)";"BA";"CAPELA DO ALTO ALEGRE";34;13;17;64
2008;"CAPIM GROSSO (BA)";"BA";"CAPIM GROSSO";385;21;37;443
2008;"CARAIBAS (BA)";"BA";"CARAIBAS";25;11;11;47
2008;"CARAVELAS (BA)";"BA";"CARAVELAS";23;5;29;57
2008;"CARDEAL DA SILVA (BA)";"BA";"CARDEAL DA SILVA";15;6;3;24
2008;"CARINHANHA (BA)";"BA";"CARINHANHA";103;10;25;138
2008;"CASA NOVA (BA)";"BA";"CASA NOVA";242;126;115;483
2008;"CASTRO ALVES (BA)";"BA";"CASTRO ALVES";117;13;44;174
2008;"CATOLANDIA (BA)";"BA";"CATOLANDIA";4;3;3;10
2008;"CATU (BA)";"BA";"CATU";301;83;75;459
2008;"CATURAMA (BA)";"BA";"CATURAMA";18;3;9;30
2008;"CENTRAL (BA)";"BA";"CENTRAL";65;9;6;80
2008;"CHORROCHO (BA)";"BA";"CHORROCHO";11;2;4;17
2008;"CICERO DANTAS (BA)";"BA";"CICERO DANTAS";73;12;22;107
2008;"CIPO (BA)";"BA";"CIPO";38;3;4;45
2008;"COARACI (BA)";"BA";"COARACI";70;2;14;86
2008;"COCOS (BA)";"BA";"COCOS";46;3;23;72
2008;"CONCEICAO DA FEIRA (BA)";"BA";"CONCEICAO DA FEIRA";191;82;13;286
2008;"CONCEICAO DO ALMEIDA (BA)";"BA";"CONCEICAO DO ALMEIDA";83;28;14;125
2008;"CONCEICAO DO COITE (BA)";"BA";"CONCEICAO DO COITE";336;53;69;458
2008;"CONCEICAO DO JACUIPE (BA)";"BA";"CONCEICAO DO JACUIPE";173;105;12;290
2008;"CONDE (BA)";"BA";"CONDE";38;9;9;56
2008;"CONDEUBA (BA)";"BA";"CONDEUBA";83;23;37;143
2008;"CONTENDAS DO SINCORA (BA)";"BA";"CONTENDAS DO SINCORA";11;7;3;21
2008;"CORACAO DE MARIA (BA)";"BA";"CORACAO DE MARIA";84;12;30;126
2008;"CORDEIROS (BA)";"BA";"CORDEIROS";24;6;12;42
2008;"CORIBE (BA)";"BA";"CORIBE";33;12;11;56
2008;"CORONEL JOAO SA (BA)";"BA";"CORONEL JOAO SA";14;0;23;37
2008;"CORRENTINA (BA)";"BA";"CORRENTINA";104;17;52;173
2008;"COTEGIPE (BA)";"BA";"COTEGIPE";25;7;8;40
2008;"CRAVOLANDIA (BA)";"BA";"CRAVOLANDIA";15;1;3;19
2008;"CRISOPOLIS (BA)";"BA";"CRISOPOLIS";44;13;18;75
2008;"CRISTOPOLIS (BA)";"BA";"CRISTOPOLIS";48;8;15;71
2008;"CRUZ DAS ALMAS (BA)";"BA";"CRUZ DAS ALMAS";767;157;50;974
2008;"CURACA (BA)";"BA";"CURACA";45;25;21;91
2008;"DARIO MEIRA (BA)";"BA";"DARIO MEIRA";8;9;5;22
2008;"DIAS D AVILA (BA)";"BA";"DIAS D AVILA";526;52;334;912
2008;"DOM BASILIO (BA)";"BA";"DOM BASILIO";203;6;14;223
2008;"DOM MACEDO COSTA (BA)";"BA";"DOM MACEDO COSTA";11;8;4;23
2008;"ELISIO MEDRADO (BA)";"BA";"ELISIO MEDRADO";20;8;10;38
2008;"ENCRUZILHADA (BA)";"BA";"ENCRUZILHADA";61;20;13;94
2008;"ENTRE RIOS (BA)";"BA";"ENTRE RIOS";162;64;63;289
2008;"ERICO CARDOSO (BA)";"BA";"ERICO CARDOSO";20;2;11;33
2008;"ESPLANADA (BA)";"BA";"ESPLANADA";103;29;50;182
2008;"EUCLIDES DA CUNHA (BA)";"BA";"EUCLIDES DA CUNHA";200;18;93;311
2008;"EUNAPOLIS (BA)";"BA";"EUNAPOLIS";986;71;227;1284
2008;"FATIMA (BA)";"BA";"FATIMA";10;4;12;26
2008;"FEIRA DA MATA (BA)";"BA";"FEIRA DA MATA";14;5;4;23
2008;"FEIRA DE SANTANA (BA)";"BA";"FEIRA DE SANTANA";6326;743;968;8037
2008;"FILADELFIA (BA)";"BA";"FILADELFIA";65;8;17;90
2008;"FIRMINO ALVES (BA)";"BA";"FIRMINO ALVES";10;0;1;11
2008;"FLORESTA AZUL (BA)";"BA";"FLORESTA AZUL";29;1;1;31
2008;"FORMOSA DO RIO PRETO (BA)";"BA";"FORMOSA DO RIO PRETO";72;2;12;86
2008;"GANDU (BA)";"BA";"GANDU";216;14;15;245
2008;"GAVIAO (BA)";"BA";"GAVIAO";10;5;4;19
2008;"GENTIO DO OURO (BA)";"BA";"GENTIO DO OURO";8;1;1;10
2008;"GLORIA (BA)";"BA";"GLORIA";38;17;30;85
2008;"GONGOGI (BA)";"BA";"GONGOGI";5;1;1;7
2008;"GOVERNADOR MANGABEIRA (BA)";"BA";"GOVERNADOR MANGABEIRA";131;23;26;180
2008;"GUAJERU (BA)";"BA";"GUAJERU";9;20;7;36
2008;"GUANAMBI (BA)";"BA";"GUANAMBI";930;54;115;1099
2008;"GUARATINGA (BA)";"BA";"GUARATINGA";54;5;19;78
2008;"HELIOPOLIS (BA)";"BA";"HELIOPOLIS";16;4;3;23
2008;"IACU (BA)";"BA";"IACU";98;14;18;130
2008;"IBIASSUCE (BA)";"BA";"IBIASSUCE";43;11;5;59
2008;"IBICARAI (BA)";"BA";"IBICARAI";99;8;17;124
2008;"IBICOARA (BA)";"BA";"IBICOARA";144;15;44;203
2008;"IBICUI (BA)";"BA";"IBICUI";34;8;8;50
2008;"IBIPEBA (BA)";"BA";"IBIPEBA";26;7;3;36
2008;"IBIPITANGA (BA)";"BA";"IBIPITANGA";52;11;20;83
2008;"IBIQUERA (BA)";"BA";"IBIQUERA";4;4;0;8
2008;"IBIRAPITANGA (BA)";"BA";"IBIRAPITANGA";35;1;5;41
2008;"IBIRAPUA (BA)";"BA";"IBIRAPUA";28;4;4;36
2008;"IBIRATAIA (BA)";"BA";"IBIRATAIA";71;22;6;99
2008;"IBITIARA (BA)";"BA";"IBITIARA";67;17;24;108
2008;"IBITITA (BA)";"BA";"IBITITA";34;1;8;43
2008;"IBOTIRAMA (BA)";"BA";"IBOTIRAMA";153;31;18;202
2008;"ICHU (BA)";"BA";"ICHU";14;5;7;26
2008;"IGAPORA (BA)";"BA";"IGAPORA";77;14;9;100
2008;"IGRAPIUNA (BA)";"BA";"IGRAPIUNA";31;19;14;64
2008;"IGUAI (BA)";"BA";"IGUAI";48;19;24;91
2008;"ILHEUS (BA)";"BA";"ILHEUS";492;111;280;883
2008;"INHAMBUPE (BA)";"BA";"INHAMBUPE";117;71;65;253
2008;"IPECAETA (BA)";"BA";"IPECAETA";4;4;31;39
2008;"IPIAU (BA)";"BA";"IPIAU";307;18;20;345
2008;"IPIRA (BA)";"BA";"IPIRA";305;27;64;396
2008;"IPUPIARA (BA)";"BA";"IPUPIARA";28;13;1;42
2008;"IRAJUBA (BA)";"BA";"IRAJUBA";17;4;16;37
2008;"IRAMAIA (BA)";"BA";"IRAMAIA";19;3;7;29
2008;"IRAQUARA (BA)";"BA";"IRAQUARA";85;14;13;112
2008;"IRARA (BA)";"BA";"IRARA";113;30;43;186
2008;"IRECE (BA)";"BA";"IRECE";575;31;40;646
2008;"ITABELA (BA)";"BA";"ITABELA";202;16;43;261
2008;"ITABERABA (BA)";"BA";"ITABERABA";372;39;41;452
2008;"ITABUNA (BA)";"BA";"ITABUNA";1433;50;558;2041
2008;"ITACARE (BA)";"BA";"ITACARE";16;17;3;36
2008;"ITAETE (BA)";"BA";"ITAETE";52;6;12;70
2008;"ITAGI (BA)";"BA";"ITAGI";28;2;2;32
2008;"ITAGIBA (BA)";"BA";"ITAGIBA";20;16;9;45
2008;"ITAGIMIRIM (BA)";"BA";"ITAGIMIRIM";42;1;2;45
2008;"ITAGUACU DA BAHIA (BA)";"BA";"ITAGUACU DA BAHIA";17;0;6;23
2008;"ITAJU DO COLONIA (BA)";"BA";"ITAJU DO COLONIA";8;0;4;12
2008;"ITAJUIPE (BA)";"BA";"ITAJUIPE";56;4;13;73
2008;"ITAMARAJU (BA)";"BA";"ITAMARAJU";355;11;109;475
2008;"ITAMARI (BA)";"BA";"ITAMARI";26;0;1;27
2008;"ITAMBE (BA)";"BA";"ITAMBE";52;14;6;72
2008;"ITANAGRA (BA)";"BA";"ITANAGRA";14;1;1;16
2008;"ITANHEM (BA)";"BA";"ITANHEM";35;7;10;52
2008;"ITAPARICA (BA)";"BA";"ITAPARICA";21;30;24;75
2008;"ITAPE (BA)";"BA";"ITAPE";15;0;0;15
2008;"ITAPEBI (BA)";"BA";"ITAPEBI";45;1;8;54
2008;"ITAPETINGA (BA)";"BA";"ITAPETINGA";419;39;75;533
2008;"ITAPICURU (BA)";"BA";"ITAPICURU";21;13;28;62
2008;"ITAPITANGA (BA)";"BA";"ITAPITANGA";11;3;3;17
2008;"ITAQUARA (BA)";"BA";"ITAQUARA";27;2;1;30
2008;"ITARANTIM (BA)";"BA";"ITARANTIM";58;2;3;63
2008;"ITATIM (BA)";"BA";"ITATIM";102;16;19;137
2008;"ITIRUCU (BA)";"BA";"ITIRUCU";99;5;9;113
2008;"ITIUBA (BA)";"BA";"ITIUBA";56;22;43;121
2008;"ITORORO (BA)";"BA";"ITORORO";74;13;15;102
2008;"ITUACU (BA)";"BA";"ITUACU";100;6;10;116
2008;"ITUBERA (BA)";"BA";"ITUBERA";110;11;16;137
2008;"IUIU (BA)";"BA";"IUIU";28;3;2;33
2008;"JABORANDI (BA)";"BA";"JABORANDI";43;1;15;59
2008;"JACARACI (BA)";"BA";"JACARACI";30;8;17;55
2008;"JACOBINA (BA)";"BA";"JACOBINA";588;65;126;779
2008;"JAGUAQUARA (BA)";"BA";"JAGUAQUARA";436;8;40;484
2008;"JAGUARARI (BA)";"BA";"JAGUARARI";126;36;48;210
2008;"JAGUARIPE (BA)";"BA";"JAGUARIPE";29;7;12;48
2008;"JANDAIRA (BA)";"BA";"JANDAIRA";13;0;7;20
2008;"JEQUIE (BA)";"BA";"JEQUIE";1234;56;257;1547
2008;"JEREMOABO (BA)";"BA";"JEREMOABO";73;14;25;112
2008;"JIQUIRICA (BA)";"BA";"JIQUIRICA";29;17;14;60
2008;"JITAUNA (BA)";"BA";"JITAUNA";23;7;4;34
2008;"JOAO DOURADO (BA)";"BA";"JOAO DOURADO";65;9;9;83
2008;"JUAZEIRO (BA)";"BA";"JUAZEIRO";2423;505;648;3576
2008;"JUCURUCU (BA)";"BA";"JUCURUCU";11;0;2;13
2008;"JUSSARA (BA)";"BA";"JUSSARA";39;10;15;64
2008;"JUSSARI (BA)";"BA";"JUSSARI";11;1;3;15
2008;"JUSSIAPE (BA)";"BA";"JUSSIAPE";46;7;7;60
2008;"LAFAIETE COUTINHO (BA)";"BA";"LAFAIETE COUTINHO";10;1;2;13
2008;"LAGEDO DO TABOCAL (BA)";"BA";"LAGEDO DO TABOCAL";22;1;5;28
2008;"LAGOA REAL (BA)";"BA";"LAGOA REAL";25;2;11;38
2008;"LAJE (BA)";"BA";"LAJE";96;30;20;146
2008;"LAJEDAO (BA)";"BA";"LAJEDAO";4;1;4;9
2008;"LAJEDINHO (BA)";"BA";"LAJEDINHO";8;4;3;15
2008;"LAMARAO (BA)";"BA";"LAMARAO";2;0;2;4
2008;"LAPAO (BA)";"BA";"LAPAO";87;5;22;114
2008;"LAURO DE FREITAS (BA)";"BA";"LAURO DE FREITAS";1608;339;353;2300
2008;"LENCOIS (BA)";"BA";"LENCOIS";10;9;1;20
2008;"LICINIO DE ALMEIDA (BA)";"BA";"LICINIO DE ALMEIDA";85;8;10;103
2008;"LIVRAMENTO DO BRUMADO (BA)";"BA";"LIVRAMENTO DO BRUMADO";268;35;56;359
2008;"LUIZ EDUARDO MAGALHAES (BA)";"BA";"LUIZ EDUARDO MAGALHAES";900;34;64;998
2008;"MACAJUBA (BA)";"BA";"MACAJUBA";16;12;23;51
2008;"MACAUBAS (BA)";"BA";"MACAUBAS";147;11;221;379
2008;"MACURURE (BA)";"BA";"MACURURE";8;3;4;15
2008;"MADRE DE DEUS (BA)";"BA";"MADRE DE DEUS";54;25;28;107
2008;"MAETINGA (BA)";"BA";"MAETINGA";21;7;9;37
2008;"MAIQUINIQUE (BA)";"BA";"MAIQUINIQUE";34;2;8;44
2008;"MAIRI (BA)";"BA";"MAIRI";50;15;26;91
2008;"MALHADA (BA)";"BA";"MALHADA";23;3;5;31
2008;"MALHADA DAS PEDRAS (BA)";"BA";"MALHADA DAS PEDRAS";53;20;17;90
2008;"MANOEL VITORINO (BA)";"BA";"MANOEL VITORINO";38;7;7;52
2008;"MANSIDAO (BA)";"BA";"MANSIDAO";4;0;3;7
2008;"MARACANI (BA)";"BA";"MARACANI";75;5;14;94
2008;"MARACAS (BA)";"BA";"MARACAS";137;9;35;181
2008;"MARAGOGIPE (BA)";"BA";"MARAGOGIPE";96;14;18;128
2008;"MARAU (BA)";"BA";"MARAU";5;1;0;6
2008;"MARCIONILIO SOUZA (BA)";"BA";"MARCIONILIO SOUZA";12;6;10;28
2008;"MASCOTE (BA)";"BA";"MASCOTE";36;3;6;45
2008;"MATA DE SAO JOAO (BA)";"BA";"MATA DE SAO JOAO";175;54;40;269
2008;"MATINA (BA)";"BA";"MATINA";12;2;13;27
2008;"MEDEIROS NETO (BA)";"BA";"MEDEIROS NETO";75;10;14;99
2008;"MIGUEL CALMON (BA)";"BA";"MIGUEL CALMON";85;7;24;116
2008;"MILAGRES (BA)";"BA";"MILAGRES";109;5;11;125
2008;"MIRANGABA (BA)";"BA";"MIRANGABA";34;11;16;61
2008;"MIRANTE (BA)";"BA";"MIRANTE";24;10;12;46
2008;"MONTE SANTO (BA)";"BA";"MONTE SANTO";101;14;73;188
2008;"MORPARA (BA)";"BA";"MORPARA";5;6;1;12
2008;"MORRO DO CHAPEU (BA)";"BA";"MORRO DO CHAPEU";96;22;9;127
2008;"MORTUGABA (BA)";"BA";"MORTUGABA";52;6;10;68
2008;"MUCUGE (BA)";"BA";"MUCUGE";72;10;26;108
2008;"MUCURI (BA)";"BA";"MUCURI";70;25;32;127
2008;"MULUNGU DO MORRO (BA)";"BA";"MULUNGU DO MORRO";26;1;1;28
2008;"MUNDO NOVO (BA)";"BA";"MUNDO NOVO";42;8;20;70
2008;"MUNIZ FERREIRA (BA)";"BA";"MUNIZ FERREIRA";33;57;5;95
2008;"MUQUEM DO SAO FRANCISCO (BA)";"BA";"MUQUEM DO SAO FRANCISCO";10;12;12;34
2008;"MURITIBA (BA)";"BA";"MURITIBA";219;30;22;271
2008;"MUTUIPE (BA)";"BA";"MUTUIPE";100;44;27;171
2008;"NAZARE (BA)";"BA";"NAZARE";180;41;23;244
2008;"NILO PECANHA (BA)";"BA";"NILO PECANHA";32;19;8;59
2008;"NORDESTINA (BA)";"BA";"NORDESTINA";18;6;13;37
2008;"NOVA CANAA (BA)";"BA";"NOVA CANAA";43;4;7;54
2008;"NOVA FATIMA (BA)";"BA";"NOVA FATIMA";38;2;3;43
2008;"NOVA IBIA (BA)";"BA";"NOVA IBIA";16;1;4;21
2008;"NOVA ITARANA (BA)";"BA";"NOVA ITARANA";16;5;5;26
2008;"NOVA REDENCAO (BA)";"BA";"NOVA REDENCAO";13;3;3;19
2008;"NOVA SOURE (BA)";"BA";"NOVA SOURE";37;7;11;55
2008;"NOVA VICOSA (BA)";"BA";"NOVA VICOSA";87;14;31;132
2008;"NOVO HORIZONTE (BA)";"BA";"NOVO HORIZONTE";27;3;6;36
2008;"NOVO TRIUNFO (BA)";"BA";"NOVO TRIUNFO";5;1;1;7
2008;"OLINDINA (BA)";"BA";"OLINDINA";78;18;35;131
2008;"OLIVEIRA DOS BREJINHOS (BA)";"BA";"OLIVEIRA DOS BREJINHOS";57;22;19;98
2008;"OURICANGAS (BA)";"BA";"OURICANGAS";26;9;16;51
2008;"OUROLANDIA (BA)";"BA";"OUROLANDIA";36;13;4;53
2008;"PALMAS DE MONTE ALTO (BA)";"BA";"PALMAS DE MONTE ALTO";43;4;17;64
2008;"PALMEIRAS (BA)";"BA";"PALMEIRAS";26;10;2;38
2008;"PARAMIRIM (BA)";"BA";"PARAMIRIM";118;3;45;166
2008;"PARATINGA (BA)";"BA";"PARATINGA";30;13;36;79
2008;"PARIPIRANGA (BA)";"BA";"PARIPIRANGA";64;3;28;95
2008;"PAU BRASIL (BA)";"BA";"PAU BRASIL";28;5;22;55
2008;"PAULO AFONSO (BA)";"BA";"PAULO AFONSO";721;234;213;1168
2008;"PE DE SERRA (BA)";"BA";"PE DE SERRA";23;2;8;33
2008;"PEDRAO (BA)";"BA";"PEDRAO";10;4;4;18
2008;"PEDRO ALEXANDRE (BA)";"BA";"PEDRO ALEXANDRE";1;3;3;7
2008;"PIATA (BA)";"BA";"PIATA";76;19;21;116
2008;"PILAO ARCADO (BA)";"BA";"PILAO ARCADO";26;14;0;40
2008;"PINDAI (BA)";"BA";"PINDAI";36;6;18;60
2008;"PINDOBACU (BA)";"BA";"PINDOBACU";32;13;20;65
2008;"PINTADAS (BA)";"BA";"PINTADAS";33;16;27;76
2008;"PIRAI DO NORTE (BA)";"BA";"PIRAI DO NORTE";10;2;0;12
2008;"PIRIPA (BA)";"BA";"PIRIPA";45;16;13;74
2008;"PIRITIBA (BA)";"BA";"PIRITIBA";42;13;14;69
2008;"PLANALTINO (BA)";"BA";"PLANALTINO";11;0;5;16
2008;"PLANALTO (BA)";"BA";"PLANALTO";100;10;35;145
2008;"POCOES (BA)";"BA";"POCOES";256;110;63;429
2008;"POJUCA (BA)";"BA";"POJUCA";290;51;67;408
2008;"PONTO NOVO (BA)";"BA";"PONTO NOVO";49;4;15;68
2008;"PORTO SEGURO (BA)";"BA";"PORTO SEGURO";506;147;452;1105
2008;"POTIRIGUA (BA)";"BA";"POTIRIGUA";27;3;3;33
2008;"PRADO (BA)";"BA";"PRADO";43;10;20;73
2008;"PRESIDENTE DUTRA (BA)";"BA";"PRESIDENTE DUTRA";38;4;3;45
2008;"PRESIDENTE JANIO QUADROS (BA)";"BA";"PRESIDENTE JANIO QUADROS";16;11;6;33
2008;"PRESIDENTE TANCREDO NEVES (BA)";"BA";"PRESIDENTE TANCREDO NEVES";76;40;9;125
2008;"QUEIMADAS (BA)";"BA";"QUEIMADAS";73;8;54;135
2008;"QUIJINGUE (BA)";"BA";"QUIJINGUE";35;10;32;77
2008;"QUIXABEIRA (BA)";"BA";"QUIXABEIRA";26;4;9;39
2008;"RAFAEL JAMBEIRO (BA)";"BA";"RAFAEL JAMBEIRO";38;12;35;85
2008;"REMANSO (BA)";"BA";"REMANSO";164;29;18;211
2008;"RETIROLANDIA (BA)";"BA";"RETIROLANDIA";34;3;7;44
2008;"RIACHAO DAS NEVES (BA)";"BA";"RIACHAO DAS NEVES";28;15;14;57
2008;"RIACHAO DO JACUIPE (BA)";"BA";"RIACHAO DO JACUIPE";177;19;26;222
2008;"RIACHO DE SANTANA (BA)";"BA";"RIACHO DE SANTANA";170;18;43;231
2008;"RIBEIRA DO AMPARO (BA)";"BA";"RIBEIRA DO AMPARO";6;6;19;31
2008;"RIBEIRA DO POMBAL (BA)";"BA";"RIBEIRA DO POMBAL";194;43;89;326
2008;"RIBEIRAO DO LARGO (BA)";"BA";"RIBEIRAO DO LARGO";16;13;5;34
2008;"RIO DE CONTAS (BA)";"BA";"RIO DE CONTAS";51;18;11;80
2008;"RIO DO ANTONIO (BA)";"BA";"RIO DO ANTONIO";65;17;5;87
2008;"RIO DO PIRES (BA)";"BA";"RIO DO PIRES";31;7;13;51
2008;"RIO REAL (BA)";"BA";"RIO REAL";129;9;35;173
2008;"RODELAS (BA)";"BA";"RODELAS";17;4;1;22
2008;"RUY BARBOSA (BA)";"BA";"RUY BARBOSA";85;20;12;117
2008;"SALINAS DA MARGARIDA (BA)";"BA";"SALINAS DA MARGARIDA";18;2;3;23
2008;"SALVADOR (BA)";"BA";"SALVADOR";12680;2953;6468;22101
2008;"SANTA BARBARA (BA)";"BA";"SANTA BARBARA";31;4;20;55
2008;"SANTA BRIGIDA (BA)";"BA";"SANTA BRIGIDA";13;10;11;34
2008;"SANTA CRUZ CABRALIA (BA)";"BA";"SANTA CRUZ CABRALIA";52;16;13;81
2008;"SANTA CRUZ DA VITORIA (BA)";"BA";"SANTA CRUZ DA VITORIA";9;4;1;14
2008;"SANTA INES (BA)";"BA";"SANTA INES";42;4;3;49
2008;"SANTA LUZIA (BA)";"BA";"SANTA LUZIA";26;2;4;32
2008;"SANTA MARIA DA VITORIA (BA)";"BA";"SANTA MARIA DA VITORIA";269;23;35;327
2008;"SANTA RITA DE CASSIA (BA)";"BA";"SANTA RITA DE CASSIA";43;4;6;53
2008;"SANTA TERESINHA (BA)";"BA";"SANTA TERESINHA";21;4;13;38
2008;"SANTALUZ (BA)";"BA";"SANTALUZ";151;13;27;191
2008;"SANTANA (BA)";"BA";"SANTANA";119;13;39;171
2008;"SANTANOPOLIS (BA)";"BA";"SANTANOPOLIS";15;6;6;27
2008;"SANTO AMARO (BA)";"BA";"SANTO AMARO";167;75;282;524
2008;"SANTO ANTONIO DE JESUS (BA)";"BA";"SANTO ANTONIO DE JESUS";1744;129;123;1996
2008;"SANTO ESTEVAO (BA)";"BA";"SANTO ESTEVAO";179;62;28;269
2008;"SAO DESIDERIO (BA)";"BA";"SAO DESIDERIO";163;8;33;204
2008;"SAO DOMINGOS (BA)";"BA";"SAO DOMINGOS";31;0;7;38
2008;"SAO FELIPE (BA)";"BA";"SAO FELIPE";141;21;27;189
2008;"SAO FELIX (BA)";"BA";"SAO FELIX";44;20;11;75
2008;"SAO FELIX DO CORIBE (BA)";"BA";"SAO FELIX DO CORIBE";91;9;14;114
2008;"SAO FRANCISCO DO CONDE (BA)";"BA";"SAO FRANCISCO DO CONDE";87;61;88;236
2008;"SAO GABRIEL (BA)";"BA";"SAO GABRIEL";21;5;5;31
2008;"SAO GONCALO DOS CAMPOS (BA)";"BA";"SAO GONCALO DOS CAMPOS";65;129;34;228
2008;"SAO JOSE DA VITORIA (BA)";"BA";"SAO JOSE DA VITORIA";6;0;4;10
2008;"SAO JOSE DO JACUIPE (BA)";"BA";"SAO JOSE DO JACUIPE";48;6;3;57
2008;"SAO MIGUEL DAS MATAS (BA)";"BA";"SAO MIGUEL DAS MATAS";33;3;2;38
2008;"SAO SEBASTIAO DO PASSE (BA)";"BA";"SAO SEBASTIAO DO PASSE";137;89;104;330
2008;"SAPEACU (BA)";"BA";"SAPEACU";77;44;22;143
2008;"SATIRO DIAS (BA)";"BA";"SATIRO DIAS";14;13;8;35
2008;"SAUBARA (BA)";"BA";"SAUBARA";15;8;1;24
2008;"SAUDE (BA)";"BA";"SAUDE";26;9;8;43
2008;"SEABRA (BA)";"BA";"SEABRA";247;64;80;391
2008;"SEBASTIAO LARANJEIRAS (BA)";"BA";"SEBASTIAO LARANJEIRAS";9;3;14;26
2008;"SENHOR DO BONFIM (BA)";"BA";"SENHOR DO BONFIM";463;91;144;698
2008;"SENTO SE (BA)";"BA";"SENTO SE";35;1;15;51
2008;"SERRA DO RAMALHO (BA)";"BA";"SERRA DO RAMALHO";39;19;15;73
2008;"SERRA DOURADA (BA)";"BA";"SERRA DOURADA";40;7;20;67
2008;"SERRA PRETA (BA)";"BA";"SERRA PRETA";20;12;32;64
2008;"SERRINHA (BA)";"BA";"SERRINHA";454;66;125;645
2008;"SERROLANDIA (BA)";"BA";"SERROLANDIA";36;18;10;64
2008;"SIMOES FILHO (BA)";"BA";"SIMOES FILHO";1778;318;593;2689
2008;"SITIO DO MATO (BA)";"BA";"SITIO DO MATO";18;8;16;42
2008;"SITIO DO QUINTO (BA)";"BA";"SITIO DO QUINTO";10;2;7;19
2008;"SOBRADINHO (BA)";"BA";"SOBRADINHO";76;13;12;101
2008;"SOUTO SOARES (BA)";"BA";"SOUTO SOARES";60;3;18;81
2008;"TABOCAS DO BREJO VELHO (BA)";"BA";"TABOCAS DO BREJO VELHO";16;3;8;27
2008;"TANHACU (BA)";"BA";"TANHACU";109;15;18;142
2008;"TANQUE NOVO (BA)";"BA";"TANQUE NOVO";212;6;33;251
2008;"TANQUINHO (BA)";"BA";"TANQUINHO";18;8;7;33
2008;"TAPEROA (BA)";"BA";"TAPEROA";84;20;10;114
2008;"TAPIRAMUTA (BA)";"BA";"TAPIRAMUTA";29;3;3;35
2008;"TEIXEIRA DE FREITAS (BA)";"BA";"TEIXEIRA DE FREITAS";1054;58;265;1377
2008;"TEODORO SAMPAIO (BA)";"BA";"TEODORO SAMPAIO";9;8;10;27
2008;"TEOFILANDIA (BA)";"BA";"TEOFILANDIA";80;8;19;107
2008;"TEOLANDIA (BA)";"BA";"TEOLANDIA";96;13;3;112
2008;"TERRA NOVA (BA)";"BA";"TERRA NOVA";7;5;14;26
2008;"TREMEDAL (BA)";"BA";"TREMEDAL";28;6;16;50
2008;"TUCANO (BA)";"BA";"TUCANO";196;27;70;293
2008;"UAUA (BA)";"BA";"UAUA";67;4;14;85
2008;"UBAIRA (BA)";"BA";"UBAIRA";76;11;27;114
2008;"UBAITABA (BA)";"BA";"UBAITABA";146;5;13;164
2008;"UBATA (BA)";"BA";"UBATA";180;14;8;202
2008;"UIBAI (BA)";"BA";"UIBAI";33;1;4;38
2008;"UMBURANAS (BA)";"BA";"UMBURANAS";23;10;11;44
2008;"UNA (BA)";"BA";"UNA";35;3;12;50
2008;"URANDI (BA)";"BA";"URANDI";71;11;18;100
2008;"URUCUCA (BA)";"BA";"URUCUCA";79;2;5;86
2008;"UTINGA (BA)";"BA";"UTINGA";42;4;6;52
2008;"VALENCA (BA)";"BA";"VALENCA";525;77;72;674
2008;"VALENTE (BA)";"BA";"VALENTE";93;7;18;118
2008;"VARZEA DA ROCA (BA)";"BA";"VARZEA DA ROCA";29;11;10;50
2008;"VARZEA DO POCO (BA)";"BA";"VARZEA DO POCO";47;5;10;62
2008;"VARZEA NOVA (BA)";"BA";"VARZEA NOVA";43;4;9;56
2008;"VARZEDO (BA)";"BA";"VARZEDO";53;6;8;67
2008;"VERA CRUZ (BA)";"BA";"VERA CRUZ";109;118;21;248
2008;"VEREDA (BA)";"BA";"VEREDA";6;1;1;8
2008;"VITORIA DA CONQUISTA (BA)";"BA";"VITORIA DA CONQUISTA";2917;361;989;4267
2008;"WAGNER (BA)";"BA";"WAGNER";15;3;8;26
2008;"WANDERLEY (BA)";"BA";"WANDERLEY";36;3;12;51
2008;"WENCESLAU GUIMARAES (BA)";"BA";"WENCESLAU GUIMARAES";87;7;6;100
2008;"XIQUE XIQUE (BA)";"BA";"XIQUE XIQUE";88;5;10;103
2008;"ABAIARA (CE)";"CE";"ABAIARA";8;22;4;34
2008;"ACARAPE (CE)";"CE";"ACARAPE";82;23;42;147
2008;"ACARAU (CE)";"CE";"ACARAU";134;13;31;178
2008;"ACOPIARA (CE)";"CE";"ACOPIARA";213;13;22;248
2008;"AIUABA (CE)";"CE";"AIUABA";13;2;0;15
2008;"ALCANTARAS (CE)";"CE";"ALCANTARAS";39;1;3;43
2008;"ALTANEIRA (CE)";"CE";"ALTANEIRA";11;4;2;17
2008;"ALTO SANTO (CE)";"CE";"ALTO SANTO";92;4;9;105
2008;"AMONTADA (CE)";"CE";"AMONTADA";118;7;9;134
2008;"ANTONINA DO NORTE (CE)";"CE";"ANTONINA DO NORTE";27;2;1;30
2008;"APUIARES (CE)";"CE";"APUIARES";55;7;0;62
2008;"AQUIRAZ (CE)";"CE";"AQUIRAZ";331;79;36;446
2008;"ARACATI (CE)";"CE";"ARACATI";342;46;64;452
2008;"ARACOIABA (CE)";"CE";"ARACOIABA";83;7;9;99
2008;"ARARENDA (CE)";"CE";"ARARENDA";16;4;1;21
2008;"ARARIPE (CE)";"CE";"ARARIPE";49;39;9;97
2008;"ARATUBA (CE)";"CE";"ARATUBA";45;2;5;52
2008;"ARNEIROZ (CE)";"CE";"ARNEIROZ";18;5;0;23
2008;"ASSARE (CE)";"CE";"ASSARE";67;11;0;78
2008;"AURORA (CE)";"CE";"AURORA";59;27;3;89
2008;"BAIXIO (CE)";"CE";"BAIXIO";8;9;2;19
2008;"BANABUIU (CE)";"CE";"BANABUIU";76;9;14;99
2008;"BARBALHA (CE)";"CE";"BARBALHA";235;56;50;341
2008;"BARREIRA (CE)";"CE";"BARREIRA";77;5;9;91
2008;"BARRO (CE)";"CE";"BARRO";39;14;10;63
2008;"BARROQUINHA (CE)";"CE";"BARROQUINHA";17;8;2;27
2008;"BATURITE (CE)";"CE";"BATURITE";163;21;21;205
2008;"BEBERIBE (CE)";"CE";"BEBERIBE";125;46;37;208
2008;"BELA CRUZ (CE)";"CE";"BELA CRUZ";68;6;11;85
2008;"BOA VIAGEM (CE)";"CE";"BOA VIAGEM";306;10;30;346
2008;"BREJO SANTO (CE)";"CE";"BREJO SANTO";241;65;23;329
2008;"CAMOCIM (CE)";"CE";"CAMOCIM";123;22;14;159
2008;"CAMPOS SALES (CE)";"CE";"CAMPOS SALES";149;38;26;213
2008;"CANINDE (CE)";"CE";"CANINDE";389;13;51;453
2008;"CAPISTRANO (CE)";"CE";"CAPISTRANO";38;5;10;53
2008;"CARIDADE (CE)";"CE";"CARIDADE";54;7;10;71
2008;"CARIRE (CE)";"CE";"CARIRE";27;9;5;41
2008;"CARIRIACU (CE)";"CE";"CARIRIACU";43;13;3;59
2008;"CARIUS (CE)";"CE";"CARIUS";33;12;2;47
2008;"CARNAUBAL (CE)";"CE";"CARNAUBAL";56;19;6;81
2008;"CASCAVEL (CE)";"CE";"CASCAVEL";330;35;60;425
2008;"CATARINA (CE)";"CE";"CATARINA";38;2;1;41
2008;"CATUNDA (CE)";"CE";"CATUNDA";21;7;2;30
2008;"CAUCAIA (CE)";"CE";"CAUCAIA";924;116;284;1324
2008;"CEDRO (CE)";"CE";"CEDRO";74;21;21;116
2008;"CHAVAL (CE)";"CE";"CHAVAL";21;4;3;28
2008;"CHORO (CE)";"CE";"CHORO";36;4;12;52
2008;"CHOROZINHO (CE)";"CE";"CHOROZINHO";78;4;29;111
2008;"COREAU (CE)";"CE";"COREAU";67;9;14;90
2008;"CRATEUS (CE)";"CE";"CRATEUS";223;19;47;289
2008;"CRATO (CE)";"CE";"CRATO";654;60;64;778
2008;"CROATA (CE)";"CE";"CROATA";33;5;2;40
2008;"CRUZ (CE)";"CE";"CRUZ";96;22;31;149
2008;"DEPUTADO IRAPUAN PINHEIRO (CE)";"CE";"DEPUTADO IRAPUAN PINHEIRO";20;3;3;26
2008;"ERERE (CE)";"CE";"ERERE";2;2;0;4
2008;"EUSEBIO (CE)";"CE";"EUSEBIO";712;27;35;774
2008;"FARIAS BRITO (CE)";"CE";"FARIAS BRITO";61;21;3;85
2008;"FORQUILHA (CE)";"CE";"FORQUILHA";87;17;20;124
2008;"FORTALEZA (CE)";"CE";"FORTALEZA";17277;2369;5156;24802
2008;"FORTIM (CE)";"CE";"FORTIM";22;23;5;50
2008;"FRECHEIRINHA (CE)";"CE";"FRECHEIRINHA";62;13;16;91
2008;"GENERAL SAMPAIO (CE)";"CE";"GENERAL SAMPAIO";24;1;2;27
2008;"GRACA (CE)";"CE";"GRACA";15;3;5;23
2008;"GRANJA (CE)";"CE";"GRANJA";129;20;10;159
2008;"GRANJEIRO (CE)";"CE";"GRANJEIRO";6;1;0;7
2008;"GROAIRAS (CE)";"CE";"GROAIRAS";39;18;8;65
2008;"GUAIUBA (CE)";"CE";"GUAIUBA";49;23;6;78
2008;"GUARACIABA DO NORTE (CE)";"CE";"GUARACIABA DO NORTE";246;7;14;267
2008;"GUARAMIRANGA (CE)";"CE";"GUARAMIRANGA";20;1;1;22
2008;"HIDROLANDIA (CE)";"CE";"HIDROLANDIA";99;11;8;118
2008;"HORIZONTE (CE)";"CE";"HORIZONTE";279;45;50;374
2008;"IBARETAMA (CE)";"CE";"IBARETAMA";44;7;13;64
2008;"IBIAPINA (CE)";"CE";"IBIAPINA";98;13;10;121
2008;"IBICUITINGA (CE)";"CE";"IBICUITINGA";44;2;6;52
2008;"ICAPUI (CE)";"CE";"ICAPUI";52;16;30;98
2008;"ICO (CE)";"CE";"ICO";229;45;38;312
2008;"IGUATU (CE)";"CE";"IGUATU";743;56;71;870
2008;"INDEPENDENCIA (CE)";"CE";"INDEPENDENCIA";138;2;10;150
2008;"IPAPORANGA (CE)";"CE";"IPAPORANGA";17;0;0;17
2008;"IPAUMIRIM (CE)";"CE";"IPAUMIRIM";157;39;23;219
2008;"IPU (CE)";"CE";"IPU";243;22;23;288
2008;"IPUEIRAS (CE)";"CE";"IPUEIRAS";48;10;2;60
2008;"IRACEMA (CE)";"CE";"IRACEMA";46;8;7;61
2008;"IRAUCUBA (CE)";"CE";"IRAUCUBA";74;11;8;93
2008;"ITAICABA (CE)";"CE";"ITAICABA";25;3;7;35
2008;"ITAITINGA (CE)";"CE";"ITAITINGA";191;42;16;249
2008;"ITAPAGE (CE)";"CE";"ITAPAGE";210;22;12;244
2008;"ITAPIPOCA (CE)";"CE";"ITAPIPOCA";513;21;25;559
2008;"ITAPIUNA (CE)";"CE";"ITAPIUNA";46;7;11;64
2008;"ITAREMA (CE)";"CE";"ITAREMA";91;12;21;124
2008;"ITATIRA (CE)";"CE";"ITATIRA";82;3;4;89
2008;"JAGUARETAMA (CE)";"CE";"JAGUARETAMA";63;3;4;70
2008;"JAGUARIBARA (CE)";"CE";"JAGUARIBARA";60;6;7;73
2008;"JAGUARIBE (CE)";"CE";"JAGUARIBE";265;13;16;294
2008;"JAGUARUANA (CE)";"CE";"JAGUARUANA";165;10;5;180
2008;"JARDIM (CE)";"CE";"JARDIM";56;40;5;101
2008;"JATI (CE)";"CE";"JATI";16;4;1;21
2008;"JIJOCA DE JERICOACOARA (CE)";"CE";"JIJOCA DE JERICOACOARA";40;7;5;52
2008;"JUAZEIRO DO NORTE (CE)";"CE";"JUAZEIRO DO NORTE";1231;118;184;1533
2008;"JUCAS (CE)";"CE";"JUCAS";41;5;12;58
2008;"LAVRAS DA MANGABEIRA (CE)";"CE";"LAVRAS DA MANGABEIRA";65;11;13;89
2008;"LIMOEIRO DO NORTE (CE)";"CE";"LIMOEIRO DO NORTE";524;21;88;633
2008;"MADALENA (CE)";"CE";"MADALENA";59;5;9;73
2008;"MARACANAU (CE)";"CE";"MARACANAU";929;155;173;1257
2008;"MARANGUAPE (CE)";"CE";"MARANGUAPE";447;50;120;617
2008;"MARCO (CE)";"CE";"MARCO";157;4;12;173
2008;"MARTINOPOLE (CE)";"CE";"MARTINOPOLE";14;3;2;19
2008;"MASSAPE (CE)";"CE";"MASSAPE";65;6;36;107
2008;"MAURITI (CE)";"CE";"MAURITI";53;33;10;96
2008;"MERUOCA (CE)";"CE";"MERUOCA";23;4;4;31
2008;"MILAGRES (CE)";"CE";"MILAGRES";70;25;12;107
2008;"MILHA (CE)";"CE";"MILHA";50;1;12;63
2008;"MIRAIMA (CE)";"CE";"MIRAIMA";29;2;2;33
2008;"MISSAO VELHA (CE)";"CE";"MISSAO VELHA";92;37;7;136
2008;"MOMBACA (CE)";"CE";"MOMBACA";168;8;3;179
2008;"MONSENHOR TABOSA (CE)";"CE";"MONSENHOR TABOSA";39;4;1;44
2008;"MORADA NOVA (CE)";"CE";"MORADA NOVA";325;32;52;409
2008;"MORAUJO (CE)";"CE";"MORAUJO";9;2;5;16
2008;"MORRINHOS (CE)";"CE";"MORRINHOS";51;9;7;67
2008;"MUCAMBO (CE)";"CE";"MUCAMBO";27;10;6;43
2008;"MULUNGU (CE)";"CE";"MULUNGU";44;4;1;49
2008;"NOVA OLINDA (CE)";"CE";"NOVA OLINDA";65;18;2;85
2008;"NOVA RUSSAS (CE)";"CE";"NOVA RUSSAS";157;11;5;173
2008;"NOVO ORIENTE (CE)";"CE";"NOVO ORIENTE";54;5;9;68
2008;"OCARA (CE)";"CE";"OCARA";93;15;26;134
2008;"OROS (CE)";"CE";"OROS";84;14;13;111
2008;"PACAJUS (CE)";"CE";"PACAJUS";463;51;80;594
2008;"PACATUBA (CE)";"CE";"PACATUBA";129;64;9;202
2008;"PACOTI (CE)";"CE";"PACOTI";82;4;7;93
2008;"PACUJA (CE)";"CE";"PACUJA";31;4;12;47
2008;"PALHANO (CE)";"CE";"PALHANO";36;7;8;51
2008;"PALMACIA (CE)";"CE";"PALMACIA";38;16;9;63
2008;"PARACURU (CE)";"CE";"PARACURU";144;11;12;167
2008;"PARAIPABA (CE)";"CE";"PARAIPABA";129;8;11;148
2008;"PARAMBU (CE)";"CE";"PARAMBU";151;4;2;157
2008;"PARAMOTI (CE)";"CE";"PARAMOTI";37;2;6;45
2008;"PEDRA BRANCA (CE)";"CE";"PEDRA BRANCA";202;10;11;223
2008;"PENAFORTE (CE)";"CE";"PENAFORTE";22;19;12;53
2008;"PENTECOSTE (CE)";"CE";"PENTECOSTE";162;7;5;174
2008;"PEREIRO (CE)";"CE";"PEREIRO";63;10;6;79
2008;"PINDORETAMA (CE)";"CE";"PINDORETAMA";100;17;5;122
2008;"PIQUET CARNEIRO (CE)";"CE";"PIQUET CARNEIRO";23;3;5;31
2008;"PIRES FERREIRA (CE)";"CE";"PIRES FERREIRA";16;2;1;19
2008;"PORANGA (CE)";"CE";"PORANGA";10;3;1;14
2008;"PORTEIRAS (CE)";"CE";"PORTEIRAS";19;42;6;67
2008;"POTENGI (CE)";"CE";"POTENGI";17;3;0;20
2008;"POTIRETAMA (CE)";"CE";"POTIRETAMA";18;0;5;23
2008;"QUITERIANOPOLIS (CE)";"CE";"QUITERIANOPOLIS";32;6;2;40
2008;"QUIXADA (CE)";"CE";"QUIXADA";487;35;55;577
2008;"QUIXELO (CE)";"CE";"QUIXELO";32;5;18;55
2008;"QUIXERAMOBIM (CE)";"CE";"QUIXERAMOBIM";333;23;65;421
2008;"QUIXERE (CE)";"CE";"QUIXERE";138;8;36;182
2008;"REDENCAO (CE)";"CE";"REDENCAO";172;26;22;220
2008;"RERIUTABA (CE)";"CE";"RERIUTABA";59;15;15;89
2008;"RUSSAS (CE)";"CE";"RUSSAS";555;26;64;645
2008;"SABOEIRO (CE)";"CE";"SABOEIRO";23;9;3;35
2008;"SALITRE (CE)";"CE";"SALITRE";37;4;12;53
2008;"SANTA QUITERIA (CE)";"CE";"SANTA QUITERIA";198;22;6;226
2008;"SANTANA DO ACARAU (CE)";"CE";"SANTANA DO ACARAU";102;19;16;137
2008;"SANTANA DO CARIRI (CE)";"CE";"SANTANA DO CARIRI";49;15;2;66
2008;"SAO BENEDITO (CE)";"CE";"SAO BENEDITO";339;61;34;434
2008;"SAO GONCALO DO AMARANTE (CE)";"CE";"SAO GONCALO DO AMARANTE";172;45;23;240
2008;"SAO JOAO DO JAGUARIBE (CE)";"CE";"SAO JOAO DO JAGUARIBE";44;8;8;60
2008;"SAO LUIS DO CURU (CE)";"CE";"SAO LUIS DO CURU";43;3;6;52
2008;"SENADOR POMPEU (CE)";"CE";"SENADOR POMPEU";121;4;22;147
2008;"SENADOR SA (CE)";"CE";"SENADOR SA";22;1;7;30
2008;"SOBRAL (CE)";"CE";"SOBRAL";1146;162;182;1490
2008;"SOLONOPOLE (CE)";"CE";"SOLONOPOLE";60;2;7;69
2008;"TABULEIRO DO NORTE (CE)";"CE";"TABULEIRO DO NORTE";266;29;28;323
2008;"TAMBORIL (CE)";"CE";"TAMBORIL";52;7;12;71
2008;"TARRAFAS (CE)";"CE";"TARRAFAS";16;6;2;24
2008;"TAUA (CE)";"CE";"TAUA";291;19;23;333
2008;"TEJUCUOCA (CE)";"CE";"TEJUCUOCA";65;3;4;72
2008;"TIANGUA (CE)";"CE";"TIANGUA";954;79;70;1103
2008;"TRAIRI (CE)";"CE";"TRAIRI";136;11;19;166
2008;"TURURU (CE)";"CE";"TURURU";35;1;3;39
2008;"UBAJARA (CE)";"CE";"UBAJARA";185;15;21;221
2008;"UMARI (CE)";"CE";"UMARI";5;3;2;10
2008;"UMIRIM (CE)";"CE";"UMIRIM";42;37;9;88
2008;"URUBURETAMA (CE)";"CE";"URUBURETAMA";57;8;23;88
2008;"URUOCA (CE)";"CE";"URUOCA";28;5;9;42
2008;"VARJOTA (CE)";"CE";"VARJOTA";80;21;4;105
2008;"VARZEA ALEGRE (CE)";"CE";"VARZEA ALEGRE";147;24;26;197
2008;"VICOSA DO CEARA (CE)";"CE";"VICOSA DO CEARA";230;17;11;258
2008;"BRASILIA (DF)";"DF";"BRASILIA";17295;4748;7466;29509
2008;"AFONSO CLAUDIO (ES)";"ES";"AFONSO CLAUDIO";412;27;109;548
2008;"AGUA DOCE DO NORTE (ES)";"ES";"AGUA DOCE DO NORTE";70;6;20;96
2008;"AGUIA BRANCA (ES)";"ES";"AGUIA BRANCA";114;2;19;135
2008;"ALEGRE (ES)";"ES";"ALEGRE";153;24;18;195
2008;"ALFREDO CHAVES (ES)";"ES";"ALFREDO CHAVES";384;15;29;428
2008;"ALTO RIO NOVO (ES)";"ES";"ALTO RIO NOVO";78;14;15;107
2008;"ANCHIETA (ES)";"ES";"ANCHIETA";230;43;33;306
2008;"APIACA (ES)";"ES";"APIACA";60;13;2;75
2008;"ARACRUZ (ES)";"ES";"ARACRUZ";969;119;356;1444
2008;"ATILIO VIVACQUA (ES)";"ES";"ATILIO VIVACQUA";156;9;15;180
2008;"BAIXO GUANDU (ES)";"ES";"BAIXO GUANDU";481;17;75;573
2008;"BARRA DE SAO FRANCISCO (ES)";"ES";"BARRA DE SAO FRANCISCO";426;13;84;523
2008;"BOA ESPERANCA (ES)";"ES";"BOA ESPERANCA";192;8;41;241
2008;"BOM JESUS DO NORTE (ES)";"ES";"BOM JESUS DO NORTE";170;28;21;219
2008;"BREJETUBA (ES)";"ES";"BREJETUBA";142;7;25;174
2008;"CACHOEIRO DE ITAPEMIRIM (ES)";"ES";"CACHOEIRO DE ITAPEMIRIM";4485;188;1988;6661
2008;"CARIACICA (ES)";"ES";"CARIACICA";4382;439;1527;6348
2008;"CASTELO (ES)";"ES";"CASTELO";1156;51;52;1259
2008;"COLATINA (ES)";"ES";"COLATINA";2039;95;435;2569
2008;"CONCEICAO DA BARRA (ES)";"ES";"CONCEICAO DA BARRA";179;14;90;283
2008;"CONCEICAO DO CASTELO (ES)";"ES";"CONCEICAO DO CASTELO";186;17;43;246
2008;"DIVINO DE SAO LOURENCO (ES)";"ES";"DIVINO DE SAO LOURENCO";39;2;5;46
2008;"DOMINGOS MARTINS (ES)";"ES";"DOMINGOS MARTINS";773;58;61;892
2008;"DORES DO RIO PRETO (ES)";"ES";"DORES DO RIO PRETO";100;4;15;119
2008;"ECOPORANGA (ES)";"ES";"ECOPORANGA";121;20;56;197
2008;"FUNDAO (ES)";"ES";"FUNDAO";275;29;36;340
2008;"GOVERNADOR LINDENBERG (ES)";"ES";"GOVERNADOR LINDENBERG";183;8;4;195
2008;"GUACUI (ES)";"ES";"GUACUI";350;38;31;419
2008;"GUARAPARI (ES)";"ES";"GUARAPARI";927;175;194;1296
2008;"IBATIBA (ES)";"ES";"IBATIBA";318;22;27;367
2008;"IBIRACU (ES)";"ES";"IBIRACU";338;25;45;408
2008;"IBITIRAMA (ES)";"ES";"IBITIRAMA";75;5;10;90
2008;"ICONHA (ES)";"ES";"ICONHA";625;23;43;691
2008;"IRUPI (ES)";"ES";"IRUPI";118;16;16;150
2008;"ITAGUACU (ES)";"ES";"ITAGUACU";208;9;49;266
2008;"ITAPEMIRIM (ES)";"ES";"ITAPEMIRIM";369;30;42;441
2008;"ITARANA (ES)";"ES";"ITARANA";254;24;25;303
2008;"IUNA (ES)";"ES";"IUNA";320;17;60;397
2008;"JAGUARE (ES)";"ES";"JAGUARE";338;10;58;406
2008;"JERONIMO MONTEIRO (ES)";"ES";"JERONIMO MONTEIRO";55;10;10;75
2008;"JOAO NEIVA (ES)";"ES";"JOAO NEIVA";278;15;25;318
2008;"LARANJA DA TERRA (ES)";"ES";"LARANJA DA TERRA";224;10;22;256
2008;"LINHARES (ES)";"ES";"LINHARES";2421;86;335;2842
2008;"MANTENOPOLIS (ES)";"ES";"MANTENOPOLIS";102;8;19;129
2008;"MARATAIZES (ES)";"ES";"MARATAIZES";587;29;39;655
2008;"MARECHAL FLORIANO (ES)";"ES";"MARECHAL FLORIANO";523;21;13;557
2008;"MARILANDIA (ES)";"ES";"MARILANDIA";309;12;21;342
2008;"MIMOSO DO SUL (ES)";"ES";"MIMOSO DO SUL";209;22;51;282
2008;"MONTANHA (ES)";"ES";"MONTANHA";161;10;29;200
2008;"MUCURICI (ES)";"ES";"MUCURICI";56;6;23;85
2008;"MUNIZ FREIRE (ES)";"ES";"MUNIZ FREIRE";142;26;28;196
2008;"MUQUI (ES)";"ES";"MUQUI";130;14;19;163
2008;"NOVA VENECIA (ES)";"ES";"NOVA VENECIA";701;24;133;858
2008;"PANCAS (ES)";"ES";"PANCAS";212;15;6;233
2008;"PEDRO CANARIO (ES)";"ES";"PEDRO CANARIO";340;26;201;567
2008;"PINHEIROS (ES)";"ES";"PINHEIROS";230;22;91;343
2008;"PIUMA (ES)";"ES";"PIUMA";162;35;8;205
2008;"PONTO BELO (ES)";"ES";"PONTO BELO";40;6;15;61
2008;"PRESIDENTE KENNEDY (ES)";"ES";"PRESIDENTE KENNEDY";233;26;16;275
2008;"RIO BANANAL (ES)";"ES";"RIO BANANAL";451;11;31;493
2008;"RIO NOVO DO SUL (ES)";"ES";"RIO NOVO DO SUL";237;4;19;260
2008;"SANTA LEOPOLDINA (ES)";"ES";"SANTA LEOPOLDINA";294;28;27;349
2008;"SANTA MARIA DE JETIBA (ES)";"ES";"SANTA MARIA DE JETIBA";1492;61;43;1596
2008;"SANTA TERESA (ES)";"ES";"SANTA TERESA";564;26;59;649
2008;"SAO DOMINGOS DO NORTE (ES)";"ES";"SAO DOMINGOS DO NORTE";168;5;17;190
2008;"SAO GABRIEL DA PALHA (ES)";"ES";"SAO GABRIEL DA PALHA";518;12;73;603
2008;"SAO JOSE DO CALCADO (ES)";"ES";"SAO JOSE DO CALCADO";70;6;14;90
2008;"SAO MATEUS (ES)";"ES";"SAO MATEUS";882;82;270;1234
2008;"SAO ROQUE DO CANAA (ES)";"ES";"SAO ROQUE DO CANAA";238;16;12;266
2008;"SERRA (ES)";"ES";"SERRA";6660;383;1875;8918
2008;"SOORETAMA (ES)";"ES";"SOORETAMA";264;11;41;316
2008;"VARGEM ALTA (ES)";"ES";"VARGEM ALTA";348;14;41;403
2008;"VENDA NOVA DO IMIGRANTE (ES)";"ES";"VENDA NOVA DO IMIGRANTE";717;18;97;832
2008;"VIANA (ES)";"ES";"VIANA";873;42;200;1115
2008;"VILA PAVAO (ES)";"ES";"VILA PAVAO";118;6;13;137
2008;"VILA VALERIO (ES)";"ES";"VILA VALERIO";280;4;22;306
2008;"VILA VELHA (ES)";"ES";"VILA VELHA";3510;646;707;4863
2008;"VITORIA (ES)";"ES";"VITORIA";3159;862;956;4977
2008;"ABADIA DE GOIAS (GO)";"GO";"ABADIA DE GOIAS";50;1;3;54
2008;"ABADIANIA (GO)";"GO";"ABADIANIA";191;15;15;221
2008;"ACREUNA (GO)";"GO";"ACREUNA";321;4;58;383
2008;"ADELANDIA (GO)";"GO";"ADELANDIA";22;0;2;24
2008;"AGUA FRIA DE GOIAS (GO)";"GO";"AGUA FRIA DE GOIAS";30;7;8;45
2008;"AGUA LIMPA (GO)";"GO";"AGUA LIMPA";14;7;1;22
2008;"AGUAS LINDAS DE GOIAS (GO)";"GO";"AGUAS LINDAS DE GOIAS";392;108;258;758
2008;"ALEXANIA (GO)";"GO";"ALEXANIA";296;24;16;336
2008;"ALOANDIA (GO)";"GO";"ALOANDIA";20;2;2;24
2008;"ALTO HORIZONTE (GO)";"GO";"ALTO HORIZONTE";21;3;8;32
2008;"ALTO PARAISO DE GOIAS (GO)";"GO";"ALTO PARAISO DE GOIAS";35;8;9;52
2008;"ALVORADA DO NORTE (GO)";"GO";"ALVORADA DO NORTE";107;3;5;115
2008;"AMARALINA (GO)";"GO";"AMARALINA";8;1;6;15
2008;"AMERICANO DO BRASIL (GO)";"GO";"AMERICANO DO BRASIL";46;5;13;64
2008;"AMORINOPOLIS (GO)";"GO";"AMORINOPOLIS";28;1;7;36
2008;"ANAPOLIS (GO)";"GO";"ANAPOLIS";7946;227;1154;9327
2008;"ANHANGUERA (GO)";"GO";"ANHANGUERA";7;2;1;10
2008;"ANICUNS (GO)";"GO";"ANICUNS";275;15;68;358
2008;"APARECIDA DE GOIANIA (GO)";"GO";"APARECIDA DE GOIANIA";3804;185;357;4346
2008;"APARECIDA DO RIO DOCE (GO)";"GO";"APARECIDA DO RIO DOCE";39;1;6;46
2008;"APORE (GO)";"GO";"APORE";43;7;5;55
2008;"ARACU (GO)";"GO";"ARACU";18;2;3;23
2008;"ARAGARCAS (GO)";"GO";"ARAGARCAS";459;4;23;486
2008;"ARAGOIANIA (GO)";"GO";"ARAGOIANIA";44;0;4;48
2008;"ARAGUAPAZ (GO)";"GO";"ARAGUAPAZ";77;0;6;83
2008;"ARENOPOLIS (GO)";"GO";"ARENOPOLIS";8;4;2;14
2008;"ARUANA (GO)";"GO";"ARUANA";18;2;5;25
2008;"AURILANDIA (GO)";"GO";"AURILANDIA";14;3;1;18
2008;"AVELINOPOLIS (GO)";"GO";"AVELINOPOLIS";26;1;0;27
2008;"BALIZA (GO)";"GO";"BALIZA";4;1;2;7
2008;"BARRO ALTO (GO)";"GO";"BARRO ALTO";81;9;39;129
2008;"BELA VISTA DE GOIAS (GO)";"GO";"BELA VISTA DE GOIAS";263;9;32;304
2008;"BOM JARDIM DE GOIAS (GO)";"GO";"BOM JARDIM DE GOIAS";80;7;11;98
2008;"BOM JESUS DE GOIAS (GO)";"GO";"BOM JESUS DE GOIAS";370;18;90;478
2008;"BONFINOPOLIS (GO)";"GO";"BONFINOPOLIS";33;2;9;44
2008;"BONOPOLIS (GO)";"GO";"BONOPOLIS";9;1;2;12
2008;"BRAZABRANTES (GO)";"GO";"BRAZABRANTES";52;3;3;58
2008;"BRITANIA (GO)";"GO";"BRITANIA";58;4;4;66
2008;"BURITI ALEGRE (GO)";"GO";"BURITI ALEGRE";159;6;5;170
2008;"BURITI DE GOIAS (GO)";"GO";"BURITI DE GOIAS";14;8;2;24
2008;"BURITINOPOLIS (GO)";"GO";"BURITINOPOLIS";12;1;3;16
2008;"CABECEIRAS (GO)";"GO";"CABECEIRAS";55;2;18;75
2008;"CACHOEIRA ALTA (GO)";"GO";"CACHOEIRA ALTA";136;10;27;173
2008;"CACHOEIRA DE GOIAS (GO)";"GO";"CACHOEIRA DE GOIAS";5;1;0;6
2008;"CACHOEIRA DOURADA (GO)";"GO";"CACHOEIRA DOURADA";83;8;23;114
2008;"CACU (GO)";"GO";"CACU";166;4;23;193
2008;"CAIAPONIA (GO)";"GO";"CAIAPONIA";129;1;6;136
2008;"CALDAS NOVAS (GO)";"GO";"CALDAS NOVAS";505;46;62;613
2008;"CALDAZINHA (GO)";"GO";"CALDAZINHA";16;0;2;18
2008;"CAMPESTRE DE GOIAS (GO)";"GO";"CAMPESTRE DE GOIAS";27;2;3;32
2008;"CAMPINACU (GO)";"GO";"CAMPINACU";8;3;3;14
2008;"CAMPINORTE (GO)";"GO";"CAMPINORTE";102;6;11;119
2008;"CAMPO ALEGRE DE GOIAS (GO)";"GO";"CAMPO ALEGRE DE GOIAS";97;5;17;119
2008;"CAMPO LIMPO DE GOIAS (GO)";"GO";"CAMPO LIMPO DE GOIAS";71;0;3;74
2008;"CAMPOS BELOS (GO)";"GO";"CAMPOS BELOS";150;5;22;177
2008;"CAMPOS VERDES (GO)";"GO";"CAMPOS VERDES";28;4;1;33
2008;"CARMO DO RIO VERDE (GO)";"GO";"CARMO DO RIO VERDE";59;10;36;105
2008;"CASTELANDIA (GO)";"GO";"CASTELANDIA";35;2;7;44
2008;"CATALAO (GO)";"GO";"CATALAO";1457;79;213;1749
2008;"CATURAI (GO)";"GO";"CATURAI";28;2;7;37
2008;"CAVALCANTE (GO)";"GO";"CAVALCANTE";23;2;3;28
2008;"CERES (GO)";"GO";"CERES";455;14;19;488
2008;"CEZARINA (GO)";"GO";"CEZARINA";88;2;7;97
2008;"CHAPADAO DO CEU (GO)";"GO";"CHAPADAO DO CEU";150;12;11;173
2008;"CIDADE OCIDENTAL (GO)";"GO";"CIDADE OCIDENTAL";97;36;63;196
2008;"COCALZINHO DE GOIAS (GO)";"GO";"COCALZINHO DE GOIAS";120;16;12;148
2008;"COLINAS DO SUL (GO)";"GO";"COLINAS DO SUL";9;2;3;14
2008;"CORREGO DO OURO (GO)";"GO";"CORREGO DO OURO";17;0;1;18
2008;"CORUMBA DE GOIAS (GO)";"GO";"CORUMBA DE GOIAS";74;5;12;91
2008;"CORUMBAIBA (GO)";"GO";"CORUMBAIBA";110;9;8;127
2008;"CRISTALINA (GO)";"GO";"CRISTALINA";840;32;197;1069
2008;"CRISTIANOPOLIS (GO)";"GO";"CRISTIANOPOLIS";36;6;1;43
2008;"CRIXAS (GO)";"GO";"CRIXAS";68;12;12;92
2008;"CROMINIA (GO)";"GO";"CROMINIA";30;1;2;33
2008;"CUMARI (GO)";"GO";"CUMARI";20;4;0;24
2008;"DAMIANOPOLIS (GO)";"GO";"DAMIANOPOLIS";5;0;3;8
2008;"DAMOLANDIA (GO)";"GO";"DAMOLANDIA";25;3;3;31
2008;"DAVINOPOLIS (GO)";"GO";"DAVINOPOLIS";24;4;4;32
2008;"DIORAMA (GO)";"GO";"DIORAMA";7;4;4;15
2008;"DIVINOPOLIS DE GOIAS (GO)";"GO";"DIVINOPOLIS DE GOIAS";21;0;5;26
2008;"DOVERLANDIA (GO)";"GO";"DOVERLANDIA";89;4;25;118
2008;"EDEALINA (GO)";"GO";"EDEALINA";54;4;6;64
2008;"EDEIA (GO)";"GO";"EDEIA";144;5;12;161
2008;"ESTRELA DO NORTE (GO)";"GO";"ESTRELA DO NORTE";21;4;1;26
2008;"FAINA (GO)";"GO";"FAINA";28;2;4;34
2008;"FAZENDA NOVA (GO)";"GO";"FAZENDA NOVA";32;3;6;41
2008;"FIRMINOPOLIS (GO)";"GO";"FIRMINOPOLIS";64;0;6;70
2008;"FLORES DE GOIAS (GO)";"GO";"FLORES DE GOIAS";24;6;4;34
2008;"FORMOSA (GO)";"GO";"FORMOSA";2385;95;505;2985
2008;"FORMOSO (GO)";"GO";"FORMOSO";35;1;4;40
2008;"GAMELEIRA DE GOIAS (GO)";"GO";"GAMELEIRA DE GOIAS";17;7;10;34
2008;"GOIANAPOLIS (GO)";"GO";"GOIANAPOLIS";156;5;10;171
2008;"GOIANDIRA (GO)";"GO";"GOIANDIRA";36;5;4;45
2008;"GOIANESIA (GO)";"GO";"GOIANESIA";747;34;143;924
2008;"GOIANIA (GO)";"GO";"GOIANIA";21467;1639;6487;29593
2008;"GOIANIRA (GO)";"GO";"GOIANIRA";162;2;61;225
2008;"GOIAS (GO)";"GO";"GOIAS";179;11;32;222
2008;"GOIATUBA (GO)";"GO";"GOIATUBA";552;18;49;619
2008;"GOUVELANDIA (GO)";"GO";"GOUVELANDIA";47;4;5;56
2008;"GUAPO (GO)";"GO";"GUAPO";109;10;7;126
2008;"GUARAITA (GO)";"GO";"GUARAITA";12;1;1;14
2008;"GUARANI DE GOIAS (GO)";"GO";"GUARANI DE GOIAS";7;1;6;14
2008;"GUARINOS (GO)";"GO";"GUARINOS";4;3;2;9
2008;"HEITORAI (GO)";"GO";"HEITORAI";16;2;2;20
2008;"HIDROLANDIA (GO)";"GO";"HIDROLANDIA";195;15;17;227
2008;"HIDROLINA (GO)";"GO";"HIDROLINA";15;0;3;18
2008;"IACIARA (GO)";"GO";"IACIARA";106;4;11;121
2008;"INACIOLANDIA (GO)";"GO";"INACIOLANDIA";43;9;5;57
2008;"INDIARA (GO)";"GO";"INDIARA";156;13;14;183
2008;"INHUMAS (GO)";"GO";"INHUMAS";901;35;157;1093
2008;"IPAMERI (GO)";"GO";"IPAMERI";232;35;64;331
2008;"IPIRANGA DE GOIAS (GO)";"GO";"IPIRANGA DE GOIAS";14;5;7;26
2008;"IPORA (GO)";"GO";"IPORA";322;14;36;372
2008;"ISRAELANDIA (GO)";"GO";"ISRAELANDIA";9;1;4;14
2008;"ITABERAI (GO)";"GO";"ITABERAI";506;15;46;567
2008;"ITAGUARI (GO)";"GO";"ITAGUARI";43;5;9;57
2008;"ITAGUARU (GO)";"GO";"ITAGUARU";53;5;7;65
2008;"ITAJA (GO)";"GO";"ITAJA";56;4;8;68
2008;"ITAPACI (GO)";"GO";"ITAPACI";141;14;58;213
2008;"ITAPIRAPUA (GO)";"GO";"ITAPIRAPUA";48;1;8;57
2008;"ITAPURANGA (GO)";"GO";"ITAPURANGA";261;14;60;335
2008;"ITARUMA (GO)";"GO";"ITARUMA";65;6;6;77
2008;"ITAUCU (GO)";"GO";"ITAUCU";66;6;8;80
2008;"ITUMBIARA (GO)";"GO";"ITUMBIARA";1863;151;214;2228
2008;"IVOLANDIA (GO)";"GO";"IVOLANDIA";4;2;4;10
2008;"JANDAIA (GO)";"GO";"JANDAIA";74;4;9;87
2008;"JARAGUA (GO)";"GO";"JARAGUA";261;16;34;311
2008;"JATAI (GO)";"GO";"JATAI";1630;53;144;1827
2008;"JAUPACI (GO)";"GO";"JAUPACI";20;3;5;28
2008;"JESUPOLIS (GO)";"GO";"JESUPOLIS";12;2;4;18
2008;"JOVIANIA (GO)";"GO";"JOVIANIA";117;5;9;131
2008;"JUSSARA (GO)";"GO";"JUSSARA";301;9;15;325
2008;"LAGOA SANTA (GO)";"GO";"LAGOA SANTA";8;3;5;16
2008;"LEOPOLDO DE BULHOES (GO)";"GO";"LEOPOLDO DE BULHOES";85;4;5;94
2008;"LUZIANIA (GO)";"GO";"LUZIANIA";1995;100;335;2430
2008;"MAIRIPOTABA (GO)";"GO";"MAIRIPOTABA";19;2;2;23
2008;"MAMBAI (GO)";"GO";"MAMBAI";50;3;10;63
2008;"MARA ROSA (GO)";"GO";"MARA ROSA";87;0;9;96
2008;"MARZAGAO (GO)";"GO";"MARZAGAO";23;2;1;26
2008;"MATRINCHA (GO)";"GO";"MATRINCHA";33;5;5;43
2008;"MAURILANDIA (GO)";"GO";"MAURILANDIA";277;15;74;366
2008;"MIMOSO DE GOIAS (GO)";"GO";"MIMOSO DE GOIAS";6;0;2;8
2008;"MINACU (GO)";"GO";"MINACU";301;25;23;349
2008;"MINEIROS (GO)";"GO";"MINEIROS";1062;59;96;1217
2008;"MOIPORA (GO)";"GO";"MOIPORA";7;1;0;8
2008;"MONTE ALEGRE DE GOIAS (GO)";"GO";"MONTE ALEGRE DE GOIAS";11;0;4;15
2008;"MONTES CLAROS DE GOIAS (GO)";"GO";"MONTES CLAROS DE GOIAS";50;2;11;63
2008;"MONTIVIDIU (GO)";"GO";"MONTIVIDIU";259;4;36;299
2008;"MONTIVIDIU DO NORTE (GO)";"GO";"MONTIVIDIU DO NORTE";18;2;12;32
2008;"MORRINHOS (GO)";"GO";"MORRINHOS";599;28;59;686
2008;"MORRO AGUDO DE GOIAS (GO)";"GO";"MORRO AGUDO DE GOIAS";11;3;2;16
2008;"MOSSAMEDES (GO)";"GO";"MOSSAMEDES";25;6;2;33
2008;"MOZARLANDIA (GO)";"GO";"MOZARLANDIA";94;1;17;112
2008;"MUNDO NOVO (GO)";"GO";"MUNDO NOVO";20;4;7;31
2008;"MUTUNOPOLIS (GO)";"GO";"MUTUNOPOLIS";16;1;4;21
2008;"NAZARIO (GO)";"GO";"NAZARIO";95;0;6;101
2008;"NEROPOLIS (GO)";"GO";"NEROPOLIS";334;17;17;368
2008;"NIQUELANDIA (GO)";"GO";"NIQUELANDIA";493;48;110;651
2008;"NOVA AMERICA (GO)";"GO";"NOVA AMERICA";12;1;3;16
2008;"NOVA AURORA (GO)";"GO";"NOVA AURORA";21;3;5;29
2008;"NOVA CRIXAS (GO)";"GO";"NOVA CRIXAS";56;2;21;79
2008;"NOVA GLORIA (GO)";"GO";"NOVA GLORIA";54;5;21;80
2008;"NOVA IGUACU DE GOIAS (GO)";"GO";"NOVA IGUACU DE GOIAS";15;1;3;19
2008;"NOVA ROMA (GO)";"GO";"NOVA ROMA";4;1;2;7
2008;"NOVA VENEZA (GO)";"GO";"NOVA VENEZA";189;3;12;204
2008;"NOVO BRASIL (GO)";"GO";"NOVO BRASIL";17;2;1;20
2008;"NOVO GAMA (GO)";"GO";"NOVO GAMA";292;52;100;444
2008;"NOVO PLANALTO (GO)";"GO";"NOVO PLANALTO";28;3;0;31
2008;"ORIZONA (GO)";"GO";"ORIZONA";141;23;34;198
2008;"OURO VERDE DE GOIAS (GO)";"GO";"OURO VERDE DE GOIAS";75;0;7;82
2008;"OUVIDOR (GO)";"GO";"OUVIDOR";71;6;9;86
2008;"PADRE BERNARDO (GO)";"GO";"PADRE BERNARDO";245;7;48;300
2008;"PALESTINA DE GOIAS (GO)";"GO";"PALESTINA DE GOIAS";16;11;3;30
2008;"PALMEIRAS DE GOIAS (GO)";"GO";"PALMEIRAS DE GOIAS";246;8;39;293
2008;"PALMELO (GO)";"GO";"PALMELO";15;1;2;18
2008;"PALMINOPOLIS (GO)";"GO";"PALMINOPOLIS";26;1;2;29
2008;"PANAMA (GO)";"GO";"PANAMA";28;0;4;32
2008;"PARANAIGUARA (GO)";"GO";"PARANAIGUARA";81;5;6;92
2008;"PARAUNA (GO)";"GO";"PARAUNA";117;10;24;151
2008;"PEROLANDIA (GO)";"GO";"PEROLANDIA";21;0;8;29
2008;"PETROLINA DE GOIAS (GO)";"GO";"PETROLINA DE GOIAS";86;2;12;100
2008;"PILAR DE GOIAS (GO)";"GO";"PILAR DE GOIAS";8;3;2;13
2008;"PIRACANJUBA (GO)";"GO";"PIRACANJUBA";293;13;25;331
2008;"PIRANHAS (GO)";"GO";"PIRANHAS";168;5;28;201
2008;"PIRENOPOLIS (GO)";"GO";"PIRENOPOLIS";215;16;19;250
2008;"PIRES DO RIO (GO)";"GO";"PIRES DO RIO";399;23;25;447
2008;"PLANALTINA (GO)";"GO";"PLANALTINA";393;29;298;720
2008;"PONTALINA (GO)";"GO";"PONTALINA";203;6;23;232
2008;"PORANGATU (GO)";"GO";"PORANGATU";482;17;55;554
2008;"PORTEIRAO (GO)";"GO";"PORTEIRAO";73;5;6;84
2008;"PORTELANDIA (GO)";"GO";"PORTELANDIA";39;14;2;55
2008;"POSSE (GO)";"GO";"POSSE";463;33;60;556
2008;"PROFESSOR JAMIL (GO)";"GO";"PROFESSOR JAMIL";25;1;4;30
2008;"QUIRINOPOLIS (GO)";"GO";"QUIRINOPOLIS";723;19;66;808
2008;"RIALMA (GO)";"GO";"RIALMA";274;15;19;308
2008;"RIANAPOLIS (GO)";"GO";"RIANAPOLIS";71;4;4;79
2008;"RIO QUENTE (GO)";"GO";"RIO QUENTE";31;12;35;78
2008;"RIO VERDE (GO)";"GO";"RIO VERDE";2709;147;354;3210
2008;"RUBIATABA (GO)";"GO";"RUBIATABA";213;10;43;266
2008;"SANCLERLANDIA (GO)";"GO";"SANCLERLANDIA";66;4;5;75
2008;"SANTA BARBARA DE GOIAS (GO)";"GO";"SANTA BARBARA DE GOIAS";68;2;6;76
2008;"SANTA CRUZ DE GOIAS (GO)";"GO";"SANTA CRUZ DE GOIAS";4;1;2;7
2008;"SANTA FE DE GOIAS (GO)";"GO";"SANTA FE DE GOIAS";33;2;3;38
2008;"SANTA HELENA DE GOIAS (GO)";"GO";"SANTA HELENA DE GOIAS";685;25;146;856
2008;"SANTA ISABEL (GO)";"GO";"SANTA ISABEL";8;3;1;12
2008;"SANTA RITA DO ARAGUAIA (GO)";"GO";"SANTA RITA DO ARAGUAIA";122;5;3;130
2008;"SANTA RITA DO NOVO DESTINO (GO)";"GO";"SANTA RITA DO NOVO DESTINO";18;2;6;26
2008;"SANTA ROSA DE GOIAS (GO)";"GO";"SANTA ROSA DE GOIAS";17;3;2;22
2008;"SANTA TEREZA DE GOIAS (GO)";"GO";"SANTA TEREZA DE GOIAS";29;1;3;33
2008;"SANTA TEREZINHA DE GOIAS (GO)";"GO";"SANTA TEREZINHA DE GOIAS";59;4;17;80
2008;"SANTO ANTONIO DA BARRA (GO)";"GO";"SANTO ANTONIO DA BARRA";25;2;7;34
2008;"SANTO ANTONIO DE GOIAS (GO)";"GO";"SANTO ANTONIO DE GOIAS";37;2;10;49
2008;"SANTO ANTONIO DO DESCOBERTO (GO)";"GO";"SANTO ANTONIO DO DESCOBERTO";245;28;187;460
2008;"SAO DOMINGOS (GO)";"GO";"SAO DOMINGOS";28;3;16;47
2008;"SAO FRANCISCO DE GOIAS (GO)";"GO";"SAO FRANCISCO DE GOIAS";37;5;5;47
2008;"SAO JOAO D ALIANCA (GO)";"GO";"SAO JOAO D ALIANCA";97;6;8;111
2008;"SAO JOAO DA PARAUNA (GO)";"GO";"SAO JOAO DA PARAUNA";9;0;3;12
2008;"SAO LUIS DE MONTES BELOS (GO)";"GO";"SAO LUIS DE MONTES BELOS";297;14;51;362
2008;"SAO LUIZ DO NORTE (GO)";"GO";"SAO LUIZ DO NORTE";21;3;9;33
2008;"SAO MIGUEL DO ARAGUAIA (GO)";"GO";"SAO MIGUEL DO ARAGUAIA";243;5;35;283
2008;"SAO MIGUEL DO PASSA QUATRO (GO)";"GO";"SAO MIGUEL DO PASSA QUATRO";23;1;3;27
2008;"SAO PATRICIO (GO)";"GO";"SAO PATRICIO";8;0;5;13
2008;"SAO SIMAO (GO)";"GO";"SAO SIMAO";133;11;41;185
2008;"SENADOR CANEDO (GO)";"GO";"SENADOR CANEDO";445;32;30;507
2008;"SERRANOPOLIS (GO)";"GO";"SERRANOPOLIS";82;6;19;107
2008;"SILVANIA (GO)";"GO";"SILVANIA";249;9;30;288
2008;"SIMOLANDIA (GO)";"GO";"SIMOLANDIA";80;1;7;88
2008;"SITIO D ABADIA (GO)";"GO";"SITIO D ABADIA";5;0;5;10
2008;"TAQUARAL DE GOIAS (GO)";"GO";"TAQUARAL DE GOIAS";17;4;2;23
2008;"TERESINA DE GOIAS (GO)";"GO";"TERESINA DE GOIAS";6;1;1;8
2008;"TEREZOPOLIS DE GOIAS (GO)";"GO";"TEREZOPOLIS DE GOIAS";60;3;19;82
2008;"TRES RANCHOS (GO)";"GO";"TRES RANCHOS";28;5;2;35
2008;"TRINDADE (GO)";"GO";"TRINDADE";788;28;81;897
2008;"TROMBAS (GO)";"GO";"TROMBAS";17;3;7;27
2008;"TURVANIA (GO)";"GO";"TURVANIA";53;3;4;60
2008;"TURVELANDIA (GO)";"GO";"TURVELANDIA";32;2;16;50
2008;"UIRAPURU (GO)";"GO";"UIRAPURU";10;4;4;18
2008;"URUACU (GO)";"GO";"URUACU";383;20;49;452
2008;"URUANA (GO)";"GO";"URUANA";196;3;4;203
2008;"URUTAI (GO)";"GO";"URUTAI";16;0;5;21
2008;"VALPARAISO DE GOIAS (GO)";"GO";"VALPARAISO DE GOIAS";348;188;114;650
2008;"VARJAO (GO)";"GO";"VARJAO";34;0;4;38
2008;"VIANOPOLIS (GO)";"GO";"VIANOPOLIS";326;17;16;359
2008;"VICENTINOPOLIS (GO)";"GO";"VICENTINOPOLIS";139;7;24;170
2008;"VILA BOA (GO)";"GO";"VILA BOA";10;2;1;13
2008;"VILA PROPICIO (GO)";"GO";"VILA PROPICIO";8;3;10;21
2008;"ACAILANDIA (MA)";"MA";"ACAILANDIA";771;45;96;912
2008;"AFONSO CUNHA (MA)";"MA";"AFONSO CUNHA";1;1;0;2
2008;"AGUA DOCE DO MARANHAO (MA)";"MA";"AGUA DOCE DO MARANHAO";1;1;0;2
2008;"ALCANTARA (MA)";"MA";"ALCANTARA";22;7;8;37
2008;"ALDEIAS ALTAS (MA)";"MA";"ALDEIAS ALTAS";31;3;3;37
2008;"ALTAMIRA DO MARANHAO (MA)";"MA";"ALTAMIRA DO MARANHAO";15;3;1;19
2008;"ALTO ALEGRE DO MARANHAO (MA)";"MA";"ALTO ALEGRE DO MARANHAO";30;17;0;47
2008;"ALTO ALEGRE DO PINDARE (MA)";"MA";"ALTO ALEGRE DO PINDARE";26;7;2;35
2008;"ALTO PARNAIBA (MA)";"MA";"ALTO PARNAIBA";25;1;2;28
2008;"AMAPA DO MARANHAO (MA)";"MA";"AMAPA DO MARANHAO";7;1;1;9
2008;"AMARANTE DO MARANHAO (MA)";"MA";"AMARANTE DO MARANHAO";48;1;5;54
2008;"ANAJATUBA (MA)";"MA";"ANAJATUBA";20;2;3;25
2008;"ANAPURUS (MA)";"MA";"ANAPURUS";28;1;4;33
2008;"APICUM ACU (MA)";"MA";"APICUM ACU";6;4;0;10
2008;"ARAGUANA (MA)";"MA";"ARAGUANA";2;0;1;3
2008;"ARAIOSES (MA)";"MA";"ARAIOSES";10;3;7;20
2008;"ARAME (MA)";"MA";"ARAME";68;6;0;74
2008;"ARARI (MA)";"MA";"ARARI";52;9;3;64
2008;"AXIXA (MA)";"MA";"AXIXA";11;4;2;17
2008;"BACABAL (MA)";"MA";"BACABAL";594;62;44;700
2008;"BACABEIRA (MA)";"MA";"BACABEIRA";57;0;4;61
2008;"BACURI (MA)";"MA";"BACURI";6;2;3;11
2008;"BACURITUBA (MA)";"MA";"BACURITUBA";3;0;0;3
2008;"BALSAS (MA)";"MA";"BALSAS";863;28;47;938
2008;"BARAO DE GRAJAU (MA)";"MA";"BARAO DE GRAJAU";22;1;3;26
2008;"BARRA DO CORDA (MA)";"MA";"BARRA DO CORDA";338;13;9;360
2008;"BARREIRINHAS (MA)";"MA";"BARREIRINHAS";37;5;10;52
2008;"BELA VISTA DO MARANHAO (MA)";"MA";"BELA VISTA DO MARANHAO";20;2;1;23
2008;"BELAGUA (MA)";"MA";"BELAGUA";2;4;3;9
2008;"BENEDITO LEITE (MA)";"MA";"BENEDITO LEITE";0;1;0;1
2008;"BEQUIMAO (MA)";"MA";"BEQUIMAO";55;7;7;69
2008;"BERNARDO DO MEARIM (MA)";"MA";"BERNARDO DO MEARIM";12;1;1;14
2008;"BOA VISTA DO GURUPI (MA)";"MA";"BOA VISTA DO GURUPI";3;1;1;5
2008;"BOM JARDIM (MA)";"MA";"BOM JARDIM";65;5;3;73
2008;"BOM JESUS DAS SELVAS (MA)";"MA";"BOM JESUS DAS SELVAS";55;3;2;60
2008;"BOM LUGAR (MA)";"MA";"BOM LUGAR";29;6;9;44
2008;"BREJO (MA)";"MA";"BREJO";39;10;8;57
2008;"BREJO DE AREIA (MA)";"MA";"BREJO DE AREIA";19;4;1;24
2008;"BURITI (MA)";"MA";"BURITI";10;2;13;25
2008;"BURITI BRAVO (MA)";"MA";"BURITI BRAVO";20;0;0;20
2008;"BURITICUPU (MA)";"MA";"BURITICUPU";212;24;7;243
2008;"BURITIRANA (MA)";"MA";"BURITIRANA";10;0;0;10
2008;"CACHOEIRA GRANDE (MA)";"MA";"CACHOEIRA GRANDE";3;2;1;6
2008;"CAJAPIO (MA)";"MA";"CAJAPIO";5;0;2;7
2008;"CAJARI (MA)";"MA";"CAJARI";1;0;0;1
2008;"CAMPESTRE DO MARANHAO (MA)";"MA";"CAMPESTRE DO MARANHAO";7;4;0;11
2008;"CANDIDO MENDES (MA)";"MA";"CANDIDO MENDES";11;5;2;18
2008;"CANTANHEDE (MA)";"MA";"CANTANHEDE";16;2;1;19
2008;"CAPINZAL DO NORTE (MA)";"MA";"CAPINZAL DO NORTE";18;9;1;28
2008;"CAROLINA (MA)";"MA";"CAROLINA";40;3;3;46
2008;"CARUTAPERA (MA)";"MA";"CARUTAPERA";17;3;5;25
2008;"CAXIAS (MA)";"MA";"CAXIAS";511;30;63;604
2008;"CEDRAL (MA)";"MA";"CEDRAL";5;2;3;10
2008;"CENTRAL DO MARANHAO (MA)";"MA";"CENTRAL DO MARANHAO";5;1;0;6
2008;"CENTRO DO GUILHERME (MA)";"MA";"CENTRO DO GUILHERME";5;0;1;6
2008;"CENTRO NOVO DO MARANHAO (MA)";"MA";"CENTRO NOVO DO MARANHAO";18;0;5;23
2008;"CHAPADINHA (MA)";"MA";"CHAPADINHA";216;30;8;254
2008;"CIDELANDIA (MA)";"MA";"CIDELANDIA";24;5;6;35
2008;"CODO (MA)";"MA";"CODO";396;15;14;425
2008;"COELHO NETO (MA)";"MA";"COELHO NETO";73;4;10;87
2008;"COLINAS (MA)";"MA";"COLINAS";86;5;7;98
2008;"CONCEICAO DO LAGO ACU (MA)";"MA";"CONCEICAO DO LAGO ACU";7;4;0;11
2008;"COROATA (MA)";"MA";"COROATA";126;25;4;155
2008;"CURURUPU (MA)";"MA";"CURURUPU";16;4;7;27
2008;"DAVINOPOLIS (MA)";"MA";"DAVINOPOLIS";20;1;0;21
2008;"DOM PEDRO (MA)";"MA";"DOM PEDRO";239;8;22;269
2008;"DUQUE BACELAR (MA)";"MA";"DUQUE BACELAR";0;2;4;6
2008;"ESPERANTINOPOLIS (MA)";"MA";"ESPERANTINOPOLIS";44;7;0;51
2008;"ESTREITO (MA)";"MA";"ESTREITO";23;3;1;27
2008;"FEIRA NOVA DO MARANHAO (MA)";"MA";"FEIRA NOVA DO MARANHAO";2;1;0;3
2008;"FERNANDO FALCAO (MA)";"MA";"FERNANDO FALCAO";8;0;2;10
2008;"FORMOSA DA SERRA NEGRA (MA)";"MA";"FORMOSA DA SERRA NEGRA";14;0;0;14
2008;"FORTALEZA DOS NOGUEIRAS (MA)";"MA";"FORTALEZA DOS NOGUEIRAS";29;1;2;32
2008;"FORTUNA (MA)";"MA";"FORTUNA";19;0;0;19
2008;"GODOFREDO VIANA (MA)";"MA";"GODOFREDO VIANA";4;3;2;9
2008;"GONCALVES DIAS (MA)";"MA";"GONCALVES DIAS";21;2;2;25
2008;"GOVERNADOR ARCHER (MA)";"MA";"GOVERNADOR ARCHER";12;5;2;19
2008;"GOVERNADOR EDISON LOBAO (MA)";"MA";"GOVERNADOR EDISON LOBAO";23;3;2;28
2008;"GOVERNADOR EUGENIO BARROS (MA)";"MA";"GOVERNADOR EUGENIO BARROS";20;4;5;29
2008;"GOVERNADOR LUIZ ROCHA (MA)";"MA";"GOVERNADOR LUIZ ROCHA";11;3;4;18
2008;"GOVERNADOR NEWTON BELLO (MA)";"MA";"GOVERNADOR NEWTON BELLO";14;0;1;15
2008;"GOVERNADOR NUNES FREIRE (MA)";"MA";"GOVERNADOR NUNES FREIRE";33;4;0;37
2008;"GRACA ARANHA (MA)";"MA";"GRACA ARANHA";13;4;2;19
2008;"GRAJAU (MA)";"MA";"GRAJAU";268;4;10;282
2008;"GUIMARAES (MA)";"MA";"GUIMARAES";8;1;2;11
2008;"HUMBERTO DE CAMPOS (MA)";"MA";"HUMBERTO DE CAMPOS";9;4;1;14
2008;"ICATU (MA)";"MA";"ICATU";7;2;3;12
2008;"IGARAPE DO MEIO (MA)";"MA";"IGARAPE DO MEIO";22;2;6;30
2008;"IGARAPE GRANDE (MA)";"MA";"IGARAPE GRANDE";46;11;4;61
2008;"IMPERATRIZ (MA)";"MA";"IMPERATRIZ";1979;92;215;2286
2008;"ITAIPAVA DO GRAJAU (MA)";"MA";"ITAIPAVA DO GRAJAU";14;1;0;15
2008;"ITAPECURU MIRIM (MA)";"MA";"ITAPECURU MIRIM";212;12;22;246
2008;"ITINGA DO MARANHAO (MA)";"MA";"ITINGA DO MARANHAO";67;3;1;71
2008;"JATOBA (MA)";"MA";"JATOBA";2;2;0;4
2008;"JENIPAPO DOS VIEIRAS (MA)";"MA";"JENIPAPO DOS VIEIRAS";21;0;1;22
2008;"JOAO LISBOA (MA)";"MA";"JOAO LISBOA";52;2;5;59
2008;"JOSELANDIA (MA)";"MA";"JOSELANDIA";30;4;4;38
2008;"JUNCO DO MARANHAO (MA)";"MA";"JUNCO DO MARANHAO";5;12;0;17
2008;"LAGO DA PEDRA (MA)";"MA";"LAGO DA PEDRA";190;21;4;215
2008;"LAGO DO JUNCO (MA)";"MA";"LAGO DO JUNCO";14;1;3;18
2008;"LAGO DOS RODRIGUES (MA)";"MA";"LAGO DOS RODRIGUES";25;7;2;34
2008;"LAGO VERDE (MA)";"MA";"LAGO VERDE";14;0;3;17
2008;"LAGOA DO MATO (MA)";"MA";"LAGOA DO MATO";3;0;2;5
2008;"LAGOA GRANDE DO MARANHAO (MA)";"MA";"LAGOA GRANDE DO MARANHAO";17;1;0;18
2008;"LAJEADO NOVO (MA)";"MA";"LAJEADO NOVO";13;3;0;16
2008;"LIMA CAMPOS (MA)";"MA";"LIMA CAMPOS";47;11;2;60
2008;"LORETO (MA)";"MA";"LORETO";2;2;1;5
2008;"LUIS DOMINGUES (MA)";"MA";"LUIS DOMINGUES";0;2;1;3
2008;"MAGALHAES DE ALMEIDA (MA)";"MA";"MAGALHAES DE ALMEIDA";6;2;1;9
2008;"MARACACUME (MA)";"MA";"MARACACUME";41;24;1;66
2008;"MARAJA DO SENA (MA)";"MA";"MARAJA DO SENA";10;0;0;10
2008;"MARANHAOZINHO (MA)";"MA";"MARANHAOZINHO";11;0;1;12
2008;"MATA ROMA (MA)";"MA";"MATA ROMA";25;5;4;34
2008;"MATINHA (MA)";"MA";"MATINHA";22;8;0;30
2008;"MATOES (MA)";"MA";"MATOES";12;2;2;16
2008;"MATOES DO NORTE (MA)";"MA";"MATOES DO NORTE";6;4;1;11
2008;"MILAGRES DO MARANHAO (MA)";"MA";"MILAGRES DO MARANHAO";3;2;2;7
2008;"MIRADOR (MA)";"MA";"MIRADOR";11;0;1;12
2008;"MIRANDA DO NORTE (MA)";"MA";"MIRANDA DO NORTE";67;1;4;72
2008;"MIRINZAL (MA)";"MA";"MIRINZAL";20;1;4;25
2008;"MONCAO (MA)";"MA";"MONCAO";7;3;3;13
2008;"MONTES ALTOS (MA)";"MA";"MONTES ALTOS";21;0;1;22
2008;"MORROS (MA)";"MA";"MORROS";9;3;2;14
2008;"NINA RODRIGUES (MA)";"MA";"NINA RODRIGUES";5;4;1;10
2008;"NOVA COLINAS (MA)";"MA";"NOVA COLINAS";5;0;3;8
2008;"NOVA IORQUE (MA)";"MA";"NOVA IORQUE";4;0;0;4
2008;"NOVA OLINDA DO MARANHAO (MA)";"MA";"NOVA OLINDA DO MARANHAO";27;13;1;41
2008;"OLHO D AGUA DAS CUNHAS (MA)";"MA";"OLHO D AGUA DAS CUNHAS";53;9;6;68
2008;"OLINDA NOVA DO MARANHAO (MA)";"MA";"OLINDA NOVA DO MARANHAO";9;1;0;10
2008;"PACO DO LUMIAR (MA)";"MA";"PACO DO LUMIAR";244;85;72;401
2008;"PALMEIRANDIA (MA)";"MA";"PALMEIRANDIA";7;1;5;13
2008;"PARAIBANO (MA)";"MA";"PARAIBANO";24;5;2;31
2008;"PARNARAMA (MA)";"MA";"PARNARAMA";19;1;0;20
2008;"PASSAGEM FRANCA (MA)";"MA";"PASSAGEM FRANCA";15;1;1;17
2008;"PASTOS BONS (MA)";"MA";"PASTOS BONS";39;3;1;43
2008;"PAULINO NEVES (MA)";"MA";"PAULINO NEVES";0;0;0;0
2008;"PAULO RAMOS (MA)";"MA";"PAULO RAMOS";40;5;0;45
2008;"PEDREIRAS (MA)";"MA";"PEDREIRAS";242;36;22;300
2008;"PEDRO DO ROSARIO (MA)";"MA";"PEDRO DO ROSARIO";10;1;1;12
2008;"PENALVA (MA)";"MA";"PENALVA";8;2;1;11
2008;"PERI MIRIM (MA)";"MA";"PERI MIRIM";16;6;4;26
2008;"PERITORO (MA)";"MA";"PERITORO";27;33;6;66
2008;"PINDARE MIRIM (MA)";"MA";"PINDARE MIRIM";81;5;14;100
2008;"PINHEIRO (MA)";"MA";"PINHEIRO";288;21;43;352
2008;"PIO XII (MA)";"MA";"PIO XII";76;3;1;80
2008;"PIRAPEMAS (MA)";"MA";"PIRAPEMAS";9;5;2;16
2008;"POCAO DE PEDRAS (MA)";"MA";"POCAO DE PEDRAS";31;12;3;46
2008;"PORTO FRANCO (MA)";"MA";"PORTO FRANCO";27;1;3;31
2008;"PORTO RICO DO MARANHAO (MA)";"MA";"PORTO RICO DO MARANHAO";2;0;1;3
2008;"PRESIDENTE DUTRA (MA)";"MA";"PRESIDENTE DUTRA";243;11;8;262
2008;"PRESIDENTE JUSCELINO (MA)";"MA";"PRESIDENTE JUSCELINO";5;1;3;9
2008;"PRESIDENTE MEDICI (MA)";"MA";"PRESIDENTE MEDICI";3;4;0;7
2008;"PRESIDENTE SARNEY (MA)";"MA";"PRESIDENTE SARNEY";1;1;1;3
2008;"PRESIDENTE VARGAS (MA)";"MA";"PRESIDENTE VARGAS";17;4;1;22
2008;"PRIMEIRA CRUZ (MA)";"MA";"PRIMEIRA CRUZ";0;0;0;0
2008;"RAPOSA (MA)";"MA";"RAPOSA";35;2;25;62
2008;"RIACHAO (MA)";"MA";"RIACHAO";22;1;2;25
2008;"RIBAMAR FIQUENE (MA)";"MA";"RIBAMAR FIQUENE";5;1;1;7
2008;"ROSARIO (MA)";"MA";"ROSARIO";138;15;27;180
2008;"SAMBAIBA (MA)";"MA";"SAMBAIBA";8;0;0;8
2008;"SANTA FILOMENA DO MARANHAO (MA)";"MA";"SANTA FILOMENA DO MARANHAO";1;3;0;4
2008;"SANTA HELENA (MA)";"MA";"SANTA HELENA";49;3;2;54
2008;"SANTA INES (MA)";"MA";"SANTA INES";433;98;75;606
2008;"SANTA LUZIA (MA)";"MA";"SANTA LUZIA";189;65;7;261
2008;"SANTA LUZIA DO PARUA (MA)";"MA";"SANTA LUZIA DO PARUA";76;7;5;88
2008;"SANTA QUITERIA DO MARANHAO (MA)";"MA";"SANTA QUITERIA DO MARANHAO";15;1;6;22
2008;"SANTA RITA (MA)";"MA";"SANTA RITA";82;6;3;91
2008;"SANTANA DO MARANHAO (MA)";"MA";"SANTANA DO MARANHAO";6;0;2;8
2008;"SANTO AMARO DO MARANHAO (MA)";"MA";"SANTO AMARO DO MARANHAO";0;3;1;4
2008;"SANTO ANTONIO DOS LOPES (MA)";"MA";"SANTO ANTONIO DOS LOPES";57;6;0;63
2008;"SAO BENEDITO DO RIO PRETO (MA)";"MA";"SAO BENEDITO DO RIO PRETO";11;8;2;21
2008;"SAO BENTO (MA)";"MA";"SAO BENTO";64;14;7;85
2008;"SAO BERNARDO (MA)";"MA";"SAO BERNARDO";44;0;6;50
2008;"SAO DOMINGOS DO AZEITAO (MA)";"MA";"SAO DOMINGOS DO AZEITAO";10;0;1;11
2008;"SAO DOMINGOS DO MARANHAO (MA)";"MA";"SAO DOMINGOS DO MARANHAO";101;2;1;104
2008;"SAO FELIX DE BALSAS (MA)";"MA";"SAO FELIX DE BALSAS";4;0;0;4
2008;"SAO FRANCISCO DO BREJAO (MA)";"MA";"SAO FRANCISCO DO BREJAO";34;1;2;37
2008;"SAO FRANCISCO DO MARANHAO (MA)";"MA";"SAO FRANCISCO DO MARANHAO";2;0;0;2
2008;"SAO JOAO BATISTA (MA)";"MA";"SAO JOAO BATISTA";27;3;3;33
2008;"SAO JOAO DO CARU (MA)";"MA";"SAO JOAO DO CARU";13;1;0;14
2008;"SAO JOAO DO PARAISO (MA)";"MA";"SAO JOAO DO PARAISO";2;0;1;3
2008;"SAO JOAO DO SOTER (MA)";"MA";"SAO JOAO DO SOTER";7;1;0;8
2008;"SAO JOAO DOS PATOS (MA)";"MA";"SAO JOAO DOS PATOS";93;0;3;96
2008;"SAO JOSE DE RIBAMAR (MA)";"MA";"SAO JOSE DE RIBAMAR";366;105;53;524
2008;"SAO JOSE DOS BASILIOS (MA)";"MA";"SAO JOSE DOS BASILIOS";7;1;1;9
2008;"SAO LUIS (MA)";"MA";"SAO LUIS";5893;972;2641;9506
2008;"SAO LUIS GONZAGA DO MARANHAO (MA)";"MA";"SAO LUIS GONZAGA DO MARANHAO";22;5;1;28
2008;"SAO MATEUS DO MARANHAO (MA)";"MA";"SAO MATEUS DO MARANHAO";70;36;15;121
2008;"SAO PEDRO DA AGUA BRANCA (MA)";"MA";"SAO PEDRO DA AGUA BRANCA";12;0;1;13
2008;"SAO PEDRO DOS CRENTES (MA)";"MA";"SAO PEDRO DOS CRENTES";5;1;1;7
2008;"SAO RAIMUNDO DAS MANGABEIRAS (MA)";"MA";"SAO RAIMUNDO DAS MANGABEIRAS";68;1;30;99
2008;"SAO RAIMUNDO DO DOCA BEZERRA (MA)";"MA";"SAO RAIMUNDO DO DOCA BEZERRA";11;0;0;11
2008;"SAO ROBERTO (MA)";"MA";"SAO ROBERTO";7;3;1;11
2008;"SAO VICENTE FERRER (MA)";"MA";"SAO VICENTE FERRER";15;2;4;21
2008;"SATUBINHA (MA)";"MA";"SATUBINHA";17;2;0;19
2008;"SENADOR ALEXANDRE COSTA (MA)";"MA";"SENADOR ALEXANDRE COSTA";14;3;1;18
2008;"SENADOR LA ROCQUE (MA)";"MA";"SENADOR LA ROCQUE";27;0;1;28
2008;"SERRANO DO MARANHAO (MA)";"MA";"SERRANO DO MARANHAO";1;0;1;2
2008;"SITIO NOVO (MA)";"MA";"SITIO NOVO";20;0;1;21
2008;"SUCUPIRA DO NORTE (MA)";"MA";"SUCUPIRA DO NORTE";13;1;2;16
2008;"SUCUPIRA DO RIACHAO (MA)";"MA";"SUCUPIRA DO RIACHAO";3;1;1;5
2008;"TASSO FRAGOSO (MA)";"MA";"TASSO FRAGOSO";21;1;2;24
2008;"TIMBIRAS (MA)";"MA";"TIMBIRAS";20;5;0;25
2008;"TIMON (MA)";"MA";"TIMON";405;22;29;456
2008;"TRIZIDELA DO VALE (MA)";"MA";"TRIZIDELA DO VALE";81;15;4;100
2008;"TUFILANDIA (MA)";"MA";"TUFILANDIA";5;5;0;10
2008;"TUNTUM (MA)";"MA";"TUNTUM";67;2;3;72
2008;"TURIACU (MA)";"MA";"TURIACU";19;1;5;25
2008;"TURILANDIA (MA)";"MA";"TURILANDIA";9;4;1;14
2008;"TUTOIA (MA)";"MA";"TUTOIA";21;3;3;27
2008;"URBANO SANTOS (MA)";"MA";"URBANO SANTOS";30;3;4;37
2008;"VARGEM GRANDE (MA)";"MA";"VARGEM GRANDE";73;2;2;77
2008;"VIANA (MA)";"MA";"VIANA";98;3;3;104
2008;"VILA NOVA DOS MARTIRIOS (MA)";"MA";"VILA NOVA DOS MARTIRIOS";13;1;0;14
2008;"VITORIA DO MEARIM (MA)";"MA";"VITORIA DO MEARIM";52;4;3;59
2008;"VITORINO FREIRE (MA)";"MA";"VITORINO FREIRE";97;4;3;104
2008;"ZE DOCA (MA)";"MA";"ZE DOCA";131;16;12;159
2008;"ABADIA DOS DOURADOS (MG)";"MG";"ABADIA DOS DOURADOS";80;23;5;108
2008;"ABAETE (MG)";"MG";"ABAETE";412;16;133;561
2008;"ABRE CAMPO (MG)";"MG";"ABRE CAMPO";126;10;43;179
2008;"ACAIACA (MG)";"MG";"ACAIACA";16;6;6;28
2008;"ACUCENA (MG)";"MG";"ACUCENA";24;9;26;59
2008;"AGUA BOA (MG)";"MG";"AGUA BOA";48;2;19;69
2008;"AGUA COMPRIDA (MG)";"MG";"AGUA COMPRIDA";35;7;6;48
2008;"AGUANIL (MG)";"MG";"AGUANIL";30;5;6;41
2008;"AGUAS FORMOSAS (MG)";"MG";"AGUAS FORMOSAS";68;15;23;106
2008;"AGUAS VERMELHAS (MG)";"MG";"AGUAS VERMELHAS";62;7;10;79
2008;"AIMORES (MG)";"MG";"AIMORES";163;11;22;196
2008;"AIURUOCA (MG)";"MG";"AIURUOCA";72;11;9;92
2008;"ALAGOA (MG)";"MG";"ALAGOA";17;0;9;26
2008;"ALBERTINA (MG)";"MG";"ALBERTINA";33;11;4;48
2008;"ALEM PARAIBA (MG)";"MG";"ALEM PARAIBA";1163;61;64;1288
2008;"ALFENAS (MG)";"MG";"ALFENAS";930;60;206;1196
2008;"ALFREDO VASCONCELOS (MG)";"MG";"ALFREDO VASCONCELOS";124;11;17;152
2008;"ALMENARA (MG)";"MG";"ALMENARA";174;22;75;271
2008;"ALPERCATA (MG)";"MG";"ALPERCATA";50;1;4;55
2008;"ALPINOPOLIS (MG)";"MG";"ALPINOPOLIS";377;15;22;414
2008;"ALTEROSA (MG)";"MG";"ALTEROSA";202;21;25;248
2008;"ALTO CAPARAO (MG)";"MG";"ALTO CAPARAO";50;6;3;59
2008;"ALTO JEQUITIBA (MG)";"MG";"ALTO JEQUITIBA";52;6;9;67
2008;"ALTO RIO DOCE (MG)";"MG";"ALTO RIO DOCE";80;9;18;107
2008;"ALVARENGA (MG)";"MG";"ALVARENGA";26;0;8;34
2008;"ALVINOPOLIS (MG)";"MG";"ALVINOPOLIS";138;14;18;170
2008;"ALVORADA DE MINAS (MG)";"MG";"ALVORADA DE MINAS";5;4;6;15
2008;"AMPARO DA SERRA (MG)";"MG";"AMPARO DA SERRA";30;4;19;53
2008;"ANDRADAS (MG)";"MG";"ANDRADAS";846;56;71;973
2008;"ANDRELANDIA (MG)";"MG";"ANDRELANDIA";113;25;16;154
2008;"ANGELANDIA (MG)";"MG";"ANGELANDIA";43;1;11;55
2008;"ANTONIO CARLOS (MG)";"MG";"ANTONIO CARLOS";129;11;17;157
2008;"ANTONIO DIAS (MG)";"MG";"ANTONIO DIAS";74;7;35;116
2008;"ANTONIO PRADO DE MINAS (MG)";"MG";"ANTONIO PRADO DE MINAS";11;2;4;17
2008;"ARACAI (MG)";"MG";"ARACAI";13;3;5;21
2008;"ARACITABA (MG)";"MG";"ARACITABA";10;2;1;13
2008;"ARACUAI (MG)";"MG";"ARACUAI";165;9;60;234
2008;"ARAGUARI (MG)";"MG";"ARAGUARI";1773;257;146;2176
2008;"ARANTINA (MG)";"MG";"ARANTINA";22;1;2;25
2008;"ARAPONGA (MG)";"MG";"ARAPONGA";43;6;7;56
2008;"ARAPORA (MG)";"MG";"ARAPORA";149;12;70;231
2008;"ARAPUA (MG)";"MG";"ARAPUA";37;2;11;50
2008;"ARAUJOS (MG)";"MG";"ARAUJOS";92;7;4;103
2008;"ARAXA (MG)";"MG";"ARAXA";1337;113;235;1685
2008;"ARCEBURGO (MG)";"MG";"ARCEBURGO";83;20;34;137
2008;"ARCOS (MG)";"MG";"ARCOS";947;60;216;1223
2008;"AREADO (MG)";"MG";"AREADO";191;11;70;272
2008;"ARGIRITA (MG)";"MG";"ARGIRITA";20;4;4;28
2008;"ARICANDUVA (MG)";"MG";"ARICANDUVA";9;3;9;21
2008;"ARINOS (MG)";"MG";"ARINOS";148;13;39;200
2008;"ASTOLFO DUTRA (MG)";"MG";"ASTOLFO DUTRA";184;8;16;208
2008;"ATALEIA (MG)";"MG";"ATALEIA";56;15;17;88
2008;"AUGUSTO DE LIMA (MG)";"MG";"AUGUSTO DE LIMA";25;3;11;39
2008;"BAEPENDI (MG)";"MG";"BAEPENDI";315;27;22;364
2008;"BALDIM (MG)";"MG";"BALDIM";128;5;7;140
2008;"BAMBUI (MG)";"MG";"BAMBUI";361;21;74;456
2008;"BANDEIRA (MG)";"MG";"BANDEIRA";3;2;2;7
2008;"BANDEIRA DO SUL (MG)";"MG";"BANDEIRA DO SUL";125;15;5;145
2008;"BARAO DE COCAIS (MG)";"MG";"BARAO DE COCAIS";377;44;48;469
2008;"BARAO DE MONTE ALTO (MG)";"MG";"BARAO DE MONTE ALTO";16;2;5;23
2008;"BARBACENA (MG)";"MG";"BARBACENA";1361;254;181;1796
2008;"BARRA LONGA (MG)";"MG";"BARRA LONGA";46;6;7;59
2008;"BARROSO (MG)";"MG";"BARROSO";364;23;19;406
2008;"BELA VISTA DE MINAS (MG)";"MG";"BELA VISTA DE MINAS";121;11;9;141
2008;"BELMIRO BRAGA (MG)";"MG";"BELMIRO BRAGA";42;6;3;51
2008;"BELO HORIZONTE (MG)";"MG";"BELO HORIZONTE";27871;4317;7551;39739
2008;"BELO ORIENTE (MG)";"MG";"BELO ORIENTE";219;92;76;387
2008;"BELO VALE (MG)";"MG";"BELO VALE";87;13;18;118
2008;"BERILO (MG)";"MG";"BERILO";43;5;21;69
2008;"BERIZAL (MG)";"MG";"BERIZAL";14;2;5;21
2008;"BERTOPOLIS (MG)";"MG";"BERTOPOLIS";9;3;2;14
2008;"BETIM (MG)";"MG";"BETIM";3475;425;986;4886
2008;"BIAS FORTES (MG)";"MG";"BIAS FORTES";19;4;3;26
2008;"BICAS (MG)";"MG";"BICAS";196;28;25;249
2008;"BIQUINHAS (MG)";"MG";"BIQUINHAS";37;8;2;47
2008;"BOA ESPERANCA (MG)";"MG";"BOA ESPERANCA";512;36;125;673
2008;"BOCAINA DE MINAS (MG)";"MG";"BOCAINA DE MINAS";42;10;6;58
2008;"BOCAIUVA (MG)";"MG";"BOCAIUVA";331;28;110;469
2008;"BOM DESPACHO (MG)";"MG";"BOM DESPACHO";841;49;283;1173
2008;"BOM JARDIM DE MINAS (MG)";"MG";"BOM JARDIM DE MINAS";79;7;12;98
2008;"BOM JESUS DA PENHA (MG)";"MG";"BOM JESUS DA PENHA";103;7;7;117
2008;"BOM JESUS DO AMPARO (MG)";"MG";"BOM JESUS DO AMPARO";59;7;9;75
2008;"BOM JESUS DO GALHO (MG)";"MG";"BOM JESUS DO GALHO";67;4;13;84
2008;"BOM REPOUSO (MG)";"MG";"BOM REPOUSO";156;12;4;172
2008;"BOM SUCESSO (MG)";"MG";"BOM SUCESSO";201;17;33;251
2008;"BONFIM (MG)";"MG";"BONFIM";93;14;14;121
2008;"BONFINOPOLIS DE MINAS (MG)";"MG";"BONFINOPOLIS DE MINAS";71;1;20;92
2008;"BONITO DE MINAS (MG)";"MG";"BONITO DE MINAS";14;3;13;30
2008;"BORDA DA MATA (MG)";"MG";"BORDA DA MATA";225;16;53;294
2008;"BOTELHOS (MG)";"MG";"BOTELHOS";220;35;24;279
2008;"BOTUMIRIM (MG)";"MG";"BOTUMIRIM";12;1;6;19
2008;"BRAS PIRES (MG)";"MG";"BRAS PIRES";30;7;6;43
2008;"BRASILANDIA DE MINAS (MG)";"MG";"BRASILANDIA DE MINAS";178;6;72;256
2008;"BRASILIA DE MINAS (MG)";"MG";"BRASILIA DE MINAS";145;6;57;208
2008;"BRASOPOLIS (MG)";"MG";"BRASOPOLIS";167;22;23;212
2008;"BRAUNAS (MG)";"MG";"BRAUNAS";10;5;12;27
2008;"BRUMADINHO (MG)";"MG";"BRUMADINHO";712;90;199;1001
2008;"BUENO BRANDAO (MG)";"MG";"BUENO BRANDAO";159;28;21;208
2008;"BUENOPOLIS (MG)";"MG";"BUENOPOLIS";84;3;23;110
2008;"BUGRE (MG)";"MG";"BUGRE";18;1;4;23
2008;"BURITIS (MG)";"MG";"BURITIS";218;7;75;300
2008;"BURITIZEIRO (MG)";"MG";"BURITIZEIRO";188;4;72;264
2008;"CABECEIRA GRANDE (MG)";"MG";"CABECEIRA GRANDE";21;0;8;29
2008;"CABO VERDE (MG)";"MG";"CABO VERDE";173;12;20;205
2008;"CACHOEIRA DA PRATA (MG)";"MG";"CACHOEIRA DA PRATA";50;3;2;55
2008;"CACHOEIRA DE MINAS (MG)";"MG";"CACHOEIRA DE MINAS";102;20;8;130
2008;"CACHOEIRA DE PAJEU (MG)";"MG";"CACHOEIRA DE PAJEU";30;8;12;50
2008;"CACHOEIRA DOURADA (MG)";"MG";"CACHOEIRA DOURADA";23;9;3;35
2008;"CAETANOPOLIS (MG)";"MG";"CAETANOPOLIS";95;12;34;141
2008;"CAETE (MG)";"MG";"CAETE";456;55;59;570
2008;"CAIANA (MG)";"MG";"CAIANA";30;6;7;43
2008;"CAJURI (MG)";"MG";"CAJURI";34;5;6;45
2008;"CALDAS (MG)";"MG";"CALDAS";228;18;25;271
2008;"CAMACHO (MG)";"MG";"CAMACHO";49;4;5;58
2008;"CAMANDUCAIA (MG)";"MG";"CAMANDUCAIA";422;33;31;486
2008;"CAMBUI (MG)";"MG";"CAMBUI";439;29;84;552
2008;"CAMBUQUIRA (MG)";"MG";"CAMBUQUIRA";108;18;9;135
2008;"CAMPANARIO (MG)";"MG";"CAMPANARIO";11;6;4;21
2008;"CAMPANHA (MG)";"MG";"CAMPANHA";193;22;20;235
2008;"CAMPESTRE (MG)";"MG";"CAMPESTRE";393;30;38;461
2008;"CAMPINA VERDE (MG)";"MG";"CAMPINA VERDE";243;18;40;301
2008;"CAMPO AZUL (MG)";"MG";"CAMPO AZUL";5;2;3;10
2008;"CAMPO BELO (MG)";"MG";"CAMPO BELO";1013;54;102;1169
2008;"CAMPO DO MEIO (MG)";"MG";"CAMPO DO MEIO";109;14;47;170
2008;"CAMPO FLORIDO (MG)";"MG";"CAMPO FLORIDO";104;22;50;176
2008;"CAMPOS ALTOS (MG)";"MG";"CAMPOS ALTOS";274;12;50;336
2008;"CAMPOS GERAIS (MG)";"MG";"CAMPOS GERAIS";276;12;50;338
2008;"CANA VERDE (MG)";"MG";"CANA VERDE";52;5;6;63
2008;"CANAA (MG)";"MG";"CANAA";51;5;9;65
2008;"CANAPOLIS (MG)";"MG";"CANAPOLIS";166;10;90;266
2008;"CANDEIAS (MG)";"MG";"CANDEIAS";207;14;25;246
2008;"CANTAGALO (MG)";"MG";"CANTAGALO";12;2;6;20
2008;"CAPARAO (MG)";"MG";"CAPARAO";42;2;3;47
2008;"CAPELA NOVA (MG)";"MG";"CAPELA NOVA";14;13;2;29
2008;"CAPELINHA (MG)";"MG";"CAPELINHA";533;26;121;680
2008;"CAPETINGA (MG)";"MG";"CAPETINGA";152;12;23;187
2008;"CAPIM BRANCO (MG)";"MG";"CAPIM BRANCO";60;10;14;84
2008;"CAPINOPOLIS (MG)";"MG";"CAPINOPOLIS";218;22;65;305
2008;"CAPITAO ANDRADE (MG)";"MG";"CAPITAO ANDRADE";25;5;2;32
2008;"CAPITAO ENEAS (MG)";"MG";"CAPITAO ENEAS";51;2;17;70
2008;"CAPITOLIO (MG)";"MG";"CAPITOLIO";126;18;13;157
2008;"CAPUTIRA (MG)";"MG";"CAPUTIRA";101;1;22;124
2008;"CARAI (MG)";"MG";"CARAI";40;23;30;93
2008;"CARANAIBA (MG)";"MG";"CARANAIBA";14;4;8;26
2008;"CARANDAI (MG)";"MG";"CARANDAI";418;26;80;524
2008;"CARANGOLA (MG)";"MG";"CARANGOLA";315;30;39;384
2008;"CARATINGA (MG)";"MG";"CARATINGA";986;50;798;1834
2008;"CARBONITA (MG)";"MG";"CARBONITA";147;7;32;186
2008;"CAREACU (MG)";"MG";"CAREACU";76;6;4;86
2008;"CARLOS CHAGAS (MG)";"MG";"CARLOS CHAGAS";119;28;36;183
2008;"CARMESIA (MG)";"MG";"CARMESIA";57;0;1095;1152
2008;"CARMO DA CACHOEIRA (MG)";"MG";"CARMO DA CACHOEIRA";139;23;39;201
2008;"CARMO DA MATA (MG)";"MG";"CARMO DA MATA";118;12;37;167
2008;"CARMO DE MINAS (MG)";"MG";"CARMO DE MINAS";122;20;14;156
2008;"CARMO DO CAJURU (MG)";"MG";"CARMO DO CAJURU";274;27;59;360
2008;"CARMO DO PARANAIBA (MG)";"MG";"CARMO DO PARANAIBA";500;44;80;624
2008;"CARMO DO RIO CLARO (MG)";"MG";"CARMO DO RIO CLARO";268;13;56;337
2008;"CARMOPOLIS DE MINAS (MG)";"MG";"CARMOPOLIS DE MINAS";463;19;23;505
2008;"CARNEIRINHO (MG)";"MG";"CARNEIRINHO";154;18;58;230
2008;"CARRANCAS (MG)";"MG";"CARRANCAS";39;7;10;56
2008;"CARVALHOPOLIS (MG)";"MG";"CARVALHOPOLIS";29;10;4;43
2008;"CARVALHOS (MG)";"MG";"CARVALHOS";48;6;5;59
2008;"CASA GRANDE (MG)";"MG";"CASA GRANDE";23;3;1;27
2008;"CASCALHO RICO (MG)";"MG";"CASCALHO RICO";44;14;2;60
2008;"CASSIA (MG)";"MG";"CASSIA";349;22;24;395
2008;"CATAGUASES (MG)";"MG";"CATAGUASES";583;62;144;789
2008;"CATAS ALTAS (MG)";"MG";"CATAS ALTAS";106;8;6;120
2008;"CATAS ALTAS DA NORUEGA (MG)";"MG";"CATAS ALTAS DA NORUEGA";28;2;5;35
2008;"CATUJI (MG)";"MG";"CATUJI";33;11;10;54
2008;"CATUTI (MG)";"MG";"CATUTI";12;6;13;31
2008;"CAXAMBU (MG)";"MG";"CAXAMBU";194;28;19;241
2008;"CEDRO DO ABAETE (MG)";"MG";"CEDRO DO ABAETE";9;1;2;12
2008;"CENTRAL DE MINAS (MG)";"MG";"CENTRAL DE MINAS";69;8;9;86
2008;"CENTRALINA (MG)";"MG";"CENTRALINA";86;3;14;103
2008;"CHACARA (MG)";"MG";"CHACARA";24;7;2;33
2008;"CHALE (MG)";"MG";"CHALE";39;7;7;53
2008;"CHAPADA DO NORTE (MG)";"MG";"CHAPADA DO NORTE";35;6;13;54
2008;"CHAPADA GAUCHA (MG)";"MG";"CHAPADA GAUCHA";67;3;7;77
2008;"CHIADOR (MG)";"MG";"CHIADOR";40;7;5;52
2008;"CIPOTANEA (MG)";"MG";"CIPOTANEA";30;1;5;36
2008;"CLARAVAL (MG)";"MG";"CLARAVAL";149;4;30;183
2008;"CLARO DOS POCOES (MG)";"MG";"CLARO DOS POCOES";25;2;15;42
2008;"CLAUDIO (MG)";"MG";"CLAUDIO";599;26;49;674
2008;"COIMBRA (MG)";"MG";"COIMBRA";86;3;8;97
2008;"COLUNA (MG)";"MG";"COLUNA";27;1;10;38
2008;"COMENDADOR GOMES (MG)";"MG";"COMENDADOR GOMES";32;4;5;41
2008;"COMERCINHO (MG)";"MG";"COMERCINHO";20;6;8;34
2008;"CONCEICAO DA APARECIDA (MG)";"MG";"CONCEICAO DA APARECIDA";116;6;8;130
2008;"CONCEICAO DA BARRA DE MINAS (MG)";"MG";"CONCEICAO DA BARRA DE MINAS";28;6;4;38
2008;"CONCEICAO DAS ALAGOAS (MG)";"MG";"CONCEICAO DAS ALAGOAS";410;13;88;511
2008;"CONCEICAO DAS PEDRAS (MG)";"MG";"CONCEICAO DAS PEDRAS";18;9;2;29
2008;"CONCEICAO DE IPANEMA (MG)";"MG";"CONCEICAO DE IPANEMA";27;5;2;34
2008;"CONCEICAO DO MATO DENTRO (MG)";"MG";"CONCEICAO DO MATO DENTRO";81;8;98;187
2008;"CONCEICAO DO PARA (MG)";"MG";"CONCEICAO DO PARA";57;11;13;81
2008;"CONCEICAO DO RIO VERDE (MG)";"MG";"CONCEICAO DO RIO VERDE";187;30;15;232
2008;"CONCEICAO DOS OUROS (MG)";"MG";"CONCEICAO DOS OUROS";272;25;8;305
2008;"CONEGO MARINHO (MG)";"MG";"CONEGO MARINHO";8;3;7;18
2008;"CONFINS (MG)";"MG";"CONFINS";80;15;9;104
2008;"CONGONHAL (MG)";"MG";"CONGONHAL";178;7;13;198
2008;"CONGONHAS (MG)";"MG";"CONGONHAS";711;89;94;894
2008;"CONGONHAS DO NORTE (MG)";"MG";"CONGONHAS DO NORTE";27;3;3;33
2008;"CONQUISTA (MG)";"MG";"CONQUISTA";159;14;31;204
2008;"CONSELHEIRO LAFAIETE (MG)";"MG";"CONSELHEIRO LAFAIETE";1032;183;457;1672
2008;"CONSELHEIRO PENA (MG)";"MG";"CONSELHEIRO PENA";163;4;44;211
2008;"CONSOLACAO (MG)";"MG";"CONSOLACAO";11;6;0;17
2008;"CONTAGEM (MG)";"MG";"CONTAGEM";10151;1154;2129;13434
2008;"COQUEIRAL (MG)";"MG";"COQUEIRAL";79;9;10;98
2008;"CORACAO DE JESUS (MG)";"MG";"CORACAO DE JESUS";120;4;70;194
2008;"CORDISBURGO (MG)";"MG";"CORDISBURGO";67;7;7;81
2008;"CORDISLANDIA (MG)";"MG";"CORDISLANDIA";45;3;2;50
2008;"CORINTO (MG)";"MG";"CORINTO";257;5;53;315
2008;"COROACI (MG)";"MG";"COROACI";35;5;7;47
2008;"COROMANDEL (MG)";"MG";"COROMANDEL";482;36;75;593
2008;"CORONEL FABRICIANO (MG)";"MG";"CORONEL FABRICIANO";941;128;437;1506
2008;"CORONEL MURTA (MG)";"MG";"CORONEL MURTA";14;2;8;24
2008;"CORONEL PACHECO (MG)";"MG";"CORONEL PACHECO";30;6;7;43
2008;"CORONEL XAVIER CHAVES (MG)";"MG";"CORONEL XAVIER CHAVES";66;5;2;73
2008;"CORREGO DANTA (MG)";"MG";"CORREGO DANTA";24;4;6;34
2008;"CORREGO DO BOM JESUS (MG)";"MG";"CORREGO DO BOM JESUS";31;5;6;42
2008;"CORREGO FUNDO (MG)";"MG";"CORREGO FUNDO";287;11;17;315
2008;"CORREGO NOVO (MG)";"MG";"CORREGO NOVO";11;4;6;21
2008;"COUTO DE MAGALHAES DE MINAS (MG)";"MG";"COUTO DE MAGALHAES DE MINAS";27;1;8;36
2008;"CRISOLITA (MG)";"MG";"CRISOLITA";3;5;8;16
2008;"CRISTAIS (MG)";"MG";"CRISTAIS";128;5;9;142
2008;"CRISTALIA (MG)";"MG";"CRISTALIA";19;4;12;35
2008;"CRISTIANO OTONI (MG)";"MG";"CRISTIANO OTONI";66;10;8;84
2008;"CRISTINA (MG)";"MG";"CRISTINA";74;15;6;95
2008;"CRUCILANDIA (MG)";"MG";"CRUCILANDIA";122;4;9;135
2008;"CRUZEIRO DA FORTALEZA (MG)";"MG";"CRUZEIRO DA FORTALEZA";49;5;11;65
2008;"CRUZILIA (MG)";"MG";"CRUZILIA";261;15;17;293
2008;"CUPARAQUE (MG)";"MG";"CUPARAQUE";28;7;3;38
2008;"CURRAL DE DENTRO (MG)";"MG";"CURRAL DE DENTRO";35;4;6;45
2008;"CURVELO (MG)";"MG";"CURVELO";953;33;1528;2514
2008;"DATAS (MG)";"MG";"DATAS";23;5;10;38
2008;"DELFIM MOREIRA (MG)";"MG";"DELFIM MOREIRA";66;5;16;87
2008;"DELFINOPOLIS (MG)";"MG";"DELFINOPOLIS";67;9;7;83
2008;"DELTA (MG)";"MG";"DELTA";390;22;116;528
2008;"DESCOBERTO (MG)";"MG";"DESCOBERTO";23;6;1;30
2008;"DESTERRO DE ENTRE RIOS (MG)";"MG";"DESTERRO DE ENTRE RIOS";87;14;16;117
2008;"DESTERRO DO MELO (MG)";"MG";"DESTERRO DO MELO";25;2;7;34
2008;"DIAMANTINA (MG)";"MG";"DIAMANTINA";259;51;281;591
2008;"DIOGO DE VASCONCELOS (MG)";"MG";"DIOGO DE VASCONCELOS";16;2;7;25
2008;"DIONISIO (MG)";"MG";"DIONISIO";40;4;17;61
2008;"DIVINESIA (MG)";"MG";"DIVINESIA";53;8;4;65
2008;"DIVINO (MG)";"MG";"DIVINO";202;13;34;249
2008;"DIVINO DAS LARANJEIRAS (MG)";"MG";"DIVINO DAS LARANJEIRAS";26;0;4;30
2008;"DIVINOLANDIA DE MINAS (MG)";"MG";"DIVINOLANDIA DE MINAS";50;4;16;70
2008;"DIVINOPOLIS (MG)";"MG";"DIVINOPOLIS";2866;205;649;3720
2008;"DIVISA ALEGRE (MG)";"MG";"DIVISA ALEGRE";32;3;5;40
2008;"DIVISA NOVA (MG)";"MG";"DIVISA NOVA";58;10;13;81
2008;"DIVISOPOLIS (MG)";"MG";"DIVISOPOLIS";13;7;8;28
2008;"DOM BOSCO (MG)";"MG";"DOM BOSCO";16;1;8;25
2008;"DOM CAVATI (MG)";"MG";"DOM CAVATI";126;2;5;133
2008;"DOM JOAQUIM (MG)";"MG";"DOM JOAQUIM";6;4;4;14
2008;"DOM SILVERIO (MG)";"MG";"DOM SILVERIO";48;8;5;61
2008;"DOM VICOSO (MG)";"MG";"DOM VICOSO";25;12;5;42
2008;"DONA EUZEBIA (MG)";"MG";"DONA EUZEBIA";239;6;2;247
2008;"DORES DE CAMPOS (MG)";"MG";"DORES DE CAMPOS";61;6;20;87
2008;"DORES DE GUANHAES (MG)";"MG";"DORES DE GUANHAES";32;3;17;52
2008;"DORES DO INDAIA (MG)";"MG";"DORES DO INDAIA";182;19;25;226
2008;"DORES DO TURVO (MG)";"MG";"DORES DO TURVO";36;3;10;49
2008;"DORESOPOLIS (MG)";"MG";"DORESOPOLIS";10;8;1;19
2008;"DOURADOQUARA (MG)";"MG";"DOURADOQUARA";26;6;1;33
2008;"DURANDE (MG)";"MG";"DURANDE";76;4;7;87
2008;"ELOI MENDES (MG)";"MG";"ELOI MENDES";456;41;21;518
2008;"ENGENHEIRO CALDAS (MG)";"MG";"ENGENHEIRO CALDAS";110;8;6;124
2008;"ENGENHEIRO NAVARRO (MG)";"MG";"ENGENHEIRO NAVARRO";38;1;15;54
2008;"ENTRE FOLHAS (MG)";"MG";"ENTRE FOLHAS";50;2;4;56
2008;"ENTRE RIOS DE MINAS (MG)";"MG";"ENTRE RIOS DE MINAS";244;15;51;310
2008;"ERVALIA (MG)";"MG";"ERVALIA";232;7;23;262
2008;"ESMERALDAS (MG)";"MG";"ESMERALDAS";338;27;224;589
2008;"ESPERA FELIZ (MG)";"MG";"ESPERA FELIZ";252;23;30;305
2008;"ESPINOSA (MG)";"MG";"ESPINOSA";250;11;43;304
2008;"ESPIRITO SANTO DO DOURADO (MG)";"MG";"ESPIRITO SANTO DO DOURADO";61;3;5;69
2008;"ESTIVA (MG)";"MG";"ESTIVA";243;15;17;275
2008;"ESTRELA DALVA (MG)";"MG";"ESTRELA DALVA";19;4;0;23
2008;"ESTRELA DO INDAIA (MG)";"MG";"ESTRELA DO INDAIA";35;4;2;41
2008;"ESTRELA DO SUL (MG)";"MG";"ESTRELA DO SUL";85;7;14;106
2008;"EUGENOPOLIS (MG)";"MG";"EUGENOPOLIS";62;14;18;94
2008;"EWBANK DA CAMARA (MG)";"MG";"EWBANK DA CAMARA";39;1;5;45
2008;"EXTREMA (MG)";"MG";"EXTREMA";396;58;44;498
2008;"FAMA (MG)";"MG";"FAMA";11;8;1;20
2008;"FARIA LEMOS (MG)";"MG";"FARIA LEMOS";22;8;0;30
2008;"FELICIO DOS SANTOS (MG)";"MG";"FELICIO DOS SANTOS";14;6;11;31
2008;"FELISBURGO (MG)";"MG";"FELISBURGO";14;2;6;22
2008;"FELIXLANDIA (MG)";"MG";"FELIXLANDIA";180;8;37;225
2008;"FERNANDES TOURINHO (MG)";"MG";"FERNANDES TOURINHO";12;6;7;25
2008;"FERROS (MG)";"MG";"FERROS";75;7;35;117
2008;"FERVEDOURO (MG)";"MG";"FERVEDOURO";79;10;7;96
2008;"FLORESTAL (MG)";"MG";"FLORESTAL";53;7;12;72
2008;"FORMIGA (MG)";"MG";"FORMIGA";1342;98;176;1616
2008;"FORMOSO (MG)";"MG";"FORMOSO";23;1;17;41
2008;"FORTALEZA DE MINAS (MG)";"MG";"FORTALEZA DE MINAS";48;16;5;69
2008;"FORTUNA DE MINAS (MG)";"MG";"FORTUNA DE MINAS";18;3;6;27
2008;"FRANCISCO BADARO (MG)";"MG";"FRANCISCO BADARO";32;2;13;47
2008;"FRANCISCO DUMONT (MG)";"MG";"FRANCISCO DUMONT";41;2;18;61
2008;"FRANCISCO SA (MG)";"MG";"FRANCISCO SA";100;7;54;161
2008;"FRANCISCOPOLIS (MG)";"MG";"FRANCISCOPOLIS";11;2;9;22
2008;"FREI GASPAR (MG)";"MG";"FREI GASPAR";15;6;5;26
2008;"FREI INOCENCIO (MG)";"MG";"FREI INOCENCIO";86;8;19;113
2008;"FREI LAGONEGRO (MG)";"MG";"FREI LAGONEGRO";3;5;4;12
2008;"FRONTEIRA (MG)";"MG";"FRONTEIRA";233;23;67;323
2008;"FRONTEIRA DOS VALES (MG)";"MG";"FRONTEIRA DOS VALES";7;5;1;13
2008;"FRUTA DE LEITE (MG)";"MG";"FRUTA DE LEITE";19;1;17;37
2008;"FRUTAL (MG)";"MG";"FRUTAL";1262;101;171;1534
2008;"FUNILANDIA (MG)";"MG";"FUNILANDIA";29;3;9;41
2008;"GALILEIA (MG)";"MG";"GALILEIA";62;0;6;68
2008;"GAMELEIRAS (MG)";"MG";"GAMELEIRAS";25;2;10;37
2008;"GLAUCILANDIA (MG)";"MG";"GLAUCILANDIA";0;2;3;5
2008;"GOIABEIRA (MG)";"MG";"GOIABEIRA";20;5;3;28
2008;"GOIANA (MG)";"MG";"GOIANA";19;2;4;25
2008;"GONCALVES (MG)";"MG";"GONCALVES";100;15;4;119
2008;"GONZAGA (MG)";"MG";"GONZAGA";27;5;8;40
2008;"GOUVEA (MG)";"MG";"GOUVEA";121;6;20;147
2008;"GOVERNADOR VALADARES (MG)";"MG";"GOVERNADOR VALADARES";2801;222;312;3335
2008;"GRAO MOGOL (MG)";"MG";"GRAO MOGOL";43;3;60;106
2008;"GRUPIARA (MG)";"MG";"GRUPIARA";10;1;2;13
2008;"GUANHAES (MG)";"MG";"GUANHAES";378;28;77;483
2008;"GUAPE (MG)";"MG";"GUAPE";133;14;33;180
2008;"GUARACIABA (MG)";"MG";"GUARACIABA";53;10;25;88
2008;"GUARACIAMA (MG)";"MG";"GUARACIAMA";25;3;13;41
2008;"GUARANESIA (MG)";"MG";"GUARANESIA";334;27;73;434
2008;"GUARANI (MG)";"MG";"GUARANI";87;10;7;104
2008;"GUARARA (MG)";"MG";"GUARARA";42;8;2;52
2008;"GUARDA MOR (MG)";"MG";"GUARDA MOR";73;11;12;96
2008;"GUAXUPE (MG)";"MG";"GUAXUPE";776;56;135;967
2008;"GUIDOVAL (MG)";"MG";"GUIDOVAL";106;1;4;111
2008;"GUIMARANIA (MG)";"MG";"GUIMARANIA";113;3;15;131
2008;"GUIRICEMA (MG)";"MG";"GUIRICEMA";189;7;16;212
2008;"GURINHATA (MG)";"MG";"GURINHATA";74;8;18;100
2008;"HELIODORA (MG)";"MG";"HELIODORA";71;7;8;86
2008;"IAPU (MG)";"MG";"IAPU";106;12;14;132
2008;"IBERTIOGA (MG)";"MG";"IBERTIOGA";31;10;1;42
2008;"IBIA (MG)";"MG";"IBIA";339;30;76;445
2008;"IBIAI (MG)";"MG";"IBIAI";41;4;6;51
2008;"IBIRACATU (MG)";"MG";"IBIRACATU";6;3;6;15
2008;"IBIRACI (MG)";"MG";"IBIRACI";325;21;24;370
2008;"IBIRITE (MG)";"MG";"IBIRITE";1051;139;220;1410
2008;"IBITIURA DE MINAS (MG)";"MG";"IBITIURA DE MINAS";65;3;3;71
2008;"IBITURUNA (MG)";"MG";"IBITURUNA";29;5;1;35
2008;"ICARAI DE MINAS (MG)";"MG";"ICARAI DE MINAS";15;4;2;21
2008;"IGARAPE (MG)";"MG";"IGARAPE";528;51;108;687
2008;"IGARATINGA (MG)";"MG";"IGARATINGA";341;5;15;361
2008;"IGUATAMA (MG)";"MG";"IGUATAMA";102;5;17;124
2008;"IJACI (MG)";"MG";"IJACI";94;4;11;109
2008;"ILICINEA (MG)";"MG";"ILICINEA";163;7;24;194
2008;"IMBE DE MINAS (MG)";"MG";"IMBE DE MINAS";33;2;4;39
2008;"INCONFIDENTES (MG)";"MG";"INCONFIDENTES";68;11;13;92
2008;"INDAIABIRA (MG)";"MG";"INDAIABIRA";33;4;17;54
2008;"INDIANOPOLIS (MG)";"MG";"INDIANOPOLIS";47;28;17;92
2008;"INGAI (MG)";"MG";"INGAI";16;10;4;30
2008;"INHAPIM (MG)";"MG";"INHAPIM";283;9;42;334
2008;"INHAUMA (MG)";"MG";"INHAUMA";71;4;11;86
2008;"INIMUTABA (MG)";"MG";"INIMUTABA";28;2;3;33
2008;"IPABA (MG)";"MG";"IPABA";70;9;19;98
2008;"IPANEMA (MG)";"MG";"IPANEMA";167;21;21;209
2008;"IPATINGA (MG)";"MG";"IPATINGA";2614;388;553;3555
2008;"IPIACU (MG)";"MG";"IPIACU";44;2;8;54
2008;"IPUIUNA (MG)";"MG";"IPUIUNA";309;17;15;341
2008;"IRAI DE MINAS (MG)";"MG";"IRAI DE MINAS";165;14;26;205
2008;"ITABIRA (MG)";"MG";"ITABIRA";1180;150;332;1662
2008;"ITABIRINHA DE MANTENA (MG)";"MG";"ITABIRINHA DE MANTENA";112;1;24;137
2008;"ITABIRITO (MG)";"MG";"ITABIRITO";769;141;246;1156
2008;"ITACAMBIRA (MG)";"MG";"ITACAMBIRA";9;0;5;14
2008;"ITACARAMBI (MG)";"MG";"ITACARAMBI";72;6;25;103
2008;"ITAGUARA (MG)";"MG";"ITAGUARA";320;11;33;364
2008;"ITAIPE (MG)";"MG";"ITAIPE";46;2;16;64
2008;"ITAJUBA (MG)";"MG";"ITAJUBA";745;76;90;911
2008;"ITAMARANDIBA (MG)";"MG";"ITAMARANDIBA";460;18;80;558
2008;"ITAMARATI DE MINAS (MG)";"MG";"ITAMARATI DE MINAS";92;8;12;112
2008;"ITAMBACURI (MG)";"MG";"ITAMBACURI";138;13;27;178
2008;"ITAMBE DO MATO DENTRO (MG)";"MG";"ITAMBE DO MATO DENTRO";16;6;2;24
2008;"ITAMOGI (MG)";"MG";"ITAMOGI";175;14;18;207
2008;"ITAMONTE (MG)";"MG";"ITAMONTE";281;20;23;324
2008;"ITANHANDU (MG)";"MG";"ITANHANDU";275;19;18;312
2008;"ITANHOMI (MG)";"MG";"ITANHOMI";78;14;14;106
2008;"ITAOBIM (MG)";"MG";"ITAOBIM";179;18;25;222
2008;"ITAPAGIPE (MG)";"MG";"ITAPAGIPE";169;12;25;206
2008;"ITAPECERICA (MG)";"MG";"ITAPECERICA";279;27;53;359
2008;"ITAPEVA (MG)";"MG";"ITAPEVA";213;13;8;234
2008;"ITATIAIUCU (MG)";"MG";"ITATIAIUCU";235;4;29;268
2008;"ITAU DE MINAS (MG)";"MG";"ITAU DE MINAS";236;25;34;295
2008;"ITAUNA (MG)";"MG";"ITAUNA";1219;170;221;1610
2008;"ITAVERAVA (MG)";"MG";"ITAVERAVA";33;3;7;43
2008;"ITINGA (MG)";"MG";"ITINGA";43;7;18;68
2008;"ITUETA (MG)";"MG";"ITUETA";40;4;11;55
2008;"ITUIUTABA (MG)";"MG";"ITUIUTABA";1097;137;229;1463
2008;"ITUMIRIM (MG)";"MG";"ITUMIRIM";51;12;2;65
2008;"ITURAMA (MG)";"MG";"ITURAMA";638;44;239;921
2008;"ITUTINGA (MG)";"MG";"ITUTINGA";58;20;0;78
2008;"JABOTICATUBAS (MG)";"MG";"JABOTICATUBAS";156;6;42;204
2008;"JACINTO (MG)";"MG";"JACINTO";17;3;14;34
2008;"JACUI (MG)";"MG";"JACUI";108;14;19;141
2008;"JACUTINGA (MG)";"MG";"JACUTINGA";284;38;43;365
2008;"JAGUARACU (MG)";"MG";"JAGUARACU";36;2;3;41
2008;"JAIBA (MG)";"MG";"JAIBA";246;10;56;312
2008;"JAMPRUCA (MG)";"MG";"JAMPRUCA";13;4;15;32
2008;"JANAUBA (MG)";"MG";"JANAUBA";620;10;88;718
2008;"JANUARIA (MG)";"MG";"JANUARIA";264;10;62;336
2008;"JAPARAIBA (MG)";"MG";"JAPARAIBA";54;2;20;76
2008;"JAPONVAR (MG)";"MG";"JAPONVAR";5;4;10;19
2008;"JECEABA (MG)";"MG";"JECEABA";57;17;7;81
2008;"JENIPAPO DE MINAS (MG)";"MG";"JENIPAPO DE MINAS";15;7;11;33
2008;"JEQUERI (MG)";"MG";"JEQUERI";57;7;23;87
2008;"JEQUITAI (MG)";"MG";"JEQUITAI";52;3;8;63
2008;"JEQUITIBA (MG)";"MG";"JEQUITIBA";54;5;20;79
2008;"JEQUITINHONHA (MG)";"MG";"JEQUITINHONHA";69;18;20;107
2008;"JESUANIA (MG)";"MG";"JESUANIA";59;7;7;73
2008;"JOAIMA (MG)";"MG";"JOAIMA";51;5;17;73
2008;"JOANESIA (MG)";"MG";"JOANESIA";12;3;9;24
2008;"JOAO MONLEVADE (MG)";"MG";"JOAO MONLEVADE";968;101;201;1270
2008;"JOAO PINHEIRO (MG)";"MG";"JOAO PINHEIRO";747;21;171;939
2008;"JOAQUIM FELICIO (MG)";"MG";"JOAQUIM FELICIO";26;0;8;34
2008;"JORDANIA (MG)";"MG";"JORDANIA";15;5;15;35
2008;"JOSE GONCALVES DE MINAS (MG)";"MG";"JOSE GONCALVES DE MINAS";23;6;5;34
2008;"JOSE RAYDAN (MG)";"MG";"JOSE RAYDAN";15;2;8;25
2008;"JOSENOPOLIS (MG)";"MG";"JOSENOPOLIS";18;2;3;23
2008;"JUATUBA (MG)";"MG";"JUATUBA";181;28;150;359
2008;"JUIZ DE FORA (MG)";"MG";"JUIZ DE FORA";4493;500;1257;6250
2008;"JURAMENTO (MG)";"MG";"JURAMENTO";12;2;10;24
2008;"JURUAIA (MG)";"MG";"JURUAIA";58;12;13;83
2008;"JUVENILIA (MG)";"MG";"JUVENILIA";8;4;5;17
2008;"LADAINHA (MG)";"MG";"LADAINHA";42;11;20;73
2008;"LAGAMAR (MG)";"MG";"LAGAMAR";66;17;16;99
2008;"LAGOA DA PRATA (MG)";"MG";"LAGOA DA PRATA";680;36;155;871
2008;"LAGOA DOS PATOS (MG)";"MG";"LAGOA DOS PATOS";25;2;6;33
2008;"LAGOA DOURADA (MG)";"MG";"LAGOA DOURADA";309;7;33;349
2008;"LAGOA FORMOSA (MG)";"MG";"LAGOA FORMOSA";244;17;59;320
2008;"LAGOA GRANDE (MG)";"MG";"LAGOA GRANDE";86;3;39;128
2008;"LAGOA SANTA (MG)";"MG";"LAGOA SANTA";552;79;91;722
2008;"LAJINHA (MG)";"MG";"LAJINHA";193;11;27;231
2008;"LAMBARI (MG)";"MG";"LAMBARI";254;29;19;302
2008;"LAMIM (MG)";"MG";"LAMIM";35;2;5;42
2008;"LARANJAL (MG)";"MG";"LARANJAL";137;9;1;147
2008;"LASSANCE (MG)";"MG";"LASSANCE";33;2;5;40
2008;"LAVRAS (MG)";"MG";"LAVRAS";992;122;186;1300
2008;"LEANDRO FERREIRA (MG)";"MG";"LEANDRO FERREIRA";25;6;5;36
2008;"LEME DO PRADO (MG)";"MG";"LEME DO PRADO";23;4;14;41
2008;"LEOPOLDINA (MG)";"MG";"LEOPOLDINA";593;45;62;700
2008;"LIBERDADE (MG)";"MG";"LIBERDADE";59;7;7;73
2008;"LIMA DUARTE (MG)";"MG";"LIMA DUARTE";144;27;36;207
2008;"LIMEIRA DO OESTE (MG)";"MG";"LIMEIRA DO OESTE";98;11;40;149
2008;"LONTRA (MG)";"MG";"LONTRA";8;3;4;15
2008;"LUISBURGO (MG)";"MG";"LUISBURGO";22;4;20;46
2008;"LUISLANDIA (MG)";"MG";"LUISLANDIA";5;3;4;12
2008;"LUMINARIAS (MG)";"MG";"LUMINARIAS";79;4;29;112
2008;"LUZ (MG)";"MG";"LUZ";258;47;22;327
2008;"MACHACALIS (MG)";"MG";"MACHACALIS";23;2;5;30
2008;"MACHADO (MG)";"MG";"MACHADO";623;69;78;770
2008;"MADRE DE DEUS DE MINAS (MG)";"MG";"MADRE DE DEUS DE MINAS";70;4;3;77
2008;"MALACACHETA (MG)";"MG";"MALACACHETA";84;5;31;120
2008;"MAMONAS (MG)";"MG";"MAMONAS";76;4;6;86
2008;"MANGA (MG)";"MG";"MANGA";92;3;34;129
2008;"MANHUACU (MG)";"MG";"MANHUACU";1230;65;114;1409
2008;"MANHUMIRIM (MG)";"MG";"MANHUMIRIM";263;24;31;318
2008;"MANTENA (MG)";"MG";"MANTENA";536;26;71;633
2008;"MAR DE ESPANHA (MG)";"MG";"MAR DE ESPANHA";120;15;12;147
2008;"MARAVILHAS (MG)";"MG";"MARAVILHAS";149;12;5;166
2008;"MARIA DA FE (MG)";"MG";"MARIA DA FE";218;11;24;253
2008;"MARIANA (MG)";"MG";"MARIANA";496;111;228;835
2008;"MARILAC (MG)";"MG";"MARILAC";12;5;5;22
2008;"MARIO CAMPOS (MG)";"MG";"MARIO CAMPOS";162;11;11;184
2008;"MARIPA DE MINAS (MG)";"MG";"MARIPA DE MINAS";34;5;3;42
2008;"MARLIERIA (MG)";"MG";"MARLIERIA";35;5;6;46
2008;"MARMELOPOLIS (MG)";"MG";"MARMELOPOLIS";25;8;6;39
2008;"MARTINHO CAMPOS (MG)";"MG";"MARTINHO CAMPOS";305;24;64;393
2008;"MARTINS SOARES (MG)";"MG";"MARTINS SOARES";59;2;12;73
2008;"MATA VERDE (MG)";"MG";"MATA VERDE";11;8;2;21
2008;"MATERLANDIA (MG)";"MG";"MATERLANDIA";12;3;4;19
2008;"MATEUS LEME (MG)";"MG";"MATEUS LEME";546;59;84;689
2008;"MATHIAS LOBATO (MG)";"MG";"MATHIAS LOBATO";33;2;4;39
2008;"MATIAS BARBOSA (MG)";"MG";"MATIAS BARBOSA";401;18;33;452
2008;"MATIAS CARDOSO (MG)";"MG";"MATIAS CARDOSO";14;3;12;29
2008;"MATIPO (MG)";"MG";"MATIPO";237;19;26;282
2008;"MATO VERDE (MG)";"MG";"MATO VERDE";114;5;24;143
2008;"MATOZINHOS (MG)";"MG";"MATOZINHOS";269;52;105;426
2008;"MATUTINA (MG)";"MG";"MATUTINA";64;8;4;76
2008;"MEDEIROS (MG)";"MG";"MEDEIROS";41;13;2;56
2008;"MEDINA (MG)";"MG";"MEDINA";105;30;30;165
2008;"MENDES PIMENTEL (MG)";"MG";"MENDES PIMENTEL";35;4;9;48
2008;"MERCES (MG)";"MG";"MERCES";128;8;11;147
2008;"MESQUITA (MG)";"MG";"MESQUITA";18;4;4;26
2008;"MINAS NOVAS (MG)";"MG";"MINAS NOVAS";90;15;72;177
2008;"MINDURI (MG)";"MG";"MINDURI";52;9;2;63
2008;"MIRABELA (MG)";"MG";"MIRABELA";65;7;20;92
2008;"MIRADOURO (MG)";"MG";"MIRADOURO";95;7;27;129
2008;"MIRAI (MG)";"MG";"MIRAI";119;10;17;146
2008;"MIRAVANIA (MG)";"MG";"MIRAVANIA";6;2;6;14
2008;"MOEDA (MG)";"MG";"MOEDA";65;3;14;82
2008;"MOEMA (MG)";"MG";"MOEMA";128;9;105;242
2008;"MONJOLOS (MG)";"MG";"MONJOLOS";6;2;6;14
2008;"MONSENHOR PAULO (MG)";"MG";"MONSENHOR PAULO";143;10;7;160
2008;"MONTALVANIA (MG)";"MG";"MONTALVANIA";87;6;35;128
2008;"MONTE ALEGRE DE MINAS (MG)";"MG";"MONTE ALEGRE DE MINAS";421;26;35;482
2008;"MONTE AZUL (MG)";"MG";"MONTE AZUL";152;11;39;202
2008;"MONTE BELO (MG)";"MG";"MONTE BELO";218;21;45;284
2008;"MONTE CARMELO (MG)";"MG";"MONTE CARMELO";1121;65;115;1301
2008;"MONTE FORMOSO (MG)";"MG";"MONTE FORMOSO";9;3;11;23
2008;"MONTE SANTO DE MINAS (MG)";"MG";"MONTE SANTO DE MINAS";373;27;78;478
2008;"MONTE SIAO (MG)";"MG";"MONTE SIAO";196;29;31;256
2008;"MONTES CLAROS (MG)";"MG";"MONTES CLAROS";3590;183;862;4635
2008;"MONTEZUMA (MG)";"MG";"MONTEZUMA";16;6;11;33
2008;"MORADA NOVA DE MINAS (MG)";"MG";"MORADA NOVA DE MINAS";82;20;13;115
2008;"MORRO DA GARCA (MG)";"MG";"MORRO DA GARCA";39;2;16;57
2008;"MORRO DO PILAR (MG)";"MG";"MORRO DO PILAR";21;7;0;28
2008;"MUNHOZ (MG)";"MG";"MUNHOZ";82;10;7;99
2008;"MURIAE (MG)";"MG";"MURIAE";1183;77;153;1413
2008;"MUTUM (MG)";"MG";"MUTUM";144;18;36;198
2008;"MUZAMBINHO (MG)";"MG";"MUZAMBINHO";305;49;38;392
2008;"NACIP RAYDAN (MG)";"MG";"NACIP RAYDAN";6;0;3;9
2008;"NANUQUE (MG)";"MG";"NANUQUE";554;45;160;759
2008;"NAQUE (MG)";"MG";"NAQUE";29;3;19;51
2008;"NATALANDIA (MG)";"MG";"NATALANDIA";15;3;12;30
2008;"NATERCIA (MG)";"MG";"NATERCIA";66;10;14;90
2008;"NAZARENO (MG)";"MG";"NAZARENO";138;9;21;168
2008;"NEPOMUCENO (MG)";"MG";"NEPOMUCENO";378;14;48;440
2008;"NINHEIRA (MG)";"MG";"NINHEIRA";21;3;19;43
2008;"NOVA BELEM (MG)";"MG";"NOVA BELEM";34;2;8;44
2008;"NOVA ERA (MG)";"MG";"NOVA ERA";171;18;72;261
2008;"NOVA LIMA (MG)";"MG";"NOVA LIMA";897;256;145;1298
2008;"NOVA MODICA (MG)";"MG";"NOVA MODICA";13;1;12;26
2008;"NOVA PONTE (MG)";"MG";"NOVA PONTE";182;41;59;282
2008;"NOVA PORTEIRINHA (MG)";"MG";"NOVA PORTEIRINHA";15;2;12;29
2008;"NOVA RESENDE (MG)";"MG";"NOVA RESENDE";283;20;30;333
2008;"NOVA SERRANA (MG)";"MG";"NOVA SERRANA";354;42;51;447
2008;"NOVA UNIAO (MG)";"MG";"NOVA UNIAO";106;10;15;131
2008;"NOVO CRUZEIRO (MG)";"MG";"NOVO CRUZEIRO";105;24;74;203
2008;"NOVO ORIENTE DE MINAS (MG)";"MG";"NOVO ORIENTE DE MINAS";22;6;12;40
2008;"NOVORIZONTE (MG)";"MG";"NOVORIZONTE";35;2;6;43
2008;"OLARIA (MG)";"MG";"OLARIA";12;5;3;20
2008;"OLHOS D AGUA (MG)";"MG";"OLHOS D AGUA";40;7;26;73
2008;"OLIMPIO NORONHA (MG)";"MG";"OLIMPIO NORONHA";22;12;6;40
2008;"OLIVEIRA (MG)";"MG";"OLIVEIRA";667;45;75;787
2008;"OLIVEIRA FORTES (MG)";"MG";"OLIVEIRA FORTES";17;4;2;23
2008;"ONCA DE PITANGUI (MG)";"MG";"ONCA DE PITANGUI";23;5;8;36
2008;"ORATORIOS (MG)";"MG";"ORATORIOS";46;2;14;62
2008;"ORIZANIA (MG)";"MG";"ORIZANIA";44;5;8;57
2008;"OURO BRANCO (MG)";"MG";"OURO BRANCO";411;85;234;730
2008;"OURO FINO (MG)";"MG";"OURO FINO";430;40;69;539
2008;"OURO PRETO (MG)";"MG";"OURO PRETO";855;163;262;1280
2008;"OURO VERDE DE MINAS (MG)";"MG";"OURO VERDE DE MINAS";13;3;4;20
2008;"PADRE CARVALHO (MG)";"MG";"PADRE CARVALHO";14;3;13;30
2008;"PADRE PARAISO (MG)";"MG";"PADRE PARAISO";98;57;46;201
2008;"PAI PEDRO (MG)";"MG";"PAI PEDRO";14;4;18;36
2008;"PAINEIRAS (MG)";"MG";"PAINEIRAS";75;9;8;92
2008;"PAINS (MG)";"MG";"PAINS";206;15;20;241
2008;"PAIVA (MG)";"MG";"PAIVA";9;4;1;14
2008;"PALMA (MG)";"MG";"PALMA";71;3;4;78
2008;"PALMOPOLIS (MG)";"MG";"PALMOPOLIS";15;3;7;25
2008;"PAPAGAIOS (MG)";"MG";"PAPAGAIOS";500;7;49;556
2008;"PARA DE MINAS (MG)";"MG";"PARA DE MINAS";1735;113;171;2019
2008;"PARACATU (MG)";"MG";"PARACATU";1129;62;288;1479
2008;"PARAGUACU (MG)";"MG";"PARAGUACU";269;34;24;327
2008;"PARAISOPOLIS (MG)";"MG";"PARAISOPOLIS";383;39;24;446
2008;"PARAOPEBA (MG)";"MG";"PARAOPEBA";382;20;45;447
2008;"PASSA QUATRO (MG)";"MG";"PASSA QUATRO";304;18;26;348
2008;"PASSA TEMPO (MG)";"MG";"PASSA TEMPO";139;19;10;168
2008;"PASSA VINTE (MG)";"MG";"PASSA VINTE";29;15;6;50
2008;"PASSABEM (MG)";"MG";"PASSABEM";7;4;2;13
2008;"PASSOS (MG)";"MG";"PASSOS";1662;111;330;2103
2008;"PATIS (MG)";"MG";"PATIS";6;2;6;14
2008;"PATOS DE MINAS (MG)";"MG";"PATOS DE MINAS";2416;105;381;2902
2008;"PATROCINIO (MG)";"MG";"PATROCINIO";1374;75;437;1886
2008;"PATROCINIO DO MURIAE (MG)";"MG";"PATROCINIO DO MURIAE";60;4;3;67
2008;"PAULA CANDIDO (MG)";"MG";"PAULA CANDIDO";49;8;11;68
2008;"PAULISTAS (MG)";"MG";"PAULISTAS";11;2;7;20
2008;"PAVAO (MG)";"MG";"PAVAO";37;11;6;54
2008;"PECANHA (MG)";"MG";"PECANHA";115;6;45;166
2008;"PEDRA AZUL (MG)";"MG";"PEDRA AZUL";116;16;48;180
2008;"PEDRA BONITA (MG)";"MG";"PEDRA BONITA";29;6;12;47
2008;"PEDRA DO ANTA (MG)";"MG";"PEDRA DO ANTA";23;2;13;38
2008;"PEDRA DO INDAIA (MG)";"MG";"PEDRA DO INDAIA";50;6;4;60
2008;"PEDRA DOURADA (MG)";"MG";"PEDRA DOURADA";9;4;3;16
2008;"PEDRALVA (MG)";"MG";"PEDRALVA";117;15;18;150
2008;"PEDRAS DE MARIA DA CRUZ (MG)";"MG";"PEDRAS DE MARIA DA CRUZ";11;4;21;36
2008;"PEDRINOPOLIS (MG)";"MG";"PEDRINOPOLIS";56;10;7;73
2008;"PEDRO LEOPOLDO (MG)";"MG";"PEDRO LEOPOLDO";858;102;193;1153
2008;"PEDRO TEIXEIRA (MG)";"MG";"PEDRO TEIXEIRA";15;4;1;20
2008;"PEQUERI (MG)";"MG";"PEQUERI";63;4;3;70
2008;"PEQUI (MG)";"MG";"PEQUI";39;8;6;53
2008;"PERDIGAO (MG)";"MG";"PERDIGAO";119;14;3;136
2008;"PERDIZES (MG)";"MG";"PERDIZES";241;33;27;301
2008;"PERDOES (MG)";"MG";"PERDOES";448;28;52;528
2008;"PERIQUITO (MG)";"MG";"PERIQUITO";29;6;18;53
2008;"PESCADOR (MG)";"MG";"PESCADOR";10;8;3;21
2008;"PIAU (MG)";"MG";"PIAU";34;7;7;48
2008;"PIEDADE DE CARATINGA (MG)";"MG";"PIEDADE DE CARATINGA";107;7;6;120
2008;"PIEDADE DE PONTE NOVA (MG)";"MG";"PIEDADE DE PONTE NOVA";29;2;12;43
2008;"PIEDADE DO RIO GRANDE (MG)";"MG";"PIEDADE DO RIO GRANDE";43;4;8;55
2008;"PIEDADE DOS GERAIS (MG)";"MG";"PIEDADE DOS GERAIS";57;4;11;72
2008;"PIMENTA (MG)";"MG";"PIMENTA";180;5;21;206
2008;"PINGO D AGUA (MG)";"MG";"PINGO D AGUA";14;3;5;22
2008;"PINTOPOLIS (MG)";"MG";"PINTOPOLIS";10;2;2;14
2008;"PIRACEMA (MG)";"MG";"PIRACEMA";72;9;11;92
2008;"PIRAJUBA (MG)";"MG";"PIRAJUBA";111;14;9;134
2008;"PIRANGA (MG)";"MG";"PIRANGA";113;18;35;166
2008;"PIRANGUCU (MG)";"MG";"PIRANGUCU";27;18;31;76
2008;"PIRANGUINHO (MG)";"MG";"PIRANGUINHO";121;12;7;140
2008;"PIRAPETINGA (MG)";"MG";"PIRAPETINGA";287;17;24;328
2008;"PIRAPORA (MG)";"MG";"PIRAPORA";450;20;103;573
2008;"PIRAUBA (MG)";"MG";"PIRAUBA";104;17;8;129
2008;"PITANGUI (MG)";"MG";"PITANGUI";497;38;58;593
2008;"PIUI (MG)";"MG";"PIUI";578;36;50;664
2008;"PLANURA (MG)";"MG";"PLANURA";143;7;43;193
2008;"POCO FUNDO (MG)";"MG";"POCO FUNDO";212;42;14;268
2008;"POCOS DE CALDAS (MG)";"MG";"POCOS DE CALDAS";2504;399;389;3292
2008;"POCRANE (MG)";"MG";"POCRANE";63;6;8;77
2008;"POMPEU (MG)";"MG";"POMPEU";391;24;89;504
2008;"PONTE NOVA (MG)";"MG";"PONTE NOVA";851;36;112;999
2008;"PONTO CHIQUE (MG)";"MG";"PONTO CHIQUE";5;1;8;14
2008;"PONTO DOS VOLANTES (MG)";"MG";"PONTO DOS VOLANTES";16;4;24;44
2008;"PORTEIRINHA (MG)";"MG";"PORTEIRINHA";260;10;129;399
2008;"PORTO FIRME (MG)";"MG";"PORTO FIRME";53;6;10;69
2008;"POTE (MG)";"MG";"POTE";48;8;15;71
2008;"POUSO ALEGRE (MG)";"MG";"POUSO ALEGRE";1996;185;455;2636
2008;"POUSO ALTO (MG)";"MG";"POUSO ALTO";97;14;6;117
2008;"PRADOS (MG)";"MG";"PRADOS";71;8;5;84
2008;"PRATA (MG)";"MG";"PRATA";354;75;66;495
2008;"PRATAPOLIS (MG)";"MG";"PRATAPOLIS";147;18;13;178
2008;"PRATINHA (MG)";"MG";"PRATINHA";41;8;3;52
2008;"PRESIDENTE BERNARDES (MG)";"MG";"PRESIDENTE BERNARDES";16;7;7;30
2008;"PRESIDENTE JUSCELINO (MG)";"MG";"PRESIDENTE JUSCELINO";33;3;12;48
2008;"PRESIDENTE KUBITSCHEK (MG)";"MG";"PRESIDENTE KUBITSCHEK";14;8;4;26
2008;"PRESIDENTE OLEGARIO (MG)";"MG";"PRESIDENTE OLEGARIO";192;13;75;280
2008;"PRUDENTE DE MORAIS (MG)";"MG";"PRUDENTE DE MORAIS";88;7;12;107
2008;"QUARTEL GERAL (MG)";"MG";"QUARTEL GERAL";38;8;2;48
2008;"QUELUZITA (MG)";"MG";"QUELUZITA";19;5;3;27
2008;"RAPOSOS (MG)";"MG";"RAPOSOS";52;30;25;107
2008;"RAUL SOARES (MG)";"MG";"RAUL SOARES";175;19;42;236
2008;"RECREIO (MG)";"MG";"RECREIO";130;11;18;159
2008;"REDUTO (MG)";"MG";"REDUTO";44;4;2;50
2008;"RESENDE COSTA (MG)";"MG";"RESENDE COSTA";139;13;10;162
2008;"RESPLENDOR (MG)";"MG";"RESPLENDOR";173;17;29;219
2008;"RESSAQUINHA (MG)";"MG";"RESSAQUINHA";100;2;9;111
2008;"RIACHINHO (MG)";"MG";"RIACHINHO";56;4;17;77
2008;"RIACHO DOS MACHADOS (MG)";"MG";"RIACHO DOS MACHADOS";52;2;31;85
2008;"RIBEIRAO DAS NEVES (MG)";"MG";"RIBEIRAO DAS NEVES";1879;314;522;2715
2008;"RIBEIRAO VERMELHO (MG)";"MG";"RIBEIRAO VERMELHO";23;6;3;32
2008;"RIO ACIMA (MG)";"MG";"RIO ACIMA";106;16;15;137
2008;"RIO CASCA (MG)";"MG";"RIO CASCA";204;10;46;260
2008;"RIO DO PRADO (MG)";"MG";"RIO DO PRADO";10;8;5;23
2008;"RIO DOCE (MG)";"MG";"RIO DOCE";21;3;7;31
2008;"RIO ESPERA (MG)";"MG";"RIO ESPERA";28;0;5;33
2008;"RIO MANSO (MG)";"MG";"RIO MANSO";90;5;10;105
2008;"RIO NOVO (MG)";"MG";"RIO NOVO";94;6;20;120
2008;"RIO PARANAIBA (MG)";"MG";"RIO PARANAIBA";133;10;43;186
2008;"RIO PARDO DE MINAS (MG)";"MG";"RIO PARDO DE MINAS";162;7;84;253
2008;"RIO PIRACICABA (MG)";"MG";"RIO PIRACICABA";163;20;27;210
2008;"RIO POMBA (MG)";"MG";"RIO POMBA";205;20;24;249
2008;"RIO PRETO (MG)";"MG";"RIO PRETO";480;106;52;638
2008;"RIO VERMELHO (MG)";"MG";"RIO VERMELHO";53;17;32;102
2008;"RITAPOLIS (MG)";"MG";"RITAPOLIS";20;5;7;32
2008;"ROCHEDO DE MINAS (MG)";"MG";"ROCHEDO DE MINAS";19;5;2;26
2008;"RODEIRO (MG)";"MG";"RODEIRO";150;5;10;165
2008;"ROMARIA (MG)";"MG";"ROMARIA";39;6;7;52
2008;"ROSARIO DA LIMEIRA (MG)";"MG";"ROSARIO DA LIMEIRA";51;7;27;85
2008;"RUBELITA (MG)";"MG";"RUBELITA";9;3;8;20
2008;"RUBIM (MG)";"MG";"RUBIM";17;1;25;43
2008;"SABARA (MG)";"MG";"SABARA";519;184;300;1003
2008;"SABINOPOLIS (MG)";"MG";"SABINOPOLIS";114;16;30;160
2008;"SACRAMENTO (MG)";"MG";"SACRAMENTO";419;50;49;518
2008;"SALINAS (MG)";"MG";"SALINAS";301;33;104;438
2008;"SALTO DA DIVISA (MG)";"MG";"SALTO DA DIVISA";6;3;6;15
2008;"SANTA BARBARA (MG)";"MG";"SANTA BARBARA";343;46;127;516
2008;"SANTA BARBARA DO LESTE (MG)";"MG";"SANTA BARBARA DO LESTE";143;6;3;152
2008;"SANTA BARBARA DO MONTE VERDE (MG)";"MG";"SANTA BARBARA DO MONTE VERDE";993;94;164;1251
2008;"SANTA BARBARA DO TUGURIO (MG)";"MG";"SANTA BARBARA DO TUGURIO";45;4;8;57
2008;"SANTA CRUZ DE MINAS (MG)";"MG";"SANTA CRUZ DE MINAS";48;2;4;54
2008;"SANTA CRUZ DE SALINAS (MG)";"MG";"SANTA CRUZ DE SALINAS";8;2;18;28
2008;"SANTA CRUZ DO ESCALVADO (MG)";"MG";"SANTA CRUZ DO ESCALVADO";27;1;6;34
2008;"SANTA EFIGENIA DE MINAS (MG)";"MG";"SANTA EFIGENIA DE MINAS";15;4;3;22
2008;"SANTA FE DE MINAS (MG)";"MG";"SANTA FE DE MINAS";7;2;3;12
2008;"SANTA HELENA DE MINAS (MG)";"MG";"SANTA HELENA DE MINAS";9;2;5;16
2008;"SANTA JULIANA (MG)";"MG";"SANTA JULIANA";252;26;38;316
2008;"SANTA LUZIA (MG)";"MG";"SANTA LUZIA";1372;164;521;2057
2008;"SANTA MARGARIDA (MG)";"MG";"SANTA MARGARIDA";177;17;16;210
2008;"SANTA MARIA DE ITABIRA (MG)";"MG";"SANTA MARIA DE ITABIRA";82;10;23;115
2008;"SANTA MARIA DO SALTO (MG)";"MG";"SANTA MARIA DO SALTO";7;4;4;15
2008;"SANTA MARIA DO SUACUI (MG)";"MG";"SANTA MARIA DO SUACUI";67;4;27;98
2008;"SANTA RITA DE CALDAS (MG)";"MG";"SANTA RITA DE CALDAS";239;16;9;264
2008;"SANTA RITA DE JACUTINGA (MG)";"MG";"SANTA RITA DE JACUTINGA";49;4;6;59
2008;"SANTA RITA DE MINAS (MG)";"MG";"SANTA RITA DE MINAS";90;6;8;104
2008;"SANTA RITA DO IBITIPOCA (MG)";"MG";"SANTA RITA DO IBITIPOCA";36;4;1;41
2008;"SANTA RITA DO ITUETO (MG)";"MG";"SANTA RITA DO ITUETO";63;6;10;79
2008;"SANTA RITA DO SAPUCAI (MG)";"MG";"SANTA RITA DO SAPUCAI";340;46;58;444
2008;"SANTA ROSA DA SERRA (MG)";"MG";"SANTA ROSA DA SERRA";31;5;5;41
2008;"SANTA VITORIA (MG)";"MG";"SANTA VITORIA";259;12;41;312
2008;"SANTANA DA VARGEM (MG)";"MG";"SANTANA DA VARGEM";65;7;13;85
2008;"SANTANA DE CATAGUASES (MG)";"MG";"SANTANA DE CATAGUASES";33;11;7;51
2008;"SANTANA DE PIRAPAMA (MG)";"MG";"SANTANA DE PIRAPAMA";56;2;21;79
2008;"SANTANA DO DESERTO (MG)";"MG";"SANTANA DO DESERTO";50;3;5;58
2008;"SANTANA DO GARAMBEU (MG)";"MG";"SANTANA DO GARAMBEU";10;2;3;15
2008;"SANTANA DO JACARE (MG)";"MG";"SANTANA DO JACARE";29;6;4;39
2008;"SANTANA DO MANHUACU (MG)";"MG";"SANTANA DO MANHUACU";105;2;10;117
2008;"SANTANA DO PARAISO (MG)";"MG";"SANTANA DO PARAISO";85;10;38;133
2008;"SANTANA DO RIACHO (MG)";"MG";"SANTANA DO RIACHO";13;4;9;26
2008;"SANTANA DOS MONTES (MG)";"MG";"SANTANA DOS MONTES";20;7;5;32
2008;"SANTO ANTONIO DO AMPARO (MG)";"MG";"SANTO ANTONIO DO AMPARO";223;20;19;262
2008;"SANTO ANTONIO DO AVENTUREIRO (MG)";"MG";"SANTO ANTONIO DO AVENTUREIRO";47;4;6;57
2008;"SANTO ANTONIO DO GRAMA (MG)";"MG";"SANTO ANTONIO DO GRAMA";50;1;5;56
2008;"SANTO ANTONIO DO ITAMBE (MG)";"MG";"SANTO ANTONIO DO ITAMBE";10;4;6;20
2008;"SANTO ANTONIO DO JACINTO (MG)";"MG";"SANTO ANTONIO DO JACINTO";25;3;26;54
2008;"SANTO ANTONIO DO MONTE (MG)";"MG";"SANTO ANTONIO DO MONTE";399;32;83;514
2008;"SANTO ANTONIO DO RETIRO (MG)";"MG";"SANTO ANTONIO DO RETIRO";21;3;18;42
2008;"SANTO ANTONIO DO RIO ABAIXO (MG)";"MG";"SANTO ANTONIO DO RIO ABAIXO";9;6;2;17
2008;"SANTO HIPOLITO (MG)";"MG";"SANTO HIPOLITO";21;3;2;26
2008;"SANTOS DUMONT (MG)";"MG";"SANTOS DUMONT";360;51;103;514
2008;"SAO BENTO ABADE (MG)";"MG";"SAO BENTO ABADE";33;5;6;44
2008;"SAO BRAS DO SUACUI (MG)";"MG";"SAO BRAS DO SUACUI";31;1;6;38
2008;"SAO DOMINGOS DAS DORES (MG)";"MG";"SAO DOMINGOS DAS DORES";73;2;3;78
2008;"SAO DOMINGOS DO PRATA (MG)";"MG";"SAO DOMINGOS DO PRATA";174;10;47;231
2008;"SAO FELIX DE MINAS (MG)";"MG";"SAO FELIX DE MINAS";14;1;5;20
2008;"SAO FRANCISCO (MG)";"MG";"SAO FRANCISCO";180;8;70;258
2008;"SAO FRANCISCO DE PAULA (MG)";"MG";"SAO FRANCISCO DE PAULA";65;7;17;89
2008;"SAO FRANCISCO DE SALES (MG)";"MG";"SAO FRANCISCO DE SALES";62;6;17;85
2008;"SAO FRANCISCO DO GLORIA (MG)";"MG";"SAO FRANCISCO DO GLORIA";46;8;3;57
2008;"SAO GERALDO (MG)";"MG";"SAO GERALDO";108;7;5;120
2008;"SAO GERALDO DA PIEDADE (MG)";"MG";"SAO GERALDO DA PIEDADE";12;3;5;20
2008;"SAO GERALDO DO BAIXIO (MG)";"MG";"SAO GERALDO DO BAIXIO";11;4;6;21
2008;"SAO GONCALO DO ABAETE (MG)";"MG";"SAO GONCALO DO ABAETE";76;11;12;99
2008;"SAO GONCALO DO PARA (MG)";"MG";"SAO GONCALO DO PARA";155;6;8;169
2008;"SAO GONCALO DO RIO ABAIXO (MG)";"MG";"SAO GONCALO DO RIO ABAIXO";115;21;20;156
2008;"SAO GONCALO DO RIO PRETO (MG)";"MG";"SAO GONCALO DO RIO PRETO";20;6;7;33
2008;"SAO GONCALO DO SAPUCAI (MG)";"MG";"SAO GONCALO DO SAPUCAI";382;22;55;459
2008;"SAO GOTARDO (MG)";"MG";"SAO GOTARDO";703;48;139;890
2008;"SAO JOAO BATISTA DO GLORIA (MG)";"MG";"SAO JOAO BATISTA DO GLORIA";87;7;11;105
2008;"SAO JOAO DA LAGOA (MG)";"MG";"SAO JOAO DA LAGOA";28;2;8;38
2008;"SAO JOAO DA MATA (MG)";"MG";"SAO JOAO DA MATA";34;8;0;42
2008;"SAO JOAO DA PONTE (MG)";"MG";"SAO JOAO DA PONTE";41;5;27;73
2008;"SAO JOAO DAS MISSOES (MG)";"MG";"SAO JOAO DAS MISSOES";13;4;10;27
2008;"SAO JOAO DEL REI (MG)";"MG";"SAO JOAO DEL REI";957;101;186;1244
2008;"SAO JOAO DO MANHUACU (MG)";"MG";"SAO JOAO DO MANHUACU";110;8;15;133
2008;"SAO JOAO DO MANTENINHA (MG)";"MG";"SAO JOAO DO MANTENINHA";64;4;4;72
2008;"SAO JOAO DO ORIENTE (MG)";"MG";"SAO JOAO DO ORIENTE";87;8;4;99
2008;"SAO JOAO DO PACUI (MG)";"MG";"SAO JOAO DO PACUI";5;0;2;7
2008;"SAO JOAO DO PARAISO (MG)";"MG";"SAO JOAO DO PARAISO";126;8;59;193
2008;"SAO JOAO EVANGELISTA (MG)";"MG";"SAO JOAO EVANGELISTA";95;4;28;127
2008;"SAO JOAO NEPOMUCENO (MG)";"MG";"SAO JOAO NEPOMUCENO";230;21;37;288
2008;"SAO JOAQUIM DE BICAS (MG)";"MG";"SAO JOAQUIM DE BICAS";404;56;49;509
2008;"SAO JOSE DA BARRA (MG)";"MG";"SAO JOSE DA BARRA";77;7;26;110
2008;"SAO JOSE DA LAPA (MG)";"MG";"SAO JOSE DA LAPA";216;26;28;270
2008;"SAO JOSE DA SAFIRA (MG)";"MG";"SAO JOSE DA SAFIRA";3;2;1;6
2008;"SAO JOSE DA VARGINHA (MG)";"MG";"SAO JOSE DA VARGINHA";38;2;7;47
2008;"SAO JOSE DO ALEGRE (MG)";"MG";"SAO JOSE DO ALEGRE";40;7;4;51
2008;"SAO JOSE DO DIVINO (MG)";"MG";"SAO JOSE DO DIVINO";14;2;8;24
2008;"SAO JOSE DO GOIABAL (MG)";"MG";"SAO JOSE DO GOIABAL";44;11;49;104
2008;"SAO JOSE DO JACURI (MG)";"MG";"SAO JOSE DO JACURI";12;3;4;19
2008;"SAO JOSE DO MANTIMENTO (MG)";"MG";"SAO JOSE DO MANTIMENTO";18;2;5;25
2008;"SAO LOURENCO (MG)";"MG";"SAO LOURENCO";422;59;25;506
2008;"SAO MIGUEL DO ANTA (MG)";"MG";"SAO MIGUEL DO ANTA";76;3;7;86
2008;"SAO PEDRO DA UNIAO (MG)";"MG";"SAO PEDRO DA UNIAO";94;13;4;111
2008;"SAO PEDRO DO SUACUI (MG)";"MG";"SAO PEDRO DO SUACUI";23;2;6;31
2008;"SAO PEDRO DOS FERROS (MG)";"MG";"SAO PEDRO DOS FERROS";118;6;26;150
2008;"SAO ROMAO (MG)";"MG";"SAO ROMAO";19;2;11;32
2008;"SAO ROQUE DE MINAS (MG)";"MG";"SAO ROQUE DE MINAS";113;8;6;127
2008;"SAO SEBASTIAO DA BELA VISTA (MG)";"MG";"SAO SEBASTIAO DA BELA VISTA";34;3;11;48
2008;"SAO SEBASTIAO DA VARGEM ALEGRE (MG)";"MG";"SAO SEBASTIAO DA VARGEM ALEGRE";7;2;5;14
2008;"SAO SEBASTIAO DO ANTA (MG)";"MG";"SAO SEBASTIAO DO ANTA";33;1;5;39
2008;"SAO SEBASTIAO DO MARANHAO (MG)";"MG";"SAO SEBASTIAO DO MARANHAO";26;4;9;39
2008;"SAO SEBASTIAO DO OESTE (MG)";"MG";"SAO SEBASTIAO DO OESTE";95;7;12;114
2008;"SAO SEBASTIAO DO PARAISO (MG)";"MG";"SAO SEBASTIAO DO PARAISO";1285;77;151;1513
2008;"SAO SEBASTIAO DO RIO PRETO (MG)";"MG";"SAO SEBASTIAO DO RIO PRETO";8;2;3;13
2008;"SAO SEBASTIAO DO RIO VERDE (MG)";"MG";"SAO SEBASTIAO DO RIO VERDE";13;2;3;18
2008;"SAO TIAGO (MG)";"MG";"SAO TIAGO";107;10;10;127
2008;"SAO TOMAS DE AQUINO (MG)";"MG";"SAO TOMAS DE AQUINO";69;16;8;93
2008;"SAO TOME DAS LETRAS (MG)";"MG";"SAO TOME DAS LETRAS";83;7;12;102
2008;"SAO VICENTE DE MINAS (MG)";"MG";"SAO VICENTE DE MINAS";67;14;1;82
2008;"SAPUCAI MIRIM (MG)";"MG";"SAPUCAI MIRIM";165;34;11;210
2008;"SARDOA (MG)";"MG";"SARDOA";31;7;6;44
2008;"SARZEDO (MG)";"MG";"SARZEDO";291;23;33;347
2008;"SEM PEIXE (MG)";"MG";"SEM PEIXE";5;4;5;14
2008;"SENADOR AMARAL (MG)";"MG";"SENADOR AMARAL";83;14;7;104
2008;"SENADOR CORTES (MG)";"MG";"SENADOR CORTES";13;4;3;20
2008;"SENADOR FIRMINO (MG)";"MG";"SENADOR FIRMINO";63;7;14;84
2008;"SENADOR JOSE BENTO (MG)";"MG";"SENADOR JOSE BENTO";17;0;6;23
2008;"SENADOR MODESTINO GONCALVES (MG)";"MG";"SENADOR MODESTINO GONCALVES";18;7;5;30
2008;"SENHORA DE OLIVEIRA (MG)";"MG";"SENHORA DE OLIVEIRA";62;5;9;76
2008;"SENHORA DO PORTO (MG)";"MG";"SENHORA DO PORTO";21;3;9;33
2008;"SENHORA DOS REMEDIOS (MG)";"MG";"SENHORA DOS REMEDIOS";70;10;14;94
2008;"SERICITA (MG)";"MG";"SERICITA";62;3;5;70
2008;"SERITINGA (MG)";"MG";"SERITINGA";28;1;2;31
2008;"SERRA AZUL DE MINAS (MG)";"MG";"SERRA AZUL DE MINAS";9;3;8;20
2008;"SERRA DA SAUDADE (MG)";"MG";"SERRA DA SAUDADE";5;5;0;10
2008;"SERRA DO SALITRE (MG)";"MG";"SERRA DO SALITRE";188;7;55;250
2008;"SERRA DOS AIMORES (MG)";"MG";"SERRA DOS AIMORES";57;3;21;81
2008;"SERRANIA (MG)";"MG";"SERRANIA";110;13;7;130
2008;"SERRANOPOLIS DE MINAS (MG)";"MG";"SERRANOPOLIS DE MINAS";5;1;10;16
2008;"SERRANOS (MG)";"MG";"SERRANOS";10;5;1;16
2008;"SERRO (MG)";"MG";"SERRO";144;17;40;201
2008;"SETE LAGOAS (MG)";"MG";"SETE LAGOAS";2678;311;403;3392
2008;"SETUBINHA (MG)";"MG";"SETUBINHA";14;1;15;30
2008;"SILVEIRANIA (MG)";"MG";"SILVEIRANIA";7;2;4;13
2008;"SILVIANOPOLIS (MG)";"MG";"SILVIANOPOLIS";73;10;8;91
2008;"SIMAO PEREIRA (MG)";"MG";"SIMAO PEREIRA";64;5;2;71
2008;"SIMONESIA (MG)";"MG";"SIMONESIA";150;10;27;187
2008;"SOBRALIA (MG)";"MG";"SOBRALIA";27;3;6;36
2008;"SOLEDADE DE MINAS (MG)";"MG";"SOLEDADE DE MINAS";36;7;0;43
2008;"TABULEIRO (MG)";"MG";"TABULEIRO";51;5;6;62
2008;"TAIOBEIRAS (MG)";"MG";"TAIOBEIRAS";512;19;94;625
2008;"TAPARUBA (MG)";"MG";"TAPARUBA";19;2;6;27
2008;"TAPIRA (MG)";"MG";"TAPIRA";39;6;11;56
2008;"TAPIRAI (MG)";"MG";"TAPIRAI";12;1;2;15
2008;"TAQUARACU DE MINAS (MG)";"MG";"TAQUARACU DE MINAS";54;6;8;68
2008;"TARUMIRIM (MG)";"MG";"TARUMIRIM";104;9;18;131
2008;"TEIXEIRAS (MG)";"MG";"TEIXEIRAS";111;10;14;135
2008;"TEOFILO OTONI (MG)";"MG";"TEOFILO OTONI";1236;135;125;1496
2008;"TIMOTEO (MG)";"MG";"TIMOTEO";957;152;115;1224
2008;"TIRADENTES (MG)";"MG";"TIRADENTES";67;12;11;90
2008;"TIROS (MG)";"MG";"TIROS";131;13;6;150
2008;"TOCANTINS (MG)";"MG";"TOCANTINS";181;5;9;195
2008;"TOCOS DO MOJI (MG)";"MG";"TOCOS DO MOJI";40;9;6;55
2008;"TOLEDO (MG)";"MG";"TOLEDO";54;3;7;64
2008;"TOMBOS (MG)";"MG";"TOMBOS";94;15;15;124
2008;"TRES CORACOES (MG)";"MG";"TRES CORACOES";854;77;116;1047
2008;"TRES MARIAS (MG)";"MG";"TRES MARIAS";312;31;79;422
2008;"TRES PONTAS (MG)";"MG";"TRES PONTAS";731;55;121;907
2008;"TUMIRITINGA (MG)";"MG";"TUMIRITINGA";30;3;4;37
2008;"TUPACIGUARA (MG)";"MG";"TUPACIGUARA";390;44;51;485
2008;"TURMALINA (MG)";"MG";"TURMALINA";240;21;42;303
2008;"TURVOLANDIA (MG)";"MG";"TURVOLANDIA";76;15;6;97
2008;"UBA (MG)";"MG";"UBA";1510;60;101;1671
2008;"UBAI (MG)";"MG";"UBAI";21;4;14;39
2008;"UBAPORANGA (MG)";"MG";"UBAPORANGA";124;6;12;142
2008;"UBERABA (MG)";"MG";"UBERABA";3609;629;651;4889
2008;"UBERLANDIA (MG)";"MG";"UBERLANDIA";9532;825;1207;11564
2008;"UMBURATIBA (MG)";"MG";"UMBURATIBA";8;2;1;11
2008;"UNAI (MG)";"MG";"UNAI";1167;54;254;1475
2008;"UNIAO DE MINAS (MG)";"MG";"UNIAO DE MINAS";35;5;23;63
2008;"URUANA DE MINAS (MG)";"MG";"URUANA DE MINAS";14;2;9;25
2008;"URUCANIA (MG)";"MG";"URUCANIA";132;5;32;169
2008;"URUCUIA (MG)";"MG";"URUCUIA";52;4;18;74
2008;"VARGEM ALEGRE (MG)";"MG";"VARGEM ALEGRE";50;6;11;67
2008;"VARGEM BONITA (MG)";"MG";"VARGEM BONITA";16;4;3;23
2008;"VARGEM GRANDE DO RIO PARDO (MG)";"MG";"VARGEM GRANDE DO RIO PARDO";26;3;7;36
2008;"VARGINHA (MG)";"MG";"VARGINHA";1708;112;229;2049
2008;"VARJAO DE MINAS (MG)";"MG";"VARJAO DE MINAS";83;8;39;130
2008;"VARZEA DA PALMA (MG)";"MG";"VARZEA DA PALMA";396;12;62;470
2008;"VARZELANDIA (MG)";"MG";"VARZELANDIA";37;6;24;67
2008;"VAZANTE (MG)";"MG";"VAZANTE";280;29;77;386
2008;"VERDELANDIA (MG)";"MG";"VERDELANDIA";12;2;5;19
2008;"VEREDINHA (MG)";"MG";"VEREDINHA";29;3;18;50
2008;"VERISSIMO (MG)";"MG";"VERISSIMO";35;24;4;63
2008;"VERMELHO NOVO (MG)";"MG";"VERMELHO NOVO";62;6;16;84
2008;"VESPASIANO (MG)";"MG";"VESPASIANO";561;89;122;772
2008;"VICOSA (MG)";"MG";"VICOSA";547;104;146;797
2008;"VIEIRAS (MG)";"MG";"VIEIRAS";23;6;4;33
2008;"VIRGEM DA LAPA (MG)";"MG";"VIRGEM DA LAPA";49;8;17;74
2008;"VIRGINIA (MG)";"MG";"VIRGINIA";99;10;4;113
2008;"VIRGINOPOLIS (MG)";"MG";"VIRGINOPOLIS";77;5;15;97
2008;"VIRGOLANDIA (MG)";"MG";"VIRGOLANDIA";15;5;5;25
2008;"VISCONDE DO RIO BRANCO (MG)";"MG";"VISCONDE DO RIO BRANCO";765;35;62;862
2008;"VOLTA GRANDE (MG)";"MG";"VOLTA GRANDE";39;4;6;49
2008;"WENCESLAU BRAZ (MG)";"MG";"WENCESLAU BRAZ";42;5;4;51
2008;"AGUA CLARA (MS)";"MS";"AGUA CLARA";359;9;61;429
2008;"ALCINOPOLIS (MS)";"MS";"ALCINOPOLIS";65;9;14;88
2008;"AMAMBAI (MS)";"MS";"AMAMBAI";605;13;40;658
2008;"ANASTACIO (MS)";"MS";"ANASTACIO";310;8;16;334
2008;"ANAURILANDIA (MS)";"MS";"ANAURILANDIA";103;11;30;144
2008;"ANGELICA (MS)";"MS";"ANGELICA";180;4;35;219
2008;"ANTONIO JOAO (MS)";"MS";"ANTONIO JOAO";96;1;16;113
2008;"APARECIDA DO TABOADO (MS)";"MS";"APARECIDA DO TABOADO";310;26;43;379
2008;"AQUIDAUANA (MS)";"MS";"AQUIDAUANA";306;17;50;373
2008;"ARAL MOREIRA (MS)";"MS";"ARAL MOREIRA";158;10;15;183
2008;"BANDEIRANTES (MS)";"MS";"BANDEIRANTES";110;2;18;130
2008;"BATAGUASSU (MS)";"MS";"BATAGUASSU";480;17;133;630
2008;"BATAYPORA (MS)";"MS";"BATAYPORA";140;8;23;171
2008;"BELA VISTA (MS)";"MS";"BELA VISTA";176;15;31;222
2008;"BODOQUENA (MS)";"MS";"BODOQUENA";72;9;24;105
2008;"BONITO (MS)";"MS";"BONITO";222;45;41;308
2008;"BRASILANDIA (MS)";"MS";"BRASILANDIA";206;16;57;279
2008;"CAARAPO (MS)";"MS";"CAARAPO";440;8;83;531
2008;"CAMAPUA (MS)";"MS";"CAMAPUA";274;23;22;319
2008;"CAMPO GRANDE (MS)";"MS";"CAMPO GRANDE";10945;631;1503;13079
2008;"CARACOL (MS)";"MS";"CARACOL";35;13;7;55
2008;"CASSILANDIA (MS)";"MS";"CASSILANDIA";418;13;25;456
2008;"CHAPADAO DO SUL (MS)";"MS";"CHAPADAO DO SUL";577;13;60;650
2008;"CORGUINHO (MS)";"MS";"CORGUINHO";43;4;16;63
2008;"CORONEL SAPUCAIA (MS)";"MS";"CORONEL SAPUCAIA";233;1;12;246
2008;"CORUMBA (MS)";"MS";"CORUMBA";658;46;171;875
2008;"COSTA RICA (MS)";"MS";"COSTA RICA";404;7;57;468
2008;"COXIM (MS)";"MS";"COXIM";468;10;51;529
2008;"DEODAPOLIS (MS)";"MS";"DEODAPOLIS";195;10;60;265
2008;"DOIS IRMAOS DO BURITI (MS)";"MS";"DOIS IRMAOS DO BURITI";93;16;23;132
2008;"DOURADINA (MS)";"MS";"DOURADINA";201;3;16;220
2008;"DOURADOS (MS)";"MS";"DOURADOS";3321;159;266;3746
2008;"ELDORADO (MS)";"MS";"ELDORADO";244;8;21;273
2008;"FATIMA DO SUL (MS)";"MS";"FATIMA DO SUL";376;4;24;404
2008;"FIGUEIRAO (MS)";"MS";"FIGUEIRAO";21;14;4;39
2008;"GLORIA DE DOURADOS (MS)";"MS";"GLORIA DE DOURADOS";160;4;28;192
2008;"GUIA LOPES DA LAGUNA (MS)";"MS";"GUIA LOPES DA LAGUNA";119;10;29;158
2008;"IGUATEMI (MS)";"MS";"IGUATEMI";208;4;40;252
2008;"INOCENCIA (MS)";"MS";"INOCENCIA";146;2;20;168
2008;"ITAPORA (MS)";"MS";"ITAPORA";317;15;43;375
2008;"ITAQUIRAI (MS)";"MS";"ITAQUIRAI";162;7;58;227
2008;"IVINHEMA (MS)";"MS";"IVINHEMA";469;7;181;657
2008;"JAPORA (MS)";"MS";"JAPORA";9;4;8;21
2008;"JARAGUARI (MS)";"MS";"JARAGUARI";78;2;14;94
2008;"JARDIM (MS)";"MS";"JARDIM";360;17;29;406
2008;"JATEI (MS)";"MS";"JATEI";30;4;13;47
2008;"JUTI (MS)";"MS";"JUTI";48;3;16;67
2008;"LADARIO (MS)";"MS";"LADARIO";149;23;67;239
2008;"LAGUNA CARAPA (MS)";"MS";"LAGUNA CARAPA";142;3;18;163
2008;"MARACAJU (MS)";"MS";"MARACAJU";783;10;134;927
2008;"MIRANDA (MS)";"MS";"MIRANDA";245;19;54;318
2008;"MUNDO NOVO (MS)";"MS";"MUNDO NOVO";246;17;23;286
2008;"NAVIRAI (MS)";"MS";"NAVIRAI";737;28;142;907
2008;"NIOAQUE (MS)";"MS";"NIOAQUE";121;14;36;171
2008;"NOVA ALVORADA DO SUL (MS)";"MS";"NOVA ALVORADA DO SUL";261;15;77;353
2008;"NOVA ANDRADINA (MS)";"MS";"NOVA ANDRADINA";872;20;175;1067
2008;"NOVO HORIZONTE DO SUL (MS)";"MS";"NOVO HORIZONTE DO SUL";64;5;13;82
2008;"PARANAIBA (MS)";"MS";"PARANAIBA";735;14;73;822
2008;"PARANHOS (MS)";"MS";"PARANHOS";85;4;17;106
2008;"PEDRO GOMES (MS)";"MS";"PEDRO GOMES";73;3;9;85
2008;"PONTA PORA (MS)";"MS";"PONTA PORA";1395;43;149;1587
2008;"PORTO MURTINHO (MS)";"MS";"PORTO MURTINHO";50;7;16;73
2008;"RIBAS DO RIO PARDO (MS)";"MS";"RIBAS DO RIO PARDO";485;15;42;542
2008;"RIO BRILHANTE (MS)";"MS";"RIO BRILHANTE";557;20;132;709
2008;"RIO NEGRO (MS)";"MS";"RIO NEGRO";42;5;7;54
2008;"RIO VERDE DE MATO GROSSO (MS)";"MS";"RIO VERDE DE MATO GROSSO";265;10;15;290
2008;"ROCHEDO (MS)";"MS";"ROCHEDO";36;3;8;47
2008;"SANTA RITA DO PARDO (MS)";"MS";"SANTA RITA DO PARDO";114;11;28;153
2008;"SAO GABRIEL DO OESTE (MS)";"MS";"SAO GABRIEL DO OESTE";709;17;36;762
2008;"SELVIRIA (MS)";"MS";"SELVIRIA";89;5;18;112
2008;"SETE QUEDAS (MS)";"MS";"SETE QUEDAS";189;4;19;212
2008;"SIDROLANDIA (MS)";"MS";"SIDROLANDIA";542;43;157;742
2008;"SONORA (MS)";"MS";"SONORA";179;11;77;267
2008;"TACURU (MS)";"MS";"TACURU";92;4;12;108
2008;"TAQUARUSSU (MS)";"MS";"TAQUARUSSU";43;1;9;53
2008;"TERENOS (MS)";"MS";"TERENOS";261;12;28;301
2008;"TRES LAGOAS (MS)";"MS";"TRES LAGOAS";1357;83;313;1753
2008;"VICENTINA (MS)";"MS";"VICENTINA";94;6;40;140
2008;"ACORIZAL (MT)";"MT";"ACORIZAL";12;2;2;16
2008;"AGUA BOA (MT)";"MT";"AGUA BOA";375;6;22;403
2008;"ALTA FLORESTA (MT)";"MT";"ALTA FLORESTA";1032;14;68;1114
2008;"ALTO ARAGUAIA (MT)";"MT";"ALTO ARAGUAIA";103;7;22;132
2008;"ALTO BOA VISTA (MT)";"MT";"ALTO BOA VISTA";18;0;2;20
2008;"ALTO GARCAS (MT)";"MT";"ALTO GARCAS";232;3;26;261
2008;"ALTO PARAGUAI (MT)";"MT";"ALTO PARAGUAI";22;6;1;29
2008;"ALTO TAQUARI (MT)";"MT";"ALTO TAQUARI";136;10;13;159
2008;"APIACAS (MT)";"MT";"APIACAS";81;6;3;90
2008;"ARAGUAIANA (MT)";"MT";"ARAGUAIANA";7;0;1;8
2008;"ARAGUAINHA (MT)";"MT";"ARAGUAINHA";6;1;0;7
2008;"ARAPUTANGA (MT)";"MT";"ARAPUTANGA";229;8;21;258
2008;"ARENAPOLIS (MT)";"MT";"ARENAPOLIS";175;6;47;228
2008;"ARIPUANA (MT)";"MT";"ARIPUANA";279;9;21;309
2008;"BARAO DE MELGACO (MT)";"MT";"BARAO DE MELGACO";7;0;3;10
2008;"BARRA DO BUGRES (MT)";"MT";"BARRA DO BUGRES";445;14;115;574
2008;"BARRA DO GARCAS (MT)";"MT";"BARRA DO GARCAS";735;23;150;908
2008;"BOM JESUS DO ARAGUAIA (MT)";"MT";"BOM JESUS DO ARAGUAIA";15;0;5;20
2008;"BRASNORTE (MT)";"MT";"BRASNORTE";244;3;34;281
2008;"CACERES (MT)";"MT";"CACERES";695;46;267;1008
2008;"CAMPINAPOLIS (MT)";"MT";"CAMPINAPOLIS";50;2;12;64
2008;"CAMPO NOVO DO PARECIS (MT)";"MT";"CAMPO NOVO DO PARECIS";574;13;86;673
2008;"CAMPO VERDE (MT)";"MT";"CAMPO VERDE";674;33;77;784
2008;"CAMPOS DE JULIO (MT)";"MT";"CAMPOS DE JULIO";138;10;18;166
2008;"CANABRAVA DO NORTE (MT)";"MT";"CANABRAVA DO NORTE";15;0;7;22
2008;"CANARANA (MT)";"MT";"CANARANA";422;7;22;451
2008;"CARLINDA (MT)";"MT";"CARLINDA";103;0;16;119
2008;"CASTANHEIRA (MT)";"MT";"CASTANHEIRA";89;2;10;101
2008;"CHAPADA DOS GUIMARAES (MT)";"MT";"CHAPADA DOS GUIMARAES";174;17;40;231
2008;"CLAUDIA (MT)";"MT";"CLAUDIA";345;3;17;365
2008;"COCALINHO (MT)";"MT";"COCALINHO";14;1;7;22
2008;"COLIDER (MT)";"MT";"COLIDER";684;13;68;765
2008;"COLNIZA (MT)";"MT";"COLNIZA";197;1;3;201
2008;"COMODORO (MT)";"MT";"COMODORO";358;7;48;413
2008;"CONFRESA (MT)";"MT";"CONFRESA";92;4;22;118
2008;"CONQUISTA D OESTE (MT)";"MT";"CONQUISTA D OESTE";28;1;9;38
2008;"COTRIGUACU (MT)";"MT";"COTRIGUACU";111;1;27;139
2008;"CUIABA (MT)";"MT";"CUIABA";6730;589;1604;8923
2008;"CURVELANDIA (MT)";"MT";"CURVELANDIA";58;0;13;71
2008;"DENISE (MT)";"MT";"DENISE";70;4;23;97
2008;"DIAMANTINO (MT)";"MT";"DIAMANTINO";409;12;54;475
2008;"DOM AQUINO (MT)";"MT";"DOM AQUINO";94;7;15;116
2008;"FELIZ NATAL (MT)";"MT";"FELIZ NATAL";189;4;14;207
2008;"FIGUEIROPOLIS D OESTE (MT)";"MT";"FIGUEIROPOLIS D OESTE";63;2;8;73
2008;"GAUCHA DO NORTE (MT)";"MT";"GAUCHA DO NORTE";41;2;8;51
2008;"GENERAL CARNEIRO (MT)";"MT";"GENERAL CARNEIRO";18;4;3;25
2008;"GLORIA D OESTE (MT)";"MT";"GLORIA D OESTE";34;3;8;45
2008;"GUARANTA DO NORTE (MT)";"MT";"GUARANTA DO NORTE";749;7;49;805
2008;"GUIRATINGA (MT)";"MT";"GUIRATINGA";125;6;6;137
2008;"INDIAVAI (MT)";"MT";"INDIAVAI";19;1;6;26
2008;"IPIRANGA DO NORTE (MT)";"MT";"IPIRANGA DO NORTE";61;1;4;66
2008;"ITANHANGA (MT)";"MT";"ITANHANGA";64;2;6;72
2008;"ITAUBA (MT)";"MT";"ITAUBA";92;4;7;103
2008;"ITIQUIRA (MT)";"MT";"ITIQUIRA";74;6;19;99
2008;"JACIARA (MT)";"MT";"JACIARA";483;33;103;619
2008;"JANGADA (MT)";"MT";"JANGADA";49;8;13;70
2008;"JAURU (MT)";"MT";"JAURU";141;2;26;169
2008;"JUARA (MT)";"MT";"JUARA";612;13;39;664
2008;"JUINA (MT)";"MT";"JUINA";743;4;37;784
2008;"JURUENA (MT)";"MT";"JURUENA";121;2;10;133
2008;"JUSCIMEIRA (MT)";"MT";"JUSCIMEIRA";101;5;43;149
2008;"LAMBARI D OESTE (MT)";"MT";"LAMBARI D OESTE";56;1;21;78
2008;"LUCAS DO RIO VERDE (MT)";"MT";"LUCAS DO RIO VERDE";1182;29;82;1293
2008;"LUCIARA (MT)";"MT";"LUCIARA";8;0;2;10
2008;"MARCELANDIA (MT)";"MT";"MARCELANDIA";318;5;15;338
2008;"MATUPA (MT)";"MT";"MATUPA";306;6;25;337
2008;"MIRASSOL D OESTE (MT)";"MT";"MIRASSOL D OESTE";634;6;58;698
2008;"NOBRES (MT)";"MT";"NOBRES";218;8;41;267
2008;"NORTELANDIA (MT)";"MT";"NORTELANDIA";84;4;11;99
2008;"NOSSA SENHORA DO LIVRAMENTO (MT)";"MT";"NOSSA SENHORA DO LIVRAMENTO";47;3;22;72
2008;"NOVA BANDEIRANTES (MT)";"MT";"NOVA BANDEIRANTES";107;2;17;126
2008;"NOVA BRASILANDIA (MT)";"MT";"NOVA BRASILANDIA";27;1;8;36
2008;"NOVA CANAA DO NORTE (MT)";"MT";"NOVA CANAA DO NORTE";165;1;22;188
2008;"NOVA GUARITA (MT)";"MT";"NOVA GUARITA";76;0;11;87
2008;"NOVA LACERDA (MT)";"MT";"NOVA LACERDA";61;0;18;79
2008;"NOVA MARILANDIA (MT)";"MT";"NOVA MARILANDIA";21;4;4;29
2008;"NOVA MARINGA (MT)";"MT";"NOVA MARINGA";70;0;7;77
2008;"NOVA MONTE VERDE (MT)";"MT";"NOVA MONTE VERDE";85;5;2;92
2008;"NOVA MUTUM (MT)";"MT";"NOVA MUTUM";699;13;37;749
2008;"NOVA NAZARE (MT)";"MT";"NOVA NAZARE";6;2;3;11
2008;"NOVA OLIMPIA (MT)";"MT";"NOVA OLIMPIA";265;15;71;351
2008;"NOVA SANTA HELENA (MT)";"MT";"NOVA SANTA HELENA";45;1;9;55
2008;"NOVA UBIRATA (MT)";"MT";"NOVA UBIRATA";101;6;12;119
2008;"NOVA XAVANTINA (MT)";"MT";"NOVA XAVANTINA";281;10;34;325
2008;"NOVO HORIZONTE DO NORTE (MT)";"MT";"NOVO HORIZONTE DO NORTE";35;0;10;45
2008;"NOVO MUNDO (MT)";"MT";"NOVO MUNDO";83;1;6;90
2008;"NOVO SANTO ANTONIO (MT)";"MT";"NOVO SANTO ANTONIO";2;0;2;4
2008;"NOVO SAO JOAQUIM (MT)";"MT";"NOVO SAO JOAQUIM";45;0;9;54
2008;"PARANAITA (MT)";"MT";"PARANAITA";165;5;20;190
2008;"PARANATINGA (MT)";"MT";"PARANATINGA";300;6;35;341
2008;"PEDRA PRETA (MT)";"MT";"PEDRA PRETA";257;10;30;297
2008;"PEIXOTO DE AZEVEDO (MT)";"MT";"PEIXOTO DE AZEVEDO";249;7;45;301
2008;"PLANALTO DA SERRA (MT)";"MT";"PLANALTO DA SERRA";9;1;4;14
2008;"POCONE (MT)";"MT";"POCONE";282;11;24;317
2008;"PONTAL DO ARAGUAIA (MT)";"MT";"PONTAL DO ARAGUAIA";10;1;0;11
2008;"PONTE BRANCA (MT)";"MT";"PONTE BRANCA";4;1;0;5
2008;"PONTES E LACERDA (MT)";"MT";"PONTES E LACERDA";709;20;78;807
2008;"PORTO ALEGRE DO NORTE (MT)";"MT";"PORTO ALEGRE DO NORTE";28;6;22;56
2008;"PORTO DOS GAUCHOS (MT)";"MT";"PORTO DOS GAUCHOS";91;5;6;102
2008;"PORTO ESPERIDIAO (MT)";"MT";"PORTO ESPERIDIAO";98;3;30;131
2008;"PORTO ESTRELA (MT)";"MT";"PORTO ESTRELA";12;2;4;18
2008;"POXOREO (MT)";"MT";"POXOREO";90;9;27;126
2008;"PRIMAVERA DO LESTE (MT)";"MT";"PRIMAVERA DO LESTE";1423;47;90;1560
2008;"QUERENCIA (MT)";"MT";"QUERENCIA";196;1;13;210
2008;"RESERVA DO CABACAL (MT)";"MT";"RESERVA DO CABACAL";22;2;4;28
2008;"RIBEIRAO CASCALHEIRA (MT)";"MT";"RIBEIRAO CASCALHEIRA";61;1;7;69
2008;"RIBEIRAOZINHO (MT)";"MT";"RIBEIRAOZINHO";7;1;6;14
2008;"RIO BRANCO (MT)";"MT";"RIO BRANCO";86;4;14;104
2008;"RONDOLANDIA (MT)";"MT";"RONDOLANDIA";6;0;4;10
2008;"RONDONOPOLIS (MT)";"MT";"RONDONOPOLIS";3264;115;337;3716
2008;"ROSARIO OESTE (MT)";"MT";"ROSARIO OESTE";104;6;18;128
2008;"SALTO DO CEU (MT)";"MT";"SALTO DO CEU";35;2;7;44
2008;"SANTA CARMEN (MT)";"MT";"SANTA CARMEN";121;3;8;132
2008;"SANTA CRUZ DO XINGU (MT)";"MT";"SANTA CRUZ DO XINGU";3;1;3;7
2008;"SANTA RITA DO TRIVELATO (MT)";"MT";"SANTA RITA DO TRIVELATO";37;2;8;47
2008;"SANTA TEREZINHA (MT)";"MT";"SANTA TEREZINHA";6;2;9;17
2008;"SANTO AFONSO (MT)";"MT";"SANTO AFONSO";24;1;4;29
2008;"SANTO ANTONIO DO LESTE (MT)";"MT";"SANTO ANTONIO DO LESTE";52;1;10;63
2008;"SANTO ANTONIO DO LEVERGER (MT)";"MT";"SANTO ANTONIO DO LEVERGER";62;11;12;85
2008;"SAO FELIX DO ARAGUAIA (MT)";"MT";"SAO FELIX DO ARAGUAIA";30;3;17;50
2008;"SAO JOSE DO POVO (MT)";"MT";"SAO JOSE DO POVO";16;1;4;21
2008;"SAO JOSE DO RIO CLARO (MT)";"MT";"SAO JOSE DO RIO CLARO";267;8;39;314
2008;"SAO JOSE DO XINGU (MT)";"MT";"SAO JOSE DO XINGU";8;0;7;15
2008;"SAO JOSE DOS QUATRO MARCOS (MT)";"MT";"SAO JOSE DOS QUATRO MARCOS";362;8;48;418
2008;"SAO PEDRO DA CIPA (MT)";"MT";"SAO PEDRO DA CIPA";18;2;20;40
2008;"SAPEZAL (MT)";"MT";"SAPEZAL";378;5;34;417
2008;"SERRA NOVA DOURADA (MT)";"MT";"SERRA NOVA DOURADA";6;0;1;7
2008;"SINOP (MT)";"MT";"SINOP";2599;43;114;2756
2008;"SORRISO (MT)";"MT";"SORRISO";1760;32;111;1903
2008;"TABAPORA (MT)";"MT";"TABAPORA";89;3;14;106
2008;"TANGARA DA SERRA (MT)";"MT";"TANGARA DA SERRA";1626;69;196;1891
2008;"TAPURAH (MT)";"MT";"TAPURAH";286;7;20;313
2008;"TERRA NOVA DO NORTE (MT)";"MT";"TERRA NOVA DO NORTE";245;10;19;274
2008;"TESOURO (MT)";"MT";"TESOURO";10;1;3;14
2008;"TORIXOREU (MT)";"MT";"TORIXOREU";16;1;3;20
2008;"UNIAO DO SUL (MT)";"MT";"UNIAO DO SUL";76;0;6;82
2008;"VALE DE SAO DOMINGOS (MT)";"MT";"VALE DE SAO DOMINGOS";18;1;8;27
2008;"VARZEA GRANDE (MT)";"MT";"VARZEA GRANDE";3659;213;418;4290
2008;"VERA (MT)";"MT";"VERA";246;4;14;264
2008;"VILA BELA DA SANTISSIMA TRINDA (MT)";"MT";"VILA BELA DA SANTISSIMA TRINDA";81;2;23;106
2008;"VILA RICA (MT)";"MT";"VILA RICA";189;3;20;212
2008;"ABAETETUBA (PA)";"PA";"ABAETETUBA";214;14;151;379
2008;"ABEL FIGUEIREDO (PA)";"PA";"ABEL FIGUEIREDO";41;5;2;48
2008;"ACARA (PA)";"PA";"ACARA";60;3;26;89
2008;"AFUA (PA)";"PA";"AFUA";1;0;0;1
2008;"AGUA AZUL DO NORTE (PA)";"PA";"AGUA AZUL DO NORTE";39;4;5;48
2008;"ALENQUER (PA)";"PA";"ALENQUER";100;3;29;132
2008;"ALMEIRIM (PA)";"PA";"ALMEIRIM";176;10;79;265
2008;"ALTAMIRA (PA)";"PA";"ALTAMIRA";781;110;48;939
2008;"ANAJAS (PA)";"PA";"ANAJAS";0;0;1;1
2008;"ANANINDEUA (PA)";"PA";"ANANINDEUA";3196;295;1042;4533
2008;"ANAPU (PA)";"PA";"ANAPU";35;8;2;45
2008;"AUGUSTO CORREA (PA)";"PA";"AUGUSTO CORREA";24;1;32;57
2008;"AURORA DO PARA (PA)";"PA";"AURORA DO PARA";43;2;40;85
2008;"AVEIRO (PA)";"PA";"AVEIRO";4;0;0;4
2008;"BAGRE (PA)";"PA";"BAGRE";1;0;0;1
2008;"BAIAO (PA)";"PA";"BAIAO";29;0;7;36
2008;"BANNACH (PA)";"PA";"BANNACH";14;0;0;14
2008;"BARCARENA (PA)";"PA";"BARCARENA";618;142;500;1260
2008;"BELEM (PA)";"PA";"BELEM";6752;1195;2413;10360
2008;"BELTERRA (PA)";"PA";"BELTERRA";24;2;15;41
2008;"BENEVIDES (PA)";"PA";"BENEVIDES";349;24;70;443
2008;"BOM JESUS DO TOCANTINS (PA)";"PA";"BOM JESUS DO TOCANTINS";57;13;4;74
2008;"BONITO (PA)";"PA";"BONITO";28;0;30;58
2008;"BRAGANCA (PA)";"PA";"BRAGANCA";313;20;123;456
2008;"BRASIL NOVO (PA)";"PA";"BRASIL NOVO";120;26;2;148
2008;"BREJO GRANDE DO ARAGUAIA (PA)";"PA";"BREJO GRANDE DO ARAGUAIA";8;6;5;19
2008;"BREU BRANCO (PA)";"PA";"BREU BRANCO";220;8;38;266
2008;"BREVES (PA)";"PA";"BREVES";16;0;4;20
2008;"BUJARU (PA)";"PA";"BUJARU";28;4;7;39
2008;"CACHOEIRA DO ARARI (PA)";"PA";"CACHOEIRA DO ARARI";6;2;9;17
2008;"CACHOEIRA DO PIRIA (PA)";"PA";"CACHOEIRA DO PIRIA";21;3;10;34
2008;"CAMETA (PA)";"PA";"CAMETA";74;3;34;111
2008;"CANAA DOS CARAJAS (PA)";"PA";"CANAA DOS CARAJAS";173;40;65;278
2008;"CAPANEMA (PA)";"PA";"CAPANEMA";529;20;89;638
2008;"CAPITAO POCO (PA)";"PA";"CAPITAO POCO";257;17;47;321
2008;"CASTANHAL (PA)";"PA";"CASTANHAL";2068;128;265;2461
2008;"CHAVES (PA)";"PA";"CHAVES";0;0;0;0
2008;"COLARES (PA)";"PA";"COLARES";5;2;0;7
2008;"CONCEICAO DO ARAGUAIA (PA)";"PA";"CONCEICAO DO ARAGUAIA";285;19;59;363
2008;"CONCORDIA DO PARA (PA)";"PA";"CONCORDIA DO PARA";86;0;24;110
2008;"CUMARU DO NORTE (PA)";"PA";"CUMARU DO NORTE";15;0;4;19
2008;"CURIONOPOLIS (PA)";"PA";"CURIONOPOLIS";50;84;3;137
2008;"CURRALINHO (PA)";"PA";"CURRALINHO";1;0;1;2
2008;"CURUA (PA)";"PA";"CURUA";0;0;0;0
2008;"CURUCA (PA)";"PA";"CURUCA";41;5;11;57
2008;"DOM ELISEU (PA)";"PA";"DOM ELISEU";433;31;27;491
2008;"ELDORADO DOS CARAJAS (PA)";"PA";"ELDORADO DOS CARAJAS";110;23;4;137
2008;"FARO (PA)";"PA";"FARO";2;1;0;3
2008;"FLORESTA DO ARAGUAIA (PA)";"PA";"FLORESTA DO ARAGUAIA";64;2;3;69
2008;"GARRAFAO DO NORTE (PA)";"PA";"GARRAFAO DO NORTE";56;2;9;67
2008;"GOIANESIA DO PARA (PA)";"PA";"GOIANESIA DO PARA";239;10;18;267
2008;"GURUPA (PA)";"PA";"GURUPA";3;0;0;3
2008;"IGARAPE ACU (PA)";"PA";"IGARAPE ACU";106;44;49;199
2008;"IGARAPE MIRI (PA)";"PA";"IGARAPE MIRI";54;9;16;79
2008;"INHANGAPI (PA)";"PA";"INHANGAPI";22;1;26;49
2008;"IPIXUNA DO PARA (PA)";"PA";"IPIXUNA DO PARA";42;2;13;57
2008;"IRITUIA (PA)";"PA";"IRITUIA";44;3;26;73
2008;"ITAITUBA (PA)";"PA";"ITAITUBA";536;32;45;613
2008;"ITUPIRANGA (PA)";"PA";"ITUPIRANGA";122;72;16;210
2008;"JACAREACANGA (PA)";"PA";"JACAREACANGA";7;0;0;7
2008;"JACUNDA (PA)";"PA";"JACUNDA";530;19;32;581
2008;"JURUTI (PA)";"PA";"JURUTI";41;2;2;45
2008;"LIMOEIRO DO AJURU (PA)";"PA";"LIMOEIRO DO AJURU";0;0;0;0
2008;"MAE DO RIO (PA)";"PA";"MAE DO RIO";239;11;50;300
2008;"MAGALHAES BARATA (PA)";"PA";"MAGALHAES BARATA";11;20;4;35
2008;"MARABA (PA)";"PA";"MARABA";2722;180;342;3244
2008;"MARACANA (PA)";"PA";"MARACANA";15;12;9;36
2008;"MARAPANIM (PA)";"PA";"MARAPANIM";26;10;16;52
2008;"MARITUBA (PA)";"PA";"MARITUBA";545;71;207;823
2008;"MEDICILANDIA (PA)";"PA";"MEDICILANDIA";131;6;12;149
2008;"MELGACO (PA)";"PA";"MELGACO";1;0;0;1
2008;"MOCAJUBA (PA)";"PA";"MOCAJUBA";7;1;6;14
2008;"MOJU (PA)";"PA";"MOJU";106;5;102;213
2008;"MONTE ALEGRE (PA)";"PA";"MONTE ALEGRE";180;3;85;268
2008;"MUANA (PA)";"PA";"MUANA";0;1;1;2
2008;"NOVA ESPERANCA DO PIRIA (PA)";"PA";"NOVA ESPERANCA DO PIRIA";46;2;12;60
2008;"NOVA IPIXUNA (PA)";"PA";"NOVA IPIXUNA";116;1;22;139
2008;"NOVA TIMBOTEUA (PA)";"PA";"NOVA TIMBOTEUA";35;8;12;55
2008;"NOVO PROGRESSO (PA)";"PA";"NOVO PROGRESSO";136;2;11;149
2008;"NOVO REPARTIMENTO (PA)";"PA";"NOVO REPARTIMENTO";266;22;20;308
2008;"OBIDOS (PA)";"PA";"OBIDOS";127;0;26;153
2008;"OEIRAS DO PARA (PA)";"PA";"OEIRAS DO PARA";4;1;0;5
2008;"ORIXIMINA (PA)";"PA";"ORIXIMINA";231;7;13;251
2008;"OUREM (PA)";"PA";"OUREM";66;2;12;80
2008;"OURILANDIA DO NORTE (PA)";"PA";"OURILANDIA DO NORTE";142;4;5;151
2008;"PACAJA (PA)";"PA";"PACAJA";91;5;7;103
2008;"PALESTINA DO PARA (PA)";"PA";"PALESTINA DO PARA";15;9;1;25
2008;"PARAGOMINAS (PA)";"PA";"PARAGOMINAS";1083;13;120;1216
2008;"PARAUAPEBAS (PA)";"PA";"PARAUAPEBAS";923;464;164;1551
2008;"PAU D ARCO (PA)";"PA";"PAU D ARCO";12;7;3;22
2008;"PEIXE BOI (PA)";"PA";"PEIXE BOI";16;2;8;26
2008;"PICARRA (PA)";"PA";"PICARRA";11;1;2;14
2008;"PLACAS (PA)";"PA";"PLACAS";35;1;1;37
2008;"PONTA DE PEDRAS (PA)";"PA";"PONTA DE PEDRAS";3;0;0;3
2008;"PORTEL (PA)";"PA";"PORTEL";12;0;0;12
2008;"PORTO DE MOZ (PA)";"PA";"PORTO DE MOZ";10;0;0;10
2008;"PRAINHA (PA)";"PA";"PRAINHA";14;0;2;16
2008;"PRIMAVERA (PA)";"PA";"PRIMAVERA";9;1;8;18
2008;"QUATIPURU (PA)";"PA";"QUATIPURU";7;1;12;20
2008;"REDENCAO (PA)";"PA";"REDENCAO";804;49;68;921
2008;"RIO MARIA (PA)";"PA";"RIO MARIA";176;43;14;233
2008;"RONDON DO PARA (PA)";"PA";"RONDON DO PARA";421;34;11;466
2008;"RUROPOLIS (PA)";"PA";"RUROPOLIS";120;6;9;135
2008;"SALINOPOLIS (PA)";"PA";"SALINOPOLIS";106;15;38;159
2008;"SALVATERRA (PA)";"PA";"SALVATERRA";15;16;14;45
2008;"SANTA BARBARA DO PARA (PA)";"PA";"SANTA BARBARA DO PARA";39;9;26;74
2008;"SANTA CRUZ DO ARARI (PA)";"PA";"SANTA CRUZ DO ARARI";1;0;0;1
2008;"SANTA ISABEL DO PARA (PA)";"PA";"SANTA ISABEL DO PARA";445;21;127;593
2008;"SANTA LUZIA DO PARA (PA)";"PA";"SANTA LUZIA DO PARA";80;6;29;115
2008;"SANTA MARIA DAS BARREIRAS (PA)";"PA";"SANTA MARIA DAS BARREIRAS";38;1;8;47
2008;"SANTA MARIA DO PARA (PA)";"PA";"SANTA MARIA DO PARA";180;32;42;254
2008;"SANTANA DO ARAGUAIA (PA)";"PA";"SANTANA DO ARAGUAIA";106;12;10;128
2008;"SANTAREM (PA)";"PA";"SANTAREM";1939;66;462;2467
2008;"SANTAREM NOVO (PA)";"PA";"SANTAREM NOVO";6;2;6;14
2008;"SANTO ANTONIO DO TAUA (PA)";"PA";"SANTO ANTONIO DO TAUA";80;34;79;193
2008;"SAO CAETANO DE ODIVELAS (PA)";"PA";"SAO CAETANO DE ODIVELAS";16;0;1;17
2008;"SAO DOMINGOS DO ARAGUAIA (PA)";"PA";"SAO DOMINGOS DO ARAGUAIA";100;22;14;136
2008;"SAO DOMINGOS DO CAPIM (PA)";"PA";"SAO DOMINGOS DO CAPIM";38;0;12;50
2008;"SAO FELIX DO XINGU (PA)";"PA";"SAO FELIX DO XINGU";145;5;9;159
2008;"SAO FRANCISCO DO PARA (PA)";"PA";"SAO FRANCISCO DO PARA";26;34;21;81
2008;"SAO GERALDO DO ARAGUAIA (PA)";"PA";"SAO GERALDO DO ARAGUAIA";86;7;12;105
2008;"SAO JOAO DA PONTA (PA)";"PA";"SAO JOAO DA PONTA";2;9;5;16
2008;"SAO JOAO DE PIRABAS (PA)";"PA";"SAO JOAO DE PIRABAS";15;7;10;32
2008;"SAO JOAO DO ARAGUAIA (PA)";"PA";"SAO JOAO DO ARAGUAIA";11;16;6;33
2008;"SAO MIGUEL DO GUAMA (PA)";"PA";"SAO MIGUEL DO GUAMA";299;17;61;377
2008;"SAO SEBASTIAO DA BOA VISTA (PA)";"PA";"SAO SEBASTIAO DA BOA VISTA";2;0;0;2
2008;"SAPUCAIA (PA)";"PA";"SAPUCAIA";21;2;3;26
2008;"SENADOR JOSE PORFIRIO (PA)";"PA";"SENADOR JOSE PORFIRIO";17;1;1;19
2008;"SOURE (PA)";"PA";"SOURE";25;1;8;34
2008;"TAILANDIA (PA)";"PA";"TAILANDIA";477;23;44;544
2008;"TERRA ALTA (PA)";"PA";"TERRA ALTA";15;13;13;41
2008;"TERRA SANTA (PA)";"PA";"TERRA SANTA";9;0;1;10
2008;0;0;0;0;0;0;0
2008;"TOME ACU (PA)";"PA";"TOME ACU";327;11;70;408
2008;"TRACUATEUA (PA)";"PA";"TRACUATEUA";15;4;15;34
2008;"TRAIRAO (PA)";"PA";"TRAIRAO";62;1;2;65
2008;"TUCUMA (PA)";"PA";"TUCUMA";352;12;39;403
2008;"TUCURUI (PA)";"PA";"TUCURUI";611;88;129;828
2008;"ULIANOPOLIS (PA)";"PA";"ULIANOPOLIS";145;16;15;176
2008;"URUARA (PA)";"PA";"URUARA";359;7;15;381
2008;"VIGIA (PA)";"PA";"VIGIA";89;3;59;151
2008;"VISEU (PA)";"PA";"VISEU";35;3;21;59
2008;"VITORIA DO XINGU (PA)";"PA";"VITORIA DO XINGU";7;12;7;26
2008;"XINGUARA (PA)";"PA";"XINGUARA";577;25;69;671
2008;"AGUA BRANCA (PB)";"PB";"AGUA BRANCA";10;4;2;16
2008;"AGUIAR (PB)";"PB";"AGUIAR";6;2;1;9
2008;"ALAGOA GRANDE (PB)";"PB";"ALAGOA GRANDE";80;13;22;115
2008;"ALAGOA NOVA (PB)";"PB";"ALAGOA NOVA";85;64;7;156
2008;"ALAGOINHA (PB)";"PB";"ALAGOINHA";45;5;14;64
2008;"ALCANTIL (PB)";"PB";"ALCANTIL";31;15;9;55
2008;"ALGODAO DE JANDAIRA (PB)";"PB";"ALGODAO DE JANDAIRA";13;0;1;14
2008;"ALHANDRA (PB)";"PB";"ALHANDRA";83;15;12;110
2008;"AMPARO (PB)";"PB";"AMPARO";2;1;3;6
2008;"APARECIDA (PB)";"PB";"APARECIDA";28;3;5;36
2008;"ARACAGI (PB)";"PB";"ARACAGI";42;0;24;66
2008;"ARARA (PB)";"PB";"ARARA";38;3;12;53
2008;"ARARUNA (PB)";"PB";"ARARUNA";64;17;17;98
2008;"AREIA (PB)";"PB";"AREIA";91;18;10;119
2008;"AREIA DE BARAUNAS (PB)";"PB";"AREIA DE BARAUNAS";3;1;1;5
2008;"AREIAL (PB)";"PB";"AREIAL";16;4;3;23
2008;"AROEIRAS (PB)";"PB";"AROEIRAS";33;6;9;48
2008;"ASSUNCAO (PB)";"PB";"ASSUNCAO";10;6;3;19
2008;"BAIA DA TRAICAO (PB)";"PB";"BAIA DA TRAICAO";7;4;7;18
2008;"BANANEIRAS (PB)";"PB";"BANANEIRAS";62;11;20;93
2008;"BARAUNA (PB)";"PB";"BARAUNA";14;0;2;16
2008;"BARRA DE SANTA ROSA (PB)";"PB";"BARRA DE SANTA ROSA";49;5;9;63
2008;"BARRA DE SANTANA (PB)";"PB";"BARRA DE SANTANA";44;4;5;53
2008;"BARRA DE SAO MIGUEL (PB)";"PB";"BARRA DE SAO MIGUEL";3;0;1;4
2008;"BAYEUX (PB)";"PB";"BAYEUX";460;27;136;623
2008;"BELEM (PB)";"PB";"BELEM";93;9;11;113
2008;"BELEM DO BREJO DO CRUZ (PB)";"PB";"BELEM DO BREJO DO CRUZ";8;11;1;20
2008;"BERNARDINO BATISTA (PB)";"PB";"BERNARDINO BATISTA";2;0;1;3
2008;"BOA VENTURA (PB)";"PB";"BOA VENTURA";6;1;0;7
2008;"BOA VISTA (PB)";"PB";"BOA VISTA";83;4;10;97
2008;"BOM JESUS (PB)";"PB";"BOM JESUS";4;1;0;5
2008;"BOM SUCESSO (PB)";"PB";"BOM SUCESSO";4;1;3;8
2008;"BONITO DE SANTA FE (PB)";"PB";"BONITO DE SANTA FE";20;4;0;24
2008;"BOQUEIRAO (PB)";"PB";"BOQUEIRAO";159;4;15;178
2008;"BORBOREMA (PB)";"PB";"BORBOREMA";22;11;0;33
2008;"BREJO DO CRUZ (PB)";"PB";"BREJO DO CRUZ";40;8;3;51
2008;"BREJO DOS SANTOS (PB)";"PB";"BREJO DOS SANTOS";12;2;0;14
2008;"CAAPORA (PB)";"PB";"CAAPORA";19;6;2;27
2008;"CABACEIRAS (PB)";"PB";"CABACEIRAS";15;4;13;32
2008;"CABEDELO (PB)";"PB";"CABEDELO";316;13;24;353
2008;"CACHOEIRA DOS INDIOS (PB)";"PB";"CACHOEIRA DOS INDIOS";10;0;3;13
2008;"CACIMBA DE AREIA (PB)";"PB";"CACIMBA DE AREIA";6;0;5;11
2008;"CACIMBA DE DENTRO (PB)";"PB";"CACIMBA DE DENTRO";40;9;28;77
2008;"CACIMBAS (PB)";"PB";"CACIMBAS";3;2;1;6
2008;"CAICARA (PB)";"PB";"CAICARA";13;3;4;20
2008;"CAJAZEIRAS (PB)";"PB";"CAJAZEIRAS";413;23;37;473
2008;"CAJAZEIRINHAS (PB)";"PB";"CAJAZEIRINHAS";7;3;0;10
2008;"CALDAS BRANDAO (PB)";"PB";"CALDAS BRANDAO";17;4;4;25
2008;"CAMALAU (PB)";"PB";"CAMALAU";15;3;9;27
2008;"CAMPINA GRANDE (PB)";"PB";"CAMPINA GRANDE";3843;220;652;4715
2008;"CAPIM (PB)";"PB";"CAPIM";14;1;8;23
2008;"CARAUBAS (PB)";"PB";"CARAUBAS";4;4;2;10
2008;"CARRAPATEIRA (PB)";"PB";"CARRAPATEIRA";0;2;0;2
2008;"CASSERENGUE (PB)";"PB";"CASSERENGUE";16;2;14;32
2008;"CATINGUEIRA (PB)";"PB";"CATINGUEIRA";8;1;0;9
2008;"CATOLE DO ROCHA (PB)";"PB";"CATOLE DO ROCHA";208;25;13;246
2008;"CATURITE (PB)";"PB";"CATURITE";61;13;8;82
2008;"CONCEICAO (PB)";"PB";"CONCEICAO";63;12;5;80
2008;"CONDADO (PB)";"PB";"CONDADO";17;2;4;23
2008;"CONDE (PB)";"PB";"CONDE";55;11;7;73
2008;"CONGO (PB)";"PB";"CONGO";15;2;0;17
2008;"COREMAS (PB)";"PB";"COREMAS";36;8;4;48
2008;"COXIXOLA (PB)";"PB";"COXIXOLA";1;3;0;4
2008;"CRUZ DO ESPIRITO SANTO (PB)";"PB";"CRUZ DO ESPIRITO SANTO";17;4;10;31
2008;"CUBATI (PB)";"PB";"CUBATI";18;2;0;20
2008;"CUITE (PB)";"PB";"CUITE";70;3;7;80
2008;"CUITE DE MAMANGUAPE (PB)";"PB";"CUITE DE MAMANGUAPE";9;4;14;27
2008;"CUITEGI (PB)";"PB";"CUITEGI";16;2;1;19
2008;"CURRAL DE CIMA (PB)";"PB";"CURRAL DE CIMA";15;4;9;28
2008;"CURRAL VELHO (PB)";"PB";"CURRAL VELHO";4;0;2;6
2008;"DAMIAO (PB)";"PB";"DAMIAO";12;3;4;19
2008;"DESTERRO (PB)";"PB";"DESTERRO";21;4;2;27
2008;"DIAMANTE (PB)";"PB";"DIAMANTE";7;2;1;10
2008;"DONA INES (PB)";"PB";"DONA INES";20;2;11;33
2008;"DUAS ESTRADAS (PB)";"PB";"DUAS ESTRADAS";8;4;3;15
2008;"EMAS (PB)";"PB";"EMAS";2;2;2;6
2008;"ESPERANCA (PB)";"PB";"ESPERANCA";340;11;79;430
2008;"FAGUNDES (PB)";"PB";"FAGUNDES";28;5;11;44
2008;"FREI MARTINHO (PB)";"PB";"FREI MARTINHO";6;0;3;9
2008;"GADO BRAVO (PB)";"PB";"GADO BRAVO";22;4;4;30
2008;"GUARABIRA (PB)";"PB";"GUARABIRA";397;35;117;549
2008;"GURINHEM (PB)";"PB";"GURINHEM";29;4;16;49
2008;"GURJAO (PB)";"PB";"GURJAO";11;2;1;14
2008;"IBIARA (PB)";"PB";"IBIARA";6;2;1;9
2008;"IGARACY (PB)";"PB";"IGARACY";12;5;2;19
2008;"IMACULADA (PB)";"PB";"IMACULADA";9;2;1;12
2008;"INGA (PB)";"PB";"INGA";89;5;21;115
2008;"ITABAIANA (PB)";"PB";"ITABAIANA";145;10;31;186
2008;"ITAPORANGA (PB)";"PB";"ITAPORANGA";84;27;11;122
2008;"ITAPOROROCA (PB)";"PB";"ITAPOROROCA";61;3;13;77
2008;"ITATUBA (PB)";"PB";"ITATUBA";23;2;5;30
2008;"JACARAU (PB)";"PB";"JACARAU";38;4;9;51
2008;"JERICO (PB)";"PB";"JERICO";20;2;0;22
2008;"JOAO PESSOA (PB)";"PB";"JOAO PESSOA";4033;603;977;5613
2008;"JUAREZ TAVORA (PB)";"PB";"JUAREZ TAVORA";22;4;9;35
2008;"JUAZEIRINHO (PB)";"PB";"JUAZEIRINHO";42;11;4;57
2008;"JUNCO DO SERIDO (PB)";"PB";"JUNCO DO SERIDO";40;5;4;49
2008;"JURIPIRANGA (PB)";"PB";"JURIPIRANGA";27;3;17;47
2008;"JURU (PB)";"PB";"JURU";9;7;0;16
2008;"LAGOA (PB)";"PB";"LAGOA";10;2;3;15
2008;"LAGOA DE DENTRO (PB)";"PB";"LAGOA DE DENTRO";20;2;5;27
2008;"LAGOA SECA (PB)";"PB";"LAGOA SECA";135;32;16;183
2008;"LASTRO (PB)";"PB";"LASTRO";6;2;0;8
2008;"LIVRAMENTO (PB)";"PB";"LIVRAMENTO";30;5;1;36
2008;"LOGRADOURO (PB)";"PB";"LOGRADOURO";2;4;5;11
2008;"LUCENA (PB)";"PB";"LUCENA";15;1;7;23
2008;"MAE D AGUA (PB)";"PB";"MAE D AGUA";1;0;4;5
2008;"MALTA (PB)";"PB";"MALTA";7;3;2;12
2008;"MAMANGUAPE (PB)";"PB";"MAMANGUAPE";309;7;61;377
2008;"MANAIRA (PB)";"PB";"MANAIRA";11;2;1;14
2008;"MARCACAO (PB)";"PB";"MARCACAO";0;3;9;12
2008;"MARI (PB)";"PB";"MARI";75;4;32;111
2008;"MARIZOPOLIS (PB)";"PB";"MARIZOPOLIS";14;5;1;20
2008;"MASSARANDUBA (PB)";"PB";"MASSARANDUBA";18;3;5;26
2008;"MATARACA (PB)";"PB";"MATARACA";27;4;13;44
2008;"MATINHAS (PB)";"PB";"MATINHAS";5;2;1;8
2008;"MATO GROSSO (PB)";"PB";"MATO GROSSO";4;2;1;7
2008;"MATUREIA (PB)";"PB";"MATUREIA";12;7;2;21
2008;"MOGEIRO (PB)";"PB";"MOGEIRO";22;4;3;29
2008;"MONTADAS (PB)";"PB";"MONTADAS";19;1;4;24
2008;"MONTE HOREBE (PB)";"PB";"MONTE HOREBE";4;1;2;7
2008;"MONTEIRO (PB)";"PB";"MONTEIRO";195;52;32;279
2008;"MULUNGU (PB)";"PB";"MULUNGU";28;3;8;39
2008;"NATUBA (PB)";"PB";"NATUBA";13;1;1;15
2008;"NAZAREZINHO (PB)";"PB";"NAZAREZINHO";20;6;2;28
2008;"NOVA FLORESTA (PB)";"PB";"NOVA FLORESTA";29;5;5;39
2008;"NOVA OLINDA (PB)";"PB";"NOVA OLINDA";19;5;2;26
2008;"NOVA PALMEIRA (PB)";"PB";"NOVA PALMEIRA";14;1;2;17
2008;"OLHO D AGUA (PB)";"PB";"OLHO D AGUA";3;4;3;10
2008;"OLIVEDOS (PB)";"PB";"OLIVEDOS";22;4;7;33
2008;"OURO VELHO (PB)";"PB";"OURO VELHO";10;2;1;13
2008;"PARARI (PB)";"PB";"PARARI";1;1;0;2
2008;"PASSAGEM (PB)";"PB";"PASSAGEM";14;0;1;15
2008;"PATOS (PB)";"PB";"PATOS";689;87;44;820
2008;"PAULISTA (PB)";"PB";"PAULISTA";35;2;3;40
2008;"PEDRA BRANCA (PB)";"PB";"PEDRA BRANCA";3;3;2;8
2008;"PEDRA LAVRADA (PB)";"PB";"PEDRA LAVRADA";22;4;3;29
2008;"PEDRAS DE FOGO (PB)";"PB";"PEDRAS DE FOGO";199;17;55;271
2008;"PEDRO REGIS (PB)";"PB";"PEDRO REGIS";17;1;2;20
2008;"PIANCO (PB)";"PB";"PIANCO";69;10;2;81
2008;"PICUI (PB)";"PB";"PICUI";75;5;15;95
2008;"PILAR (PB)";"PB";"PILAR";13;1;13;27
2008;"PILOES (PB)";"PB";"PILOES";16;2;2;20
2008;"PILOEZINHOS (PB)";"PB";"PILOEZINHOS";11;2;5;18
2008;"PIRPIRITUBA (PB)";"PB";"PIRPIRITUBA";23;0;7;30
2008;"PITIMBU (PB)";"PB";"PITIMBU";12;11;6;29
2008;"POCINHOS (PB)";"PB";"POCINHOS";75;13;14;102
2008;"POCO DANTAS (PB)";"PB";"POCO DANTAS";1;2;1;4
2008;"POCO DE JOSE DE MOURA (PB)";"PB";"POCO DE JOSE DE MOURA";4;1;2;7
2008;"POMBAL (PB)";"PB";"POMBAL";222;17;10;249
2008;"PRATA (PB)";"PB";"PRATA";16;6;2;24
2008;"PRINCESA ISABEL (PB)";"PB";"PRINCESA ISABEL";75;47;3;125
2008;"PUXINANA (PB)";"PB";"PUXINANA";44;10;5;59
2008;"QUEIMADAS (PB)";"PB";"QUEIMADAS";340;106;82;528
2008;"QUIXABA (PB)";"PB";"QUIXABA";3;3;2;8
2008;"REMIGIO (PB)";"PB";"REMIGIO";152;4;13;169
2008;"RIACHAO (PB)";"PB";"RIACHAO";1;0;5;6
2008;"RIACHAO DO BACAMARTE (PB)";"PB";"RIACHAO DO BACAMARTE";5;0;3;8
2008;"RIACHAO DO POCO (PB)";"PB";"RIACHAO DO POCO";5;0;7;12
2008;"RIACHO DE SANTO ANTONIO (PB)";"PB";"RIACHO DE SANTO ANTONIO";9;6;2;17
2008;"RIACHO DOS CAVALOS (PB)";"PB";"RIACHO DOS CAVALOS";12;2;2;16
2008;"RIO TINTO (PB)";"PB";"RIO TINTO";54;4;21;79
2008;"SALGADINHO (PB)";"PB";"SALGADINHO";4;1;0;5
2008;"SALGADO DE SAO FELIX (PB)";"PB";"SALGADO DE SAO FELIX";12;3;0;15
2008;"SANTA CECILIA (PB)";"PB";"SANTA CECILIA";11;0;4;15
2008;"SANTA CRUZ (PB)";"PB";"SANTA CRUZ";9;4;5;18
2008;"SANTA HELENA (PB)";"PB";"SANTA HELENA";7;0;4;11
2008;"SANTA INES (PB)";"PB";"SANTA INES";10;1;0;11
2008;"SANTA LUZIA (PB)";"PB";"SANTA LUZIA";182;18;12;212
2008;"SANTA RITA (PB)";"PB";"SANTA RITA";486;44;184;714
2008;"SANTA TERESINHA (PB)";"PB";"SANTA TERESINHA";17;1;5;23
2008;"SANTANA DE MANGUEIRA (PB)";"PB";"SANTANA DE MANGUEIRA";3;0;1;4
2008;"SANTANA DOS GARROTES (PB)";"PB";"SANTANA DOS GARROTES";15;3;0;18
2008;"SANTAREM (PB)";"PB";"SANTAREM";3;0;0;3
2008;"SANTO ANDRE (PB)";"PB";"SANTO ANDRE";11;1;6;18
2008;"SAO BENTO (PB)";"PB";"SAO BENTO";193;17;12;222
2008;"SAO BENTO DE POMBAL (PB)";"PB";"SAO BENTO DE POMBAL";10;2;1;13
2008;"SAO DOMINGOS DE POMBAL (PB)";"PB";"SAO DOMINGOS DE POMBAL";3;0;2;5
2008;"SAO DOMINGOS DO CARIRI (PB)";"PB";"SAO DOMINGOS DO CARIRI";5;0;1;6
2008;"SAO FRANCISCO (PB)";"PB";"SAO FRANCISCO";9;0;4;13
2008;"SAO JOAO DO CARIRI (PB)";"PB";"SAO JOAO DO CARIRI";14;4;3;21
2008;"SAO JOAO DO RIO DO PEIXE (PB)";"PB";"SAO JOAO DO RIO DO PEIXE";29;1;10;40
2008;"SAO JOAO DO TIGRE (PB)";"PB";"SAO JOAO DO TIGRE";7;0;1;8
2008;"SAO JOSE DA LAGOA TAPADA (PB)";"PB";"SAO JOSE DA LAGOA TAPADA";8;1;3;12
2008;"SAO JOSE DE CAIANA (PB)";"PB";"SAO JOSE DE CAIANA";3;3;1;7
2008;"SAO JOSE DE ESPINHARAS (PB)";"PB";"SAO JOSE DE ESPINHARAS";10;2;2;14
2008;"SAO JOSE DE PIRANHAS (PB)";"PB";"SAO JOSE DE PIRANHAS";33;6;3;42
2008;"SAO JOSE DE PRINCESA (PB)";"PB";"SAO JOSE DE PRINCESA";3;1;1;5
2008;"SAO JOSE DO BONFIM (PB)";"PB";"SAO JOSE DO BONFIM";7;0;2;9
2008;"SAO JOSE DO BREJO DO CRUZ (PB)";"PB";"SAO JOSE DO BREJO DO CRUZ";0;1;0;1
2008;"SAO JOSE DO SABUGI (PB)";"PB";"SAO JOSE DO SABUGI";19;2;1;22
2008;"SAO JOSE DOS CORDEIROS (PB)";"PB";"SAO JOSE DOS CORDEIROS";4;1;2;7
2008;"SAO JOSE DOS RAMOS (PB)";"PB";"SAO JOSE DOS RAMOS";15;1;5;21
2008;"SAO MAMEDE (PB)";"PB";"SAO MAMEDE";14;1;1;16
2008;"SAO MIGUEL DE TAIPU (PB)";"PB";"SAO MIGUEL DE TAIPU";11;0;4;15
2008;"SAO SEBASTIAO DE LAGOA DE ROCA (PB)";"PB";"SAO SEBASTIAO DE LAGOA DE ROCA";36;11;5;52
2008;"SAO SEBASTIAO DO UMBUZEIRO (PB)";"PB";"SAO SEBASTIAO DO UMBUZEIRO";7;0;2;9
2008;"SAPE (PB)";"PB";"SAPE";295;17;70;382
2008;"SERIDO (PB)";"PB";"SERIDO";10;5;4;19
2008;"SERRA BRANCA (PB)";"PB";"SERRA BRANCA";58;17;6;81
2008;"SERRA DA RAIZ (PB)";"PB";"SERRA DA RAIZ";3;0;4;7
2008;"SERRA GRANDE (PB)";"PB";"SERRA GRANDE";4;0;1;5
2008;"SERRA REDONDA (PB)";"PB";"SERRA REDONDA";14;3;2;19
2008;"SERRARIA (PB)";"PB";"SERRARIA";10;3;4;17
2008;"SERTAOZINHO (PB)";"PB";"SERTAOZINHO";3;0;4;7
2008;"SOBRADO (PB)";"PB";"SOBRADO";22;1;2;25
2008;"SOLANEA (PB)";"PB";"SOLANEA";144;18;23;185
2008;"SOLEDADE (PB)";"PB";"SOLEDADE";101;12;10;123
2008;"SOSSEGO (PB)";"PB";"SOSSEGO";15;3;2;20
2008;"SOUSA (PB)";"PB";"SOUSA";537;16;42;595
2008;"SUME (PB)";"PB";"SUME";52;12;14;78
2008;"TACIMA (PB)";"PB";"TACIMA";22;4;12;38
2008;"TAPEROA (PB)";"PB";"TAPEROA";53;6;2;61
2008;"TAVARES (PB)";"PB";"TAVARES";21;6;3;30
2008;"TEIXEIRA (PB)";"PB";"TEIXEIRA";87;9;14;110
2008;"TENORIO (PB)";"PB";"TENORIO";12;0;2;14
2008;"TRIUNFO (PB)";"PB";"TRIUNFO";6;2;2;10
2008;"UIRAUNA (PB)";"PB";"UIRAUNA";48;6;5;59
2008;"UMBUZEIRO (PB)";"PB";"UMBUZEIRO";49;15;19;83
2008;"VARZEA (PB)";"PB";"VARZEA";5;4;2;11
2008;"VIEIROPOLIS (PB)";"PB";"VIEIROPOLIS";10;0;4;14
2008;"VISTA SERRANA (PB)";"PB";"VISTA SERRANA";14;0;3;17
2008;"ZABELE (PB)";"PB";"ZABELE";6;0;0;6
2008;"ABREU E LIMA (PE)";"PE";"ABREU E LIMA";387;30;296;713
2008;"AFOGADOS DA INGAZEIRA (PE)";"PE";"AFOGADOS DA INGAZEIRA";241;24;26;291
2008;"AFRANIO (PE)";"PE";"AFRANIO";74;7;4;85
2008;"AGRESTINA (PE)";"PE";"AGRESTINA";109;14;15;138
2008;"AGUA PRETA (PE)";"PE";"AGUA PRETA";115;22;30;167
2008;"AGUAS BELAS (PE)";"PE";"AGUAS BELAS";206;43;33;282
2008;"ALAGOINHA (PE)";"PE";"ALAGOINHA";67;10;7;84
2008;"ALIANCA (PE)";"PE";"ALIANCA";101;3;76;180
2008;"ALTINHO (PE)";"PE";"ALTINHO";52;11;17;80
2008;"AMARAJI (PE)";"PE";"AMARAJI";67;15;22;104
2008;"ANGELIM (PE)";"PE";"ANGELIM";30;3;2;35
2008;"ARACOIABA (PE)";"PE";"ARACOIABA";56;9;59;124
2008;"ARARIPINA (PE)";"PE";"ARARIPINA";954;22;46;1022
2008;"ARCOVERDE (PE)";"PE";"ARCOVERDE";797;76;96;969
2008;"BARRA DE GUABIRABA (PE)";"PE";"BARRA DE GUABIRABA";52;12;7;71
2008;"BARREIROS (PE)";"PE";"BARREIROS";199;14;30;243
2008;"BELEM DE MARIA (PE)";"PE";"BELEM DE MARIA";69;11;7;87
2008;"BELEM DE SAO FRANCISCO (PE)";"PE";"BELEM DE SAO FRANCISCO";72;6;7;85
2008;"BELO JARDIM (PE)";"PE";"BELO JARDIM";481;86;46;613
2008;"BETANIA (PE)";"PE";"BETANIA";31;4;3;38
2008;"BEZERROS (PE)";"PE";"BEZERROS";526;54;40;620
2008;"BODOCO (PE)";"PE";"BODOCO";145;2;6;153
2008;"BOM CONSELHO (PE)";"PE";"BOM CONSELHO";258;38;19;315
2008;"BOM JARDIM (PE)";"PE";"BOM JARDIM";111;154;24;289
2008;"BONITO (PE)";"PE";"BONITO";240;31;16;287
2008;"BREJAO (PE)";"PE";"BREJAO";29;1;7;37
2008;"BREJINHO (PE)";"PE";"BREJINHO";18;2;3;23
2008;"BREJO DA MADRE DE DEUS (PE)";"PE";"BREJO DA MADRE DE DEUS";153;217;7;377
2008;"BUENOS AIRES (PE)";"PE";"BUENOS AIRES";45;3;7;55
2008;"BUIQUE (PE)";"PE";"BUIQUE";193;30;24;247
2008;"CABO DE SANTO AGOSTINHO (PE)";"PE";"CABO DE SANTO AGOSTINHO";981;135;281;1397
2008;"CABROBO (PE)";"PE";"CABROBO";192;9;7;208
2008;"CACHOEIRINHA (PE)";"PE";"CACHOEIRINHA";104;13;7;124
2008;"CAETES (PE)";"PE";"CAETES";183;24;8;215
2008;"CALCADO (PE)";"PE";"CALCADO";43;4;14;61
2008;"CALUMBI (PE)";"PE";"CALUMBI";46;3;4;53
2008;"CAMARAGIBE (PE)";"PE";"CAMARAGIBE";559;180;99;838
2008;"CAMOCIM DE SAO FELIX (PE)";"PE";"CAMOCIM DE SAO FELIX";108;14;4;126
2008;"CAMUTANGA (PE)";"PE";"CAMUTANGA";61;0;10;71
2008;"CANHOTINHO (PE)";"PE";"CANHOTINHO";172;22;7;201
2008;"CAPOEIRAS (PE)";"PE";"CAPOEIRAS";149;24;1;174
2008;"CARNAIBA (PE)";"PE";"CARNAIBA";45;13;3;61
2008;"CARNAUBEIRA DA PENHA (PE)";"PE";"CARNAUBEIRA DA PENHA";26;2;0;28
2008;"CARPINA (PE)";"PE";"CARPINA";716;83;90;889
2008;"CARUARU (PE)";"PE";"CARUARU";3251;437;421;4109
2008;"CASINHAS (PE)";"PE";"CASINHAS";25;120;4;149
2008;"CATENDE (PE)";"PE";"CATENDE";173;13;29;215
2008;"CEDRO (PE)";"PE";"CEDRO";29;4;7;40
2008;"CHA DE ALEGRIA (PE)";"PE";"CHA DE ALEGRIA";30;7;12;49
2008;"CHA GRANDE (PE)";"PE";"CHA GRANDE";207;29;13;249
2008;"CONDADO (PE)";"PE";"CONDADO";108;6;59;173
2008;"CORRENTES (PE)";"PE";"CORRENTES";63;24;4;91
2008;"CORTES (PE)";"PE";"CORTES";148;16;18;182
2008;"CUMARU (PE)";"PE";"CUMARU";70;36;2;108
2008;"CUPIRA (PE)";"PE";"CUPIRA";202;26;12;240
2008;"CUSTODIA (PE)";"PE";"CUSTODIA";218;22;8;248
2008;"DORMENTES (PE)";"PE";"DORMENTES";86;3;6;95
2008;"ESCADA (PE)";"PE";"ESCADA";270;37;105;412
2008;"EXU (PE)";"PE";"EXU";232;3;16;251
2008;"FEIRA NOVA (PE)";"PE";"FEIRA NOVA";142;13;6;161
2008;"FERNANDO DE NORONHA (PE)";"PE";"FERNANDO DE NORONHA";15;13;9;37
2008;"FERREIROS (PE)";"PE";"FERREIROS";40;2;31;73
2008;"FLORES (PE)";"PE";"FLORES";46;6;3;55
2008;"FLORESTA (PE)";"PE";"FLORESTA";317;2;3;322
2008;"FREI MIGUELINHO (PE)";"PE";"FREI MIGUELINHO";105;118;13;236
2008;"GAMELEIRA (PE)";"PE";"GAMELEIRA";58;8;39;105
2008;"GARANHUNS (PE)";"PE";"GARANHUNS";1450;133;80;1663
2008;"GLORIA DO GOITA (PE)";"PE";"GLORIA DO GOITA";115;20;17;152
2008;"GOIANA (PE)";"PE";"GOIANA";620;39;112;771
2008;"GRANITO (PE)";"PE";"GRANITO";16;1;0;17
2008;"GRAVATA (PE)";"PE";"GRAVATA";708;65;37;810
2008;"IATI (PE)";"PE";"IATI";28;15;15;58
2008;"IBIMIRIM (PE)";"PE";"IBIMIRIM";146;21;5;172
2008;"IBIRAJUBA (PE)";"PE";"IBIRAJUBA";44;0;3;47
2008;"IGARASSU (PE)";"PE";"IGARASSU";647;38;266;951
2008;"IGUARACI (PE)";"PE";"IGUARACI";70;11;14;95
2008;"ILHA DE ITAMARACA (PE)";"PE";"ILHA DE ITAMARACA";48;7;7;62
2008;"INAJA (PE)";"PE";"INAJA";36;1;3;40
2008;"INGAZEIRA (PE)";"PE";"INGAZEIRA";15;0;1;16
2008;"IPOJUCA (PE)";"PE";"IPOJUCA";426;172;134;732
2008;"IPUBI (PE)";"PE";"IPUBI";140;7;18;165
2008;"ITACURUBA (PE)";"PE";"ITACURUBA";14;1;3;18
2008;"ITAIBA (PE)";"PE";"ITAIBA";75;15;3;93
2008;"ITAMBE (PE)";"PE";"ITAMBE";293;7;84;384
2008;"ITAPETIM (PE)";"PE";"ITAPETIM";31;2;3;36
2008;"ITAPISSUMA (PE)";"PE";"ITAPISSUMA";60;41;6;107
2008;"ITAQUITINGA (PE)";"PE";"ITAQUITINGA";32;2;24;58
2008;"JABOATAO DOS GUARARAPES (PE)";"PE";"JABOATAO DOS GUARARAPES";4011;727;1527;6265
2008;"JAQUEIRA (PE)";"PE";"JAQUEIRA";48;3;10;61
2008;"JATAUBA (PE)";"PE";"JATAUBA";49;108;6;163
2008;"JATOBA (PE)";"PE";"JATOBA";23;3;5;31
2008;"JOAO ALFREDO (PE)";"PE";"JOAO ALFREDO";140;384;8;532
2008;"JOAQUIM NABUCO (PE)";"PE";"JOAQUIM NABUCO";98;12;30;140
2008;"JUCATI (PE)";"PE";"JUCATI";82;4;8;94
2008;"JUPI (PE)";"PE";"JUPI";121;8;13;142
2008;"JUREMA (PE)";"PE";"JUREMA";62;6;3;71
2008;"LAGOA DO CARRO (PE)";"PE";"LAGOA DO CARRO";55;9;9;73
2008;"LAGOA DO ITAENGA (PE)";"PE";"LAGOA DO ITAENGA";248;17;48;313
2008;"LAGOA DO OURO (PE)";"PE";"LAGOA DO OURO";31;16;3;50
2008;"LAGOA DOS GATOS (PE)";"PE";"LAGOA DOS GATOS";78;8;4;90
2008;"LAGOA GRANDE (PE)";"PE";"LAGOA GRANDE";67;5;10;82
2008;"LAJEDO (PE)";"PE";"LAJEDO";432;33;29;494
2008;"LIMOEIRO (PE)";"PE";"LIMOEIRO";371;76;40;487
2008;"MACAPARANA (PE)";"PE";"MACAPARANA";121;10;31;162
2008;"MACHADOS (PE)";"PE";"MACHADOS";79;19;6;104
2008;"MANARI (PE)";"PE";"MANARI";26;2;3;31
2008;"MARAIAL (PE)";"PE";"MARAIAL";127;3;11;141
2008;"MIRANDIBA (PE)";"PE";"MIRANDIBA";77;5;1;83
2008;"MOREILANDIA (PE)";"PE";"MOREILANDIA";29;0;3;32
2008;"MORENO (PE)";"PE";"MORENO";427;63;172;662
2008;"NAZARE DA MATA (PE)";"PE";"NAZARE DA MATA";171;9;31;211
2008;"OLINDA (PE)";"PE";"OLINDA";2185;291;1047;3523
2008;"OROBO (PE)";"PE";"OROBO";78;123;20;221
2008;"OROCO (PE)";"PE";"OROCO";43;1;5;49
2008;"OURICURI (PE)";"PE";"OURICURI";437;17;50;504
2008;"PALMARES (PE)";"PE";"PALMARES";443;50;137;630
2008;"PALMEIRINA (PE)";"PE";"PALMEIRINA";16;8;1;25
2008;"PANELAS (PE)";"PE";"PANELAS";66;11;7;84
2008;"PARANATAMA (PE)";"PE";"PARANATAMA";34;10;7;51
2008;"PARNAMIRIM (PE)";"PE";"PARNAMIRIM";110;2;7;119
2008;"PASSIRA (PE)";"PE";"PASSIRA";163;38;15;216
2008;"PAUDALHO (PE)";"PE";"PAUDALHO";357;18;35;410
2008;"PAULISTA (PE)";"PE";"PAULISTA";1078;158;244;1480
2008;"PEDRA (PE)";"PE";"PEDRA";100;15;10;125
2008;"PESQUEIRA (PE)";"PE";"PESQUEIRA";454;45;73;572
2008;"PETROLANDIA (PE)";"PE";"PETROLANDIA";178;2;12;192
2008;"PETROLINA (PE)";"PE";"PETROLINA";2324;188;267;2779
2008;"POCAO (PE)";"PE";"POCAO";34;17;4;55
2008;"POMBOS (PE)";"PE";"POMBOS";276;26;18;320
2008;"PRIMAVERA (PE)";"PE";"PRIMAVERA";61;11;26;98
2008;"QUIPAPA (PE)";"PE";"QUIPAPA";71;9;22;102
2008;"QUIXABA (PE)";"PE";"QUIXABA";16;6;2;24
2008;"RECIFE (PE)";"PE";"RECIFE";13781;1494;2876;18151
2008;"RIACHO DAS ALMAS (PE)";"PE";"RIACHO DAS ALMAS";160;59;18;237
2008;"RIBEIRAO (PE)";"PE";"RIBEIRAO";242;34;71;347
2008;"RIO FORMOSO (PE)";"PE";"RIO FORMOSO";95;8;47;150
2008;"SAIRE (PE)";"PE";"SAIRE";65;8;15;88
2008;"SALGADINHO (PE)";"PE";"SALGADINHO";14;22;3;39
2008;"SALGUEIRO (PE)";"PE";"SALGUEIRO";409;18;39;466
2008;"SALOA (PE)";"PE";"SALOA";53;11;2;66
2008;"SANHARO (PE)";"PE";"SANHARO";62;10;19;91
2008;"SANTA CRUZ (PE)";"PE";"SANTA CRUZ";85;3;4;92
2008;"SANTA CRUZ DA BAIXA VERDE (PE)";"PE";"SANTA CRUZ DA BAIXA VERDE";177;1;2;180
2008;"SANTA CRUZ DO CAPIBARIBE (PE)";"PE";"SANTA CRUZ DO CAPIBARIBE";561;262;34;857
2008;"SANTA FILOMENA (PE)";"PE";"SANTA FILOMENA";32;0;10;42
2008;"SANTA MARIA DA BOA VISTA (PE)";"PE";"SANTA MARIA DA BOA VISTA";149;7;30;186
2008;"SANTA MARIA DO CAMBUCA (PE)";"PE";"SANTA MARIA DO CAMBUCA";109;87;8;204
2008;"SANTA TEREZINHA (PE)";"PE";"SANTA TEREZINHA";24;3;3;30
2008;"SAO BENEDITO DO SUL (PE)";"PE";"SAO BENEDITO DO SUL";23;3;6;32
2008;"SAO BENTO DO UNA (PE)";"PE";"SAO BENTO DO UNA";518;30;50;598
2008;"SAO CAITANO (PE)";"PE";"SAO CAITANO";210;44;30;284
2008;"SAO JOAO (PE)";"PE";"SAO JOAO";90;17;8;115
2008;"SAO JOAQUIM DO MONTE (PE)";"PE";"SAO JOAQUIM DO MONTE";49;10;14;73
2008;"SAO JOSE DA COROA GRANDE (PE)";"PE";"SAO JOSE DA COROA GRANDE";43;4;12;59
2008;"SAO JOSE DO BELMONTE (PE)";"PE";"SAO JOSE DO BELMONTE";202;14;14;230
2008;"SAO JOSE DO EGITO (PE)";"PE";"SAO JOSE DO EGITO";365;26;42;433
2008;"SAO LOURENCO DA MATA (PE)";"PE";"SAO LOURENCO DA MATA";258;20;253;531
2008;"SAO VICENTE FERRER (PE)";"PE";"SAO VICENTE FERRER";105;4;8;117
2008;"SERRA TALHADA (PE)";"PE";"SERRA TALHADA";1127;36;34;1197
2008;"SERRITA (PE)";"PE";"SERRITA";65;3;4;72
2008;"SERTANIA (PE)";"PE";"SERTANIA";304;15;24;343
2008;"SIRINHAEM (PE)";"PE";"SIRINHAEM";168;7;30;205
2008;"SOLIDAO (PE)";"PE";"SOLIDAO";15;2;1;18
2008;"SURUBIM (PE)";"PE";"SURUBIM";504;451;38;993
2008;"TABIRA (PE)";"PE";"TABIRA";124;14;10;148
2008;"TACAIMBO (PE)";"PE";"TACAIMBO";59;11;13;83
2008;"TACARATU (PE)";"PE";"TACARATU";30;10;3;43
2008;"TAMANDARE (PE)";"PE";"TAMANDARE";55;7;10;72
2008;"TAQUARITINGA DO NORTE (PE)";"PE";"TAQUARITINGA DO NORTE";117;73;7;197
2008;"TEREZINHA (PE)";"PE";"TEREZINHA";16;1;4;21
2008;"TERRA NOVA (PE)";"PE";"TERRA NOVA";79;0;4;83
2008;"TIMBAUBA (PE)";"PE";"TIMBAUBA";670;25;60;755
2008;"TORITAMA (PE)";"PE";"TORITAMA";167;44;14;225
2008;"TRACUNHAEM (PE)";"PE";"TRACUNHAEM";40;11;13;64
2008;"TRINDADE (PE)";"PE";"TRINDADE";238;8;9;255
2008;"TRIUNFO (PE)";"PE";"TRIUNFO";152;7;6;165
2008;"TUPANATINGA (PE)";"PE";"TUPANATINGA";99;14;3;116
2008;"TUPARETAMA (PE)";"PE";"TUPARETAMA";76;10;14;100
2008;"VENTUROSA (PE)";"PE";"VENTUROSA";101;16;5;122
2008;"VERDEJANTE (PE)";"PE";"VERDEJANTE";54;1;9;64
2008;"VERTENTE DO LERIO (PE)";"PE";"VERTENTE DO LERIO";47;56;4;107
2008;"VERTENTES (PE)";"PE";"VERTENTES";107;54;18;179
2008;"VICENCIA (PE)";"PE";"VICENCIA";211;12;51;274
2008;"VITORIA DE SANTO ANTAO (PE)";"PE";"VITORIA DE SANTO ANTAO";1729;77;225;2031
2008;"XEXEU (PE)";"PE";"XEXEU";53;3;19;75
2008;"ACAUA (PI)";"PI";"ACAUA";10;1;1;12
2008;"AGRICOLANDIA (PI)";"PI";"AGRICOLANDIA";11;0;7;18
2008;"AGUA BRANCA (PI)";"PI";"AGUA BRANCA";66;8;6;80
2008;"ALAGOINHA DO PIAUI (PI)";"PI";"ALAGOINHA DO PIAUI";10;1;2;13
2008;"ALEGRETE DO PIAUI (PI)";"PI";"ALEGRETE DO PIAUI";4;0;1;5
2008;"ALTO LONGA (PI)";"PI";"ALTO LONGA";16;3;3;22
2008;"ALTOS (PI)";"PI";"ALTOS";143;4;17;164
2008;"ALVORADA DO GURGUEIA (PI)";"PI";"ALVORADA DO GURGUEIA";8;2;3;13
2008;"AMARANTE (PI)";"PI";"AMARANTE";33;5;7;45
2008;"ANGICAL DO PIAUI (PI)";"PI";"ANGICAL DO PIAUI";11;0;1;12
2008;"ANISIO DE ABREU (PI)";"PI";"ANISIO DE ABREU";3;7;3;13
2008;"ANTONIO ALMEIDA (PI)";"PI";"ANTONIO ALMEIDA";12;1;2;15
2008;"AROAZES (PI)";"PI";"AROAZES";7;2;3;12
2008;"AROEIRAS DO ITAIM (PI)";"PI";"AROEIRAS DO ITAIM";5;0;2;7
2008;"ARRAIAL (PI)";"PI";"ARRAIAL";1;0;2;3
2008;"ASSUNCAO DO PIAUI (PI)";"PI";"ASSUNCAO DO PIAUI";2;0;1;3
2008;"AVELINO LOPES (PI)";"PI";"AVELINO LOPES";9;4;1;14
2008;"BAIXA GRANDE DO RIBEIRO (PI)";"PI";"BAIXA GRANDE DO RIBEIRO";13;0;0;13
2008;"BARRA D ALCANTARA (PI)";"PI";"BARRA D ALCANTARA";13;0;0;13
2008;"BARRAS (PI)";"PI";"BARRAS";83;7;21;111
2008;"BARREIRAS DO PIAUI (PI)";"PI";"BARREIRAS DO PIAUI";3;0;0;3
2008;"BARRO DURO (PI)";"PI";"BARRO DURO";32;2;2;36
2008;"BATALHA (PI)";"PI";"BATALHA";51;2;8;61
2008;"BELA VISTA DO PIAUI (PI)";"PI";"BELA VISTA DO PIAUI";2;0;1;3
2008;"BELEM DO PIAUI (PI)";"PI";"BELEM DO PIAUI";2;0;0;2
2008;"BENEDITINOS (PI)";"PI";"BENEDITINOS";15;1;7;23
2008;"BERTOLINIA (PI)";"PI";"BERTOLINIA";14;2;1;17
2008;"BETANIA DO PIAUI (PI)";"PI";"BETANIA DO PIAUI";5;4;2;11
2008;"BOA HORA (PI)";"PI";"BOA HORA";5;0;1;6
2008;"BOCAINA (PI)";"PI";"BOCAINA";5;6;2;13
2008;"BOM JESUS (PI)";"PI";"BOM JESUS";135;0;7;142
2008;"BOM PRINCIPIO DO PIAUI (PI)";"PI";"BOM PRINCIPIO DO PIAUI";6;5;2;13
2008;"BONFIM DO PIAUI (PI)";"PI";"BONFIM DO PIAUI";3;2;3;8
2008;"BOQUEIRAO DO PIAUI (PI)";"PI";"BOQUEIRAO DO PIAUI";5;0;0;5
2008;"BRASILEIRA (PI)";"PI";"BRASILEIRA";11;0;5;16
2008;"BREJO DO PIAUI (PI)";"PI";"BREJO DO PIAUI";3;3;0;6
2008;"BURITI DOS LOPES (PI)";"PI";"BURITI DOS LOPES";17;1;9;27
2008;"BURITI DOS MONTES (PI)";"PI";"BURITI DOS MONTES";7;3;0;10
2008;"CABECEIRAS DO PIAUI (PI)";"PI";"CABECEIRAS DO PIAUI";3;0;5;8
2008;"CAJAZEIRAS DO PIAUI (PI)";"PI";"CAJAZEIRAS DO PIAUI";1;0;0;1
2008;"CAJUEIRO DA PRAIA (PI)";"PI";"CAJUEIRO DA PRAIA";5;1;2;8
2008;"CALDEIRAO GRANDE DO PIAUI (PI)";"PI";"CALDEIRAO GRANDE DO PIAUI";3;2;1;6
2008;"CAMPINAS DO PIAUI (PI)";"PI";"CAMPINAS DO PIAUI";1;1;1;3
2008;"CAMPO ALEGRE DO FIDALGO (PI)";"PI";"CAMPO ALEGRE DO FIDALGO";2;1;0;3
2008;"CAMPO GRANDE DO PIAUI (PI)";"PI";"CAMPO GRANDE DO PIAUI";13;2;0;15
2008;"CAMPO LARGO DO PIAUI (PI)";"PI";"CAMPO LARGO DO PIAUI";1;2;0;3
2008;"CAMPO MAIOR (PI)";"PI";"CAMPO MAIOR";289;10;39;338
2008;"CANAVIEIRA (PI)";"PI";"CANAVIEIRA";0;0;0;0
2008;"CANTO DO BURITI (PI)";"PI";"CANTO DO BURITI";61;5;4;70
2008;"CAPITAO DE CAMPOS (PI)";"PI";"CAPITAO DE CAMPOS";13;2;8;23
2008;"CAPITAO GERVASIO OLIVEIRA (PI)";"PI";"CAPITAO GERVASIO OLIVEIRA";2;0;2;4
2008;"CARACOL (PI)";"PI";"CARACOL";14;2;0;16
2008;"CARAUBAS DO PIAUI (PI)";"PI";"CARAUBAS DO PIAUI";5;1;1;7
2008;"CARIDADE DO PIAUI (PI)";"PI";"CARIDADE DO PIAUI";4;0;2;6
2008;"CASTELO DO PIAUI (PI)";"PI";"CASTELO DO PIAUI";35;1;3;39
2008;"CAXINGO (PI)";"PI";"CAXINGO";6;1;2;9
2008;"COCAL (PI)";"PI";"COCAL";34;3;4;41
2008;"COCAL DE TELHA (PI)";"PI";"COCAL DE TELHA";5;1;1;7
2008;"COCAL DOS ALVES (PI)";"PI";"COCAL DOS ALVES";0;2;0;2
2008;"COIVARAS (PI)";"PI";"COIVARAS";4;0;4;8
2008;"COLONIA DO GURGUEIA (PI)";"PI";"COLONIA DO GURGUEIA";3;4;0;7
2008;"COLONIA DO PIAUI (PI)";"PI";"COLONIA DO PIAUI";7;1;1;9
2008;"CONCEICAO DO CANINDE (PI)";"PI";"CONCEICAO DO CANINDE";2;2;0;4
2008;"CORONEL JOSE DIAS (PI)";"PI";"CORONEL JOSE DIAS";3;0;0;3
2008;"CORRENTE (PI)";"PI";"CORRENTE";54;4;3;61
2008;"CRISTALANDIA DO PIAUI (PI)";"PI";"CRISTALANDIA DO PIAUI";3;0;1;4
2008;"CRISTINO CASTRO (PI)";"PI";"CRISTINO CASTRO";19;2;3;24
2008;"CURIMATA (PI)";"PI";"CURIMATA";7;0;1;8
2008;"CURRAIS (PI)";"PI";"CURRAIS";1;1;0;2
2008;"CURRAL NOVO DO PIAUI (PI)";"PI";"CURRAL NOVO DO PIAUI";0;1;1;2
2008;"CURRALINHOS (PI)";"PI";"CURRALINHOS";3;0;1;4
2008;"DEMERVAL LOBAO (PI)";"PI";"DEMERVAL LOBAO";33;4;2;39
2008;"DIRCEU ARCOVERDE (PI)";"PI";"DIRCEU ARCOVERDE";5;2;1;8
2008;"DOM EXPEDITO LOPES (PI)";"PI";"DOM EXPEDITO LOPES";72;2;2;76
2008;"DOM INOCENCIO (PI)";"PI";"DOM INOCENCIO";9;2;3;14
2008;"DOMINGOS MOURAO (PI)";"PI";"DOMINGOS MOURAO";2;0;0;2
2008;"ELESBAO VELOSO (PI)";"PI";"ELESBAO VELOSO";46;0;5;51
2008;"ELISEU MARTINS (PI)";"PI";"ELISEU MARTINS";7;1;1;9
2008;"ESPERANTINA (PI)";"PI";"ESPERANTINA";108;12;17;137
2008;"FARTURA DO PIAUI (PI)";"PI";"FARTURA DO PIAUI";3;0;1;4
2008;"FLORES DO PIAUI (PI)";"PI";"FLORES DO PIAUI";2;1;0;3
2008;"FLORESTA DO PIAUI (PI)";"PI";"FLORESTA DO PIAUI";0;1;1;2
2008;"FLORIANO (PI)";"PI";"FLORIANO";994;55;33;1082
2008;"FRANCINOPOLIS (PI)";"PI";"FRANCINOPOLIS";7;4;0;11
2008;"FRANCISCO AYRES (PI)";"PI";"FRANCISCO AYRES";4;5;2;11
2008;"FRANCISCO MACEDO (PI)";"PI";"FRANCISCO MACEDO";1;2;2;5
2008;"FRANCISCO SANTOS (PI)";"PI";"FRANCISCO SANTOS";57;7;2;66
2008;"FRONTEIRAS (PI)";"PI";"FRONTEIRAS";50;9;11;70
2008;"GEMINIANO (PI)";"PI";"GEMINIANO";8;4;6;18
2008;"GILBUES (PI)";"PI";"GILBUES";6;1;4;11
2008;"GUADALUPE (PI)";"PI";"GUADALUPE";43;8;4;55
2008;"GUARIBAS (PI)";"PI";"GUARIBAS";1;0;0;1
2008;"HUGO NAPOLEAO (PI)";"PI";"HUGO NAPOLEAO";5;0;1;6
2008;"ILHA GRANDE (PI)";"PI";"ILHA GRANDE";7;3;1;11
2008;"INHUMA (PI)";"PI";"INHUMA";54;4;9;67
2008;"IPIRANGA DO PIAUI (PI)";"PI";"IPIRANGA DO PIAUI";31;8;3;42
2008;"ISAIAS COELHO (PI)";"PI";"ISAIAS COELHO";3;0;2;5
2008;"ITAINOPOLIS (PI)";"PI";"ITAINOPOLIS";17;13;4;34
2008;"ITAUEIRA (PI)";"PI";"ITAUEIRA";20;4;0;24
2008;"JACOBINA DO PIAUI (PI)";"PI";"JACOBINA DO PIAUI";10;1;1;12
2008;"JAICOS (PI)";"PI";"JAICOS";56;6;2;64
2008;"JARDIM DO MULATO (PI)";"PI";"JARDIM DO MULATO";2;1;0;3
2008;"JATOBA DO PIAUI (PI)";"PI";"JATOBA DO PIAUI";17;0;2;19
2008;"JERUMENHA (PI)";"PI";"JERUMENHA";8;1;0;9
2008;"JOAO COSTA (PI)";"PI";"JOAO COSTA";1;0;0;1
2008;"JOAQUIM PIRES (PI)";"PI";"JOAQUIM PIRES";10;0;0;10
2008;"JOCA MARQUES (PI)";"PI";"JOCA MARQUES";1;0;1;2
2008;"JOSE DE FREITAS (PI)";"PI";"JOSE DE FREITAS";49;4;11;64
2008;"JUAZEIRO DO PIAUI (PI)";"PI";"JUAZEIRO DO PIAUI";3;0;0;3
2008;"JULIO BORGES (PI)";"PI";"JULIO BORGES";1;1;0;2
2008;"JUREMA (PI)";"PI";"JUREMA";2;2;1;5
2008;"LAGOA ALEGRE (PI)";"PI";"LAGOA ALEGRE";3;1;3;7
2008;"LAGOA DE SAO FRANCISCO (PI)";"PI";"LAGOA DE SAO FRANCISCO";1;0;0;1
2008;"LAGOA DO BARRO DO PIAUI (PI)";"PI";"LAGOA DO BARRO DO PIAUI";1;1;5;7
2008;"LAGOA DO PIAUI (PI)";"PI";"LAGOA DO PIAUI";9;0;0;9
2008;"LAGOA DO SITIO (PI)";"PI";"LAGOA DO SITIO";11;1;1;13
2008;"LAGOINHA DO PIAUI (PI)";"PI";"LAGOINHA DO PIAUI";3;2;2;7
2008;"LANDRI SALES (PI)";"PI";"LANDRI SALES";2;3;1;6
2008;"LUIS CORREIA (PI)";"PI";"LUIS CORREIA";29;7;11;47
2008;"LUZILANDIA (PI)";"PI";"LUZILANDIA";16;2;5;23
2008;"MADEIRO (PI)";"PI";"MADEIRO";3;1;1;5
2008;"MANOEL EMIDIO (PI)";"PI";"MANOEL EMIDIO";3;1;2;6
2008;"MARCOLANDIA (PI)";"PI";"MARCOLANDIA";52;14;4;70
2008;"MARCOS PARENTE (PI)";"PI";"MARCOS PARENTE";3;5;0;8
2008;"MASSAPE DO PIAUI (PI)";"PI";"MASSAPE DO PIAUI";2;1;0;3
2008;"MATIAS OLIMPIO (PI)";"PI";"MATIAS OLIMPIO";11;5;5;21
2008;"MIGUEL ALVES (PI)";"PI";"MIGUEL ALVES";22;2;10;34
2008;"MIGUEL LEAO (PI)";"PI";"MIGUEL LEAO";2;1;0;3
2008;"MILTON BRANDAO (PI)";"PI";"MILTON BRANDAO";1;0;0;1
2008;"MONSENHOR GIL (PI)";"PI";"MONSENHOR GIL";11;0;1;12
2008;"MONSENHOR HIPOLITO (PI)";"PI";"MONSENHOR HIPOLITO";10;9;1;20
2008;"MONTE ALEGRE DO PIAUI (PI)";"PI";"MONTE ALEGRE DO PIAUI";5;1;1;7
2008;"MORRO CABECA NO TEMPO (PI)";"PI";"MORRO CABECA NO TEMPO";0;0;0;0
2008;"MORRO DO CHAPEU DO PIAUI (PI)";"PI";"MORRO DO CHAPEU DO PIAUI";3;0;2;5
2008;"MURICI DOS PORTELAS (PI)";"PI";"MURICI DOS PORTELAS";3;0;1;4
2008;"NAZARE DO PIAUI (PI)";"PI";"NAZARE DO PIAUI";7;8;2;17
2008;"NOSSA SENHORA DE NAZARE (PI)";"PI";"NOSSA SENHORA DE NAZARE";2;0;4;6
2008;"NOSSA SENHORA DOS REMEDIOS (PI)";"PI";"NOSSA SENHORA DOS REMEDIOS";0;0;0;0
2008;"NOVA SANTA RITA (PI)";"PI";"NOVA SANTA RITA";1;2;0;3
2008;"NOVO ORIENTE DO PIAUI (PI)";"PI";"NOVO ORIENTE DO PIAUI";7;3;4;14
2008;"NOVO SANTO ANTONIO (PI)";"PI";"NOVO SANTO ANTONIO";5;0;1;6
2008;"OEIRAS (PI)";"PI";"OEIRAS";221;22;19;262
2008;"OLHO D AGUA DO PIAUI (PI)";"PI";"OLHO D AGUA DO PIAUI";3;1;1;5
2008;"PADRE MARCOS (PI)";"PI";"PADRE MARCOS";6;3;1;10
2008;"PAES LANDIM (PI)";"PI";"PAES LANDIM";2;1;0;3
2008;"PAJEU DO PIAUI (PI)";"PI";"PAJEU DO PIAUI";4;2;0;6
2008;"PALMEIRA DO PIAUI (PI)";"PI";"PALMEIRA DO PIAUI";14;1;0;15
2008;"PALMEIRAIS (PI)";"PI";"PALMEIRAIS";11;3;4;18
2008;"PAQUETA (PI)";"PI";"PAQUETA";4;7;2;13
2008;"PARNAGUA (PI)";"PI";"PARNAGUA";3;1;0;4
2008;"PARNAIBA (PI)";"PI";"PARNAIBA";785;86;173;1044
2008;"PASSAGEM FRANCA DO PIAUI (PI)";"PI";"PASSAGEM FRANCA DO PIAUI";1;0;0;1
2008;"PATOS DO PIAUI (PI)";"PI";"PATOS DO PIAUI";11;0;5;16
2008;"PAU D ARCO DO PIAUI (PI)";"PI";"PAU D ARCO DO PIAUI";3;0;2;5
2008;"PAULISTANA (PI)";"PI";"PAULISTANA";76;14;7;97
2008;"PAVUSSU (PI)";"PI";"PAVUSSU";1;4;0;5
2008;"PEDRO II (PI)";"PI";"PEDRO II";47;5;3;55
2008;"PEDRO LAURENTINO (PI)";"PI";"PEDRO LAURENTINO";2;0;0;2
2008;"PICOS (PI)";"PI";"PICOS";1361;103;56;1520
2008;"PIMENTEIRAS (PI)";"PI";"PIMENTEIRAS";19;5;1;25
2008;"PIO IX (PI)";"PI";"PIO IX";19;2;3;24
2008;"PIRACURUCA (PI)";"PI";"PIRACURUCA";123;10;20;153
2008;"PIRIPIRI (PI)";"PI";"PIRIPIRI";221;13;70;304
2008;"PORTO (PI)";"PI";"PORTO";3;3;0;6
2008;"PORTO ALEGRE DO PIAUI (PI)";"PI";"PORTO ALEGRE DO PIAUI";5;4;0;9
2008;"PRATA DO PIAUI (PI)";"PI";"PRATA DO PIAUI";3;1;1;5
2008;"QUEIMADA NOVA (PI)";"PI";"QUEIMADA NOVA";8;1;2;11
2008;"REDENCAO DO GURGUEIA (PI)";"PI";"REDENCAO DO GURGUEIA";6;0;6;12
2008;"REGENERACAO (PI)";"PI";"REGENERACAO";49;5;5;59
2008;"RIACHO FRIO (PI)";"PI";"RIACHO FRIO";1;1;1;3
2008;"RIBEIRA DO PIAUI (PI)";"PI";"RIBEIRA DO PIAUI";1;0;1;2
2008;"RIBEIRO GONCALVES (PI)";"PI";"RIBEIRO GONCALVES";9;0;0;9
2008;"RIO GRANDE DO PIAUI (PI)";"PI";"RIO GRANDE DO PIAUI";8;2;2;12
2008;"SANTA CRUZ DO PIAUI (PI)";"PI";"SANTA CRUZ DO PIAUI";12;7;0;19
2008;"SANTA CRUZ DOS MILAGRES (PI)";"PI";"SANTA CRUZ DOS MILAGRES";1;0;0;1
2008;"SANTA FILOMENA (PI)";"PI";"SANTA FILOMENA";6;1;1;8
2008;"SANTA LUZ (PI)";"PI";"SANTA LUZ";5;0;1;6
2008;"SANTA ROSA DO PIAUI (PI)";"PI";"SANTA ROSA DO PIAUI";4;2;3;9
2008;"SANTANA DO PIAUI (PI)";"PI";"SANTANA DO PIAUI";16;3;5;24
2008;"SANTO ANTONIO DE LISBOA (PI)";"PI";"SANTO ANTONIO DE LISBOA";17;8;4;29
2008;"SANTO ANTONIO DOS MILAGRES (PI)";"PI";"SANTO ANTONIO DOS MILAGRES";1;3;0;4
2008;"SANTO INACIO DO PIAUI (PI)";"PI";"SANTO INACIO DO PIAUI";2;3;0;5
2008;"SAO BRAZ DO PIAUI (PI)";"PI";"SAO BRAZ DO PIAUI";1;0;0;1
2008;"SAO FELIX DO PIAUI (PI)";"PI";"SAO FELIX DO PIAUI";4;1;0;5
2008;"SAO FRANCISCO DE ASSIS DO PIAU (PI)";"PI";"SAO FRANCISCO DE ASSIS DO PIAU";1;0;0;1
2008;"SAO FRANCISCO DO PIAUI (PI)";"PI";"SAO FRANCISCO DO PIAUI";5;1;4;10
2008;"SAO GONCALO DO GURGUEIA (PI)";"PI";"SAO GONCALO DO GURGUEIA";1;2;0;3
2008;"SAO GONCALO DO PIAUI (PI)";"PI";"SAO GONCALO DO PIAUI";6;3;5;14
2008;"SAO JOAO DA CANABRAVA (PI)";"PI";"SAO JOAO DA CANABRAVA";9;5;3;17
2008;"SAO JOAO DA FRONTEIRA (PI)";"PI";"SAO JOAO DA FRONTEIRA";2;1;3;6
2008;"SAO JOAO DA SERRA (PI)";"PI";"SAO JOAO DA SERRA";3;0;0;3
2008;"SAO JOAO DA VARJOTA (PI)";"PI";"SAO JOAO DA VARJOTA";1;1;1;3
2008;"SAO JOAO DO ARRAIAL (PI)";"PI";"SAO JOAO DO ARRAIAL";5;1;0;6
2008;"SAO JOAO DO PIAUI (PI)";"PI";"SAO JOAO DO PIAUI";56;6;5;67
2008;"SAO JOSE DO DIVINO (PI)";"PI";"SAO JOSE DO DIVINO";5;1;1;7
2008;"SAO JOSE DO PEIXE (PI)";"PI";"SAO JOSE DO PEIXE";1;1;0;2
2008;"SAO JOSE DO PIAUI (PI)";"PI";"SAO JOSE DO PIAUI";15;7;3;25
2008;"SAO JULIAO (PI)";"PI";"SAO JULIAO";9;7;2;18
2008;"SAO LOURENCO DO PIAUI (PI)";"PI";"SAO LOURENCO DO PIAUI";0;0;1;1
2008;"SAO LUIS DO PIAUI (PI)";"PI";"SAO LUIS DO PIAUI";3;3;0;6
2008;"SAO MIGUEL DA BAIXA GRANDE (PI)";"PI";"SAO MIGUEL DA BAIXA GRANDE";7;1;0;8
2008;"SAO MIGUEL DO FIDALGO (PI)";"PI";"SAO MIGUEL DO FIDALGO";2;1;1;4
2008;"SAO MIGUEL DO TAPUIO (PI)";"PI";"SAO MIGUEL DO TAPUIO";7;0;1;8
2008;"SAO PEDRO DO PIAUI (PI)";"PI";"SAO PEDRO DO PIAUI";26;0;2;28
2008;"SAO RAIMUNDO NONATO (PI)";"PI";"SAO RAIMUNDO NONATO";146;3;17;166
2008;"SEBASTIAO BARROS (PI)";"PI";"SEBASTIAO BARROS";0;2;0;2
2008;"SEBASTIAO LEAL (PI)";"PI";"SEBASTIAO LEAL";7;1;0;8
2008;"SIGEFREDO PACHECO (PI)";"PI";"SIGEFREDO PACHECO";24;3;1;28
2008;"SIMOES (PI)";"PI";"SIMOES";33;1;1;35
2008;"SIMPLICIO MENDES (PI)";"PI";"SIMPLICIO MENDES";32;6;4;42
2008;"SOCORRO DO PIAUI (PI)";"PI";"SOCORRO DO PIAUI";0;0;0;0
2008;"SUSSUAPARA (PI)";"PI";"SUSSUAPARA";12;10;3;25
2008;"TAMBORIL DO PIAUI (PI)";"PI";"TAMBORIL DO PIAUI";2;0;0;2
2008;"TANQUE DO PIAUI (PI)";"PI";"TANQUE DO PIAUI";5;0;2;7
2008;"TERESINA (PI)";"PI";"TERESINA";8024;780;1948;10752
2008;"UNIAO (PI)";"PI";"UNIAO";70;16;25;111
2008;"URUCUI (PI)";"PI";"URUCUI";87;3;4;94
2008;"VALENCA DO PIAUI (PI)";"PI";"VALENCA DO PIAUI";91;17;9;117
2008;"VARZEA BRANCA (PI)";"PI";"VARZEA BRANCA";3;0;6;9
2008;"VARZEA GRANDE (PI)";"PI";"VARZEA GRANDE";5;2;0;7
2008;"VERA MENDES (PI)";"PI";"VERA MENDES";3;3;0;6
2008;"VILA NOVA DO PIAUI (PI)";"PI";"VILA NOVA DO PIAUI";5;1;1;7
2008;"WALL FERRAZ (PI)";"PI";"WALL FERRAZ";3;5;0;8
2008;"ABATIA (PR)";"PR";"ABATIA";114;2;29;145
2008;"ADRIANOPOLIS (PR)";"PR";"ADRIANOPOLIS";87;4;17;108
2008;"AGUDOS DO SUL (PR)";"PR";"AGUDOS DO SUL";282;6;17;305
2008;"ALMIRANTE TAMANDARE (PR)";"PR";"ALMIRANTE TAMANDARE";1049;67;194;1310
2008;"ALTAMIRA DO PARANA (PR)";"PR";"ALTAMIRA DO PARANA";35;4;9;48
2008;"ALTO PARANA (PR)";"PR";"ALTO PARANA";218;6;67;291
2008;"ALTO PIQUIRI (PR)";"PR";"ALTO PIQUIRI";166;4;31;201
2008;"ALTONIA (PR)";"PR";"ALTONIA";335;13;31;379
2008;"ALVORADA DO SUL (PR)";"PR";"ALVORADA DO SUL";250;7;46;303
2008;"AMAPORA (PR)";"PR";"AMAPORA";66;2;32;100
2008;"AMPERE (PR)";"PR";"AMPERE";331;13;21;365
2008;"ANAHY (PR)";"PR";"ANAHY";55;2;7;64
2008;"ANDIRA (PR)";"PR";"ANDIRA";475;11;67;553
2008;"ANGULO (PR)";"PR";"ANGULO";58;1;4;63
2008;"ANTONINA (PR)";"PR";"ANTONINA";79;13;24;116
2008;"ANTONIO OLINTO (PR)";"PR";"ANTONIO OLINTO";107;2;21;130
2008;"APUCARANA (PR)";"PR";"APUCARANA";2115;233;246;2594
2008;"ARAPONGAS (PR)";"PR";"ARAPONGAS";2885;145;91;3121
2008;"ARAPOTI (PR)";"PR";"ARAPOTI";423;27;57;507
2008;"ARAPUA (PR)";"PR";"ARAPUA";78;2;16;96
2008;"ARARUNA (PR)";"PR";"ARARUNA";329;6;24;359
2008;"ARAUCARIA (PR)";"PR";"ARAUCARIA";2446;234;521;3201
2008;"ARIRANHA DO IVAI (PR)";"PR";"ARIRANHA DO IVAI";32;3;13;48
2008;"ASSAI (PR)";"PR";"ASSAI";433;20;29;482
2008;"ASSIS CHATEAUBRIAND (PR)";"PR";"ASSIS CHATEAUBRIAND";1007;25;59;1091
2008;"ASTORGA (PR)";"PR";"ASTORGA";557;30;80;667
2008;"ATALAIA (PR)";"PR";"ATALAIA";88;9;16;113
2008;"BALSA NOVA (PR)";"PR";"BALSA NOVA";245;9;28;282
2008;"BANDEIRANTES (PR)";"PR";"BANDEIRANTES";746;30;90;866
2008;"BARBOSA FERRAZ (PR)";"PR";"BARBOSA FERRAZ";156;6;21;183
2008;"BARRA DO JACARE (PR)";"PR";"BARRA DO JACARE";36;6;7;49
2008;"BARRACAO (PR)";"PR";"BARRACAO";181;19;42;242
2008;"BELA VISTA DO CAROBA (PR)";"PR";"BELA VISTA DO CAROBA";44;2;10;56
2008;"BELA VISTA DO PARAISO (PR)";"PR";"BELA VISTA DO PARAISO";347;10;53;410
2008;"BITURUNA (PR)";"PR";"BITURUNA";343;12;91;446
2008;"BOA ESPERANCA (PR)";"PR";"BOA ESPERANCA";153;4;14;171
2008;"BOA ESPERANCA DO IGUACU (PR)";"PR";"BOA ESPERANCA DO IGUACU";50;6;8;64
2008;"BOA VENTURA DE SAO ROQUE (PR)";"PR";"BOA VENTURA DE SAO ROQUE";144;5;20;169
2008;"BOA VISTA DA APARECIDA (PR)";"PR";"BOA VISTA DA APARECIDA";137;7;21;165
2008;"BOCAIUVA DO SUL (PR)";"PR";"BOCAIUVA DO SUL";218;12;14;244
2008;"BOM JESUS DO SUL (PR)";"PR";"BOM JESUS DO SUL";33;4;5;42
2008;"BOM SUCESSO (PR)";"PR";"BOM SUCESSO";89;2;29;120
2008;"BOM SUCESSO DO SUL (PR)";"PR";"BOM SUCESSO DO SUL";86;11;7;104
2008;"BORRAZOPOLIS (PR)";"PR";"BORRAZOPOLIS";216;2;6;224
2008;"BRAGANEY (PR)";"PR";"BRAGANEY";126;4;17;147
2008;"BRASILANDIA DO SUL (PR)";"PR";"BRASILANDIA DO SUL";49;2;7;58
2008;"CAFEARA (PR)";"PR";"CAFEARA";29;2;10;41
2008;"CAFELANDIA (PR)";"PR";"CAFELANDIA";446;14;41;501
2008;"CAFEZAL DO SUL (PR)";"PR";"CAFEZAL DO SUL";80;1;28;109
2008;"CALIFORNIA (PR)";"PR";"CALIFORNIA";208;4;15;227
2008;"CAMBARA (PR)";"PR";"CAMBARA";874;22;59;955
2008;"CAMBE (PR)";"PR";"CAMBE";1562;161;179;1902
2008;"CAMBIRA (PR)";"PR";"CAMBIRA";202;1;16;219
2008;"CAMPINA DA LAGOA (PR)";"PR";"CAMPINA DA LAGOA";319;13;38;370
2008;"CAMPINA DO SIMAO (PR)";"PR";"CAMPINA DO SIMAO";74;3;20;97
2008;"CAMPINA GRANDE DO SUL (PR)";"PR";"CAMPINA GRANDE DO SUL";621;45;40;706
2008;"CAMPO BONITO (PR)";"PR";"CAMPO BONITO";86;5;9;100
2008;"CAMPO DO TENENTE (PR)";"PR";"CAMPO DO TENENTE";119;8;29;156
2008;"CAMPO LARGO (PR)";"PR";"CAMPO LARGO";1897;176;440;2513
2008;"CAMPO MAGRO (PR)";"PR";"CAMPO MAGRO";301;32;25;358
2008;"CAMPO MOURAO (PR)";"PR";"CAMPO MOURAO";1840;53;436;2329
2008;"CANDIDO DE ABREU (PR)";"PR";"CANDIDO DE ABREU";190;5;32;227
2008;"CANDOI (PR)";"PR";"CANDOI";320;7;69;396
2008;"CANTAGALO (PR)";"PR";"CANTAGALO";210;9;34;253
2008;"CAPANEMA (PR)";"PR";"CAPANEMA";363;11;46;420
2008;"CAPITAO LEONIDAS MARQUES (PR)";"PR";"CAPITAO LEONIDAS MARQUES";421;14;24;459
2008;"CARAMBEI (PR)";"PR";"CARAMBEI";485;26;53;564
2008;"CARLOPOLIS (PR)";"PR";"CARLOPOLIS";234;10;33;277
2008;"CASCAVEL (PR)";"PR";"CASCAVEL";6566;255;699;7520
2008;"CASTRO (PR)";"PR";"CASTRO";1474;102;205;1781
2008;"CATANDUVAS (PR)";"PR";"CATANDUVAS";178;7;21;206
2008;"CENTENARIO DO SUL (PR)";"PR";"CENTENARIO DO SUL";105;14;49;168
2008;"CERRO AZUL (PR)";"PR";"CERRO AZUL";330;8;47;385
2008;"CEU AZUL (PR)";"PR";"CEU AZUL";293;10;33;336
2008;"CHOPINZINHO (PR)";"PR";"CHOPINZINHO";446;17;65;528
2008;"CIANORTE (PR)";"PR";"CIANORTE";1305;46;170;1521
2008;"CIDADE GAUCHA (PR)";"PR";"CIDADE GAUCHA";229;9;74;312
2008;"CLEVELANDIA (PR)";"PR";"CLEVELANDIA";463;27;35;525
2008;"COLOMBO (PR)";"PR";"COLOMBO";3345;186;441;3972
2008;"COLORADO (PR)";"PR";"COLORADO";527;31;67;625
2008;"CONGONHINHAS (PR)";"PR";"CONGONHINHAS";98;6;26;130
2008;"CONSELHEIRO MAIRINCK (PR)";"PR";"CONSELHEIRO MAIRINCK";34;1;6;41
2008;"CONTENDA (PR)";"PR";"CONTENDA";597;10;40;647
2008;"CORBELIA (PR)";"PR";"CORBELIA";658;11;33;702
2008;"CORNELIO PROCOPIO (PR)";"PR";"CORNELIO PROCOPIO";920;74;99;1093
2008;"CORONEL DOMINGOS SOARES (PR)";"PR";"CORONEL DOMINGOS SOARES";100;5;20;125
2008;"CORONEL VIVIDA (PR)";"PR";"CORONEL VIVIDA";581;17;80;678
2008;"CORUMBATAI DO SUL (PR)";"PR";"CORUMBATAI DO SUL";41;2;23;66
2008;"CRUZ MACHADO (PR)";"PR";"CRUZ MACHADO";399;12;52;463
2008;"CRUZEIRO DO IGUACU (PR)";"PR";"CRUZEIRO DO IGUACU";58;3;13;74
2008;"CRUZEIRO DO OESTE (PR)";"PR";"CRUZEIRO DO OESTE";382;14;68;464
2008;"CRUZEIRO DO SUL (PR)";"PR";"CRUZEIRO DO SUL";68;2;17;87
2008;"CRUZMALTINA (PR)";"PR";"CRUZMALTINA";65;2;5;72
2008;"CURITIBA (PR)";"PR";"CURITIBA";34798;3408;5646;43852
2008;"CURIUVA (PR)";"PR";"CURIUVA";186;23;61;270
2008;"DIAMANTE D OESTE (PR)";"PR";"DIAMANTE D OESTE";65;5;12;82
2008;"DIAMANTE DO NORTE (PR)";"PR";"DIAMANTE DO NORTE";64;1;21;86
2008;"DIAMANTE DO SUL (PR)";"PR";"DIAMANTE DO SUL";32;2;5;39
2008;"DOIS VIZINHOS (PR)";"PR";"DOIS VIZINHOS";801;32;74;907
2008;"DOURADINA (PR)";"PR";"DOURADINA";206;7;8;221
2008;"DOUTOR CAMARGO (PR)";"PR";"DOUTOR CAMARGO";135;3;28;166
2008;"DOUTOR ULYSSES (PR)";"PR";"DOUTOR ULYSSES";36;1;8;45
2008;"ENEAS MARQUES (PR)";"PR";"ENEAS MARQUES";140;10;15;165
2008;"ENGENHEIRO BELTRAO (PR)";"PR";"ENGENHEIRO BELTRAO";421;6;72;499
2008;"ENTRE RIOS DO OESTE (PR)";"PR";"ENTRE RIOS DO OESTE";111;4;7;122
2008;"ESPERANCA NOVA (PR)";"PR";"ESPERANCA NOVA";18;2;3;23
2008;"ESPIGAO ALTO DO IGUACU (PR)";"PR";"ESPIGAO ALTO DO IGUACU";50;6;4;60
2008;"FAROL (PR)";"PR";"FAROL";60;0;9;69
2008;"FAXINAL (PR)";"PR";"FAXINAL";302;7;30;339
2008;"FAZENDA RIO GRANDE (PR)";"PR";"FAZENDA RIO GRANDE";741;48;185;974
2008;"FENIX (PR)";"PR";"FENIX";85;2;12;99
2008;"FERNANDES PINHEIRO (PR)";"PR";"FERNANDES PINHEIRO";88;3;16;107
2008;"FIGUEIRA (PR)";"PR";"FIGUEIRA";114;5;27;146
2008;"FLOR DA SERRA DO SUL (PR)";"PR";"FLOR DA SERRA DO SUL";85;2;20;107
2008;"FLORAI (PR)";"PR";"FLORAI";120;2;19;141
2008;"FLORESTA (PR)";"PR";"FLORESTA";210;6;17;233
2008;"FLORESTOPOLIS (PR)";"PR";"FLORESTOPOLIS";184;7;76;267
2008;"FLORIDA (PR)";"PR";"FLORIDA";43;9;9;61
2008;"FORMOSA DO OESTE (PR)";"PR";"FORMOSA DO OESTE";172;24;15;211
2008;"FOZ DO IGUACU (PR)";"PR";"FOZ DO IGUACU";2863;821;842;4526
2008;"FOZ DO JORDAO (PR)";"PR";"FOZ DO JORDAO";59;2;11;72
2008;"FRANCISCO ALVES (PR)";"PR";"FRANCISCO ALVES";148;2;18;168
2008;"FRANCISCO BELTRAO (PR)";"PR";"FRANCISCO BELTRAO";1623;81;172;1876
2008;"GENERAL CARNEIRO (PR)";"PR";"GENERAL CARNEIRO";386;7;46;439
2008;"GODOY MOREIRA (PR)";"PR";"GODOY MOREIRA";37;2;8;47
2008;"GOIOERE (PR)";"PR";"GOIOERE";651;25;62;738
2008;"GOIOXIM (PR)";"PR";"GOIOXIM";69;4;18;91
2008;"GRANDES RIOS (PR)";"PR";"GRANDES RIOS";72;6;7;85
2008;"GUAIRA (PR)";"PR";"GUAIRA";1086;25;53;1164
2008;"GUAIRACA (PR)";"PR";"GUAIRACA";118;3;22;143
2008;"GUAMIRANGA (PR)";"PR";"GUAMIRANGA";131;4;18;153
2008;"GUAPIRAMA (PR)";"PR";"GUAPIRAMA";103;4;19;126
2008;"GUAPOREMA (PR)";"PR";"GUAPOREMA";38;2;4;44
2008;"GUARACI (PR)";"PR";"GUARACI";78;3;25;106
2008;"GUARANIACU (PR)";"PR";"GUARANIACU";350;14;50;414
2008;"GUARAPUAVA (PR)";"PR";"GUARAPUAVA";3812;271;350;4433
2008;"GUARAQUECABA (PR)";"PR";"GUARAQUECABA";18;0;6;24
2008;"GUARATUBA (PR)";"PR";"GUARATUBA";221;20;40;281
2008;"HONORIO SERPA (PR)";"PR";"HONORIO SERPA";111;2;24;137
2008;"IBAITI (PR)";"PR";"IBAITI";456;18;156;630
2008;"IBEMA (PR)";"PR";"IBEMA";133;6;14;153
2008;"IBIPORA (PR)";"PR";"IBIPORA";779;30;107;916
2008;"ICARAIMA (PR)";"PR";"ICARAIMA";101;4;21;126
2008;"IGUARACU (PR)";"PR";"IGUARACU";59;2;12;73
2008;"IGUATU (PR)";"PR";"IGUATU";31;0;7;38
2008;"IMBAU (PR)";"PR";"IMBAU";174;14;29;217
2008;"IMBITUVA (PR)";"PR";"IMBITUVA";619;11;40;670
2008;"INACIO MARTINS (PR)";"PR";"INACIO MARTINS";224;10;24;258
2008;"INAJA (PR)";"PR";"INAJA";35;0;17;52
2008;"INDIANOPOLIS (PR)";"PR";"INDIANOPOLIS";124;3;8;135
2008;"IPIRANGA (PR)";"PR";"IPIRANGA";285;13;35;333
2008;"IPORA (PR)";"PR";"IPORA";316;9;35;360
2008;"IRACEMA DO OESTE (PR)";"PR";"IRACEMA DO OESTE";62;5;4;71
2008;"IRATI (PR)";"PR";"IRATI";1284;60;122;1466
2008;"IRETAMA (PR)";"PR";"IRETAMA";130;3;26;159
2008;"ITAGUAJE (PR)";"PR";"ITAGUAJE";69;6;23;98
2008;"ITAIPULANDIA (PR)";"PR";"ITAIPULANDIA";158;14;24;196
2008;"ITAMBARACA (PR)";"PR";"ITAMBARACA";138;4;24;166
2008;"ITAMBE (PR)";"PR";"ITAMBE";170;6;21;197
2008;"ITAPEJARA D OESTE (PR)";"PR";"ITAPEJARA D OESTE";245;5;18;268
2008;"ITAPERUCU (PR)";"PR";"ITAPERUCU";490;31;51;572
2008;"ITAUNA DO SUL (PR)";"PR";"ITAUNA DO SUL";40;2;7;49
2008;"IVAI (PR)";"PR";"IVAI";267;5;22;294
2008;"IVAIPORA (PR)";"PR";"IVAIPORA";708;21;83;812
2008;"IVATE (PR)";"PR";"IVATE";144;9;46;199
2008;"IVATUBA (PR)";"PR";"IVATUBA";50;2;8;60
2008;"JABOTI (PR)";"PR";"JABOTI";57;4;7;68
2008;"JACAREZINHO (PR)";"PR";"JACAREZINHO";466;55;120;641
2008;"JAGUAPITA (PR)";"PR";"JAGUAPITA";277;14;48;339
2008;"JAGUARIAIVA (PR)";"PR";"JAGUARIAIVA";610;45;91;746
2008;"JANDAIA DO SUL (PR)";"PR";"JANDAIA DO SUL";509;21;88;618
2008;"JANIOPOLIS (PR)";"PR";"JANIOPOLIS";115;4;14;133
2008;"JAPIRA (PR)";"PR";"JAPIRA";33;0;6;39
2008;"JAPURA (PR)";"PR";"JAPURA";193;4;11;208
2008;"JARDIM ALEGRE (PR)";"PR";"JARDIM ALEGRE";181;9;20;210
2008;"JARDIM OLINDA (PR)";"PR";"JARDIM OLINDA";35;2;7;44
2008;"JATAIZINHO (PR)";"PR";"JATAIZINHO";280;18;21;319
2008;"JESUITAS (PR)";"PR";"JESUITAS";216;8;23;247
2008;"JOAQUIM TAVORA (PR)";"PR";"JOAQUIM TAVORA";208;6;15;229
2008;"JUNDIAI DO SUL (PR)";"PR";"JUNDIAI DO SUL";26;2;10;38
2008;"JURANDA (PR)";"PR";"JURANDA";270;2;7;279
2008;"JUSSARA (PR)";"PR";"JUSSARA";148;4;24;176
2008;"KALORE (PR)";"PR";"KALORE";129;6;19;154
2008;"LAPA (PR)";"PR";"LAPA";1047;50;123;1220
2008;"LARANJAL (PR)";"PR";"LARANJAL";41;4;14;59
2008;"LARANJEIRAS DO SUL (PR)";"PR";"LARANJEIRAS DO SUL";576;19;63;658
2008;"LEOPOLIS (PR)";"PR";"LEOPOLIS";69;4;5;78
2008;"LIDIANOPOLIS (PR)";"PR";"LIDIANOPOLIS";68;7;15;90
2008;"LINDOESTE (PR)";"PR";"LINDOESTE";74;6;10;90
2008;"LOANDA (PR)";"PR";"LOANDA";352;9;44;405
2008;"LOBATO (PR)";"PR";"LOBATO";151;5;26;182
2008;"LONDRINA (PR)";"PR";"LONDRINA";7918;634;1648;10200
2008;"LUIZIANA (PR)";"PR";"LUIZIANA";127;2;13;142
2008;"LUNARDELLI (PR)";"PR";"LUNARDELLI";85;6;6;97
2008;"LUPIONOPOLIS (PR)";"PR";"LUPIONOPOLIS";89;2;91;182
2008;"MALLET (PR)";"PR";"MALLET";271;11;32;314
2008;"MAMBORE (PR)";"PR";"MAMBORE";488;4;27;519
2008;"MANDAGUACU (PR)";"PR";"MANDAGUACU";348;8;44;400
2008;"MANDAGUARI (PR)";"PR";"MANDAGUARI";634;21;54;709
2008;"MANDIRITUBA (PR)";"PR";"MANDIRITUBA";784;17;52;853
2008;"MANFRINOPOLIS (PR)";"PR";"MANFRINOPOLIS";26;2;18;46
2008;"MANGUEIRINHA (PR)";"PR";"MANGUEIRINHA";389;14;47;450
2008;"MANOEL RIBAS (PR)";"PR";"MANOEL RIBAS";259;7;25;291
2008;"MARECHAL CANDIDO RONDON (PR)";"PR";"MARECHAL CANDIDO RONDON";1244;48;106;1398
2008;"MARIA HELENA (PR)";"PR";"MARIA HELENA";91;3;20;114
2008;"MARIALVA (PR)";"PR";"MARIALVA";723;35;47;805
2008;"MARILANDIA DO SUL (PR)";"PR";"MARILANDIA DO SUL";205;10;15;230
2008;"MARILENA (PR)";"PR";"MARILENA";98;2;22;122
2008;"MARILUZ (PR)";"PR";"MARILUZ";160;6;51;217
2008;"MARINGA (PR)";"PR";"MARINGA";7369;371;806;8546
2008;"MARIOPOLIS (PR)";"PR";"MARIOPOLIS";173;7;21;201
2008;"MARIPA (PR)";"PR";"MARIPA";253;6;12;271
2008;"MARMELEIRO (PR)";"PR";"MARMELEIRO";279;10;42;331
2008;"MARQUINHO (PR)";"PR";"MARQUINHO";49;2;9;60
2008;"MARUMBI (PR)";"PR";"MARUMBI";79;5;13;97
2008;"MATELANDIA (PR)";"PR";"MATELANDIA";325;5;30;360
2008;"MATINHOS (PR)";"PR";"MATINHOS";219;28;20;267
2008;"MATO RICO (PR)";"PR";"MATO RICO";36;2;7;45
2008;"MAUA DA SERRA (PR)";"PR";"MAUA DA SERRA";173;2;14;189
2008;"MEDIANEIRA (PR)";"PR";"MEDIANEIRA";998;35;86;1119
2008;"MERCEDES (PR)";"PR";"MERCEDES";174;6;23;203
2008;"MIRADOR (PR)";"PR";"MIRADOR";12;2;9;23
2008;"MIRASELVA (PR)";"PR";"MIRASELVA";31;6;20;57
2008;"MISSAL (PR)";"PR";"MISSAL";279;16;27;322
2008;"MOREIRA SALES (PR)";"PR";"MOREIRA SALES";150;10;59;219
2008;"MORRETES (PR)";"PR";"MORRETES";143;13;24;180
2008;"MUNHOZ DE MELLO (PR)";"PR";"MUNHOZ DE MELLO";52;4;9;65
2008;"NOSSA SENHORA DAS GRACAS (PR)";"PR";"NOSSA SENHORA DAS GRACAS";26;5;30;61
2008;"NOVA ALIANCA DO IVAI (PR)";"PR";"NOVA ALIANCA DO IVAI";16;5;4;25
2008;"NOVA AMERICA DA COLINA (PR)";"PR";"NOVA AMERICA DA COLINA";99;4;10;113
2008;"NOVA AURORA (PR)";"PR";"NOVA AURORA";363;9;29;401
2008;"NOVA CANTU (PR)";"PR";"NOVA CANTU";100;1;22;123
2008;"NOVA ESPERANCA (PR)";"PR";"NOVA ESPERANCA";681;24;52;757
2008;"NOVA ESPERANCA DO SUDOESTE (PR)";"PR";"NOVA ESPERANCA DO SUDOESTE";67;8;13;88
2008;"NOVA FATIMA (PR)";"PR";"NOVA FATIMA";202;2;26;230
2008;"NOVA LARANJEIRAS (PR)";"PR";"NOVA LARANJEIRAS";124;3;28;155
2008;"NOVA LONDRINA (PR)";"PR";"NOVA LONDRINA";350;10;40;400
2008;"NOVA OLIMPIA (PR)";"PR";"NOVA OLIMPIA";78;5;23;106
2008;"NOVA PRATA DO IGUACU (PR)";"PR";"NOVA PRATA DO IGUACU";201;3;23;227
2008;"NOVA SANTA BARBARA (PR)";"PR";"NOVA SANTA BARBARA";110;8;4;122
2008;"NOVA SANTA ROSA (PR)";"PR";"NOVA SANTA ROSA";281;7;11;299
2008;"NOVA TEBAS (PR)";"PR";"NOVA TEBAS";79;4;9;92
2008;"NOVO ITACOLOMI (PR)";"PR";"NOVO ITACOLOMI";67;1;6;74
2008;"ORTIGUEIRA (PR)";"PR";"ORTIGUEIRA";277;15;51;343
2008;"OURIZONA (PR)";"PR";"OURIZONA";62;4;19;85
2008;"OURO VERDE DO OESTE (PR)";"PR";"OURO VERDE DO OESTE";130;4;9;143
2008;"PAICANDU (PR)";"PR";"PAICANDU";386;17;39;442
2008;"PALMAS (PR)";"PR";"PALMAS";777;49;66;892
2008;"PALMEIRA (PR)";"PR";"PALMEIRA";800;30;58;888
2008;"PALMITAL (PR)";"PR";"PALMITAL";195;11;38;244
2008;"PALOTINA (PR)";"PR";"PALOTINA";1027;24;92;1143
2008;"PARAISO DO NORTE (PR)";"PR";"PARAISO DO NORTE";220;15;45;280
2008;"PARANACITY (PR)";"PR";"PARANACITY";198;11;40;249
2008;"PARANAGUA (PR)";"PR";"PARANAGUA";1470;113;131;1714
2008;"PARANAPOEMA (PR)";"PR";"PARANAPOEMA";46;1;15;62
2008;"PARANAVAI (PR)";"PR";"PARANAVAI";1643;62;164;1869
2008;"PATO BRAGADO (PR)";"PR";"PATO BRAGADO";121;3;14;138
2008;"PATO BRANCO (PR)";"PR";"PATO BRANCO";1656;113;320;2089
2008;"PAULA FREITAS (PR)";"PR";"PAULA FREITAS";123;2;15;140
2008;"PAULO FRONTIN (PR)";"PR";"PAULO FRONTIN";134;2;11;147
2008;"PEABIRU (PR)";"PR";"PEABIRU";266;13;14;293
2008;"PEROBAL (PR)";"PR";"PEROBAL";88;2;28;118
2008;"PEROLA (PR)";"PR";"PEROLA";185;5;13;203
2008;"PEROLA D OESTE (PR)";"PR";"PEROLA D OESTE";121;2;19;142
2008;"PIEN (PR)";"PR";"PIEN";315;15;13;343
2008;"PINHAIS (PR)";"PR";"PINHAIS";1659;131;248;2038
2008;"PINHAL DO SAO BENTO (PR)";"PR";"PINHAL DO SAO BENTO";32;2;8;42
2008;"PINHALAO (PR)";"PR";"PINHALAO";76;6;14;96
2008;"PINHAO (PR)";"PR";"PINHAO";403;10;72;485
2008;"PIRAI DO SUL (PR)";"PR";"PIRAI DO SUL";402;20;68;490
2008;"PIRAQUARA (PR)";"PR";"PIRAQUARA";389;63;138;590
2008;"PITANGA (PR)";"PR";"PITANGA";670;17;95;782
2008;"PITANGUEIRAS (PR)";"PR";"PITANGUEIRAS";50;4;21;75
2008;"PLANALTINA DO PARANA (PR)";"PR";"PLANALTINA DO PARANA";84;3;11;98
2008;"PLANALTO (PR)";"PR";"PLANALTO";287;11;24;322
2008;"PONTA GROSSA (PR)";"PR";"PONTA GROSSA";5232;434;884;6550
2008;"PONTAL DO PARANA (PR)";"PR";"PONTAL DO PARANA";159;10;36;205
2008;"PORECATU (PR)";"PR";"PORECATU";301;19;124;444
2008;"PORTO AMAZONAS (PR)";"PR";"PORTO AMAZONAS";49;8;8;65
2008;"PORTO BARREIRO (PR)";"PR";"PORTO BARREIRO";52;4;18;74
2008;"PORTO RICO (PR)";"PR";"PORTO RICO";18;0;7;25
2008;"PORTO VITORIA (PR)";"PR";"PORTO VITORIA";147;3;10;160
2008;"PRADO FERREIRA (PR)";"PR";"PRADO FERREIRA";79;3;10;92
2008;"PRANCHITA (PR)";"PR";"PRANCHITA";198;1;12;211
2008;"PRESIDENTE CASTELO BRANCO (PR)";"PR";"PRESIDENTE CASTELO BRANCO";65;6;21;92
2008;"PRIMEIRO DE MAIO (PR)";"PR";"PRIMEIRO DE MAIO";268;12;21;301
2008;"PRUDENTOPOLIS (PR)";"PR";"PRUDENTOPOLIS";946;19;96;1061
2008;"QUARTO CENTENARIO (PR)";"PR";"QUARTO CENTENARIO";124;6;8;138
2008;"QUATIGUA (PR)";"PR";"QUATIGUA";339;7;14;360
2008;"QUATRO BARRAS (PR)";"PR";"QUATRO BARRAS";512;38;122;672
2008;"QUATRO PONTES (PR)";"PR";"QUATRO PONTES";154;4;5;163
2008;"QUEDAS DO IGUACU (PR)";"PR";"QUEDAS DO IGUACU";520;14;108;642
2008;"QUERENCIA DO NORTE (PR)";"PR";"QUERENCIA DO NORTE";169;4;21;194
2008;"QUINTA DO SOL (PR)";"PR";"QUINTA DO SOL";101;3;17;121
2008;"QUITANDINHA (PR)";"PR";"QUITANDINHA";436;6;50;492
2008;"RAMILANDIA (PR)";"PR";"RAMILANDIA";47;2;8;57
2008;"RANCHO ALEGRE (PR)";"PR";"RANCHO ALEGRE";99;2;11;112
2008;"RANCHO ALEGRE D OESTE (PR)";"PR";"RANCHO ALEGRE D OESTE";80;2;9;91
2008;"REALEZA (PR)";"PR";"REALEZA";472;18;32;522
2008;"REBOUCAS (PR)";"PR";"REBOUCAS";218;8;34;260
2008;"RENASCENCA (PR)";"PR";"RENASCENCA";181;5;27;213
2008;"RESERVA (PR)";"PR";"RESERVA";466;10;52;528
2008;"RESERVA DO IGUACU (PR)";"PR";"RESERVA DO IGUACU";66;6;15;87
2008;"RIBEIRAO CLARO (PR)";"PR";"RIBEIRAO CLARO";150;21;19;190
2008;"RIBEIRAO DO PINHAL (PR)";"PR";"RIBEIRAO DO PINHAL";180;26;22;228
2008;"RIO AZUL (PR)";"PR";"RIO AZUL";212;6;34;252
2008;"RIO BOM (PR)";"PR";"RIO BOM";64;3;8;75
2008;"RIO BONITO DO IGUACU (PR)";"PR";"RIO BONITO DO IGUACU";205;6;53;264
2008;"RIO BRANCO DO IVAI (PR)";"PR";"RIO BRANCO DO IVAI";40;2;10;52
2008;"RIO BRANCO DO SUL (PR)";"PR";"RIO BRANCO DO SUL";590;65;77;732
2008;"RIO NEGRO (PR)";"PR";"RIO NEGRO";780;53;51;884
2008;"ROLANDIA (PR)";"PR";"ROLANDIA";1455;70;90;1615
2008;"RONCADOR (PR)";"PR";"RONCADOR";258;2;26;286
2008;"RONDON (PR)";"PR";"RONDON";249;9;50;308
2008;"ROSARIO DO IVAI (PR)";"PR";"ROSARIO DO IVAI";48;6;18;72
2008;"SABAUDIA (PR)";"PR";"SABAUDIA";145;6;13;164
2008;"SALGADO FILHO (PR)";"PR";"SALGADO FILHO";72;3;17;92
2008;"SALTO DO ITARARE (PR)";"PR";"SALTO DO ITARARE";81;5;18;104
2008;"SALTO DO LONTRA (PR)";"PR";"SALTO DO LONTRA";214;6;26;246
2008;"SANTA AMELIA (PR)";"PR";"SANTA AMELIA";75;5;13;93
2008;"SANTA CECILIA DO PAVAO (PR)";"PR";"SANTA CECILIA DO PAVAO";63;9;9;81
2008;"SANTA CRUZ DO MONTE CASTELO (PR)";"PR";"SANTA CRUZ DO MONTE CASTELO";173;7;25;205
2008;"SANTA FE (PR)";"PR";"SANTA FE";176;8;26;210
2008;"SANTA HELENA (PR)";"PR";"SANTA HELENA";548;27;79;654
2008;"SANTA INES (PR)";"PR";"SANTA INES";10;4;9;23
2008;"SANTA ISABEL DO IVAI (PR)";"PR";"SANTA ISABEL DO IVAI";159;9;24;192
2008;"SANTA IZABEL DO OESTE (PR)";"PR";"SANTA IZABEL DO OESTE";203;9;28;240
2008;"SANTA LUCIA (PR)";"PR";"SANTA LUCIA";93;1;8;102
2008;"SANTA MARIA DO OESTE (PR)";"PR";"SANTA MARIA DO OESTE";147;8;19;174
2008;"SANTA MARIANA (PR)";"PR";"SANTA MARIANA";243;12;36;291
2008;"SANTA MONICA (PR)";"PR";"SANTA MONICA";45;3;12;60
2008;"SANTA TEREZA DO OESTE (PR)";"PR";"SANTA TEREZA DO OESTE";162;11;11;184
2008;"SANTA TEREZINHA DE ITAIPU (PR)";"PR";"SANTA TEREZINHA DE ITAIPU";378;27;41;446
2008;"SANTANA DO ITARARE (PR)";"PR";"SANTANA DO ITARARE";82;2;14;98
2008;"SANTO ANTONIO DA PLATINA (PR)";"PR";"SANTO ANTONIO DA PLATINA";522;23;206;751
2008;"SANTO ANTONIO DO CAIUA (PR)";"PR";"SANTO ANTONIO DO CAIUA";15;3;9;27
2008;"SANTO ANTONIO DO PARAISO (PR)";"PR";"SANTO ANTONIO DO PARAISO";65;3;7;75
2008;"SANTO ANTONIO DO SUDOESTE (PR)";"PR";"SANTO ANTONIO DO SUDOESTE";301;12;36;349
2008;"SANTO INACIO (PR)";"PR";"SANTO INACIO";77;7;18;102
2008;"SAO CARLOS DO IVAI (PR)";"PR";"SAO CARLOS DO IVAI";206;9;23;238
2008;"SAO JERONIMO DA SERRA (PR)";"PR";"SAO JERONIMO DA SERRA";103;5;17;125
2008;"SAO JOAO (PR)";"PR";"SAO JOAO";270;11;34;315
2008;"SAO JOAO DO CAIUA (PR)";"PR";"SAO JOAO DO CAIUA";58;3;26;87
2008;"SAO JOAO DO IVAI (PR)";"PR";"SAO JOAO DO IVAI";256;10;36;302
2008;"SAO JOAO DO TRIUNFO (PR)";"PR";"SAO JOAO DO TRIUNFO";172;7;32;211
2008;"SAO JORGE D OESTE (PR)";"PR";"SAO JORGE D OESTE";169;9;25;203
2008;"SAO JORGE DO IVAI (PR)";"PR";"SAO JORGE DO IVAI";244;4;13;261
2008;"SAO JORGE DO PATROCINIO (PR)";"PR";"SAO JORGE DO PATROCINIO";99;4;14;117
2008;"SAO JOSE DA BOA VISTA (PR)";"PR";"SAO JOSE DA BOA VISTA";85;2;15;102
2008;"SAO JOSE DAS PALMEIRAS (PR)";"PR";"SAO JOSE DAS PALMEIRAS";57;9;12;78
2008;"SAO JOSE DOS PINHAIS (PR)";"PR";"SAO JOSE DOS PINHAIS";5496;502;555;6553
2008;"SAO MANOEL DO PARANA (PR)";"PR";"SAO MANOEL DO PARANA";35;2;7;44
2008;"SAO MATEUS DO SUL (PR)";"PR";"SAO MATEUS DO SUL";810;49;85;944
2008;"SAO MIGUEL DO IGUACU (PR)";"PR";"SAO MIGUEL DO IGUACU";734;18;75;827
2008;"SAO PEDRO DO IGUACU (PR)";"PR";"SAO PEDRO DO IGUACU";142;5;24;171
2008;"SAO PEDRO DO IVAI (PR)";"PR";"SAO PEDRO DO IVAI";283;4;47;334
2008;"SAO PEDRO DO PARANA (PR)";"PR";"SAO PEDRO DO PARANA";21;1;6;28
2008;"SAO SEBASTIAO DA AMOREIRA (PR)";"PR";"SAO SEBASTIAO DA AMOREIRA";173;5;24;202
2008;"SAO TOME (PR)";"PR";"SAO TOME";106;8;20;134
2008;"SAPOPEMA (PR)";"PR";"SAPOPEMA";73;3;11;87
2008;"SARANDI (PR)";"PR";"SARANDI";785;39;120;944
2008;"SAUDADE DO IGUACU (PR)";"PR";"SAUDADE DO IGUACU";61;10;16;87
2008;"SENGES (PR)";"PR";"SENGES";426;18;46;490
2008;"SERRANOPOLIS DO IGUACU (PR)";"PR";"SERRANOPOLIS DO IGUACU";125;13;10;148
2008;"SERTANEJA (PR)";"PR";"SERTANEJA";181;10;22;213
2008;"SERTANOPOLIS (PR)";"PR";"SERTANOPOLIS";468;6;41;515
2008;"SIQUEIRA CAMPOS (PR)";"PR";"SIQUEIRA CAMPOS";314;11;40;365
2008;"SULINA (PR)";"PR";"SULINA";71;6;11;88
2008;"TAMARANA (PR)";"PR";"TAMARANA";230;9;30;269
2008;"TAMBOARA (PR)";"PR";"TAMBOARA";63;6;9;78
2008;"TAPEJARA (PR)";"PR";"TAPEJARA";334;14;70;418
2008;"TAPIRA (PR)";"PR";"TAPIRA";110;5;16;131
2008;"TEIXEIRA SOARES (PR)";"PR";"TEIXEIRA SOARES";189;12;53;254
2008;"TELEMACO BORBA (PR)";"PR";"TELEMACO BORBA";986;187;219;1392
2008;"TERRA BOA (PR)";"PR";"TERRA BOA";273;9;64;346
2008;"TERRA RICA (PR)";"PR";"TERRA RICA";314;6;55;375
2008;"TERRA ROXA (PR)";"PR";"TERRA ROXA";404;10;41;455
2008;"TIBAGI (PR)";"PR";"TIBAGI";265;24;46;335
2008;"TIJUCAS DO SUL (PR)";"PR";"TIJUCAS DO SUL";374;7;25;406
2008;"TOLEDO (PR)";"PR";"TOLEDO";2454;157;228;2839
2008;"TOMAZINA (PR)";"PR";"TOMAZINA";65;8;14;87
2008;"TRES BARRAS DO PARANA (PR)";"PR";"TRES BARRAS DO PARANA";293;3;20;316
2008;"TUNAS DO PARANA (PR)";"PR";"TUNAS DO PARANA";64;8;18;90
2008;"TUNEIRAS DO OESTE (PR)";"PR";"TUNEIRAS DO OESTE";112;2;31;145
2008;"TUPASSI (PR)";"PR";"TUPASSI";297;8;20;325
2008;"TURVO (PR)";"PR";"TURVO";330;7;42;379
2008;"UBIRATA (PR)";"PR";"UBIRATA";568;21;46;635
2008;"UMUARAMA (PR)";"PR";"UMUARAMA";2104;53;206;2363
2008;"UNIAO DA VITORIA (PR)";"PR";"UNIAO DA VITORIA";1206;30;62;1298
2008;"UNIFLOR (PR)";"PR";"UNIFLOR";33;5;9;47
2008;"URAI (PR)";"PR";"URAI";261;17;24;302
2008;"VENTANIA (PR)";"PR";"VENTANIA";134;15;31;180
2008;"VERA CRUZ DO OESTE (PR)";"PR";"VERA CRUZ DO OESTE";220;6;8;234
2008;"VERE (PR)";"PR";"VERE";173;9;17;199
2008;"VILA ALTA (PR)";"PR";"VILA ALTA";32;6;12;50
2008;"VIRMOND (PR)";"PR";"VIRMOND";92;1;13;106
2008;"VITORINO (PR)";"PR";"VITORINO";198;7;23;228
2008;"WENCESLAU BRAZ (PR)";"PR";"WENCESLAU BRAZ";362;16;64;442
2008;"XAMBRE (PR)";"PR";"XAMBRE";74;5;11;90
2008;"ANGRA DOS REIS (RJ)";"RJ";"ANGRA DOS REIS";901;164;233;1298
2008;"APERIBE (RJ)";"RJ";"APERIBE";80;5;2;87
2008;"ARARUAMA (RJ)";"RJ";"ARARUAMA";1528;294;102;1924
2008;"AREAL (RJ)";"RJ";"AREAL";107;26;26;159
2008;"ARMACAO DE BUZIOS (RJ)";"RJ";"ARMACAO DE BUZIOS";195;211;27;433
2008;"ARRAIAL DO CABO (RJ)";"RJ";"ARRAIAL DO CABO";111;33;11;155
2008;"BARRA DO PIRAI (RJ)";"RJ";"BARRA DO PIRAI";1725;105;212;2042
2008;"BARRA MANSA (RJ)";"RJ";"BARRA MANSA";1614;104;459;2177
2008;"BELFORD ROXO (RJ)";"RJ";"BELFORD ROXO";959;231;579;1769
2008;"BOM JARDIM (RJ)";"RJ";"BOM JARDIM";423;22;28;473
2008;"BOM JESUS DO ITABAPOANA (RJ)";"RJ";"BOM JESUS DO ITABAPOANA";285;35;37;357
2008;"CABO FRIO (RJ)";"RJ";"CABO FRIO";3251;317;420;3988
2008;"CACHOEIRAS DE MACACU (RJ)";"RJ";"CACHOEIRAS DE MACACU";625;104;32;761
2008;"CAMBUCI (RJ)";"RJ";"CAMBUCI";71;11;11;93
2008;"CAMPOS DOS GOYTACAZES (RJ)";"RJ";"CAMPOS DOS GOYTACAZES";5193;448;903;6544
2008;"CANTAGALO (RJ)";"RJ";"CANTAGALO";129;27;31;187
2008;"CARAPEBUS (RJ)";"RJ";"CARAPEBUS";57;22;5;84
2008;"CARDOSO MOREIRA (RJ)";"RJ";"CARDOSO MOREIRA";140;11;22;173
2008;"CARMO (RJ)";"RJ";"CARMO";87;12;26;125
2008;"CASIMIRO DE ABREU (RJ)";"RJ";"CASIMIRO DE ABREU";468;71;35;574
2008;"COMENDADOR LEVY GASPARIAN (RJ)";"RJ";"COMENDADOR LEVY GASPARIAN";93;25;13;131
2008;"CONCEICAO DE MACABU (RJ)";"RJ";"CONCEICAO DE MACABU";144;28;55;227
2008;"CORDEIRO (RJ)";"RJ";"CORDEIRO";250;37;32;319
2008;"DUAS BARRAS (RJ)";"RJ";"DUAS BARRAS";69;15;6;90
2008;"DUQUE DE CAXIAS (RJ)";"RJ";"DUQUE DE CAXIAS";6065;719;2850;9634
2008;"ENGENHEIRO PAULO DE FRONTIN (RJ)";"RJ";"ENGENHEIRO PAULO DE FRONTIN";123;22;12;157
2008;"GUAPIMIRIM (RJ)";"RJ";"GUAPIMIRIM";231;43;33;307
2008;"IGUABA GRANDE (RJ)";"RJ";"IGUABA GRANDE";108;78;17;203
2008;"ITABORAI (RJ)";"RJ";"ITABORAI";2861;825;695;4381
2008;"ITAGUAI (RJ)";"RJ";"ITAGUAI";1078;243;221;1542
2008;"ITALVA (RJ)";"RJ";"ITALVA";178;12;14;204
2008;"ITAOCARA (RJ)";"RJ";"ITAOCARA";255;36;20;311
2008;"ITAPERUNA (RJ)";"RJ";"ITAPERUNA";998;95;96;1189
2008;"ITATIAIA (RJ)";"RJ";"ITATIAIA";151;68;40;259
2008;"JAPERI (RJ)";"RJ";"JAPERI";242;41;36;319
2008;"LAJE DO MURIAE (RJ)";"RJ";"LAJE DO MURIAE";41;5;7;53
2008;"MACAE (RJ)";"RJ";"MACAE";2321;563;778;3662
2008;"MACUCO (RJ)";"RJ";"MACUCO";116;7;5;128
2008;"MAGE (RJ)";"RJ";"MAGE";951;325;152;1428
2008;"MANGARATIBA (RJ)";"RJ";"MANGARATIBA";108;98;91;297
2008;"MARICA (RJ)";"RJ";"MARICA";775;279;214;1268
2008;"MENDES (RJ)";"RJ";"MENDES";234;34;19;287
2008;"MESQUITA (RJ)";"RJ";"MESQUITA";346;110;596;1052
2008;"MIGUEL PEREIRA (RJ)";"RJ";"MIGUEL PEREIRA";295;59;28;382
2008;"MIRACEMA (RJ)";"RJ";"MIRACEMA";189;11;22;222
2008;"NATIVIDADE (RJ)";"RJ";"NATIVIDADE";77;11;24;112
2008;"NILOPOLIS (RJ)";"RJ";"NILOPOLIS";495;118;289;902
2008;"NITEROI (RJ)";"RJ";"NITEROI";1796;1220;1779;4795
2008;"NOVA FRIBURGO (RJ)";"RJ";"NOVA FRIBURGO";3177;183;289;3649
2008;"NOVA IGUACU (RJ)";"RJ";"NOVA IGUACU";4540;1053;1310;6903
2008;"PARACAMBI (RJ)";"RJ";"PARACAMBI";474;54;90;618
2008;"PARAIBA DO SUL (RJ)";"RJ";"PARAIBA DO SUL";392;57;86;535
2008;"PARATI (RJ)";"RJ";"PARATI";140;51;29;220
2008;"PATY DO ALFERES (RJ)";"RJ";"PATY DO ALFERES";397;56;34;487
2008;"PETROPOLIS (RJ)";"RJ";"PETROPOLIS";2820;484;665;3969
2008;"PINHEIRAL (RJ)";"RJ";"PINHEIRAL";133;22;30;185
2008;"PIRAI (RJ)";"RJ";"PIRAI";364;37;40;441
2008;"PORCIUNCULA (RJ)";"RJ";"PORCIUNCULA";69;8;14;91
2008;"PORTO REAL (RJ)";"RJ";"PORTO REAL";318;30;23;371
2008;"QUATIS (RJ)";"RJ";"QUATIS";188;69;36;293
2008;"QUEIMADOS (RJ)";"RJ";"QUEIMADOS";327;246;95;668
2008;"QUISSAMA (RJ)";"RJ";"QUISSAMA";170;19;70;259
2008;"RESENDE (RJ)";"RJ";"RESENDE";1015;160;302;1477
2008;"RIO BONITO (RJ)";"RJ";"RIO BONITO";3874;382;132;4388
2008;"RIO CLARO (RJ)";"RJ";"RIO CLARO";64;7;7;78
2008;"RIO DAS FLORES (RJ)";"RJ";"RIO DAS FLORES";57;13;6;76
2008;"RIO DAS OSTRAS (RJ)";"RJ";"RIO DAS OSTRAS";717;432;58;1207
2008;"RIO DE JANEIRO (RJ)";"RJ";"RIO DE JANEIRO";28152;12750;13604;54506
2008;"SANTA MARIA MADALENA (RJ)";"RJ";"SANTA MARIA MADALENA";39;9;1;49
2008;"SANTO ANTONIO DE PADUA (RJ)";"RJ";"SANTO ANTONIO DE PADUA";507;70;15;592
2008;"SAO FIDELIS (RJ)";"RJ";"SAO FIDELIS";356;24;43;423
2008;"SAO FRANCISCO DE ITABAPOANA (RJ)";"RJ";"SAO FRANCISCO DE ITABAPOANA";237;30;27;294
2008;"SAO GONCALO (RJ)";"RJ";"SAO GONCALO";2257;1713;2014;5984
2008;"SAO JOAO DA BARRA (RJ)";"RJ";"SAO JOAO DA BARRA";265;37;37;339
2008;"SAO JOAO DE MERITI (RJ)";"RJ";"SAO JOAO DE MERITI";2371;400;1122;3893
2008;"SAO JOSE DE UBA (RJ)";"RJ";"SAO JOSE DE UBA";19;5;3;27
2008;"SAO JOSE DO VALE DO RIO PRETO (RJ)";"RJ";"SAO JOSE DO VALE DO RIO PRETO";458;31;12;501
2008;"SAO PEDRO DA ALDEIA (RJ)";"RJ";"SAO PEDRO DA ALDEIA";442;65;44;551
2008;"SAO SEBASTIAO DO ALTO (RJ)";"RJ";"SAO SEBASTIAO DO ALTO";78;4;2;84
2008;"SAPUCAIA (RJ)";"RJ";"SAPUCAIA";93;8;5;106
2008;"SAQUAREMA (RJ)";"RJ";"SAQUAREMA";548;105;73;726
2008;"SEROPEDICA (RJ)";"RJ";"SEROPEDICA";481;38;146;665
2008;"SILVA JARDIM (RJ)";"RJ";"SILVA JARDIM";242;35;20;297
2008;"SUMIDOURO (RJ)";"RJ";"SUMIDOURO";174;6;10;190
2008;"TANGUA (RJ)";"RJ";"TANGUA";212;20;6;238
2008;"TERESOPOLIS (RJ)";"RJ";"TERESOPOLIS";1581;203;270;2054
2008;"TRAJANO DE MORAIS (RJ)";"RJ";"TRAJANO DE MORAIS";40;10;6;56
2008;"TRES RIOS (RJ)";"RJ";"TRES RIOS";706;75;179;960
2008;"VALENCA (RJ)";"RJ";"VALENCA";272;47;56;375
2008;"VARRE SAI (RJ)";"RJ";"VARRE SAI";33;6;4;43
2008;"VASSOURAS (RJ)";"RJ";"VASSOURAS";390;57;92;539
2008;"VOLTA REDONDA (RJ)";"RJ";"VOLTA REDONDA";2044;234;573;2851
2008;"ACARI (RN)";"RN";"ACARI";76;8;5;89
2008;"AFONSO BEZERRA (RN)";"RN";"AFONSO BEZERRA";15;4;2;21
2008;"AGUA NOVA (RN)";"RN";"AGUA NOVA";3;6;1;10
2008;"ALEXANDRIA (RN)";"RN";"ALEXANDRIA";46;22;12;80
2008;"ALMINO AFONSO (RN)";"RN";"ALMINO AFONSO";13;7;0;20
2008;"ALTO DO RODRIGUES (RN)";"RN";"ALTO DO RODRIGUES";93;14;22;129
2008;"ANGICOS (RN)";"RN";"ANGICOS";83;9;11;103
2008;"ANTONIO MARTINS (RN)";"RN";"ANTONIO MARTINS";9;11;0;20
2008;"APODI (RN)";"RN";"APODI";179;11;16;206
2008;"AREIA BRANCA (RN)";"RN";"AREIA BRANCA";92;33;40;165
2008;"ARES (RN)";"RN";"ARES";76;7;16;99
2008;"ASSU (RN)";"RN";"ASSU";399;40;58;497
2008;"BAIA FORMOSA (RN)";"RN";"BAIA FORMOSA";38;0;13;51
2008;"BARAUNA (RN)";"RN";"BARAUNA";125;14;10;149
2008;"BARCELONA (RN)";"RN";"BARCELONA";18;1;1;20
2008;"BENTO FERNANDES (RN)";"RN";"BENTO FERNANDES";12;5;4;21
2008;"BOA SAUDE (RN)";"RN";"BOA SAUDE";40;6;3;49
2008;"BODO (RN)";"RN";"BODO";4;6;1;11
2008;"BOM JESUS (RN)";"RN";"BOM JESUS";42;2;2;46
2008;"BREJINHO (RN)";"RN";"BREJINHO";47;9;13;69
2008;"CAICARA DO NORTE (RN)";"RN";"CAICARA DO NORTE";11;1;1;13
2008;"CAICARA DO RIO DO VENTO (RN)";"RN";"CAICARA DO RIO DO VENTO";18;5;1;24
2008;"CAICO (RN)";"RN";"CAICO";1281;68;34;1383
2008;"CAMPO GRANDE (RN)";"RN";"CAMPO GRANDE";29;8;0;37
2008;"CAMPO REDONDO (RN)";"RN";"CAMPO REDONDO";33;8;6;47
2008;"CANGUARETAMA (RN)";"RN";"CANGUARETAMA";119;18;48;185
2008;"CARAUBAS (RN)";"RN";"CARAUBAS";98;17;6;121
2008;"CARNAUBA DOS DANTAS (RN)";"RN";"CARNAUBA DOS DANTAS";118;4;5;127
2008;"CARNAUBAIS (RN)";"RN";"CARNAUBAIS";39;17;9;65
2008;"CEARA MIRIM (RN)";"RN";"CEARA MIRIM";248;25;69;342
2008;"CERRO CORA (RN)";"RN";"CERRO CORA";68;6;3;77
2008;"CORONEL EZEQUIEL (RN)";"RN";"CORONEL EZEQUIEL";23;6;3;32
2008;"CORONEL JOAO PESSOA (RN)";"RN";"CORONEL JOAO PESSOA";6;2;0;8
2008;"CRUZETA (RN)";"RN";"CRUZETA";55;8;3;66
2008;"CURRAIS NOVOS (RN)";"RN";"CURRAIS NOVOS";523;39;41;603
2008;"DOUTOR SEVERIANO (RN)";"RN";"DOUTOR SEVERIANO";10;9;2;21
2008;"ENCANTO (RN)";"RN";"ENCANTO";10;5;1;16
2008;"EQUADOR (RN)";"RN";"EQUADOR";54;3;0;57
2008;"ESPIRITO SANTO (RN)";"RN";"ESPIRITO SANTO";14;4;10;28
2008;"ESPIRITO SANTO DO OESTE (RN)";"RN";"ESPIRITO SANTO DO OESTE";15;5;1;21
2008;"EXTREMOZ (RN)";"RN";"EXTREMOZ";43;15;46;104
2008;"FELIPE GUERRA (RN)";"RN";"FELIPE GUERRA";11;6;4;21
2008;"FERNANDO PEDROZA (RN)";"RN";"FERNANDO PEDROZA";13;2;1;16
2008;"FLORANIA (RN)";"RN";"FLORANIA";40;6;4;50
2008;"FRANCISCO DANTAS (RN)";"RN";"FRANCISCO DANTAS";6;2;1;9
2008;"FRUTUOSO GOMES (RN)";"RN";"FRUTUOSO GOMES";15;10;0;25
2008;"GALINHOS (RN)";"RN";"GALINHOS";6;3;1;10
2008;"GOIANINHA (RN)";"RN";"GOIANINHA";107;29;46;182
2008;"GOVERNADOR DIX SEPT ROSADO (RN)";"RN";"GOVERNADOR DIX SEPT ROSADO";99;7;10;116
2008;"GROSSOS (RN)";"RN";"GROSSOS";32;5;9;46
2008;"GUAMARE (RN)";"RN";"GUAMARE";43;14;22;79
2008;"IELMO MARINHO (RN)";"RN";"IELMO MARINHO";39;2;13;54
2008;"IPANGUACU (RN)";"RN";"IPANGUACU";56;14;50;120
2008;"IPUEIRA (RN)";"RN";"IPUEIRA";12;9;6;27
2008;"ITAJA (RN)";"RN";"ITAJA";60;4;6;70
2008;"ITAU (RN)";"RN";"ITAU";15;5;1;21
2008;"JACANA (RN)";"RN";"JACANA";79;28;8;115
2008;"JANDAIRA (RN)";"RN";"JANDAIRA";32;1;11;44
2008;"JANDUIS (RN)";"RN";"JANDUIS";10;3;1;14
2008;"JAPI (RN)";"RN";"JAPI";31;6;7;44
2008;"JARDIM DE ANGICOS (RN)";"RN";"JARDIM DE ANGICOS";4;1;1;6
2008;"JARDIM DE PIRANHAS (RN)";"RN";"JARDIM DE PIRANHAS";66;17;5;88
2008;"JARDIM DO SERIDO (RN)";"RN";"JARDIM DO SERIDO";115;17;46;178
2008;"JOAO CAMARA (RN)";"RN";"JOAO CAMARA";228;12;20;260
2008;"JOAO DIAS (RN)";"RN";"JOAO DIAS";3;1;0;4
2008;"JOSE DA PENHA (RN)";"RN";"JOSE DA PENHA";14;12;1;27
2008;"JUCURUTU (RN)";"RN";"JUCURUTU";95;17;7;119
2008;"JUNDIA (RN)";"RN";"JUNDIA";9;2;4;15
2008;"LAGOA DANTA (RN)";"RN";"LAGOA DANTA";24;2;9;35
2008;"LAGOA DE PEDRAS (RN)";"RN";"LAGOA DE PEDRAS";24;3;5;32
2008;"LAGOA DE VELHOS (RN)";"RN";"LAGOA DE VELHOS";13;0;0;13
2008;"LAGOA NOVA (RN)";"RN";"LAGOA NOVA";53;6;2;61
2008;"LAGOA SALGADA (RN)";"RN";"LAGOA SALGADA";46;3;4;53
2008;"LAJES (RN)";"RN";"LAJES";43;5;5;53
2008;"LAJES PINTADAS (RN)";"RN";"LAJES PINTADAS";16;6;4;26
2008;"LUCRECIA (RN)";"RN";"LUCRECIA";19;5;1;25
2008;"LUIS GOMES (RN)";"RN";"LUIS GOMES";23;20;4;47
2008;"MACAIBA (RN)";"RN";"MACAIBA";527;38;44;609
2008;"MACAU (RN)";"RN";"MACAU";115;29;36;180
2008;"MAJOR SALES (RN)";"RN";"MAJOR SALES";9;9;0;18
2008;"MARCELINO VIEIRA (RN)";"RN";"MARCELINO VIEIRA";13;9;1;23
2008;"MARTINS (RN)";"RN";"MARTINS";31;6;4;41
2008;"MAXARANGUAPE (RN)";"RN";"MAXARANGUAPE";12;5;5;22
2008;"MESSIAS TARGINO (RN)";"RN";"MESSIAS TARGINO";25;6;1;32
2008;"MONTANHAS (RN)";"RN";"MONTANHAS";38;3;13;54
2008;"MONTE ALEGRE (RN)";"RN";"MONTE ALEGRE";77;6;11;94
2008;"MONTE DAS GAMELEIRAS (RN)";"RN";"MONTE DAS GAMELEIRAS";6;2;6;14
2008;"MOSSORO (RN)";"RN";"MOSSORO";2775;218;142;3135
2008;"NATAL (RN)";"RN";"NATAL";5467;1082;1965;8514
2008;"NISIA FLORESTA (RN)";"RN";"NISIA FLORESTA";57;28;54;139
2008;"NOVA CRUZ (RN)";"RN";"NOVA CRUZ";253;13;38;304
2008;"OLHO D AGUA DO BORGES (RN)";"RN";"OLHO D AGUA DO BORGES";14;3;1;18
2008;"OURO BRANCO (RN)";"RN";"OURO BRANCO";38;3;5;46
2008;"PARANA (RN)";"RN";"PARANA";9;6;1;16
2008;"PARAZINHO (RN)";"RN";"PARAZINHO";16;1;5;22
2008;"PARELHAS (RN)";"RN";"PARELHAS";258;16;21;295
2008;"PARNAMIRIM (RN)";"RN";"PARNAMIRIM";1330;275;251;1856
2008;"PASSA E FICA (RN)";"RN";"PASSA E FICA";81;19;10;110
2008;"PASSAGEM (RN)";"RN";"PASSAGEM";16;7;2;25
2008;"PATU (RN)";"RN";"PATU";59;20;2;81
2008;"PAU DOS FERROS (RN)";"RN";"PAU DOS FERROS";301;29;13;343
2008;"PEDRA GRANDE (RN)";"RN";"PEDRA GRANDE";6;1;1;8
2008;"PEDRA PRETA (RN)";"RN";"PEDRA PRETA";16;2;5;23
2008;"PEDRO AVELINO (RN)";"RN";"PEDRO AVELINO";32;1;2;35
2008;"PEDRO VELHO (RN)";"RN";"PEDRO VELHO";39;3;9;51
2008;"PENDENCIAS (RN)";"RN";"PENDENCIAS";41;8;13;62
2008;"PILOES (RN)";"RN";"PILOES";0;2;0;2
2008;"POCO BRANCO (RN)";"RN";"POCO BRANCO";30;4;4;38
2008;"PORTALEGRE (RN)";"RN";"PORTALEGRE";26;7;1;34
2008;"PORTO DO MANGUE (RN)";"RN";"PORTO DO MANGUE";39;8;7;54
2008;"PUREZA (RN)";"RN";"PUREZA";46;2;8;56
2008;"RAFAEL FERNANDES (RN)";"RN";"RAFAEL FERNANDES";8;4;0;12
2008;"RAFAEL GODEIRO (RN)";"RN";"RAFAEL GODEIRO";9;2;0;11
2008;"RIACHO DA CRUZ (RN)";"RN";"RIACHO DA CRUZ";2;2;0;4
2008;"RIACHO DE SANTANA (RN)";"RN";"RIACHO DE SANTANA";3;6;1;10
2008;"RIACHUELO (RN)";"RN";"RIACHUELO";21;2;3;26
2008;"RIO DO FOGO (RN)";"RN";"RIO DO FOGO";25;1;6;32
2008;"RODOLFO FERNANDES (RN)";"RN";"RODOLFO FERNANDES";16;7;2;25
2008;"RUY BARBOSA (RN)";"RN";"RUY BARBOSA";12;1;1;14
2008;"SANTA CRUZ (RN)";"RN";"SANTA CRUZ";309;15;18;342
2008;"SANTA MARIA (RN)";"RN";"SANTA MARIA";33;1;3;37
2008;"SANTANA DO MATOS (RN)";"RN";"SANTANA DO MATOS";61;8;3;72
2008;"SANTANA DO SERIDO (RN)";"RN";"SANTANA DO SERIDO";16;3;0;19
2008;"SANTO ANTONIO (RN)";"RN";"SANTO ANTONIO";85;27;12;124
2008;"SAO BENTO DO NORTE (RN)";"RN";"SAO BENTO DO NORTE";8;2;1;11
2008;"SAO BENTO DO TRAIRI (RN)";"RN";"SAO BENTO DO TRAIRI";19;1;2;22
2008;"SAO FERNANDO (RN)";"RN";"SAO FERNANDO";6;6;1;13
2008;"SAO FRANCISCO DO OESTE (RN)";"RN";"SAO FRANCISCO DO OESTE";10;2;1;13
2008;"SAO GONCALO DO AMARANTE (RN)";"RN";"SAO GONCALO DO AMARANTE";236;72;99;407
2008;"SAO JOAO DO SABUGI (RN)";"RN";"SAO JOAO DO SABUGI";29;13;1;43
2008;"SAO JOSE DE MIPIBU (RN)";"RN";"SAO JOSE DE MIPIBU";186;35;34;255
2008;"SAO JOSE DO CAMPESTRE (RN)";"RN";"SAO JOSE DO CAMPESTRE";57;4;9;70
2008;"SAO JOSE DO SERIDO (RN)";"RN";"SAO JOSE DO SERIDO";23;6;1;30
2008;"SAO MIGUEL (RN)";"RN";"SAO MIGUEL";127;15;18;160
2008;"SAO MIGUEL DE TOUROS (RN)";"RN";"SAO MIGUEL DE TOUROS";16;5;6;27
2008;"SAO PAULO DO POTENGI (RN)";"RN";"SAO PAULO DO POTENGI";88;6;5;99
2008;"SAO PEDRO (RN)";"RN";"SAO PEDRO";25;2;4;31
2008;"SAO RAFAEL (RN)";"RN";"SAO RAFAEL";25;15;4;44
2008;"SAO TOME (RN)";"RN";"SAO TOME";43;3;17;63
2008;"SAO VICENTE (RN)";"RN";"SAO VICENTE";35;2;1;38
2008;"SENADOR ELOI DE SOUZA (RN)";"RN";"SENADOR ELOI DE SOUZA";10;5;4;19
2008;"SENADOR GEORGINO AVELINO (RN)";"RN";"SENADOR GEORGINO AVELINO";11;1;1;13
2008;"SERRA CAIADA (RN)";"RN";"SERRA CAIADA";26;2;6;34
2008;"SERRA DE SAO BENTO (RN)";"RN";"SERRA DE SAO BENTO";25;4;1;30
2008;"SERRA DO MEL (RN)";"RN";"SERRA DO MEL";50;10;6;66
2008;"SERRA NEGRA DO NORTE (RN)";"RN";"SERRA NEGRA DO NORTE";84;11;2;97
2008;"SERRINHA (RN)";"RN";"SERRINHA";22;12;2;36
2008;"SERRINHA DOS PINTOS (RN)";"RN";"SERRINHA DOS PINTOS";25;5;1;31
2008;"SEVERIANO MELO (RN)";"RN";"SEVERIANO MELO";20;2;4;26
2008;"SITIO NOVO (RN)";"RN";"SITIO NOVO";18;6;0;24
2008;"TABOLEIRO GRANDE (RN)";"RN";"TABOLEIRO GRANDE";5;5;1;11
2008;"TAIPU (RN)";"RN";"TAIPU";44;3;7;54
2008;"TANGARA (RN)";"RN";"TANGARA";78;1;19;98
2008;"TENENTE ANANIAS (RN)";"RN";"TENENTE ANANIAS";27;4;1;32
2008;"TENENTE LAURENTINO CRUZ (RN)";"RN";"TENENTE LAURENTINO CRUZ";34;9;3;46
2008;"TIBAU (RN)";"RN";"TIBAU";18;13;3;34
2008;"TIBAU DO SUL (RN)";"RN";"TIBAU DO SUL";36;39;9;84
2008;"TIMBAUBA DOS BATISTAS (RN)";"RN";"TIMBAUBA DOS BATISTAS";17;7;1;25
2008;"TOUROS (RN)";"RN";"TOUROS";129;22;28;179
2008;"TRIUNFO POTIGUAR (RN)";"RN";"TRIUNFO POTIGUAR";9;6;1;16
2008;"UMARIZAL (RN)";"RN";"UMARIZAL";52;21;2;75
2008;"UPANEMA (RN)";"RN";"UPANEMA";38;9;8;55
2008;"VARZEA (RN)";"RN";"VARZEA";8;5;5;18
2008;"VENHA VER (RN)";"RN";"VENHA VER";13;4;0;17
2008;"VERA CRUZ (RN)";"RN";"VERA CRUZ";93;5;16;114
2008;"VICOSA (RN)";"RN";"VICOSA";5;1;0;6
2008;"VILA FLOR (RN)";"RN";"VILA FLOR";9;1;1;11
2008;"ALTA FLORESTA D OESTE (RO)";"RO";"ALTA FLORESTA D OESTE";396;10;30;436
2008;"ALTO ALEGRE DOS PARECIS (RO)";"RO";"ALTO ALEGRE DOS PARECIS";79;3;7;89
2008;"ALTO PARAISO (RO)";"RO";"ALTO PARAISO";149;7;27;183
2008;"ALVORADA D OESTE (RO)";"RO";"ALVORADA D OESTE";214;5;39;258
2008;"ARIQUEMES (RO)";"RO";"ARIQUEMES";1699;23;142;1864
2008;"BURITIS (RO)";"RO";"BURITIS";301;4;15;320
2008;"CABIXI (RO)";"RO";"CABIXI";49;1;14;64
2008;"CACAULANDIA (RO)";"RO";"CACAULANDIA";39;2;8;49
2008;"CACOAL (RO)";"RO";"CACOAL";1342;32;174;1548
2008;"CAMPO NOVO DE RONDONIA (RO)";"RO";"CAMPO NOVO DE RONDONIA";33;0;6;39
2008;"CANDEIAS DO JAMARI (RO)";"RO";"CANDEIAS DO JAMARI";87;4;5;96
2008;"CASTANHEIRAS (RO)";"RO";"CASTANHEIRAS";20;2;4;26
2008;"CEREJEIRAS (RO)";"RO";"CEREJEIRAS";312;10;35;357
2008;"CHUPINGUAIA (RO)";"RO";"CHUPINGUAIA";71;2;12;85
2008;"COLORADO DO OESTE (RO)";"RO";"COLORADO DO OESTE";339;7;29;375
2008;"CORUMBIARA (RO)";"RO";"CORUMBIARA";39;4;6;49
2008;"COSTA MARQUES (RO)";"RO";"COSTA MARQUES";39;2;6;47
2008;"CUJUBIM (RO)";"RO";"CUJUBIM";88;3;7;98
2008;"ESPIGAO D OESTE (RO)";"RO";"ESPIGAO D OESTE";416;3;60;479
2008;"GOVERNADOR JORGE TEIXEIRA (RO)";"RO";"GOVERNADOR JORGE TEIXEIRA";30;0;8;38
2008;"GUAJARA MIRIM (RO)";"RO";"GUAJARA MIRIM";448;11;12;471
2008;"JAMARI (RO)";"RO";"JAMARI";62;0;15;77
2008;"JARU (RO)";"RO";"JARU";905;22;137;1064
2008;"JI PARANA (RO)";"RO";"JI PARANA";2303;49;552;2904
2008;"MACHADINHO D OESTE (RO)";"RO";"MACHADINHO D OESTE";214;3;30;247
2008;"MINISTRO ANDREAZZA (RO)";"RO";"MINISTRO ANDREAZZA";127;2;13;142
2008;"MIRANTE DA SERRA (RO)";"RO";"MIRANTE DA SERRA";132;2;12;146
2008;"MONTE NEGRO (RO)";"RO";"MONTE NEGRO";188;3;37;228
2008;"NOVA BRASILANDIA D OESTE (RO)";"RO";"NOVA BRASILANDIA D OESTE";201;7;29;237
2008;"NOVA UNIAO (RO)";"RO";"NOVA UNIAO";26;1;2;29
2008;"NOVO HORIZONTE DO OESTE (RO)";"RO";"NOVO HORIZONTE DO OESTE";60;1;10;71
2008;"OURO PRETO DO OESTE (RO)";"RO";"OURO PRETO DO OESTE";613;24;89;726
2008;"PARECIS (RO)";"RO";"PARECIS";17;1;7;25
2008;"PIMENTA BUENO (RO)";"RO";"PIMENTA BUENO";803;26;55;884
2008;"PIMENTEIRAS DO OESTE (RO)";"RO";"PIMENTEIRAS DO OESTE";8;0;8;16
2008;"PORTO VELHO (RO)";"RO";"PORTO VELHO";3967;219;763;4949
2008;"PRESIDENTE MEDICI (RO)";"RO";"PRESIDENTE MEDICI";224;3;28;255
2008;"PRIMAVERA DE RONDONIA (RO)";"RO";"PRIMAVERA DE RONDONIA";25;1;9;35
2008;"RIO CRESPO (RO)";"RO";"RIO CRESPO";52;1;13;66
2008;"ROLIM DE MOURA (RO)";"RO";"ROLIM DE MOURA";1055;24;93;1172
2008;"SANTA LUZIA D OESTE (RO)";"RO";"SANTA LUZIA D OESTE";104;3;31;138
2008;"SAO FELIPE D OESTE (RO)";"RO";"SAO FELIPE D OESTE";37;1;13;51
2008;"SAO FRANCISCO DO GUAPORE (RO)";"RO";"SAO FRANCISCO DO GUAPORE";141;2;14;157
2008;"SAO MIGUEL DO GUAPORE (RO)";"RO";"SAO MIGUEL DO GUAPORE";204;4;37;245
2008;"SERINGUEIRAS (RO)";"RO";"SERINGUEIRAS";94;3;18;115
2008;"TEIXEIROPOLIS (RO)";"RO";"TEIXEIROPOLIS";19;0;10;29
2008;"THEOBROMA (RO)";"RO";"THEOBROMA";30;0;14;44
2008;"URUPA (RO)";"RO";"URUPA";95;2;24;121
2008;"VALE DO ANARI (RO)";"RO";"VALE DO ANARI";29;1;2;32
2008;"VALE DO PARAISO (RO)";"RO";"VALE DO PARAISO";46;0;3;49
2008;"VILA NOVA DO MAMORE (RO)";"RO";"VILA NOVA DO MAMORE";97;1;8;106
2008;"VILHENA (RO)";"RO";"VILHENA";1139;37;138;1314
2008;"ALTO ALEGRE (RR)";"RR";"ALTO ALEGRE";37;3;8;48
2008;"AMAJARI (RR)";"RR";"AMAJARI";10;3;0;13
2008;"BOA VISTA (RR)";"RR";"BOA VISTA";2404;267;505;3176
2008;"BONFIM (RR)";"RR";"BONFIM";8;0;0;8
2008;"CANTA (RR)";"RR";"CANTA";19;3;6;28
2008;"CARACARAI (RR)";"RR";"CARACARAI";53;2;1;56
2008;"CAROEBE (RR)";"RR";"CAROEBE";16;3;11;30
2008;"IRACEMA (RR)";"RR";"IRACEMA";19;10;0;29
2008;"MUCAJAI (RR)";"RR";"MUCAJAI";65;22;23;110
2008;"NORMANDIA (RR)";"RR";"NORMANDIA";11;0;0;11
2008;"PACARAIMA (RR)";"RR";"PACARAIMA";29;1;3;33
2008;"RORAINOPOLIS (RR)";"RR";"RORAINOPOLIS";55;6;5;66
2008;"SAO JOAO DA BALIZA (RR)";"RR";"SAO JOAO DA BALIZA";29;5;1;35
2008;"SAO LUIZ (RR)";"RR";"SAO LUIZ";27;3;2;32
2008;"UIRAMUTA (RR)";"RR";"UIRAMUTA";1;0;0;1
2008;"ACEGUA (RS)";"RS";"ACEGUA";54;11;9;74
2008;"AGUA SANTA (RS)";"RS";"AGUA SANTA";134;3;13;150
2008;"AGUDO (RS)";"RS";"AGUDO";269;15;42;326
2008;"AJURICABA (RS)";"RS";"AJURICABA";314;12;29;355
2008;"ALECRIM (RS)";"RS";"ALECRIM";74;5;19;98
2008;"ALEGRETE (RS)";"RS";"ALEGRETE";866;41;171;1078
2008;"ALEGRIA (RS)";"RS";"ALEGRIA";75;3;15;93
2008;"ALMIRANTE TAMANDARE DO SUL (RS)";"RS";"ALMIRANTE TAMANDARE DO SUL";64;6;3;73
2008;"ALPESTRE (RS)";"RS";"ALPESTRE";111;22;33;166
2008;"ALTO ALEGRE (RS)";"RS";"ALTO ALEGRE";64;4;6;74
2008;"ALTO FELIZ (RS)";"RS";"ALTO FELIZ";77;6;10;93
2008;"ALVORADA (RS)";"RS";"ALVORADA";1352;120;506;1978
2008;"AMARAL FERRADOR (RS)";"RS";"AMARAL FERRADOR";129;10;19;158
2008;"AMETISTA DO SUL (RS)";"RS";"AMETISTA DO SUL";46;3;31;80
2008;"ANDRE DA ROCHA (RS)";"RS";"ANDRE DA ROCHA";43;3;3;49
2008;"ANTA GORDA (RS)";"RS";"ANTA GORDA";177;9;19;205
2008;"ANTONIO PRADO (RS)";"RS";"ANTONIO PRADO";578;17;36;631
2008;"ARAMBARE (RS)";"RS";"ARAMBARE";31;5;7;43
2008;"ARARICA (RS)";"RS";"ARARICA";65;7;6;78
2008;"ARATIBA (RS)";"RS";"ARATIBA";139;18;24;181
2008;"ARROIO DO MEIO (RS)";"RS";"ARROIO DO MEIO";425;27;43;495
2008;"ARROIO DO PADRE (RS)";"RS";"ARROIO DO PADRE";84;7;11;102
2008;"ARROIO DO SAL (RS)";"RS";"ARROIO DO SAL";78;11;10;99
2008;"ARROIO DO TIGRE (RS)";"RS";"ARROIO DO TIGRE";240;23;29;292
2008;"ARROIO DOS RATOS (RS)";"RS";"ARROIO DOS RATOS";176;7;52;235
2008;"ARROIO GRANDE (RS)";"RS";"ARROIO GRANDE";209;13;41;263
2008;"ARVOREZINHA (RS)";"RS";"ARVOREZINHA";385;37;28;450
2008;"AUGUSTO PESTANA (RS)";"RS";"AUGUSTO PESTANA";324;14;22;360
2008;"AUREA (RS)";"RS";"AUREA";102;5;7;114
2008;"BAGE (RS)";"RS";"BAGE";1033;136;250;1419
2008;"BALNEARIO PINHAL (RS)";"RS";"BALNEARIO PINHAL";88;11;12;111
2008;"BARAO (RS)";"RS";"BARAO";167;25;30;222
2008;"BARAO DE COTEGIPE (RS)";"RS";"BARAO DE COTEGIPE";177;13;14;204
2008;"BARAO DO TRIUNFO (RS)";"RS";"BARAO DO TRIUNFO";110;18;23;151
2008;"BARRA DO GUARITA (RS)";"RS";"BARRA DO GUARITA";17;6;4;27
2008;"BARRA DO QUARAI (RS)";"RS";"BARRA DO QUARAI";31;3;11;45
2008;"BARRA DO RIBEIRO (RS)";"RS";"BARRA DO RIBEIRO";141;9;42;192
2008;"BARRA DO RIO AZUL (RS)";"RS";"BARRA DO RIO AZUL";39;8;10;57
2008;"BARRA FUNDA (RS)";"RS";"BARRA FUNDA";144;6;5;155
2008;"BARRACAO (RS)";"RS";"BARRACAO";116;8;15;139
2008;"BARROS CASSAL (RS)";"RS";"BARROS CASSAL";132;8;33;173
2008;"BENJAMIN CONSTANT DO SUL (RS)";"RS";"BENJAMIN CONSTANT DO SUL";25;4;7;36
2008;"BENTO GONCALVES (RS)";"RS";"BENTO GONCALVES";2915;199;275;3389
2008;"BOA VISTA DAS MISSOES (RS)";"RS";"BOA VISTA DAS MISSOES";72;4;12;88
2008;"BOA VISTA DO BURICA (RS)";"RS";"BOA VISTA DO BURICA";180;9;20;209
2008;"BOA VISTA DO CADEADO (RS)";"RS";"BOA VISTA DO CADEADO";55;2;19;76
2008;"BOA VISTA DO INCRA (RS)";"RS";"BOA VISTA DO INCRA";53;1;6;60
2008;"BOA VISTA DO SUL (RS)";"RS";"BOA VISTA DO SUL";296;5;7;308
2008;"BOM JESUS (RS)";"RS";"BOM JESUS";232;21;35;288
2008;"BOM PRINCIPIO (RS)";"RS";"BOM PRINCIPIO";347;27;25;399
2008;"BOM PROGRESSO (RS)";"RS";"BOM PROGRESSO";33;5;3;41
2008;"BOM RETIRO DO SUL (RS)";"RS";"BOM RETIRO DO SUL";144;7;29;180
2008;"BOQUEIRAO DO LEAO (RS)";"RS";"BOQUEIRAO DO LEAO";144;6;18;168
2008;"BOSSOROCA (RS)";"RS";"BOSSOROCA";143;3;16;162
2008;"BOZANO (RS)";"RS";"BOZANO";105;1;7;113
2008;"BRAGA (RS)";"RS";"BRAGA";56;0;8;64
2008;"BROCHIER (RS)";"RS";"BROCHIER";216;12;18;246
2008;"BUTIA (RS)";"RS";"BUTIA";338;14;83;435
2008;"CACAPAVA DO SUL (RS)";"RS";"CACAPAVA DO SUL";522;41;92;655
2008;"CACEQUI (RS)";"RS";"CACEQUI";118;13;18;149
2008;"CACHOEIRA DO SUL (RS)";"RS";"CACHOEIRA DO SUL";989;67;199;1255
2008;"CACHOEIRINHA (RS)";"RS";"CACHOEIRINHA";1906;193;295;2394
2008;"CACIQUE DOBLE (RS)";"RS";"CACIQUE DOBLE";91;3;10;104
2008;"CAIBATE (RS)";"RS";"CAIBATE";112;7;3;122
2008;"CAICARA (RS)";"RS";"CAICARA";74;7;14;95
2008;"CAMAQUA (RS)";"RS";"CAMAQUA";1201;43;191;1435
2008;"CAMARGO (RS)";"RS";"CAMARGO";102;7;14;123
2008;"CAMBARA DO SUL (RS)";"RS";"CAMBARA DO SUL";273;11;29;313
2008;"CAMPESTRE DA SERRA (RS)";"RS";"CAMPESTRE DA SERRA";143;5;8;156
2008;"CAMPINA DAS MISSOES (RS)";"RS";"CAMPINA DAS MISSOES";110;11;24;145
2008;"CAMPINAS DO SUL (RS)";"RS";"CAMPINAS DO SUL";182;13;19;214
2008;"CAMPO BOM (RS)";"RS";"CAMPO BOM";626;78;89;793
2008;"CAMPO NOVO (RS)";"RS";"CAMPO NOVO";131;8;16;155
2008;"CAMPOS BORGES (RS)";"RS";"CAMPOS BORGES";102;8;13;123
2008;"CANDELARIA (RS)";"RS";"CANDELARIA";352;17;62;431
2008;"CANDIDO GODOI (RS)";"RS";"CANDIDO GODOI";186;17;16;219
2008;"CANDIOTA (RS)";"RS";"CANDIOTA";98;27;27;152
2008;"CANELA (RS)";"RS";"CANELA";476;72;103;651
2008;"CANGUCU (RS)";"RS";"CANGUCU";939;55;128;1122
2008;"CANOAS (RS)";"RS";"CANOAS";3697;376;955;5028
2008;"CANUDOS DO VALE (RS)";"RS";"CANUDOS DO VALE";19;7;1;27
2008;"CAPAO BONITO DO SUL (RS)";"RS";"CAPAO BONITO DO SUL";36;3;3;42
2008;"CAPAO DA CANOA (RS)";"RS";"CAPAO DA CANOA";362;60;77;499
2008;"CAPAO DO CIPO (RS)";"RS";"CAPAO DO CIPO";68;5;4;77
2008;"CAPAO DO LEAO (RS)";"RS";"CAPAO DO LEAO";321;21;22;364
2008;"CAPELA DE SANTANA (RS)";"RS";"CAPELA DE SANTANA";130;12;15;157
2008;"CAPITAO (RS)";"RS";"CAPITAO";57;7;7;71
2008;"CAPIVARI DO SUL (RS)";"RS";"CAPIVARI DO SUL";101;9;3;113
2008;"CARAA (RS)";"RS";"CARAA";89;2;19;110
2008;"CARAZINHO (RS)";"RS";"CARAZINHO";1221;60;181;1462
2008;"CARLOS BARBOSA (RS)";"RS";"CARLOS BARBOSA";651;45;79;775
2008;"CARLOS GOMES (RS)";"RS";"CARLOS GOMES";19;2;6;27
2008;"CASCA (RS)";"RS";"CASCA";342;14;15;371
2008;"CASEIROS (RS)";"RS";"CASEIROS";125;5;11;141
2008;"CATUIPE (RS)";"RS";"CATUIPE";309;7;24;340
2008;"CAXIAS DO SUL (RS)";"RS";"CAXIAS DO SUL";7473;1172;1403;10048
2008;"CENTENARIO (RS)";"RS";"CENTENARIO";72;9;6;87
2008;"CERRITO (RS)";"RS";"CERRITO";111;4;5;120
2008;"CERRO BRANCO (RS)";"RS";"CERRO BRANCO";66;6;12;84
2008;"CERRO GRANDE (RS)";"RS";"CERRO GRANDE";36;1;8;45
2008;"CERRO GRANDE DO SUL (RS)";"RS";"CERRO GRANDE DO SUL";205;17;14;236
2008;"CERRO LARGO (RS)";"RS";"CERRO LARGO";282;13;34;329
2008;"CHAPADA (RS)";"RS";"CHAPADA";279;31;19;329
2008;"CHARQUEADAS (RS)";"RS";"CHARQUEADAS";291;62;62;415
2008;"CHARRUA (RS)";"RS";"CHARRUA";80;3;10;93
2008;"CHIAPETTA (RS)";"RS";"CHIAPETTA";116;5;10;131
2008;"CHUI (RS)";"RS";"CHUI";120;13;14;147
2008;"CHUVISCA (RS)";"RS";"CHUVISCA";96;3;24;123
2008;"CIDREIRA (RS)";"RS";"CIDREIRA";83;9;16;108
2008;"CIRIACO (RS)";"RS";"CIRIACO";136;13;20;169
2008;"COLINAS (RS)";"RS";"COLINAS";54;5;8;67
2008;"COLORADO (RS)";"RS";"COLORADO";186;13;13;212
2008;"CONDOR (RS)";"RS";"CONDOR";198;9;19;226
2008;"CONSTANTINA (RS)";"RS";"CONSTANTINA";235;15;62;312
2008;"COQUEIRO BAIXO (RS)";"RS";"COQUEIRO BAIXO";17;7;2;26
2008;"COQUEIROS DO SUL (RS)";"RS";"COQUEIROS DO SUL";97;2;10;109
2008;"CORONEL BARROS (RS)";"RS";"CORONEL BARROS";82;1;9;92
2008;"CORONEL BICACO (RS)";"RS";"CORONEL BICACO";163;15;14;192
2008;"CORONEL PILAR (RS)";"RS";"CORONEL PILAR";185;4;9;198
2008;"COTIPORA (RS)";"RS";"COTIPORA";172;10;8;190
2008;"COXILHA (RS)";"RS";"COXILHA";87;3;8;98
2008;"CRISSIUMAL (RS)";"RS";"CRISSIUMAL";246;20;36;302
2008;"CRISTAL (RS)";"RS";"CRISTAL";143;5;21;169
2008;"CRISTAL DO SUL (RS)";"RS";"CRISTAL DO SUL";19;2;12;33
2008;"CRUZ ALTA (RS)";"RS";"CRUZ ALTA";1118;63;110;1291
2008;"CRUZALTENSE (RS)";"RS";"CRUZALTENSE";54;2;7;63
2008;"CRUZEIRO DO SUL (RS)";"RS";"CRUZEIRO DO SUL";297;8;4;309
2008;"DAVID CANABARRO (RS)";"RS";"DAVID CANABARRO";146;5;22;173
2008;"DERRUBADAS (RS)";"RS";"DERRUBADAS";68;11;3;82
2008;"DEZESSEIS DE NOVEMBRO (RS)";"RS";"DEZESSEIS DE NOVEMBRO";43;3;5;51
2008;"DILERMANDO DE AGUIAR (RS)";"RS";"DILERMANDO DE AGUIAR";32;2;25;59
2008;"DOIS IRMAOS (RS)";"RS";"DOIS IRMAOS";369;16;104;489
2008;"DOIS IRMAOS DAS MISSOES (RS)";"RS";"DOIS IRMAOS DAS MISSOES";46;4;5;55
2008;"DOIS LAJEADOS (RS)";"RS";"DOIS LAJEADOS";108;4;14;126
2008;"DOM FELICIANO (RS)";"RS";"DOM FELICIANO";219;12;71;302
2008;"DOM PEDRITO (RS)";"RS";"DOM PEDRITO";513;27;31;571
2008;"DOM PEDRO DE ALCANTARA (RS)";"RS";"DOM PEDRO DE ALCANTARA";76;2;3;81
2008;"DONA FRANCISCA (RS)";"RS";"DONA FRANCISCA";40;1;6;47
2008;"DOUTOR MAURICIO CARDOSO (RS)";"RS";"DOUTOR MAURICIO CARDOSO";153;18;16;187
2008;"DOUTOR RICARDO (RS)";"RS";"DOUTOR RICARDO";48;3;8;59
2008;"ELDORADO DO SUL (RS)";"RS";"ELDORADO DO SUL";354;26;34;414
2008;"ENCANTADO (RS)";"RS";"ENCANTADO";563;37;85;685
2008;"ENCRUZILHADA DO SUL (RS)";"RS";"ENCRUZILHADA DO SUL";323;12;119;454
2008;"ENGENHO VELHO (RS)";"RS";"ENGENHO VELHO";25;3;8;36
2008;"ENTRE IJUIS (RS)";"RS";"ENTRE IJUIS";262;11;24;297
2008;"ENTRE RIOS DO SUL (RS)";"RS";"ENTRE RIOS DO SUL";47;10;12;69
2008;"EREBANGO (RS)";"RS";"EREBANGO";98;2;7;107
2008;"ERECHIM (RS)";"RS";"ERECHIM";1595;195;533;2323
2008;"ERNESTINA (RS)";"RS";"ERNESTINA";129;14;10;153
2008;"ERVAL GRANDE (RS)";"RS";"ERVAL GRANDE";100;18;14;132
2008;"ERVAL SECO (RS)";"RS";"ERVAL SECO";130;6;30;166
2008;"ESMERALDA (RS)";"RS";"ESMERALDA";62;4;10;76
2008;"ESPERANCA DO SUL (RS)";"RS";"ESPERANCA DO SUL";41;1;9;51
2008;"ESPUMOSO (RS)";"RS";"ESPUMOSO";525;25;65;615
2008;"ESTACAO (RS)";"RS";"ESTACAO";176;13;7;196
2008;"ESTANCIA VELHA (RS)";"RS";"ESTANCIA VELHA";682;60;93;835
2008;"ESTEIO (RS)";"RS";"ESTEIO";1048;120;208;1376
2008;"ESTRELA (RS)";"RS";"ESTRELA";792;43;72;907
2008;"ESTRELA VELHA (RS)";"RS";"ESTRELA VELHA";98;5;11;114
2008;"EUGENIO DE CASTRO (RS)";"RS";"EUGENIO DE CASTRO";79;7;7;93
2008;"FAGUNDES VARELA (RS)";"RS";"FAGUNDES VARELA";91;4;13;108
2008;"FARROUPILHA (RS)";"RS";"FARROUPILHA";1789;206;165;2160
2008;"FAXINAL DO SOTURNO (RS)";"RS";"FAXINAL DO SOTURNO";117;6;6;129
2008;"FAXINALZINHO (RS)";"RS";"FAXINALZINHO";54;7;8;69
2008;"FAZENDA VILANOVA (RS)";"RS";"FAZENDA VILANOVA";100;8;6;114
2008;"FELIZ (RS)";"RS";"FELIZ";353;27;70;450
2008;"FLORES DA CUNHA (RS)";"RS";"FLORES DA CUNHA";1258;59;92;1409
2008;"FLORIANO PEIXOTO (RS)";"RS";"FLORIANO PEIXOTO";50;11;12;73
2008;"FONTOURA XAVIER (RS)";"RS";"FONTOURA XAVIER";165;12;27;204
2008;"FORMIGUEIRO (RS)";"RS";"FORMIGUEIRO";111;4;19;134
2008;"FORQUETINHA (RS)";"RS";"FORQUETINHA";49;3;2;54
2008;"FORTALEZA DOS VALOS (RS)";"RS";"FORTALEZA DOS VALOS";215;2;16;233
2008;"FREDERICO WESTPHALEN (RS)";"RS";"FREDERICO WESTPHALEN";568;29;65;662
2008;"GARIBALDI (RS)";"RS";"GARIBALDI";1281;61;100;1442
2008;"GARRUCHOS (RS)";"RS";"GARRUCHOS";26;5;9;40
2008;"GAURAMA (RS)";"RS";"GAURAMA";169;12;12;193
2008;"GENERAL CAMARA (RS)";"RS";"GENERAL CAMARA";68;10;18;96
2008;"GENTIL (RS)";"RS";"GENTIL";81;7;18;106
2008;"GETULIO VARGAS (RS)";"RS";"GETULIO VARGAS";447;19;26;492
2008;"GIRUA (RS)";"RS";"GIRUA";451;26;34;511
2008;"GLORINHA (RS)";"RS";"GLORINHA";172;26;9;207
2008;"GRAMADO (RS)";"RS";"GRAMADO";605;98;113;816
2008;"GRAMADO DOS LOUREIROS (RS)";"RS";"GRAMADO DOS LOUREIROS";25;1;9;35
2008;"GRAMADO XAVIER (RS)";"RS";"GRAMADO XAVIER";54;4;6;64
2008;"GRAVATAI (RS)";"RS";"GRAVATAI";2652;396;461;3509
2008;"GUABIJU (RS)";"RS";"GUABIJU";49;6;7;62
2008;"GUAIBA (RS)";"RS";"GUAIBA";915;141;361;1417
2008;"GUAPORE (RS)";"RS";"GUAPORE";375;29;50;454
2008;"GUARANI DAS MISSOES (RS)";"RS";"GUARANI DAS MISSOES";192;7;15;214
2008;"HARMONIA (RS)";"RS";"HARMONIA";182;7;11;200
2008;"HERVAL (RS)";"RS";"HERVAL";103;6;7;116
2008;"HERVEIRAS (RS)";"RS";"HERVEIRAS";47;2;2;51
2008;"HORIZONTINA (RS)";"RS";"HORIZONTINA";287;31;45;363
2008;"HULHA NEGRA (RS)";"RS";"HULHA NEGRA";36;8;27;71
2008;"HUMAITA (RS)";"RS";"HUMAITA";90;2;7;99
2008;"IBARAMA (RS)";"RS";"IBARAMA";83;4;13;100
2008;"IBIACA (RS)";"RS";"IBIACA";224;6;16;246
2008;"IBIRAIARAS (RS)";"RS";"IBIRAIARAS";402;7;23;432
2008;"IBIRAPUITA (RS)";"RS";"IBIRAPUITA";105;4;22;131
2008;"IBIRUBA (RS)";"RS";"IBIRUBA";763;34;57;854
2008;"IGREJINHA (RS)";"RS";"IGREJINHA";355;34;66;455
2008;"IJUI (RS)";"RS";"IJUI";1638;93;102;1833
2008;"ILOPOLIS (RS)";"RS";"ILOPOLIS";152;7;4;163
2008;"IMBE (RS)";"RS";"IMBE";206;17;35;258
2008;"IMIGRANTE (RS)";"RS";"IMIGRANTE";78;11;19;108
2008;"INDEPENDENCIA (RS)";"RS";"INDEPENDENCIA";164;20;32;216
2008;"INHACORA (RS)";"RS";"INHACORA";61;6;6;73
2008;"IPE (RS)";"RS";"IPE";224;18;24;266
2008;"IPIRANGA DO SUL (RS)";"RS";"IPIRANGA DO SUL";98;8;9;115
2008;"IRAI (RS)";"RS";"IRAI";96;6;18;120
2008;"ITAARA (RS)";"RS";"ITAARA";99;3;6;108
2008;"ITACURUBI (RS)";"RS";"ITACURUBI";25;6;8;39
2008;"ITAPUCA (RS)";"RS";"ITAPUCA";42;3;6;51
2008;"ITAQUI (RS)";"RS";"ITAQUI";570;17;46;633
2008;"ITATI (RS)";"RS";"ITATI";51;4;6;61
2008;"ITATIBA DO SUL (RS)";"RS";"ITATIBA DO SUL";76;13;5;94
2008;"IVORA (RS)";"RS";"IVORA";56;4;7;67
2008;"IVOTI (RS)";"RS";"IVOTI";454;36;85;575
2008;"JABOTICABA (RS)";"RS";"JABOTICABA";49;3;14;66
2008;"JACUIZINHO (RS)";"RS";"JACUIZINHO";39;3;7;49
2008;"JACUTINGA (RS)";"RS";"JACUTINGA";97;10;6;113
2008;"JAGUARAO (RS)";"RS";"JAGUARAO";282;13;35;330
2008;"JAGUARI (RS)";"RS";"JAGUARI";210;18;47;275
2008;"JAQUIRANA (RS)";"RS";"JAQUIRANA";130;7;8;145
2008;"JARI (RS)";"RS";"JARI";43;4;9;56
2008;"JOIA (RS)";"RS";"JOIA";253;9;30;292
2008;"JULIO DE CASTILHOS (RS)";"RS";"JULIO DE CASTILHOS";511;22;44;577
2008;"LAGOA BONITA DO SUL (RS)";"RS";"LAGOA BONITA DO SUL";41;5;19;65
2008;"LAGOA DOS TRES CANTOS (RS)";"RS";"LAGOA DOS TRES CANTOS";75;7;3;85
2008;"LAGOA VERMELHA (RS)";"RS";"LAGOA VERMELHA";568;32;67;667
2008;"LAGOAO (RS)";"RS";"LAGOAO";57;5;25;87
2008;"LAJEADO (RS)";"RS";"LAJEADO";1707;137;225;2069
2008;"LAJEADO DO BUGRE (RS)";"RS";"LAJEADO DO BUGRE";17;1;5;23
2008;"LAVRAS DO SUL (RS)";"RS";"LAVRAS DO SUL";70;10;18;98
2008;"LIBERATO SALZANO (RS)";"RS";"LIBERATO SALZANO";95;4;19;118
2008;"LINDOLFO COLLOR (RS)";"RS";"LINDOLFO COLLOR";103;10;14;127
2008;"LINHA NOVA (RS)";"RS";"LINHA NOVA";58;7;3;68
2008;"MACAMBARA (RS)";"RS";"MACAMBARA";29;3;24;56
2008;"MACHADINHO (RS)";"RS";"MACHADINHO";96;7;17;120
2008;"MAMPITUBA (RS)";"RS";"MAMPITUBA";29;1;7;37
2008;"MANOEL VIANA (RS)";"RS";"MANOEL VIANA";144;6;10;160
2008;"MAQUINE (RS)";"RS";"MAQUINE";239;10;9;258
2008;"MARATA (RS)";"RS";"MARATA";89;11;22;122
2008;"MARAU (RS)";"RS";"MARAU";894;60;119;1073
2008;"MARCELINO RAMOS (RS)";"RS";"MARCELINO RAMOS";105;17;18;140
2008;"MARIANA PIMENTEL (RS)";"RS";"MARIANA PIMENTEL";91;7;18;116
2008;"MARIANO MORO (RS)";"RS";"MARIANO MORO";57;11;6;74
2008;"MARQUES DE SOUZA (RS)";"RS";"MARQUES DE SOUZA";104;11;11;126
2008;"MATA (RS)";"RS";"MATA";88;3;14;105
2008;"MATO CASTELHANO (RS)";"RS";"MATO CASTELHANO";112;8;21;141
2008;"MATO LEITAO (RS)";"RS";"MATO LEITAO";259;6;8;273
2008;"MATO QUEIMADO (RS)";"RS";"MATO QUEIMADO";36;6;5;47
2008;"MAXIMILIANO DE ALMEIDA (RS)";"RS";"MAXIMILIANO DE ALMEIDA";116;7;32;155
2008;"MINAS DO LEAO (RS)";"RS";"MINAS DO LEAO";100;14;25;139
2008;"MIRAGUAI (RS)";"RS";"MIRAGUAI";68;1;16;85
2008;"MONTAURI (RS)";"RS";"MONTAURI";52;5;3;60
2008;"MONTE ALEGRE DOS CAMPOS (RS)";"RS";"MONTE ALEGRE DOS CAMPOS";56;4;25;85
2008;"MONTE BELO DO SUL (RS)";"RS";"MONTE BELO DO SUL";183;8;15;206
2008;"MONTENEGRO (RS)";"RS";"MONTENEGRO";1158;135;207;1500
2008;"MORMACO (RS)";"RS";"MORMACO";62;5;7;74
2008;"MORRINHOS DO SUL (RS)";"RS";"MORRINHOS DO SUL";127;1;6;134
2008;"MORRO REDONDO (RS)";"RS";"MORRO REDONDO";191;5;17;213
2008;"MORRO REUTER (RS)";"RS";"MORRO REUTER";136;10;28;174
2008;"MOSTARDAS (RS)";"RS";"MOSTARDAS";229;8;43;280
2008;"MUCUM (RS)";"RS";"MUCUM";86;9;20;115
2008;"MUITOS CAPOES (RS)";"RS";"MUITOS CAPOES";48;3;4;55
2008;"MULITERNO (RS)";"RS";"MULITERNO";78;5;6;89
2008;"NAO ME TOQUE (RS)";"RS";"NAO ME TOQUE";449;24;47;520
2008;"NICOLAU VERGUEIRO (RS)";"RS";"NICOLAU VERGUEIRO";72;5;13;90
2008;"NONOAI (RS)";"RS";"NONOAI";188;14;42;244
2008;"NOVA ALVORADA (RS)";"RS";"NOVA ALVORADA";110;3;7;120
2008;"NOVA ARACA (RS)";"RS";"NOVA ARACA";140;20;23;183
2008;"NOVA BASSANO (RS)";"RS";"NOVA BASSANO";410;23;28;461
2008;"NOVA BOA VISTA (RS)";"RS";"NOVA BOA VISTA";59;10;10;79
2008;"NOVA BRESCIA (RS)";"RS";"NOVA BRESCIA";92;15;6;113
2008;"NOVA CANDELARIA (RS)";"RS";"NOVA CANDELARIA";65;7;6;78
2008;"NOVA ESPERANCA DO SUL (RS)";"RS";"NOVA ESPERANCA DO SUL";52;5;17;74
2008;"NOVA HARTZ (RS)";"RS";"NOVA HARTZ";114;12;59;185
2008;"NOVA PADUA (RS)";"RS";"NOVA PADUA";273;4;6;283
2008;"NOVA PALMA (RS)";"RS";"NOVA PALMA";205;14;20;239
2008;"NOVA PETROPOLIS (RS)";"RS";"NOVA PETROPOLIS";457;41;58;556
2008;"NOVA PRATA (RS)";"RS";"NOVA PRATA";533;23;44;600
2008;"NOVA RAMADA (RS)";"RS";"NOVA RAMADA";78;6;7;91
2008;"NOVA ROMA DO SUL (RS)";"RS";"NOVA ROMA DO SUL";233;9;29;271
2008;"NOVA SANTA RITA (RS)";"RS";"NOVA SANTA RITA";423;39;36;498
2008;"NOVO BARREIRO (RS)";"RS";"NOVO BARREIRO";83;7;10;100
2008;"NOVO CABRAIS (RS)";"RS";"NOVO CABRAIS";72;0;9;81
2008;"NOVO HAMBURGO (RS)";"RS";"NOVO HAMBURGO";2417;240;374;3031
2008;"NOVO MACHADO (RS)";"RS";"NOVO MACHADO";124;20;9;153
2008;"NOVO TIRADENTES (RS)";"RS";"NOVO TIRADENTES";28;2;10;40
2008;"NOVO XINGU (RS)";"RS";"NOVO XINGU";27;9;8;44
2008;"OSORIO (RS)";"RS";"OSORIO";738;42;116;896
2008;"PAIM FILHO (RS)";"RS";"PAIM FILHO";101;4;21;126
2008;"PALMARES DO SUL (RS)";"RS";"PALMARES DO SUL";159;14;26;199
2008;"PALMEIRA DAS MISSOES (RS)";"RS";"PALMEIRA DAS MISSOES";778;23;68;869
2008;"PALMITINHO (RS)";"RS";"PALMITINHO";134;5;26;165
2008;"PANAMBI (RS)";"RS";"PANAMBI";845;48;101;994
2008;"PANTANO GRANDE (RS)";"RS";"PANTANO GRANDE";284;9;22;315
2008;"PARAI (RS)";"RS";"PARAI";348;8;21;377
2008;"PARAISO DO SUL (RS)";"RS";"PARAISO DO SUL";84;2;6;92
2008;"PARECI NOVO (RS)";"RS";"PARECI NOVO";389;8;20;417
2008;"PAROBE (RS)";"RS";"PAROBE";416;60;125;601
2008;"PASSA SETE (RS)";"RS";"PASSA SETE";59;1;22;82
2008;"PASSO DO SOBRADO (RS)";"RS";"PASSO DO SOBRADO";120;8;40;168
2008;"PASSO FUNDO (RS)";"RS";"PASSO FUNDO";2747;160;318;3225
2008;"PAULO BENTO (RS)";"RS";"PAULO BENTO";63;11;6;80
2008;"PAVERAMA (RS)";"RS";"PAVERAMA";165;24;40;229
2008;"PEDRAS ALTAS (RS)";"RS";"PEDRAS ALTAS";12;13;1;26
2008;"PEDRO OSORIO (RS)";"RS";"PEDRO OSORIO";97;5;28;130
2008;"PEJUCARA (RS)";"RS";"PEJUCARA";197;3;12;212
2008;"PELOTAS (RS)";"RS";"PELOTAS";4588;235;918;5741
2008;"PICADA CAFE (RS)";"RS";"PICADA CAFE";89;16;51;156
2008;"PINHAL (RS)";"RS";"PINHAL";61;2;10;73
2008;"PINHAL DA SERRA (RS)";"RS";"PINHAL DA SERRA";36;6;8;50
2008;"PINHAL GRANDE (RS)";"RS";"PINHAL GRANDE";89;14;19;122
2008;"PINHEIRINHO DO VALE (RS)";"RS";"PINHEIRINHO DO VALE";45;2;20;67
2008;"PINHEIRO MACHADO (RS)";"RS";"PINHEIRO MACHADO";137;10;32;179
2008;"PINTO BANDEIRA (RS)";"RS";"PINTO BANDEIRA";4;0;0;4
2008;"PIRAPO (RS)";"RS";"PIRAPO";27;7;9;43
2008;"PIRATINI (RS)";"RS";"PIRATINI";227;24;80;331
2008;"PLANALTO (RS)";"RS";"PLANALTO";167;6;28;201
2008;"POCO DAS ANTAS (RS)";"RS";"POCO DAS ANTAS";75;9;16;100
2008;"PONTAO (RS)";"RS";"PONTAO";79;4;16;99
2008;"PONTE PRETA (RS)";"RS";"PONTE PRETA";53;5;4;62
2008;"PORTAO (RS)";"RS";"PORTAO";1620;73;87;1780
2008;"PORTO ALEGRE (RS)";"RS";"PORTO ALEGRE";13558;1999;3978;19535
2008;"PORTO LUCENA (RS)";"RS";"PORTO LUCENA";77;7;14;98
2008;"PORTO MAUA (RS)";"RS";"PORTO MAUA";40;8;7;55
2008;"PORTO VERA CRUZ (RS)";"RS";"PORTO VERA CRUZ";6;2;6;14
2008;"PORTO XAVIER (RS)";"RS";"PORTO XAVIER";175;10;29;214
2008;"POUSO NOVO (RS)";"RS";"POUSO NOVO";28;6;5;39
2008;"PRESIDENTE LUCENA (RS)";"RS";"PRESIDENTE LUCENA";113;2;6;121
2008;"PROGRESSO (RS)";"RS";"PROGRESSO";87;8;19;114
2008;"PROTASIO ALVES (RS)";"RS";"PROTASIO ALVES";45;3;4;52
2008;"PUTINGA (RS)";"RS";"PUTINGA";89;8;11;108
2008;"QUARAI (RS)";"RS";"QUARAI";151;10;37;198
2008;"QUATRO IRMAOS (RS)";"RS";"QUATRO IRMAOS";49;10;3;62
2008;"QUEVEDOS (RS)";"RS";"QUEVEDOS";23;2;5;30
2008;"QUINZE DE NOVEMBRO (RS)";"RS";"QUINZE DE NOVEMBRO";156;16;17;189
2008;"REDENTORA (RS)";"RS";"REDENTORA";88;11;16;115
2008;"RELVADO (RS)";"RS";"RELVADO";42;5;3;50
2008;"RESTINGA SECA (RS)";"RS";"RESTINGA SECA";259;8;50;317
2008;"RIO DOS INDIOS (RS)";"RS";"RIO DOS INDIOS";50;3;25;78
2008;"RIO GRANDE (RS)";"RS";"RIO GRANDE";1795;120;406;2321
2008;"RIO PARDO (RS)";"RS";"RIO PARDO";359;32;65;456
2008;"RIOZINHO (RS)";"RS";"RIOZINHO";47;4;25;76
2008;"ROCA SALES (RS)";"RS";"ROCA SALES";147;16;38;201
2008;"RODEIO BONITO (RS)";"RS";"RODEIO BONITO";84;6;20;110
2008;"ROLADOR (RS)";"RS";"ROLADOR";46;4;7;57
2008;"ROLANTE (RS)";"RS";"ROLANTE";202;18;47;267
2008;"RONDA ALTA (RS)";"RS";"RONDA ALTA";226;13;20;259
2008;"RONDINHA (RS)";"RS";"RONDINHA";147;12;25;184
2008;"ROQUE GONZALES (RS)";"RS";"ROQUE GONZALES";118;2;20;140
2008;"ROSARIO DO SUL (RS)";"RS";"ROSARIO DO SUL";415;28;62;505
2008;"SAGRADA FAMILIA (RS)";"RS";"SAGRADA FAMILIA";22;3;8;33
2008;"SALDANHA MARINHO (RS)";"RS";"SALDANHA MARINHO";143;11;6;160
2008;"SALTO DO JACUI (RS)";"RS";"SALTO DO JACUI";161;13;24;198
2008;"SALVADOR DAS MISSOES (RS)";"RS";"SALVADOR DAS MISSOES";90;2;3;95
2008;"SALVADOR DO SUL (RS)";"RS";"SALVADOR DO SUL";228;24;24;276
2008;"SANANDUVA (RS)";"RS";"SANANDUVA";541;17;43;601
2008;"SANTA BARBARA DO SUL (RS)";"RS";"SANTA BARBARA DO SUL";308;16;37;361
2008;"SANTA CECILIA DO SUL (RS)";"RS";"SANTA CECILIA DO SUL";43;3;9;55
2008;"SANTA CLARA DO SUL (RS)";"RS";"SANTA CLARA DO SUL";114;22;10;146
2008;"SANTA CRUZ DO SUL (RS)";"RS";"SANTA CRUZ DO SUL";1672;139;498;2309
2008;"SANTA MARGARIDA DO SUL (RS)";"RS";"SANTA MARGARIDA DO SUL";39;6;0;45
2008;"SANTA MARIA (RS)";"RS";"SANTA MARIA";2730;289;892;3911
2008;"SANTA MARIA DO HERVAL (RS)";"RS";"SANTA MARIA DO HERVAL";171;9;45;225
2008;"SANTA ROSA (RS)";"RS";"SANTA ROSA";1280;83;136;1499
2008;"SANTA TEREZA (RS)";"RS";"SANTA TEREZA";78;4;5;87
2008;"SANTA VITORIA DO PALMAR (RS)";"RS";"SANTA VITORIA DO PALMAR";460;8;61;529
2008;"SANTANA DA BOA VISTA (RS)";"RS";"SANTANA DA BOA VISTA";64;6;35;105
2008;"SANTANA DO LIVRAMENTO (RS)";"RS";"SANTANA DO LIVRAMENTO";633;41;132;806
2008;"SANTIAGO (RS)";"RS";"SANTIAGO";693;48;85;826
2008;"SANTO ANGELO (RS)";"RS";"SANTO ANGELO";1049;69;75;1193
2008;"SANTO ANTONIO DA PATRULHA (RS)";"RS";"SANTO ANTONIO DA PATRULHA";735;24;138;897
2008;"SANTO ANTONIO DAS MISSOES (RS)";"RS";"SANTO ANTONIO DAS MISSOES";143;27;21;191
2008;"SANTO ANTONIO DO PALMA (RS)";"RS";"SANTO ANTONIO DO PALMA";43;5;7;55
2008;"SANTO ANTONIO DO PLANALTO (RS)";"RS";"SANTO ANTONIO DO PLANALTO";88;5;6;99
2008;"SANTO AUGUSTO (RS)";"RS";"SANTO AUGUSTO";442;22;23;487
2008;"SANTO CRISTO (RS)";"RS";"SANTO CRISTO";411;17;39;467
2008;"SANTO EXPEDITO DO SUL (RS)";"RS";"SANTO EXPEDITO DO SUL";82;4;11;97
2008;"SAO BORJA (RS)";"RS";"SAO BORJA";1016;45;73;1134
2008;"SAO DOMINGOS DO SUL (RS)";"RS";"SAO DOMINGOS DO SUL";82;7;3;92
2008;"SAO FRANCISCO DE ASSIS (RS)";"RS";"SAO FRANCISCO DE ASSIS";260;12;73;345
2008;"SAO FRANCISCO DE PAULA (RS)";"RS";"SAO FRANCISCO DE PAULA";440;29;48;517
2008;"SAO GABRIEL (RS)";"RS";"SAO GABRIEL";774;23;97;894
2008;"SAO JERONIMO (RS)";"RS";"SAO JERONIMO";247;21;111;379
2008;"SAO JOAO DA URTIGA (RS)";"RS";"SAO JOAO DA URTIGA";122;6;17;145
2008;"SAO JOAO DO POLESINE (RS)";"RS";"SAO JOAO DO POLESINE";59;0;5;64
2008;"SAO JORGE (RS)";"RS";"SAO JORGE";125;5;14;144
2008;"SAO JOSE DAS MISSOES (RS)";"RS";"SAO JOSE DAS MISSOES";41;4;7;52
2008;"SAO JOSE DO HERVAL (RS)";"RS";"SAO JOSE DO HERVAL";62;3;10;75
2008;"SAO JOSE DO HORTENCIO (RS)";"RS";"SAO JOSE DO HORTENCIO";176;9;27;212
2008;"SAO JOSE DO INHACORA (RS)";"RS";"SAO JOSE DO INHACORA";33;4;3;40
2008;"SAO JOSE DO NORTE (RS)";"RS";"SAO JOSE DO NORTE";286;3;41;330
2008;"SAO JOSE DO OURO (RS)";"RS";"SAO JOSE DO OURO";270;9;26;305
2008;"SAO JOSE DO SUL (RS)";"RS";"SAO JOSE DO SUL";113;14;2;129
2008;"SAO JOSE DOS AUSENTES (RS)";"RS";"SAO JOSE DOS AUSENTES";82;6;9;97
2008;"SAO LEOPOLDO (RS)";"RS";"SAO LEOPOLDO";1660;200;469;2329
2008;"SAO LOURENCO DO SUL (RS)";"RS";"SAO LOURENCO DO SUL";853;33;120;1006
2008;"SAO LUIZ GONZAGA (RS)";"RS";"SAO LUIZ GONZAGA";527;42;69;638
2008;"SAO MARCOS (RS)";"RS";"SAO MARCOS";611;12;92;715
2008;"SAO MARTINHO (RS)";"RS";"SAO MARTINHO";163;9;12;184
2008;"SAO MARTINHO DA SERRA (RS)";"RS";"SAO MARTINHO DA SERRA";37;1;2;40
2008;"SAO MIGUEL DAS MISSOES (RS)";"RS";"SAO MIGUEL DAS MISSOES";192;21;31;244
2008;"SAO NICOLAU (RS)";"RS";"SAO NICOLAU";58;5;7;70
2008;"SAO PAULO DAS MISSOES (RS)";"RS";"SAO PAULO DAS MISSOES";93;7;21;121
2008;"SAO PEDRO DA SERRA (RS)";"RS";"SAO PEDRO DA SERRA";96;8;8;112
2008;"SAO PEDRO DAS MISSOES (RS)";"RS";"SAO PEDRO DAS MISSOES";26;5;4;35
2008;"SAO PEDRO DO BUTIA (RS)";"RS";"SAO PEDRO DO BUTIA";95;1;9;105
2008;"SAO PEDRO DO SUL (RS)";"RS";"SAO PEDRO DO SUL";243;32;27;302
2008;"SAO SEBASTIAO DO CAI (RS)";"RS";"SAO SEBASTIAO DO CAI";646;21;62;729
2008;"SAO SEPE (RS)";"RS";"SAO SEPE";393;19;76;488
2008;"SAO VALENTIM (RS)";"RS";"SAO VALENTIM";65;9;8;82
2008;"SAO VALENTIM DO SUL (RS)";"RS";"SAO VALENTIM DO SUL";72;3;7;82
2008;"SAO VALERIO DO SUL (RS)";"RS";"SAO VALERIO DO SUL";35;4;5;44
2008;"SAO VENDELINO (RS)";"RS";"SAO VENDELINO";76;8;3;87
2008;"SAO VICENTE DO SUL (RS)";"RS";"SAO VICENTE DO SUL";113;5;32;150
2008;"SAPIRANGA (RS)";"RS";"SAPIRANGA";773;96;130;999
2008;"SAPUCAIA DO SUL (RS)";"RS";"SAPUCAIA DO SUL";1390;138;145;1673
2008;"SARANDI (RS)";"RS";"SARANDI";522;22;53;597
2008;"SEBERI (RS)";"RS";"SEBERI";201;9;30;240
2008;"SEDE NOVA (RS)";"RS";"SEDE NOVA";54;8;9;71
2008;"SEGREDO (RS)";"RS";"SEGREDO";122;5;22;149
2008;"SELBACH (RS)";"RS";"SELBACH";250;9;15;274
2008;"SENADOR SALGADO FILHO (RS)";"RS";"SENADOR SALGADO FILHO";90;9;12;111
2008;"SENTINELA DO SUL (RS)";"RS";"SENTINELA DO SUL";108;5;11;124
2008;"SERAFINA CORREA (RS)";"RS";"SERAFINA CORREA";266;43;41;350
2008;"SERIO (RS)";"RS";"SERIO";50;7;5;62
2008;"SERTAO (RS)";"RS";"SERTAO";218;11;23;252
2008;"SERTAO SANTANA (RS)";"RS";"SERTAO SANTANA";160;12;20;192
2008;"SETE DE SETEMBRO (RS)";"RS";"SETE DE SETEMBRO";50;1;7;58
2008;"SEVERIANO DE ALMEIDA (RS)";"RS";"SEVERIANO DE ALMEIDA";80;12;11;103
2008;"SILVEIRA MARTINS (RS)";"RS";"SILVEIRA MARTINS";116;1;4;121
2008;"SINIMBU (RS)";"RS";"SINIMBU";119;2;5;126
2008;"SOBRADINHO (RS)";"RS";"SOBRADINHO";268;19;43;330
2008;"SOLEDADE (RS)";"RS";"SOLEDADE";434;21;85;540
2008;"TABAI (RS)";"RS";"TABAI";146;18;6;170
2008;"TAPEJARA (RS)";"RS";"TAPEJARA";624;14;57;695
2008;"TAPERA (RS)";"RS";"TAPERA";320;21;22;363
2008;"TAPES (RS)";"RS";"TAPES";259;12;27;298
2008;"TAQUARA (RS)";"RS";"TAQUARA";663;52;217;932
2008;"TAQUARI (RS)";"RS";"TAQUARI";409;29;115;553
2008;"TAQUARUCU DO SUL (RS)";"RS";"TAQUARUCU DO SUL";56;2;9;67
2008;"TAVARES (RS)";"RS";"TAVARES";90;5;8;103
2008;"TENENTE PORTELA (RS)";"RS";"TENENTE PORTELA";234;9;30;273
2008;"TERRA DE AREIA (RS)";"RS";"TERRA DE AREIA";274;13;18;305
2008;"TEUTONIA (RS)";"RS";"TEUTONIA";515;33;62;610
2008;"TIO HUGO (RS)";"RS";"TIO HUGO";74;7;6;87
2008;"TIRADENTES DO SUL (RS)";"RS";"TIRADENTES DO SUL";85;8;6;99
2008;"TOROPI (RS)";"RS";"TOROPI";41;2;16;59
2008;"TORRES (RS)";"RS";"TORRES";352;20;57;429
2008;"TRAMANDAI (RS)";"RS";"TRAMANDAI";516;50;127;693
2008;"TRAVESSEIRO (RS)";"RS";"TRAVESSEIRO";37;6;8;51
2008;"TRES ARROIOS (RS)";"RS";"TRES ARROIOS";78;9;3;90
2008;"TRES CACHOEIRAS (RS)";"RS";"TRES CACHOEIRAS";591;11;10;612
2008;"TRES COROAS (RS)";"RS";"TRES COROAS";208;23;47;278
2008;"TRES DE MAIO (RS)";"RS";"TRES DE MAIO";598;51;63;712
2008;"TRES FORQUILHAS (RS)";"RS";"TRES FORQUILHAS";86;3;2;91
2008;"TRES PALMEIRAS (RS)";"RS";"TRES PALMEIRAS";64;4;14;82
2008;"TRES PASSOS (RS)";"RS";"TRES PASSOS";358;22;104;484
2008;"TRINDADE DO SUL (RS)";"RS";"TRINDADE DO SUL";98;5;22;125
2008;"TRIUNFO (RS)";"RS";"TRIUNFO";401;104;123;628
2008;"TUCUNDUVA (RS)";"RS";"TUCUNDUVA";191;13;11;215
2008;"TUNAS (RS)";"RS";"TUNAS";38;5;13;56
2008;"TUPANCI DO SUL (RS)";"RS";"TUPANCI DO SUL";46;2;10;58
2008;"TUPANCIRETA (RS)";"RS";"TUPANCIRETA";452;26;39;517
2008;"TUPANDI (RS)";"RS";"TUPANDI";86;23;24;133
2008;"TUPARENDI (RS)";"RS";"TUPARENDI";198;10;24;232
2008;"TURUCU (RS)";"RS";"TURUCU";68;4;8;80
2008;"UBIRETAMA (RS)";"RS";"UBIRETAMA";65;6;3;74
2008;"UNIAO DA SERRA (RS)";"RS";"UNIAO DA SERRA";50;2;8;60
2008;"UNISTALDA (RS)";"RS";"UNISTALDA";21;5;10;36
2008;"URUGUAIANA (RS)";"RS";"URUGUAIANA";1699;73;146;1918
2008;"VACARIA (RS)";"RS";"VACARIA";1543;97;369;2009
2008;"VALE DO SOL (RS)";"RS";"VALE DO SOL";171;3;30;204
2008;"VALE REAL (RS)";"RS";"VALE REAL";225;9;10;244
2008;"VALE VERDE (RS)";"RS";"VALE VERDE";45;2;5;52
2008;"VANINI (RS)";"RS";"VANINI";86;13;11;110
2008;"VENANCIO AIRES (RS)";"RS";"VENANCIO AIRES";1009;64;161;1234
2008;"VERA CRUZ (RS)";"RS";"VERA CRUZ";323;10;84;417
2008;"VERANOPOLIS (RS)";"RS";"VERANOPOLIS";815;39;75;929
2008;"VESPASIANO CORREA (RS)";"RS";"VESPASIANO CORREA";73;3;17;93
2008;"VIADUTOS (RS)";"RS";"VIADUTOS";115;9;18;142
2008;"VIAMAO (RS)";"RS";"VIAMAO";1577;225;487;2289
2008;"VICENTE DUTRA (RS)";"RS";"VICENTE DUTRA";44;1;16;61
2008;"VICTOR GRAEFF (RS)";"RS";"VICTOR GRAEFF";136;15;5;156
2008;"VILA FLORES (RS)";"RS";"VILA FLORES";156;11;11;178
2008;"VILA LANGARO (RS)";"RS";"VILA LANGARO";79;5;9;93
2008;"VILA MARIA (RS)";"RS";"VILA MARIA";216;10;35;261
2008;"VILA NOVA DO SUL (RS)";"RS";"VILA NOVA DO SUL";84;5;8;97
2008;"VISTA ALEGRE (RS)";"RS";"VISTA ALEGRE";45;4;10;59
2008;"VISTA ALEGRE DO PRATA (RS)";"RS";"VISTA ALEGRE DO PRATA";34;6;3;43
2008;"VISTA GAUCHA (RS)";"RS";"VISTA GAUCHA";47;2;11;60
2008;"VITORIA DAS MISSOES (RS)";"RS";"VITORIA DAS MISSOES";81;1;8;90
2008;"WESTFALIA (RS)";"RS";"WESTFALIA";96;17;9;122
2008;"XANGRI LA (RS)";"RS";"XANGRI LA";135;10;4;149
2008;"ABDON BATISTA (SC)";"SC";"ABDON BATISTA";47;6;8;61
2008;"ABELARDO LUZ (SC)";"SC";"ABELARDO LUZ";313;9;52;374
2008;"AGROLANDIA (SC)";"SC";"AGROLANDIA";186;11;15;212
2008;"AGRONOMICA (SC)";"SC";"AGRONOMICA";123;2;10;135
2008;"AGUA DOCE (SC)";"SC";"AGUA DOCE";153;17;16;186
2008;"AGUAS DE CHAPECO (SC)";"SC";"AGUAS DE CHAPECO";69;4;25;98
2008;"AGUAS FRIAS (SC)";"SC";"AGUAS FRIAS";38;2;4;44
2008;"AGUAS MORNAS (SC)";"SC";"AGUAS MORNAS";206;4;11;221
2008;"ALFREDO WAGNER (SC)";"SC";"ALFREDO WAGNER";207;20;9;236
2008;"ALTO BELA VISTA (SC)";"SC";"ALTO BELA VISTA";48;5;6;59
2008;"ANCHIETA (SC)";"SC";"ANCHIETA";141;14;16;171
2008;"ANGELINA (SC)";"SC";"ANGELINA";149;12;10;171
2008;"ANITA GARIBALDI (SC)";"SC";"ANITA GARIBALDI";126;9;21;156
2008;"ANITAPOLIS (SC)";"SC";"ANITAPOLIS";72;8;9;89
2008;"ANTONIO CARLOS (SC)";"SC";"ANTONIO CARLOS";494;9;6;509
2008;"APIUNA (SC)";"SC";"APIUNA";128;11;16;155
2008;"ARABUTA (SC)";"SC";"ARABUTA";91;7;22;120
2008;"ARAQUARI (SC)";"SC";"ARAQUARI";313;18;26;357
2008;"ARARANGUA (SC)";"SC";"ARARANGUA";1175;53;144;1372
2008;"ARMAZEM (SC)";"SC";"ARMAZEM";228;12;8;248
2008;"ARROIO TRINTA (SC)";"SC";"ARROIO TRINTA";149;8;9;166
2008;"ARVOREDO (SC)";"SC";"ARVOREDO";26;7;5;38
2008;"ASCURRA (SC)";"SC";"ASCURRA";170;16;28;214
2008;"ATALANTA (SC)";"SC";"ATALANTA";79;2;5;86
2008;"AURORA (SC)";"SC";"AURORA";166;7;6;179
2008;"BALNEARIO ARROIO DO SILVA (SC)";"SC";"BALNEARIO ARROIO DO SILVA";75;8;20;103
2008;"BALNEARIO CAMBORIU (SC)";"SC";"BALNEARIO CAMBORIU";817;191;206;1214
2008;"BALNEARIO GAIVOTA (SC)";"SC";"BALNEARIO GAIVOTA";129;7;10;146
2008;"BANDEIRANTE (SC)";"SC";"BANDEIRANTE";23;2;12;37
2008;"BARRA BONITA (SC)";"SC";"BARRA BONITA";26;3;7;36
2008;"BARRA DO SUL (SC)";"SC";"BARRA DO SUL";80;5;3;88
2008;"BARRA VELHA (SC)";"SC";"BARRA VELHA";267;25;19;311
2008;"BELA VISTA DO TOLDO (SC)";"SC";"BELA VISTA DO TOLDO";73;1;9;83
2008;"BELMONTE (SC)";"SC";"BELMONTE";43;2;6;51
2008;"BENEDITO NOVO (SC)";"SC";"BENEDITO NOVO";255;20;18;293
2008;"BIGUACU (SC)";"SC";"BIGUACU";790;52;137;979
2008;"BLUMENAU (SC)";"SC";"BLUMENAU";4338;321;704;5363
2008;"BOCAINA DO SUL (SC)";"SC";"BOCAINA DO SUL";37;6;17;60
2008;"BOM JARDIM DA SERRA (SC)";"SC";"BOM JARDIM DA SERRA";89;3;16;108
2008;"BOM JESUS (SC)";"SC";"BOM JESUS";52;1;7;60
2008;"BOM JESUS DO OESTE (SC)";"SC";"BOM JESUS DO OESTE";34;1;9;44
2008;"BOM RETIRO (SC)";"SC";"BOM RETIRO";138;15;23;176
2008;"BOMBINHAS (SC)";"SC";"BOMBINHAS";109;24;18;151
2008;"BOTUVERA (SC)";"SC";"BOTUVERA";184;8;8;200
2008;"BRACO DO NORTE (SC)";"SC";"BRACO DO NORTE";844;35;49;928
2008;"BRACO DO TROMBUDO (SC)";"SC";"BRACO DO TROMBUDO";110;7;3;120
2008;"BRUNOPOLIS (SC)";"SC";"BRUNOPOLIS";57;3;8;68
2008;"BRUSQUE (SC)";"SC";"BRUSQUE";1855;111;150;2116
2008;"CACADOR (SC)";"SC";"CACADOR";1791;87;769;2647
2008;"CAIBI (SC)";"SC";"CAIBI";157;5;24;186
2008;"CALMON (SC)";"SC";"CALMON";35;3;19;57
2008;"CAMBORIU (SC)";"SC";"CAMBORIU";781;30;24;835
2008;"CAMPO ALEGRE (SC)";"SC";"CAMPO ALEGRE";334;12;6;352
2008;"CAMPO BELO DO SUL (SC)";"SC";"CAMPO BELO DO SUL";167;7;22;196
2008;"CAMPO ERE (SC)";"SC";"CAMPO ERE";208;8;26;242
2008;"CAMPOS NOVOS (SC)";"SC";"CAMPOS NOVOS";836;53;70;959
2008;"CANELINHA (SC)";"SC";"CANELINHA";452;14;11;477
2008;"CANOINHAS (SC)";"SC";"CANOINHAS";1116;46;105;1267
2008;"CAPAO ALTO (SC)";"SC";"CAPAO ALTO";40;5;11;56
2008;"CAPINZAL (SC)";"SC";"CAPINZAL";389;28;31;448
2008;"CAPIVARI DE BAIXO (SC)";"SC";"CAPIVARI DE BAIXO";258;11;24;293
2008;"CATANDUVAS (SC)";"SC";"CATANDUVAS";278;16;31;325
2008;"CAXAMBU DO SUL (SC)";"SC";"CAXAMBU DO SUL";83;3;16;102
2008;"CELSO RAMOS (SC)";"SC";"CELSO RAMOS";45;4;3;52
2008;"CERRO NEGRO (SC)";"SC";"CERRO NEGRO";29;5;13;47
2008;"CHAPADAO DO LAGEADO (SC)";"SC";"CHAPADAO DO LAGEADO";43;4;6;53
2008;"CHAPECO (SC)";"SC";"CHAPECO";3425;183;313;3921
2008;"COCAL DO SUL (SC)";"SC";"COCAL DO SUL";227;13;14;254
2008;"CONCORDIA (SC)";"SC";"CONCORDIA";1821;95;152;2068
2008;"CORDILHEIRA ALTA (SC)";"SC";"CORDILHEIRA ALTA";221;8;2;231
2008;"CORONEL FREITAS (SC)";"SC";"CORONEL FREITAS";232;6;25;263
2008;"CORONEL MARTINS (SC)";"SC";"CORONEL MARTINS";37;7;13;57
2008;"CORREIA PINTO (SC)";"SC";"CORREIA PINTO";297;28;44;369
2008;"CORUPA (SC)";"SC";"CORUPA";322;8;29;359
2008;"CRICIUMA (SC)";"SC";"CRICIUMA";3103;272;363;3738
2008;"CUNHA PORA (SC)";"SC";"CUNHA PORA";290;12;45;347
2008;"CUNHATAI (SC)";"SC";"CUNHATAI";21;3;3;27
2008;"CURITIBANOS (SC)";"SC";"CURITIBANOS";876;37;86;999
2008;"DESCANSO (SC)";"SC";"DESCANSO";198;12;22;232
2008;"DIONISIO CERQUEIRA (SC)";"SC";"DIONISIO CERQUEIRA";122;9;19;150
2008;"DONA EMMA (SC)";"SC";"DONA EMMA";97;7;7;111
2008;"DOUTOR PEDRINHO (SC)";"SC";"DOUTOR PEDRINHO";108;10;8;126
2008;"ENTRE RIOS (SC)";"SC";"ENTRE RIOS";17;3;8;28
2008;"ERMO (SC)";"SC";"ERMO";54;2;5;61
2008;"ERVAL VELHO (SC)";"SC";"ERVAL VELHO";91;6;20;117
2008;"FAXINAL DOS GUEDES (SC)";"SC";"FAXINAL DOS GUEDES";336;15;25;376
2008;"FLOR DO SERTAO (SC)";"SC";"FLOR DO SERTAO";19;4;12;35
2008;"FLORIANOPOLIS (SC)";"SC";"FLORIANOPOLIS";3079;778;1554;5411
2008;"FORMOSA DO SUL (SC)";"SC";"FORMOSA DO SUL";46;3;15;64
2008;"FORQUILHINHA (SC)";"SC";"FORQUILHINHA";459;18;38;515
2008;"FRAIBURGO (SC)";"SC";"FRAIBURGO";743;42;205;990
2008;"FREI ROGERIO (SC)";"SC";"FREI ROGERIO";62;5;8;75
2008;"GALVAO (SC)";"SC";"GALVAO";71;2;10;83
2008;"GAROPABA (SC)";"SC";"GAROPABA";191;16;33;240
2008;"GARUVA (SC)";"SC";"GARUVA";288;21;17;326
2008;"GASPAR (SC)";"SC";"GASPAR";1085;48;75;1208
2008;"GOVERNADOR CELSO RAMOS (SC)";"SC";"GOVERNADOR CELSO RAMOS";135;13;8;156
2008;"GRAO PARA (SC)";"SC";"GRAO PARA";212;8;10;230
2008;"GRAVATAL (SC)";"SC";"GRAVATAL";218;7;14;239
2008;"GUABIRUBA (SC)";"SC";"GUABIRUBA";261;8;12;281
2008;"GUARACIABA (SC)";"SC";"GUARACIABA";183;7;33;223
2008;"GUARAMIRIM (SC)";"SC";"GUARAMIRIM";818;25;20;863
2008;"GUARUJA DO SUL (SC)";"SC";"GUARUJA DO SUL";147;7;15;169
2008;"GUATAMBU (SC)";"SC";"GUATAMBU";68;9;17;94
2008;"HERVAL D OESTE (SC)";"SC";"HERVAL D OESTE";268;29;48;345
2008;"IBIAM (SC)";"SC";"IBIAM";54;1;10;65
2008;"IBICARE (SC)";"SC";"IBICARE";123;8;7;138
2008;"IBIRAMA (SC)";"SC";"IBIRAMA";344;30;62;436
2008;"ICARA (SC)";"SC";"ICARA";1278;55;112;1445
2008;"ILHOTA (SC)";"SC";"ILHOTA";258;20;13;291
2008;"IMARUI (SC)";"SC";"IMARUI";87;12;25;124
2008;"IMBITUBA (SC)";"SC";"IMBITUBA";476;61;60;597
2008;"IMBUIA (SC)";"SC";"IMBUIA";161;6;13;180
2008;"INDAIAL (SC)";"SC";"INDAIAL";1091;53;76;1220
2008;"IOMERE (SC)";"SC";"IOMERE";129;9;7;145
2008;"IPIRA (SC)";"SC";"IPIRA";84;7;11;102
2008;"IPORA DO OESTE (SC)";"SC";"IPORA DO OESTE";212;11;35;258
2008;"IPUACU (SC)";"SC";"IPUACU";79;8;15;102
2008;"IPUMIRIM (SC)";"SC";"IPUMIRIM";199;10;19;228
2008;"IRACEMINHA (SC)";"SC";"IRACEMINHA";84;6;15;105
2008;"IRANI (SC)";"SC";"IRANI";255;20;48;323
2008;"IRATI (SC)";"SC";"IRATI";24;6;9;39
2008;"IRINEOPOLIS (SC)";"SC";"IRINEOPOLIS";195;3;8;206
2008;"ITA (SC)";"SC";"ITA";84;15;26;125
2008;"ITAIOPOLIS (SC)";"SC";"ITAIOPOLIS";480;17;55;552
2008;"ITAJAI (SC)";"SC";"ITAJAI";3604;267;303;4174
2008;"ITAPEMA (SC)";"SC";"ITAPEMA";410;41;39;490
2008;"ITAPIRANGA (SC)";"SC";"ITAPIRANGA";245;19;42;306
2008;"ITAPOA (SC)";"SC";"ITAPOA";124;6;4;134
2008;"ITUPORANGA (SC)";"SC";"ITUPORANGA";556;16;41;613
2008;"JABORA (SC)";"SC";"JABORA";102;9;16;127
2008;"JACINTO MACHADO (SC)";"SC";"JACINTO MACHADO";354;5;28;387
2008;"JAGUARUNA (SC)";"SC";"JAGUARUNA";369;11;32;412
2008;"JARAGUA DO SUL (SC)";"SC";"JARAGUA DO SUL";2073;181;275;2529
2008;"JARDINOPOLIS (SC)";"SC";"JARDINOPOLIS";16;4;5;25
2008;"JOACABA (SC)";"SC";"JOACABA";747;49;29;825
2008;"JOINVILLE (SC)";"SC";"JOINVILLE";7006;561;798;8365
2008;"JOSE BOITEUX (SC)";"SC";"JOSE BOITEUX";94;14;8;116
2008;"JUPIA (SC)";"SC";"JUPIA";35;3;7;45
2008;"LACERDOPOLIS (SC)";"SC";"LACERDOPOLIS";99;8;5;112
2008;"LAGEADO GRANDE (SC)";"SC";"LAGEADO GRANDE";29;1;5;35
2008;"LAGES (SC)";"SC";"LAGES";3226;192;314;3732
2008;"LAGUNA (SC)";"SC";"LAGUNA";478;67;76;621
2008;"LAURENTINO (SC)";"SC";"LAURENTINO";249;4;4;257
2008;"LAURO MULLER (SC)";"SC";"LAURO MULLER";352;14;29;395
2008;"LEBON REGIS (SC)";"SC";"LEBON REGIS";190;8;30;228
2008;"LEOBERTO LEAL (SC)";"SC";"LEOBERTO LEAL";101;8;5;114
2008;"LINDOIA DO SUL (SC)";"SC";"LINDOIA DO SUL";118;11;35;164
2008;"LONTRAS (SC)";"SC";"LONTRAS";254;19;19;292
2008;"LUIZ ALVES (SC)";"SC";"LUIZ ALVES";393;12;17;422
2008;"LUZERNA (SC)";"SC";"LUZERNA";114;10;14;138
2008;"MACIEIRA (SC)";"SC";"MACIEIRA";51;5;9;65
2008;"MAFRA (SC)";"SC";"MAFRA";1108;75;115;1298
2008;"MAJOR GERCINO (SC)";"SC";"MAJOR GERCINO";118;9;9;136
2008;"MAJOR VIEIRA (SC)";"SC";"MAJOR VIEIRA";146;5;7;158
2008;"MARACAJA (SC)";"SC";"MARACAJA";177;1;7;185
2008;"MARAVILHA (SC)";"SC";"MARAVILHA";531;47;52;630
2008;"MAREMA (SC)";"SC";"MAREMA";56;10;9;75
2008;"MASSARANDUBA (SC)";"SC";"MASSARANDUBA";459;11;29;499
2008;"MATOS COSTA (SC)";"SC";"MATOS COSTA";31;5;8;44
2008;"MELEIRO (SC)";"SC";"MELEIRO";209;3;15;227
2008;"MIRIM DOCE (SC)";"SC";"MIRIM DOCE";50;2;6;58
2008;"MODELO (SC)";"SC";"MODELO";87;7;11;105
2008;"MONDAI (SC)";"SC";"MONDAI";171;7;36;214
2008;"MONTE CARLO (SC)";"SC";"MONTE CARLO";157;13;79;249
2008;"MONTE CASTELO (SC)";"SC";"MONTE CASTELO";154;5;12;171
2008;"MORRO DA FUMACA (SC)";"SC";"MORRO DA FUMACA";702;20;31;753
2008;"MORRO GRANDE (SC)";"SC";"MORRO GRANDE";83;0;7;90
2008;"NAVEGANTES (SC)";"SC";"NAVEGANTES";528;51;44;623
2008;"NOVA ERECHIM (SC)";"SC";"NOVA ERECHIM";73;3;9;85
2008;"NOVA ITABERABA (SC)";"SC";"NOVA ITABERABA";66;3;11;80
2008;"NOVA TRENTO (SC)";"SC";"NOVA TRENTO";203;10;30;243
2008;"NOVA VENEZA (SC)";"SC";"NOVA VENEZA";359;31;20;410
2008;"NOVO HORIZONTE (SC)";"SC";"NOVO HORIZONTE";56;6;8;70
2008;"ORLEANS (SC)";"SC";"ORLEANS";766;13;43;822
2008;"OTACILIO COSTA (SC)";"SC";"OTACILIO COSTA";363;28;36;427
2008;"OURO (SC)";"SC";"OURO";203;20;28;251
2008;"OURO VERDE (SC)";"SC";"OURO VERDE";71;2;5;78
2008;"PAIAL (SC)";"SC";"PAIAL";8;3;20;31
2008;"PAINEL (SC)";"SC";"PAINEL";22;3;7;32
2008;"PALHOCA (SC)";"SC";"PALHOCA";1658;107;291;2056
2008;"PALMA SOLA (SC)";"SC";"PALMA SOLA";163;4;20;187
2008;"PALMEIRA (SC)";"SC";"PALMEIRA";68;6;3;77
2008;"PALMITOS (SC)";"SC";"PALMITOS";308;23;47;378
2008;"PAPANDUVA (SC)";"SC";"PAPANDUVA";465;19;56;540
2008;"PARAISO (SC)";"SC";"PARAISO";47;3;9;59
2008;"PASSO DE TORRES (SC)";"SC";"PASSO DE TORRES";95;6;14;115
2008;"PASSOS MAIA (SC)";"SC";"PASSOS MAIA";93;1;23;117
2008;"PAULO LOPES (SC)";"SC";"PAULO LOPES";219;9;11;239
2008;"PEDRAS GRANDES (SC)";"SC";"PEDRAS GRANDES";223;9;10;242
2008;"PENHA (SC)";"SC";"PENHA";304;16;34;354
2008;"PERITIBA (SC)";"SC";"PERITIBA";77;4;9;90
2008;"PETROLANDIA (SC)";"SC";"PETROLANDIA";135;7;20;162
2008;"PICARRAS (SC)";"SC";"PICARRAS";242;20;15;277
2008;"PINHALZINHO (SC)";"SC";"PINHALZINHO";352;11;39;402
2008;"PINHEIRO PRETO (SC)";"SC";"PINHEIRO PRETO";231;4;8;243
2008;"PIRATUBA (SC)";"SC";"PIRATUBA";76;8;25;109
2008;"PLANALTO ALEGRE (SC)";"SC";"PLANALTO ALEGRE";45;4;5;54
2008;"POMERODE (SC)";"SC";"POMERODE";509;24;93;626
2008;"PONTE ALTA (SC)";"SC";"PONTE ALTA";104;3;11;118
2008;"PONTE ALTA DO NORTE (SC)";"SC";"PONTE ALTA DO NORTE";59;4;14;77
2008;"PONTE SERRADA (SC)";"SC";"PONTE SERRADA";275;20;51;346
2008;"PORTO BELO (SC)";"SC";"PORTO BELO";176;19;17;212
2008;"PORTO UNIAO (SC)";"SC";"PORTO UNIAO";511;16;30;557
2008;"POUSO REDONDO (SC)";"SC";"POUSO REDONDO";360;14;29;403
2008;"PRAIA GRANDE (SC)";"SC";"PRAIA GRANDE";174;10;17;201
2008;"PRESIDENTE CASTELO BRANCO (SC)";"SC";"PRESIDENTE CASTELO BRANCO";31;4;7;42
2008;"PRESIDENTE GETULIO (SC)";"SC";"PRESIDENTE GETULIO";265;25;64;354
2008;"PRESIDENTE NEREU (SC)";"SC";"PRESIDENTE NEREU";21;7;5;33
2008;"PRINCESA (SC)";"SC";"PRINCESA";35;1;10;46
2008;"QUILOMBO (SC)";"SC";"QUILOMBO";173;9;27;209
2008;"RANCHO QUEIMADO (SC)";"SC";"RANCHO QUEIMADO";100;3;4;107
2008;"RIO DAS ANTAS (SC)";"SC";"RIO DAS ANTAS";167;6;22;195
2008;"RIO DO CAMPO (SC)";"SC";"RIO DO CAMPO";141;12;15;168
2008;"RIO DO OESTE (SC)";"SC";"RIO DO OESTE";152;12;16;180
2008;"RIO DO SUL (SC)";"SC";"RIO DO SUL";1241;67;106;1414
2008;"RIO DOS CEDROS (SC)";"SC";"RIO DOS CEDROS";204;17;24;245
2008;"RIO FORTUNA (SC)";"SC";"RIO FORTUNA";224;9;14;247
2008;"RIO NEGRINHO (SC)";"SC";"RIO NEGRINHO";841;49;69;959
2008;"RIO RUFINO (SC)";"SC";"RIO RUFINO";36;4;14;54
2008;"RIQUEZA (SC)";"SC";"RIQUEZA";90;3;19;112
2008;"RODEIO (SC)";"SC";"RODEIO";187;8;12;207
2008;"ROMELANDIA (SC)";"SC";"ROMELANDIA";83;4;18;105
2008;"SALETE (SC)";"SC";"SALETE";144;12;15;171
2008;"SALTINHO (SC)";"SC";"SALTINHO";38;2;20;60
2008;"SALTO VELOSO (SC)";"SC";"SALTO VELOSO";124;6;5;135
2008;"SANGAO (SC)";"SC";"SANGAO";357;7;12;376
2008;"SANTA CECILIA (SC)";"SC";"SANTA CECILIA";315;25;43;383
2008;"SANTA HELENA (SC)";"SC";"SANTA HELENA";48;10;7;65
2008;"SANTA ROSA DE LIMA (SC)";"SC";"SANTA ROSA DE LIMA";87;5;6;98
2008;"SANTA ROSA DO SUL (SC)";"SC";"SANTA ROSA DO SUL";240;8;14;262
2008;"SANTA TEREZINHA (SC)";"SC";"SANTA TEREZINHA";139;10;21;170
2008;"SANTA TEREZINHA DO PROGRESSO (SC)";"SC";"SANTA TEREZINHA DO PROGRESSO";40;2;11;53
2008;"SANTIAGO DO SUL (SC)";"SC";"SANTIAGO DO SUL";35;5;4;44
2008;"SANTO AMARO DA IMPERATRIZ (SC)";"SC";"SANTO AMARO DA IMPERATRIZ";512;21;65;598
2008;"SAO BENTO DO SUL (SC)";"SC";"SAO BENTO DO SUL";1259;103;125;1487
2008;"SAO BERNARDINO (SC)";"SC";"SAO BERNARDINO";36;1;17;54
2008;"SAO BONIFACIO (SC)";"SC";"SAO BONIFACIO";110;4;9;123
2008;"SAO CARLOS (SC)";"SC";"SAO CARLOS";180;16;36;232
2008;"SAO CRISTOVAO DO SUL (SC)";"SC";"SAO CRISTOVAO DO SUL";151;5;12;168
2008;"SAO DOMINGOS (SC)";"SC";"SAO DOMINGOS";239;9;37;285
2008;"SAO FRANCISCO DO SUL (SC)";"SC";"SAO FRANCISCO DO SUL";517;44;64;625
2008;"SAO JOAO BATISTA (SC)";"SC";"SAO JOAO BATISTA";481;13;38;532
2008;"SAO JOAO DO ITAPERIU (SC)";"SC";"SAO JOAO DO ITAPERIU";166;2;5;173
2008;"SAO JOAO DO OESTE (SC)";"SC";"SAO JOAO DO OESTE";129;8;11;148
2008;"SAO JOAO DO SUL (SC)";"SC";"SAO JOAO DO SUL";173;3;10;186
2008;"SAO JOAQUIM (SC)";"SC";"SAO JOAQUIM";682;45;151;878
2008;"SAO JOSE (SC)";"SC";"SAO JOSE";3051;228;212;3491
2008;"SAO JOSE DO CEDRO (SC)";"SC";"SAO JOSE DO CEDRO";339;14;80;433
2008;"SAO JOSE DO CERRITO (SC)";"SC";"SAO JOSE DO CERRITO";137;4;29;170
2008;"SAO LOURENCO D OESTE (SC)";"SC";"SAO LOURENCO D OESTE";692;32;49;773
2008;"SAO LUDGERO (SC)";"SC";"SAO LUDGERO";470;8;18;496
2008;"SAO MARTINHO (SC)";"SC";"SAO MARTINHO";115;8;3;126
2008;"SAO MIGUEL D OESTE (SC)";"SC";"SAO MIGUEL D OESTE";886;31;91;1008
2008;"SAO MIGUEL DA BOA VISTA (SC)";"SC";"SAO MIGUEL DA BOA VISTA";18;3;9;30
2008;"SAO PEDRO DE ALCANTARA (SC)";"SC";"SAO PEDRO DE ALCANTARA";113;5;3;121
2008;"SAUDADES (SC)";"SC";"SAUDADES";143;8;32;183
2008;"SCHROEDER (SC)";"SC";"SCHROEDER";163;3;17;183
2008;"SEARA (SC)";"SC";"SEARA";352;37;64;453
2008;"SERRA ALTA (SC)";"SC";"SERRA ALTA";47;9;15;71
2008;"SIDEROPOLIS (SC)";"SC";"SIDEROPOLIS";364;20;58;442
2008;"SOMBRIO (SC)";"SC";"SOMBRIO";631;51;31;713
2008;"SUL BRASIL (SC)";"SC";"SUL BRASIL";32;5;8;45
2008;"TAIO (SC)";"SC";"TAIO";474;14;36;524
2008;"TANGARA (SC)";"SC";"TANGARA";358;6;31;395
2008;"TIGRINHOS (SC)";"SC";"TIGRINHOS";21;3;13;37
2008;"TIJUCAS (SC)";"SC";"TIJUCAS";729;34;43;806
2008;"TIMBE DO SUL (SC)";"SC";"TIMBE DO SUL";139;7;10;156
2008;"TIMBO (SC)";"SC";"TIMBO";543;38;52;633
2008;"TIMBO GRANDE (SC)";"SC";"TIMBO GRANDE";123;3;15;141
2008;"TRES BARRAS (SC)";"SC";"TRES BARRAS";231;20;42;293
2008;"TREVISO (SC)";"SC";"TREVISO";87;7;5;99
2008;"TREZE DE MAIO (SC)";"SC";"TREZE DE MAIO";360;8;13;381
2008;"TREZE TILIAS (SC)";"SC";"TREZE TILIAS";212;11;16;239
2008;"TROMBUDO CENTRAL (SC)";"SC";"TROMBUDO CENTRAL";200;13;10;223
2008;"TUBARAO (SC)";"SC";"TUBARAO";2049;68;361;2478
2008;"TUNAPOLIS (SC)";"SC";"TUNAPOLIS";75;8;26;109
2008;"TURVO (SC)";"SC";"TURVO";335;12;24;371
2008;"UNIAO DO OESTE (SC)";"SC";"UNIAO DO OESTE";45;2;12;59
2008;"URUBICI (SC)";"SC";"URUBICI";191;9;35;235
2008;"URUPEMA (SC)";"SC";"URUPEMA";47;5;6;58
2008;"URUSSANGA (SC)";"SC";"URUSSANGA";378;27;77;482
2008;"VARGEAO (SC)";"SC";"VARGEAO";100;1;10;111
2008;"VARGEM (SC)";"SC";"VARGEM";47;2;10;59
2008;"VARGEM BONITA (SC)";"SC";"VARGEM BONITA";138;10;26;174
2008;"VIDAL RAMOS (SC)";"SC";"VIDAL RAMOS";113;9;12;134
2008;"VIDEIRA (SC)";"SC";"VIDEIRA";1381;88;107;1576
2008;"VITOR MEIRELES (SC)";"SC";"VITOR MEIRELES";72;9;12;93
2008;"WITMARSUM (SC)";"SC";"WITMARSUM";86;10;6;102
2008;"XANXERE (SC)";"SC";"XANXERE";1100;88;106;1294
2008;"XAVANTINA (SC)";"SC";"XAVANTINA";144;14;4;162
2008;"XAXIM (SC)";"SC";"XAXIM";586;35;100;721
2008;"ZORTEA (SC)";"SC";"ZORTEA";36;4;3;43
2008;"AMPARO DE SAO FRANCISCO (SE)";"SE";"AMPARO DE SAO FRANCISCO";4;5;3;12
2008;"AQUIDABA (SE)";"SE";"AQUIDABA";107;10;37;154
2008;"ARACAJU (SE)";"SE";"ARACAJU";4606;789;1610;7005
2008;"ARAUA (SE)";"SE";"ARAUA";44;16;15;75
2008;"AREIA BRANCA (SE)";"SE";"AREIA BRANCA";117;7;17;141
2008;"BARRA DOS COQUEIROS (SE)";"SE";"BARRA DOS COQUEIROS";32;7;25;64
2008;"BOQUIM (SE)";"SE";"BOQUIM";168;12;21;201
2008;"BREJO GRANDE (SE)";"SE";"BREJO GRANDE";4;5;7;16
2008;"CAMPO DO BRITO (SE)";"SE";"CAMPO DO BRITO";263;20;55;338
2008;"CANHOBA (SE)";"SE";"CANHOBA";6;3;2;11
2008;"CANINDE DE SAO FRANCISCO (SE)";"SE";"CANINDE DE SAO FRANCISCO";110;20;19;149
2008;"CAPELA (SE)";"SE";"CAPELA";62;13;32;107
2008;"CARIRA (SE)";"SE";"CARIRA";181;39;53;273
2008;"CARMOPOLIS (SE)";"SE";"CARMOPOLIS";100;40;31;171
2008;"CEDRO DE SAO JOAO (SE)";"SE";"CEDRO DE SAO JOAO";18;4;3;25
2008;"CRISTINAPOLIS (SE)";"SE";"CRISTINAPOLIS";45;18;26;89
2008;"CUMBE (SE)";"SE";"CUMBE";17;6;3;26
2008;"DIVINA PASTORA (SE)";"SE";"DIVINA PASTORA";8;5;3;16
2008;"ESTANCIA (SE)";"SE";"ESTANCIA";340;133;117;590
2008;"FEIRA NOVA (SE)";"SE";"FEIRA NOVA";11;7;3;21
2008;"FREI PAULO (SE)";"SE";"FREI PAULO";79;23;30;132
2008;"GARARU (SE)";"SE";"GARARU";22;3;18;43
2008;"GENERAL MAYNARD (SE)";"SE";"GENERAL MAYNARD";9;15;17;41
2008;"GRACCHO CARDOSO (SE)";"SE";"GRACCHO CARDOSO";15;4;6;25
2008;"ILHA DAS FLORES (SE)";"SE";"ILHA DAS FLORES";9;6;4;19
2008;"INDIAROBA (SE)";"SE";"INDIAROBA";28;16;13;57
2008;"ITABAIANA (SE)";"SE";"ITABAIANA";2357;97;95;2549
2008;"ITABAIANINHA (SE)";"SE";"ITABAIANINHA";372;44;33;449
2008;"ITABI (SE)";"SE";"ITABI";16;4;8;28
2008;"ITAPORANGA D AJUDA (SE)";"SE";"ITAPORANGA D AJUDA";159;22;33;214
2008;"JAPARATUBA (SE)";"SE";"JAPARATUBA";36;18;33;87
2008;"JAPOATA (SE)";"SE";"JAPOATA";37;6;22;65
2008;"LAGARTO (SE)";"SE";"LAGARTO";754;126;137;1017
2008;"LARANJEIRAS (SE)";"SE";"LARANJEIRAS";83;21;29;133
2008;"MACAMBIRA (SE)";"SE";"MACAMBIRA";31;12;8;51
2008;"MALHADA DOS BOIS (SE)";"SE";"MALHADA DOS BOIS";14;7;3;24
2008;"MALHADOR (SE)";"SE";"MALHADOR";135;20;33;188
2008;"MARUIM (SE)";"SE";"MARUIM";32;11;19;62
2008;"MOITA BONITA (SE)";"SE";"MOITA BONITA";310;24;10;344
2008;"MONTE ALEGRE DE SERGIPE (SE)";"SE";"MONTE ALEGRE DE SERGIPE";84;17;18;119
2008;"MURIBECA (SE)";"SE";"MURIBECA";18;11;19;48
2008;"NEOPOLIS (SE)";"SE";"NEOPOLIS";34;10;13;57
2008;"NOSSA SENHORA APARECIDA (SE)";"SE";"NOSSA SENHORA APARECIDA";109;14;8;131
2008;"NOSSA SENHORA DA GLORIA (SE)";"SE";"NOSSA SENHORA DA GLORIA";320;20;63;403
2008;"NOSSA SENHORA DAS DORES (SE)";"SE";"NOSSA SENHORA DAS DORES";131;15;47;193
2008;"NOSSA SENHORA DE LOURDES (SE)";"SE";"NOSSA SENHORA DE LOURDES";17;3;6;26
2008;"NOSSA SENHORA DO SOCORRO (SE)";"SE";"NOSSA SENHORA DO SOCORRO";592;48;105;745
2008;"PACATUBA (SE)";"SE";"PACATUBA";25;5;23;53
2008;"PEDRA MOLE (SE)";"SE";"PEDRA MOLE";8;1;3;12
2008;"PEDRINHAS (SE)";"SE";"PEDRINHAS";47;4;8;59
2008;"PINHAO (SE)";"SE";"PINHAO";23;15;1;39
2008;"PIRAMBU (SE)";"SE";"PIRAMBU";12;4;13;29
2008;"POCO REDONDO (SE)";"SE";"POCO REDONDO";78;18;28;124
2008;"POCO VERDE (SE)";"SE";"POCO VERDE";65;21;65;151
2008;"PORTO DA FOLHA (SE)";"SE";"PORTO DA FOLHA";66;21;25;112
2008;"PROPRIA (SE)";"SE";"PROPRIA";168;30;48;246
2008;"RIACHAO DO DANTAS (SE)";"SE";"RIACHAO DO DANTAS";20;7;12;39
2008;"RIACHUELO (SE)";"SE";"RIACHUELO";27;6;12;45
2008;"RIBEIROPOLIS (SE)";"SE";"RIBEIROPOLIS";231;42;41;314
2008;"ROSARIO DO CATETE (SE)";"SE";"ROSARIO DO CATETE";26;21;11;58
2008;"SALGADO (SE)";"SE";"SALGADO";80;15;55;150
2008;"SANTA LUZIA DO ITANHY (SE)";"SE";"SANTA LUZIA DO ITANHY";16;5;7;28
2008;"SANTA ROSA DE LIMA (SE)";"SE";"SANTA ROSA DE LIMA";15;5;5;25
2008;"SANTANA DO SAO FRANCISCO (SE)";"SE";"SANTANA DO SAO FRANCISCO";8;4;7;19
2008;"SANTO AMARO DAS BROTAS (SE)";"SE";"SANTO AMARO DAS BROTAS";13;5;9;27
2008;"SAO CRISTOVAO (SE)";"SE";"SAO CRISTOVAO";260;55;88;403
2008;"SAO DOMINGOS (SE)";"SE";"SAO DOMINGOS";111;13;11;135
2008;"SAO FRANCISCO (SE)";"SE";"SAO FRANCISCO";13;4;17;34
2008;"SAO MIGUEL DO ALEIXO (SE)";"SE";"SAO MIGUEL DO ALEIXO";34;5;10;49
2008;"SIMAO DIAS (SE)";"SE";"SIMAO DIAS";177;42;148;367
2008;"SIRIRI (SE)";"SE";"SIRIRI";28;9;19;56
2008;"TELHA (SE)";"SE";"TELHA";7;2;3;12
2008;"TOBIAS BARRETO (SE)";"SE";"TOBIAS BARRETO";182;51;108;341
2008;"TOMAR DO GERU (SE)";"SE";"TOMAR DO GERU";35;7;11;53
2008;"UMBAUBA (SE)";"SE";"UMBAUBA";216;32;22;270
2008;"ADAMANTINA (SP)";"SP";"ADAMANTINA";653;47;66;766
2008;"ADOLFO (SP)";"SP";"ADOLFO";64;3;20;87
2008;"AGUAI (SP)";"SP";"AGUAI";712;60;106;878
2008;"AGUAS DA PRATA (SP)";"SP";"AGUAS DA PRATA";115;12;7;134
2008;"AGUAS DE LINDOIA (SP)";"SP";"AGUAS DE LINDOIA";135;42;33;210
2008;"AGUAS DE SANTA BARBARA (SP)";"SP";"AGUAS DE SANTA BARBARA";94;11;14;119
2008;"AGUAS DE SAO PEDRO (SP)";"SP";"AGUAS DE SAO PEDRO";23;7;3;33
2008;"AGUDOS (SP)";"SP";"AGUDOS";473;54;72;599
2008;"ALAMBARI (SP)";"SP";"ALAMBARI";69;8;4;81
2008;"ALFREDO MARCONDES (SP)";"SP";"ALFREDO MARCONDES";52;7;8;67
2008;"ALTAIR (SP)";"SP";"ALTAIR";61;6;28;95
2008;"ALTINOPOLIS (SP)";"SP";"ALTINOPOLIS";311;24;81;416
2008;"ALTO ALEGRE (SP)";"SP";"ALTO ALEGRE";72;3;34;109
2008;"ALUMINIO (SP)";"SP";"ALUMINIO";195;28;38;261
2008;"ALVARES FLORENCE (SP)";"SP";"ALVARES FLORENCE";55;4;14;73
2008;"ALVARES MACHADO (SP)";"SP";"ALVARES MACHADO";366;9;28;403
2008;"ALVARO DE CARVALHO (SP)";"SP";"ALVARO DE CARVALHO";18;3;18;39
2008;"ALVINLANDIA (SP)";"SP";"ALVINLANDIA";32;3;12;47
2008;"AMERICANA (SP)";"SP";"AMERICANA";2959;363;727;4049
2008;"AMERICO BRASILIENSE (SP)";"SP";"AMERICO BRASILIENSE";584;42;219;845
2008;"AMERICO DE CAMPOS (SP)";"SP";"AMERICO DE CAMPOS";139;6;24;169
2008;"AMPARO (SP)";"SP";"AMPARO";1182;178;118;1478
2008;"ANALANDIA (SP)";"SP";"ANALANDIA";57;10;11;78
2008;"ANDRADINA (SP)";"SP";"ANDRADINA";904;37;105;1046
2008;"ANGATUBA (SP)";"SP";"ANGATUBA";341;34;67;442
2008;"ANHEMBI (SP)";"SP";"ANHEMBI";65;19;8;92
2008;"ANHUMAS (SP)";"SP";"ANHUMAS";63;6;6;75
2008;"APARECIDA (SP)";"SP";"APARECIDA";807;45;576;1428
2008;"APARECIDA D OESTE (SP)";"SP";"APARECIDA D OESTE";93;7;20;120
2008;"APIAI (SP)";"SP";"APIAI";248;31;59;338
2008;"ARACARIGUAMA (SP)";"SP";"ARACARIGUAMA";402;38;37;477
2008;"ARACATUBA (SP)";"SP";"ARACATUBA";2925;197;572;3694
2008;"ARACOIABA DA SERRA (SP)";"SP";"ARACOIABA DA SERRA";369;46;14;429
2008;"ARAMINA (SP)";"SP";"ARAMINA";63;5;17;85
2008;"ARANDU (SP)";"SP";"ARANDU";47;8;15;70
2008;"ARAPEI (SP)";"SP";"ARAPEI";39;7;9;55
2008;"ARARAQUARA (SP)";"SP";"ARARAQUARA";2900;327;799;4026
2008;"ARARAS (SP)";"SP";"ARARAS";1958;178;206;2342
2008;"ARCO IRIS (SP)";"SP";"ARCO IRIS";46;5;9;60
2008;"AREALVA (SP)";"SP";"AREALVA";148;7;17;172
2008;"AREIAS (SP)";"SP";"AREIAS";41;5;4;50
2008;"AREIOPOLIS (SP)";"SP";"AREIOPOLIS";102;11;51;164
2008;"ARIRANHA (SP)";"SP";"ARIRANHA";249;21;96;366
2008;"ARTUR NOGUEIRA (SP)";"SP";"ARTUR NOGUEIRA";835;87;126;1048
2008;"ARUJA (SP)";"SP";"ARUJA";1872;171;296;2339
2008;"ASPASIA (SP)";"SP";"ASPASIA";24;3;4;31
2008;"ASSIS (SP)";"SP";"ASSIS";1407;126;327;1860
2008;"ATIBAIA (SP)";"SP";"ATIBAIA";1795;233;257;2285
2008;"AURIFLAMA (SP)";"SP";"AURIFLAMA";287;14;32;333
2008;"AVAI (SP)";"SP";"AVAI";54;6;16;76
2008;"AVANHANDAVA (SP)";"SP";"AVANHANDAVA";120;9;31;160
2008;"AVARE (SP)";"SP";"AVARE";1070;95;234;1399
2008;"BADY BASSITT (SP)";"SP";"BADY BASSITT";302;20;53;375
2008;"BALBINOS (SP)";"SP";"BALBINOS";12;1;5;18
2008;"BALSAMO (SP)";"SP";"BALSAMO";141;4;14;159
2008;"BANANAL (SP)";"SP";"BANANAL";104;14;23;141
2008;"BARAO DE ANTONINA (SP)";"SP";"BARAO DE ANTONINA";24;2;11;37
2008;"BARBOSA (SP)";"SP";"BARBOSA";87;4;20;111
2008;"BARIRI (SP)";"SP";"BARIRI";726;33;82;841
2008;"BARRA BONITA (SP)";"SP";"BARRA BONITA";1086;62;190;1338
2008;"BARRA DO CHAPEU (SP)";"SP";"BARRA DO CHAPEU";26;3;7;36
2008;"BARRA DO TURVO (SP)";"SP";"BARRA DO TURVO";48;5;35;88
2008;"BARRETOS (SP)";"SP";"BARRETOS";1645;131;409;2185
2008;"BARRINHA (SP)";"SP";"BARRINHA";382;29;142;553
2008;"BARUERI (SP)";"SP";"BARUERI";4213;551;857;5621
2008;"BASTOS (SP)";"SP";"BASTOS";613;17;58;688
2008;"BATATAIS (SP)";"SP";"BATATAIS";962;61;132;1155
2008;"BAURU (SP)";"SP";"BAURU";4437;413;981;5831
2008;"BEBEDOURO (SP)";"SP";"BEBEDOURO";1439;105;212;1756
2008;"BENTO DE ABREU (SP)";"SP";"BENTO DE ABREU";82;5;13;100
2008;"BERNARDINO DE CAMPOS (SP)";"SP";"BERNARDINO DE CAMPOS";276;14;30;320
2008;"BERTIOGA (SP)";"SP";"BERTIOGA";381;44;59;484
2008;"BILAC (SP)";"SP";"BILAC";127;10;22;159
2008;"BIRIGUI (SP)";"SP";"BIRIGUI";1422;52;104;1578
2008;"BIRITIBA MIRIM (SP)";"SP";"BIRITIBA MIRIM";261;16;20;297
2008;"BOA ESPERANCA DO SUL (SP)";"SP";"BOA ESPERANCA DO SUL";347;22;81;450
2008;"BOCAINA (SP)";"SP";"BOCAINA";204;23;33;260
2008;"BOFETE (SP)";"SP";"BOFETE";138;13;41;192
2008;"BOITUVA (SP)";"SP";"BOITUVA";882;63;84;1029
2008;"BOM JESUS DOS PERDOES (SP)";"SP";"BOM JESUS DOS PERDOES";315;40;20;375
2008;"BOM SUCESSO DE ITARARE (SP)";"SP";"BOM SUCESSO DE ITARARE";51;7;8;66
2008;"BORA (SP)";"SP";"BORA";27;1;4;32
2008;"BORACEIA (SP)";"SP";"BORACEIA";211;3;18;232
2008;"BORBOREMA (SP)";"SP";"BORBOREMA";263;10;66;339
2008;"BOREBI (SP)";"SP";"BOREBI";40;8;6;54
2008;"BOTUCATU (SP)";"SP";"BOTUCATU";1359;198;387;1944
2008;"BRAGANCA PAULISTA (SP)";"SP";"BRAGANCA PAULISTA";2171;214;218;2603
2008;"BRAUNA (SP)";"SP";"BRAUNA";69;1;52;122
2008;"BREJO ALEGRE (SP)";"SP";"BREJO ALEGRE";163;2;20;185
2008;"BRODOSQUI (SP)";"SP";"BRODOSQUI";452;17;30;499
2008;"BROTAS (SP)";"SP";"BROTAS";422;35;121;578
2008;"BURI (SP)";"SP";"BURI";325;19;39;383
2008;"BURITAMA (SP)";"SP";"BURITAMA";270;21;45;336
2008;"BURITIZAL (SP)";"SP";"BURITIZAL";95;9;34;138
2008;"CABRALIA PAULISTA (SP)";"SP";"CABRALIA PAULISTA";106;2;7;115
2008;"CABREUVA (SP)";"SP";"CABREUVA";832;76;62;970
2008;"CACAPAVA (SP)";"SP";"CACAPAVA";709;183;100;992
2008;"CACHOEIRA PAULISTA (SP)";"SP";"CACHOEIRA PAULISTA";262;45;14;321
2008;"CACONDE (SP)";"SP";"CACONDE";195;22;61;278
2008;"CAFELANDIA (SP)";"SP";"CAFELANDIA";228;8;53;289
2008;"CAIABU (SP)";"SP";"CAIABU";36;3;34;73
2008;"CAIEIRAS (SP)";"SP";"CAIEIRAS";804;152;329;1285
2008;"CAIUA (SP)";"SP";"CAIUA";56;9;10;75
2008;"CAJAMAR (SP)";"SP";"CAJAMAR";927;90;111;1128
2008;"CAJATI (SP)";"SP";"CAJATI";348;39;56;443
2008;"CAJOBI (SP)";"SP";"CAJOBI";273;5;70;348
2008;"CAJURU (SP)";"SP";"CAJURU";394;16;85;495
2008;"CAMPINA DO MONTE ALEGRE (SP)";"SP";"CAMPINA DO MONTE ALEGRE";63;11;21;95
2008;"CAMPINAS (SP)";"SP";"CAMPINAS";15255;2734;4126;22115
2008;"CAMPO LIMPO PAULISTA (SP)";"SP";"CAMPO LIMPO PAULISTA";471;82;27;580
2008;"CAMPOS DO JORDAO (SP)";"SP";"CAMPOS DO JORDAO";513;133;52;698
2008;"CAMPOS NOVOS PAULISTA (SP)";"SP";"CAMPOS NOVOS PAULISTA";79;4;24;107
2008;"CANANEIA (SP)";"SP";"CANANEIA";59;2;9;70
2008;"CANAS (SP)";"SP";"CANAS";46;4;5;55
2008;"CANDIDO MOTA (SP)";"SP";"CANDIDO MOTA";718;22;54;794
2008;"CANDIDO RODRIGUES (SP)";"SP";"CANDIDO RODRIGUES";99;9;4;112
2008;"CANITAR (SP)";"SP";"CANITAR";47;9;23;79
2008;"CAPAO BONITO (SP)";"SP";"CAPAO BONITO";747;63;125;935
2008;"CAPELA DO ALTO (SP)";"SP";"CAPELA DO ALTO";325;19;28;372
2008;"CAPIVARI (SP)";"SP";"CAPIVARI";1059;65;169;1293
2008;"CARAGUATATUBA (SP)";"SP";"CARAGUATATUBA";1062;122;93;1277
2008;"CARAPICUIBA (SP)";"SP";"CARAPICUIBA";2318;479;787;3584
2008;"CARDOSO (SP)";"SP";"CARDOSO";153;7;37;197
2008;"CASA BRANCA (SP)";"SP";"CASA BRANCA";425;43;73;541
2008;"CASSIA DOS COQUEIROS (SP)";"SP";"CASSIA DOS COQUEIROS";12;3;9;24
2008;"CASTILHO (SP)";"SP";"CASTILHO";194;22;76;292
2008;"CATANDUVA (SP)";"SP";"CATANDUVA";2654;169;414;3237
2008;"CATIGUA (SP)";"SP";"CATIGUA";101;10;28;139
2008;"CEDRAL (SP)";"SP";"CEDRAL";212;12;14;238
2008;"CERQUEIRA CESAR (SP)";"SP";"CERQUEIRA CESAR";251;35;78;364
2008;"CERQUILHO (SP)";"SP";"CERQUILHO";793;79;84;956
2008;"CESARIO LANGE (SP)";"SP";"CESARIO LANGE";271;35;37;343
2008;"CHARQUEADA (SP)";"SP";"CHARQUEADA";382;21;76;479
2008;"CHAVANTES (SP)";"SP";"CHAVANTES";142;10;42;194
2008;"CLEMENTINA (SP)";"SP";"CLEMENTINA";210;7;55;272
2008;"COLINA (SP)";"SP";"COLINA";332;11;66;409
2008;"COLOMBIA (SP)";"SP";"COLOMBIA";114;22;69;205
2008;"CONCHAL (SP)";"SP";"CONCHAL";636;29;186;851
2008;"CONCHAS (SP)";"SP";"CONCHAS";259;23;25;307
2008;"CORDEIROPOLIS (SP)";"SP";"CORDEIROPOLIS";549;51;28;628
2008;"COROADOS (SP)";"SP";"COROADOS";63;5;14;82
2008;"CORONEL MACEDO (SP)";"SP";"CORONEL MACEDO";51;8;24;83
2008;"CORUMBATAI (SP)";"SP";"CORUMBATAI";126;9;8;143
2008;"COSMOPOLIS (SP)";"SP";"COSMOPOLIS";606;182;224;1012
2008;"COSMORAMA (SP)";"SP";"COSMORAMA";124;3;33;160
2008;"COTIA (SP)";"SP";"COTIA";2082;636;332;3050
2008;"CRAVINHOS (SP)";"SP";"CRAVINHOS";785;45;127;957
2008;"CRISTAIS PAULISTA (SP)";"SP";"CRISTAIS PAULISTA";88;3;22;113
2008;"CRUZALIA (SP)";"SP";"CRUZALIA";66;8;4;78
2008;"CRUZEIRO (SP)";"SP";"CRUZEIRO";561;77;37;675
2008;"CUBATAO (SP)";"SP";"CUBATAO";2292;308;377;2977
2008;"CUNHA (SP)";"SP";"CUNHA";221;24;21;266
2008;"DESCALVADO (SP)";"SP";"DESCALVADO";792;54;144;990
2008;"DIADEMA (SP)";"SP";"DIADEMA";3432;570;501;4503
2008;"DIRCE REIS (SP)";"SP";"DIRCE REIS";47;5;6;58
2008;"DIVINOLANDIA (SP)";"SP";"DIVINOLANDIA";381;17;27;425
2008;"DOBRADA (SP)";"SP";"DOBRADA";65;5;60;130
2008;"DOIS CORREGOS (SP)";"SP";"DOIS CORREGOS";582;39;110;731
2008;"DOLCINOPOLIS (SP)";"SP";"DOLCINOPOLIS";21;4;7;32
2008;"DOURADO (SP)";"SP";"DOURADO";159;17;46;222
2008;"DRACENA (SP)";"SP";"DRACENA";918;29;112;1059
2008;"DUARTINA (SP)";"SP";"DUARTINA";233;23;40;296
2008;"DUMONT (SP)";"SP";"DUMONT";270;9;47;326
2008;"ECHAPORA (SP)";"SP";"ECHAPORA";93;2;16;111
2008;"ELDORADO (SP)";"SP";"ELDORADO";168;7;42;217
2008;"ELIAS FAUSTO (SP)";"SP";"ELIAS FAUSTO";279;15;54;348
2008;"ELISIARIO (SP)";"SP";"ELISIARIO";51;4;5;60
2008;"EMBAUBA (SP)";"SP";"EMBAUBA";77;2;26;105
2008;"EMBU (SP)";"SP";"EMBU";1577;389;502;2468
2008;"EMBU GUACU (SP)";"SP";"EMBU GUACU";989;124;147;1260
2008;"EMILIANOPOLIS (SP)";"SP";"EMILIANOPOLIS";49;3;18;70
2008;"ENGENHEIRO COELHO (SP)";"SP";"ENGENHEIRO COELHO";274;24;116;414
2008;"ESPIRITO SANTO DO PINHAL (SP)";"SP";"ESPIRITO SANTO DO PINHAL";552;94;65;711
2008;"ESPIRITO SANTO DO TURVO (SP)";"SP";"ESPIRITO SANTO DO TURVO";132;13;32;177
2008;"ESTIVA GERBI (SP)";"SP";"ESTIVA GERBI";222;9;18;249
2008;"ESTRELA D OESTE (SP)";"SP";"ESTRELA D OESTE";242;6;15;263
2008;"ESTRELA DO NORTE (SP)";"SP";"ESTRELA DO NORTE";22;3;9;34
2008;"EUCLIDES DA CUNHA PAULISTA (SP)";"SP";"EUCLIDES DA CUNHA PAULISTA";77;3;33;113
2008;"FARTURA (SP)";"SP";"FARTURA";200;16;23;239
2008;"FERNANDO PRESTES (SP)";"SP";"FERNANDO PRESTES";205;6;16;227
2008;"FERNANDOPOLIS (SP)";"SP";"FERNANDOPOLIS";1142;48;144;1334
2008;"FERNAO (SP)";"SP";"FERNAO";18;3;6;27
2008;"FERRAZ DE VASCONCELOS (SP)";"SP";"FERRAZ DE VASCONCELOS";992;145;181;1318
2008;"FLORA RICA (SP)";"SP";"FLORA RICA";12;1;7;20
2008;"FLOREAL (SP)";"SP";"FLOREAL";42;10;5;57
2008;"FLORIDA PAULISTA (SP)";"SP";"FLORIDA PAULISTA";302;9;94;405
2008;"FLORINEA (SP)";"SP";"FLORINEA";37;4;6;47
2008;"FRANCA (SP)";"SP";"FRANCA";2612;263;458;3333
2008;"FRANCISCO MORATO (SP)";"SP";"FRANCISCO MORATO";385;125;121;631
2008;"FRANCO DA ROCHA (SP)";"SP";"FRANCO DA ROCHA";502;114;157;773
2008;"GABRIEL MONTEIRO (SP)";"SP";"GABRIEL MONTEIRO";44;2;8;54
2008;"GALIA (SP)";"SP";"GALIA";122;10;30;162
2008;"GARCA (SP)";"SP";"GARCA";638;38;103;779
2008;"GASTAO VIDIGAL (SP)";"SP";"GASTAO VIDIGAL";69;8;41;118
2008;"GAVIAO PEIXOTO (SP)";"SP";"GAVIAO PEIXOTO";47;6;19;72
2008;"GENERAL SALGADO (SP)";"SP";"GENERAL SALGADO";272;12;77;361
2008;"GETULINA (SP)";"SP";"GETULINA";127;4;54;185
2008;"GLICERIO (SP)";"SP";"GLICERIO";100;1;20;121
2008;"GUAICARA (SP)";"SP";"GUAICARA";64;6;19;89
2008;"GUAIMBE (SP)";"SP";"GUAIMBE";102;4;20;126
2008;"GUAIRA (SP)";"SP";"GUAIRA";976;29;134;1139
2008;"GUAPIACU (SP)";"SP";"GUAPIACU";372;19;64;455
2008;"GUAPIARA (SP)";"SP";"GUAPIARA";276;18;39;333
2008;"GUARA (SP)";"SP";"GUARA";193;18;128;339
2008;"GUARACAI (SP)";"SP";"GUARACAI";277;12;26;315
2008;"GUARACI (SP)";"SP";"GUARACI";124;6;54;184
2008;"GUARANI D OESTE (SP)";"SP";"GUARANI D OESTE";24;2;6;32
2008;"GUARANTA (SP)";"SP";"GUARANTA";78;3;36;117
2008;"GUARARAPES (SP)";"SP";"GUARARAPES";638;33;120;791
2008;"GUARAREMA (SP)";"SP";"GUARAREMA";295;47;43;385
2008;"GUARATINGUETA (SP)";"SP";"GUARATINGUETA";918;226;162;1306
2008;"GUAREI (SP)";"SP";"GUAREI";206;19;38;263
2008;"GUARIBA (SP)";"SP";"GUARIBA";783;43;241;1067
2008;"GUARUJA (SP)";"SP";"GUARUJA";1722;380;363;2465
2008;"GUARULHOS (SP)";"SP";"GUARULHOS";15956;3075;2796;21827
2008;"GUATAPARA (SP)";"SP";"GUATAPARA";118;7;38;163
2008;"GUZOLANDIA (SP)";"SP";"GUZOLANDIA";59;5;37;101
2008;"HERCULANDIA (SP)";"SP";"HERCULANDIA";374;3;21;398
2008;"HOLAMBRA (SP)";"SP";"HOLAMBRA";348;23;56;427
2008;"HORTOLANDIA (SP)";"SP";"HORTOLANDIA";1195;233;234;1662
2008;"IACANGA (SP)";"SP";"IACANGA";160;9;26;195
2008;"IACRI (SP)";"SP";"IACRI";121;2;14;137
2008;"IARAS (SP)";"SP";"IARAS";34;18;17;69
2008;"IBATE (SP)";"SP";"IBATE";453;54;220;727
2008;"IBIRA (SP)";"SP";"IBIRA";151;18;60;229
2008;"IBIRAREMA (SP)";"SP";"IBIRAREMA";124;7;29;160
2008;"IBITINGA (SP)";"SP";"IBITINGA";716;51;127;894
2008;"IBIUNA (SP)";"SP";"IBIUNA";1410;99;101;1610
2008;"ICEM (SP)";"SP";"ICEM";156;7;80;243
2008;"IEPE (SP)";"SP";"IEPE";132;5;25;162
2008;"IGARACU DO TIETE (SP)";"SP";"IGARACU DO TIETE";368;15;61;444
2008;"IGARAPAVA (SP)";"SP";"IGARAPAVA";551;36;105;692
2008;"IGARATA (SP)";"SP";"IGARATA";97;8;9;114
2008;"IGUAPE (SP)";"SP";"IGUAPE";177;21;33;231
2008;"ILHA COMPRIDA (SP)";"SP";"ILHA COMPRIDA";97;9;40;146
2008;"ILHA SOLTEIRA (SP)";"SP";"ILHA SOLTEIRA";215;24;69;308
2008;"ILHABELA (SP)";"SP";"ILHABELA";212;40;41;293
2008;"INDAIATUBA (SP)";"SP";"INDAIATUBA";2357;349;225;2931
2008;"INDIANA (SP)";"SP";"INDIANA";108;4;9;121
2008;"INDIAPORA (SP)";"SP";"INDIAPORA";54;6;16;76
2008;"INUBIA PAULISTA (SP)";"SP";"INUBIA PAULISTA";49;3;12;64
2008;"IPAUCU (SP)";"SP";"IPAUCU";148;14;40;202
2008;"IPERO (SP)";"SP";"IPERO";182;14;41;237
2008;"IPEUNA (SP)";"SP";"IPEUNA";117;16;23;156
2008;"IPIGUA (SP)";"SP";"IPIGUA";24;1;7;32
2008;"IPORANGA (SP)";"SP";"IPORANGA";23;4;8;35
2008;"IPUA (SP)";"SP";"IPUA";245;9;75;329
2008;"IRACEMAPOLIS (SP)";"SP";"IRACEMAPOLIS";489;36;76;601
2008;"IRAPUA (SP)";"SP";"IRAPUA";135;3;69;207
2008;"IRAPURU (SP)";"SP";"IRAPURU";106;10;26;142
2008;"ITABERA (SP)";"SP";"ITABERA";192;12;25;229
2008;"ITAI (SP)";"SP";"ITAI";405;29;107;541
2008;"ITAJOBI (SP)";"SP";"ITAJOBI";431;13;42;486
2008;"ITAJU (SP)";"SP";"ITAJU";65;2;16;83
2008;"ITANHAEM (SP)";"SP";"ITANHAEM";590;99;95;784
2008;"ITAOCA (SP)";"SP";"ITAOCA";15;7;6;28
2008;"ITAPECERICA DA SERRA (SP)";"SP";"ITAPECERICA DA SERRA";1596;459;428;2483
2008;"ITAPETININGA (SP)";"SP";"ITAPETININGA";2119;247;276;2642
2008;"ITAPEVA (SP)";"SP";"ITAPEVA";1574;177;303;2054
2008;"ITAPEVI (SP)";"SP";"ITAPEVI";1185;165;105;1455
2008;"ITAPIRA (SP)";"SP";"ITAPIRA";1449;102;186;1737
2008;"ITAPIRAPUA PAULISTA (SP)";"SP";"ITAPIRAPUA PAULISTA";32;12;8;52
2008;"ITAPOLIS (SP)";"SP";"ITAPOLIS";1148;31;160;1339
2008;"ITAPORANGA (SP)";"SP";"ITAPORANGA";183;10;52;245
2008;"ITAPUI (SP)";"SP";"ITAPUI";388;16;67;471
2008;"ITAPURA (SP)";"SP";"ITAPURA";19;3;9;31
2008;"ITAQUAQUECETUBA (SP)";"SP";"ITAQUAQUECETUBA";1591;219;297;2107
2008;"ITARARE (SP)";"SP";"ITARARE";826;50;257;1133
2008;"ITARIRI (SP)";"SP";"ITARIRI";247;15;18;280
2008;"ITATIBA (SP)";"SP";"ITATIBA";2020;143;200;2363
2008;"ITATINGA (SP)";"SP";"ITATINGA";167;23;89;279
2008;"ITIRAPINA (SP)";"SP";"ITIRAPINA";204;14;50;268
2008;"ITIRAPUA (SP)";"SP";"ITIRAPUA";50;5;22;77
2008;"ITOBI (SP)";"SP";"ITOBI";112;10;67;189
2008;"ITU (SP)";"SP";"ITU";2383;241;447;3071
2008;"ITUPEVA (SP)";"SP";"ITUPEVA";763;79;71;913
2008;"ITUVERAVA (SP)";"SP";"ITUVERAVA";625;31;123;779
2008;"JABORANDI (SP)";"SP";"JABORANDI";151;9;42;202
2008;"JABOTICABAL (SP)";"SP";"JABOTICABAL";1520;79;203;1802
2008;"JACAREI (SP)";"SP";"JACAREI";2116;422;310;2848
2008;"JACI (SP)";"SP";"JACI";163;8;11;182
2008;"JACUPIRANGA (SP)";"SP";"JACUPIRANGA";340;25;210;575
2008;"JAGUARIUNA (SP)";"SP";"JAGUARIUNA";956;84;120;1160
2008;"JALES (SP)";"SP";"JALES";1006;28;62;1096
2008;"JAMBEIRO (SP)";"SP";"JAMBEIRO";42;16;7;65
2008;"JANDIRA (SP)";"SP";"JANDIRA";1016;163;121;1300
2008;"JARDINOPOLIS (SP)";"SP";"JARDINOPOLIS";778;60;88;926
2008;"JARINU (SP)";"SP";"JARINU";450;23;35;508
2008;"JAU (SP)";"SP";"JAU";1896;221;282;2399
2008;"JERIQUARA (SP)";"SP";"JERIQUARA";42;3;9;54
2008;"JOANOPOLIS (SP)";"SP";"JOANOPOLIS";259;15;13;287
2008;"JOAO RAMALHO (SP)";"SP";"JOAO RAMALHO";27;4;23;54
2008;"JOSE BONIFACIO (SP)";"SP";"JOSE BONIFACIO";731;32;88;851
2008;"JULIO MESQUITA (SP)";"SP";"JULIO MESQUITA";41;1;19;61
2008;"JUMIRIM (SP)";"SP";"JUMIRIM";81;4;5;90
2008;"JUNDIAI (SP)";"SP";"JUNDIAI";6124;739;959;7822
2008;"JUNQUEIROPOLIS (SP)";"SP";"JUNQUEIROPOLIS";396;16;122;534
2008;"JUQUIA (SP)";"SP";"JUQUIA";350;14;17;381
2008;"JUQUITIBA (SP)";"SP";"JUQUITIBA";456;54;77;587
2008;"LAGOINHA (SP)";"SP";"LAGOINHA";78;8;14;100
2008;"LARANJAL PAULISTA (SP)";"SP";"LARANJAL PAULISTA";540;39;122;701
2008;"LAVINIA (SP)";"SP";"LAVINIA";75;8;10;93
2008;"LAVRINHAS (SP)";"SP";"LAVRINHAS";90;20;10;120
2008;"LEME (SP)";"SP";"LEME";2009;103;411;2523
2008;"LENCOIS PAULISTA (SP)";"SP";"LENCOIS PAULISTA";1177;105;194;1476
2008;"LIMEIRA (SP)";"SP";"LIMEIRA";4167;585;558;5310
2008;"LINDOIA (SP)";"SP";"LINDOIA";105;14;12;131
2008;"LINS (SP)";"SP";"LINS";1377;68;143;1588
2008;"LORENA (SP)";"SP";"LORENA";732;96;26;854
2008;"LOURDES (SP)";"SP";"LOURDES";20;5;10;35
2008;"LOUVEIRA (SP)";"SP";"LOUVEIRA";791;82;40;913
2008;"LUCELIA (SP)";"SP";"LUCELIA";367;27;156;550
2008;"LUCIANOPOLIS (SP)";"SP";"LUCIANOPOLIS";45;5;11;61
2008;"LUIS ANTONIO (SP)";"SP";"LUIS ANTONIO";251;24;121;396
2008;"LUIZIANIA (SP)";"SP";"LUIZIANIA";55;1;21;77
2008;"LUPERCIO (SP)";"SP";"LUPERCIO";61;2;26;89
2008;"LUTECIA (SP)";"SP";"LUTECIA";43;5;9;57
2008;"MACATUBA (SP)";"SP";"MACATUBA";499;19;72;590
2008;"MACAUBAL (SP)";"SP";"MACAUBAL";122;11;19;152
2008;"MACEDONIA (SP)";"SP";"MACEDONIA";38;3;10;51
2008;"MAGDA (SP)";"SP";"MAGDA";81;11;11;103
2008;"MAIRINQUE (SP)";"SP";"MAIRINQUE";435;72;83;590
2008;"MAIRIPORA (SP)";"SP";"MAIRIPORA";954;145;118;1217
2008;"MANDURI (SP)";"SP";"MANDURI";149;18;58;225
2008;"MARABA PAULISTA (SP)";"SP";"MARABA PAULISTA";27;2;11;40
2008;"MARACAI (SP)";"SP";"MARACAI";292;40;45;377
2008;"MARAPOAMA (SP)";"SP";"MARAPOAMA";140;13;14;167
2008;"MARIAPOLIS (SP)";"SP";"MARIAPOLIS";38;1;20;59
2008;"MARILIA (SP)";"SP";"MARILIA";2652;201;382;3235
2008;"MARINOPOLIS (SP)";"SP";"MARINOPOLIS";57;2;5;64
2008;"MARTINOPOLIS (SP)";"SP";"MARTINOPOLIS";355;26;71;452
2008;"MATAO (SP)";"SP";"MATAO";1361;64;237;1662
2008;"MAUA (SP)";"SP";"MAUA";2865;931;803;4599
2008;"MENDONCA (SP)";"SP";"MENDONCA";89;4;17;110
2008;"MERIDIANO (SP)";"SP";"MERIDIANO";77;4;11;92
2008;"MESOPOLIS (SP)";"SP";"MESOPOLIS";19;3;9;31
2008;"MIGUELOPOLIS (SP)";"SP";"MIGUELOPOLIS";284;10;89;383
2008;"MINEIROS DO TIETE (SP)";"SP";"MINEIROS DO TIETE";256;8;34;298
2008;"MIRA ESTRELA (SP)";"SP";"MIRA ESTRELA";32;5;20;57
2008;"MIRACATU (SP)";"SP";"MIRACATU";500;32;23;555
2008;"MIRANDOPOLIS (SP)";"SP";"MIRANDOPOLIS";514;25;154;693
2008;"MIRANTE DO PARANAPANEMA (SP)";"SP";"MIRANTE DO PARANAPANEMA";173;17;75;265
2008;"MIRASSOL (SP)";"SP";"MIRASSOL";947;37;53;1037
2008;"MIRASSOLANDIA (SP)";"SP";"MIRASSOLANDIA";31;10;10;51
2008;"MOCOCA (SP)";"SP";"MOCOCA";900;83;232;1215
2008;"MOGI DAS CRUZES (SP)";"SP";"MOGI DAS CRUZES";4053;588;1023;5664
2008;"MOGI GUACU (SP)";"SP";"MOGI GUACU";1825;308;336;2469
2008;"MOGI MIRIM (SP)";"SP";"MOGI MIRIM";1729;170;429;2328
2008;"MOMBUCA (SP)";"SP";"MOMBUCA";80;5;12;97
2008;"MONCOES (SP)";"SP";"MONCOES";64;8;10;82
2008;"MONGAGUA (SP)";"SP";"MONGAGUA";357;48;42;447
2008;"MONTE ALEGRE DO SUL (SP)";"SP";"MONTE ALEGRE DO SUL";195;25;27;247
2008;"MONTE ALTO (SP)";"SP";"MONTE ALTO";1342;39;101;1482
2008;"MONTE APRAZIVEL (SP)";"SP";"MONTE APRAZIVEL";541;15;122;678
2008;"MONTE AZUL PAULISTA (SP)";"SP";"MONTE AZUL PAULISTA";478;20;115;613
2008;"MONTE CASTELO (SP)";"SP";"MONTE CASTELO";76;4;12;92
2008;"MONTE MOR (SP)";"SP";"MONTE MOR";560;72;144;776
2008;"MONTEIRO LOBATO (SP)";"SP";"MONTEIRO LOBATO";102;18;11;131
2008;"MORRO AGUDO (SP)";"SP";"MORRO AGUDO";656;21;157;834
2008;"MORUNGABA (SP)";"SP";"MORUNGABA";319;45;18;382
2008;"MOTUCA (SP)";"SP";"MOTUCA";147;7;31;185
2008;"MUNICIPIO NAO INFORMADO (SP)";"SP";"MUNICIPIO NAO INFORMADO";0;0;0;0
2008;"MURUTINGA DO SUL (SP)";"SP";"MURUTINGA DO SUL";72;8;9;89
2008;"NANTES (SP)";"SP";"NANTES";19;1;19;39
2008;"NARANDIBA (SP)";"SP";"NARANDIBA";68;3;20;91
2008;"NATIVIDADE DA SERRA (SP)";"SP";"NATIVIDADE DA SERRA";53;19;9;81
2008;"NAZARE PAULISTA (SP)";"SP";"NAZARE PAULISTA";431;9;21;461
2008;"NEVES PAULISTA (SP)";"SP";"NEVES PAULISTA";181;6;28;215
2008;"NHANDEARA (SP)";"SP";"NHANDEARA";179;8;28;215
2008;"NIPOA (SP)";"SP";"NIPOA";109;3;16;128
2008;"NOVA ALIANCA (SP)";"SP";"NOVA ALIANCA";101;11;15;127
2008;"NOVA CAMPINA (SP)";"SP";"NOVA CAMPINA";60;9;11;80
2008;"NOVA CANAA PAULISTA (SP)";"SP";"NOVA CANAA PAULISTA";23;4;6;33
2008;"NOVA CASTILHO (SP)";"SP";"NOVA CASTILHO";11;2;8;21
2008;"NOVA EUROPA (SP)";"SP";"NOVA EUROPA";156;4;90;250
2008;"NOVA GRANADA (SP)";"SP";"NOVA GRANADA";277;18;85;380
2008;"NOVA GUATAPORANGA (SP)";"SP";"NOVA GUATAPORANGA";29;2;15;46
2008;"NOVA INDEPENDENCIA (SP)";"SP";"NOVA INDEPENDENCIA";31;5;9;45
2008;"NOVA LUZITANIA (SP)";"SP";"NOVA LUZITANIA";36;2;23;61
2008;"NOVA ODESSA (SP)";"SP";"NOVA ODESSA";736;102;112;950
2008;"NOVAIS (SP)";"SP";"NOVAIS";103;9;38;150
2008;"NOVO HORIZONTE (SP)";"SP";"NOVO HORIZONTE";971;22;184;1177
2008;"NUPORANGA (SP)";"SP";"NUPORANGA";177;10;41;228
2008;"OCAUCU (SP)";"SP";"OCAUCU";91;3;11;105
2008;"OLEO (SP)";"SP";"OLEO";20;8;6;34
2008;"OLIMPIA (SP)";"SP";"OLIMPIA";920;73;163;1156
2008;"ONDA VERDE (SP)";"SP";"ONDA VERDE";74;6;20;100
2008;"ORIENTE (SP)";"SP";"ORIENTE";62;4;19;85
2008;"ORINDIUVA (SP)";"SP";"ORINDIUVA";144;10;73;227
2008;"ORLANDIA (SP)";"SP";"ORLANDIA";870;40;251;1161
2008;"OSASCO (SP)";"SP";"OSASCO";7419;1304;2253;10976
2008;"OSCAR BRESSANE (SP)";"SP";"OSCAR BRESSANE";39;2;10;51
2008;"OSVALDO CRUZ (SP)";"SP";"OSVALDO CRUZ";514;23;96;633
2008;"OURINHOS (SP)";"SP";"OURINHOS";1857;101;341;2299
2008;"OURO VERDE (SP)";"SP";"OURO VERDE";119;2;47;168
2008;"OUROESTE (SP)";"SP";"OUROESTE";99;11;27;137
2008;"PACAEMBU (SP)";"SP";"PACAEMBU";161;21;42;224
2008;"PALESTINA (SP)";"SP";"PALESTINA";142;7;40;189
2008;"PALMARES PAULISTA (SP)";"SP";"PALMARES PAULISTA";67;6;85;158
2008;"PALMEIRA D OESTE (SP)";"SP";"PALMEIRA D OESTE";210;7;30;247
2008;"PALMITAL (SP)";"SP";"PALMITAL";568;27;58;653
2008;"PANORAMA (SP)";"SP";"PANORAMA";249;6;16;271
2008;"PARAGUACU PAULISTA (SP)";"SP";"PARAGUACU PAULISTA";574;71;85;730
2008;"PARAIBUNA (SP)";"SP";"PARAIBUNA";177;40;34;251
2008;"PARAISO (SP)";"SP";"PARAISO";185;8;54;247
2008;"PARANAPANEMA (SP)";"SP";"PARANAPANEMA";460;20;55;535
2008;"PARANAPUA (SP)";"SP";"PARANAPUA";62;5;9;76
2008;"PARAPUA (SP)";"SP";"PARAPUA";244;3;40;287
2008;"PARDINHO (SP)";"SP";"PARDINHO";117;10;16;143
2008;"PARIQUERA ACU (SP)";"SP";"PARIQUERA ACU";297;13;12;322
2008;"PARISI (SP)";"SP";"PARISI";24;4;9;37
2008;"PATROCINIO PAULISTA (SP)";"SP";"PATROCINIO PAULISTA";185;7;37;229
2008;"PAULICEIA (SP)";"SP";"PAULICEIA";207;7;18;232
2008;"PAULINIA (SP)";"SP";"PAULINIA";1555;128;302;1985
2008;"PAULISTANIA (SP)";"SP";"PAULISTANIA";20;6;6;32
2008;"PAULO DE FARIA (SP)";"SP";"PAULO DE FARIA";100;9;47;156
2008;"PEDERNEIRAS (SP)";"SP";"PEDERNEIRAS";798;62;184;1044
2008;"PEDRA BELA (SP)";"SP";"PEDRA BELA";131;8;12;151
2008;"PEDRANOPOLIS (SP)";"SP";"PEDRANOPOLIS";39;1;16;56
2008;"PEDREGULHO (SP)";"SP";"PEDREGULHO";235;15;86;336
2008;"PEDREIRA (SP)";"SP";"PEDREIRA";603;84;66;753
2008;"PEDRINHAS PAULISTA (SP)";"SP";"PEDRINHAS PAULISTA";129;3;12;144
2008;"PEDRO DE TOLEDO (SP)";"SP";"PEDRO DE TOLEDO";121;15;6;142
2008;"PENAPOLIS (SP)";"SP";"PENAPOLIS";1202;35;238;1475
2008;"PEREIRA BARRETO (SP)";"SP";"PEREIRA BARRETO";351;21;115;487
2008;"PEREIRAS (SP)";"SP";"PEREIRAS";209;12;25;246
2008;"PERUIBE (SP)";"SP";"PERUIBE";481;121;69;671
2008;"PIACATU (SP)";"SP";"PIACATU";75;1;12;88
2008;"PIEDADE (SP)";"SP";"PIEDADE";1110;84;69;1263
2008;"PILAR DO SUL (SP)";"SP";"PILAR DO SUL";611;43;57;711
2008;"PINDAMONHANGABA (SP)";"SP";"PINDAMONHANGABA";1249;208;169;1626
2008;"PINDORAMA (SP)";"SP";"PINDORAMA";229;12;53;294
2008;"PINHALZINHO (SP)";"SP";"PINHALZINHO";311;22;8;341
2008;"PIQUEROBI (SP)";"SP";"PIQUEROBI";28;6;5;39
2008;"PIQUETE (SP)";"SP";"PIQUETE";146;41;19;206
2008;"PIRACAIA (SP)";"SP";"PIRACAIA";401;53;25;479
2008;"PIRACICABA (SP)";"SP";"PIRACICABA";6313;660;1098;8071
2008;"PIRAJU (SP)";"SP";"PIRAJU";361;42;60;463
2008;"PIRAJUI (SP)";"SP";"PIRAJUI";293;14;65;372
2008;"PIRANGI (SP)";"SP";"PIRANGI";359;18;55;432
2008;"PIRAPORA DO BOM JESUS (SP)";"SP";"PIRAPORA DO BOM JESUS";193;16;15;224
2008;"PIRAPOZINHO (SP)";"SP";"PIRAPOZINHO";391;23;36;450
2008;"PIRASSUNUNGA (SP)";"SP";"PIRASSUNUNGA";911;128;217;1256
2008;"PIRATININGA (SP)";"SP";"PIRATININGA";194;16;30;240
2008;"PITANGUEIRAS (SP)";"SP";"PITANGUEIRAS";722;26;224;972
2008;"PLANALTO (SP)";"SP";"PLANALTO";77;7;19;103
2008;"PLATINA (SP)";"SP";"PLATINA";42;7;11;60
2008;"POA (SP)";"SP";"POA";686;107;90;883
2008;"POLONI (SP)";"SP";"POLONI";144;5;35;184
2008;"POMPEIA (SP)";"SP";"POMPEIA";236;12;44;292
2008;"PONGAI (SP)";"SP";"PONGAI";41;4;13;58
2008;"PONTAL (SP)";"SP";"PONTAL";795;26;384;1205
2008;"PONTALINDA (SP)";"SP";"PONTALINDA";34;3;21;58
2008;"PONTES GESTAL (SP)";"SP";"PONTES GESTAL";50;2;19;71
2008;"POPULINA (SP)";"SP";"POPULINA";64;4;18;86
2008;"PORANGABA (SP)";"SP";"PORANGABA";105;10;9;124
2008;"PORTO FELIZ (SP)";"SP";"PORTO FELIZ";1050;61;157;1268
2008;"PORTO FERREIRA (SP)";"SP";"PORTO FERREIRA";911;61;136;1108
2008;"POTIM (SP)";"SP";"POTIM";41;42;14;97
2008;"POTIRENDABA (SP)";"SP";"POTIRENDABA";391;16;54;461
2008;"PRACINHA (SP)";"SP";"PRACINHA";10;1;14;25
2008;"PRADOPOLIS (SP)";"SP";"PRADOPOLIS";342;14;150;506
2008;"PRAIA GRANDE (SP)";"SP";"PRAIA GRANDE";1510;233;185;1928
2008;"PRATANIA (SP)";"SP";"PRATANIA";98;9;25;132
2008;"PRESIDENTE ALVES (SP)";"SP";"PRESIDENTE ALVES";83;5;31;119
2008;"PRESIDENTE BERNARDES (SP)";"SP";"PRESIDENTE BERNARDES";197;16;27;240
2008;"PRESIDENTE EPITACIO (SP)";"SP";"PRESIDENTE EPITACIO";403;36;94;533
2008;"PRESIDENTE PRUDENTE (SP)";"SP";"PRESIDENTE PRUDENTE";3229;253;727;4209
2008;"PRESIDENTE VENCESLAU (SP)";"SP";"PRESIDENTE VENCESLAU";546;32;50;628
2008;"PROMISSAO (SP)";"SP";"PROMISSAO";644;41;161;846
2008;"QUADRA (SP)";"SP";"QUADRA";41;5;19;65
2008;"QUATA (SP)";"SP";"QUATA";186;14;57;257
2008;"QUEIROZ (SP)";"SP";"QUEIROZ";20;2;10;32
2008;"QUELUZ (SP)";"SP";"QUELUZ";104;16;8;128
2008;"QUINTANA (SP)";"SP";"QUINTANA";84;10;15;109
2008;"RAFARD (SP)";"SP";"RAFARD";238;13;22;273
2008;"RANCHARIA (SP)";"SP";"RANCHARIA";501;53;69;623
2008;"REDENCAO DA SERRA (SP)";"SP";"REDENCAO DA SERRA";51;14;17;82
2008;"REGENTE FEIJO (SP)";"SP";"REGENTE FEIJO";328;25;23;376
2008;"REGINOPOLIS (SP)";"SP";"REGINOPOLIS";80;4;18;102
2008;"REGISTRO (SP)";"SP";"REGISTRO";876;64;238;1178
2008;"RESTINGA (SP)";"SP";"RESTINGA";45;4;14;63
2008;"RIBEIRA (SP)";"SP";"RIBEIRA";22;5;6;33
2008;"RIBEIRAO BONITO (SP)";"SP";"RIBEIRAO BONITO";262;22;73;357
2008;"RIBEIRAO BRANCO (SP)";"SP";"RIBEIRAO BRANCO";124;18;28;170
2008;"RIBEIRAO CORRENTE (SP)";"SP";"RIBEIRAO CORRENTE";46;6;25;77
2008;"RIBEIRAO DO SUL (SP)";"SP";"RIBEIRAO DO SUL";99;9;13;121
2008;"RIBEIRAO DOS INDIOS (SP)";"SP";"RIBEIRAO DOS INDIOS";20;2;13;35
2008;"RIBEIRAO GRANDE (SP)";"SP";"RIBEIRAO GRANDE";68;12;14;94
2008;"RIBEIRAO PIRES (SP)";"SP";"RIBEIRAO PIRES";1403;327;319;2049
2008;"RIBEIRAO PRETO (SP)";"SP";"RIBEIRAO PRETO";8010;728;1309;10047
2008;"RIFAINA (SP)";"SP";"RIFAINA";35;2;8;45
2008;"RINCAO (SP)";"SP";"RINCAO";216;8;42;266
2008;"RINOPOLIS (SP)";"SP";"RINOPOLIS";172;6;53;231
2008;"RIO CLARO (SP)";"SP";"RIO CLARO";2730;258;380;3368
2008;"RIO DAS PEDRAS (SP)";"SP";"RIO DAS PEDRAS";625;54;159;838
2008;"RIO GRANDE DA SERRA (SP)";"SP";"RIO GRANDE DA SERRA";204;74;45;323
2008;"RIOLANDIA (SP)";"SP";"RIOLANDIA";88;4;47;139
2008;"RIVERSUL (SP)";"SP";"RIVERSUL";47;8;23;78
2008;"ROSANA (SP)";"SP";"ROSANA";141;8;42;191
2008;"ROSEIRA (SP)";"SP";"ROSEIRA";125;37;15;177
2008;"RUBIACEA (SP)";"SP";"RUBIACEA";34;2;11;47
2008;"RUBINEIA (SP)";"SP";"RUBINEIA";20;4;6;30
2008;"SABINO (SP)";"SP";"SABINO";57;7;8;72
2008;"SAGRES (SP)";"SP";"SAGRES";11;3;6;20
2008;"SALES (SP)";"SP";"SALES";64;4;25;93
2008;"SALES OLIVEIRA (SP)";"SP";"SALES OLIVEIRA";204;8;41;253
2008;"SALESOPOLIS (SP)";"SP";"SALESOPOLIS";515;49;36;600
2008;"SALMOURAO (SP)";"SP";"SALMOURAO";27;1;32;60
2008;"SALTINHO (SP)";"SP";"SALTINHO";294;12;6;312
2008;"SALTO (SP)";"SP";"SALTO";1678;185;179;2042
2008;"SALTO DE PIRAPORA (SP)";"SP";"SALTO DE PIRAPORA";528;34;51;613
2008;"SALTO GRANDE (SP)";"SP";"SALTO GRANDE";126;7;26;159
2008;"SANDOVALINA (SP)";"SP";"SANDOVALINA";24;3;9;36
2008;"SANTA ADELIA (SP)";"SP";"SANTA ADELIA";507;22;73;602
2008;"SANTA ALBERTINA (SP)";"SP";"SANTA ALBERTINA";81;6;21;108
2008;"SANTA BARBARA D OESTE (SP)";"SP";"SANTA BARBARA D OESTE";2146;322;250;2718
2008;"SANTA BRANCA (SP)";"SP";"SANTA BRANCA";101;21;34;156
2008;"SANTA CLARA D OESTE (SP)";"SP";"SANTA CLARA D OESTE";19;1;3;23
2008;"SANTA CRUZ DA CONCEICAO (SP)";"SP";"SANTA CRUZ DA CONCEICAO";118;10;12;140
2008;"SANTA CRUZ DA ESPERANCA (SP)";"SP";"SANTA CRUZ DA ESPERANCA";21;1;5;27
2008;"SANTA CRUZ DAS PALMEIRAS (SP)";"SP";"SANTA CRUZ DAS PALMEIRAS";607;29;199;835
2008;"SANTA CRUZ DO RIO PARDO (SP)";"SP";"SANTA CRUZ DO RIO PARDO";1040;74;66;1180
2008;"SANTA ERNESTINA (SP)";"SP";"SANTA ERNESTINA";89;6;45;140
2008;"SANTA FE DO SUL (SP)";"SP";"SANTA FE DO SUL";574;18;36;628
2008;"SANTA GERTRUDES (SP)";"SP";"SANTA GERTRUDES";468;42;24;534
2008;"SANTA ISABEL (SP)";"SP";"SANTA ISABEL";734;49;87;870
2008;"SANTA LUCIA (SP)";"SP";"SANTA LUCIA";114;16;44;174
2008;"SANTA MARIA DA SERRA (SP)";"SP";"SANTA MARIA DA SERRA";189;20;27;236
2008;"SANTA MERCEDES (SP)";"SP";"SANTA MERCEDES";42;5;8;55
2008;"SANTA RITA D OESTE (SP)";"SP";"SANTA RITA D OESTE";25;1;5;31
2008;"SANTA RITA DO PASSA QUATRO (SP)";"SP";"SANTA RITA DO PASSA QUATRO";519;49;41;609
2008;"SANTA ROSA DE VITERBO (SP)";"SP";"SANTA ROSA DE VITERBO";362;32;77;471
2008;"SANTA SALETE (SP)";"SP";"SANTA SALETE";37;5;7;49
2008;"SANTANA DA PONTE PENSA (SP)";"SP";"SANTANA DA PONTE PENSA";24;3;2;29
2008;"SANTANA DE PARNAIBA (SP)";"SP";"SANTANA DE PARNAIBA";1313;198;100;1611
2008;"SANTO ANASTACIO (SP)";"SP";"SANTO ANASTACIO";414;15;53;482
2008;"SANTO ANDRE (SP)";"SP";"SANTO ANDRE";7766;1517;1690;10973
2008;"SANTO ANTONIO DA ALEGRIA (SP)";"SP";"SANTO ANTONIO DA ALEGRIA";82;5;19;106
2008;"SANTO ANTONIO DE POSSE (SP)";"SP";"SANTO ANTONIO DE POSSE";597;38;97;732
2008;"SANTO ANTONIO DO ARACANGUA (SP)";"SP";"SANTO ANTONIO DO ARACANGUA";186;9;81;276
2008;"SANTO ANTONIO DO JARDIM (SP)";"SP";"SANTO ANTONIO DO JARDIM";185;13;11;209
2008;"SANTO ANTONIO DO PINHAL (SP)";"SP";"SANTO ANTONIO DO PINHAL";90;19;5;114
2008;"SANTO EXPEDITO (SP)";"SP";"SANTO EXPEDITO";24;1;6;31
2008;"SANTOPOLIS DO AGUAPEI (SP)";"SP";"SANTOPOLIS DO AGUAPEI";70;4;29;103
2008;"SANTOS (SP)";"SP";"SANTOS";4749;720;684;6153
2008;"SAO BENTO DO SAPUCAI (SP)";"SP";"SAO BENTO DO SAPUCAI";107;37;9;153
2008;"SAO BERNARDO DO CAMPO (SP)";"SP";"SAO BERNARDO DO CAMPO";10209;1788;2237;14234
2008;"SAO CAETANO DO SUL (SP)";"SP";"SAO CAETANO DO SUL";2612;490;430;3532
2008;"SAO CARLOS (SP)";"SP";"SAO CARLOS";3142;308;362;3812
2008;"SAO FRANCISCO (SP)";"SP";"SAO FRANCISCO";27;4;10;41
2008;"SAO JOAO DA BOA VISTA (SP)";"SP";"SAO JOAO DA BOA VISTA";1596;186;83;1865
2008;"SAO JOAO DAS DUAS PONTES (SP)";"SP";"SAO JOAO DAS DUAS PONTES";16;6;7;29
2008;"SAO JOAO DE IRACEMA (SP)";"SP";"SAO JOAO DE IRACEMA";22;5;11;38
2008;"SAO JOAO DO PAU D ALHO (SP)";"SP";"SAO JOAO DO PAU D ALHO";30;4;6;40
2008;"SAO JOAQUIM DA BARRA (SP)";"SP";"SAO JOAQUIM DA BARRA";754;35;172;961
2008;"SAO JOSE DA BELA VISTA (SP)";"SP";"SAO JOSE DA BELA VISTA";59;9;42;110
2008;"SAO JOSE DO BARREIRO (SP)";"SP";"SAO JOSE DO BARREIRO";28;11;5;44
2008;"SAO JOSE DO RIO PARDO (SP)";"SP";"SAO JOSE DO RIO PARDO";1068;58;117;1243
2008;"SAO JOSE DO RIO PRETO (SP)";"SP";"SAO JOSE DO RIO PRETO";6474;483;1165;8122
2008;"SAO JOSE DOS CAMPOS (SP)";"SP";"SAO JOSE DOS CAMPOS";5627;1405;1399;8431
2008;"SAO LOURENCO DA SERRA (SP)";"SP";"SAO LOURENCO DA SERRA";185;15;16;216
2008;"SAO LUIZ DO PARAITINGA (SP)";"SP";"SAO LUIZ DO PARAITINGA";116;12;24;152
2008;"SAO MANUEL (SP)";"SP";"SAO MANUEL";696;66;153;915
2008;"SAO MIGUEL ARCANJO (SP)";"SP";"SAO MIGUEL ARCANJO";585;57;51;693
2008;"SAO PAULO (SP)";"SP";"SAO PAULO";135222;28672;39280;203174
2008;"SAO PEDRO (SP)";"SP";"SAO PEDRO";498;64;68;630
2008;"SAO PEDRO DO TURVO (SP)";"SP";"SAO PEDRO DO TURVO";140;10;27;177
2008;"SAO ROQUE (SP)";"SP";"SAO ROQUE";816;135;172;1123
2008;"SAO SEBASTIAO (SP)";"SP";"SAO SEBASTIAO";507;61;130;698
2008;"SAO SEBASTIAO DA GRAMA (SP)";"SP";"SAO SEBASTIAO DA GRAMA";217;21;26;264
2008;"SAO SIMAO (SP)";"SP";"SAO SIMAO";294;16;34;344
2008;"SAO VICENTE (SP)";"SP";"SAO VICENTE";1526;607;785;2918
2008;"SARAPUI (SP)";"SP";"SARAPUI";126;6;9;141
2008;"SARUTAIA (SP)";"SP";"SARUTAIA";27;10;18;55
2008;"SEBASTIANOPOLIS DO SUL (SP)";"SP";"SEBASTIANOPOLIS DO SUL";130;3;16;149
2008;"SERRA AZUL (SP)";"SP";"SERRA AZUL";121;12;82;215
2008;"SERRA NEGRA (SP)";"SP";"SERRA NEGRA";361;37;29;427
2008;"SERRANA (SP)";"SP";"SERRANA";547;96;215;858
2008;"SERTAOZINHO (SP)";"SP";"SERTAOZINHO";2359;121;379;2859
2008;"SETE BARRAS (SP)";"SP";"SETE BARRAS";159;5;25;189
2008;"SEVERINIA (SP)";"SP";"SEVERINIA";319;13;151;483
2008;"SILVEIRAS (SP)";"SP";"SILVEIRAS";61;13;6;80
2008;"SOCORRO (SP)";"SP";"SOCORRO";661;87;41;789
2008;"SOROCABA (SP)";"SP";"SOROCABA";6527;990;1165;8682
2008;"SUD MENUCCI (SP)";"SP";"SUD MENUCCI";141;13;51;205
2008;"SUMARE (SP)";"SP";"SUMARE";2073;444;396;2913
2008;"SUZANO (SP)";"SP";"SUZANO";2256;320;360;2936
2008;"SUZANOPOLIS (SP)";"SP";"SUZANOPOLIS";44;7;15;66
2008;"TABAPUA (SP)";"SP";"TABAPUA";150;12;44;206
2008;"TABATINGA (SP)";"SP";"TABATINGA";333;12;112;457
2008;"TABOAO DA SERRA (SP)";"SP";"TABOAO DA SERRA";1839;544;491;2874
2008;"TACIBA (SP)";"SP";"TACIBA";70;2;19;91
2008;"TAGUAI (SP)";"SP";"TAGUAI";131;3;22;156
2008;"TAIACU (SP)";"SP";"TAIACU";130;3;17;150
2008;"TAIUVA (SP)";"SP";"TAIUVA";138;3;22;163
2008;"TAMBAU (SP)";"SP";"TAMBAU";468;30;46;544
2008;"TANABI (SP)";"SP";"TANABI";436;21;83;540
2008;"TAPIRAI (SP)";"SP";"TAPIRAI";150;8;10;168
2008;"TAPIRATIBA (SP)";"SP";"TAPIRATIBA";276;10;50;336
2008;"TAQUARAL (SP)";"SP";"TAQUARAL";49;5;17;71
2008;"TAQUARITINGA (SP)";"SP";"TAQUARITINGA";1389;54;285;1728
2008;"TAQUARITUBA (SP)";"SP";"TAQUARITUBA";549;28;64;641
2008;"TAQUARIVAI (SP)";"SP";"TAQUARIVAI";45;9;10;64
2008;"TARABAI (SP)";"SP";"TARABAI";80;6;27;113
2008;"TARUMA (SP)";"SP";"TARUMA";354;12;229;595
2008;"TATUI (SP)";"SP";"TATUI";1609;97;484;2190
2008;"TAUBATE (SP)";"SP";"TAUBATE";2563;617;727;3907
2008;"TEJUPA (SP)";"SP";"TEJUPA";40;7;6;53
2008;"TEODORO SAMPAIO (SP)";"SP";"TEODORO SAMPAIO";231;11;278;520
2008;"TERRA ROXA (SP)";"SP";"TERRA ROXA";166;9;56;231
2008;"TIETE (SP)";"SP";"TIETE";1081;34;137;1252
2008;"TIMBURI (SP)";"SP";"TIMBURI";24;3;7;34
2008;"TORRE DE PEDRA (SP)";"SP";"TORRE DE PEDRA";41;4;5;50
2008;"TORRINHA (SP)";"SP";"TORRINHA";352;17;34;403
2008;"TRABIJU (SP)";"SP";"TRABIJU";31;7;5;43
2008;"TREMEMBE (SP)";"SP";"TREMEMBE";327;47;11;385
2008;"TRES FRONTEIRAS (SP)";"SP";"TRES FRONTEIRAS";58;5;7;70
2008;"TUIUTI (SP)";"SP";"TUIUTI";76;15;16;107
2008;"TUPA (SP)";"SP";"TUPA";1239;43;185;1467
2008;"TUPI PAULISTA (SP)";"SP";"TUPI PAULISTA";273;9;24;306
2008;"TURIUBA (SP)";"SP";"TURIUBA";18;1;7;26
2008;"TURMALINA (SP)";"SP";"TURMALINA";26;4;10;40
2008;"UBARANA (SP)";"SP";"UBARANA";104;4;25;133
2008;"UBATUBA (SP)";"SP";"UBATUBA";542;68;59;669
2008;"UBIRAJARA (SP)";"SP";"UBIRAJARA";86;8;23;117
2008;"UCHOA (SP)";"SP";"UCHOA";128;7;35;170
2008;"UNIAO PAULISTA (SP)";"SP";"UNIAO PAULISTA";37;2;7;46
2008;"URANIA (SP)";"SP";"URANIA";127;12;28;167
2008;"URU (SP)";"SP";"URU";11;7;8;26
2008;"URUPES (SP)";"SP";"URUPES";323;14;42;379
2008;"VALENTIM GENTIL (SP)";"SP";"VALENTIM GENTIL";181;15;27;223
2008;"VALINHOS (SP)";"SP";"VALINHOS";1821;389;1210;3420
2008;"VALPARAISO (SP)";"SP";"VALPARAISO";377;22;146;545
2008;"VARGEM (SP)";"SP";"VARGEM";207;11;13;231
2008;"VARGEM GRANDE DO SUL (SP)";"SP";"VARGEM GRANDE DO SUL";968;61;163;1192
2008;"VARGEM GRANDE PAULISTA (SP)";"SP";"VARGEM GRANDE PAULISTA";717;68;51;836
2008;"VARZEA PAULISTA (SP)";"SP";"VARZEA PAULISTA";844;258;172;1274
2008;"VERA CRUZ (SP)";"SP";"VERA CRUZ";128;18;24;170
2008;"VINHEDO (SP)";"SP";"VINHEDO";1113;118;91;1322
2008;"VIRADOURO (SP)";"SP";"VIRADOURO";348;13;72;433
2008;"VISTA ALEGRE DO ALTO (SP)";"SP";"VISTA ALEGRE DO ALTO";280;18;105;403
2008;"VITORIA BRASIL (SP)";"SP";"VITORIA BRASIL";16;0;9;25
2008;"VOTORANTIM (SP)";"SP";"VOTORANTIM";1000;205;128;1333
2008;"VOTUPORANGA (SP)";"SP";"VOTUPORANGA";1617;65;138;1820
2008;"ZACARIAS (SP)";"SP";"ZACARIAS";32;6;13;51
2008;"ABREULANDIA (TO)";"TO";"ABREULANDIA";11;1;0;12
2008;"AGUIARNOPOLIS (TO)";"TO";"AGUIARNOPOLIS";30;1;4;35
2008;"ALIANCA DO TOCANTINS (TO)";"TO";"ALIANCA DO TOCANTINS";71;4;3;78
2008;"ALMAS (TO)";"TO";"ALMAS";36;0;2;38
2008;"ALVORADA (TO)";"TO";"ALVORADA";136;0;2;138
2008;"ANANAS (TO)";"TO";"ANANAS";38;8;10;56
2008;"ANGICO (TO)";"TO";"ANGICO";10;1;2;13
2008;"APARECIDA DO RIO NEGRO (TO)";"TO";"APARECIDA DO RIO NEGRO";50;11;2;63
2008;"ARAGOMINAS (TO)";"TO";"ARAGOMINAS";102;3;12;117
2008;"ARAGUACEMA (TO)";"TO";"ARAGUACEMA";20;1;5;26
2008;"ARAGUACU (TO)";"TO";"ARAGUACU";68;2;5;75
2008;"ARAGUAINA (TO)";"TO";"ARAGUAINA";3094;112;264;3470
2008;"ARAGUANA (TO)";"TO";"ARAGUANA";216;21;33;270
2008;"ARAGUATINS (TO)";"TO";"ARAGUATINS";365;52;54;471
2008;"ARAPOEMA (TO)";"TO";"ARAPOEMA";36;2;9;47
2008;"ARRAIAS (TO)";"TO";"ARRAIAS";31;1;5;37
2008;"AUGUSTINOPOLIS (TO)";"TO";"AUGUSTINOPOLIS";108;38;3;149
2008;"AURORA DO TOCANTINS (TO)";"TO";"AURORA DO TOCANTINS";4;0;1;5
2008;"AXIXA DO TOCANTINS (TO)";"TO";"AXIXA DO TOCANTINS";26;17;4;47
2008;"BABACULANDIA (TO)";"TO";"BABACULANDIA";498;24;16;538
2008;"BANDEIRANTES DO TOCANTINS (TO)";"TO";"BANDEIRANTES DO TOCANTINS";18;1;4;23
2008;"BARRA DO OURO (TO)";"TO";"BARRA DO OURO";2;0;0;2
2008;"BARROLANDIA (TO)";"TO";"BARROLANDIA";39;3;2;44
2008;"BERNARDO SAYAO (TO)";"TO";"BERNARDO SAYAO";34;1;7;42
2008;"BOM JESUS DO TOCANTINS (TO)";"TO";"BOM JESUS DO TOCANTINS";1;2;0;3
2008;"BRASILANDIA DO TOCANTINS (TO)";"TO";"BRASILANDIA DO TOCANTINS";10;1;1;12
2008;"BREJINHO DE NAZARE (TO)";"TO";"BREJINHO DE NAZARE";33;0;5;38
2008;"BURITI DO TOCANTINS (TO)";"TO";"BURITI DO TOCANTINS";31;12;2;45
2008;"CACHOEIRINHA (TO)";"TO";"CACHOEIRINHA";4;1;0;5
2008;"CAMPOS LINDOS (TO)";"TO";"CAMPOS LINDOS";32;1;1;34
2008;"CARIRI DO TOCANTINS (TO)";"TO";"CARIRI DO TOCANTINS";29;2;4;35
2008;"CARMOLANDIA (TO)";"TO";"CARMOLANDIA";572;69;162;803
2008;"CARRASCO BONITO (TO)";"TO";"CARRASCO BONITO";3;4;1;8
2008;"CASEARA (TO)";"TO";"CASEARA";26;2;1;29
2008;"CENTENARIO (TO)";"TO";"CENTENARIO";3;1;1;5
2008;"CHAPADA DA NATIVIDADE (TO)";"TO";"CHAPADA DA NATIVIDADE";14;0;2;16
2008;"CHAPADA DE AREIA (TO)";"TO";"CHAPADA DE AREIA";4;0;2;6
2008;"COLINAS DO TOCANTINS (TO)";"TO";"COLINAS DO TOCANTINS";464;11;41;516
2008;"COLMEIA (TO)";"TO";"COLMEIA";100;7;9;116
2008;"COMBINADO (TO)";"TO";"COMBINADO";15;1;6;22
2008;"CONCEICAO DO TOCANTINS (TO)";"TO";"CONCEICAO DO TOCANTINS";8;0;0;8
2008;"COUTO DE MAGALHAES (TO)";"TO";"COUTO DE MAGALHAES";6;6;2;14
2008;"CRISTALANDIA (TO)";"TO";"CRISTALANDIA";75;0;2;77
2008;"CRIXAS DO TOCANTINS (TO)";"TO";"CRIXAS DO TOCANTINS";5;2;0;7
2008;"DARCINOPOLIS (TO)";"TO";"DARCINOPOLIS";108;15;4;127
2008;"DIANOPOLIS (TO)";"TO";"DIANOPOLIS";104;7;22;133
2008;"DIVINOPOLIS DO TOCANTINS (TO)";"TO";"DIVINOPOLIS DO TOCANTINS";51;3;3;57
2008;"DOIS IRMAOS DO TOCANTINS (TO)";"TO";"DOIS IRMAOS DO TOCANTINS";34;2;1;37
2008;"DUERE (TO)";"TO";"DUERE";21;3;3;27
2008;"ESPERANTINA (TO)";"TO";"ESPERANTINA";14;10;3;27
2008;"FATIMA (TO)";"TO";"FATIMA";22;2;2;26
2008;"FIGUEIROPOLIS (TO)";"TO";"FIGUEIROPOLIS";42;3;3;48
2008;"FILADELFIA (TO)";"TO";"FILADELFIA";42;9;4;55
2008;"FORMOSO DO ARAGUAIA (TO)";"TO";"FORMOSO DO ARAGUAIA";139;5;15;159
2008;"FORTALEZA DO TABOCAO (TO)";"TO";"FORTALEZA DO TABOCAO";24;5;1;30
2008;"GOIANORTE (TO)";"TO";"GOIANORTE";18;1;3;22
2008;"GOIATINS (TO)";"TO";"GOIATINS";70;13;5;88
2008;"GUARAI (TO)";"TO";"GUARAI";289;10;21;320
2008;"GURUPI (TO)";"TO";"GURUPI";1213;25;170;1408
2008;"IPUEIRAS (TO)";"TO";"IPUEIRAS";2;0;2;4
2008;"ITACAJA (TO)";"TO";"ITACAJA";25;1;0;26
2008;"ITAGUATINS (TO)";"TO";"ITAGUATINS";46;7;20;73
2008;"ITAPIRATINS (TO)";"TO";"ITAPIRATINS";9;2;5;16
2008;"ITAPORA DO TOCANTINS (TO)";"TO";"ITAPORA DO TOCANTINS";14;3;2;19
2008;"JAU DO TOCANTINS (TO)";"TO";"JAU DO TOCANTINS";11;0;6;17
2008;"JUARINA (TO)";"TO";"JUARINA";10;1;1;12
2008;"LAGOA DA CONFUSAO (TO)";"TO";"LAGOA DA CONFUSAO";78;2;5;85
2008;"LAGOA DO TOCANTINS (TO)";"TO";"LAGOA DO TOCANTINS";4;2;3;9
2008;"LAJEADO (TO)";"TO";"LAJEADO";20;0;9;29
2008;"LAVANDEIRA (TO)";"TO";"LAVANDEIRA";3;1;1;5
2008;"LIZARDA (TO)";"TO";"LIZARDA";13;1;0;14
2008;"LUZINOPOLIS (TO)";"TO";"LUZINOPOLIS";5;2;0;7
2008;"MARIANOPOLIS DO TOCANTINS (TO)";"TO";"MARIANOPOLIS DO TOCANTINS";25;0;4;29
2008;"MATEIROS (TO)";"TO";"MATEIROS";11;0;2;13
2008;"MAURILANDIA DO TOCANTINS (TO)";"TO";"MAURILANDIA DO TOCANTINS";8;3;1;12
2008;"MIRACEMA DO TOCANTINS (TO)";"TO";"MIRACEMA DO TOCANTINS";149;12;43;204
2008;"MIRANORTE (TO)";"TO";"MIRANORTE";195;10;6;211
2008;"MONTE DO CARMO (TO)";"TO";"MONTE DO CARMO";9;1;3;13
2008;"MONTE SANTO DO TOCANTINS (TO)";"TO";"MONTE SANTO DO TOCANTINS";45;2;1;48
2008;"MURICILANDIA (TO)";"TO";"MURICILANDIA";14;2;2;18
2008;"NATIVIDADE (TO)";"TO";"NATIVIDADE";47;2;1;50
2008;"NAZARE (TO)";"TO";"NAZARE";17;5;1;23
2008;"NOVA OLINDA (TO)";"TO";"NOVA OLINDA";72;4;6;82
2008;"NOVA ROSALANDIA (TO)";"TO";"NOVA ROSALANDIA";20;0;3;23
2008;"NOVO ACORDO (TO)";"TO";"NOVO ACORDO";15;0;1;16
2008;"NOVO ALEGRE (TO)";"TO";"NOVO ALEGRE";5;2;1;8
2008;"NOVO JARDIM (TO)";"TO";"NOVO JARDIM";9;0;2;11
2008;"OLIVEIRA DE FATIMA (TO)";"TO";"OLIVEIRA DE FATIMA";5;0;2;7
2008;"PALMAS (TO)";"TO";"PALMAS";2898;217;482;3597
2008;"PALMEIRANTE (TO)";"TO";"PALMEIRANTE";7;4;1;12
2008;"PALMEIRAS DO TOCANTINS (TO)";"TO";"PALMEIRAS DO TOCANTINS";35;6;2;43
2008;"PALMEIROPOLIS (TO)";"TO";"PALMEIROPOLIS";71;2;10;83
2008;"PARAISO DO TOCANTINS (TO)";"TO";"PARAISO DO TOCANTINS";915;20;86;1021
2008;"PARANA (TO)";"TO";"PARANA";12;3;1;16
2008;"PAU D ARCO (TO)";"TO";"PAU D ARCO";8;0;2;10
2008;"PEDRO AFONSO (TO)";"TO";"PEDRO AFONSO";91;0;9;100
2008;"PEIXE (TO)";"TO";"PEIXE";36;5;54;95
2008;"PEQUIZEIRO (TO)";"TO";"PEQUIZEIRO";20;0;4;24
2008;"PINDORAMA DO TOCANTINS (TO)";"TO";"PINDORAMA DO TOCANTINS";20;0;2;22
2008;"PIRAQUE (TO)";"TO";"PIRAQUE";4;0;4;8
2008;"PIUM (TO)";"TO";"PIUM";29;3;6;38
2008;"PONTE ALTA DO BOM JESUS (TO)";"TO";"PONTE ALTA DO BOM JESUS";10;0;0;10
2008;"PONTE ALTA DO TOCANTINS (TO)";"TO";"PONTE ALTA DO TOCANTINS";23;2;1;26
2008;"PORTO ALEGRE DO TOCANTINS (TO)";"TO";"PORTO ALEGRE DO TOCANTINS";7;0;2;9
2008;"PORTO NACIONAL (TO)";"TO";"PORTO NACIONAL";518;22;79;619
2008;"PRAIA NORTE (TO)";"TO";"PRAIA NORTE";6;5;1;12
2008;"PRESIDENTE KENNEDY (TO)";"TO";"PRESIDENTE KENNEDY";28;3;1;32
2008;"PUGMIL (TO)";"TO";"PUGMIL";7;1;1;9
2008;"RECURSOLANDIA (TO)";"TO";"RECURSOLANDIA";7;0;0;7
2008;"RIACHINHO (TO)";"TO";"RIACHINHO";50;2;10;62
2008;"RIO DA CONCEICAO (TO)";"TO";"RIO DA CONCEICAO";4;1;1;6
2008;"RIO DOS BOIS (TO)";"TO";"RIO DOS BOIS";5;0;3;8
2008;"RIO SONO (TO)";"TO";"RIO SONO";12;1;4;17
2008;"SAMPAIO (TO)";"TO";"SAMPAIO";100;3;2;105
2008;"SANDOLANDIA (TO)";"TO";"SANDOLANDIA";7;2;1;10
2008;"SANTA FE DO ARAGUAIA (TO)";"TO";"SANTA FE DO ARAGUAIA";81;25;10;116
2008;"SANTA MARIA DO TOCANTINS (TO)";"TO";"SANTA MARIA DO TOCANTINS";9;2;0;11
2008;"SANTA RITA DO TOCANTINS (TO)";"TO";"SANTA RITA DO TOCANTINS";6;2;2;10
2008;"SANTA ROSA DO TOCANTINS (TO)";"TO";"SANTA ROSA DO TOCANTINS";18;0;2;20
2008;"SANTA TEREZA DO TOCANTINS (TO)";"TO";"SANTA TEREZA DO TOCANTINS";11;1;0;12
2008;"SANTA TEREZINHA DO TOCANTINS (TO)";"TO";"SANTA TEREZINHA DO TOCANTINS";4;3;2;9
2008;"SAO BENTO DO TOCANTINS (TO)";"TO";"SAO BENTO DO TOCANTINS";12;5;10;27
2008;"SAO FELIX DO TOCANTINS (TO)";"TO";"SAO FELIX DO TOCANTINS";3;1;0;4
2008;"SAO MIGUEL DO TOCANTINS (TO)";"TO";"SAO MIGUEL DO TOCANTINS";141;35;42;218
2008;"SAO SALVADOR DO TOCANTINS (TO)";"TO";"SAO SALVADOR DO TOCANTINS";30;0;1;31
2008;"SAO SEBASTIAO DO TOCANTINS (TO)";"TO";"SAO SEBASTIAO DO TOCANTINS";5;2;1;8
2008;"SAO VALERIO DA NATIVIDADE (TO)";"TO";"SAO VALERIO DA NATIVIDADE";31;1;4;36
2008;"SILVANOPOLIS (TO)";"TO";"SILVANOPOLIS";24;1;0;25
2008;"SITIO NOVO DO TOCANTINS (TO)";"TO";"SITIO NOVO DO TOCANTINS";32;11;11;54
2008;"SUCUPIRA (TO)";"TO";"SUCUPIRA";6;0;6;12
2008;"TAGUATINGA (TO)";"TO";"TAGUATINGA";48;5;11;64
2008;"TAIPAS DO TOCANTINS (TO)";"TO";"TAIPAS DO TOCANTINS";4;0;0;4
2008;"TALISMA (TO)";"TO";"TALISMA";9;4;0;13
2008;"TOCANTINIA (TO)";"TO";"TOCANTINIA";19;0;3;22
2008;"TOCANTINOPOLIS (TO)";"TO";"TOCANTINOPOLIS";1627;286;248;2161
2008;"TUPIRAMA (TO)";"TO";"TUPIRAMA";12;2;1;15
2008;"TUPIRATINS (TO)";"TO";"TUPIRATINS";9;0;3;12
2008;"WANDERLANDIA (TO)";"TO";"WANDERLANDIA";43;4;5;52
2008;"XAMBIOA (TO)";"TO";"XAMBIOA";80;3;6;89
