"ano";"chave";"UF";"MUNICIPIO";"CAMINHAO";"MICRO_ONIBUS";"ONIBUS";"total"
2016;"ACRELANDIA (AC)";"AC";"ACRELANDIA";230;8;43;281
2016;"ASSIS BRASIL (AC)";"AC";"ASSIS BRASIL";28;2;2;32
2016;"BRASILEIA (AC)";"AC";"BRASILEIA";234;4;17;255
2016;"BUJARI (AC)";"AC";"BUJARI";107;4;12;123
2016;"CAPIXABA (AC)";"AC";"CAPIXABA";77;1;13;91
2016;"CRUZEIRO DO SUL (AC)";"AC";"CRUZEIRO DO SUL";710;59;66;835
2016;"EPITACIOLANDIA (AC)";"AC";"EPITACIOLANDIA";214;2;14;230
2016;"FEIJO (AC)";"AC";"FEIJO";109;2;6;117
2016;"JORDAO (AC)";"AC";"JORDAO";3;0;0;3
2016;"MANCIO LIMA (AC)";"AC";"MANCIO LIMA";79;3;11;93
2016;"MANOEL URBANO (AC)";"AC";"MANOEL URBANO";48;0;5;53
2016;"MARECHAL THAUMATURGO (AC)";"AC";"MARECHAL THAUMATURGO";10;0;8;18
2016;"PLACIDO DE CASTRO (AC)";"AC";"PLACIDO DE CASTRO";145;3;16;164
2016;"PORTO ACRE (AC)";"AC";"PORTO ACRE";171;1;35;207
2016;"PORTO WALTER (AC)";"AC";"PORTO WALTER";9;0;4;13
2016;"RIO BRANCO (AC)";"AC";"RIO BRANCO";4125;224;718;5067
2016;"RODRIGUES ALVES (AC)";"AC";"RODRIGUES ALVES";16;0;7;23
2016;"SANTA ROSA DO PURUS (AC)";"AC";"SANTA ROSA DO PURUS";4;0;3;7
2016;"SENA MADUREIRA (AC)";"AC";"SENA MADUREIRA";97;5;8;110
2016;"SENADOR GUIOMARD (AC)";"AC";"SENADOR GUIOMARD";344;9;29;382
2016;"TARAUACA (AC)";"AC";"TARAUACA";138;20;25;183
2016;"XAPURI (AC)";"AC";"XAPURI";70;4;5;79
2016;"AGUA BRANCA (AL)";"AL";"AGUA BRANCA";71;73;11;155
2016;"ANADIA (AL)";"AL";"ANADIA";43;42;38;123
2016;"ARAPIRACA (AL)";"AL";"ARAPIRACA";2883;390;379;3652
2016;"ATALAIA (AL)";"AL";"ATALAIA";200;47;138;385
2016;"BARRA DE SANTO ANTONIO (AL)";"AL";"BARRA DE SANTO ANTONIO";31;4;22;57
2016;"BARRA DE SAO MIGUEL (AL)";"AL";"BARRA DE SAO MIGUEL";29;4;9;42
2016;"BATALHA (AL)";"AL";"BATALHA";108;38;11;157
2016;"BELEM (AL)";"AL";"BELEM";11;23;5;39
2016;"BELO MONTE (AL)";"AL";"BELO MONTE";35;14;7;56
2016;"BOCA DA MATA (AL)";"AL";"BOCA DA MATA";217;68;93;378
2016;"BRANQUINHA (AL)";"AL";"BRANQUINHA";30;20;20;70
2016;"CACIMBINHAS (AL)";"AL";"CACIMBINHAS";66;46;12;124
2016;"CAJUEIRO (AL)";"AL";"CAJUEIRO";89;8;49;146
2016;"CAMPESTRE (AL)";"AL";"CAMPESTRE";31;53;9;93
2016;"CAMPO ALEGRE (AL)";"AL";"CAMPO ALEGRE";128;107;129;364
2016;"CAMPO GRANDE (AL)";"AL";"CAMPO GRANDE";51;18;19;88
2016;"CANAPI (AL)";"AL";"CANAPI";46;39;22;107
2016;"CAPELA (AL)";"AL";"CAPELA";65;5;59;129
2016;"CARNEIROS (AL)";"AL";"CARNEIROS";33;11;5;49
2016;"CHA PRETA (AL)";"AL";"CHA PRETA";30;7;6;43
2016;"COITE DO NOIA (AL)";"AL";"COITE DO NOIA";73;8;26;107
2016;"COLONIA LEOPOLDINA (AL)";"AL";"COLONIA LEOPOLDINA";81;22;33;136
2016;"COQUEIRO SECO (AL)";"AL";"COQUEIRO SECO";8;3;9;20
2016;"CORURIPE (AL)";"AL";"CORURIPE";339;78;231;648
2016;"CRAIBAS (AL)";"AL";"CRAIBAS";150;36;28;214
2016;"DELMIRO GOUVEIA (AL)";"AL";"DELMIRO GOUVEIA";545;410;67;1022
2016;"DOIS RIACHOS (AL)";"AL";"DOIS RIACHOS";79;17;13;109
2016;"ESTRELA DE ALAGOAS (AL)";"AL";"ESTRELA DE ALAGOAS";50;85;25;160
2016;"FEIRA GRANDE (AL)";"AL";"FEIRA GRANDE";82;2;46;130
2016;"FELIZ DESERTO (AL)";"AL";"FELIZ DESERTO";10;4;11;25
2016;"FLEXEIRAS (AL)";"AL";"FLEXEIRAS";34;20;45;99
2016;"GIRAU DO PONCIANO (AL)";"AL";"GIRAU DO PONCIANO";201;60;68;329
2016;"IBATEGUARA (AL)";"AL";"IBATEGUARA";43;62;15;120
2016;"IGACI (AL)";"AL";"IGACI";128;127;38;293
2016;"IGREJA NOVA (AL)";"AL";"IGREJA NOVA";83;25;96;204
2016;"INHAPI (AL)";"AL";"INHAPI";72;24;7;103
2016;"JACARE DOS HOMENS (AL)";"AL";"JACARE DOS HOMENS";37;7;11;55
2016;"JACUIPE (AL)";"AL";"JACUIPE";12;13;16;41
2016;"JAPARATINGA (AL)";"AL";"JAPARATINGA";15;24;13;52
2016;"JARAMATAIA (AL)";"AL";"JARAMATAIA";29;10;7;46
2016;"JEQUIA DA PRAIA (AL)";"AL";"JEQUIA DA PRAIA";38;7;38;83
2016;"JOAQUIM GOMES (AL)";"AL";"JOAQUIM GOMES";108;26;75;209
2016;"JUNDIA (AL)";"AL";"JUNDIA";15;5;14;34
2016;"JUNQUEIRO (AL)";"AL";"JUNQUEIRO";192;25;111;328
2016;"LAGOA DA CANOA (AL)";"AL";"LAGOA DA CANOA";97;24;31;152
2016;"LIMOEIRO DE ANADIA (AL)";"AL";"LIMOEIRO DE ANADIA";127;26;46;199
2016;"MACEIO (AL)";"AL";"MACEIO";7273;1159;2141;10573
2016;"MAJOR ISIDORO (AL)";"AL";"MAJOR ISIDORO";91;33;25;149
2016;"MAR VERMELHO (AL)";"AL";"MAR VERMELHO";13;2;9;24
2016;"MARAGOGI (AL)";"AL";"MARAGOGI";79;129;39;247
2016;"MARAVILHA (AL)";"AL";"MARAVILHA";57;45;9;111
2016;"MARECHAL DEODORO (AL)";"AL";"MARECHAL DEODORO";293;65;154;512
2016;"MARIBONDO (AL)";"AL";"MARIBONDO";72;16;15;103
2016;"MATA GRANDE (AL)";"AL";"MATA GRANDE";63;33;12;108
2016;"MATRIZ DE CAMARAGIBE (AL)";"AL";"MATRIZ DE CAMARAGIBE";136;27;123;286
2016;"MESSIAS (AL)";"AL";"MESSIAS";67;47;90;204
2016;"MINADOR DO NEGRAO (AL)";"AL";"MINADOR DO NEGRAO";54;12;8;74
2016;"MONTEIROPOLIS (AL)";"AL";"MONTEIROPOLIS";14;4;6;24
2016;"MURICI (AL)";"AL";"MURICI";116;24;97;237
2016;"NOVO LINO (AL)";"AL";"NOVO LINO";64;45;63;172
2016;"OLHO D AGUA DAS FLORES (AL)";"AL";"OLHO D AGUA DAS FLORES";118;96;30;244
2016;"OLHO D AGUA DO CASADO (AL)";"AL";"OLHO D AGUA DO CASADO";35;17;10;62
2016;"OLHO D AGUA GRANDE (AL)";"AL";"OLHO D AGUA GRANDE";14;2;12;28
2016;"OLIVENCA (AL)";"AL";"OLIVENCA";60;28;12;100
2016;"OURO BRANCO (AL)";"AL";"OURO BRANCO";83;45;30;158
2016;"PALESTINA (AL)";"AL";"PALESTINA";11;14;5;30
2016;"PALMEIRA DOS INDIOS (AL)";"AL";"PALMEIRA DOS INDIOS";623;273;70;966
2016;"PAO DE ACUCAR (AL)";"AL";"PAO DE ACUCAR";74;37;14;125
2016;"PARICONHA (AL)";"AL";"PARICONHA";41;34;18;93
2016;"PARIPUEIRA (AL)";"AL";"PARIPUEIRA";59;5;18;82
2016;"PASSO DE CAMARAGIBE (AL)";"AL";"PASSO DE CAMARAGIBE";39;9;31;79
2016;"PAULO JACINTO (AL)";"AL";"PAULO JACINTO";18;9;9;36
2016;"PENEDO (AL)";"AL";"PENEDO";243;64;251;558
2016;"PIACABUCU (AL)";"AL";"PIACABUCU";33;12;19;64
2016;"PILAR (AL)";"AL";"PILAR";153;55;73;281
2016;"PINDOBA (AL)";"AL";"PINDOBA";7;1;4;12
2016;"PIRANHAS (AL)";"AL";"PIRANHAS";82;97;16;195
2016;"POCO DAS TRINCHEIRAS (AL)";"AL";"POCO DAS TRINCHEIRAS";66;58;24;148
2016;"PORTO CALVO (AL)";"AL";"PORTO CALVO";194;124;72;390
2016;"PORTO DE PEDRAS (AL)";"AL";"PORTO DE PEDRAS";18;9;10;37
2016;"PORTO REAL DO COLEGIO (AL)";"AL";"PORTO REAL DO COLEGIO";31;32;21;84
2016;"QUEBRANGULO (AL)";"AL";"QUEBRANGULO";38;9;13;60
2016;"RIO LARGO (AL)";"AL";"RIO LARGO";462;191;203;856
2016;"ROTEIRO (AL)";"AL";"ROTEIRO";13;29;13;55
2016;"SANTA LUZIA DO NORTE (AL)";"AL";"SANTA LUZIA DO NORTE";20;5;56;81
2016;"SANTANA DO IPANEMA (AL)";"AL";"SANTANA DO IPANEMA";432;213;39;684
2016;"SANTANA DO MUNDAU (AL)";"AL";"SANTANA DO MUNDAU";74;35;11;120
2016;"SAO BRAS (AL)";"AL";"SAO BRAS";4;4;6;14
2016;"SAO JOSE DA LAJE (AL)";"AL";"SAO JOSE DA LAJE";111;73;53;237
2016;"SAO JOSE DA TAPERA (AL)";"AL";"SAO JOSE DA TAPERA";127;75;29;231
2016;"SAO LUIS DO QUITUNDE (AL)";"AL";"SAO LUIS DO QUITUNDE";233;33;190;456
2016;"SAO MIGUEL DOS CAMPOS (AL)";"AL";"SAO MIGUEL DOS CAMPOS";441;151;160;752
2016;"SAO MIGUEL DOS MILAGRES (AL)";"AL";"SAO MIGUEL DOS MILAGRES";30;3;8;41
2016;"SAO SEBASTIAO (AL)";"AL";"SAO SEBASTIAO";159;45;134;338
2016;"SATUBA (AL)";"AL";"SATUBA";60;16;25;101
2016;"SENADOR RUI PALMEIRA (AL)";"AL";"SENADOR RUI PALMEIRA";42;17;15;74
2016;"TANQUE D ARCA (AL)";"AL";"TANQUE D ARCA";14;18;10;42
2016;"TAQUARANA (AL)";"AL";"TAQUARANA";107;68;40;215
2016;"TEOTONIO VILELA (AL)";"AL";"TEOTONIO VILELA";187;84;186;457
2016;"TRAIPU (AL)";"AL";"TRAIPU";98;15;23;136
2016;"UNIAO DOS PALMARES (AL)";"AL";"UNIAO DOS PALMARES";511;258;195;964
2016;"VICOSA (AL)";"AL";"VICOSA";140;30;45;215
2016;"ALVARAES (AM)";"AM";"ALVARAES";9;0;3;12
2016;"AMATURA (AM)";"AM";"AMATURA";3;0;1;4
2016;"ANAMA (AM)";"AM";"ANAMA";1;0;6;7
2016;"ANORI (AM)";"AM";"ANORI";7;1;3;11
2016;"APUI (AM)";"AM";"APUI";154;3;27;184
2016;"ATALAIA DO NORTE (AM)";"AM";"ATALAIA DO NORTE";2;1;1;4
2016;"AUTAZES (AM)";"AM";"AUTAZES";37;4;21;62
2016;"BARCELOS (AM)";"AM";"BARCELOS";11;1;1;13
2016;"BARREIRINHA (AM)";"AM";"BARREIRINHA";9;0;6;15
2016;"BENJAMIN CONSTANT (AM)";"AM";"BENJAMIN CONSTANT";12;6;4;22
2016;"BERURI (AM)";"AM";"BERURI";2;0;0;2
2016;"BOA VISTA DO RAMOS (AM)";"AM";"BOA VISTA DO RAMOS";3;0;1;4
2016;"BOCA DO ACRE (AM)";"AM";"BOCA DO ACRE";60;4;8;72
2016;"BORBA (AM)";"AM";"BORBA";20;0;6;26
2016;"CAAPIRANGA (AM)";"AM";"CAAPIRANGA";9;1;8;18
2016;"CANUTAMA (AM)";"AM";"CANUTAMA";5;0;1;6
2016;"CARAUARI (AM)";"AM";"CARAUARI";40;1;1;42
2016;"CAREIRO (AM)";"AM";"CAREIRO";76;48;70;194
2016;"CAREIRO DA VARZEA (AM)";"AM";"CAREIRO DA VARZEA";23;26;43;92
2016;"COARI (AM)";"AM";"COARI";135;7;13;155
2016;"CODAJAS (AM)";"AM";"CODAJAS";9;2;4;15
2016;"EIRUNEPE (AM)";"AM";"EIRUNEPE";35;1;5;41
2016;"ENVIRA (AM)";"AM";"ENVIRA";17;0;4;21
2016;"FONTE BOA (AM)";"AM";"FONTE BOA";16;0;0;16
2016;"GUAJARA (AM)";"AM";"GUAJARA";3;0;7;10
2016;"HUMAITA (AM)";"AM";"HUMAITA";202;6;25;233
2016;"IPIXUNA (AM)";"AM";"IPIXUNA";4;0;3;7
2016;"IRANDUBA (AM)";"AM";"IRANDUBA";354;40;121;515
2016;"ITACOATIARA (AM)";"AM";"ITACOATIARA";393;38;159;590
2016;"ITAMARATI (AM)";"AM";"ITAMARATI";11;0;0;11
2016;"ITAPIRANGA (AM)";"AM";"ITAPIRANGA";18;2;6;26
2016;"JAPURA (AM)";"AM";"JAPURA";4;0;4;8
2016;"JURUA (AM)";"AM";"JURUA";10;0;4;14
2016;"JUTAI (AM)";"AM";"JUTAI";4;0;0;4
2016;"LABREA (AM)";"AM";"LABREA";42;1;7;50
2016;"MANACAPURU (AM)";"AM";"MANACAPURU";382;89;111;582
2016;"MANAQUIRI (AM)";"AM";"MANAQUIRI";13;7;8;28
2016;"MANAUS (AM)";"AM";"MANAUS";16524;3039;7740;27303
2016;"MANICORE (AM)";"AM";"MANICORE";51;1;16;68
2016;"MARAA (AM)";"AM";"MARAA";5;1;0;6
2016;"MAUES (AM)";"AM";"MAUES";51;4;20;75
2016;"NHAMUNDA (AM)";"AM";"NHAMUNDA";8;0;1;9
2016;"NOVA OLINDA DO NORTE (AM)";"AM";"NOVA OLINDA DO NORTE";21;6;10;37
2016;"NOVO AIRAO (AM)";"AM";"NOVO AIRAO";30;9;10;49
2016;"NOVO ARIPUANA (AM)";"AM";"NOVO ARIPUANA";32;2;7;41
2016;"PARINTINS (AM)";"AM";"PARINTINS";164;6;26;196
2016;"PAUINI (AM)";"AM";"PAUINI";3;1;1;5
2016;"PRESIDENTE FIGUEIREDO (AM)";"AM";"PRESIDENTE FIGUEIREDO";331;51;93;475
2016;"RIO PRETO DA EVA (AM)";"AM";"RIO PRETO DA EVA";163;17;77;257
2016;"SANTA ISABEL DO RIO NEGRO (AM)";"AM";"SANTA ISABEL DO RIO NEGRO";10;3;3;16
2016;"SANTO ANTONIO DO ICA (AM)";"AM";"SANTO ANTONIO DO ICA";7;0;0;7
2016;"SAO GABRIEL DA CACHOEIRA (AM)";"AM";"SAO GABRIEL DA CACHOEIRA";95;13;30;138
2016;"SAO PAULO DE OLIVENCA (AM)";"AM";"SAO PAULO DE OLIVENCA";7;0;5;12
2016;"SAO SEBASTIAO DO UATUMA (AM)";"AM";"SAO SEBASTIAO DO UATUMA";6;0;1;7
2016;"SILVES (AM)";"AM";"SILVES";13;6;4;23
2016;"TABATINGA (AM)";"AM";"TABATINGA";72;10;6;88
2016;"TAPAUA (AM)";"AM";"TAPAUA";5;0;2;7
2016;"TEFE (AM)";"AM";"TEFE";73;19;13;105
2016;"TONANTINS (AM)";"AM";"TONANTINS";6;0;1;7
2016;"UARINI (AM)";"AM";"UARINI";11;0;4;15
2016;"URUCARA (AM)";"AM";"URUCARA";21;4;1;26
2016;"URUCURITUBA (AM)";"AM";"URUCURITUBA";7;0;2;9
2016;"AMAPA (AP)";"AP";"AMAPA";12;1;2;15
2016;"CALCOENE (AP)";"AP";"CALCOENE";19;2;3;24
2016;"CUTIAS (AP)";"AP";"CUTIAS";5;2;0;7
2016;"FERREIRA GOMES (AP)";"AP";"FERREIRA GOMES";5;4;5;14
2016;"ITAUBAL (AP)";"AP";"ITAUBAL";9;0;5;14
2016;"LARANJAL DO JARI (AP)";"AP";"LARANJAL DO JARI";99;10;18;127
2016;"MACAPA (AP)";"AP";"MACAPA";2957;352;879;4188
2016;"MAZAGAO (AP)";"AP";"MAZAGAO";56;15;21;92
2016;"OIAPOQUE (AP)";"AP";"OIAPOQUE";69;7;18;94
2016;"PEDRA BRANCA DO AMAPARI (AP)";"AP";"PEDRA BRANCA DO AMAPARI";32;7;17;56
2016;"PORTO GRANDE (AP)";"AP";"PORTO GRANDE";55;5;15;75
2016;"PRACUUBA (AP)";"AP";"PRACUUBA";7;1;2;10
2016;"SANTANA (AP)";"AP";"SANTANA";657;47;179;883
2016;"SERRA DO NAVIO (AP)";"AP";"SERRA DO NAVIO";15;4;3;22
2016;"TARTARUGALZINHO (AP)";"AP";"TARTARUGALZINHO";26;5;5;36
2016;"VITORIA DO JARI (AP)";"AP";"VITORIA DO JARI";4;1;4;9
2016;"ABAIRA (BA)";"BA";"ABAIRA";58;28;15;101
2016;"ABARE (BA)";"BA";"ABARE";52;45;25;122
2016;"ACAJUTIBA (BA)";"BA";"ACAJUTIBA";73;16;19;108
2016;"ADUSTINA (BA)";"BA";"ADUSTINA";14;9;12;35
2016;"AGUA FRIA (BA)";"BA";"AGUA FRIA";30;17;46;93
2016;"AIQUARA (BA)";"BA";"AIQUARA";6;6;5;17
2016;"ALAGOINHAS (BA)";"BA";"ALAGOINHAS";1380;353;598;2331
2016;"ALCOBACA (BA)";"BA";"ALCOBACA";52;10;34;96
2016;"ALMADINA (BA)";"BA";"ALMADINA";17;2;6;25
2016;"AMARGOSA (BA)";"BA";"AMARGOSA";332;86;83;501
2016;"AMELIA RODRIGUES (BA)";"BA";"AMELIA RODRIGUES";213;124;39;376
2016;"AMERICA DOURADA (BA)";"BA";"AMERICA DOURADA";38;16;14;68
2016;"ANAGE (BA)";"BA";"ANAGE";132;76;49;257
2016;"ANDARAI (BA)";"BA";"ANDARAI";40;13;23;76
2016;"ANDORINHA (BA)";"BA";"ANDORINHA";86;19;57;162
2016;"ANGICAL (BA)";"BA";"ANGICAL";39;12;26;77
2016;"ANGUERA (BA)";"BA";"ANGUERA";17;6;17;40
2016;"ANTAS (BA)";"BA";"ANTAS";31;9;10;50
2016;"ANTONIO CARDOSO (BA)";"BA";"ANTONIO CARDOSO";9;34;24;67
2016;"ANTONIO GONCALVES (BA)";"BA";"ANTONIO GONCALVES";28;14;12;54
2016;"APORA (BA)";"BA";"APORA";53;33;43;129
2016;"APUAREMA (BA)";"BA";"APUAREMA";25;6;10;41
2016;"ARACAS (BA)";"BA";"ARACAS";80;28;37;145
2016;"ARACATU (BA)";"BA";"ARACATU";137;36;35;208
2016;"ARACI (BA)";"BA";"ARACI";301;31;68;400
2016;"ARAMARI (BA)";"BA";"ARAMARI";43;6;16;65
2016;"ARATACA (BA)";"BA";"ARATACA";30;0;4;34
2016;"ARATUIPE (BA)";"BA";"ARATUIPE";44;9;16;69
2016;"AURELINO LEAL (BA)";"BA";"AURELINO LEAL";54;6;13;73
2016;"BAIANOPOLIS (BA)";"BA";"BAIANOPOLIS";60;6;42;108
2016;"BAIXA GRANDE (BA)";"BA";"BAIXA GRANDE";117;70;54;241
2016;"BANZAE (BA)";"BA";"BANZAE";25;5;23;53
2016;"BARRA (BA)";"BA";"BARRA";98;39;37;174
2016;"BARRA DA ESTIVA (BA)";"BA";"BARRA DA ESTIVA";286;71;65;422
2016;"BARRA DO CHOCA (BA)";"BA";"BARRA DO CHOCA";148;206;38;392
2016;"BARRA DO MENDES (BA)";"BA";"BARRA DO MENDES";79;32;26;137
2016;"BARRA DO ROCHA (BA)";"BA";"BARRA DO ROCHA";11;6;6;23
2016;"BARREIRAS (BA)";"BA";"BARREIRAS";2623;183;494;3300
2016;"BARRO ALTO (BA)";"BA";"BARRO ALTO";60;21;24;105
2016;"BARRO PRETO (BA)";"BA";"BARRO PRETO";21;2;11;34
2016;"BARROCAS (BA)";"BA";"BARROCAS";109;11;24;144
2016;"BELMONTE (BA)";"BA";"BELMONTE";59;8;12;79
2016;"BELO CAMPO (BA)";"BA";"BELO CAMPO";134;24;38;196
2016;"BIRITINGA (BA)";"BA";"BIRITINGA";33;17;37;87
2016;"BOA NOVA (BA)";"BA";"BOA NOVA";43;53;23;119
2016;"BOA VISTA DO TUPIM (BA)";"BA";"BOA VISTA DO TUPIM";72;16;24;112
2016;"BOM JESUS DA LAPA (BA)";"BA";"BOM JESUS DA LAPA";493;79;147;719
2016;"BOM JESUS DA SERRA (BA)";"BA";"BOM JESUS DA SERRA";40;53;23;116
2016;"BONINAL (BA)";"BA";"BONINAL";93;30;40;163
2016;"BONITO (BA)";"BA";"BONITO";109;19;25;153
2016;"BOQUIRA (BA)";"BA";"BOQUIRA";152;12;73;237
2016;"BOTUPORA (BA)";"BA";"BOTUPORA";67;5;53;125
2016;"BREJOES (BA)";"BA";"BREJOES";99;11;41;151
2016;"BREJOLANDIA (BA)";"BA";"BREJOLANDIA";34;7;19;60
2016;"BROTAS DE MACAUBAS (BA)";"BA";"BROTAS DE MACAUBAS";37;60;26;123
2016;"BRUMADO (BA)";"BA";"BRUMADO";1610;293;355;2258
2016;"BUERAREMA (BA)";"BA";"BUERAREMA";156;12;44;212
2016;"BURITIRAMA (BA)";"BA";"BURITIRAMA";48;11;26;85
2016;"CAATIBA (BA)";"BA";"CAATIBA";20;6;3;29
2016;"CABACEIRAS DO PARAGUACU (BA)";"BA";"CABACEIRAS DO PARAGUACU";95;30;66;191
2016;"CACHOEIRA (BA)";"BA";"CACHOEIRA";123;125;85;333
2016;"CACULE (BA)";"BA";"CACULE";420;39;51;510
2016;"CAEM (BA)";"BA";"CAEM";30;21;19;70
2016;"CAETANOS (BA)";"BA";"CAETANOS";91;15;18;124
2016;"CAETITE (BA)";"BA";"CAETITE";629;137;135;901
2016;"CAFARNAUM (BA)";"BA";"CAFARNAUM";84;8;40;132
2016;"CAIRU (BA)";"BA";"CAIRU";15;15;13;43
2016;"CALDEIRAO GRANDE (BA)";"BA";"CALDEIRAO GRANDE";31;7;21;59
2016;"CAMACAN (BA)";"BA";"CAMACAN";196;24;47;267
2016;"CAMACARI (BA)";"BA";"CAMACARI";2607;562;1204;4373
2016;"CAMAMU (BA)";"BA";"CAMAMU";177;49;38;264
2016;"CAMPO ALEGRE DE LOURDES (BA)";"BA";"CAMPO ALEGRE DE LOURDES";68;10;18;96
2016;"CAMPO FORMOSO (BA)";"BA";"CAMPO FORMOSO";324;31;118;473
2016;"CANAPOLIS (BA)";"BA";"CANAPOLIS";20;32;13;65
2016;"CANARANA (BA)";"BA";"CANARANA";198;35;37;270
2016;"CANAVIEIRAS (BA)";"BA";"CANAVIEIRAS";99;9;18;126
2016;"CANDEAL (BA)";"BA";"CANDEAL";24;23;27;74
2016;"CANDEIAS (BA)";"BA";"CANDEIAS";867;371;365;1603
2016;"CANDIBA (BA)";"BA";"CANDIBA";70;0;26;96
2016;"CANDIDO SALES (BA)";"BA";"CANDIDO SALES";339;62;58;459
2016;"CANSANCAO (BA)";"BA";"CANSANCAO";220;68;86;374
2016;"CANUDOS (BA)";"BA";"CANUDOS";67;12;49;128
2016;"CAPELA DO ALTO ALEGRE (BA)";"BA";"CAPELA DO ALTO ALEGRE";98;28;28;154
2016;"CAPIM GROSSO (BA)";"BA";"CAPIM GROSSO";624;108;76;808
2016;"CARAIBAS (BA)";"BA";"CARAIBAS";68;34;25;127
2016;"CARAVELAS (BA)";"BA";"CARAVELAS";52;18;43;113
2016;"CARDEAL DA SILVA (BA)";"BA";"CARDEAL DA SILVA";30;14;25;69
2016;"CARINHANHA (BA)";"BA";"CARINHANHA";123;51;52;226
2016;"CASA NOVA (BA)";"BA";"CASA NOVA";436;229;250;915
2016;"CASTRO ALVES (BA)";"BA";"CASTRO ALVES";154;25;65;244
2016;"CATOLANDIA (BA)";"BA";"CATOLANDIA";10;3;9;22
2016;"CATU (BA)";"BA";"CATU";444;156;120;720
2016;"CATURAMA (BA)";"BA";"CATURAMA";44;11;18;73
2016;"CENTRAL (BA)";"BA";"CENTRAL";97;30;14;141
2016;"CHORROCHO (BA)";"BA";"CHORROCHO";43;6;15;64
2016;"CICERO DANTAS (BA)";"BA";"CICERO DANTAS";144;35;62;241
2016;"CIPO (BA)";"BA";"CIPO";61;11;20;92
2016;"COARACI (BA)";"BA";"COARACI";129;8;30;167
2016;"COCOS (BA)";"BA";"COCOS";87;7;43;137
2016;"CONCEICAO DA FEIRA (BA)";"BA";"CONCEICAO DA FEIRA";245;138;21;404
2016;"CONCEICAO DO ALMEIDA (BA)";"BA";"CONCEICAO DO ALMEIDA";133;49;39;221
2016;"CONCEICAO DO COITE (BA)";"BA";"CONCEICAO DO COITE";618;144;141;903
2016;"CONCEICAO DO JACUIPE (BA)";"BA";"CONCEICAO DO JACUIPE";377;160;32;569
2016;"CONDE (BA)";"BA";"CONDE";66;22;26;114
2016;"CONDEUBA (BA)";"BA";"CONDEUBA";132;57;79;268
2016;"CONTENDAS DO SINCORA (BA)";"BA";"CONTENDAS DO SINCORA";32;11;11;54
2016;"CORACAO DE MARIA (BA)";"BA";"CORACAO DE MARIA";116;57;67;240
2016;"CORDEIROS (BA)";"BA";"CORDEIROS";44;17;24;85
2016;"CORIBE (BA)";"BA";"CORIBE";53;23;30;106
2016;"CORONEL JOAO SA (BA)";"BA";"CORONEL JOAO SA";11;2;24;37
2016;"CORRENTINA (BA)";"BA";"CORRENTINA";158;41;91;290
2016;"COTEGIPE (BA)";"BA";"COTEGIPE";62;25;25;112
2016;"CRAVOLANDIA (BA)";"BA";"CRAVOLANDIA";21;5;8;34
2016;"CRISOPOLIS (BA)";"BA";"CRISOPOLIS";71;35;38;144
2016;"CRISTOPOLIS (BA)";"BA";"CRISTOPOLIS";60;12;36;108
2016;"CRUZ DAS ALMAS (BA)";"BA";"CRUZ DAS ALMAS";1102;363;110;1575
2016;"CURACA (BA)";"BA";"CURACA";103;39;47;189
2016;"DARIO MEIRA (BA)";"BA";"DARIO MEIRA";23;22;5;50
2016;"DIAS D AVILA (BA)";"BA";"DIAS D AVILA";712;156;412;1280
2016;"DOM BASILIO (BA)";"BA";"DOM BASILIO";360;18;36;414
2016;"DOM MACEDO COSTA (BA)";"BA";"DOM MACEDO COSTA";12;30;10;52
2016;"ELISIO MEDRADO (BA)";"BA";"ELISIO MEDRADO";43;24;19;86
2016;"ENCRUZILHADA (BA)";"BA";"ENCRUZILHADA";81;33;20;134
2016;"ENTRE RIOS (BA)";"BA";"ENTRE RIOS";253;107;113;473
2016;"ERICO CARDOSO (BA)";"BA";"ERICO CARDOSO";41;9;26;76
2016;"ESPLANADA (BA)";"BA";"ESPLANADA";146;44;108;298
2016;"EUCLIDES DA CUNHA (BA)";"BA";"EUCLIDES DA CUNHA";308;85;211;604
2016;"EUNAPOLIS (BA)";"BA";"EUNAPOLIS";1418;136;476;2030
2016;"FATIMA (BA)";"BA";"FATIMA";19;10;21;50
2016;"FEIRA DA MATA (BA)";"BA";"FEIRA DA MATA";25;12;12;49
2016;"FEIRA DE SANTANA (BA)";"BA";"FEIRA DE SANTANA";8987;1449;1510;11946
2016;"FILADELFIA (BA)";"BA";"FILADELFIA";148;17;27;192
2016;"FIRMINO ALVES (BA)";"BA";"FIRMINO ALVES";17;3;4;24
2016;"FLORESTA AZUL (BA)";"BA";"FLORESTA AZUL";41;3;3;47
2016;"FORMOSA DO RIO PRETO (BA)";"BA";"FORMOSA DO RIO PRETO";172;11;28;211
2016;"GANDU (BA)";"BA";"GANDU";315;175;32;522
2016;"GAVIAO (BA)";"BA";"GAVIAO";24;14;9;47
2016;"GENTIO DO OURO (BA)";"BA";"GENTIO DO OURO";28;14;8;50
2016;"GLORIA (BA)";"BA";"GLORIA";65;27;50;142
2016;"GONGOGI (BA)";"BA";"GONGOGI";14;6;4;24
2016;"GOVERNADOR MANGABEIRA (BA)";"BA";"GOVERNADOR MANGABEIRA";236;50;45;331
2016;"GUAJERU (BA)";"BA";"GUAJERU";36;33;18;87
2016;"GUANAMBI (BA)";"BA";"GUANAMBI";1368;109;220;1697
2016;"GUARATINGA (BA)";"BA";"GUARATINGA";90;8;38;136
2016;"HELIOPOLIS (BA)";"BA";"HELIOPOLIS";26;8;22;56
2016;"IACU (BA)";"BA";"IACU";164;29;41;234
2016;"IBIASSUCE (BA)";"BA";"IBIASSUCE";99;24;23;146
2016;"IBICARAI (BA)";"BA";"IBICARAI";144;21;31;196
2016;"IBICOARA (BA)";"BA";"IBICOARA";287;74;81;442
2016;"IBICUI (BA)";"BA";"IBICUI";57;22;18;97
2016;"IBIPEBA (BA)";"BA";"IBIPEBA";57;31;19;107
2016;"IBIPITANGA (BA)";"BA";"IBIPITANGA";94;28;41;163
2016;"IBIQUERA (BA)";"BA";"IBIQUERA";10;8;4;22
2016;"IBIRAPITANGA (BA)";"BA";"IBIRAPITANGA";83;43;17;143
2016;"IBIRAPUA (BA)";"BA";"IBIRAPUA";86;7;10;103
2016;"IBIRATAIA (BA)";"BA";"IBIRATAIA";84;52;20;156
2016;"IBITIARA (BA)";"BA";"IBITIARA";117;65;56;238
2016;"IBITITA (BA)";"BA";"IBITITA";59;16;29;104
2016;"IBOTIRAMA (BA)";"BA";"IBOTIRAMA";273;85;39;397
2016;"ICHU (BA)";"BA";"ICHU";42;28;15;85
2016;"IGAPORA (BA)";"BA";"IGAPORA";119;40;43;202
2016;"IGRAPIUNA (BA)";"BA";"IGRAPIUNA";54;33;26;113
2016;"IGUAI (BA)";"BA";"IGUAI";73;45;43;161
2016;"ILHEUS (BA)";"BA";"ILHEUS";837;189;306;1332
2016;"INHAMBUPE (BA)";"BA";"INHAMBUPE";218;114;95;427
2016;"IPECAETA (BA)";"BA";"IPECAETA";31;11;55;97
2016;"IPIAU (BA)";"BA";"IPIAU";417;66;81;564
2016;"IPIRA (BA)";"BA";"IPIRA";462;80;124;666
2016;"IPUPIARA (BA)";"BA";"IPUPIARA";75;31;8;114
2016;"IRAJUBA (BA)";"BA";"IRAJUBA";49;2;22;73
2016;"IRAMAIA (BA)";"BA";"IRAMAIA";46;14;23;83
2016;"IRAQUARA (BA)";"BA";"IRAQUARA";135;40;51;226
2016;"IRARA (BA)";"BA";"IRARA";172;36;83;291
2016;"IRECE (BA)";"BA";"IRECE";1047;129;300;1476
2016;"ITABELA (BA)";"BA";"ITABELA";312;19;113;444
2016;"ITABERABA (BA)";"BA";"ITABERABA";601;112;93;806
2016;"ITABUNA (BA)";"BA";"ITABUNA";2040;96;796;2932
2016;"ITACARE (BA)";"BA";"ITACARE";38;30;10;78
2016;"ITAETE (BA)";"BA";"ITAETE";82;21;29;132
2016;"ITAGI (BA)";"BA";"ITAGI";49;5;6;60
2016;"ITAGIBA (BA)";"BA";"ITAGIBA";35;58;20;113
2016;"ITAGIMIRIM (BA)";"BA";"ITAGIMIRIM";60;6;9;75
2016;"ITAGUACU DA BAHIA (BA)";"BA";"ITAGUACU DA BAHIA";30;15;8;53
2016;"ITAJU DO COLONIA (BA)";"BA";"ITAJU DO COLONIA";29;3;7;39
2016;"ITAJUIPE (BA)";"BA";"ITAJUIPE";94;24;19;137
2016;"ITAMARAJU (BA)";"BA";"ITAMARAJU";494;55;172;721
2016;"ITAMARI (BA)";"BA";"ITAMARI";51;13;2;66
2016;"ITAMBE (BA)";"BA";"ITAMBE";89;74;11;174
2016;"ITANAGRA (BA)";"BA";"ITANAGRA";22;1;5;28
2016;"ITANHEM (BA)";"BA";"ITANHEM";66;11;28;105
2016;"ITAPARICA (BA)";"BA";"ITAPARICA";49;34;48;131
2016;"ITAPE (BA)";"BA";"ITAPE";33;0;5;38
2016;"ITAPEBI (BA)";"BA";"ITAPEBI";59;2;8;69
2016;"ITAPETINGA (BA)";"BA";"ITAPETINGA";512;77;144;733
2016;"ITAPICURU (BA)";"BA";"ITAPICURU";55;16;47;118
2016;"ITAPITANGA (BA)";"BA";"ITAPITANGA";12;4;4;20
2016;"ITAQUARA (BA)";"BA";"ITAQUARA";47;8;12;67
2016;"ITARANTIM (BA)";"BA";"ITARANTIM";105;17;6;128
2016;"ITATIM (BA)";"BA";"ITATIM";246;36;34;316
2016;"ITIRUCU (BA)";"BA";"ITIRUCU";123;20;22;165
2016;"ITIUBA (BA)";"BA";"ITIUBA";135;51;82;268
2016;"ITORORO (BA)";"BA";"ITORORO";101;24;26;151
2016;"ITUACU (BA)";"BA";"ITUACU";187;63;51;301
2016;"ITUBERA (BA)";"BA";"ITUBERA";160;23;40;223
2016;"IUIU (BA)";"BA";"IUIU";48;12;15;75
2016;"JABORANDI (BA)";"BA";"JABORANDI";90;1;33;124
2016;"JACARACI (BA)";"BA";"JACARACI";54;16;37;107
2016;"JACOBINA (BA)";"BA";"JACOBINA";793;140;261;1194
2016;"JAGUAQUARA (BA)";"BA";"JAGUAQUARA";649;46;79;774
2016;"JAGUARARI (BA)";"BA";"JAGUARARI";283;86;89;458
2016;"JAGUARIPE (BA)";"BA";"JAGUARIPE";49;32;30;111
2016;"JANDAIRA (BA)";"BA";"JANDAIRA";23;5;16;44
2016;"JEQUIE (BA)";"BA";"JEQUIE";1836;158;432;2426
2016;"JEREMOABO (BA)";"BA";"JEREMOABO";100;34;61;195
2016;"JIQUIRICA (BA)";"BA";"JIQUIRICA";56;23;23;102
2016;"JITAUNA (BA)";"BA";"JITAUNA";33;13;18;64
2016;"JOAO DOURADO (BA)";"BA";"JOAO DOURADO";170;43;41;254
2016;"JUAZEIRO (BA)";"BA";"JUAZEIRO";2796;1030;1051;4877
2016;"JUCURUCU (BA)";"BA";"JUCURUCU";19;1;5;25
2016;"JUSSARA (BA)";"BA";"JUSSARA";73;22;22;117
2016;"JUSSARI (BA)";"BA";"JUSSARI";19;1;3;23
2016;"JUSSIAPE (BA)";"BA";"JUSSIAPE";73;35;29;137
2016;"LAFAIETE COUTINHO (BA)";"BA";"LAFAIETE COUTINHO";23;3;10;36
2016;"LAGEDO DO TABOCAL (BA)";"BA";"LAGEDO DO TABOCAL";42;5;10;57
2016;"LAGOA REAL (BA)";"BA";"LAGOA REAL";92;17;31;140
2016;"LAJE (BA)";"BA";"LAJE";196;94;50;340
2016;"LAJEDAO (BA)";"BA";"LAJEDAO";14;1;13;28
2016;"LAJEDINHO (BA)";"BA";"LAJEDINHO";12;7;14;33
2016;"LAMARAO (BA)";"BA";"LAMARAO";12;16;8;36
2016;"LAPAO (BA)";"BA";"LAPAO";162;19;54;235
2016;"LAURO DE FREITAS (BA)";"BA";"LAURO DE FREITAS";2556;532;764;3852
2016;"LENCOIS (BA)";"BA";"LENCOIS";41;27;5;73
2016;"LICINIO DE ALMEIDA (BA)";"BA";"LICINIO DE ALMEIDA";132;17;23;172
2016;"LIVRAMENTO DE NOSSA SENHORA (BA)";"BA";"LIVRAMENTO DE NOSSA SENHORA";519;76;145;740
2016;"LUIS EDUARDO MAGALHAES (BA)";"BA";"LUIS EDUARDO MAGALHAES";1713;111;207;2031
2016;"MACAJUBA (BA)";"BA";"MACAJUBA";33;29;44;106
2016;"MACARANI (BA)";"BA";"MACARANI";99;12;20;131
2016;"MACAUBAS (BA)";"BA";"MACAUBAS";250;45;251;546
2016;"MACURURE (BA)";"BA";"MACURURE";26;5;15;46
2016;"MADRE DE DEUS (BA)";"BA";"MADRE DE DEUS";102;57;34;193
2016;"MAETINGA (BA)";"BA";"MAETINGA";45;12;18;75
2016;"MAIQUINIQUE (BA)";"BA";"MAIQUINIQUE";57;7;14;78
2016;"MAIRI (BA)";"BA";"MAIRI";92;33;44;169
2016;"MALHADA (BA)";"BA";"MALHADA";54;25;27;106
2016;"MALHADA DE PEDRAS (BA)";"BA";"MALHADA DE PEDRAS";100;44;40;184
2016;"MANOEL VITORINO (BA)";"BA";"MANOEL VITORINO";66;22;13;101
2016;"MANSIDAO (BA)";"BA";"MANSIDAO";28;0;11;39
2016;"MARACAS (BA)";"BA";"MARACAS";269;32;59;360
2016;"MARAGOGIPE (BA)";"BA";"MARAGOGIPE";160;50;59;269
2016;"MARAU (BA)";"BA";"MARAU";35;4;10;49
2016;"MARCIONILIO SOUZA (BA)";"BA";"MARCIONILIO SOUZA";39;24;17;80
2016;"MASCOTE (BA)";"BA";"MASCOTE";52;6;11;69
2016;"MATA DE SAO JOAO (BA)";"BA";"MATA DE SAO JOAO";291;107;107;505
2016;"MATINA (BA)";"BA";"MATINA";30;19;33;82
2016;"MEDEIROS NETO (BA)";"BA";"MEDEIROS NETO";100;21;49;170
2016;"MIGUEL CALMON (BA)";"BA";"MIGUEL CALMON";94;39;41;174
2016;"MILAGRES (BA)";"BA";"MILAGRES";173;13;20;206
2016;"MIRANGABA (BA)";"BA";"MIRANGABA";66;15;50;131
2016;"MIRANTE (BA)";"BA";"MIRANTE";69;26;20;115
2016;"MONTE SANTO (BA)";"BA";"MONTE SANTO";284;77;168;529
2016;"MORPARA (BA)";"BA";"MORPARA";24;18;10;52
2016;"MORRO DO CHAPEU (BA)";"BA";"MORRO DO CHAPEU";200;63;25;288
2016;"MORTUGABA (BA)";"BA";"MORTUGABA";89;8;21;118
2016;"MUCUGE (BA)";"BA";"MUCUGE";114;22;72;208
2016;"MUCURI (BA)";"BA";"MUCURI";152;40;112;304
2016;"MULUNGU DO MORRO (BA)";"BA";"MULUNGU DO MORRO";104;10;17;131
2016;"MUNDO NOVO (BA)";"BA";"MUNDO NOVO";70;29;29;128
2016;"MUNIZ FERREIRA (BA)";"BA";"MUNIZ FERREIRA";64;43;10;117
2016;"MUQUEM DO SAO FRANCISCO (BA)";"BA";"MUQUEM DO SAO FRANCISCO";42;22;34;98
2016;"MURITIBA (BA)";"BA";"MURITIBA";153;49;39;241
2016;"MUTUIPE (BA)";"BA";"MUTUIPE";156;91;61;308
2016;"NAZARE (BA)";"BA";"NAZARE";270;73;44;387
2016;"NILO PECANHA (BA)";"BA";"NILO PECANHA";47;33;25;105
2016;"NORDESTINA (BA)";"BA";"NORDESTINA";90;14;31;135
2016;"NOVA CANAA (BA)";"BA";"NOVA CANAA";72;23;16;111
2016;"NOVA FATIMA (BA)";"BA";"NOVA FATIMA";86;7;14;107
2016;"NOVA IBIA (BA)";"BA";"NOVA IBIA";23;12;7;42
2016;"NOVA ITARANA (BA)";"BA";"NOVA ITARANA";40;7;7;54
2016;"NOVA REDENCAO (BA)";"BA";"NOVA REDENCAO";18;10;7;35
2016;"NOVA SOURE (BA)";"BA";"NOVA SOURE";68;11;36;115
2016;"NOVA VICOSA (BA)";"BA";"NOVA VICOSA";198;52;77;327
2016;"NOVO HORIZONTE (BA)";"BA";"NOVO HORIZONTE";60;15;15;90
2016;"NOVO TRIUNFO (BA)";"BA";"NOVO TRIUNFO";20;3;4;27
2016;"OLINDINA (BA)";"BA";"OLINDINA";102;46;72;220
2016;"OLIVEIRA DOS BREJINHOS (BA)";"BA";"OLIVEIRA DOS BREJINHOS";139;58;52;249
2016;"OURICANGAS (BA)";"BA";"OURICANGAS";43;12;28;83
2016;"OUROLANDIA (BA)";"BA";"OUROLANDIA";81;25;10;116
2016;"PALMAS DE MONTE ALTO (BA)";"BA";"PALMAS DE MONTE ALTO";77;11;42;130
2016;"PALMEIRAS (BA)";"BA";"PALMEIRAS";51;36;9;96
2016;"PARAMIRIM (BA)";"BA";"PARAMIRIM";204;31;76;311
2016;"PARATINGA (BA)";"BA";"PARATINGA";75;42;49;166
2016;"PARIPIRANGA (BA)";"BA";"PARIPIRANGA";70;12;41;123
2016;"PAU BRASIL (BA)";"BA";"PAU BRASIL";55;14;41;110
2016;"PAULO AFONSO (BA)";"BA";"PAULO AFONSO";905;339;372;1616
2016;"PE DE SERRA (BA)";"BA";"PE DE SERRA";86;19;30;135
2016;"PEDRAO (BA)";"BA";"PEDRAO";9;6;9;24
2016;"PEDRO ALEXANDRE (BA)";"BA";"PEDRO ALEXANDRE";2;5;12;19
2016;"PIATA (BA)";"BA";"PIATA";103;52;38;193
2016;"PILAO ARCADO (BA)";"BA";"PILAO ARCADO";66;37;8;111
2016;"PINDAI (BA)";"BA";"PINDAI";62;19;36;117
2016;"PINDOBACU (BA)";"BA";"PINDOBACU";63;32;31;126
2016;"PINTADAS (BA)";"BA";"PINTADAS";68;26;58;152
2016;"PIRAI DO NORTE (BA)";"BA";"PIRAI DO NORTE";33;7;2;42
2016;"PIRIPA (BA)";"BA";"PIRIPA";98;32;23;153
2016;"PIRITIBA (BA)";"BA";"PIRITIBA";82;25;23;130
2016;"PLANALTINO (BA)";"BA";"PLANALTINO";57;11;27;95
2016;"PLANALTO (BA)";"BA";"PLANALTO";131;56;65;252
2016;"POCOES (BA)";"BA";"POCOES";445;352;97;894
2016;"POJUCA (BA)";"BA";"POJUCA";414;118;80;612
2016;"PONTO NOVO (BA)";"BA";"PONTO NOVO";88;13;39;140
2016;"PORTO SEGURO (BA)";"BA";"PORTO SEGURO";787;358;410;1555
2016;"POTIRAGUA (BA)";"BA";"POTIRAGUA";52;7;7;66
2016;"PRADO (BA)";"BA";"PRADO";89;17;51;157
2016;"PRESIDENTE DUTRA (BA)";"BA";"PRESIDENTE DUTRA";77;9;12;98
2016;"PRESIDENTE JANIO QUADROS (BA)";"BA";"PRESIDENTE JANIO QUADROS";51;32;22;105
2016;"PRESIDENTE TANCREDO NEVES (BA)";"BA";"PRESIDENTE TANCREDO NEVES";319;198;40;557
2016;"QUEIMADAS (BA)";"BA";"QUEIMADAS";140;30;70;240
2016;"QUIJINGUE (BA)";"BA";"QUIJINGUE";60;28;73;161
2016;"QUIXABEIRA (BA)";"BA";"QUIXABEIRA";55;18;14;87
2016;"RAFAEL JAMBEIRO (BA)";"BA";"RAFAEL JAMBEIRO";86;36;84;206
2016;"REMANSO (BA)";"BA";"REMANSO";231;94;31;356
2016;"RETIROLANDIA (BA)";"BA";"RETIROLANDIA";115;17;23;155
2016;"RIACHAO DAS NEVES (BA)";"BA";"RIACHAO DAS NEVES";70;26;32;128
2016;"RIACHAO DO JACUIPE (BA)";"BA";"RIACHAO DO JACUIPE";371;53;44;468
2016;"RIACHO DE SANTANA (BA)";"BA";"RIACHO DE SANTANA";271;26;79;376
2016;"RIBEIRA DO AMPARO (BA)";"BA";"RIBEIRA DO AMPARO";13;10;34;57
2016;"RIBEIRA DO POMBAL (BA)";"BA";"RIBEIRA DO POMBAL";291;97;137;525
2016;"RIBEIRAO DO LARGO (BA)";"BA";"RIBEIRAO DO LARGO";32;25;9;66
2016;"RIO DE CONTAS (BA)";"BA";"RIO DE CONTAS";82;40;24;146
2016;"RIO DO ANTONIO (BA)";"BA";"RIO DO ANTONIO";192;30;24;246
2016;"RIO DO PIRES (BA)";"BA";"RIO DO PIRES";92;15;22;129
2016;"RIO REAL (BA)";"BA";"RIO REAL";230;24;65;319
2016;"RODELAS (BA)";"BA";"RODELAS";37;5;8;50
2016;"RUY BARBOSA (BA)";"BA";"RUY BARBOSA";155;73;33;261
2016;"SALINAS DA MARGARIDA (BA)";"BA";"SALINAS DA MARGARIDA";27;13;11;51
2016;"SALVADOR (BA)";"BA";"SALVADOR";18041;4375;9103;31519
2016;"SANTA BARBARA (BA)";"BA";"SANTA BARBARA";82;20;22;124
2016;"SANTA BRIGIDA (BA)";"BA";"SANTA BRIGIDA";24;35;30;89
2016;"SANTA CRUZ CABRALIA (BA)";"BA";"SANTA CRUZ CABRALIA";104;46;41;191
2016;"SANTA CRUZ DA VITORIA (BA)";"BA";"SANTA CRUZ DA VITORIA";17;5;5;27
2016;"SANTA INES (BA)";"BA";"SANTA INES";43;17;6;66
2016;"SANTA LUZIA (BA)";"BA";"SANTA LUZIA";38;6;7;51
2016;"SANTA MARIA DA VITORIA (BA)";"BA";"SANTA MARIA DA VITORIA";440;57;72;569
2016;"SANTA RITA DE CASSIA (BA)";"BA";"SANTA RITA DE CASSIA";70;9;19;98
2016;"SANTA TERESINHA (BA)";"BA";"SANTA TERESINHA";45;14;36;95
2016;"SANTALUZ (BA)";"BA";"SANTALUZ";351;38;54;443
2016;"SANTANA (BA)";"BA";"SANTANA";172;14;74;260
2016;"SANTANOPOLIS (BA)";"BA";"SANTANOPOLIS";27;12;16;55
2016;"SANTO AMARO (BA)";"BA";"SANTO AMARO";258;140;161;559
2016;"SANTO ANTONIO DE JESUS (BA)";"BA";"SANTO ANTONIO DE JESUS";2362;269;209;2840
2016;"SANTO ESTEVAO (BA)";"BA";"SANTO ESTEVAO";343;104;72;519
2016;"SAO DESIDERIO (BA)";"BA";"SAO DESIDERIO";318;36;113;467
2016;"SAO DOMINGOS (BA)";"BA";"SAO DOMINGOS";47;2;9;58
2016;"SAO FELIPE (BA)";"BA";"SAO FELIPE";298;52;56;406
2016;"SAO FELIX (BA)";"BA";"SAO FELIX";63;28;19;110
2016;"SAO FELIX DO CORIBE (BA)";"BA";"SAO FELIX DO CORIBE";164;24;25;213
2016;"SAO FRANCISCO DO CONDE (BA)";"BA";"SAO FRANCISCO DO CONDE";162;106;96;364
2016;"SAO GABRIEL (BA)";"BA";"SAO GABRIEL";43;10;22;75
2016;"SAO GONCALO DOS CAMPOS (BA)";"BA";"SAO GONCALO DOS CAMPOS";244;232;45;521
2016;"SAO JOSE DA VITORIA (BA)";"BA";"SAO JOSE DA VITORIA";19;1;7;27
2016;"SAO JOSE DO JACUIPE (BA)";"BA";"SAO JOSE DO JACUIPE";80;22;9;111
2016;"SAO MIGUEL DAS MATAS (BA)";"BA";"SAO MIGUEL DAS MATAS";69;10;21;100
2016;"SAO SEBASTIAO DO PASSE (BA)";"BA";"SAO SEBASTIAO DO PASSE";234;229;144;607
2016;"SAPEACU (BA)";"BA";"SAPEACU";107;72;40;219
2016;"SATIRO DIAS (BA)";"BA";"SATIRO DIAS";31;19;18;68
2016;"SAUBARA (BA)";"BA";"SAUBARA";36;33;3;72
2016;"SAUDE (BA)";"BA";"SAUDE";50;26;21;97
2016;"SEABRA (BA)";"BA";"SEABRA";539;136;156;831
2016;"SEBASTIAO LARANJEIRAS (BA)";"BA";"SEBASTIAO LARANJEIRAS";35;5;31;71
2016;"SENHOR DO BONFIM (BA)";"BA";"SENHOR DO BONFIM";682;151;213;1046
2016;"SENTO SE (BA)";"BA";"SENTO SE";51;11;24;86
2016;"SERRA DO RAMALHO (BA)";"BA";"SERRA DO RAMALHO";113;40;44;197
2016;"SERRA DOURADA (BA)";"BA";"SERRA DOURADA";70;19;38;127
2016;"SERRA PRETA (BA)";"BA";"SERRA PRETA";60;17;64;141
2016;"SERRINHA (BA)";"BA";"SERRINHA";803;151;231;1185
2016;"SERROLANDIA (BA)";"BA";"SERROLANDIA";71;52;23;146
2016;"SIMOES FILHO (BA)";"BA";"SIMOES FILHO";2509;542;861;3912
2016;"SITIO DO MATO (BA)";"BA";"SITIO DO MATO";42;11;27;80
2016;"SITIO DO QUINTO (BA)";"BA";"SITIO DO QUINTO";21;3;12;36
2016;"SOBRADINHO (BA)";"BA";"SOBRADINHO";112;42;33;187
2016;"SOUTO SOARES (BA)";"BA";"SOUTO SOARES";120;17;30;167
2016;"TABOCAS DO BREJO VELHO (BA)";"BA";"TABOCAS DO BREJO VELHO";37;4;15;56
2016;"TANHACU (BA)";"BA";"TANHACU";287;69;50;406
2016;"TANQUE NOVO (BA)";"BA";"TANQUE NOVO";273;12;51;336
2016;"TANQUINHO (BA)";"BA";"TANQUINHO";31;23;17;71
2016;"TAPEROA (BA)";"BA";"TAPEROA";159;26;23;208
2016;"TAPIRAMUTA (BA)";"BA";"TAPIRAMUTA";56;12;20;88
2016;"TEIXEIRA DE FREITAS (BA)";"BA";"TEIXEIRA DE FREITAS";1593;130;403;2126
2016;"TEODORO SAMPAIO (BA)";"BA";"TEODORO SAMPAIO";12;12;14;38
2016;"TEOFILANDIA (BA)";"BA";"TEOFILANDIA";132;47;35;214
2016;"TEOLANDIA (BA)";"BA";"TEOLANDIA";168;48;17;233
2016;"TERRA NOVA (BA)";"BA";"TERRA NOVA";26;16;21;63
2016;"TREMEDAL (BA)";"BA";"TREMEDAL";61;28;46;135
2016;"TUCANO (BA)";"BA";"TUCANO";314;56;107;477
2016;"UAUA (BA)";"BA";"UAUA";259;45;38;342
2016;"UBAIRA (BA)";"BA";"UBAIRA";131;40;54;225
2016;"UBAITABA (BA)";"BA";"UBAITABA";191;18;25;234
2016;"UBATA (BA)";"BA";"UBATA";220;23;21;264
2016;"UIBAI (BA)";"BA";"UIBAI";64;18;19;101
2016;"UMBURANAS (BA)";"BA";"UMBURANAS";62;25;24;111
2016;"UNA (BA)";"BA";"UNA";68;12;60;140
2016;"URANDI (BA)";"BA";"URANDI";153;19;36;208
2016;"URUCUCA (BA)";"BA";"URUCUCA";106;10;17;133
2016;"UTINGA (BA)";"BA";"UTINGA";75;16;10;101
2016;"VALENCA (BA)";"BA";"VALENCA";811;280;140;1231
2016;"VALENTE (BA)";"BA";"VALENTE";200;21;35;256
2016;"VARZEA DA ROCA (BA)";"BA";"VARZEA DA ROCA";57;20;24;101
2016;"VARZEA DO POCO (BA)";"BA";"VARZEA DO POCO";73;18;15;106
2016;"VARZEA NOVA (BA)";"BA";"VARZEA NOVA";69;14;19;102
2016;"VARZEDO (BA)";"BA";"VARZEDO";72;16;30;118
2016;"VERA CRUZ (BA)";"BA";"VERA CRUZ";207;208;63;478
2016;"VEREDA (BA)";"BA";"VEREDA";13;5;3;21
2016;"VITORIA DA CONQUISTA (BA)";"BA";"VITORIA DA CONQUISTA";4647;1040;1529;7216
2016;"WAGNER (BA)";"BA";"WAGNER";39;5;16;60
2016;"WANDERLEY (BA)";"BA";"WANDERLEY";87;7;23;117
2016;"WENCESLAU GUIMARAES (BA)";"BA";"WENCESLAU GUIMARAES";135;32;18;185
2016;"XIQUE XIQUE (BA)";"BA";"XIQUE XIQUE";173;40;31;244
2016;"ABAIARA (CE)";"CE";"ABAIARA";42;28;9;79
2016;"ACARAPE (CE)";"CE";"ACARAPE";105;16;127;248
2016;"ACARAU (CE)";"CE";"ACARAU";249;40;67;356
2016;"ACOPIARA (CE)";"CE";"ACOPIARA";407;35;45;487
2016;"AIUABA (CE)";"CE";"AIUABA";37;6;7;50
2016;"ALCANTARAS (CE)";"CE";"ALCANTARAS";50;11;23;84
2016;"ALTANEIRA (CE)";"CE";"ALTANEIRA";37;17;6;60
2016;"ALTO SANTO (CE)";"CE";"ALTO SANTO";157;12;19;188
2016;"AMONTADA (CE)";"CE";"AMONTADA";202;32;33;267
2016;"ANTONINA DO NORTE (CE)";"CE";"ANTONINA DO NORTE";58;2;9;69
2016;"APUIARES (CE)";"CE";"APUIARES";96;8;12;116
2016;"AQUIRAZ (CE)";"CE";"AQUIRAZ";831;151;125;1107
2016;"ARACATI (CE)";"CE";"ARACATI";586;130;159;875
2016;"ARACOIABA (CE)";"CE";"ARACOIABA";131;20;32;183
2016;"ARARENDA (CE)";"CE";"ARARENDA";38;10;7;55
2016;"ARARIPE (CE)";"CE";"ARARIPE";104;112;54;270
2016;"ARATUBA (CE)";"CE";"ARATUBA";86;1;19;106
2016;"ARNEIROZ (CE)";"CE";"ARNEIROZ";39;17;5;61
2016;"ASSARE (CE)";"CE";"ASSARE";119;47;15;181
2016;"AURORA (CE)";"CE";"AURORA";105;32;21;158
2016;"BAIXIO (CE)";"CE";"BAIXIO";15;16;8;39
2016;"BANABUIU (CE)";"CE";"BANABUIU";232;10;28;270
2016;"BARBALHA (CE)";"CE";"BARBALHA";427;107;104;638
2016;"BARREIRA (CE)";"CE";"BARREIRA";160;12;23;195
2016;"BARRO (CE)";"CE";"BARRO";106;36;19;161
2016;"BARROQUINHA (CE)";"CE";"BARROQUINHA";64;28;8;100
2016;"BATURITE (CE)";"CE";"BATURITE";236;23;33;292
2016;"BEBERIBE (CE)";"CE";"BEBERIBE";298;79;84;461
2016;"BELA CRUZ (CE)";"CE";"BELA CRUZ";151;14;40;205
2016;"BOA VIAGEM (CE)";"CE";"BOA VIAGEM";591;30;79;700
2016;"BREJO SANTO (CE)";"CE";"BREJO SANTO";533;107;69;709
2016;"CAMOCIM (CE)";"CE";"CAMOCIM";245;58;38;341
2016;"CAMPOS SALES (CE)";"CE";"CAMPOS SALES";254;97;64;415
2016;"CANINDE (CE)";"CE";"CANINDE";620;62;149;831
2016;"CAPISTRANO (CE)";"CE";"CAPISTRANO";75;12;24;111
2016;"CARIDADE (CE)";"CE";"CARIDADE";85;9;17;111
2016;"CARIRE (CE)";"CE";"CARIRE";86;14;31;131
2016;"CARIRIACU (CE)";"CE";"CARIRIACU";97;42;14;153
2016;"CARIUS (CE)";"CE";"CARIUS";59;27;11;97
2016;"CARNAUBAL (CE)";"CE";"CARNAUBAL";83;28;12;123
2016;"CASCAVEL (CE)";"CE";"CASCAVEL";558;85;181;824
2016;"CATARINA (CE)";"CE";"CATARINA";55;5;2;62
2016;"CATUNDA (CE)";"CE";"CATUNDA";52;8;8;68
2016;"CAUCAIA (CE)";"CE";"CAUCAIA";2013;342;450;2805
2016;"CEDRO (CE)";"CE";"CEDRO";125;45;43;213
2016;"CHAVAL (CE)";"CE";"CHAVAL";38;17;10;65
2016;"CHORO (CE)";"CE";"CHORO";75;10;37;122
2016;"CHOROZINHO (CE)";"CE";"CHOROZINHO";160;18;38;216
2016;"COREAU (CE)";"CE";"COREAU";113;15;42;170
2016;"CRATEUS (CE)";"CE";"CRATEUS";420;99;112;631
2016;"CRATO (CE)";"CE";"CRATO";1119;202;143;1464
2016;"CROATA (CE)";"CE";"CROATA";84;24;17;125
2016;"CRUZ (CE)";"CE";"CRUZ";205;28;95;328
2016;"DEPUTADO IRAPUAN PINHEIRO (CE)";"CE";"DEPUTADO IRAPUAN PINHEIRO";24;9;14;47
2016;"ERERE (CE)";"CE";"ERERE";9;3;6;18
2016;"EUSEBIO (CE)";"CE";"EUSEBIO";1646;79;87;1812
2016;"FARIAS BRITO (CE)";"CE";"FARIAS BRITO";125;39;23;187
2016;"FORQUILHA (CE)";"CE";"FORQUILHA";148;30;53;231
2016;"FORTALEZA (CE)";"CE";"FORTALEZA";22200;3545;7118;32863
2016;"FORTIM (CE)";"CE";"FORTIM";47;30;24;101
2016;"FRECHEIRINHA (CE)";"CE";"FRECHEIRINHA";101;17;24;142
2016;"GENERAL SAMPAIO (CE)";"CE";"GENERAL SAMPAIO";33;6;9;48
2016;"GRACA (CE)";"CE";"GRACA";34;14;12;60
2016;"GRANJA (CE)";"CE";"GRANJA";251;120;40;411
2016;"GRANJEIRO (CE)";"CE";"GRANJEIRO";17;4;2;23
2016;"GROAIRAS (CE)";"CE";"GROAIRAS";75;25;33;133
2016;"GUAIUBA (CE)";"CE";"GUAIUBA";97;25;12;134
2016;"GUARACIABA DO NORTE (CE)";"CE";"GUARACIABA DO NORTE";493;42;27;562
2016;"GUARAMIRANGA (CE)";"CE";"GUARAMIRANGA";36;3;12;51
2016;"HIDROLANDIA (CE)";"CE";"HIDROLANDIA";179;20;19;218
2016;"HORIZONTE (CE)";"CE";"HORIZONTE";531;91;91;713
2016;"IBARETAMA (CE)";"CE";"IBARETAMA";139;7;23;169
2016;"IBIAPINA (CE)";"CE";"IBIAPINA";191;32;29;252
2016;"IBICUITINGA (CE)";"CE";"IBICUITINGA";88;8;23;119
2016;"ICAPUI (CE)";"CE";"ICAPUI";115;30;65;210
2016;"ICO (CE)";"CE";"ICO";376;102;91;569
2016;"IGUATU (CE)";"CE";"IGUATU";1080;74;155;1309
2016;"INDEPENDENCIA (CE)";"CE";"INDEPENDENCIA";257;4;23;284
2016;"IPAPORANGA (CE)";"CE";"IPAPORANGA";40;6;9;55
2016;"IPAUMIRIM (CE)";"CE";"IPAUMIRIM";302;74;42;418
2016;"IPU (CE)";"CE";"IPU";337;27;28;392
2016;"IPUEIRAS (CE)";"CE";"IPUEIRAS";106;47;13;166
2016;"IRACEMA (CE)";"CE";"IRACEMA";61;19;16;96
2016;"IRAUCUBA (CE)";"CE";"IRAUCUBA";118;25;35;178
2016;"ITAICABA (CE)";"CE";"ITAICABA";37;5;16;58
2016;"ITAITINGA (CE)";"CE";"ITAITINGA";454;70;59;583
2016;"ITAPAJE (CE)";"CE";"ITAPAJE";365;48;57;470
2016;"ITAPIPOCA (CE)";"CE";"ITAPIPOCA";988;96;111;1195
2016;"ITAPIUNA (CE)";"CE";"ITAPIUNA";70;9;33;112
2016;"ITAREMA (CE)";"CE";"ITAREMA";154;19;43;216
2016;"ITATIRA (CE)";"CE";"ITATIRA";175;10;33;218
2016;"JAGUARETAMA (CE)";"CE";"JAGUARETAMA";139;13;18;170
2016;"JAGUARIBARA (CE)";"CE";"JAGUARIBARA";102;15;16;133
2016;"JAGUARIBE (CE)";"CE";"JAGUARIBE";406;66;46;518
2016;"JAGUARUANA (CE)";"CE";"JAGUARUANA";293;25;22;340
2016;"JARDIM (CE)";"CE";"JARDIM";173;72;37;282
2016;"JATI (CE)";"CE";"JATI";53;95;12;160
2016;"JIJOCA DE JERICOACOARA (CE)";"CE";"JIJOCA DE JERICOACOARA";101;16;19;136
2016;"JUAZEIRO DO NORTE (CE)";"CE";"JUAZEIRO DO NORTE";2011;207;294;2512
2016;"JUCAS (CE)";"CE";"JUCAS";127;8;30;165
2016;"LAVRAS DA MANGABEIRA (CE)";"CE";"LAVRAS DA MANGABEIRA";115;31;38;184
2016;"LIMOEIRO DO NORTE (CE)";"CE";"LIMOEIRO DO NORTE";808;47;138;993
2016;"MADALENA (CE)";"CE";"MADALENA";189;9;26;224
2016;"MARACANAU (CE)";"CE";"MARACANAU";2171;265;418;2854
2016;"MARANGUAPE (CE)";"CE";"MARANGUAPE";700;178;298;1176
2016;"MARCO (CE)";"CE";"MARCO";303;22;23;348
2016;"MARTINOPOLE (CE)";"CE";"MARTINOPOLE";49;21;3;73
2016;"MASSAPE (CE)";"CE";"MASSAPE";121;41;103;265
2016;"MAURITI (CE)";"CE";"MAURITI";184;71;63;318
2016;"MERUOCA (CE)";"CE";"MERUOCA";46;16;22;84
2016;"MILAGRES (CE)";"CE";"MILAGRES";124;70;28;222
2016;"MILHA (CE)";"CE";"MILHA";103;16;29;148
2016;"MIRAIMA (CE)";"CE";"MIRAIMA";36;1;13;50
2016;"MISSAO VELHA (CE)";"CE";"MISSAO VELHA";264;70;30;364
2016;"MOMBACA (CE)";"CE";"MOMBACA";268;37;40;345
2016;"MONSENHOR TABOSA (CE)";"CE";"MONSENHOR TABOSA";90;8;8;106
2016;"MORADA NOVA (CE)";"CE";"MORADA NOVA";584;68;108;760
2016;"MORAUJO (CE)";"CE";"MORAUJO";27;6;9;42
2016;"MORRINHOS (CE)";"CE";"MORRINHOS";105;19;31;155
2016;"MUCAMBO (CE)";"CE";"MUCAMBO";43;20;17;80
2016;"MULUNGU (CE)";"CE";"MULUNGU";77;9;16;102
2016;"NOVA OLINDA (CE)";"CE";"NOVA OLINDA";127;29;16;172
2016;"NOVA RUSSAS (CE)";"CE";"NOVA RUSSAS";206;28;16;250
2016;"NOVO ORIENTE (CE)";"CE";"NOVO ORIENTE";86;37;21;144
2016;"OCARA (CE)";"CE";"OCARA";207;15;52;274
2016;"OROS (CE)";"CE";"OROS";153;35;33;221
2016;"PACAJUS (CE)";"CE";"PACAJUS";740;107;182;1029
2016;"PACATUBA (CE)";"CE";"PACATUBA";283;81;41;405
2016;"PACOTI (CE)";"CE";"PACOTI";115;5;16;136
2016;"PACUJA (CE)";"CE";"PACUJA";22;5;8;35
2016;"PALHANO (CE)";"CE";"PALHANO";91;14;14;119
2016;"PALMACIA (CE)";"CE";"PALMACIA";51;14;20;85
2016;"PARACURU (CE)";"CE";"PARACURU";231;28;46;305
2016;"PARAIPABA (CE)";"CE";"PARAIPABA";295;20;34;349
2016;"PARAMBU (CE)";"CE";"PARAMBU";255;14;23;292
2016;"PARAMOTI (CE)";"CE";"PARAMOTI";70;8;23;101
2016;"PEDRA BRANCA (CE)";"CE";"PEDRA BRANCA";525;35;46;606
2016;"PENAFORTE (CE)";"CE";"PENAFORTE";93;54;24;171
2016;"PENTECOSTE (CE)";"CE";"PENTECOSTE";302;19;28;349
2016;"PEREIRO (CE)";"CE";"PEREIRO";105;14;33;152
2016;"PINDORETAMA (CE)";"CE";"PINDORETAMA";182;17;40;239
2016;"PIQUET CARNEIRO (CE)";"CE";"PIQUET CARNEIRO";61;9;16;86
2016;"PIRES FERREIRA (CE)";"CE";"PIRES FERREIRA";23;7;5;35
2016;"PORANGA (CE)";"CE";"PORANGA";28;13;7;48
2016;"PORTEIRAS (CE)";"CE";"PORTEIRAS";68;385;64;517
2016;"POTENGI (CE)";"CE";"POTENGI";60;6;10;76
2016;"POTIRETAMA (CE)";"CE";"POTIRETAMA";54;5;6;65
2016;"QUITERIANOPOLIS (CE)";"CE";"QUITERIANOPOLIS";98;17;9;124
2016;"QUIXADA (CE)";"CE";"QUIXADA";1040;72;141;1253
2016;"QUIXELO (CE)";"CE";"QUIXELO";79;23;41;143
2016;"QUIXERAMOBIM (CE)";"CE";"QUIXERAMOBIM";621;47;152;820
2016;"QUIXERE (CE)";"CE";"QUIXERE";276;16;47;339
2016;"REDENCAO (CE)";"CE";"REDENCAO";239;44;65;348
2016;"RERIUTABA (CE)";"CE";"RERIUTABA";114;28;22;164
2016;"RUSSAS (CE)";"CE";"RUSSAS";971;62;183;1216
2016;"SABOEIRO (CE)";"CE";"SABOEIRO";50;10;12;72
2016;"SALITRE (CE)";"CE";"SALITRE";156;16;38;210
2016;"SANTA QUITERIA (CE)";"CE";"SANTA QUITERIA";327;50;25;402
2016;"SANTANA DO ACARAU (CE)";"CE";"SANTANA DO ACARAU";167;58;57;282
2016;"SANTANA DO CARIRI (CE)";"CE";"SANTANA DO CARIRI";86;33;23;142
2016;"SAO BENEDITO (CE)";"CE";"SAO BENEDITO";510;123;69;702
2016;"SAO GONCALO DO AMARANTE (CE)";"CE";"SAO GONCALO DO AMARANTE";434;108;177;719
2016;"SAO JOAO DO JAGUARIBE (CE)";"CE";"SAO JOAO DO JAGUARIBE";49;3;9;61
2016;"SAO LUIS DO CURU (CE)";"CE";"SAO LUIS DO CURU";70;3;11;84
2016;"SENADOR POMPEU (CE)";"CE";"SENADOR POMPEU";195;27;68;290
2016;"SENADOR SA (CE)";"CE";"SENADOR SA";25;6;17;48
2016;"SOBRAL (CE)";"CE";"SOBRAL";1699;260;454;2413
2016;"SOLONOPOLE (CE)";"CE";"SOLONOPOLE";94;20;21;135
2016;"TABULEIRO DO NORTE (CE)";"CE";"TABULEIRO DO NORTE";401;41;54;496
2016;"TAMBORIL (CE)";"CE";"TAMBORIL";134;23;27;184
2016;"TARRAFAS (CE)";"CE";"TARRAFAS";29;11;8;48
2016;"TAUA (CE)";"CE";"TAUA";545;121;56;722
2016;"TEJUCUOCA (CE)";"CE";"TEJUCUOCA";108;14;25;147
2016;"TIANGUA (CE)";"CE";"TIANGUA";1495;174;213;1882
2016;"TRAIRI (CE)";"CE";"TRAIRI";254;27;80;361
2016;"TURURU (CE)";"CE";"TURURU";69;12;14;95
2016;"UBAJARA (CE)";"CE";"UBAJARA";302;28;72;402
2016;"UMARI (CE)";"CE";"UMARI";12;4;7;23
2016;"UMIRIM (CE)";"CE";"UMIRIM";60;39;43;142
2016;"URUBURETAMA (CE)";"CE";"URUBURETAMA";103;11;36;150
2016;"URUOCA (CE)";"CE";"URUOCA";83;16;20;119
2016;"VARJOTA (CE)";"CE";"VARJOTA";172;37;13;222
2016;"VARZEA ALEGRE (CE)";"CE";"VARZEA ALEGRE";281;54;58;393
2016;"VICOSA DO CEARA (CE)";"CE";"VICOSA DO CEARA";445;54;84;583
2016;"BRASILIA (DF)";"DF";"BRASILIA";23502;5501;12196;41199
2016;"AFONSO CLAUDIO (ES)";"ES";"AFONSO CLAUDIO";739;101;110;950
2016;"AGUA DOCE DO NORTE (ES)";"ES";"AGUA DOCE DO NORTE";136;35;34;205
2016;"AGUIA BRANCA (ES)";"ES";"AGUIA BRANCA";179;12;51;242
2016;"ALEGRE (ES)";"ES";"ALEGRE";285;52;38;375
2016;"ALFREDO CHAVES (ES)";"ES";"ALFREDO CHAVES";514;43;42;599
2016;"ALTO RIO NOVO (ES)";"ES";"ALTO RIO NOVO";121;24;21;166
2016;"ANCHIETA (ES)";"ES";"ANCHIETA";358;94;57;509
2016;"APIACA (ES)";"ES";"APIACA";165;25;6;196
2016;"ARACRUZ (ES)";"ES";"ARACRUZ";1480;229;505;2214
2016;"ATILIO VIVACQUA (ES)";"ES";"ATILIO VIVACQUA";214;16;25;255
2016;"BAIXO GUANDU (ES)";"ES";"BAIXO GUANDU";566;46;94;706
2016;"BARRA DE SAO FRANCISCO (ES)";"ES";"BARRA DE SAO FRANCISCO";631;54;146;831
2016;"BOA ESPERANCA (ES)";"ES";"BOA ESPERANCA";282;20;55;357
2016;"BOM JESUS DO NORTE (ES)";"ES";"BOM JESUS DO NORTE";325;44;37;406
2016;"BREJETUBA (ES)";"ES";"BREJETUBA";307;32;58;397
2016;"CACHOEIRO DE ITAPEMIRIM (ES)";"ES";"CACHOEIRO DE ITAPEMIRIM";5183;266;1719;7168
2016;"CARIACICA (ES)";"ES";"CARIACICA";5874;724;1546;8144
2016;"CASTELO (ES)";"ES";"CASTELO";1233;104;104;1441
2016;"COLATINA (ES)";"ES";"COLATINA";2656;214;608;3478
2016;"CONCEICAO DA BARRA (ES)";"ES";"CONCEICAO DA BARRA";261;25;131;417
2016;"CONCEICAO DO CASTELO (ES)";"ES";"CONCEICAO DO CASTELO";306;55;63;424
2016;"DIVINO DE SAO LOURENCO (ES)";"ES";"DIVINO DE SAO LOURENCO";80;9;11;100
2016;"DOMINGOS MARTINS (ES)";"ES";"DOMINGOS MARTINS";1331;126;90;1547
2016;"DORES DO RIO PRETO (ES)";"ES";"DORES DO RIO PRETO";154;29;18;201
2016;"ECOPORANGA (ES)";"ES";"ECOPORANGA";205;56;107;368
2016;"FUNDAO (ES)";"ES";"FUNDAO";372;54;47;473
2016;"GOVERNADOR LINDENBERG (ES)";"ES";"GOVERNADOR LINDENBERG";317;8;7;332
2016;"GUACUI (ES)";"ES";"GUACUI";731;61;73;865
2016;"GUARAPARI (ES)";"ES";"GUARAPARI";1328;348;313;1989
2016;"IBATIBA (ES)";"ES";"IBATIBA";587;111;83;781
2016;"IBIRACU (ES)";"ES";"IBIRACU";386;31;56;473
2016;"IBITIRAMA (ES)";"ES";"IBITIRAMA";162;32;24;218
2016;"ICONHA (ES)";"ES";"ICONHA";755;28;68;851
2016;"IRUPI (ES)";"ES";"IRUPI";265;48;35;348
2016;"ITAGUACU (ES)";"ES";"ITAGUACU";311;15;62;388
2016;"ITAPEMIRIM (ES)";"ES";"ITAPEMIRIM";617;58;85;760
2016;"ITARANA (ES)";"ES";"ITARANA";437;41;41;519
2016;"IUNA (ES)";"ES";"IUNA";533;89;67;689
2016;"JAGUARE (ES)";"ES";"JAGUARE";495;28;103;626
2016;"JERONIMO MONTEIRO (ES)";"ES";"JERONIMO MONTEIRO";114;31;20;165
2016;"JOAO NEIVA (ES)";"ES";"JOAO NEIVA";335;31;38;404
2016;"LARANJA DA TERRA (ES)";"ES";"LARANJA DA TERRA";342;22;31;395
2016;"LINHARES (ES)";"ES";"LINHARES";3062;218;573;3853
2016;"MANTENOPOLIS (ES)";"ES";"MANTENOPOLIS";177;31;33;241
2016;"MARATAIZES (ES)";"ES";"MARATAIZES";1170;55;101;1326
2016;"MARECHAL FLORIANO (ES)";"ES";"MARECHAL FLORIANO";806;53;45;904
2016;"MARILANDIA (ES)";"ES";"MARILANDIA";439;24;31;494
2016;"MIMOSO DO SUL (ES)";"ES";"MIMOSO DO SUL";362;74;93;529
2016;"MONTANHA (ES)";"ES";"MONTANHA";247;14;88;349
2016;"MUCURICI (ES)";"ES";"MUCURICI";75;12;23;110
2016;"MUNIZ FREIRE (ES)";"ES";"MUNIZ FREIRE";284;59;48;391
2016;"MUQUI (ES)";"ES";"MUQUI";216;25;37;278
2016;"NOVA VENECIA (ES)";"ES";"NOVA VENECIA";1008;63;198;1269
2016;"PANCAS (ES)";"ES";"PANCAS";332;37;21;390
2016;"PEDRO CANARIO (ES)";"ES";"PEDRO CANARIO";665;57;317;1039
2016;"PINHEIROS (ES)";"ES";"PINHEIROS";346;22;152;520
2016;"PIUMA (ES)";"ES";"PIUMA";302;41;16;359
2016;"PONTO BELO (ES)";"ES";"PONTO BELO";70;12;15;97
2016;"PRESIDENTE KENNEDY (ES)";"ES";"PRESIDENTE KENNEDY";374;19;24;417
2016;"RIO BANANAL (ES)";"ES";"RIO BANANAL";693;30;63;786
2016;"RIO NOVO DO SUL (ES)";"ES";"RIO NOVO DO SUL";379;32;30;441
2016;"SANTA LEOPOLDINA (ES)";"ES";"SANTA LEOPOLDINA";493;47;35;575
2016;"SANTA MARIA DE JETIBA (ES)";"ES";"SANTA MARIA DE JETIBA";2651;95;83;2829
2016;"SANTA TERESA (ES)";"ES";"SANTA TERESA";799;54;125;978
2016;"SAO DOMINGOS DO NORTE (ES)";"ES";"SAO DOMINGOS DO NORTE";270;22;42;334
2016;"SAO GABRIEL DA PALHA (ES)";"ES";"SAO GABRIEL DA PALHA";781;40;145;966
2016;"SAO JOSE DO CALCADO (ES)";"ES";"SAO JOSE DO CALCADO";118;30;22;170
2016;"SAO MATEUS (ES)";"ES";"SAO MATEUS";1327;124;394;1845
2016;"SAO ROQUE DO CANAA (ES)";"ES";"SAO ROQUE DO CANAA";364;24;31;419
2016;"SERRA (ES)";"ES";"SERRA";8972;798;2233;12003
2016;"SOORETAMA (ES)";"ES";"SOORETAMA";371;20;60;451
2016;"VARGEM ALTA (ES)";"ES";"VARGEM ALTA";568;39;64;671
2016;"VENDA NOVA DO IMIGRANTE (ES)";"ES";"VENDA NOVA DO IMIGRANTE";891;33;126;1050
2016;"VIANA (ES)";"ES";"VIANA";1282;120;377;1779
2016;"VILA PAVAO (ES)";"ES";"VILA PAVAO";181;10;32;223
2016;"VILA VALERIO (ES)";"ES";"VILA VALERIO";407;20;68;495
2016;"VILA VELHA (ES)";"ES";"VILA VELHA";4478;977;1040;6495
2016;"VITORIA (ES)";"ES";"VITORIA";4252;1071;967;6290
2016;"ABADIA DE GOIAS (GO)";"GO";"ABADIA DE GOIAS";138;8;7;153
2016;"ABADIANIA (GO)";"GO";"ABADIANIA";304;40;30;374
2016;"ACREUNA (GO)";"GO";"ACREUNA";450;15;122;587
2016;"ADELANDIA (GO)";"GO";"ADELANDIA";39;1;6;46
2016;"AGUA FRIA DE GOIAS (GO)";"GO";"AGUA FRIA DE GOIAS";56;8;21;85
2016;"AGUA LIMPA (GO)";"GO";"AGUA LIMPA";22;6;2;30
2016;"AGUAS LINDAS DE GOIAS (GO)";"GO";"AGUAS LINDAS DE GOIAS";1347;210;703;2260
2016;"ALEXANIA (GO)";"GO";"ALEXANIA";529;52;52;633
2016;"ALOANDIA (GO)";"GO";"ALOANDIA";30;1;4;35
2016;"ALTO HORIZONTE (GO)";"GO";"ALTO HORIZONTE";68;7;20;95
2016;"ALTO PARAISO DE GOIAS (GO)";"GO";"ALTO PARAISO DE GOIAS";77;10;16;103
2016;"ALVORADA DO NORTE (GO)";"GO";"ALVORADA DO NORTE";157;12;16;185
2016;"AMARALINA (GO)";"GO";"AMARALINA";13;3;11;27
2016;"AMERICANO DO BRASIL (GO)";"GO";"AMERICANO DO BRASIL";73;8;23;104
2016;"AMORINOPOLIS (GO)";"GO";"AMORINOPOLIS";41;7;11;59
2016;"ANAPOLIS (GO)";"GO";"ANAPOLIS";9953;339;1856;12148
2016;"ANHANGUERA (GO)";"GO";"ANHANGUERA";8;1;0;9
2016;"ANICUNS (GO)";"GO";"ANICUNS";410;26;114;550
2016;"APARECIDA DE GOIANIA (GO)";"GO";"APARECIDA DE GOIANIA";7113;448;613;8174
2016;"APARECIDA DO RIO DOCE (GO)";"GO";"APARECIDA DO RIO DOCE";63;9;12;84
2016;"APORE (GO)";"GO";"APORE";105;14;27;146
2016;"ARACU (GO)";"GO";"ARACU";34;8;13;55
2016;"ARAGARCAS (GO)";"GO";"ARAGARCAS";576;17;30;623
2016;"ARAGOIANIA (GO)";"GO";"ARAGOIANIA";103;3;9;115
2016;"ARAGUAPAZ (GO)";"GO";"ARAGUAPAZ";109;12;18;139
2016;"ARENOPOLIS (GO)";"GO";"ARENOPOLIS";27;10;9;46
2016;"ARUANA (GO)";"GO";"ARUANA";71;2;20;93
2016;"AURILANDIA (GO)";"GO";"AURILANDIA";33;4;3;40
2016;"AVELINOPOLIS (GO)";"GO";"AVELINOPOLIS";61;4;3;68
2016;"BALIZA (GO)";"GO";"BALIZA";12;0;7;19
2016;"BARRO ALTO (GO)";"GO";"BARRO ALTO";171;37;83;291
2016;"BELA VISTA DE GOIAS (GO)";"GO";"BELA VISTA DE GOIAS";517;23;51;591
2016;"BOM JARDIM DE GOIAS (GO)";"GO";"BOM JARDIM DE GOIAS";159;7;38;204
2016;"BOM JESUS (GO)";"GO";"BOM JESUS";440;67;121;628
2016;"BONFINOPOLIS (GO)";"GO";"BONFINOPOLIS";69;6;11;86
2016;"BONOPOLIS (GO)";"GO";"BONOPOLIS";21;5;10;36
2016;"BRAZABRANTES (GO)";"GO";"BRAZABRANTES";71;3;5;79
2016;"BRITANIA (GO)";"GO";"BRITANIA";96;9;12;117
2016;"BURITI ALEGRE (GO)";"GO";"BURITI ALEGRE";241;38;21;300
2016;"BURITI DE GOIAS (GO)";"GO";"BURITI DE GOIAS";20;8;2;30
2016;"BURITINOPOLIS (GO)";"GO";"BURITINOPOLIS";28;3;8;39
2016;"CABECEIRAS (GO)";"GO";"CABECEIRAS";163;9;31;203
2016;"CACHOEIRA ALTA (GO)";"GO";"CACHOEIRA ALTA";169;24;91;284
2016;"CACHOEIRA DE GOIAS (GO)";"GO";"CACHOEIRA DE GOIAS";9;3;2;14
2016;"CACHOEIRA DOURADA (GO)";"GO";"CACHOEIRA DOURADA";118;14;36;168
2016;"CACU (GO)";"GO";"CACU";289;29;40;358
2016;"CAIAPONIA (GO)";"GO";"CAIAPONIA";241;13;14;268
2016;"CALDAS NOVAS (GO)";"GO";"CALDAS NOVAS";835;118;119;1072
2016;"CALDAZINHA (GO)";"GO";"CALDAZINHA";38;4;3;45
2016;"CAMPESTRE DE GOIAS (GO)";"GO";"CAMPESTRE DE GOIAS";53;1;7;61
2016;"CAMPINACU (GO)";"GO";"CAMPINACU";46;2;6;54
2016;"CAMPINORTE (GO)";"GO";"CAMPINORTE";201;20;18;239
2016;"CAMPO ALEGRE DE GOIAS (GO)";"GO";"CAMPO ALEGRE DE GOIAS";165;20;27;212
2016;"CAMPO LIMPO DE GOIAS (GO)";"GO";"CAMPO LIMPO DE GOIAS";172;2;7;181
2016;"CAMPOS BELOS (GO)";"GO";"CAMPOS BELOS";300;17;56;373
2016;"CAMPOS VERDES (GO)";"GO";"CAMPOS VERDES";42;8;2;52
2016;"CARMO DO RIO VERDE (GO)";"GO";"CARMO DO RIO VERDE";103;16;53;172
2016;"CASTELANDIA (GO)";"GO";"CASTELANDIA";64;6;8;78
2016;"CATALAO (GO)";"GO";"CATALAO";2052;205;387;2644
2016;"CATURAI (GO)";"GO";"CATURAI";62;5;8;75
2016;"CAVALCANTE (GO)";"GO";"CAVALCANTE";49;3;5;57
2016;"CERES (GO)";"GO";"CERES";506;28;47;581
2016;"CEZARINA (GO)";"GO";"CEZARINA";149;10;23;182
2016;"CHAPADAO DO CEU (GO)";"GO";"CHAPADAO DO CEU";343;19;32;394
2016;"CIDADE OCIDENTAL (GO)";"GO";"CIDADE OCIDENTAL";184;74;99;357
2016;"COCALZINHO DE GOIAS (GO)";"GO";"COCALZINHO DE GOIAS";232;30;34;296
2016;"COLINAS DO SUL (GO)";"GO";"COLINAS DO SUL";24;4;1;29
2016;"CORREGO DO OURO (GO)";"GO";"CORREGO DO OURO";17;3;3;23
2016;"CORUMBA DE GOIAS (GO)";"GO";"CORUMBA DE GOIAS";112;20;32;164
2016;"CORUMBAIBA (GO)";"GO";"CORUMBAIBA";163;24;10;197
2016;"CRISTALINA (GO)";"GO";"CRISTALINA";1870;117;497;2484
2016;"CRISTIANOPOLIS (GO)";"GO";"CRISTIANOPOLIS";67;7;4;78
2016;"CRIXAS (GO)";"GO";"CRIXAS";175;20;22;217
2016;"CROMINIA (GO)";"GO";"CROMINIA";60;7;4;71
2016;"CUMARI (GO)";"GO";"CUMARI";27;8;4;39
2016;"DAMIANOPOLIS (GO)";"GO";"DAMIANOPOLIS";31;4;17;52
2016;"DAMOLANDIA (GO)";"GO";"DAMOLANDIA";57;6;7;70
2016;"DAVINOPOLIS (GO)";"GO";"DAVINOPOLIS";29;4;4;37
2016;"DIORAMA (GO)";"GO";"DIORAMA";15;5;7;27
2016;"DIVINOPOLIS DE GOIAS (GO)";"GO";"DIVINOPOLIS DE GOIAS";33;5;10;48
2016;"DOVERLANDIA (GO)";"GO";"DOVERLANDIA";150;13;38;201
2016;"EDEALINA (GO)";"GO";"EDEALINA";83;15;13;111
2016;"EDEIA (GO)";"GO";"EDEIA";262;10;28;300
2016;"ESTRELA DO NORTE (GO)";"GO";"ESTRELA DO NORTE";43;1;2;46
2016;"FAINA (GO)";"GO";"FAINA";68;18;9;95
2016;"FAZENDA NOVA (GO)";"GO";"FAZENDA NOVA";49;8;9;66
2016;"FIRMINOPOLIS (GO)";"GO";"FIRMINOPOLIS";119;5;6;130
2016;"FLORES DE GOIAS (GO)";"GO";"FLORES DE GOIAS";53;5;11;69
2016;"FORMOSA (GO)";"GO";"FORMOSA";3400;205;680;4285
2016;"FORMOSO (GO)";"GO";"FORMOSO";56;6;9;71
2016;"GAMELEIRA DE GOIAS (GO)";"GO";"GAMELEIRA DE GOIAS";36;4;19;59
2016;"GOIANAPOLIS (GO)";"GO";"GOIANAPOLIS";262;26;29;317
2016;"GOIANDIRA (GO)";"GO";"GOIANDIRA";54;9;5;68
2016;"GOIANESIA (GO)";"GO";"GOIANESIA";1099;108;293;1500
2016;"GOIANIA (GO)";"GO";"GOIANIA";25047;2033;6733;33813
2016;"GOIANIRA (GO)";"GO";"GOIANIRA";406;26;92;524
2016;"GOIAS (GO)";"GO";"GOIAS";285;20;51;356
2016;"GOIATUBA (GO)";"GO";"GOIATUBA";808;52;132;992
2016;"GOUVELANDIA (GO)";"GO";"GOUVELANDIA";65;11;12;88
2016;"GUAPO (GO)";"GO";"GUAPO";254;27;61;342
2016;"GUARAITA (GO)";"GO";"GUARAITA";24;3;3;30
2016;"GUARANI DE GOIAS (GO)";"GO";"GUARANI DE GOIAS";15;5;9;29
2016;"GUARINOS (GO)";"GO";"GUARINOS";12;7;3;22
2016;"HEITORAI (GO)";"GO";"HEITORAI";39;3;5;47
2016;"HIDROLANDIA (GO)";"GO";"HIDROLANDIA";656;34;47;737
2016;"HIDROLINA (GO)";"GO";"HIDROLINA";28;1;4;33
2016;"IACIARA (GO)";"GO";"IACIARA";148;13;25;186
2016;"INACIOLANDIA (GO)";"GO";"INACIOLANDIA";65;5;16;86
2016;"INDIARA (GO)";"GO";"INDIARA";254;16;37;307
2016;"INHUMAS (GO)";"GO";"INHUMAS";1191;91;194;1476
2016;"IPAMERI (GO)";"GO";"IPAMERI";420;82;89;591
2016;"IPIRANGA DE GOIAS (GO)";"GO";"IPIRANGA DE GOIAS";32;8;6;46
2016;"IPORA (GO)";"GO";"IPORA";550;45;57;652
2016;"ISRAELANDIA (GO)";"GO";"ISRAELANDIA";43;4;8;55
2016;"ITABERAI (GO)";"GO";"ITABERAI";881;47;100;1028
2016;"ITAGUARI (GO)";"GO";"ITAGUARI";60;14;12;86
2016;"ITAGUARU (GO)";"GO";"ITAGUARU";116;12;12;140
2016;"ITAJA (GO)";"GO";"ITAJA";123;8;20;151
2016;"ITAPACI (GO)";"GO";"ITAPACI";230;24;103;357
2016;"ITAPIRAPUA (GO)";"GO";"ITAPIRAPUA";73;6;12;91
2016;"ITAPURANGA (GO)";"GO";"ITAPURANGA";419;32;75;526
2016;"ITARUMA (GO)";"GO";"ITARUMA";105;21;18;144
2016;"ITAUCU (GO)";"GO";"ITAUCU";139;10;14;163
2016;"ITUMBIARA (GO)";"GO";"ITUMBIARA";2066;246;406;2718
2016;"IVOLANDIA (GO)";"GO";"IVOLANDIA";12;4;1;17
2016;"JANDAIA (GO)";"GO";"JANDAIA";119;8;18;145
2016;"JARAGUA (GO)";"GO";"JARAGUA";479;39;43;561
2016;"JATAI (GO)";"GO";"JATAI";2390;167;276;2833
2016;"JAUPACI (GO)";"GO";"JAUPACI";29;4;7;40
2016;"JESUPOLIS (GO)";"GO";"JESUPOLIS";23;4;7;34
2016;"JOVIANIA (GO)";"GO";"JOVIANIA";140;18;21;179
2016;"JUSSARA (GO)";"GO";"JUSSARA";460;22;26;508
2016;"LAGOA SANTA (GO)";"GO";"LAGOA SANTA";22;4;7;33
2016;"LEOPOLDO DE BULHOES (GO)";"GO";"LEOPOLDO DE BULHOES";212;24;11;247
2016;"LUZIANIA (GO)";"GO";"LUZIANIA";2468;262;550;3280
2016;"MAIRIPOTABA (GO)";"GO";"MAIRIPOTABA";34;6;4;44
2016;"MAMBAI (GO)";"GO";"MAMBAI";92;4;27;123
2016;"MARA ROSA (GO)";"GO";"MARA ROSA";158;11;16;185
2016;"MARZAGAO (GO)";"GO";"MARZAGAO";31;2;3;36
2016;"MATRINCHA (GO)";"GO";"MATRINCHA";47;4;12;63
2016;"MAURILANDIA (GO)";"GO";"MAURILANDIA";395;18;125;538
2016;"MIMOSO DE GOIAS (GO)";"GO";"MIMOSO DE GOIAS";10;6;6;22
2016;"MINACU (GO)";"GO";"MINACU";523;55;46;624
2016;"MINEIROS (GO)";"GO";"MINEIROS";1416;87;186;1689
2016;"MOIPORA (GO)";"GO";"MOIPORA";8;0;1;9
2016;"MONTE ALEGRE DE GOIAS (GO)";"GO";"MONTE ALEGRE DE GOIAS";30;5;8;43
2016;"MONTES CLAROS DE GOIAS (GO)";"GO";"MONTES CLAROS DE GOIAS";108;17;32;157
2016;"MONTIVIDIU (GO)";"GO";"MONTIVIDIU";374;34;76;484
2016;"MONTIVIDIU DO NORTE (GO)";"GO";"MONTIVIDIU DO NORTE";28;5;19;52
2016;"MORRINHOS (GO)";"GO";"MORRINHOS";904;78;151;1133
2016;"MORRO AGUDO DE GOIAS (GO)";"GO";"MORRO AGUDO DE GOIAS";31;5;4;40
2016;"MOSSAMEDES (GO)";"GO";"MOSSAMEDES";50;10;6;66
2016;"MOZARLANDIA (GO)";"GO";"MOZARLANDIA";157;20;41;218
2016;"MUNDO NOVO (GO)";"GO";"MUNDO NOVO";52;6;21;79
2016;"MUTUNOPOLIS (GO)";"GO";"MUTUNOPOLIS";39;4;16;59
2016;"NAZARIO (GO)";"GO";"NAZARIO";116;10;18;144
2016;"NEROPOLIS (GO)";"GO";"NEROPOLIS";613;24;41;678
2016;"NIQUELANDIA (GO)";"GO";"NIQUELANDIA";721;88;159;968
2016;"NOVA AMERICA (GO)";"GO";"NOVA AMERICA";33;2;2;37
2016;"NOVA AURORA (GO)";"GO";"NOVA AURORA";48;7;5;60
2016;"NOVA CRIXAS (GO)";"GO";"NOVA CRIXAS";133;9;41;183
2016;"NOVA GLORIA (GO)";"GO";"NOVA GLORIA";111;9;26;146
2016;"NOVA IGUACU DE GOIAS (GO)";"GO";"NOVA IGUACU DE GOIAS";28;6;6;40
2016;"NOVA ROMA (GO)";"GO";"NOVA ROMA";5;4;6;15
2016;"NOVA VENEZA (GO)";"GO";"NOVA VENEZA";159;15;23;197
2016;"NOVO BRASIL (GO)";"GO";"NOVO BRASIL";27;7;4;38
2016;"NOVO GAMA (GO)";"GO";"NOVO GAMA";430;117;171;718
2016;"NOVO PLANALTO (GO)";"GO";"NOVO PLANALTO";48;11;3;62
2016;"ORIZONA (GO)";"GO";"ORIZONA";239;55;50;344
2016;"OURO VERDE DE GOIAS (GO)";"GO";"OURO VERDE DE GOIAS";103;2;14;119
2016;"OUVIDOR (GO)";"GO";"OUVIDOR";84;5;17;106
2016;"PADRE BERNARDO (GO)";"GO";"PADRE BERNARDO";482;36;94;612
2016;"PALESTINA DE GOIAS (GO)";"GO";"PALESTINA DE GOIAS";24;15;11;50
2016;"PALMEIRAS DE GOIAS (GO)";"GO";"PALMEIRAS DE GOIAS";426;23;119;568
2016;"PALMELO (GO)";"GO";"PALMELO";32;3;6;41
2016;"PALMINOPOLIS (GO)";"GO";"PALMINOPOLIS";73;2;7;82
2016;"PANAMA (GO)";"GO";"PANAMA";70;12;9;91
2016;"PARANAIGUARA (GO)";"GO";"PARANAIGUARA";109;12;16;137
2016;"PARAUNA (GO)";"GO";"PARAUNA";199;31;45;275
2016;"PEROLANDIA (GO)";"GO";"PEROLANDIA";54;9;9;72
2016;"PETROLINA DE GOIAS (GO)";"GO";"PETROLINA DE GOIAS";168;6;21;195
2016;"PILAR DE GOIAS (GO)";"GO";"PILAR DE GOIAS";25;5;7;37
2016;"PIRACANJUBA (GO)";"GO";"PIRACANJUBA";487;42;32;561
2016;"PIRANHAS (GO)";"GO";"PIRANHAS";240;18;43;301
2016;"PIRENOPOLIS (GO)";"GO";"PIRENOPOLIS";319;63;39;421
2016;"PIRES DO RIO (GO)";"GO";"PIRES DO RIO";578;38;56;672
2016;"PLANALTINA (GO)";"GO";"PLANALTINA";750;108;465;1323
2016;"PONTALINA (GO)";"GO";"PONTALINA";320;21;37;378
2016;"PORANGATU (GO)";"GO";"PORANGATU";779;58;89;926
2016;"PORTEIRAO (GO)";"GO";"PORTEIRAO";111;9;54;174
2016;"PORTELANDIA (GO)";"GO";"PORTELANDIA";61;28;4;93
2016;"POSSE (GO)";"GO";"POSSE";740;62;125;927
2016;"PROFESSOR JAMIL (GO)";"GO";"PROFESSOR JAMIL";36;3;6;45
2016;"QUIRINOPOLIS (GO)";"GO";"QUIRINOPOLIS";1000;65;266;1331
2016;"RIALMA (GO)";"GO";"RIALMA";308;27;38;373
2016;"RIANAPOLIS (GO)";"GO";"RIANAPOLIS";99;5;10;114
2016;"RIO QUENTE (GO)";"GO";"RIO QUENTE";54;21;57;132
2016;"RIO VERDE (GO)";"GO";"RIO VERDE";3837;390;589;4816
2016;"RUBIATABA (GO)";"GO";"RUBIATABA";365;30;100;495
2016;"SANCLERLANDIA (GO)";"GO";"SANCLERLANDIA";135;10;9;154
2016;"SANTA BARBARA DE GOIAS (GO)";"GO";"SANTA BARBARA DE GOIAS";124;8;9;141
2016;"SANTA CRUZ DE GOIAS (GO)";"GO";"SANTA CRUZ DE GOIAS";11;4;4;19
2016;"SANTA FE DE GOIAS (GO)";"GO";"SANTA FE DE GOIAS";50;8;5;63
2016;"SANTA HELENA DE GOIAS (GO)";"GO";"SANTA HELENA DE GOIAS";1019;60;280;1359
2016;"SANTA ISABEL (GO)";"GO";"SANTA ISABEL";12;9;6;27
2016;"SANTA RITA DO ARAGUAIA (GO)";"GO";"SANTA RITA DO ARAGUAIA";144;18;9;171
2016;"SANTA RITA DO NOVO DESTINO (GO)";"GO";"SANTA RITA DO NOVO DESTINO";24;14;9;47
2016;"SANTA ROSA DE GOIAS (GO)";"GO";"SANTA ROSA DE GOIAS";36;3;5;44
2016;"SANTA TEREZA DE GOIAS (GO)";"GO";"SANTA TEREZA DE GOIAS";46;4;7;57
2016;"SANTA TEREZINHA DE GOIAS (GO)";"GO";"SANTA TEREZINHA DE GOIAS";116;15;22;153
2016;"SANTO ANTONIO DA BARRA (GO)";"GO";"SANTO ANTONIO DA BARRA";37;17;20;74
2016;"SANTO ANTONIO DE GOIAS (GO)";"GO";"SANTO ANTONIO DE GOIAS";88;8;21;117
2016;"SANTO ANTONIO DO DESCOBERTO (GO)";"GO";"SANTO ANTONIO DO DESCOBERTO";325;73;201;599
2016;"SAO DOMINGOS (GO)";"GO";"SAO DOMINGOS";47;6;40;93
2016;"SAO FRANCISCO DE GOIAS (GO)";"GO";"SAO FRANCISCO DE GOIAS";60;5;13;78
2016;"SAO JOAO D ALIANCA (GO)";"GO";"SAO JOAO D ALIANCA";150;6;23;179
2016;"SAO JOAO DA PARAUNA (GO)";"GO";"SAO JOAO DA PARAUNA";25;2;3;30
2016;"SAO LUIS DE MONTES BELOS (GO)";"GO";"SAO LUIS DE MONTES BELOS";490;32;91;613
2016;"SAO LUIZ DO NORTE (GO)";"GO";"SAO LUIZ DO NORTE";68;10;19;97
2016;"SAO MIGUEL DO ARAGUAIA (GO)";"GO";"SAO MIGUEL DO ARAGUAIA";365;25;71;461
2016;"SAO MIGUEL DO PASSA QUATRO (GO)";"GO";"SAO MIGUEL DO PASSA QUATRO";58;2;5;65
2016;"SAO PATRICIO (GO)";"GO";"SAO PATRICIO";13;2;4;19
2016;"SAO SIMAO (GO)";"GO";"SAO SIMAO";240;38;65;343
2016;"SENADOR CANEDO (GO)";"GO";"SENADOR CANEDO";928;108;91;1127
2016;"SERRANOPOLIS (GO)";"GO";"SERRANOPOLIS";124;13;22;159
2016;"SILVANIA (GO)";"GO";"SILVANIA";430;43;52;525
2016;"SIMOLANDIA (GO)";"GO";"SIMOLANDIA";152;4;10;166
2016;"SITIO D ABADIA (GO)";"GO";"SITIO D ABADIA";13;1;8;22
2016;"TAQUARAL DE GOIAS (GO)";"GO";"TAQUARAL DE GOIAS";34;4;7;45
2016;"TERESINA DE GOIAS (GO)";"GO";"TERESINA DE GOIAS";16;1;2;19
2016;"TEREZOPOLIS DE GOIAS (GO)";"GO";"TEREZOPOLIS DE GOIAS";103;4;28;135
2016;"TRES RANCHOS (GO)";"GO";"TRES RANCHOS";45;9;5;59
2016;"TRINDADE (GO)";"GO";"TRINDADE";1266;89;142;1497
2016;"TROMBAS (GO)";"GO";"TROMBAS";39;4;14;57
2016;"TURVANIA (GO)";"GO";"TURVANIA";64;6;8;78
2016;"TURVELANDIA (GO)";"GO";"TURVELANDIA";66;12;22;100
2016;"UIRAPURU (GO)";"GO";"UIRAPURU";20;10;7;37
2016;"URUACU (GO)";"GO";"URUACU";674;41;99;814
2016;"URUANA (GO)";"GO";"URUANA";313;8;18;339
2016;"URUTAI (GO)";"GO";"URUTAI";31;2;10;43
2016;"VALPARAISO DE GOIAS (GO)";"GO";"VALPARAISO DE GOIAS";755;238;254;1247
2016;"VARJAO (GO)";"GO";"VARJAO";60;0;8;68
2016;"VIANOPOLIS (GO)";"GO";"VIANOPOLIS";601;35;43;679
2016;"VICENTINOPOLIS (GO)";"GO";"VICENTINOPOLIS";212;11;67;290
2016;"VILA BOA (GO)";"GO";"VILA BOA";35;3;23;61
2016;"VILA PROPICIO (GO)";"GO";"VILA PROPICIO";28;17;25;70
2016;"ACAILANDIA (MA)";"MA";"ACAILANDIA";1701;123;216;2040
2016;"AFONSO CUNHA (MA)";"MA";"AFONSO CUNHA";10;1;5;16
2016;"AGUA DOCE DO MARANHAO (MA)";"MA";"AGUA DOCE DO MARANHAO";3;2;9;14
2016;"ALCANTARA (MA)";"MA";"ALCANTARA";52;22;35;109
2016;"ALDEIAS ALTAS (MA)";"MA";"ALDEIAS ALTAS";46;3;22;71
2016;"ALTAMIRA DO MARANHAO (MA)";"MA";"ALTAMIRA DO MARANHAO";23;3;2;28
2016;"ALTO ALEGRE DO MARANHAO (MA)";"MA";"ALTO ALEGRE DO MARANHAO";60;30;3;93
2016;"ALTO ALEGRE DO PINDARE (MA)";"MA";"ALTO ALEGRE DO PINDARE";45;10;4;59
2016;"ALTO PARNAIBA (MA)";"MA";"ALTO PARNAIBA";76;3;7;86
2016;"AMAPA DO MARANHAO (MA)";"MA";"AMAPA DO MARANHAO";18;2;3;23
2016;"AMARANTE DO MARANHAO (MA)";"MA";"AMARANTE DO MARANHAO";127;7;8;142
2016;"ANAJATUBA (MA)";"MA";"ANAJATUBA";43;7;11;61
2016;"ANAPURUS (MA)";"MA";"ANAPURUS";59;1;18;78
2016;"APICUM ACU (MA)";"MA";"APICUM ACU";18;10;3;31
2016;"ARAGUANA (MA)";"MA";"ARAGUANA";14;0;7;21
2016;"ARAIOSES (MA)";"MA";"ARAIOSES";35;6;27;68
2016;"ARAME (MA)";"MA";"ARAME";112;10;4;126
2016;"ARARI (MA)";"MA";"ARARI";106;8;11;125
2016;"AXIXA (MA)";"MA";"AXIXA";23;6;11;40
2016;"BACABAL (MA)";"MA";"BACABAL";936;97;94;1127
2016;"BACABEIRA (MA)";"MA";"BACABEIRA";123;9;33;165
2016;"BACURI (MA)";"MA";"BACURI";13;8;6;27
2016;"BACURITUBA (MA)";"MA";"BACURITUBA";4;0;5;9
2016;"BALSAS (MA)";"MA";"BALSAS";1845;62;140;2047
2016;"BARAO DE GRAJAU (MA)";"MA";"BARAO DE GRAJAU";78;4;11;93
2016;"BARRA DO CORDA (MA)";"MA";"BARRA DO CORDA";746;27;19;792
2016;"BARREIRINHAS (MA)";"MA";"BARREIRINHAS";95;7;23;125
2016;"BELA VISTA DO MARANHAO (MA)";"MA";"BELA VISTA DO MARANHAO";50;5;4;59
2016;"BELAGUA (MA)";"MA";"BELAGUA";2;6;2;10
2016;"BENEDITO LEITE (MA)";"MA";"BENEDITO LEITE";8;5;2;15
2016;"BEQUIMAO (MA)";"MA";"BEQUIMAO";96;13;19;128
2016;"BERNARDO DO MEARIM (MA)";"MA";"BERNARDO DO MEARIM";41;1;4;46
2016;"BOA VISTA DO GURUPI (MA)";"MA";"BOA VISTA DO GURUPI";10;5;3;18
2016;"BOM JARDIM (MA)";"MA";"BOM JARDIM";128;11;8;147
2016;"BOM JESUS DAS SELVAS (MA)";"MA";"BOM JESUS DAS SELVAS";144;6;7;157
2016;"BOM LUGAR (MA)";"MA";"BOM LUGAR";35;15;12;62
2016;"BREJO (MA)";"MA";"BREJO";82;18;14;114
2016;"BREJO DE AREIA (MA)";"MA";"BREJO DE AREIA";25;3;6;34
2016;"BURITI (MA)";"MA";"BURITI";27;12;20;59
2016;"BURITI BRAVO (MA)";"MA";"BURITI BRAVO";47;2;8;57
2016;"BURITICUPU (MA)";"MA";"BURITICUPU";503;48;19;570
2016;"BURITIRANA (MA)";"MA";"BURITIRANA";30;2;2;34
2016;"CACHOEIRA GRANDE (MA)";"MA";"CACHOEIRA GRANDE";8;2;5;15
2016;"CAJAPIO (MA)";"MA";"CAJAPIO";10;1;2;13
2016;"CAJARI (MA)";"MA";"CAJARI";10;3;5;18
2016;"CAMPESTRE DO MARANHAO (MA)";"MA";"CAMPESTRE DO MARANHAO";38;17;15;70
2016;"CANDIDO MENDES (MA)";"MA";"CANDIDO MENDES";11;8;3;22
2016;"CANTANHEDE (MA)";"MA";"CANTANHEDE";26;3;8;37
2016;"CAPINZAL DO NORTE (MA)";"MA";"CAPINZAL DO NORTE";41;16;2;59
2016;"CAROLINA (MA)";"MA";"CAROLINA";91;4;11;106
2016;"CARUTAPERA (MA)";"MA";"CARUTAPERA";31;17;12;60
2016;"CAXIAS (MA)";"MA";"CAXIAS";925;72;167;1164
2016;"CEDRAL (MA)";"MA";"CEDRAL";14;0;7;21
2016;"CENTRAL DO MARANHAO (MA)";"MA";"CENTRAL DO MARANHAO";13;5;4;22
2016;"CENTRO DO GUILHERME (MA)";"MA";"CENTRO DO GUILHERME";19;0;4;23
2016;"CENTRO NOVO DO MARANHAO (MA)";"MA";"CENTRO NOVO DO MARANHAO";31;2;10;43
2016;"CHAPADINHA (MA)";"MA";"CHAPADINHA";385;31;24;440
2016;"CIDELANDIA (MA)";"MA";"CIDELANDIA";66;9;12;87
2016;"CODO (MA)";"MA";"CODO";671;32;43;746
2016;"COELHO NETO (MA)";"MA";"COELHO NETO";116;17;45;178
2016;"COLINAS (MA)";"MA";"COLINAS";173;17;19;209
2016;"CONCEICAO DO LAGO ACU (MA)";"MA";"CONCEICAO DO LAGO ACU";27;3;1;31
2016;"COROATA (MA)";"MA";"COROATA";210;51;14;275
2016;"CURURUPU (MA)";"MA";"CURURUPU";39;12;8;59
2016;"DAVINOPOLIS (MA)";"MA";"DAVINOPOLIS";85;3;5;93
2016;"DOM PEDRO (MA)";"MA";"DOM PEDRO";458;9;37;504
2016;"DUQUE BACELAR (MA)";"MA";"DUQUE BACELAR";4;2;8;14
2016;"ESPERANTINOPOLIS (MA)";"MA";"ESPERANTINOPOLIS";93;14;1;108
2016;"ESTREITO (MA)";"MA";"ESTREITO";185;17;19;221
2016;"FEIRA NOVA DO MARANHAO (MA)";"MA";"FEIRA NOVA DO MARANHAO";16;0;5;21
2016;"FERNANDO FALCAO (MA)";"MA";"FERNANDO FALCAO";20;0;5;25
2016;"FORMOSA DA SERRA NEGRA (MA)";"MA";"FORMOSA DA SERRA NEGRA";40;5;8;53
2016;"FORTALEZA DOS NOGUEIRAS (MA)";"MA";"FORTALEZA DOS NOGUEIRAS";96;9;9;114
2016;"FORTUNA (MA)";"MA";"FORTUNA";43;16;4;63
2016;"GODOFREDO VIANA (MA)";"MA";"GODOFREDO VIANA";12;11;12;35
2016;"GONCALVES DIAS (MA)";"MA";"GONCALVES DIAS";65;5;10;80
2016;"GOVERNADOR ARCHER (MA)";"MA";"GOVERNADOR ARCHER";33;10;7;50
2016;"GOVERNADOR EDISON LOBAO (MA)";"MA";"GOVERNADOR EDISON LOBAO";89;1;11;101
2016;"GOVERNADOR EUGENIO BARROS (MA)";"MA";"GOVERNADOR EUGENIO BARROS";55;11;17;83
2016;"GOVERNADOR LUIZ ROCHA (MA)";"MA";"GOVERNADOR LUIZ ROCHA";20;3;5;28
2016;"GOVERNADOR NEWTON BELLO (MA)";"MA";"GOVERNADOR NEWTON BELLO";21;0;1;22
2016;"GOVERNADOR NUNES FREIRE (MA)";"MA";"GOVERNADOR NUNES FREIRE";95;7;7;109
2016;"GRACA ARANHA (MA)";"MA";"GRACA ARANHA";18;4;5;27
2016;"GRAJAU (MA)";"MA";"GRAJAU";530;32;48;610
2016;"GUIMARAES (MA)";"MA";"GUIMARAES";19;3;18;40
2016;"HUMBERTO DE CAMPOS (MA)";"MA";"HUMBERTO DE CAMPOS";22;9;8;39
2016;"ICATU (MA)";"MA";"ICATU";24;3;7;34
2016;"IGARAPE DO MEIO (MA)";"MA";"IGARAPE DO MEIO";32;5;9;46
2016;"IGARAPE GRANDE (MA)";"MA";"IGARAPE GRANDE";68;9;8;85
2016;"IMPERATRIZ (MA)";"MA";"IMPERATRIZ";4016;268;450;4734
2016;"ITAIPAVA DO GRAJAU (MA)";"MA";"ITAIPAVA DO GRAJAU";31;5;7;43
2016;"ITAPECURU MIRIM (MA)";"MA";"ITAPECURU MIRIM";405;36;36;477
2016;"ITINGA DO MARANHAO (MA)";"MA";"ITINGA DO MARANHAO";161;9;10;180
2016;"JATOBA (MA)";"MA";"JATOBA";5;2;5;12
2016;"JENIPAPO DOS VIEIRAS (MA)";"MA";"JENIPAPO DOS VIEIRAS";57;2;10;69
2016;"JOAO LISBOA (MA)";"MA";"JOAO LISBOA";136;6;7;149
2016;"JOSELANDIA (MA)";"MA";"JOSELANDIA";74;13;8;95
2016;"JUNCO DO MARANHAO (MA)";"MA";"JUNCO DO MARANHAO";12;15;3;30
2016;"LAGO DA PEDRA (MA)";"MA";"LAGO DA PEDRA";310;44;18;372
2016;"LAGO DO JUNCO (MA)";"MA";"LAGO DO JUNCO";19;2;12;33
2016;"LAGO DOS RODRIGUES (MA)";"MA";"LAGO DOS RODRIGUES";48;11;7;66
2016;"LAGO VERDE (MA)";"MA";"LAGO VERDE";35;0;11;46
2016;"LAGOA DO MATO (MA)";"MA";"LAGOA DO MATO";28;0;11;39
2016;"LAGOA GRANDE DO MARANHAO (MA)";"MA";"LAGOA GRANDE DO MARANHAO";36;1;2;39
2016;"LAJEADO NOVO (MA)";"MA";"LAJEADO NOVO";26;5;4;35
2016;"LIMA CAMPOS (MA)";"MA";"LIMA CAMPOS";87;33;8;128
2016;"LORETO (MA)";"MA";"LORETO";28;4;9;41
2016;"LUIS DOMINGUES (MA)";"MA";"LUIS DOMINGUES";5;2;4;11
2016;"MAGALHAES DE ALMEIDA (MA)";"MA";"MAGALHAES DE ALMEIDA";20;2;11;33
2016;"MARACACUME (MA)";"MA";"MARACACUME";82;51;3;136
2016;"MARAJA DO SENA (MA)";"MA";"MARAJA DO SENA";13;0;1;14
2016;"MARANHAOZINHO (MA)";"MA";"MARANHAOZINHO";43;2;3;48
2016;"MATA ROMA (MA)";"MA";"MATA ROMA";45;8;20;73
2016;"MATINHA (MA)";"MA";"MATINHA";52;9;7;68
2016;"MATOES (MA)";"MA";"MATOES";43;5;22;70
2016;"MATOES DO NORTE (MA)";"MA";"MATOES DO NORTE";23;5;6;34
2016;"MILAGRES DO MARANHAO (MA)";"MA";"MILAGRES DO MARANHAO";8;3;7;18
2016;"MIRADOR (MA)";"MA";"MIRADOR";39;3;3;45
2016;"MIRANDA DO NORTE (MA)";"MA";"MIRANDA DO NORTE";155;9;13;177
2016;"MIRINZAL (MA)";"MA";"MIRINZAL";48;6;6;60
2016;"MONCAO (MA)";"MA";"MONCAO";30;7;8;45
2016;"MONTES ALTOS (MA)";"MA";"MONTES ALTOS";38;0;2;40
2016;"MORROS (MA)";"MA";"MORROS";22;4;6;32
2016;"NINA RODRIGUES (MA)";"MA";"NINA RODRIGUES";11;3;6;20
2016;"NOVA COLINAS (MA)";"MA";"NOVA COLINAS";19;2;12;33
2016;"NOVA IORQUE (MA)";"MA";"NOVA IORQUE";12;1;2;15
2016;"NOVA OLINDA DO MARANHAO (MA)";"MA";"NOVA OLINDA DO MARANHAO";56;14;7;77
2016;"OLHO D AGUA DAS CUNHAS (MA)";"MA";"OLHO D AGUA DAS CUNHAS";75;18;12;105
2016;"OLINDA NOVA DO MARANHAO (MA)";"MA";"OLINDA NOVA DO MARANHAO";35;1;10;46
2016;"PACO DO LUMIAR (MA)";"MA";"PACO DO LUMIAR";461;130;152;743
2016;"PALMEIRANDIA (MA)";"MA";"PALMEIRANDIA";25;2;11;38
2016;"PARAIBANO (MA)";"MA";"PARAIBANO";83;16;7;106
2016;"PARNARAMA (MA)";"MA";"PARNARAMA";51;3;5;59
2016;"PASSAGEM FRANCA (MA)";"MA";"PASSAGEM FRANCA";43;7;7;57
2016;"PASTOS BONS (MA)";"MA";"PASTOS BONS";142;12;10;164
2016;"PAULINO NEVES (MA)";"MA";"PAULINO NEVES";10;1;12;23
2016;"PAULO RAMOS (MA)";"MA";"PAULO RAMOS";85;9;6;100
2016;"PEDREIRAS (MA)";"MA";"PEDREIRAS";394;67;45;506
2016;"PEDRO DO ROSARIO (MA)";"MA";"PEDRO DO ROSARIO";20;1;6;27
2016;"PENALVA (MA)";"MA";"PENALVA";41;3;4;48
2016;"PERI MIRIM (MA)";"MA";"PERI MIRIM";26;12;8;46
2016;"PERITORO (MA)";"MA";"PERITORO";57;71;11;139
2016;"PINDARE MIRIM (MA)";"MA";"PINDARE MIRIM";104;17;15;136
2016;"PINHEIRO (MA)";"MA";"PINHEIRO";498;42;91;631
2016;"PIO XII (MA)";"MA";"PIO XII";125;6;8;139
2016;"PIRAPEMAS (MA)";"MA";"PIRAPEMAS";24;6;3;33
2016;"POCAO DE PEDRAS (MA)";"MA";"POCAO DE PEDRAS";51;17;6;74
2016;"PORTO FRANCO (MA)";"MA";"PORTO FRANCO";114;17;12;143
2016;"PORTO RICO DO MARANHAO (MA)";"MA";"PORTO RICO DO MARANHAO";4;1;3;8
2016;"PRESIDENTE DUTRA (MA)";"MA";"PRESIDENTE DUTRA";508;26;29;563
2016;"PRESIDENTE JUSCELINO (MA)";"MA";"PRESIDENTE JUSCELINO";8;2;4;14
2016;"PRESIDENTE MEDICI (MA)";"MA";"PRESIDENTE MEDICI";15;6;3;24
2016;"PRESIDENTE SARNEY (MA)";"MA";"PRESIDENTE SARNEY";17;9;8;34
2016;"PRESIDENTE VARGAS (MA)";"MA";"PRESIDENTE VARGAS";24;5;5;34
2016;"PRIMEIRA CRUZ (MA)";"MA";"PRIMEIRA CRUZ";2;1;4;7
2016;"RAPOSA (MA)";"MA";"RAPOSA";121;5;61;187
2016;"RIACHAO (MA)";"MA";"RIACHAO";97;13;19;129
2016;"RIBAMAR FIQUENE (MA)";"MA";"RIBAMAR FIQUENE";28;3;4;35
2016;"ROSARIO (MA)";"MA";"ROSARIO";224;26;55;305
2016;"SAMBAIBA (MA)";"MA";"SAMBAIBA";26;5;7;38
2016;"SANTA FILOMENA DO MARANHAO (MA)";"MA";"SANTA FILOMENA DO MARANHAO";8;7;6;21
2016;"SANTA HELENA (MA)";"MA";"SANTA HELENA";106;12;14;132
2016;"SANTA INES (MA)";"MA";"SANTA INES";883;187;119;1189
2016;"SANTA LUZIA (MA)";"MA";"SANTA LUZIA";299;93;14;406
2016;"SANTA LUZIA DO PARUA (MA)";"MA";"SANTA LUZIA DO PARUA";144;15;13;172
2016;"SANTA QUITERIA DO MARANHAO (MA)";"MA";"SANTA QUITERIA DO MARANHAO";47;3;17;67
2016;"SANTA RITA (MA)";"MA";"SANTA RITA";175;11;19;205
2016;"SANTANA DO MARANHAO (MA)";"MA";"SANTANA DO MARANHAO";11;2;7;20
2016;"SANTO AMARO DO MARANHAO (MA)";"MA";"SANTO AMARO DO MARANHAO";4;6;2;12
2016;"SANTO ANTONIO DOS LOPES (MA)";"MA";"SANTO ANTONIO DOS LOPES";116;10;12;138
2016;"SAO BENEDITO DO RIO PRETO (MA)";"MA";"SAO BENEDITO DO RIO PRETO";22;9;4;35
2016;"SAO BENTO (MA)";"MA";"SAO BENTO";159;43;19;221
2016;"SAO BERNARDO (MA)";"MA";"SAO BERNARDO";94;9;21;124
2016;"SAO DOMINGOS DO AZEITAO (MA)";"MA";"SAO DOMINGOS DO AZEITAO";53;3;2;58
2016;"SAO DOMINGOS DO MARANHAO (MA)";"MA";"SAO DOMINGOS DO MARANHAO";237;4;21;262
2016;"SAO FELIX DE BALSAS (MA)";"MA";"SAO FELIX DE BALSAS";8;2;2;12
2016;"SAO FRANCISCO DO BREJAO (MA)";"MA";"SAO FRANCISCO DO BREJAO";63;2;4;69
2016;"SAO FRANCISCO DO MARANHAO (MA)";"MA";"SAO FRANCISCO DO MARANHAO";11;0;2;13
2016;"SAO JOAO BATISTA (MA)";"MA";"SAO JOAO BATISTA";34;6;10;50
2016;"SAO JOAO DO CARU (MA)";"MA";"SAO JOAO DO CARU";33;1;2;36
2016;"SAO JOAO DO PARAISO (MA)";"MA";"SAO JOAO DO PARAISO";21;6;6;33
2016;"SAO JOAO DO SOTER (MA)";"MA";"SAO JOAO DO SOTER";30;2;9;41
2016;"SAO JOAO DOS PATOS (MA)";"MA";"SAO JOAO DOS PATOS";206;9;7;222
2016;"SAO JOSE DE RIBAMAR (MA)";"MA";"SAO JOSE DE RIBAMAR";889;160;293;1342
2016;"SAO JOSE DOS BASILIOS (MA)";"MA";"SAO JOSE DOS BASILIOS";17;3;4;24
2016;"SAO LUIS (MA)";"MA";"SAO LUIS";9802;1438;4406;15646
2016;"SAO LUIS GONZAGA DO MARANHAO (MA)";"MA";"SAO LUIS GONZAGA DO MARANHAO";39;13;9;61
2016;"SAO MATEUS DO MARANHAO (MA)";"MA";"SAO MATEUS DO MARANHAO";129;42;24;195
2016;"SAO PEDRO DA AGUA BRANCA (MA)";"MA";"SAO PEDRO DA AGUA BRANCA";18;6;6;30
2016;"SAO PEDRO DOS CRENTES (MA)";"MA";"SAO PEDRO DOS CRENTES";35;1;8;44
2016;"SAO RAIMUNDO DAS MANGABEIRAS (MA)";"MA";"SAO RAIMUNDO DAS MANGABEIRAS";167;13;52;232
2016;"SAO RAIMUNDO DO DOCA BEZERRA (MA)";"MA";"SAO RAIMUNDO DO DOCA BEZERRA";18;0;1;19
2016;"SAO ROBERTO (MA)";"MA";"SAO ROBERTO";19;6;3;28
2016;"SAO VICENTE FERRER (MA)";"MA";"SAO VICENTE FERRER";31;2;5;38
2016;"SATUBINHA (MA)";"MA";"SATUBINHA";16;6;2;24
2016;"SENADOR ALEXANDRE COSTA (MA)";"MA";"SENADOR ALEXANDRE COSTA";27;10;6;43
2016;"SENADOR LA ROCQUE (MA)";"MA";"SENADOR LA ROCQUE";79;0;3;82
2016;"SERRANO DO MARANHAO (MA)";"MA";"SERRANO DO MARANHAO";6;1;6;13
2016;"SITIO NOVO (MA)";"MA";"SITIO NOVO";72;5;7;84
2016;"SUCUPIRA DO NORTE (MA)";"MA";"SUCUPIRA DO NORTE";23;4;5;32
2016;"SUCUPIRA DO RIACHAO (MA)";"MA";"SUCUPIRA DO RIACHAO";11;6;6;23
2016;"TASSO FRAGOSO (MA)";"MA";"TASSO FRAGOSO";84;5;7;96
2016;"TIMBIRAS (MA)";"MA";"TIMBIRAS";42;4;5;51
2016;"TIMON (MA)";"MA";"TIMON";701;50;158;909
2016;"TRIZIDELA DO VALE (MA)";"MA";"TRIZIDELA DO VALE";166;32;10;208
2016;"TUFILANDIA (MA)";"MA";"TUFILANDIA";9;6;1;16
2016;"TUNTUM (MA)";"MA";"TUNTUM";143;7;16;166
2016;"TURIACU (MA)";"MA";"TURIACU";43;5;7;55
2016;"TURILANDIA (MA)";"MA";"TURILANDIA";13;4;3;20
2016;"TUTOIA (MA)";"MA";"TUTOIA";91;20;11;122
2016;"URBANO SANTOS (MA)";"MA";"URBANO SANTOS";82;8;20;110
2016;"VARGEM GRANDE (MA)";"MA";"VARGEM GRANDE";141;9;16;166
2016;"VIANA (MA)";"MA";"VIANA";230;13;6;249
2016;"VILA NOVA DOS MARTIRIOS (MA)";"MA";"VILA NOVA DOS MARTIRIOS";40;6;6;52
2016;"VITORIA DO MEARIM (MA)";"MA";"VITORIA DO MEARIM";110;9;9;128
2016;"VITORINO FREIRE (MA)";"MA";"VITORINO FREIRE";129;8;12;149
2016;"ZE DOCA (MA)";"MA";"ZE DOCA";255;26;35;316
2016;"ABADIA DOS DOURADOS (MG)";"MG";"ABADIA DOS DOURADOS";164;33;13;210
2016;"ABAETE (MG)";"MG";"ABAETE";498;44;183;725
2016;"ABRE CAMPO (MG)";"MG";"ABRE CAMPO";238;14;53;305
2016;"ACAIACA (MG)";"MG";"ACAIACA";35;9;10;54
2016;"ACUCENA (MG)";"MG";"ACUCENA";52;18;37;107
2016;"AGUA BOA (MG)";"MG";"AGUA BOA";79;17;34;130
2016;"AGUA COMPRIDA (MG)";"MG";"AGUA COMPRIDA";34;11;9;54
2016;"AGUANIL (MG)";"MG";"AGUANIL";75;5;10;90
2016;"AGUAS FORMOSAS (MG)";"MG";"AGUAS FORMOSAS";113;30;53;196
2016;"AGUAS VERMELHAS (MG)";"MG";"AGUAS VERMELHAS";90;26;28;144
2016;"AIMORES (MG)";"MG";"AIMORES";197;41;44;282
2016;"AIURUOCA (MG)";"MG";"AIURUOCA";117;29;10;156
2016;"ALAGOA (MG)";"MG";"ALAGOA";37;3;21;61
2016;"ALBERTINA (MG)";"MG";"ALBERTINA";53;19;7;79
2016;"ALEM PARAIBA (MG)";"MG";"ALEM PARAIBA";1525;128;77;1730
2016;"ALFENAS (MG)";"MG";"ALFENAS";1333;156;351;1840
2016;"ALFREDO VASCONCELOS (MG)";"MG";"ALFREDO VASCONCELOS";168;14;30;212
2016;"ALMENARA (MG)";"MG";"ALMENARA";310;92;141;543
2016;"ALPERCATA (MG)";"MG";"ALPERCATA";91;4;7;102
2016;"ALPINOPOLIS (MG)";"MG";"ALPINOPOLIS";491;49;80;620
2016;"ALTEROSA (MG)";"MG";"ALTEROSA";272;34;64;370
2016;"ALTO CAPARAO (MG)";"MG";"ALTO CAPARAO";87;19;22;128
2016;"ALTO JEQUITIBA (MG)";"MG";"ALTO JEQUITIBA";107;9;18;134
2016;"ALTO RIO DOCE (MG)";"MG";"ALTO RIO DOCE";131;35;34;200
2016;"ALVARENGA (MG)";"MG";"ALVARENGA";38;4;15;57
2016;"ALVINOPOLIS (MG)";"MG";"ALVINOPOLIS";227;18;28;273
2016;"ALVORADA DE MINAS (MG)";"MG";"ALVORADA DE MINAS";28;19;18;65
2016;"AMPARO DA SERRA (MG)";"MG";"AMPARO DA SERRA";53;7;36;96
2016;"ANDRADAS (MG)";"MG";"ANDRADAS";1203;110;122;1435
2016;"ANDRELANDIA (MG)";"MG";"ANDRELANDIA";163;39;25;227
2016;"ANGELANDIA (MG)";"MG";"ANGELANDIA";87;13;36;136
2016;"ANTONIO CARLOS (MG)";"MG";"ANTONIO CARLOS";175;28;43;246
2016;"ANTONIO DIAS (MG)";"MG";"ANTONIO DIAS";115;16;57;188
2016;"ANTONIO PRADO DE MINAS (MG)";"MG";"ANTONIO PRADO DE MINAS";21;5;5;31
2016;"ARACAI (MG)";"MG";"ARACAI";17;10;7;34
2016;"ARACITABA (MG)";"MG";"ARACITABA";13;2;3;18
2016;"ARACUAI (MG)";"MG";"ARACUAI";279;16;114;409
2016;"ARAGUARI (MG)";"MG";"ARAGUARI";2581;426;203;3210
2016;"ARANTINA (MG)";"MG";"ARANTINA";40;7;4;51
2016;"ARAPONGA (MG)";"MG";"ARAPONGA";76;8;15;99
2016;"ARAPORA (MG)";"MG";"ARAPORA";216;15;64;295
2016;"ARAPUA (MG)";"MG";"ARAPUA";55;4;15;74
2016;"ARAUJOS (MG)";"MG";"ARAUJOS";154;18;9;181
2016;"ARAXA (MG)";"MG";"ARAXA";1989;232;358;2579
2016;"ARCEBURGO (MG)";"MG";"ARCEBURGO";159;28;71;258
2016;"ARCOS (MG)";"MG";"ARCOS";1269;112;302;1683
2016;"AREADO (MG)";"MG";"AREADO";246;29;88;363
2016;"ARGIRITA (MG)";"MG";"ARGIRITA";27;5;9;41
2016;"ARICANDUVA (MG)";"MG";"ARICANDUVA";28;6;13;47
2016;"ARINOS (MG)";"MG";"ARINOS";467;35;132;634
2016;"ASTOLFO DUTRA (MG)";"MG";"ASTOLFO DUTRA";280;8;25;313
2016;"ATALEIA (MG)";"MG";"ATALEIA";95;30;39;164
2016;"AUGUSTO DE LIMA (MG)";"MG";"AUGUSTO DE LIMA";33;7;23;63
2016;"BAEPENDI (MG)";"MG";"BAEPENDI";416;70;36;522
2016;"BALDIM (MG)";"MG";"BALDIM";203;14;23;240
2016;"BAMBUI (MG)";"MG";"BAMBUI";557;56;90;703
2016;"BANDEIRA (MG)";"MG";"BANDEIRA";19;8;14;41
2016;"BANDEIRA DO SUL (MG)";"MG";"BANDEIRA DO SUL";122;30;10;162
2016;"BARAO DE COCAIS (MG)";"MG";"BARAO DE COCAIS";526;112;91;729
2016;"BARAO D0 MONTE ALTO (MG)";"MG";"BARAO D0 MONTE ALTO";59;7;13;79
2016;"BARBACENA (MG)";"MG";"BARBACENA";1893;335;264;2492
2016;"BARRA LONGA (MG)";"MG";"BARRA LONGA";44;5;11;60
2016;"BARROSO (MG)";"MG";"BARROSO";485;33;41;559
2016;"BELA VISTA DE MINAS (MG)";"MG";"BELA VISTA DE MINAS";175;14;11;200
2016;"BELMIRO BRAGA (MG)";"MG";"BELMIRO BRAGA";77;14;9;100
2016;"BELO HORIZONTE (MG)";"MG";"BELO HORIZONTE";35397;6246;8769;50412
2016;"BELO ORIENTE (MG)";"MG";"BELO ORIENTE";250;27;101;378
2016;"BELO VALE (MG)";"MG";"BELO VALE";243;29;35;307
2016;"BERILO (MG)";"MG";"BERILO";77;7;37;121
2016;"BERIZAL (MG)";"MG";"BERIZAL";37;9;10;56
2016;"BERTOPOLIS (MG)";"MG";"BERTOPOLIS";14;3;4;21
2016;"BETIM (MG)";"MG";"BETIM";6093;765;1416;8274
2016;"BIAS FORTES (MG)";"MG";"BIAS FORTES";31;3;6;40
2016;"BICAS (MG)";"MG";"BICAS";243;37;40;320
2016;"BIQUINHAS (MG)";"MG";"BIQUINHAS";60;7;4;71
2016;"BOA ESPERANCA (MG)";"MG";"BOA ESPERANCA";854;117;214;1185
2016;"BOCAINA DE MINAS (MG)";"MG";"BOCAINA DE MINAS";104;18;13;135
2016;"BOCAIUVA (MG)";"MG";"BOCAIUVA";593;86;215;894
2016;"BOM DESPACHO (MG)";"MG";"BOM DESPACHO";1143;100;473;1716
2016;"BOM JARDIM DE MINAS (MG)";"MG";"BOM JARDIM DE MINAS";148;19;18;185
2016;"BOM JESUS DA PENHA (MG)";"MG";"BOM JESUS DA PENHA";148;20;19;187
2016;"BOM JESUS DO AMPARO (MG)";"MG";"BOM JESUS DO AMPARO";94;8;15;117
2016;"BOM JESUS DO GALHO (MG)";"MG";"BOM JESUS DO GALHO";116;6;22;144
2016;"BOM REPOUSO (MG)";"MG";"BOM REPOUSO";212;14;18;244
2016;"BOM SUCESSO (MG)";"MG";"BOM SUCESSO";239;35;63;337
2016;"BONFIM (MG)";"MG";"BONFIM";164;20;24;208
2016;"BONFINOPOLIS DE MINAS (MG)";"MG";"BONFINOPOLIS DE MINAS";102;4;33;139
2016;"BONITO DE MINAS (MG)";"MG";"BONITO DE MINAS";42;7;35;84
2016;"BORDA DA MATA (MG)";"MG";"BORDA DA MATA";314;42;84;440
2016;"BOTELHOS (MG)";"MG";"BOTELHOS";256;93;49;398
2016;"BOTUMIRIM (MG)";"MG";"BOTUMIRIM";39;7;29;75
2016;"BRAS PIRES (MG)";"MG";"BRAS PIRES";55;9;11;75
2016;"BRASILANDIA DE MINAS (MG)";"MG";"BRASILANDIA DE MINAS";234;20;119;373
2016;"BRASILIA DE MINAS (MG)";"MG";"BRASILIA DE MINAS";306;29;87;422
2016;"BRASOPOLIS (MG)";"MG";"BRASOPOLIS";221;41;47;309
2016;"BRAUNAS (MG)";"MG";"BRAUNAS";20;8;20;48
2016;"BRUMADINHO (MG)";"MG";"BRUMADINHO";950;137;240;1327
2016;"BUENO BRANDAO (MG)";"MG";"BUENO BRANDAO";240;47;24;311
2016;"BUENOPOLIS (MG)";"MG";"BUENOPOLIS";119;14;35;168
2016;"BUGRE (MG)";"MG";"BUGRE";30;3;9;42
2016;"BURITIS (MG)";"MG";"BURITIS";319;13;108;440
2016;"BURITIZEIRO (MG)";"MG";"BURITIZEIRO";274;44;119;437
2016;"CABECEIRA GRANDE (MG)";"MG";"CABECEIRA GRANDE";67;5;13;85
2016;"CABO VERDE (MG)";"MG";"CABO VERDE";193;52;48;293
2016;"CACHOEIRA DA PRATA (MG)";"MG";"CACHOEIRA DA PRATA";58;2;7;67
2016;"CACHOEIRA DE MINAS (MG)";"MG";"CACHOEIRA DE MINAS";141;25;23;189
2016;"CACHOEIRA DE PAJEU (MG)";"MG";"CACHOEIRA DE PAJEU";42;18;22;82
2016;"CACHOEIRA DOURADA (MG)";"MG";"CACHOEIRA DOURADA";16;11;3;30
2016;"CAETANOPOLIS (MG)";"MG";"CAETANOPOLIS";155;20;51;226
2016;"CAETE (MG)";"MG";"CAETE";573;139;66;778
2016;"CAIANA (MG)";"MG";"CAIANA";53;12;14;79
2016;"CAJURI (MG)";"MG";"CAJURI";63;9;12;84
2016;"CALDAS (MG)";"MG";"CALDAS";313;49;32;394
2016;"CAMACHO (MG)";"MG";"CAMACHO";49;11;18;78
2016;"CAMANDUCAIA (MG)";"MG";"CAMANDUCAIA";539;53;65;657
2016;"CAMBUI (MG)";"MG";"CAMBUI";649;86;109;844
2016;"CAMBUQUIRA (MG)";"MG";"CAMBUQUIRA";166;40;37;243
2016;"CAMPANARIO (MG)";"MG";"CAMPANARIO";19;5;6;30
2016;"CAMPANHA (MG)";"MG";"CAMPANHA";294;63;54;411
2016;"CAMPESTRE (MG)";"MG";"CAMPESTRE";552;63;73;688
2016;"CAMPINA VERDE (MG)";"MG";"CAMPINA VERDE";277;49;52;378
2016;"CAMPO AZUL (MG)";"MG";"CAMPO AZUL";12;3;9;24
2016;"CAMPO BELO (MG)";"MG";"CAMPO BELO";1379;99;132;1610
2016;"CAMPO DO MEIO (MG)";"MG";"CAMPO DO MEIO";135;26;77;238
2016;"CAMPO FLORIDO (MG)";"MG";"CAMPO FLORIDO";206;40;77;323
2016;"CAMPOS ALTOS (MG)";"MG";"CAMPOS ALTOS";377;41;112;530
2016;"CAMPOS GERAIS (MG)";"MG";"CAMPOS GERAIS";411;46;143;600
2016;"CANA VERDE (MG)";"MG";"CANA VERDE";76;7;21;104
2016;"CANAA (MG)";"MG";"CANAA";62;5;9;76
2016;"CANAPOLIS (MG)";"MG";"CANAPOLIS";250;14;92;356
2016;"CANDEIAS (MG)";"MG";"CANDEIAS";274;40;41;355
2016;"CANTAGALO (MG)";"MG";"CANTAGALO";25;5;7;37
2016;"CAPARAO (MG)";"MG";"CAPARAO";74;4;13;91
2016;"CAPELA NOVA (MG)";"MG";"CAPELA NOVA";31;15;7;53
2016;"CAPELINHA (MG)";"MG";"CAPELINHA";808;65;194;1067
2016;"CAPETINGA (MG)";"MG";"CAPETINGA";185;28;41;254
2016;"CAPIM BRANCO (MG)";"MG";"CAPIM BRANCO";94;20;20;134
2016;"CAPINOPOLIS (MG)";"MG";"CAPINOPOLIS";297;30;68;395
2016;"CAPITAO ANDRADE (MG)";"MG";"CAPITAO ANDRADE";54;7;8;69
2016;"CAPITAO ENEAS (MG)";"MG";"CAPITAO ENEAS";99;5;34;138
2016;"CAPITOLIO (MG)";"MG";"CAPITOLIO";175;25;29;229
2016;"CAPUTIRA (MG)";"MG";"CAPUTIRA";143;10;56;209
2016;"CARAI (MG)";"MG";"CARAI";85;58;54;197
2016;"CARANAIBA (MG)";"MG";"CARANAIBA";27;13;17;57
2016;"CARANDAI (MG)";"MG";"CARANDAI";623;73;118;814
2016;"CARANGOLA (MG)";"MG";"CARANGOLA";436;67;65;568
2016;"CARATINGA (MG)";"MG";"CARATINGA";1370;95;483;1948
2016;"CARBONITA (MG)";"MG";"CARBONITA";166;23;51;240
2016;"CAREACU (MG)";"MG";"CAREACU";141;15;15;171
2016;"CARLOS CHAGAS (MG)";"MG";"CARLOS CHAGAS";172;42;57;271
2016;"CARMESIA (MG)";"MG";"CARMESIA";81;3;1430;1514
2016;"CARMO DA CACHOEIRA (MG)";"MG";"CARMO DA CACHOEIRA";193;50;59;302
2016;"CARMO DA MATA (MG)";"MG";"CARMO DA MATA";143;35;56;234
2016;"CARMO DE MINAS (MG)";"MG";"CARMO DE MINAS";164;50;32;246
2016;"CARMO DO CAJURU (MG)";"MG";"CARMO DO CAJURU";433;67;110;610
2016;"CARMO DO PARANAIBA (MG)";"MG";"CARMO DO PARANAIBA";743;86;126;955
2016;"CARMO DO RIO CLARO (MG)";"MG";"CARMO DO RIO CLARO";403;35;97;535
2016;"CARMOPOLIS DE MINAS (MG)";"MG";"CARMOPOLIS DE MINAS";556;72;54;682
2016;"CARNEIRINHO (MG)";"MG";"CARNEIRINHO";206;23;74;303
2016;"CARRANCAS (MG)";"MG";"CARRANCAS";56;9;11;76
2016;"CARVALHOPOLIS (MG)";"MG";"CARVALHOPOLIS";47;13;8;68
2016;"CARVALHOS (MG)";"MG";"CARVALHOS";82;9;10;101
2016;"CASA GRANDE (MG)";"MG";"CASA GRANDE";47;4;5;56
2016;"CASCALHO RICO (MG)";"MG";"CASCALHO RICO";54;32;5;91
2016;"CASSIA (MG)";"MG";"CASSIA";436;64;67;567
2016;"CATAGUASES (MG)";"MG";"CATAGUASES";824;103;175;1102
2016;"CATAS ALTAS (MG)";"MG";"CATAS ALTAS";162;23;9;194
2016;"CATAS ALTAS DA NORUEGA (MG)";"MG";"CATAS ALTAS DA NORUEGA";50;5;12;67
2016;"CATUJI (MG)";"MG";"CATUJI";47;23;23;93
2016;"CATUTI (MG)";"MG";"CATUTI";42;5;28;75
2016;"CAXAMBU (MG)";"MG";"CAXAMBU";229;53;28;310
2016;"CEDRO DO ABAETE (MG)";"MG";"CEDRO DO ABAETE";12;2;3;17
2016;"CENTRAL DE MINAS (MG)";"MG";"CENTRAL DE MINAS";84;10;24;118
2016;"CENTRALINA (MG)";"MG";"CENTRALINA";122;8;20;150
2016;"CHACARA (MG)";"MG";"CHACARA";43;6;16;65
2016;"CHALE (MG)";"MG";"CHALE";86;11;17;114
2016;"CHAPADA DO NORTE (MG)";"MG";"CHAPADA DO NORTE";52;19;31;102
2016;"CHAPADA GAUCHA (MG)";"MG";"CHAPADA GAUCHA";157;9;47;213
2016;"CHIADOR (MG)";"MG";"CHIADOR";157;25;9;191
2016;"CIPOTANEA (MG)";"MG";"CIPOTANEA";69;7;18;94
2016;"CLARAVAL (MG)";"MG";"CLARAVAL";121;10;24;155
2016;"CLARO DOS POCOES (MG)";"MG";"CLARO DOS POCOES";69;11;36;116
2016;"CLAUDIO (MG)";"MG";"CLAUDIO";777;56;66;899
2016;"COIMBRA (MG)";"MG";"COIMBRA";142;7;14;163
2016;"COLUNA (MG)";"MG";"COLUNA";68;6;20;94
2016;"COMENDADOR GOMES (MG)";"MG";"COMENDADOR GOMES";47;11;14;72
2016;"COMERCINHO (MG)";"MG";"COMERCINHO";30;12;21;63
2016;"CONCEICAO DA APARECIDA (MG)";"MG";"CONCEICAO DA APARECIDA";186;17;28;231
2016;"CONCEICAO DA BARRA DE MINAS (MG)";"MG";"CONCEICAO DA BARRA DE MINAS";42;18;10;70
2016;"CONCEICAO DAS ALAGOAS (MG)";"MG";"CONCEICAO DAS ALAGOAS";565;57;128;750
2016;"CONCEICAO DAS PEDRAS (MG)";"MG";"CONCEICAO DAS PEDRAS";26;7;7;40
2016;"CONCEICAO DE IPANEMA (MG)";"MG";"CONCEICAO DE IPANEMA";54;9;6;69
2016;"CONCEICAO DO MATO DENTRO (MG)";"MG";"CONCEICAO DO MATO DENTRO";183;62;205;450
2016;"CONCEICAO DO PARA (MG)";"MG";"CONCEICAO DO PARA";82;17;17;116
2016;"CONCEICAO DO RIO VERDE (MG)";"MG";"CONCEICAO DO RIO VERDE";208;69;36;313
2016;"CONCEICAO DOS OUROS (MG)";"MG";"CONCEICAO DOS OUROS";281;24;19;324
2016;"CONEGO MARINHO (MG)";"MG";"CONEGO MARINHO";28;5;22;55
2016;"CONFINS (MG)";"MG";"CONFINS";184;19;36;239
2016;"CONGONHAL (MG)";"MG";"CONGONHAL";285;13;15;313
2016;"CONGONHAS (MG)";"MG";"CONGONHAS";1188;175;144;1507
2016;"CONGONHAS DO NORTE (MG)";"MG";"CONGONHAS DO NORTE";57;7;11;75
2016;"CONQUISTA (MG)";"MG";"CONQUISTA";171;25;39;235
2016;"CONSELHEIRO LAFAIETE (MG)";"MG";"CONSELHEIRO LAFAIETE";1566;373;696;2635
2016;"CONSELHEIRO PENA (MG)";"MG";"CONSELHEIRO PENA";237;9;63;309
2016;"CONSOLACAO (MG)";"MG";"CONSOLACAO";17;9;3;29
2016;"CONTAGEM (MG)";"MG";"CONTAGEM";14718;1758;3035;19511
2016;"COQUEIRAL (MG)";"MG";"COQUEIRAL";131;15;27;173
2016;"CORACAO DE JESUS (MG)";"MG";"CORACAO DE JESUS";215;10;118;343
2016;"CORDISBURGO (MG)";"MG";"CORDISBURGO";109;18;17;144
2016;"CORDISLANDIA (MG)";"MG";"CORDISLANDIA";40;15;7;62
2016;"CORINTO (MG)";"MG";"CORINTO";370;31;92;493
2016;"COROACI (MG)";"MG";"COROACI";82;8;16;106
2016;"COROMANDEL (MG)";"MG";"COROMANDEL";689;105;99;893
2016;"CORONEL FABRICIANO (MG)";"MG";"CORONEL FABRICIANO";1248;230;547;2025
2016;"CORONEL MURTA (MG)";"MG";"CORONEL MURTA";36;8;18;62
2016;"CORONEL PACHECO (MG)";"MG";"CORONEL PACHECO";33;5;8;46
2016;"CORONEL XAVIER CHAVES (MG)";"MG";"CORONEL XAVIER CHAVES";91;9;4;104
2016;"CORREGO DANTA (MG)";"MG";"CORREGO DANTA";45;4;17;66
2016;"CORREGO DO BOM JESUS (MG)";"MG";"CORREGO DO BOM JESUS";41;11;13;65
2016;"CORREGO FUNDO (MG)";"MG";"CORREGO FUNDO";349;23;23;395
2016;"CORREGO NOVO (MG)";"MG";"CORREGO NOVO";12;5;7;24
2016;"COUTO DE MAGALHAES DE MINAS (MG)";"MG";"COUTO DE MAGALHAES DE MINAS";61;3;12;76
2016;"CRISOLITA (MG)";"MG";"CRISOLITA";15;18;12;45
2016;"CRISTAIS (MG)";"MG";"CRISTAIS";164;34;33;231
2016;"CRISTALIA (MG)";"MG";"CRISTALIA";32;6;27;65
2016;"CRISTIANO OTONI (MG)";"MG";"CRISTIANO OTONI";120;15;12;147
2016;"CRISTINA (MG)";"MG";"CRISTINA";114;29;16;159
2016;"CRUCILANDIA (MG)";"MG";"CRUCILANDIA";166;10;15;191
2016;"CRUZEIRO DA FORTALEZA (MG)";"MG";"CRUZEIRO DA FORTALEZA";113;10;15;138
2016;"CRUZILIA (MG)";"MG";"CRUZILIA";379;44;61;484
2016;"CUPARAQUE (MG)";"MG";"CUPARAQUE";58;9;6;73
2016;"CURRAL DE DENTRO (MG)";"MG";"CURRAL DE DENTRO";65;12;17;94
2016;"CURVELO (MG)";"MG";"CURVELO";1299;74;1639;3012
2016;"DATAS (MG)";"MG";"DATAS";47;4;18;69
2016;"DELFIM MOREIRA (MG)";"MG";"DELFIM MOREIRA";86;13;26;125
2016;"DELFINOPOLIS (MG)";"MG";"DELFINOPOLIS";115;21;18;154
2016;"DELTA (MG)";"MG";"DELTA";461;42;147;650
2016;"DESCOBERTO (MG)";"MG";"DESCOBERTO";39;8;2;49
2016;"DESTERRO DE ENTRE RIOS (MG)";"MG";"DESTERRO DE ENTRE RIOS";127;25;28;180
2016;"DESTERRO DO MELO (MG)";"MG";"DESTERRO DO MELO";40;11;18;69
2016;"DIAMANTINA (MG)";"MG";"DIAMANTINA";465;104;394;963
2016;"DIOGO DE VASCONCELOS (MG)";"MG";"DIOGO DE VASCONCELOS";23;5;11;39
2016;"DIONISIO (MG)";"MG";"DIONISIO";53;6;18;77
2016;"DIVINESIA (MG)";"MG";"DIVINESIA";93;7;15;115
2016;"DIVINO (MG)";"MG";"DIVINO";286;24;58;368
2016;"DIVINO DAS LARANJEIRAS (MG)";"MG";"DIVINO DAS LARANJEIRAS";56;1;6;63
2016;"DIVINOLANDIA DE MINAS (MG)";"MG";"DIVINOLANDIA DE MINAS";80;5;20;105
2016;"DIVINOPOLIS (MG)";"MG";"DIVINOPOLIS";3398;285;758;4441
2016;"DIVISA ALEGRE (MG)";"MG";"DIVISA ALEGRE";53;7;9;69
2016;"DIVISA NOVA (MG)";"MG";"DIVISA NOVA";103;33;41;177
2016;"DIVISOPOLIS (MG)";"MG";"DIVISOPOLIS";72;14;13;99
2016;"DOM BOSCO (MG)";"MG";"DOM BOSCO";28;6;13;47
2016;"DOM CAVATI (MG)";"MG";"DOM CAVATI";167;7;14;188
2016;"DOM JOAQUIM (MG)";"MG";"DOM JOAQUIM";31;7;13;51
2016;"DOM SILVERIO (MG)";"MG";"DOM SILVERIO";70;12;11;93
2016;"DOM VICOSO (MG)";"MG";"DOM VICOSO";31;12;13;56
2016;"DONA EUZEBIA (MG)";"MG";"DONA EUZEBIA";327;6;6;339
2016;"DORES DE CAMPOS (MG)";"MG";"DORES DE CAMPOS";122;22;42;186
2016;"DORES DE GUANHAES (MG)";"MG";"DORES DE GUANHAES";48;8;24;80
2016;"DORES DO INDAIA (MG)";"MG";"DORES DO INDAIA";260;43;19;322
2016;"DORES DO TURVO (MG)";"MG";"DORES DO TURVO";67;7;18;92
2016;"DORESOPOLIS (MG)";"MG";"DORESOPOLIS";20;8;4;32
2016;"DOURADOQUARA (MG)";"MG";"DOURADOQUARA";24;6;3;33
2016;"DURANDE (MG)";"MG";"DURANDE";106;14;25;145
2016;"ELOI MENDES (MG)";"MG";"ELOI MENDES";583;86;57;726
2016;"ENGENHEIRO CALDAS (MG)";"MG";"ENGENHEIRO CALDAS";167;8;19;194
2016;"ENGENHEIRO NAVARRO (MG)";"MG";"ENGENHEIRO NAVARRO";73;5;24;102
2016;"ENTRE FOLHAS (MG)";"MG";"ENTRE FOLHAS";67;4;11;82
2016;"ENTRE RIOS DE MINAS (MG)";"MG";"ENTRE RIOS DE MINAS";317;23;80;420
2016;"ERVALIA (MG)";"MG";"ERVALIA";344;25;59;428
2016;"ESMERALDAS (MG)";"MG";"ESMERALDAS";544;61;304;909
2016;"ESPERA FELIZ (MG)";"MG";"ESPERA FELIZ";392;45;56;493
2016;"ESPINOSA (MG)";"MG";"ESPINOSA";364;37;96;497
2016;"ESPIRITO SANTO DO DOURADO (MG)";"MG";"ESPIRITO SANTO DO DOURADO";116;11;8;135
2016;"ESTIVA (MG)";"MG";"ESTIVA";285;20;27;332
2016;"ESTRELA DALVA (MG)";"MG";"ESTRELA DALVA";33;5;3;41
2016;"ESTRELA DO INDAIA (MG)";"MG";"ESTRELA DO INDAIA";53;11;6;70
2016;"ESTRELA DO SUL (MG)";"MG";"ESTRELA DO SUL";112;18;18;148
2016;"EUGENOPOLIS (MG)";"MG";"EUGENOPOLIS";135;33;36;204
2016;"EWBANK DA CAMARA (MG)";"MG";"EWBANK DA CAMARA";38;5;4;47
2016;"EXTREMA (MG)";"MG";"EXTREMA";568;135;128;831
2016;"FAMA (MG)";"MG";"FAMA";19;8;1;28
2016;"FARIA LEMOS (MG)";"MG";"FARIA LEMOS";27;4;3;34
2016;"FELICIO DOS SANTOS (MG)";"MG";"FELICIO DOS SANTOS";51;15;29;95
2016;"FELISBURGO (MG)";"MG";"FELISBURGO";27;9;18;54
2016;"FELIXLANDIA (MG)";"MG";"FELIXLANDIA";244;20;63;327
2016;"FERNANDES TOURINHO (MG)";"MG";"FERNANDES TOURINHO";23;10;13;46
2016;"FERROS (MG)";"MG";"FERROS";117;22;59;198
2016;"FERVEDOURO (MG)";"MG";"FERVEDOURO";151;12;18;181
2016;"FLORESTAL (MG)";"MG";"FLORESTAL";109;14;42;165
2016;"FORMIGA (MG)";"MG";"FORMIGA";1740;190;236;2166
2016;"FORMOSO (MG)";"MG";"FORMOSO";49;3;36;88
2016;"FORTALEZA DE MINAS (MG)";"MG";"FORTALEZA DE MINAS";74;19;16;109
2016;"FORTUNA DE MINAS (MG)";"MG";"FORTUNA DE MINAS";37;6;11;54
2016;"FRANCISCO BADARO (MG)";"MG";"FRANCISCO BADARO";62;12;28;102
2016;"FRANCISCO DUMONT (MG)";"MG";"FRANCISCO DUMONT";65;7;33;105
2016;"FRANCISCO SA (MG)";"MG";"FRANCISCO SA";198;18;113;329
2016;"FRANCISCOPOLIS (MG)";"MG";"FRANCISCOPOLIS";24;9;18;51
2016;"FREI GASPAR (MG)";"MG";"FREI GASPAR";33;12;15;60
2016;"FREI INOCENCIO (MG)";"MG";"FREI INOCENCIO";99;9;29;137
2016;"FREI LAGONEGRO (MG)";"MG";"FREI LAGONEGRO";10;2;14;26
2016;"FRONTEIRA (MG)";"MG";"FRONTEIRA";238;51;87;376
2016;"FRONTEIRA DOS VALES (MG)";"MG";"FRONTEIRA DOS VALES";15;4;4;23
2016;"FRUTA DE LEITE (MG)";"MG";"FRUTA DE LEITE";22;6;26;54
2016;"FRUTAL (MG)";"MG";"FRUTAL";1594;149;215;1958
2016;"FUNILANDIA (MG)";"MG";"FUNILANDIA";61;2;21;84
2016;"GALILEIA (MG)";"MG";"GALILEIA";66;2;13;81
2016;"GAMELEIRAS (MG)";"MG";"GAMELEIRAS";33;7;18;58
2016;"GLAUCILANDIA (MG)";"MG";"GLAUCILANDIA";5;2;7;14
2016;"GOIABEIRA (MG)";"MG";"GOIABEIRA";31;9;5;45
2016;"GOIANA (MG)";"MG";"GOIANA";31;7;6;44
2016;"GONCALVES (MG)";"MG";"GONCALVES";101;19;9;129
2016;"GONZAGA (MG)";"MG";"GONZAGA";39;7;14;60
2016;"GOUVEA (MG)";"MG";"GOUVEA";143;21;37;201
2016;"GOVERNADOR VALADARES (MG)";"MG";"GOVERNADOR VALADARES";3499;331;356;4186
2016;"GRAO MOGOL (MG)";"MG";"GRAO MOGOL";111;26;77;214
2016;"GRUPIARA (MG)";"MG";"GRUPIARA";14;5;5;24
2016;"GUANHAES (MG)";"MG";"GUANHAES";619;62;132;813
2016;"GUAPE (MG)";"MG";"GUAPE";279;26;70;375
2016;"GUARACIABA (MG)";"MG";"GUARACIABA";91;22;39;152
2016;"GUARACIAMA (MG)";"MG";"GUARACIAMA";62;4;20;86
2016;"GUARANESIA (MG)";"MG";"GUARANESIA";398;79;119;596
2016;"GUARANI (MG)";"MG";"GUARANI";88;24;15;127
2016;"GUARARA (MG)";"MG";"GUARARA";54;13;4;71
2016;"GUARDA MOR (MG)";"MG";"GUARDA MOR";126;17;29;172
2016;"GUAXUPE (MG)";"MG";"GUAXUPE";964;92;159;1215
2016;"GUIDOVAL (MG)";"MG";"GUIDOVAL";163;3;8;174
2016;"GUIMARANIA (MG)";"MG";"GUIMARANIA";176;15;46;237
2016;"GUIRICEMA (MG)";"MG";"GUIRICEMA";271;16;25;312
2016;"GURINHATA (MG)";"MG";"GURINHATA";103;16;35;154
2016;"HELIODORA (MG)";"MG";"HELIODORA";94;14;16;124
2016;"IAPU (MG)";"MG";"IAPU";164;18;29;211
2016;"IBERTIOGA (MG)";"MG";"IBERTIOGA";56;15;9;80
2016;"IBIA (MG)";"MG";"IBIA";436;54;118;608
2016;"IBIAI (MG)";"MG";"IBIAI";70;13;11;94
2016;"IBIRACATU (MG)";"MG";"IBIRACATU";20;5;20;45
2016;"IBIRACI (MG)";"MG";"IBIRACI";424;39;47;510
2016;"IBIRITE (MG)";"MG";"IBIRITE";1487;274;339;2100
2016;"IBITIURA DE MINAS (MG)";"MG";"IBITIURA DE MINAS";116;8;6;130
2016;"IBITURUNA (MG)";"MG";"IBITURUNA";31;5;5;41
2016;"ICARAI DE MINAS (MG)";"MG";"ICARAI DE MINAS";33;1;16;50
2016;"IGARAPE (MG)";"MG";"IGARAPE";733;55;195;983
2016;"IGARATINGA (MG)";"MG";"IGARATINGA";554;9;23;586
2016;"IGUATAMA (MG)";"MG";"IGUATAMA";140;19;20;179
2016;"IJACI (MG)";"MG";"IJACI";250;12;23;285
2016;"ILICINEA (MG)";"MG";"ILICINEA";251;20;44;315
2016;"IMBE DE MINAS (MG)";"MG";"IMBE DE MINAS";50;6;14;70
2016;"INCONFIDENTES (MG)";"MG";"INCONFIDENTES";90;27;35;152
2016;"INDAIABIRA (MG)";"MG";"INDAIABIRA";94;14;28;136
2016;"INDIANOPOLIS (MG)";"MG";"INDIANOPOLIS";109;33;21;163
2016;"INGAI (MG)";"MG";"INGAI";21;20;14;55
2016;"INHAPIM (MG)";"MG";"INHAPIM";446;31;80;557
2016;"INHAUMA (MG)";"MG";"INHAUMA";121;7;24;152
2016;"INIMUTABA (MG)";"MG";"INIMUTABA";52;4;13;69
2016;"IPABA (MG)";"MG";"IPABA";97;17;27;141
2016;"IPANEMA (MG)";"MG";"IPANEMA";273;33;47;353
2016;"IPATINGA (MG)";"MG";"IPATINGA";3255;645;720;4620
2016;"IPIACU (MG)";"MG";"IPIACU";65;2;12;79
2016;"IPUIUNA (MG)";"MG";"IPUIUNA";425;44;37;506
2016;"IRAI DE MINAS (MG)";"MG";"IRAI DE MINAS";244;25;33;302
2016;"ITABIRA (MG)";"MG";"ITABIRA";1889;343;636;2868
2016;"ITABIRINHA (MG)";"MG";"ITABIRINHA";157;8;36;201
2016;"ITABIRITO (MG)";"MG";"ITABIRITO";1004;254;384;1642
2016;"ITACAMBIRA (MG)";"MG";"ITACAMBIRA";17;2;8;27
2016;"ITACARAMBI (MG)";"MG";"ITACARAMBI";145;12;43;200
2016;"ITAGUARA (MG)";"MG";"ITAGUARA";480;26;83;589
2016;"ITAIPE (MG)";"MG";"ITAIPE";83;16;29;128
2016;"ITAJUBA (MG)";"MG";"ITAJUBA";850;113;136;1099
2016;"ITAMARANDIBA (MG)";"MG";"ITAMARANDIBA";730;52;152;934
2016;"ITAMARATI DE MINAS (MG)";"MG";"ITAMARATI DE MINAS";117;13;12;142
2016;"ITAMBACURI (MG)";"MG";"ITAMBACURI";203;35;57;295
2016;"ITAMBE DO MATO DENTRO (MG)";"MG";"ITAMBE DO MATO DENTRO";23;4;6;33
2016;"ITAMOGI (MG)";"MG";"ITAMOGI";309;23;46;378
2016;"ITAMONTE (MG)";"MG";"ITAMONTE";322;25;32;379
2016;"ITANHANDU (MG)";"MG";"ITANHANDU";518;38;38;594
2016;"ITANHOMI (MG)";"MG";"ITANHOMI";124;19;27;170
2016;"ITAOBIM (MG)";"MG";"ITAOBIM";230;33;45;308
2016;"ITAPAGIPE (MG)";"MG";"ITAPAGIPE";280;23;48;351
2016;"ITAPECERICA (MG)";"MG";"ITAPECERICA";366;65;52;483
2016;"ITAPEVA (MG)";"MG";"ITAPEVA";263;37;15;315
2016;"ITATIAIUCU (MG)";"MG";"ITATIAIUCU";369;22;50;441
2016;"ITAU DE MINAS (MG)";"MG";"ITAU DE MINAS";324;47;53;424
2016;"ITAUNA (MG)";"MG";"ITAUNA";1589;251;292;2132
2016;"ITAVERAVA (MG)";"MG";"ITAVERAVA";60;8;19;87
2016;"ITINGA (MG)";"MG";"ITINGA";80;33;37;150
2016;"ITUETA (MG)";"MG";"ITUETA";74;9;21;104
2016;"ITUIUTABA (MG)";"MG";"ITUIUTABA";1438;280;375;2093
2016;"ITUMIRIM (MG)";"MG";"ITUMIRIM";72;31;9;112
2016;"ITURAMA (MG)";"MG";"ITURAMA";890;97;330;1317
2016;"ITUTINGA (MG)";"MG";"ITUTINGA";69;26;5;100
2016;"JABOTICATUBAS (MG)";"MG";"JABOTICATUBAS";313;21;68;402
2016;"JACINTO (MG)";"MG";"JACINTO";47;9;41;97
2016;"JACUI (MG)";"MG";"JACUI";167;20;35;222
2016;"JACUTINGA (MG)";"MG";"JACUTINGA";414;91;81;586
2016;"JAGUARACU (MG)";"MG";"JAGUARACU";48;2;7;57
2016;"JAIBA (MG)";"MG";"JAIBA";436;30;174;640
2016;"JAMPRUCA (MG)";"MG";"JAMPRUCA";18;6;27;51
2016;"JANAUBA (MG)";"MG";"JANAUBA";904;39;180;1123
2016;"JANUARIA (MG)";"MG";"JANUARIA";471;29;154;654
2016;"JAPARAIBA (MG)";"MG";"JAPARAIBA";97;13;21;131
2016;"JAPONVAR (MG)";"MG";"JAPONVAR";57;13;16;86
2016;"JECEABA (MG)";"MG";"JECEABA";125;38;18;181
2016;"JENIPAPO DE MINAS (MG)";"MG";"JENIPAPO DE MINAS";41;10;28;79
2016;"JEQUERI (MG)";"MG";"JEQUERI";141;12;58;211
2016;"JEQUITAI (MG)";"MG";"JEQUITAI";75;3;31;109
2016;"JEQUITIBA (MG)";"MG";"JEQUITIBA";113;12;30;155
2016;"JEQUITINHONHA (MG)";"MG";"JEQUITINHONHA";116;48;37;201
2016;"JESUANIA (MG)";"MG";"JESUANIA";77;23;12;112
2016;"JOAIMA (MG)";"MG";"JOAIMA";67;13;41;121
2016;"JOANESIA (MG)";"MG";"JOANESIA";20;7;15;42
2016;"JOAO MONLEVADE (MG)";"MG";"JOAO MONLEVADE";1296;157;262;1715
2016;"JOAO PINHEIRO (MG)";"MG";"JOAO PINHEIRO";1002;75;288;1365
2016;"JOAQUIM FELICIO (MG)";"MG";"JOAQUIM FELICIO";53;2;12;67
2016;"JORDANIA (MG)";"MG";"JORDANIA";39;16;25;80
2016;"JOSE GONCALVES DE MINAS (MG)";"MG";"JOSE GONCALVES DE MINAS";32;10;21;63
2016;"JOSE RAYDAN (MG)";"MG";"JOSE RAYDAN";33;2;20;55
2016;"JOSENOPOLIS (MG)";"MG";"JOSENOPOLIS";20;5;19;44
2016;"JUATUBA (MG)";"MG";"JUATUBA";340;58;230;628
2016;"JUIZ DE FORA (MG)";"MG";"JUIZ DE FORA";6388;868;1844;9100
2016;"JURAMENTO (MG)";"MG";"JURAMENTO";23;2;14;39
2016;"JURUAIA (MG)";"MG";"JURUAIA";109;23;30;162
2016;"JUVENILIA (MG)";"MG";"JUVENILIA";32;4;12;48
2016;"LADAINHA (MG)";"MG";"LADAINHA";64;24;52;140
2016;"LAGAMAR (MG)";"MG";"LAGAMAR";122;35;25;182
2016;"LAGOA DA PRATA (MG)";"MG";"LAGOA DA PRATA";1194;73;183;1450
2016;"LAGOA DOS PATOS (MG)";"MG";"LAGOA DOS PATOS";39;0;14;53
2016;"LAGOA DOURADA (MG)";"MG";"LAGOA DOURADA";432;42;143;617
2016;"LAGOA FORMOSA (MG)";"MG";"LAGOA FORMOSA";422;29;102;553
2016;"LAGOA GRANDE (MG)";"MG";"LAGOA GRANDE";136;10;63;209
2016;"LAGOA SANTA (MG)";"MG";"LAGOA SANTA";881;150;145;1176
2016;"LAJINHA (MG)";"MG";"LAJINHA";321;48;55;424
2016;"LAMBARI (MG)";"MG";"LAMBARI";412;69;36;517
2016;"LAMIM (MG)";"MG";"LAMIM";44;4;10;58
2016;"LARANJAL (MG)";"MG";"LARANJAL";121;11;5;137
2016;"LASSANCE (MG)";"MG";"LASSANCE";52;19;11;82
2016;"LAVRAS (MG)";"MG";"LAVRAS";1443;215;290;1948
2016;"LEANDRO FERREIRA (MG)";"MG";"LEANDRO FERREIRA";47;7;8;62
2016;"LEME DO PRADO (MG)";"MG";"LEME DO PRADO";35;5;17;57
2016;"LEOPOLDINA (MG)";"MG";"LEOPOLDINA";769;85;92;946
2016;"LIBERDADE (MG)";"MG";"LIBERDADE";137;20;12;169
2016;"LIMA DUARTE (MG)";"MG";"LIMA DUARTE";227;34;36;297
2016;"LIMEIRA DO OESTE (MG)";"MG";"LIMEIRA DO OESTE";186;34;62;282
2016;"LONTRA (MG)";"MG";"LONTRA";34;6;17;57
2016;"LUISBURGO (MG)";"MG";"LUISBURGO";49;12;24;85
2016;"LUISLANDIA (MG)";"MG";"LUISLANDIA";28;6;17;51
2016;"LUMINARIAS (MG)";"MG";"LUMINARIAS";132;11;46;189
2016;"LUZ (MG)";"MG";"LUZ";371;60;38;469
2016;"MACHACALIS (MG)";"MG";"MACHACALIS";39;5;12;56
2016;"MACHADO (MG)";"MG";"MACHADO";839;166;138;1143
2016;"MADRE DE DEUS DE MINAS (MG)";"MG";"MADRE DE DEUS DE MINAS";123;17;15;155
2016;"MALACACHETA (MG)";"MG";"MALACACHETA";127;16;59;202
2016;"MAMONAS (MG)";"MG";"MAMONAS";114;9;27;150
2016;"MANGA (MG)";"MG";"MANGA";155;13;60;228
2016;"MANHUACU (MG)";"MG";"MANHUACU";1814;164;196;2174
2016;"MANHUMIRIM (MG)";"MG";"MANHUMIRIM";367;53;49;469
2016;"MANTENA (MG)";"MG";"MANTENA";594;43;85;722
2016;"MAR DE ESPANHA (MG)";"MG";"MAR DE ESPANHA";266;32;24;322
2016;"MARAVILHAS (MG)";"MG";"MARAVILHAS";173;18;16;207
2016;"MARIA DA FE (MG)";"MG";"MARIA DA FE";274;20;39;333
2016;"MARIANA (MG)";"MG";"MARIANA";732;216;316;1264
2016;"MARILAC (MG)";"MG";"MARILAC";27;4;15;46
2016;"MARIO CAMPOS (MG)";"MG";"MARIO CAMPOS";274;29;26;329
2016;"MARIPA DE MINAS (MG)";"MG";"MARIPA DE MINAS";52;6;6;64
2016;"MARLIERIA (MG)";"MG";"MARLIERIA";45;7;13;65
2016;"MARMELOPOLIS (MG)";"MG";"MARMELOPOLIS";42;6;11;59
2016;"MARTINHO CAMPOS (MG)";"MG";"MARTINHO CAMPOS";413;31;77;521
2016;"MARTINS SOARES (MG)";"MG";"MARTINS SOARES";161;12;19;192
2016;"MATA VERDE (MG)";"MG";"MATA VERDE";64;42;10;116
2016;"MATERLANDIA (MG)";"MG";"MATERLANDIA";16;4;2;22
2016;"MATEUS LEME (MG)";"MG";"MATEUS LEME";620;101;136;857
2016;"MATHIAS LOBATO (MG)";"MG";"MATHIAS LOBATO";35;3;9;47
2016;"MATIAS BARBOSA (MG)";"MG";"MATIAS BARBOSA";719;50;47;816
2016;"MATIAS CARDOSO (MG)";"MG";"MATIAS CARDOSO";49;3;27;79
2016;"MATIPO (MG)";"MG";"MATIPO";314;32;54;400
2016;"MATO VERDE (MG)";"MG";"MATO VERDE";194;7;42;243
2016;"MATOZINHOS (MG)";"MG";"MATOZINHOS";431;117;157;705
2016;"MATUTINA (MG)";"MG";"MATUTINA";81;23;8;112
2016;"MEDEIROS (MG)";"MG";"MEDEIROS";78;23;8;109
2016;"MEDINA (MG)";"MG";"MEDINA";177;64;43;284
2016;"MENDES PIMENTEL (MG)";"MG";"MENDES PIMENTEL";43;9;14;66
2016;"MERCES (MG)";"MG";"MERCES";192;33;18;243
2016;"MESQUITA (MG)";"MG";"MESQUITA";29;18;14;61
2016;"MINAS NOVAS (MG)";"MG";"MINAS NOVAS";186;36;108;330
2016;"MINDURI (MG)";"MG";"MINDURI";86;9;5;100
2016;"MIRABELA (MG)";"MG";"MIRABELA";134;24;38;196
2016;"MIRADOURO (MG)";"MG";"MIRADOURO";116;20;34;170
2016;"MIRAI (MG)";"MG";"MIRAI";178;16;27;221
2016;"MIRAVANIA (MG)";"MG";"MIRAVANIA";19;4;17;40
2016;"MOEDA (MG)";"MG";"MOEDA";134;13;63;210
2016;"MOEMA (MG)";"MG";"MOEMA";187;18;122;327
2016;"MONJOLOS (MG)";"MG";"MONJOLOS";9;3;8;20
2016;"MONSENHOR PAULO (MG)";"MG";"MONSENHOR PAULO";216;32;16;264
2016;"MONTALVANIA (MG)";"MG";"MONTALVANIA";152;9;85;246
2016;"MONTE ALEGRE DE MINAS (MG)";"MG";"MONTE ALEGRE DE MINAS";648;77;73;798
2016;"MONTE AZUL (MG)";"MG";"MONTE AZUL";186;13;79;278
2016;"MONTE BELO (MG)";"MG";"MONTE BELO";303;46;56;405
2016;"MONTE CARMELO (MG)";"MG";"MONTE CARMELO";1509;138;180;1827
2016;"MONTE FORMOSO (MG)";"MG";"MONTE FORMOSO";30;19;44;93
2016;"MONTE SANTO DE MINAS (MG)";"MG";"MONTE SANTO DE MINAS";541;73;125;739
2016;"MONTE SIAO (MG)";"MG";"MONTE SIAO";335;58;40;433
2016;"MONTES CLAROS (MG)";"MG";"MONTES CLAROS";4863;411;1249;6523
2016;"MONTEZUMA (MG)";"MG";"MONTEZUMA";49;12;30;91
2016;"MORADA NOVA DE MINAS (MG)";"MG";"MORADA NOVA DE MINAS";136;22;28;186
2016;"MORRO DA GARCA (MG)";"MG";"MORRO DA GARCA";46;10;20;76
2016;"MORRO DO PILAR (MG)";"MG";"MORRO DO PILAR";33;8;3;44
2016;"MUNHOZ (MG)";"MG";"MUNHOZ";160;23;12;195
2016;"MURIAE (MG)";"MG";"MURIAE";1531;152;223;1906
2016;"MUTUM (MG)";"MG";"MUTUM";267;34;93;394
2016;"MUZAMBINHO (MG)";"MG";"MUZAMBINHO";508;100;54;662
2016;"NACIP RAYDAN (MG)";"MG";"NACIP RAYDAN";12;1;4;17
2016;"NANUQUE (MG)";"MG";"NANUQUE";597;74;227;898
2016;"NAQUE (MG)";"MG";"NAQUE";47;3;25;75
2016;"NATALANDIA (MG)";"MG";"NATALANDIA";32;2;21;55
2016;"NATERCIA (MG)";"MG";"NATERCIA";101;15;23;139
2016;"NAZARENO (MG)";"MG";"NAZARENO";213;18;39;270
2016;"NEPOMUCENO (MG)";"MG";"NEPOMUCENO";499;62;123;684
2016;"NINHEIRA (MG)";"MG";"NINHEIRA";61;10;41;112
2016;"NOVA BELEM (MG)";"MG";"NOVA BELEM";38;2;14;54
2016;"NOVA ERA (MG)";"MG";"NOVA ERA";271;51;80;402
2016;"NOVA LIMA (MG)";"MG";"NOVA LIMA";1751;388;250;2389
2016;"NOVA MODICA (MG)";"MG";"NOVA MODICA";22;4;14;40
2016;"NOVA PONTE (MG)";"MG";"NOVA PONTE";269;60;74;403
2016;"NOVA PORTEIRINHA (MG)";"MG";"NOVA PORTEIRINHA";47;5;20;72
2016;"NOVA RESENDE (MG)";"MG";"NOVA RESENDE";432;30;86;548
2016;"NOVA SERRANA (MG)";"MG";"NOVA SERRANA";617;75;134;826
2016;"NOVA UNIAO (MG)";"MG";"NOVA UNIAO";204;10;25;239
2016;"NOVO CRUZEIRO (MG)";"MG";"NOVO CRUZEIRO";221;50;161;432
2016;"NOVO ORIENTE DE MINAS (MG)";"MG";"NOVO ORIENTE DE MINAS";46;36;22;104
2016;"NOVORIZONTE (MG)";"MG";"NOVORIZONTE";77;1;24;102
2016;"OLARIA (MG)";"MG";"OLARIA";23;8;9;40
2016;"OLHOS D AGUA (MG)";"MG";"OLHOS D AGUA";93;16;48;157
2016;"OLIMPIO NORONHA (MG)";"MG";"OLIMPIO NORONHA";28;11;10;49
2016;"OLIVEIRA (MG)";"MG";"OLIVEIRA";799;116;139;1054
2016;"OLIVEIRA FORTES (MG)";"MG";"OLIVEIRA FORTES";28;3;3;34
2016;"ONCA DE PITANGUI (MG)";"MG";"ONCA DE PITANGUI";26;13;15;54
2016;"ORATORIOS (MG)";"MG";"ORATORIOS";101;6;24;131
2016;"ORIZANIA (MG)";"MG";"ORIZANIA";92;14;15;121
2016;"OURO BRANCO (MG)";"MG";"OURO BRANCO";553;140;215;908
2016;"OURO FINO (MG)";"MG";"OURO FINO";680;112;119;911
2016;"OURO PRETO (MG)";"MG";"OURO PRETO";1058;272;286;1616
2016;"OURO VERDE DE MINAS (MG)";"MG";"OURO VERDE DE MINAS";28;5;9;42
2016;"PADRE CARVALHO (MG)";"MG";"PADRE CARVALHO";29;9;30;68
2016;"PADRE PARAISO (MG)";"MG";"PADRE PARAISO";154;84;75;313
2016;"PAI PEDRO (MG)";"MG";"PAI PEDRO";20;4;31;55
2016;"PAINEIRAS (MG)";"MG";"PAINEIRAS";87;21;12;120
2016;"PAINS (MG)";"MG";"PAINS";267;21;30;318
2016;"PAIVA (MG)";"MG";"PAIVA";12;4;2;18
2016;"PALMA (MG)";"MG";"PALMA";118;9;9;136
2016;"PALMOPOLIS (MG)";"MG";"PALMOPOLIS";23;12;18;53
2016;"PAPAGAIOS (MG)";"MG";"PAPAGAIOS";581;15;68;664
2016;"PARA DE MINAS (MG)";"MG";"PARA DE MINAS";2434;190;240;2864
2016;"PARACATU (MG)";"MG";"PARACATU";1619;195;414;2228
2016;"PARAGUACU (MG)";"MG";"PARAGUACU";345;57;47;449
2016;"PARAISOPOLIS (MG)";"MG";"PARAISOPOLIS";386;56;49;491
2016;"PARAOPEBA (MG)";"MG";"PARAOPEBA";477;37;58;572
2016;"PASSA QUATRO (MG)";"MG";"PASSA QUATRO";408;44;29;481
2016;"PASSA TEMPO (MG)";"MG";"PASSA TEMPO";226;40;26;292
2016;"PASSA VINTE (MG)";"MG";"PASSA VINTE";283;32;14;329
2016;"PASSABEM (MG)";"MG";"PASSABEM";14;4;4;22
2016;"PASSOS (MG)";"MG";"PASSOS";2155;220;432;2807
2016;"PATIS (MG)";"MG";"PATIS";17;7;16;40
2016;"PATOS DE MINAS (MG)";"MG";"PATOS DE MINAS";3462;202;396;4060
2016;"PATROCINIO (MG)";"MG";"PATROCINIO";2071;198;590;2859
2016;"PATROCINIO DO MURIAE (MG)";"MG";"PATROCINIO DO MURIAE";110;13;9;132
2016;"PAULA CANDIDO (MG)";"MG";"PAULA CANDIDO";97;16;16;129
2016;"PAULISTAS (MG)";"MG";"PAULISTAS";51;3;11;65
2016;"PAVAO (MG)";"MG";"PAVAO";51;23;14;88
2016;"PECANHA (MG)";"MG";"PECANHA";149;13;63;225
2016;"PEDRA AZUL (MG)";"MG";"PEDRA AZUL";183;23;62;268
2016;"PEDRA BONITA (MG)";"MG";"PEDRA BONITA";92;13;22;127
2016;"PEDRA DO ANTA (MG)";"MG";"PEDRA DO ANTA";37;3;19;59
2016;"PEDRA DO INDAIA (MG)";"MG";"PEDRA DO INDAIA";100;11;7;118
2016;"PEDRA DOURADA (MG)";"MG";"PEDRA DOURADA";18;8;18;44
2016;"PEDRALVA (MG)";"MG";"PEDRALVA";188;32;29;249
2016;"PEDRAS DE MARIA DA CRUZ (MG)";"MG";"PEDRAS DE MARIA DA CRUZ";33;8;38;79
2016;"PEDRINOPOLIS (MG)";"MG";"PEDRINOPOLIS";63;15;9;87
2016;"PEDRO LEOPOLDO (MG)";"MG";"PEDRO LEOPOLDO";1257;213;203;1673
2016;"PEDRO TEIXEIRA (MG)";"MG";"PEDRO TEIXEIRA";17;7;5;29
2016;"PEQUERI (MG)";"MG";"PEQUERI";80;7;6;93
2016;"PEQUI (MG)";"MG";"PEQUI";72;21;8;101
2016;"PERDIGAO (MG)";"MG";"PERDIGAO";170;15;13;198
2016;"PERDIZES (MG)";"MG";"PERDIZES";331;63;67;461
2016;"PERDOES (MG)";"MG";"PERDOES";533;46;85;664
2016;"PERIQUITO (MG)";"MG";"PERIQUITO";60;2;25;87
2016;"PESCADOR (MG)";"MG";"PESCADOR";23;7;10;40
2016;"PIAU (MG)";"MG";"PIAU";57;12;8;77
2016;"PIEDADE DE CARATINGA (MG)";"MG";"PIEDADE DE CARATINGA";186;14;25;225
2016;"PIEDADE DE PONTE NOVA (MG)";"MG";"PIEDADE DE PONTE NOVA";43;3;19;65
2016;"PIEDADE DO RIO GRANDE (MG)";"MG";"PIEDADE DO RIO GRANDE";70;12;8;90
2016;"PIEDADE DOS GERAIS (MG)";"MG";"PIEDADE DOS GERAIS";105;10;18;133
2016;"PIMENTA (MG)";"MG";"PIMENTA";256;15;31;302
2016;"PINGO D AGUA (MG)";"MG";"PINGO D AGUA";33;3;10;46
2016;"PINTOPOLIS (MG)";"MG";"PINTOPOLIS";23;2;12;37
2016;"PIRACEMA (MG)";"MG";"PIRACEMA";129;11;21;161
2016;"PIRAJUBA (MG)";"MG";"PIRAJUBA";181;23;11;215
2016;"PIRANGA (MG)";"MG";"PIRANGA";167;26;78;271
2016;"PIRANGUCU (MG)";"MG";"PIRANGUCU";68;25;32;125
2016;"PIRANGUINHO (MG)";"MG";"PIRANGUINHO";251;26;30;307
2016;"PIRAPETINGA (MG)";"MG";"PIRAPETINGA";487;29;45;561
2016;"PIRAPORA (MG)";"MG";"PIRAPORA";612;62;188;862
2016;"PIRAUBA (MG)";"MG";"PIRAUBA";144;20;16;180
2016;"PITANGUI (MG)";"MG";"PITANGUI";590;92;99;781
2016;"PIUMHI (MG)";"MG";"PIUMHI";855;77;94;1026
2016;"PLANURA (MG)";"MG";"PLANURA";167;23;67;257
2016;"POCO FUNDO (MG)";"MG";"POCO FUNDO";347;61;31;439
2016;"POCOS DE CALDAS (MG)";"MG";"POCOS DE CALDAS";2903;628;471;4002
2016;"POCRANE (MG)";"MG";"POCRANE";99;7;17;123
2016;"POMPEU (MG)";"MG";"POMPEU";515;31;148;694
2016;"PONTE NOVA (MG)";"MG";"PONTE NOVA";1185;109;167;1461
2016;"PONTO CHIQUE (MG)";"MG";"PONTO CHIQUE";9;2;11;22
2016;"PONTO DOS VOLANTES (MG)";"MG";"PONTO DOS VOLANTES";54;18;37;109
2016;"PORTEIRINHA (MG)";"MG";"PORTEIRINHA";461;28;259;748
2016;"PORTO FIRME (MG)";"MG";"PORTO FIRME";75;8;22;105
2016;"POTE (MG)";"MG";"POTE";94;22;37;153
2016;"POUSO ALEGRE (MG)";"MG";"POUSO ALEGRE";2816;342;504;3662
2016;"POUSO ALTO (MG)";"MG";"POUSO ALTO";118;16;13;147
2016;"PRADOS (MG)";"MG";"PRADOS";125;24;17;166
2016;"PRATA (MG)";"MG";"PRATA";467;131;112;710
2016;"PRATAPOLIS (MG)";"MG";"PRATAPOLIS";248;25;30;303
2016;"PRATINHA (MG)";"MG";"PRATINHA";76;9;8;93
2016;"PRESIDENTE BERNARDES (MG)";"MG";"PRESIDENTE BERNARDES";30;9;12;51
2016;"PRESIDENTE JUSCELINO (MG)";"MG";"PRESIDENTE JUSCELINO";49;5;20;74
2016;"PRESIDENTE KUBITSCHEK (MG)";"MG";"PRESIDENTE KUBITSCHEK";29;12;8;49
2016;"PRESIDENTE OLEGARIO (MG)";"MG";"PRESIDENTE OLEGARIO";273;24;121;418
2016;"PRUDENTE DE MORAIS (MG)";"MG";"PRUDENTE DE MORAIS";122;17;14;153
2016;"QUARTEL GERAL (MG)";"MG";"QUARTEL GERAL";45;5;7;57
2016;"QUELUZITA (MG)";"MG";"QUELUZITA";25;9;5;39
2016;"RAPOSOS (MG)";"MG";"RAPOSOS";84;55;43;182
2016;"RAUL SOARES (MG)";"MG";"RAUL SOARES";282;46;71;399
2016;"RECREIO (MG)";"MG";"RECREIO";200;32;27;259
2016;"REDUTO (MG)";"MG";"REDUTO";116;15;12;143
2016;"RESENDE COSTA (MG)";"MG";"RESENDE COSTA";249;24;30;303
2016;"RESPLENDOR (MG)";"MG";"RESPLENDOR";201;42;44;287
2016;"RESSAQUINHA (MG)";"MG";"RESSAQUINHA";204;14;30;248
2016;"RIACHINHO (MG)";"MG";"RIACHINHO";121;4;27;152
2016;"RIACHO DOS MACHADOS (MG)";"MG";"RIACHO DOS MACHADOS";64;5;46;115
2016;"RIBEIRAO DAS NEVES (MG)";"MG";"RIBEIRAO DAS NEVES";2797;588;724;4109
2016;"RIBEIRAO VERMELHO (MG)";"MG";"RIBEIRAO VERMELHO";47;13;5;65
2016;"RIO ACIMA (MG)";"MG";"RIO ACIMA";129;26;17;172
2016;"RIO CASCA (MG)";"MG";"RIO CASCA";244;10;50;304
2016;"RIO DO PRADO (MG)";"MG";"RIO DO PRADO";16;10;10;36
2016;"RIO DOCE (MG)";"MG";"RIO DOCE";19;9;9;37
2016;"RIO ESPERA (MG)";"MG";"RIO ESPERA";47;3;13;63
2016;"RIO MANSO (MG)";"MG";"RIO MANSO";189;8;19;216
2016;"RIO NOVO (MG)";"MG";"RIO NOVO";192;26;35;253
2016;"RIO PARANAIBA (MG)";"MG";"RIO PARANAIBA";303;17;94;414
2016;"RIO PARDO DE MINAS (MG)";"MG";"RIO PARDO DE MINAS";241;35;187;463
2016;"RIO PIRACICABA (MG)";"MG";"RIO PIRACICABA";206;23;32;261
2016;"RIO POMBA (MG)";"MG";"RIO POMBA";291;39;43;373
2016;"RIO PRETO (MG)";"MG";"RIO PRETO";574;52;61;687
2016;"RIO VERMELHO (MG)";"MG";"RIO VERMELHO";94;38;48;180
2016;"RITAPOLIS (MG)";"MG";"RITAPOLIS";41;13;8;62
2016;"ROCHEDO DE MINAS (MG)";"MG";"ROCHEDO DE MINAS";31;4;3;38
2016;"RODEIRO (MG)";"MG";"RODEIRO";288;8;25;321
2016;"ROMARIA (MG)";"MG";"ROMARIA";53;28;11;92
2016;"ROSARIO DA LIMEIRA (MG)";"MG";"ROSARIO DA LIMEIRA";83;5;38;126
2016;"RUBELITA (MG)";"MG";"RUBELITA";23;8;12;43
2016;"RUBIM (MG)";"MG";"RUBIM";30;3;29;62
2016;"SABARA (MG)";"MG";"SABARA";860;222;404;1486
2016;"SABINOPOLIS (MG)";"MG";"SABINOPOLIS";155;44;77;276
2016;"SACRAMENTO (MG)";"MG";"SACRAMENTO";565;98;91;754
2016;"SALINAS (MG)";"MG";"SALINAS";496;53;152;701
2016;"SALTO DA DIVISA (MG)";"MG";"SALTO DA DIVISA";14;8;13;35
2016;"SANTA BARBARA (MG)";"MG";"SANTA BARBARA";437;92;112;641
2016;"SANTA BARBARA DO LESTE (MG)";"MG";"SANTA BARBARA DO LESTE";205;9;11;225
2016;"SANTA BARBARA DO MONTE VERDE (MG)";"MG";"SANTA BARBARA DO MONTE VERDE";674;56;136;866
2016;"SANTA BARBARA DO TUGURIO (MG)";"MG";"SANTA BARBARA DO TUGURIO";74;31;52;157
2016;"SANTA CRUZ DE MINAS (MG)";"MG";"SANTA CRUZ DE MINAS";84;12;6;102
2016;"SANTA CRUZ DE SALINAS (MG)";"MG";"SANTA CRUZ DE SALINAS";29;7;28;64
2016;"SANTA CRUZ DO ESCALVADO (MG)";"MG";"SANTA CRUZ DO ESCALVADO";46;11;17;74
2016;"SANTA EFIGENIA DE MINAS (MG)";"MG";"SANTA EFIGENIA DE MINAS";28;8;8;44
2016;"SANTA FE DE MINAS (MG)";"MG";"SANTA FE DE MINAS";8;2;8;18
2016;"SANTA HELENA DE MINAS (MG)";"MG";"SANTA HELENA DE MINAS";12;9;9;30
2016;"SANTA JULIANA (MG)";"MG";"SANTA JULIANA";492;47;63;602
2016;"SANTA LUZIA (MG)";"MG";"SANTA LUZIA";2076;387;715;3178
2016;"SANTA MARGARIDA (MG)";"MG";"SANTA MARGARIDA";262;34;47;343
2016;"SANTA MARIA DE ITABIRA (MG)";"MG";"SANTA MARIA DE ITABIRA";142;25;59;226
2016;"SANTA MARIA DO SALTO (MG)";"MG";"SANTA MARIA DO SALTO";11;8;10;29
2016;"SANTA MARIA DO SUACUI (MG)";"MG";"SANTA MARIA DO SUACUI";107;7;58;172
2016;"SANTA RITA DE CALDAS (MG)";"MG";"SANTA RITA DE CALDAS";360;32;20;412
2016;"SANTA RITA DE IBITIPOCA (MG)";"MG";"SANTA RITA DE IBITIPOCA";54;12;4;70
2016;"SANTA RITA DE JACUTINGA (MG)";"MG";"SANTA RITA DE JACUTINGA";112;9;8;129
2016;"SANTA RITA DE MINAS (MG)";"MG";"SANTA RITA DE MINAS";136;19;21;176
2016;"SANTA RITA DO ITUETO (MG)";"MG";"SANTA RITA DO ITUETO";92;12;21;125
2016;"SANTA RITA DO SAPUCAI (MG)";"MG";"SANTA RITA DO SAPUCAI";460;101;103;664
2016;"SANTA ROSA DA SERRA (MG)";"MG";"SANTA ROSA DA SERRA";69;13;14;96
2016;"SANTA VITORIA (MG)";"MG";"SANTA VITORIA";471;69;61;601
2016;"SANTANA DA VARGEM (MG)";"MG";"SANTANA DA VARGEM";116;13;32;161
2016;"SANTANA DE CATAGUASES (MG)";"MG";"SANTANA DE CATAGUASES";38;10;8;56
2016;"SANTANA DE PIRAPAMA (MG)";"MG";"SANTANA DE PIRAPAMA";81;7;36;124
2016;"SANTANA DO DESERTO (MG)";"MG";"SANTANA DO DESERTO";70;17;14;101
2016;"SANTANA DO GARAMBEU (MG)";"MG";"SANTANA DO GARAMBEU";21;6;8;35
2016;"SANTANA DO JACARE (MG)";"MG";"SANTANA DO JACARE";59;7;20;86
2016;"SANTANA DO MANHUACU (MG)";"MG";"SANTANA DO MANHUACU";265;9;24;298
2016;"SANTANA DO PARAISO (MG)";"MG";"SANTANA DO PARAISO";188;26;36;250
2016;"SANTANA DO RIACHO (MG)";"MG";"SANTANA DO RIACHO";56;9;7;72
2016;"SANTANA DOS MONTES (MG)";"MG";"SANTANA DOS MONTES";43;7;9;59
2016;"SANTO ANTONIO DO AMPARO (MG)";"MG";"SANTO ANTONIO DO AMPARO";312;54;108;474
2016;"SANTO ANTONIO DO AVENTUREIRO (MG)";"MG";"SANTO ANTONIO DO AVENTUREIRO";72;1;10;83
2016;"SANTO ANTONIO DO GRAMA (MG)";"MG";"SANTO ANTONIO DO GRAMA";56;11;12;79
2016;"SANTO ANTONIO DO ITAMBE (MG)";"MG";"SANTO ANTONIO DO ITAMBE";17;7;11;35
2016;"SANTO ANTONIO DO JACINTO (MG)";"MG";"SANTO ANTONIO DO JACINTO";49;6;44;99
2016;"SANTO ANTONIO DO MONTE (MG)";"MG";"SANTO ANTONIO DO MONTE";561;73;106;740
2016;"SANTO ANTONIO DO RETIRO (MG)";"MG";"SANTO ANTONIO DO RETIRO";64;5;35;104
2016;"SANTO ANTONIO DO RIO ABAIXO (MG)";"MG";"SANTO ANTONIO DO RIO ABAIXO";15;7;9;31
2016;"SANTO HIPOLITO (MG)";"MG";"SANTO HIPOLITO";25;7;4;36
2016;"SANTOS DUMONT (MG)";"MG";"SANTOS DUMONT";434;109;162;705
2016;"SAO BENTO ABADE (MG)";"MG";"SAO BENTO ABADE";45;22;26;93
2016;"SAO BRAS DO SUACUI (MG)";"MG";"SAO BRAS DO SUACUI";61;7;12;80
2016;"SAO DOMINGOS DAS DORES (MG)";"MG";"SAO DOMINGOS DAS DORES";118;13;15;146
2016;"SAO DOMINGOS DO PRATA (MG)";"MG";"SAO DOMINGOS DO PRATA";311;21;72;404
2016;"SAO FELIX DE MINAS (MG)";"MG";"SAO FELIX DE MINAS";26;3;15;44
2016;"SAO FRANCISCO (MG)";"MG";"SAO FRANCISCO";324;36;169;529
2016;"SAO FRANCISCO DE PAULA (MG)";"MG";"SAO FRANCISCO DE PAULA";83;29;31;143
2016;"SAO FRANCISCO DE SALES (MG)";"MG";"SAO FRANCISCO DE SALES";91;13;28;132
2016;"SAO FRANCISCO DO GLORIA (MG)";"MG";"SAO FRANCISCO DO GLORIA";68;8;14;90
2016;"SAO GERALDO (MG)";"MG";"SAO GERALDO";201;12;21;234
2016;"SAO GERALDO DA PIEDADE (MG)";"MG";"SAO GERALDO DA PIEDADE";21;6;12;39
2016;"SAO GERALDO DO BAIXIO (MG)";"MG";"SAO GERALDO DO BAIXIO";20;6;9;35
2016;"SAO GONCALO DO ABAETE (MG)";"MG";"SAO GONCALO DO ABAETE";103;17;21;141
2016;"SAO GONCALO DO PARA (MG)";"MG";"SAO GONCALO DO PARA";244;22;29;295
2016;"SAO GONCALO DO RIO ABAIXO (MG)";"MG";"SAO GONCALO DO RIO ABAIXO";228;58;42;328
2016;"SAO GONCALO DO RIO PRETO (MG)";"MG";"SAO GONCALO DO RIO PRETO";33;10;9;52
2016;"SAO GONCALO DO SAPUCAI (MG)";"MG";"SAO GONCALO DO SAPUCAI";491;59;87;637
2016;"SAO GOTARDO (MG)";"MG";"SAO GOTARDO";1045;110;288;1443
2016;"SAO JOAO BATISTA DO GLORIA (MG)";"MG";"SAO JOAO BATISTA DO GLORIA";153;13;17;183
2016;"SAO JOAO DA LAGOA (MG)";"MG";"SAO JOAO DA LAGOA";44;15;15;74
2016;"SAO JOAO DA MATA (MG)";"MG";"SAO JOAO DA MATA";60;20;4;84
2016;"SAO JOAO DA PONTE (MG)";"MG";"SAO JOAO DA PONTE";88;15;71;174
2016;"SAO JOAO DAS MISSOES (MG)";"MG";"SAO JOAO DAS MISSOES";42;4;21;67
2016;"SAO JOAO DEL REI (MG)";"MG";"SAO JOAO DEL REI";1249;252;252;1753
2016;"SAO JOAO DO MANHUACU (MG)";"MG";"SAO JOAO DO MANHUACU";177;16;38;231
2016;"SAO JOAO DO MANTENINHA (MG)";"MG";"SAO JOAO DO MANTENINHA";92;15;6;113
2016;"SAO JOAO DO ORIENTE (MG)";"MG";"SAO JOAO DO ORIENTE";120;10;12;142
2016;"SAO JOAO DO PACUI (MG)";"MG";"SAO JOAO DO PACUI";17;5;8;30
2016;"SAO JOAO DO PARAISO (MG)";"MG";"SAO JOAO DO PARAISO";243;34;106;383
2016;"SAO JOAO EVANGELISTA (MG)";"MG";"SAO JOAO EVANGELISTA";145;20;50;215
2016;"SAO JOAO NEPOMUCENO (MG)";"MG";"SAO JOAO NEPOMUCENO";309;50;32;391
2016;"SAO JOAQUIM DE BICAS (MG)";"MG";"SAO JOAQUIM DE BICAS";653;75;47;775
2016;"SAO JOSE DA BARRA (MG)";"MG";"SAO JOSE DA BARRA";128;16;26;170
2016;"SAO JOSE DA LAPA (MG)";"MG";"SAO JOSE DA LAPA";441;75;99;615
2016;"SAO JOSE DA SAFIRA (MG)";"MG";"SAO JOSE DA SAFIRA";10;2;6;18
2016;"SAO JOSE DA VARGINHA (MG)";"MG";"SAO JOSE DA VARGINHA";61;5;20;86
2016;"SAO JOSE DO ALEGRE (MG)";"MG";"SAO JOSE DO ALEGRE";49;7;7;63
2016;"SAO JOSE DO DIVINO (MG)";"MG";"SAO JOSE DO DIVINO";22;8;14;44
2016;"SAO JOSE DO GOIABAL (MG)";"MG";"SAO JOSE DO GOIABAL";52;8;45;105
2016;"SAO JOSE DO JACURI (MG)";"MG";"SAO JOSE DO JACURI";41;3;8;52
2016;"SAO JOSE DO MANTIMENTO (MG)";"MG";"SAO JOSE DO MANTIMENTO";40;2;5;47
2016;"SAO LOURENCO (MG)";"MG";"SAO LOURENCO";582;82;62;726
2016;"SAO MIGUEL DO ANTA (MG)";"MG";"SAO MIGUEL DO ANTA";94;12;13;119
2016;"SAO PEDRO DA UNIAO (MG)";"MG";"SAO PEDRO DA UNIAO";120;18;17;155
2016;"SAO PEDRO DO SUACUI (MG)";"MG";"SAO PEDRO DO SUACUI";43;4;9;56
2016;"SAO PEDRO DOS FERROS (MG)";"MG";"SAO PEDRO DOS FERROS";110;9;42;161
2016;"SAO ROMAO (MG)";"MG";"SAO ROMAO";45;6;14;65
2016;"SAO ROQUE DE MINAS (MG)";"MG";"SAO ROQUE DE MINAS";202;18;29;249
2016;"SAO SEBASTIAO DA BELA VISTA (MG)";"MG";"SAO SEBASTIAO DA BELA VISTA";100;14;14;128
2016;"SAO SEBASTIAO DA VARGEM ALEGRE (MG)";"MG";"SAO SEBASTIAO DA VARGEM ALEGRE";43;8;8;59
2016;"SAO SEBASTIAO DO ANTA (MG)";"MG";"SAO SEBASTIAO DO ANTA";65;11;8;84
2016;"SAO SEBASTIAO DO MARANHAO (MG)";"MG";"SAO SEBASTIAO DO MARANHAO";26;11;21;58
2016;"SAO SEBASTIAO DO OESTE (MG)";"MG";"SAO SEBASTIAO DO OESTE";182;9;33;224
2016;"SAO SEBASTIAO DO PARAISO (MG)";"MG";"SAO SEBASTIAO DO PARAISO";1707;138;240;2085
2016;"SAO SEBASTIAO DO RIO PRETO (MG)";"MG";"SAO SEBASTIAO DO RIO PRETO";10;6;7;23
2016;"SAO SEBASTIAO DO RIO VERDE (MG)";"MG";"SAO SEBASTIAO DO RIO VERDE";17;4;7;28
2016;"SAO TIAGO (MG)";"MG";"SAO TIAGO";241;20;30;291
2016;"SAO TOMAS DE AQUINO (MG)";"MG";"SAO TOMAS DE AQUINO";109;26;16;151
2016;"SAO TOME DAS LETRAS (MG)";"MG";"SAO TOME DAS LETRAS";102;17;24;143
2016;"SAO VICENTE DE MINAS (MG)";"MG";"SAO VICENTE DE MINAS";125;25;6;156
2016;"SAPUCAI MIRIM (MG)";"MG";"SAPUCAI MIRIM";230;39;13;282
2016;"SARDOA (MG)";"MG";"SARDOA";60;15;12;87
2016;"SARZEDO (MG)";"MG";"SARZEDO";828;81;120;1029
2016;"SEM PEIXE (MG)";"MG";"SEM PEIXE";16;4;13;33
2016;"SENADOR AMARAL (MG)";"MG";"SENADOR AMARAL";131;8;13;152
2016;"SENADOR CORTES (MG)";"MG";"SENADOR CORTES";23;4;4;31
2016;"SENADOR FIRMINO (MG)";"MG";"SENADOR FIRMINO";116;9;29;154
2016;"SENADOR JOSE BENTO (MG)";"MG";"SENADOR JOSE BENTO";15;2;9;26
2016;"SENADOR MODESTINO GONCALVES (MG)";"MG";"SENADOR MODESTINO GONCALVES";33;6;13;52
2016;"SENHORA DE OLIVEIRA (MG)";"MG";"SENHORA DE OLIVEIRA";87;6;15;108
2016;"SENHORA DO PORTO (MG)";"MG";"SENHORA DO PORTO";25;9;14;48
2016;"SENHORA DOS REMEDIOS (MG)";"MG";"SENHORA DOS REMEDIOS";130;39;25;194
2016;"SERICITA (MG)";"MG";"SERICITA";119;5;12;136
2016;"SERITINGA (MG)";"MG";"SERITINGA";31;2;4;37
2016;"SERRA AZUL DE MINAS (MG)";"MG";"SERRA AZUL DE MINAS";24;7;11;42
2016;"SERRA DA SAUDADE (MG)";"MG";"SERRA DA SAUDADE";9;5;2;16
2016;"SERRA DO SALITRE (MG)";"MG";"SERRA DO SALITRE";276;14;102;392
2016;"SERRA DOS AIMORES (MG)";"MG";"SERRA DOS AIMORES";79;4;29;112
2016;"SERRANIA (MG)";"MG";"SERRANIA";134;20;23;177
2016;"SERRANOPOLIS DE MINAS (MG)";"MG";"SERRANOPOLIS DE MINAS";22;1;21;44
2016;"SERRANOS (MG)";"MG";"SERRANOS";25;8;4;37
2016;"SERRO (MG)";"MG";"SERRO";206;28;91;325
2016;"SETE LAGOAS (MG)";"MG";"SETE LAGOAS";3584;462;815;4861
2016;"SETUBINHA (MG)";"MG";"SETUBINHA";35;8;28;71
2016;"SILVEIRANIA (MG)";"MG";"SILVEIRANIA";16;4;7;27
2016;"SILVIANOPOLIS (MG)";"MG";"SILVIANOPOLIS";100;12;19;131
2016;"SIMAO PEREIRA (MG)";"MG";"SIMAO PEREIRA";64;19;7;90
2016;"SIMONESIA (MG)";"MG";"SIMONESIA";301;20;47;368
2016;"SOBRALIA (MG)";"MG";"SOBRALIA";41;7;11;59
2016;"SOLEDADE DE MINAS (MG)";"MG";"SOLEDADE DE MINAS";54;17;4;75
2016;"TABULEIRO (MG)";"MG";"TABULEIRO";87;7;12;106
2016;"TAIOBEIRAS (MG)";"MG";"TAIOBEIRAS";803;47;208;1058
2016;"TAPARUBA (MG)";"MG";"TAPARUBA";31;3;11;45
2016;"TAPIRA (MG)";"MG";"TAPIRA";149;8;30;187
2016;"TAPIRAI (MG)";"MG";"TAPIRAI";19;10;5;34
2016;"TAQUARACU DE MINAS (MG)";"MG";"TAQUARACU DE MINAS";111;10;17;138
2016;"TARUMIRIM (MG)";"MG";"TARUMIRIM";147;19;29;195
2016;"TEIXEIRAS (MG)";"MG";"TEIXEIRAS";172;18;18;208
2016;"TEOFILO OTONI (MG)";"MG";"TEOFILO OTONI";1627;228;185;2040
2016;"TIMOTEO (MG)";"MG";"TIMOTEO";965;214;154;1333
2016;"TIRADENTES (MG)";"MG";"TIRADENTES";106;23;12;141
2016;"TIROS (MG)";"MG";"TIROS";185;21;18;224
2016;"TOCANTINS (MG)";"MG";"TOCANTINS";268;14;22;304
2016;"TOCOS DO MOJI (MG)";"MG";"TOCOS DO MOJI";59;13;14;86
2016;"TOLEDO (MG)";"MG";"TOLEDO";150;11;20;181
2016;"TOMBOS (MG)";"MG";"TOMBOS";141;35;35;211
2016;"TRES CORACOES (MG)";"MG";"TRES CORACOES";1125;115;214;1454
2016;"TRES MARIAS (MG)";"MG";"TRES MARIAS";446;57;113;616
2016;"TRES PONTAS (MG)";"MG";"TRES PONTAS";1086;143;222;1451
2016;"TUMIRITINGA (MG)";"MG";"TUMIRITINGA";37;6;11;54
2016;"TUPACIGUARA (MG)";"MG";"TUPACIGUARA";606;97;86;789
2016;"TURMALINA (MG)";"MG";"TURMALINA";370;41;91;502
2016;"TURVOLANDIA (MG)";"MG";"TURVOLANDIA";121;32;13;166
2016;"UBA (MG)";"MG";"UBA";2070;117;196;2383
2016;"UBAI (MG)";"MG";"UBAI";49;11;39;99
2016;"UBAPORANGA (MG)";"MG";"UBAPORANGA";202;11;30;243
2016;"UBERABA (MG)";"MG";"UBERABA";5161;1105;1116;7382
2016;"UBERLANDIA (MG)";"MG";"UBERLANDIA";11912;1321;1619;14852
2016;"UMBURATIBA (MG)";"MG";"UMBURATIBA";8;4;5;17
2016;"UNAI (MG)";"MG";"UNAI";1694;109;438;2241
2016;"UNIAO DE MINAS (MG)";"MG";"UNIAO DE MINAS";54;10;39;103
2016;"URUANA DE MINAS (MG)";"MG";"URUANA DE MINAS";25;2;12;39
2016;"URUCANIA (MG)";"MG";"URUCANIA";181;11;58;250
2016;"URUCUIA (MG)";"MG";"URUCUIA";109;7;41;157
2016;"VARGEM ALEGRE (MG)";"MG";"VARGEM ALEGRE";74;5;12;91
2016;"VARGEM BONITA (MG)";"MG";"VARGEM BONITA";41;2;7;50
2016;"VARGEM GRANDE DO RIO PARDO (MG)";"MG";"VARGEM GRANDE DO RIO PARDO";70;9;20;99
2016;"VARGINHA (MG)";"MG";"VARGINHA";2196;208;295;2699
2016;"VARJAO DE MINAS (MG)";"MG";"VARJAO DE MINAS";101;14;55;170
2016;"VARZEA DA PALMA (MG)";"MG";"VARZEA DA PALMA";505;24;107;636
2016;"VARZELANDIA (MG)";"MG";"VARZELANDIA";77;10;57;144
2016;"VAZANTE (MG)";"MG";"VAZANTE";364;47;91;502
2016;"VERDELANDIA (MG)";"MG";"VERDELANDIA";18;4;11;33
2016;"VEREDINHA (MG)";"MG";"VEREDINHA";67;18;23;108
2016;"VERISSIMO (MG)";"MG";"VERISSIMO";41;33;6;80
2016;"VERMELHO NOVO (MG)";"MG";"VERMELHO NOVO";115;12;30;157
2016;"VESPASIANO (MG)";"MG";"VESPASIANO";1377;282;224;1883
2016;"VICOSA (MG)";"MG";"VICOSA";796;175;226;1197
2016;"VIEIRAS (MG)";"MG";"VIEIRAS";40;12;10;62
2016;"VIRGEM DA LAPA (MG)";"MG";"VIRGEM DA LAPA";80;13;33;126
2016;"VIRGINIA (MG)";"MG";"VIRGINIA";188;20;10;218
2016;"VIRGINOPOLIS (MG)";"MG";"VIRGINOPOLIS";131;7;32;170
2016;"VIRGOLANDIA (MG)";"MG";"VIRGOLANDIA";28;6;14;48
2016;"VISCONDE DO RIO BRANCO (MG)";"MG";"VISCONDE DO RIO BRANCO";1113;59;78;1250
2016;"VOLTA GRANDE (MG)";"MG";"VOLTA GRANDE";68;15;9;92
2016;"WENCESLAU BRAZ (MG)";"MG";"WENCESLAU BRAZ";36;8;10;54
2016;"AGUA CLARA (MS)";"MS";"AGUA CLARA";436;31;107;574
2016;"ALCINOPOLIS (MS)";"MS";"ALCINOPOLIS";103;18;17;138
2016;"AMAMBAI (MS)";"MS";"AMAMBAI";797;27;75;899
2016;"ANASTACIO (MS)";"MS";"ANASTACIO";449;23;34;506
2016;"ANAURILANDIA (MS)";"MS";"ANAURILANDIA";121;20;64;205
2016;"ANGELICA (MS)";"MS";"ANGELICA";304;62;73;439
2016;"ANTONIO JOAO (MS)";"MS";"ANTONIO JOAO";125;7;30;162
2016;"APARECIDA DO TABOADO (MS)";"MS";"APARECIDA DO TABOADO";457;46;59;562
2016;"AQUIDAUANA (MS)";"MS";"AQUIDAUANA";397;26;79;502
2016;"ARAL MOREIRA (MS)";"MS";"ARAL MOREIRA";241;14;29;284
2016;"BANDEIRANTES (MS)";"MS";"BANDEIRANTES";224;16;53;293
2016;"BATAGUASSU (MS)";"MS";"BATAGUASSU";459;48;227;734
2016;"BATAYPORA (MS)";"MS";"BATAYPORA";195;11;31;237
2016;"BELA VISTA (MS)";"MS";"BELA VISTA";315;47;59;421
2016;"BODOQUENA (MS)";"MS";"BODOQUENA";108;28;45;181
2016;"BONITO (MS)";"MS";"BONITO";344;81;76;501
2016;"BRASILANDIA (MS)";"MS";"BRASILANDIA";253;37;89;379
2016;"CAARAPO (MS)";"MS";"CAARAPO";625;18;156;799
2016;"CAMAPUA (MS)";"MS";"CAMAPUA";366;50;46;462
2016;"CAMPO GRANDE (MS)";"MS";"CAMPO GRANDE";14898;1010;2233;18141
2016;"CARACOL (MS)";"MS";"CARACOL";66;16;15;97
2016;"CASSILANDIA (MS)";"MS";"CASSILANDIA";501;28;56;585
2016;"CHAPADAO DO SUL (MS)";"MS";"CHAPADAO DO SUL";925;31;133;1089
2016;"CORGUINHO (MS)";"MS";"CORGUINHO";69;14;24;107
2016;"CORONEL SAPUCAIA (MS)";"MS";"CORONEL SAPUCAIA";358;11;37;406
2016;"CORUMBA (MS)";"MS";"CORUMBA";950;87;249;1286
2016;"COSTA RICA (MS)";"MS";"COSTA RICA";541;17;154;712
2016;"COXIM (MS)";"MS";"COXIM";661;24;87;772
2016;"DEODAPOLIS (MS)";"MS";"DEODAPOLIS";287;22;102;411
2016;"DOIS IRMAOS DO BURITI (MS)";"MS";"DOIS IRMAOS DO BURITI";160;26;37;223
2016;"DOURADINA (MS)";"MS";"DOURADINA";313;14;24;351
2016;"DOURADOS (MS)";"MS";"DOURADOS";4244;254;570;5068
2016;"ELDORADO (MS)";"MS";"ELDORADO";271;18;37;326
2016;"FATIMA DO SUL (MS)";"MS";"FATIMA DO SUL";470;15;43;528
2016;"FIGUEIRAO (MS)";"MS";"FIGUEIRAO";60;28;5;93
2016;"GLORIA DE DOURADOS (MS)";"MS";"GLORIA DE DOURADOS";218;12;29;259
2016;"GUIA LOPES DA LAGUNA (MS)";"MS";"GUIA LOPES DA LAGUNA";209;22;30;261
2016;"IGUATEMI (MS)";"MS";"IGUATEMI";257;7;74;338
2016;"INOCENCIA (MS)";"MS";"INOCENCIA";210;10;44;264
2016;"ITAPORA (MS)";"MS";"ITAPORA";470;30;52;552
2016;"ITAQUIRAI (MS)";"MS";"ITAQUIRAI";264;10;122;396
2016;"IVINHEMA (MS)";"MS";"IVINHEMA";705;70;309;1084
2016;"JAPORA (MS)";"MS";"JAPORA";55;4;19;78
2016;"JARAGUARI (MS)";"MS";"JARAGUARI";74;10;20;104
2016;"JARDIM (MS)";"MS";"JARDIM";498;31;55;584
2016;"JATEI (MS)";"MS";"JATEI";57;7;46;110
2016;"JUTI (MS)";"MS";"JUTI";124;13;24;161
2016;"LADARIO (MS)";"MS";"LADARIO";160;28;66;254
2016;"LAGUNA CARAPA (MS)";"MS";"LAGUNA CARAPA";212;4;32;248
2016;"MARACAJU (MS)";"MS";"MARACAJU";1121;39;142;1302
2016;"MIRANDA (MS)";"MS";"MIRANDA";390;32;114;536
2016;"MUNDO NOVO (MS)";"MS";"MUNDO NOVO";324;44;26;394
2016;"NAVIRAI (MS)";"MS";"NAVIRAI";1010;45;180;1235
2016;"NIOAQUE (MS)";"MS";"NIOAQUE";191;24;65;280
2016;"NOVA ALVORADA DO SUL (MS)";"MS";"NOVA ALVORADA DO SUL";399;30;107;536
2016;"NOVA ANDRADINA (MS)";"MS";"NOVA ANDRADINA";1143;42;264;1449
2016;"NOVO HORIZONTE DO SUL (MS)";"MS";"NOVO HORIZONTE DO SUL";87;9;22;118
2016;"PARAISO DAS AGUAS (MS)";"MS";"PARAISO DAS AGUAS";81;17;13;111
2016;"PARANAIBA (MS)";"MS";"PARANAIBA";898;45;114;1057
2016;"PARANHOS (MS)";"MS";"PARANHOS";116;6;32;154
2016;"PEDRO GOMES (MS)";"MS";"PEDRO GOMES";111;8;17;136
2016;"PONTA PORA (MS)";"MS";"PONTA PORA";2067;122;352;2541
2016;"PORTO MURTINHO (MS)";"MS";"PORTO MURTINHO";96;14;28;138
2016;"RIBAS DO RIO PARDO (MS)";"MS";"RIBAS DO RIO PARDO";640;49;86;775
2016;"RIO BRILHANTE (MS)";"MS";"RIO BRILHANTE";727;60;139;926
2016;"RIO NEGRO (MS)";"MS";"RIO NEGRO";92;9;11;112
2016;"RIO VERDE DE MATO GROSSO (MS)";"MS";"RIO VERDE DE MATO GROSSO";411;26;32;469
2016;"ROCHEDO (MS)";"MS";"ROCHEDO";76;5;13;94
2016;"SANTA RITA DO PARDO (MS)";"MS";"SANTA RITA DO PARDO";143;8;39;190
2016;"SAO GABRIEL DO OESTE (MS)";"MS";"SAO GABRIEL DO OESTE";1054;31;93;1178
2016;"SELVIRIA (MS)";"MS";"SELVIRIA";102;18;26;146
2016;"SETE QUEDAS (MS)";"MS";"SETE QUEDAS";257;9;21;287
2016;"SIDROLANDIA (MS)";"MS";"SIDROLANDIA";730;145;303;1178
2016;"SONORA (MS)";"MS";"SONORA";241;24;113;378
2016;"TACURU (MS)";"MS";"TACURU";137;9;22;168
2016;"TAQUARUSSU (MS)";"MS";"TAQUARUSSU";57;6;15;78
2016;"TERENOS (MS)";"MS";"TERENOS";369;15;61;445
2016;"TRES LAGOAS (MS)";"MS";"TRES LAGOAS";1932;231;418;2581
2016;"VICENTINA (MS)";"MS";"VICENTINA";151;8;112;271
2016;"ACORIZAL (MT)";"MT";"ACORIZAL";23;6;3;32
2016;"AGUA BOA (MT)";"MT";"AGUA BOA";675;20;52;747
2016;"ALTA FLORESTA (MT)";"MT";"ALTA FLORESTA";1448;32;150;1630
2016;"ALTO ARAGUAIA (MT)";"MT";"ALTO ARAGUAIA";233;28;46;307
2016;"ALTO BOA VISTA (MT)";"MT";"ALTO BOA VISTA";54;0;7;61
2016;"ALTO GARCAS (MT)";"MT";"ALTO GARCAS";312;17;56;385
2016;"ALTO PARAGUAI (MT)";"MT";"ALTO PARAGUAI";50;8;8;66
2016;"ALTO TAQUARI (MT)";"MT";"ALTO TAQUARI";255;29;24;308
2016;"APIACAS (MT)";"MT";"APIACAS";151;9;11;171
2016;"ARAGUAIANA (MT)";"MT";"ARAGUAIANA";14;0;4;18
2016;"ARAGUAINHA (MT)";"MT";"ARAGUAINHA";9;2;1;12
2016;"ARAPUTANGA (MT)";"MT";"ARAPUTANGA";297;12;28;337
2016;"ARENAPOLIS (MT)";"MT";"ARENAPOLIS";214;11;64;289
2016;"ARIPUANA (MT)";"MT";"ARIPUANA";462;10;53;525
2016;"BARAO DE MELGACO (MT)";"MT";"BARAO DE MELGACO";15;5;7;27
2016;"BARRA DO BUGRES (MT)";"MT";"BARRA DO BUGRES";618;20;171;809
2016;"BARRA DO GARCAS (MT)";"MT";"BARRA DO GARCAS";926;37;205;1168
2016;"BOM JESUS DO ARAGUAIA (MT)";"MT";"BOM JESUS DO ARAGUAIA";72;2;18;92
2016;"BRASNORTE (MT)";"MT";"BRASNORTE";371;9;65;445
2016;"CACERES (MT)";"MT";"CACERES";1049;55;322;1426
2016;"CAMPINAPOLIS (MT)";"MT";"CAMPINAPOLIS";110;5;18;133
2016;"CAMPO NOVO DO PARECIS (MT)";"MT";"CAMPO NOVO DO PARECIS";830;53;146;1029
2016;"CAMPO VERDE (MT)";"MT";"CAMPO VERDE";1012;56;158;1226
2016;"CAMPOS DE JULIO (MT)";"MT";"CAMPOS DE JULIO";215;15;42;272
2016;"CANABRAVA DO NORTE (MT)";"MT";"CANABRAVA DO NORTE";42;0;10;52
2016;"CANARANA (MT)";"MT";"CANARANA";625;16;34;675
2016;"CARLINDA (MT)";"MT";"CARLINDA";159;2;27;188
2016;"CASTANHEIRA (MT)";"MT";"CASTANHEIRA";172;2;22;196
2016;"CHAPADA DOS GUIMARAES (MT)";"MT";"CHAPADA DOS GUIMARAES";224;40;56;320
2016;"CLAUDIA (MT)";"MT";"CLAUDIA";437;6;32;475
2016;"COCALINHO (MT)";"MT";"COCALINHO";35;1;9;45
2016;"COLIDER (MT)";"MT";"COLIDER";921;22;134;1077
2016;"COLNIZA (MT)";"MT";"COLNIZA";440;0;25;465
2016;"COMODORO (MT)";"MT";"COMODORO";582;12;99;693
2016;"CONFRESA (MT)";"MT";"CONFRESA";345;6;69;420
2016;"CONQUISTA D OESTE (MT)";"MT";"CONQUISTA D OESTE";58;5;13;76
2016;"COTRIGUACU (MT)";"MT";"COTRIGUACU";163;5;41;209
2016;"CUIABA (MT)";"MT";"CUIABA";10460;911;3344;14715
2016;"CURVELANDIA (MT)";"MT";"CURVELANDIA";98;0;21;119
2016;"DENISE (MT)";"MT";"DENISE";82;6;34;122
2016;"DIAMANTINO (MT)";"MT";"DIAMANTINO";528;23;94;645
2016;"DOM AQUINO (MT)";"MT";"DOM AQUINO";148;10;26;184
2016;"FELIZ NATAL (MT)";"MT";"FELIZ NATAL";267;3;27;297
2016;"FIGUEIROPOLIS D OESTE (MT)";"MT";"FIGUEIROPOLIS D OESTE";75;4;10;89
2016;"GAUCHA DO NORTE (MT)";"MT";"GAUCHA DO NORTE";150;4;24;178
2016;"GENERAL CARNEIRO (MT)";"MT";"GENERAL CARNEIRO";24;5;6;35
2016;"GLORIA D OESTE (MT)";"MT";"GLORIA D OESTE";62;3;18;83
2016;"GUARANTA DO NORTE (MT)";"MT";"GUARANTA DO NORTE";1002;16;77;1095
2016;"GUIRATINGA (MT)";"MT";"GUIRATINGA";209;11;15;235
2016;"INDIAVAI (MT)";"MT";"INDIAVAI";23;3;7;33
2016;"IPIRANGA DO NORTE (MT)";"MT";"IPIRANGA DO NORTE";169;7;13;189
2016;"ITANHANGA (MT)";"MT";"ITANHANGA";201;6;16;223
2016;"ITAUBA (MT)";"MT";"ITAUBA";136;11;14;161
2016;"ITIQUIRA (MT)";"MT";"ITIQUIRA";162;26;83;271
2016;"JACIARA (MT)";"MT";"JACIARA";675;48;154;877
2016;"JANGADA (MT)";"MT";"JANGADA";59;8;21;88
2016;"JAURU (MT)";"MT";"JAURU";173;9;43;225
2016;"JUARA (MT)";"MT";"JUARA";922;20;83;1025
2016;"JUINA (MT)";"MT";"JUINA";1071;20;98;1189
2016;"JURUENA (MT)";"MT";"JURUENA";206;2;19;227
2016;"JUSCIMEIRA (MT)";"MT";"JUSCIMEIRA";161;6;66;233
2016;"LAMBARI D OESTE (MT)";"MT";"LAMBARI D OESTE";97;2;28;127
2016;"LUCAS DO RIO VERDE (MT)";"MT";"LUCAS DO RIO VERDE";1799;64;166;2029
2016;"LUCIARA (MT)";"MT";"LUCIARA";11;0;3;14
2016;"MARCELANDIA (MT)";"MT";"MARCELANDIA";430;9;21;460
2016;"MATUPA (MT)";"MT";"MATUPA";468;9;54;531
2016;"MIRASSOL D OESTE (MT)";"MT";"MIRASSOL D OESTE";854;13;91;958
2016;"NOBRES (MT)";"MT";"NOBRES";335;36;61;432
2016;"NORTELANDIA (MT)";"MT";"NORTELANDIA";87;9;20;116
2016;"NOSSA SENHORA DO LIVRAMENTO (MT)";"MT";"NOSSA SENHORA DO LIVRAMENTO";111;6;32;149
2016;"NOVA BANDEIRANTES (MT)";"MT";"NOVA BANDEIRANTES";234;4;33;271
2016;"NOVA BRASILANDIA (MT)";"MT";"NOVA BRASILANDIA";73;2;13;88
2016;"NOVA CANAA DO NORTE (MT)";"MT";"NOVA CANAA DO NORTE";251;6;68;325
2016;"NOVA GUARITA (MT)";"MT";"NOVA GUARITA";112;4;18;134
2016;"NOVA LACERDA (MT)";"MT";"NOVA LACERDA";129;2;29;160
2016;"NOVA MARILANDIA (MT)";"MT";"NOVA MARILANDIA";55;6;11;72
2016;"NOVA MARINGA (MT)";"MT";"NOVA MARINGA";135;1;11;147
2016;"NOVA MONTE VERDE (MT)";"MT";"NOVA MONTE VERDE";174;4;14;192
2016;"NOVA MUTUM (MT)";"MT";"NOVA MUTUM";1215;24;128;1367
2016;"NOVA NAZARE (MT)";"MT";"NOVA NAZARE";9;6;5;20
2016;"NOVA OLIMPIA (MT)";"MT";"NOVA OLIMPIA";369;14;144;527
2016;"NOVA SANTA HELENA (MT)";"MT";"NOVA SANTA HELENA";70;5;12;87
2016;"NOVA UBIRATA (MT)";"MT";"NOVA UBIRATA";221;21;35;277
2016;"NOVA XAVANTINA (MT)";"MT";"NOVA XAVANTINA";476;29;48;553
2016;"NOVO HORIZONTE DO NORTE (MT)";"MT";"NOVO HORIZONTE DO NORTE";51;1;12;64
2016;"NOVO MUNDO (MT)";"MT";"NOVO MUNDO";125;2;23;150
2016;"NOVO SANTO ANTONIO (MT)";"MT";"NOVO SANTO ANTONIO";2;0;2;4
2016;"NOVO SAO JOAQUIM (MT)";"MT";"NOVO SAO JOAQUIM";117;2;18;137
2016;"PARANAITA (MT)";"MT";"PARANAITA";260;14;72;346
2016;"PARANATINGA (MT)";"MT";"PARANATINGA";515;26;80;621
2016;"PEDRA PRETA (MT)";"MT";"PEDRA PRETA";374;10;59;443
2016;"PEIXOTO DE AZEVEDO (MT)";"MT";"PEIXOTO DE AZEVEDO";448;17;79;544
2016;"PLANALTO DA SERRA (MT)";"MT";"PLANALTO DA SERRA";27;2;11;40
2016;"POCONE (MT)";"MT";"POCONE";536;25;43;604
2016;"PONTAL DO ARAGUAIA (MT)";"MT";"PONTAL DO ARAGUAIA";34;2;4;40
2016;"PONTE BRANCA (MT)";"MT";"PONTE BRANCA";6;1;1;8
2016;"PONTES E LACERDA (MT)";"MT";"PONTES E LACERDA";1043;27;130;1200
2016;"PORTO ALEGRE DO NORTE (MT)";"MT";"PORTO ALEGRE DO NORTE";100;6;36;142
2016;"PORTO DOS GAUCHOS (MT)";"MT";"PORTO DOS GAUCHOS";146;14;10;170
2016;"PORTO ESPERIDIAO (MT)";"MT";"PORTO ESPERIDIAO";162;9;58;229
2016;"PORTO ESTRELA (MT)";"MT";"PORTO ESTRELA";36;4;11;51
2016;"POXOREO (MT)";"MT";"POXOREO";153;25;51;229
2016;"PRIMAVERA DO LESTE (MT)";"MT";"PRIMAVERA DO LESTE";2185;104;202;2491
2016;"QUERENCIA (MT)";"MT";"QUERENCIA";405;31;48;484
2016;"RESERVA DO CABACAL (MT)";"MT";"RESERVA DO CABACAL";18;1;8;27
2016;"RIBEIRAO CASCALHEIRA (MT)";"MT";"RIBEIRAO CASCALHEIRA";142;12;19;173
2016;"RIBEIRAOZINHO (MT)";"MT";"RIBEIRAOZINHO";11;1;7;19
2016;"RIO BRANCO (MT)";"MT";"RIO BRANCO";92;4;32;128
2016;"RONDOLANDIA (MT)";"MT";"RONDOLANDIA";31;0;16;47
2016;"RONDONOPOLIS (MT)";"MT";"RONDONOPOLIS";4734;197;527;5458
2016;"ROSARIO OESTE (MT)";"MT";"ROSARIO OESTE";180;15;42;237
2016;"SALTO DO CEU (MT)";"MT";"SALTO DO CEU";53;8;24;85
2016;"SANTA CARMEM (MT)";"MT";"SANTA CARMEM";168;5;15;188
2016;"SANTA CRUZ DO XINGU (MT)";"MT";"SANTA CRUZ DO XINGU";15;1;7;23
2016;"SANTA RITA DO TRIVELATO (MT)";"MT";"SANTA RITA DO TRIVELATO";88;3;15;106
2016;"SANTA TEREZINHA (MT)";"MT";"SANTA TEREZINHA";12;2;16;30
2016;"SANTO AFONSO (MT)";"MT";"SANTO AFONSO";32;3;13;48
2016;"SANTO ANTONIO DO LESTE (MT)";"MT";"SANTO ANTONIO DO LESTE";69;6;19;94
2016;"SANTO ANTONIO DO LEVERGER (MT)";"MT";"SANTO ANTONIO DO LEVERGER";143;10;15;168
2016;"SAO FELIX DO ARAGUAIA (MT)";"MT";"SAO FELIX DO ARAGUAIA";58;17;26;101
2016;"SAO JOSE DO POVO (MT)";"MT";"SAO JOSE DO POVO";16;3;5;24
2016;"SAO JOSE DO RIO CLARO (MT)";"MT";"SAO JOSE DO RIO CLARO";364;16;54;434
2016;"SAO JOSE DO XINGU (MT)";"MT";"SAO JOSE DO XINGU";33;2;13;48
2016;"SAO JOSE DOS QUATRO MARCOS (MT)";"MT";"SAO JOSE DOS QUATRO MARCOS";499;11;75;585
2016;"SAO PEDRO DA CIPA (MT)";"MT";"SAO PEDRO DA CIPA";24;8;24;56
2016;"SAPEZAL (MT)";"MT";"SAPEZAL";593;49;112;754
2016;"SERRA NOVA DOURADA (MT)";"MT";"SERRA NOVA DOURADA";5;1;2;8
2016;"SINOP (MT)";"MT";"SINOP";3712;148;215;4075
2016;"SORRISO (MT)";"MT";"SORRISO";2485;87;204;2776
2016;"TABAPORA (MT)";"MT";"TABAPORA";176;4;28;208
2016;"TANGARA DA SERRA (MT)";"MT";"TANGARA DA SERRA";2166;94;219;2479
2016;"TAPURAH (MT)";"MT";"TAPURAH";369;8;40;417
2016;"TERRA NOVA DO NORTE (MT)";"MT";"TERRA NOVA DO NORTE";308;11;34;353
2016;"TESOURO (MT)";"MT";"TESOURO";18;5;5;28
2016;"TORIXOREU (MT)";"MT";"TORIXOREU";38;5;5;48
2016;"UNIAO DO SUL (MT)";"MT";"UNIAO DO SUL";108;0;11;119
2016;"VALE DE SAO DOMINGOS (MT)";"MT";"VALE DE SAO DOMINGOS";30;0;15;45
2016;"VARZEA GRANDE (MT)";"MT";"VARZEA GRANDE";5225;346;631;6202
2016;"VERA (MT)";"MT";"VERA";281;2;28;311
2016;"VILA BELA DA SANTISSIMA TRINDA (MT)";"MT";"VILA BELA DA SANTISSIMA TRINDA";142;5;48;195
2016;"VILA RICA (MT)";"MT";"VILA RICA";337;2;42;381
2016;"ABAETETUBA (PA)";"PA";"ABAETETUBA";378;25;271;674
2016;"ABEL FIGUEIREDO (PA)";"PA";"ABEL FIGUEIREDO";69;5;4;78
2016;"ACARA (PA)";"PA";"ACARA";106;12;91;209
2016;"AFUA (PA)";"PA";"AFUA";2;0;0;2
2016;"AGUA AZUL DO NORTE (PA)";"PA";"AGUA AZUL DO NORTE";94;10;31;135
2016;"ALENQUER (PA)";"PA";"ALENQUER";220;6;71;297
2016;"ALMEIRIM (PA)";"PA";"ALMEIRIM";252;25;101;378
2016;"ALTAMIRA (PA)";"PA";"ALTAMIRA";2123;193;658;2974
2016;"ANAJAS (PA)";"PA";"ANAJAS";0;0;1;1
2016;"ANANINDEUA (PA)";"PA";"ANANINDEUA";4565;367;1559;6491
2016;"ANAPU (PA)";"PA";"ANAPU";141;17;19;177
2016;"AUGUSTO CORREA (PA)";"PA";"AUGUSTO CORREA";50;2;62;114
2016;"AURORA DO PARA (PA)";"PA";"AURORA DO PARA";101;13;77;191
2016;"AVEIRO (PA)";"PA";"AVEIRO";4;0;6;10
2016;"BAGRE (PA)";"PA";"BAGRE";1;0;2;3
2016;"BAIAO (PA)";"PA";"BAIAO";64;6;28;98
2016;"BANNACH (PA)";"PA";"BANNACH";21;0;3;24
2016;"BARCARENA (PA)";"PA";"BARCARENA";1047;174;762;1983
2016;"BELEM (PA)";"PA";"BELEM";9229;2193;3818;15240
2016;"BELTERRA (PA)";"PA";"BELTERRA";55;9;58;122
2016;"BENEVIDES (PA)";"PA";"BENEVIDES";1011;61;139;1211
2016;"BOM JESUS DO TOCANTINS (PA)";"PA";"BOM JESUS DO TOCANTINS";89;9;10;108
2016;"BONITO (PA)";"PA";"BONITO";51;3;57;111
2016;"BRAGANCA (PA)";"PA";"BRAGANCA";467;34;197;698
2016;"BRASIL NOVO (PA)";"PA";"BRASIL NOVO";200;16;18;234
2016;"BREJO GRANDE DO ARAGUAIA (PA)";"PA";"BREJO GRANDE DO ARAGUAIA";31;4;9;44
2016;"BREU BRANCO (PA)";"PA";"BREU BRANCO";318;11;113;442
2016;"BREVES (PA)";"PA";"BREVES";74;3;10;87
2016;"BUJARU (PA)";"PA";"BUJARU";51;9;35;95
2016;"CACHOEIRA DO ARARI (PA)";"PA";"CACHOEIRA DO ARARI";15;4;17;36
2016;"CACHOEIRA DO PIRIA (PA)";"PA";"CACHOEIRA DO PIRIA";40;5;33;78
2016;"CAMETA (PA)";"PA";"CAMETA";160;10;72;242
2016;"CANAA DOS CARAJAS (PA)";"PA";"CANAA DOS CARAJAS";432;80;306;818
2016;"CAPANEMA (PA)";"PA";"CAPANEMA";765;30;121;916
2016;"CAPITAO POCO (PA)";"PA";"CAPITAO POCO";456;20;107;583
2016;"CASTANHAL (PA)";"PA";"CASTANHAL";2886;185;440;3511
2016;"CHAVES (PA)";"PA";"CHAVES";1;0;0;1
2016;"COLARES (PA)";"PA";"COLARES";8;0;4;12
2016;"CONCEICAO DO ARAGUAIA (PA)";"PA";"CONCEICAO DO ARAGUAIA";449;46;95;590
2016;"CONCORDIA DO PARA (PA)";"PA";"CONCORDIA DO PARA";176;13;78;267
2016;"CUMARU DO NORTE (PA)";"PA";"CUMARU DO NORTE";29;1;11;41
2016;"CURIONOPOLIS (PA)";"PA";"CURIONOPOLIS";154;100;13;267
2016;"CURRALINHO (PA)";"PA";"CURRALINHO";2;0;2;4
2016;"CURUA (PA)";"PA";"CURUA";8;1;4;13
2016;"CURUCA (PA)";"PA";"CURUCA";56;14;19;89
2016;"DOM ELISEU (PA)";"PA";"DOM ELISEU";601;64;60;725
2016;"ELDORADO DOS CARAJAS (PA)";"PA";"ELDORADO DOS CARAJAS";216;53;22;291
2016;"FARO (PA)";"PA";"FARO";3;1;1;5
2016;"FLORESTA DO ARAGUAIA (PA)";"PA";"FLORESTA DO ARAGUAIA";178;1;28;207
2016;"GARRAFAO DO NORTE (PA)";"PA";"GARRAFAO DO NORTE";122;6;19;147
2016;"GOIANESIA DO PARA (PA)";"PA";"GOIANESIA DO PARA";307;22;44;373
2016;"GURUPA (PA)";"PA";"GURUPA";11;0;3;14
2016;"IGARAPE ACU (PA)";"PA";"IGARAPE ACU";211;80;98;389
2016;"IGARAPE MIRI (PA)";"PA";"IGARAPE MIRI";95;25;43;163
2016;"INHANGAPI (PA)";"PA";"INHANGAPI";42;2;36;80
2016;"IPIXUNA DO PARA (PA)";"PA";"IPIXUNA DO PARA";85;12;47;144
2016;"IRITUIA (PA)";"PA";"IRITUIA";94;6;62;162
2016;"ITAITUBA (PA)";"PA";"ITAITUBA";1146;47;143;1336
2016;"ITUPIRANGA (PA)";"PA";"ITUPIRANGA";239;93;46;378
2016;"JACAREACANGA (PA)";"PA";"JACAREACANGA";29;2;1;32
2016;"JACUNDA (PA)";"PA";"JACUNDA";658;26;58;742
2016;"JURUTI (PA)";"PA";"JURUTI";108;12;16;136
2016;"LIMOEIRO DO AJURU (PA)";"PA";"LIMOEIRO DO AJURU";2;0;5;7
2016;"MAE DO RIO (PA)";"PA";"MAE DO RIO";359;31;67;457
2016;"MAGALHAES BARATA (PA)";"PA";"MAGALHAES BARATA";13;8;9;30
2016;"MARABA (PA)";"PA";"MARABA";3691;312;772;4775
2016;"MARACANA (PA)";"PA";"MARACANA";35;11;31;77
2016;"MARAPANIM (PA)";"PA";"MARAPANIM";40;12;32;84
2016;"MARITUBA (PA)";"PA";"MARITUBA";942;100;584;1626
2016;"MEDICILANDIA (PA)";"PA";"MEDICILANDIA";243;10;37;290
2016;"MELGACO (PA)";"PA";"MELGACO";7;1;4;12
2016;"MOCAJUBA (PA)";"PA";"MOCAJUBA";22;3;12;37
2016;"MOJU (PA)";"PA";"MOJU";251;24;257;532
2016;"MOJUI DOS CAMPOS (PA)";"PA";"MOJUI DOS CAMPOS";44;1;37;82
2016;"MONTE ALEGRE (PA)";"PA";"MONTE ALEGRE";319;15;172;506
2016;"MUANA (PA)";"PA";"MUANA";6;3;12;21
2016;"NOVA ESPERANCA DO PIRIA (PA)";"PA";"NOVA ESPERANCA DO PIRIA";96;5;23;124
2016;"NOVA IPIXUNA (PA)";"PA";"NOVA IPIXUNA";161;2;27;190
2016;"NOVA TIMBOTEUA (PA)";"PA";"NOVA TIMBOTEUA";75;3;25;103
2016;"NOVO PROGRESSO (PA)";"PA";"NOVO PROGRESSO";816;9;44;869
2016;"NOVO REPARTIMENTO (PA)";"PA";"NOVO REPARTIMENTO";521;38;62;621
2016;"OBIDOS (PA)";"PA";"OBIDOS";216;3;63;282
2016;"OEIRAS DO PARA (PA)";"PA";"OEIRAS DO PARA";10;1;13;24
2016;"ORIXIMINA (PA)";"PA";"ORIXIMINA";363;16;39;418
2016;"OUREM (PA)";"PA";"OUREM";175;4;20;199
2016;"OURILANDIA DO NORTE (PA)";"PA";"OURILANDIA DO NORTE";311;11;40;362
2016;"PACAJA (PA)";"PA";"PACAJA";152;32;12;196
2016;"PALESTINA DO PARA (PA)";"PA";"PALESTINA DO PARA";30;6;6;42
2016;"PARAGOMINAS (PA)";"PA";"PARAGOMINAS";1454;64;184;1702
2016;"PARAUAPEBAS (PA)";"PA";"PARAUAPEBAS";2407;631;1211;4249
2016;"PAU D ARCO (PA)";"PA";"PAU D ARCO";21;12;7;40
2016;"PEIXE BOI (PA)";"PA";"PEIXE BOI";22;6;14;42
2016;"PICARRA (PA)";"PA";"PICARRA";39;0;8;47
2016;"PLACAS (PA)";"PA";"PLACAS";107;6;4;117
2016;"PONTA DE PEDRAS (PA)";"PA";"PONTA DE PEDRAS";20;2;6;28
2016;"PORTEL (PA)";"PA";"PORTEL";25;2;11;38
2016;"PORTO DE MOZ (PA)";"PA";"PORTO DE MOZ";26;1;7;34
2016;"PRAINHA (PA)";"PA";"PRAINHA";36;0;5;41
2016;"PRIMAVERA (PA)";"PA";"PRIMAVERA";35;4;23;62
2016;"QUATIPURU (PA)";"PA";"QUATIPURU";11;5;20;36
2016;"REDENCAO (PA)";"PA";"REDENCAO";1788;88;183;2059
2016;"RIO MARIA (PA)";"PA";"RIO MARIA";331;32;55;418
2016;"RONDON DO PARA (PA)";"PA";"RONDON DO PARA";535;48;27;610
2016;"RUROPOLIS (PA)";"PA";"RUROPOLIS";242;12;24;278
2016;"SALINOPOLIS (PA)";"PA";"SALINOPOLIS";164;38;90;292
2016;"SALVATERRA (PA)";"PA";"SALVATERRA";48;36;30;114
2016;"SANTA BARBARA DO PARA (PA)";"PA";"SANTA BARBARA DO PARA";76;23;119;218
2016;"SANTA CRUZ DO ARARI (PA)";"PA";"SANTA CRUZ DO ARARI";5;1;1;7
2016;"SANTA ISABEL DO PARA (PA)";"PA";"SANTA ISABEL DO PARA";765;54;163;982
2016;"SANTA LUZIA DO PARA (PA)";"PA";"SANTA LUZIA DO PARA";129;12;34;175
2016;"SANTA MARIA DAS BARREIRAS (PA)";"PA";"SANTA MARIA DAS BARREIRAS";100;5;37;142
2016;"SANTA MARIA DO PARA (PA)";"PA";"SANTA MARIA DO PARA";348;25;50;423
2016;"SANTANA DO ARAGUAIA (PA)";"PA";"SANTANA DO ARAGUAIA";302;14;42;358
2016;"SANTAREM (PA)";"PA";"SANTAREM";3093;147;816;4056
2016;"SANTAREM NOVO (PA)";"PA";"SANTAREM NOVO";10;3;19;32
2016;"SANTO ANTONIO DO TAUA (PA)";"PA";"SANTO ANTONIO DO TAUA";156;24;104;284
2016;"SAO CAETANO DE ODIVELAS (PA)";"PA";"SAO CAETANO DE ODIVELAS";28;1;15;44
2016;"SAO DOMINGOS DO ARAGUAIA (PA)";"PA";"SAO DOMINGOS DO ARAGUAIA";188;27;29;244
2016;"SAO DOMINGOS DO CAPIM (PA)";"PA";"SAO DOMINGOS DO CAPIM";41;0;35;76
2016;"SAO FELIX DO XINGU (PA)";"PA";"SAO FELIX DO XINGU";405;9;41;455
2016;"SAO FRANCISCO DO PARA (PA)";"PA";"SAO FRANCISCO DO PARA";60;34;32;126
2016;"SAO GERALDO DO ARAGUAIA (PA)";"PA";"SAO GERALDO DO ARAGUAIA";142;6;21;169
2016;"SAO JOAO DA PONTA (PA)";"PA";"SAO JOAO DA PONTA";4;3;9;16
2016;"SAO JOAO DE PIRABAS (PA)";"PA";"SAO JOAO DE PIRABAS";38;8;26;72
2016;"SAO JOAO DO ARAGUAIA (PA)";"PA";"SAO JOAO DO ARAGUAIA";27;15;11;53
2016;"SAO MIGUEL DO GUAMA (PA)";"PA";"SAO MIGUEL DO GUAMA";447;25;133;605
2016;"SAO SEBASTIAO DA BOA VISTA (PA)";"PA";"SAO SEBASTIAO DA BOA VISTA";5;0;1;6
2016;"SAPUCAIA (PA)";"PA";"SAPUCAIA";40;4;11;55
2016;"SENADOR JOSE PORFIRIO (PA)";"PA";"SENADOR JOSE PORFIRIO";39;2;10;51
2016;"SOURE (PA)";"PA";"SOURE";37;2;17;56
2016;"TAILANDIA (PA)";"PA";"TAILANDIA";780;40;212;1032
2016;"TERRA ALTA (PA)";"PA";"TERRA ALTA";20;18;20;58
2016;"TERRA SANTA (PA)";"PA";"TERRA SANTA";28;0;3;31
2016;"TOME ACU (PA)";"PA";"TOME ACU";575;18;166;759
2016;"TRACUATEUA (PA)";"PA";"TRACUATEUA";46;7;50;103
2016;"TRAIRAO (PA)";"PA";"TRAIRAO";153;2;13;168
2016;"TUCUMA (PA)";"PA";"TUCUMA";672;22;97;791
2016;"TUCURUI (PA)";"PA";"TUCURUI";915;91;225;1231
2016;"ULIANOPOLIS (PA)";"PA";"ULIANOPOLIS";223;25;48;296
2016;"URUARA (PA)";"PA";"URUARA";571;20;39;630
2016;"VIGIA (PA)";"PA";"VIGIA";163;19;88;270
2016;"VISEU (PA)";"PA";"VISEU";86;6;49;141
2016;"VITORIA DO XINGU (PA)";"PA";"VITORIA DO XINGU";49;27;23;99
2016;"XINGUARA (PA)";"PA";"XINGUARA";1049;26;111;1186
2016;"AGUA BRANCA (PB)";"PB";"AGUA BRANCA";17;13;6;36
2016;"AGUIAR (PB)";"PB";"AGUIAR";11;7;3;21
2016;"ALAGOA GRANDE (PB)";"PB";"ALAGOA GRANDE";124;36;44;204
2016;"ALAGOA NOVA (PB)";"PB";"ALAGOA NOVA";161;38;14;213
2016;"ALAGOINHA (PB)";"PB";"ALAGOINHA";43;20;33;96
2016;"ALCANTIL (PB)";"PB";"ALCANTIL";66;14;15;95
2016;"ALGODAO DE JANDAIRA (PB)";"PB";"ALGODAO DE JANDAIRA";33;0;4;37
2016;"ALHANDRA (PB)";"PB";"ALHANDRA";182;23;35;240
2016;"AMPARO (PB)";"PB";"AMPARO";13;10;7;30
2016;"APARECIDA (PB)";"PB";"APARECIDA";43;7;18;68
2016;"ARACAGI (PB)";"PB";"ARACAGI";77;2;52;131
2016;"ARARA (PB)";"PB";"ARARA";85;10;20;115
2016;"ARARUNA (PB)";"PB";"ARARUNA";93;45;17;155
2016;"AREIA (PB)";"PB";"AREIA";126;39;28;193
2016;"AREIA DE BARAUNAS (PB)";"PB";"AREIA DE BARAUNAS";6;4;2;12
2016;"AREIAL (PB)";"PB";"AREIAL";45;11;9;65
2016;"AROEIRAS (PB)";"PB";"AROEIRAS";94;62;19;175
2016;"ASSUNCAO (PB)";"PB";"ASSUNCAO";33;6;5;44
2016;"BAIA DA TRAICAO (PB)";"PB";"BAIA DA TRAICAO";15;8;14;37
2016;"BANANEIRAS (PB)";"PB";"BANANEIRAS";115;34;31;180
2016;"BARAUNA (PB)";"PB";"BARAUNA";30;2;6;38
2016;"BARRA DE SANTA ROSA (PB)";"PB";"BARRA DE SANTA ROSA";106;7;19;132
2016;"BARRA DE SANTANA (PB)";"PB";"BARRA DE SANTANA";89;7;17;113
2016;"BARRA DE SAO MIGUEL (PB)";"PB";"BARRA DE SAO MIGUEL";16;3;5;24
2016;"BAYEUX (PB)";"PB";"BAYEUX";758;50;172;980
2016;"BELEM (PB)";"PB";"BELEM";139;12;13;164
2016;"BELEM DO BREJO DO CRUZ (PB)";"PB";"BELEM DO BREJO DO CRUZ";17;11;4;32
2016;"BERNARDINO BATISTA (PB)";"PB";"BERNARDINO BATISTA";6;1;5;12
2016;"BOA VENTURA (PB)";"PB";"BOA VENTURA";16;2;2;20
2016;"BOA VISTA (PB)";"PB";"BOA VISTA";116;11;21;148
2016;"BOM JESUS (PB)";"PB";"BOM JESUS";12;0;3;15
2016;"BOM SUCESSO (PB)";"PB";"BOM SUCESSO";14;3;8;25
2016;"BONITO DE SANTA FE (PB)";"PB";"BONITO DE SANTA FE";33;15;3;51
2016;"BOQUEIRAO (PB)";"PB";"BOQUEIRAO";235;14;26;275
2016;"BORBOREMA (PB)";"PB";"BORBOREMA";47;8;3;58
2016;"BREJO DO CRUZ (PB)";"PB";"BREJO DO CRUZ";75;12;7;94
2016;"BREJO DOS SANTOS (PB)";"PB";"BREJO DOS SANTOS";32;3;4;39
2016;"CAAPORA (PB)";"PB";"CAAPORA";51;13;12;76
2016;"CABACEIRAS (PB)";"PB";"CABACEIRAS";28;4;18;50
2016;"CABEDELO (PB)";"PB";"CABEDELO";520;47;32;599
2016;"CACHOEIRA DOS INDIOS (PB)";"PB";"CACHOEIRA DOS INDIOS";20;5;8;33
2016;"CACIMBA DE AREIA (PB)";"PB";"CACIMBA DE AREIA";6;3;5;14
2016;"CACIMBA DE DENTRO (PB)";"PB";"CACIMBA DE DENTRO";84;13;35;132
2016;"CACIMBAS (PB)";"PB";"CACIMBAS";7;11;5;23
2016;"CAICARA (PB)";"PB";"CAICARA";17;4;6;27
2016;"CAJAZEIRAS (PB)";"PB";"CAJAZEIRAS";478;55;65;598
2016;"CAJAZEIRINHAS (PB)";"PB";"CAJAZEIRINHAS";8;0;3;11
2016;"CALDAS BRANDAO (PB)";"PB";"CALDAS BRANDAO";42;4;9;55
2016;"CAMALAU (PB)";"PB";"CAMALAU";31;10;16;57
2016;"CAMPINA GRANDE (PB)";"PB";"CAMPINA GRANDE";4436;361;859;5656
2016;"CAPIM (PB)";"PB";"CAPIM";36;13;15;64
2016;"CARAUBAS (PB)";"PB";"CARAUBAS";13;11;4;28
2016;"CARRAPATEIRA (PB)";"PB";"CARRAPATEIRA";6;0;3;9
2016;"CASSERENGUE (PB)";"PB";"CASSERENGUE";41;11;17;69
2016;"CATINGUEIRA (PB)";"PB";"CATINGUEIRA";17;4;2;23
2016;"CATOLE DO ROCHA (PB)";"PB";"CATOLE DO ROCHA";270;57;15;342
2016;"CATURITE (PB)";"PB";"CATURITE";121;16;14;151
2016;"CONCEICAO (PB)";"PB";"CONCEICAO";102;34;9;145
2016;"CONDADO (PB)";"PB";"CONDADO";44;7;9;60
2016;"CONDE (PB)";"PB";"CONDE";112;26;18;156
2016;"CONGO (PB)";"PB";"CONGO";24;9;8;41
2016;"COREMAS (PB)";"PB";"COREMAS";74;25;10;109
2016;"COXIXOLA (PB)";"PB";"COXIXOLA";5;8;0;13
2016;"CRUZ DO ESPIRITO SANTO (PB)";"PB";"CRUZ DO ESPIRITO SANTO";35;8;28;71
2016;"CUBATI (PB)";"PB";"CUBATI";48;8;5;61
2016;"CUITE (PB)";"PB";"CUITE";115;10;20;145
2016;"CUITE DE MAMANGUAPE (PB)";"PB";"CUITE DE MAMANGUAPE";19;9;29;57
2016;"CUITEGI (PB)";"PB";"CUITEGI";27;6;3;36
2016;"CURRAL DE CIMA (PB)";"PB";"CURRAL DE CIMA";17;5;20;42
2016;"CURRAL VELHO (PB)";"PB";"CURRAL VELHO";6;5;2;13
2016;"DAMIAO (PB)";"PB";"DAMIAO";37;7;9;53
2016;"DESTERRO (PB)";"PB";"DESTERRO";28;16;7;51
2016;"DIAMANTE (PB)";"PB";"DIAMANTE";19;5;4;28
2016;"DONA INES (PB)";"PB";"DONA INES";53;12;19;84
2016;"DUAS ESTRADAS (PB)";"PB";"DUAS ESTRADAS";13;6;4;23
2016;"EMAS (PB)";"PB";"EMAS";9;5;3;17
2016;"ESPERANCA (PB)";"PB";"ESPERANCA";560;28;97;685
2016;"FAGUNDES (PB)";"PB";"FAGUNDES";45;13;31;89
2016;"FREI MARTINHO (PB)";"PB";"FREI MARTINHO";10;1;6;17
2016;"GADO BRAVO (PB)";"PB";"GADO BRAVO";44;27;22;93
2016;"GUARABIRA (PB)";"PB";"GUARABIRA";567;73;185;825
2016;"GURINHEM (PB)";"PB";"GURINHEM";42;9;24;75
2016;"GURJAO (PB)";"PB";"GURJAO";22;3;6;31
2016;"IBIARA (PB)";"PB";"IBIARA";10;6;4;20
2016;"IGARACY (PB)";"PB";"IGARACY";20;10;5;35
2016;"IMACULADA (PB)";"PB";"IMACULADA";17;13;5;35
2016;"INGA (PB)";"PB";"INGA";129;13;35;177
2016;"ITABAIANA (PB)";"PB";"ITABAIANA";150;14;42;206
2016;"ITAPORANGA (PB)";"PB";"ITAPORANGA";153;45;25;223
2016;"ITAPOROROCA (PB)";"PB";"ITAPOROROCA";124;4;32;160
2016;"ITATUBA (PB)";"PB";"ITATUBA";34;4;15;53
2016;"JACARAU (PB)";"PB";"JACARAU";70;3;19;92
2016;"JERICO (PB)";"PB";"JERICO";32;6;3;41
2016;"JOAO PESSOA (PB)";"PB";"JOAO PESSOA";6115;1148;2343;9606
2016;"JUAREZ TAVORA (PB)";"PB";"JUAREZ TAVORA";29;4;14;47
2016;"JUAZEIRINHO (PB)";"PB";"JUAZEIRINHO";93;18;13;124
2016;"JUNCO DO SERIDO (PB)";"PB";"JUNCO DO SERIDO";64;3;4;71
2016;"JURIPIRANGA (PB)";"PB";"JURIPIRANGA";52;4;21;77
2016;"JURU (PB)";"PB";"JURU";15;8;4;27
2016;"LAGOA (PB)";"PB";"LAGOA";16;4;5;25
2016;"LAGOA DE DENTRO (PB)";"PB";"LAGOA DE DENTRO";43;6;16;65
2016;"LAGOA SECA (PB)";"PB";"LAGOA SECA";238;49;17;304
2016;"LASTRO (PB)";"PB";"LASTRO";4;3;4;11
2016;"LIVRAMENTO (PB)";"PB";"LIVRAMENTO";39;4;5;48
2016;"LOGRADOURO (PB)";"PB";"LOGRADOURO";6;3;12;21
2016;"LUCENA (PB)";"PB";"LUCENA";30;4;20;54
2016;"MAE D AGUA (PB)";"PB";"MAE D AGUA";6;0;4;10
2016;"MALTA (PB)";"PB";"MALTA";14;7;3;24
2016;"MAMANGUAPE (PB)";"PB";"MAMANGUAPE";463;20;108;591
2016;"MANAIRA (PB)";"PB";"MANAIRA";21;15;2;38
2016;"MARCACAO (PB)";"PB";"MARCACAO";5;5;19;29
2016;"MARI (PB)";"PB";"MARI";118;10;55;183
2016;"MARIZOPOLIS (PB)";"PB";"MARIZOPOLIS";44;4;2;50
2016;"MASSARANDUBA (PB)";"PB";"MASSARANDUBA";44;22;10;76
2016;"MATARACA (PB)";"PB";"MATARACA";49;4;15;68
2016;"MATINHAS (PB)";"PB";"MATINHAS";12;3;4;19
2016;"MATO GROSSO (PB)";"PB";"MATO GROSSO";11;3;3;17
2016;"MATUREIA (PB)";"PB";"MATUREIA";19;27;7;53
2016;"MOGEIRO (PB)";"PB";"MOGEIRO";36;8;6;50
2016;"MONTADAS (PB)";"PB";"MONTADAS";45;5;8;58
2016;"MONTE HOREBE (PB)";"PB";"MONTE HOREBE";9;4;5;18
2016;"MONTEIRO (PB)";"PB";"MONTEIRO";299;77;53;429
2016;"MULUNGU (PB)";"PB";"MULUNGU";52;10;19;81
2016;"NATUBA (PB)";"PB";"NATUBA";29;4;6;39
2016;"NAZAREZINHO (PB)";"PB";"NAZAREZINHO";30;9;4;43
2016;"NOVA FLORESTA (PB)";"PB";"NOVA FLORESTA";40;10;11;61
2016;"NOVA OLINDA (PB)";"PB";"NOVA OLINDA";24;9;6;39
2016;"NOVA PALMEIRA (PB)";"PB";"NOVA PALMEIRA";31;1;4;36
2016;"OLHO D AGUA (PB)";"PB";"OLHO D AGUA";9;7;5;21
2016;"OLIVEDOS (PB)";"PB";"OLIVEDOS";34;4;9;47
2016;"OURO VELHO (PB)";"PB";"OURO VELHO";15;4;5;24
2016;"PARARI (PB)";"PB";"PARARI";7;2;2;11
2016;"PASSAGEM (PB)";"PB";"PASSAGEM";18;0;2;20
2016;"PATOS (PB)";"PB";"PATOS";760;163;59;982
2016;"PAULISTA (PB)";"PB";"PAULISTA";66;10;13;89
2016;"PEDRA BRANCA (PB)";"PB";"PEDRA BRANCA";11;8;2;21
2016;"PEDRA LAVRADA (PB)";"PB";"PEDRA LAVRADA";50;4;11;65
2016;"PEDRAS DE FOGO (PB)";"PB";"PEDRAS DE FOGO";278;33;91;402
2016;"PEDRO REGIS (PB)";"PB";"PEDRO REGIS";19;1;4;24
2016;"PIANCO (PB)";"PB";"PIANCO";93;15;7;115
2016;"PICUI (PB)";"PB";"PICUI";148;11;45;204
2016;"PILAR (PB)";"PB";"PILAR";34;3;14;51
2016;"PILOES (PB)";"PB";"PILOES";32;2;9;43
2016;"PILOEZINHOS (PB)";"PB";"PILOEZINHOS";14;3;7;24
2016;"PIRPIRITUBA (PB)";"PB";"PIRPIRITUBA";39;0;14;53
2016;"PITIMBU (PB)";"PB";"PITIMBU";39;23;10;72
2016;"POCINHOS (PB)";"PB";"POCINHOS";151;25;30;206
2016;"POCO DANTAS (PB)";"PB";"POCO DANTAS";8;2;5;15
2016;"POCO DE JOSE DE MOURA (PB)";"PB";"POCO DE JOSE DE MOURA";7;6;6;19
2016;"POMBAL (PB)";"PB";"POMBAL";348;58;18;424
2016;"PRATA (PB)";"PB";"PRATA";29;10;6;45
2016;"PRINCESA ISABEL (PB)";"PB";"PRINCESA ISABEL";113;93;18;224
2016;"PUXINANA (PB)";"PB";"PUXINANA";84;30;15;129
2016;"QUEIMADAS (PB)";"PB";"QUEIMADAS";487;104;90;681
2016;"QUIXABA (PB)";"PB";"QUIXABA";10;2;4;16
2016;"REMIGIO (PB)";"PB";"REMIGIO";317;9;28;354
2016;"RIACHAO (PB)";"PB";"RIACHAO";9;2;6;17
2016;"RIACHAO DO BACAMARTE (PB)";"PB";"RIACHAO DO BACAMARTE";24;2;5;31
2016;"RIACHAO DO POCO (PB)";"PB";"RIACHAO DO POCO";20;1;13;34
2016;"RIACHO DE SANTO ANTONIO (PB)";"PB";"RIACHO DE SANTO ANTONIO";13;4;3;20
2016;"RIACHO DOS CAVALOS (PB)";"PB";"RIACHO DOS CAVALOS";32;3;6;41
2016;"RIO TINTO (PB)";"PB";"RIO TINTO";97;10;45;152
2016;"SALGADINHO (PB)";"PB";"SALGADINHO";6;5;5;16
2016;"SALGADO DE SAO FELIX (PB)";"PB";"SALGADO DE SAO FELIX";24;5;11;40
2016;"SANTA CECILIA (PB)";"PB";"SANTA CECILIA";33;10;14;57
2016;"SANTA CRUZ (PB)";"PB";"SANTA CRUZ";17;3;14;34
2016;"SANTA HELENA (PB)";"PB";"SANTA HELENA";11;5;12;28
2016;"SANTA INES (PB)";"PB";"SANTA INES";13;3;3;19
2016;"SANTA LUZIA (PB)";"PB";"SANTA LUZIA";159;15;17;191
2016;"SANTA RITA (PB)";"PB";"SANTA RITA";902;95;290;1287
2016;"SANTA TERESINHA (PB)";"PB";"SANTA TERESINHA";28;4;6;38
2016;"SANTANA DE MANGUEIRA (PB)";"PB";"SANTANA DE MANGUEIRA";4;1;3;8
2016;"SANTANA DOS GARROTES (PB)";"PB";"SANTANA DOS GARROTES";23;11;4;38
2016;"SANTAREM (PB)";"PB";"SANTAREM";6;2;4;12
2016;"SANTO ANDRE (PB)";"PB";"SANTO ANDRE";18;5;23;46
2016;"SAO BENTINHO (PB)";"PB";"SAO BENTINHO";21;4;3;28
2016;"SAO BENTO (PB)";"PB";"SAO BENTO";253;31;20;304
2016;"SAO DOMINGOS DE POMBAL (PB)";"PB";"SAO DOMINGOS DE POMBAL";7;3;6;16
2016;"SAO DOMINGOS DO CARIRI (PB)";"PB";"SAO DOMINGOS DO CARIRI";9;4;4;17
2016;"SAO FRANCISCO (PB)";"PB";"SAO FRANCISCO";11;2;4;17
2016;"SAO JOAO DO CARIRI (PB)";"PB";"SAO JOAO DO CARIRI";32;4;10;46
2016;"SAO JOAO DO RIO DO PEIXE (PB)";"PB";"SAO JOAO DO RIO DO PEIXE";78;10;22;110
2016;"SAO JOAO DO TIGRE (PB)";"PB";"SAO JOAO DO TIGRE";16;4;5;25
2016;"SAO JOSE DA LAGOA TAPADA (PB)";"PB";"SAO JOSE DA LAGOA TAPADA";26;5;7;38
2016;"SAO JOSE DE CAIANA (PB)";"PB";"SAO JOSE DE CAIANA";9;7;6;22
2016;"SAO JOSE DE ESPINHARAS (PB)";"PB";"SAO JOSE DE ESPINHARAS";22;5;6;33
2016;"SAO JOSE DE PIRANHAS (PB)";"PB";"SAO JOSE DE PIRANHAS";51;18;10;79
2016;"SAO JOSE DE PRINCESA (PB)";"PB";"SAO JOSE DE PRINCESA";6;7;3;16
2016;"SAO JOSE DO BONFIM (PB)";"PB";"SAO JOSE DO BONFIM";11;3;3;17
2016;"SAO JOSE DO BREJO DO CRUZ (PB)";"PB";"SAO JOSE DO BREJO DO CRUZ";4;1;2;7
2016;"SAO JOSE DO SABUGI (PB)";"PB";"SAO JOSE DO SABUGI";23;1;6;30
2016;"SAO JOSE DOS CORDEIROS (PB)";"PB";"SAO JOSE DOS CORDEIROS";14;8;3;25
2016;"SAO JOSE DOS RAMOS (PB)";"PB";"SAO JOSE DOS RAMOS";23;1;10;34
2016;"SAO MAMEDE (PB)";"PB";"SAO MAMEDE";30;3;5;38
2016;"SAO MIGUEL DE TAIPU (PB)";"PB";"SAO MIGUEL DE TAIPU";27;0;8;35
2016;"SAO SEBASTIAO DE LAGOA DE ROCA (PB)";"PB";"SAO SEBASTIAO DE LAGOA DE ROCA";97;31;14;142
2016;"SAO SEBASTIAO DO UMBUZEIRO (PB)";"PB";"SAO SEBASTIAO DO UMBUZEIRO";14;2;4;20
2016;"SAO VICENTE DO SERIDO (PB)";"PB";"SAO VICENTE DO SERIDO";36;8;12;56
2016;"SAPE (PB)";"PB";"SAPE";388;33;107;528
2016;"SERRA BRANCA (PB)";"PB";"SERRA BRANCA";108;18;9;135
2016;"SERRA DA RAIZ (PB)";"PB";"SERRA DA RAIZ";10;1;5;16
2016;"SERRA GRANDE (PB)";"PB";"SERRA GRANDE";5;1;4;10
2016;"SERRA REDONDA (PB)";"PB";"SERRA REDONDA";26;9;4;39
2016;"SERRARIA (PB)";"PB";"SERRARIA";18;10;8;36
2016;"SERTAOZINHO (PB)";"PB";"SERTAOZINHO";13;3;13;29
2016;"SOBRADO (PB)";"PB";"SOBRADO";76;4;7;87
2016;"SOLANEA (PB)";"PB";"SOLANEA";257;39;38;334
2016;"SOLEDADE (PB)";"PB";"SOLEDADE";187;25;25;237
2016;"SOSSEGO (PB)";"PB";"SOSSEGO";32;5;6;43
2016;"SOUSA (PB)";"PB";"SOUSA";894;56;72;1022
2016;"SUME (PB)";"PB";"SUME";122;33;21;176
2016;"TACIMA (PB)";"PB";"TACIMA";40;8;19;67
2016;"TAPEROA (PB)";"PB";"TAPEROA";97;20;7;124
2016;"TAVARES (PB)";"PB";"TAVARES";27;12;12;51
2016;"TEIXEIRA (PB)";"PB";"TEIXEIRA";107;21;20;148
2016;"TENORIO (PB)";"PB";"TENORIO";17;1;4;22
2016;"TRIUNFO (PB)";"PB";"TRIUNFO";21;3;6;30
2016;"UIRAUNA (PB)";"PB";"UIRAUNA";84;15;5;104
2016;"UMBUZEIRO (PB)";"PB";"UMBUZEIRO";69;22;24;115
2016;"VARZEA (PB)";"PB";"VARZEA";20;7;5;32
2016;"VIEIROPOLIS (PB)";"PB";"VIEIROPOLIS";10;4;9;23
2016;"VISTA SERRANA (PB)";"PB";"VISTA SERRANA";19;0;5;24
2016;"ZABELE (PB)";"PB";"ZABELE";17;8;8;33
2016;"ABREU E LIMA (PE)";"PE";"ABREU E LIMA";577;91;399;1067
2016;"AFOGADOS DA INGAZEIRA (PE)";"PE";"AFOGADOS DA INGAZEIRA";509;98;91;698
2016;"AFRANIO (PE)";"PE";"AFRANIO";227;30;26;283
2016;"AGRESTINA (PE)";"PE";"AGRESTINA";200;50;25;275
2016;"AGUA PRETA (PE)";"PE";"AGUA PRETA";169;65;70;304
2016;"AGUAS BELAS (PE)";"PE";"AGUAS BELAS";365;74;47;486
2016;"ALAGOINHA (PE)";"PE";"ALAGOINHA";155;49;19;223
2016;"ALIANCA (PE)";"PE";"ALIANCA";175;28;141;344
2016;"ALTINHO (PE)";"PE";"ALTINHO";102;67;35;204
2016;"AMARAJI (PE)";"PE";"AMARAJI";116;28;45;189
2016;"ANGELIM (PE)";"PE";"ANGELIM";48;36;7;91
2016;"ARACOIABA (PE)";"PE";"ARACOIABA";82;17;95;194
2016;"ARARIPINA (PE)";"PE";"ARARIPINA";1159;74;70;1303
2016;"ARCOVERDE (PE)";"PE";"ARCOVERDE";1265;206;124;1595
2016;"BARRA DE GUABIRABA (PE)";"PE";"BARRA DE GUABIRABA";74;21;15;110
2016;"BARREIROS (PE)";"PE";"BARREIROS";276;38;79;393
2016;"BELEM DE MARIA (PE)";"PE";"BELEM DE MARIA";79;38;16;133
2016;"BELEM DE SAO FRANCISCO (PE)";"PE";"BELEM DE SAO FRANCISCO";115;40;21;176
2016;"BELO JARDIM (PE)";"PE";"BELO JARDIM";875;428;93;1396
2016;"BETANIA (PE)";"PE";"BETANIA";53;6;10;69
2016;"BEZERROS (PE)";"PE";"BEZERROS";867;146;90;1103
2016;"BODOCO (PE)";"PE";"BODOCO";242;5;20;267
2016;"BOM CONSELHO (PE)";"PE";"BOM CONSELHO";325;58;43;426
2016;"BOM JARDIM (PE)";"PE";"BOM JARDIM";276;336;51;663
2016;"BONITO (PE)";"PE";"BONITO";408;89;44;541
2016;"BREJAO (PE)";"PE";"BREJAO";72;21;15;108
2016;"BREJINHO (PE)";"PE";"BREJINHO";59;17;9;85
2016;"BREJO DA MADRE DE DEUS (PE)";"PE";"BREJO DA MADRE DE DEUS";372;492;18;882
2016;"BUENOS AIRES (PE)";"PE";"BUENOS AIRES";64;11;19;94
2016;"BUIQUE (PE)";"PE";"BUIQUE";278;98;47;423
2016;"CABO DE SANTO AGOSTINHO (PE)";"PE";"CABO DE SANTO AGOSTINHO";1460;273;513;2246
2016;"CABROBO (PE)";"PE";"CABROBO";259;14;31;304
2016;"CACHOEIRINHA (PE)";"PE";"CACHOEIRINHA";208;70;17;295
2016;"CAETES (PE)";"PE";"CAETES";315;75;37;427
2016;"CALCADO (PE)";"PE";"CALCADO";65;15;26;106
2016;"CALUMBI (PE)";"PE";"CALUMBI";51;4;7;62
2016;"CAMARAGIBE (PE)";"PE";"CAMARAGIBE";757;233;201;1191
2016;"CAMOCIM DE SAO FELIX (PE)";"PE";"CAMOCIM DE SAO FELIX";140;58;8;206
2016;"CAMUTANGA (PE)";"PE";"CAMUTANGA";90;2;15;107
2016;"CANHOTINHO (PE)";"PE";"CANHOTINHO";221;95;15;331
2016;"CAPOEIRAS (PE)";"PE";"CAPOEIRAS";272;54;24;350
2016;"CARNAIBA (PE)";"PE";"CARNAIBA";162;62;27;251
2016;"CARNAUBEIRA DA PENHA (PE)";"PE";"CARNAUBEIRA DA PENHA";44;12;5;61
2016;"CARPINA (PE)";"PE";"CARPINA";987;131;156;1274
2016;"CARUARU (PE)";"PE";"CARUARU";4733;894;702;6329
2016;"CASINHAS (PE)";"PE";"CASINHAS";70;143;20;233
2016;"CATENDE (PE)";"PE";"CATENDE";200;71;73;344
2016;"CEDRO (PE)";"PE";"CEDRO";45;6;12;63
2016;"CHA DE ALEGRIA (PE)";"PE";"CHA DE ALEGRIA";55;21;38;114
2016;"CHA GRANDE (PE)";"PE";"CHA GRANDE";306;69;28;403
2016;"CONDADO (PE)";"PE";"CONDADO";134;14;64;212
2016;"CORRENTES (PE)";"PE";"CORRENTES";86;42;12;140
2016;"CORTES (PE)";"PE";"CORTES";186;57;37;280
2016;"CUMARU (PE)";"PE";"CUMARU";155;112;19;286
2016;"CUPIRA (PE)";"PE";"CUPIRA";278;91;20;389
2016;"CUSTODIA (PE)";"PE";"CUSTODIA";369;78;38;485
2016;"DORMENTES (PE)";"PE";"DORMENTES";326;14;32;372
2016;"ESCADA (PE)";"PE";"ESCADA";382;96;151;629
2016;"EXU (PE)";"PE";"EXU";329;11;31;371
2016;"FEIRA NOVA (PE)";"PE";"FEIRA NOVA";257;48;16;321
2016;"FERNANDO DE NORONHA (PE)";"PE";"FERNANDO DE NORONHA";15;25;7;47
2016;"FERREIROS (PE)";"PE";"FERREIROS";82;1;49;132
2016;"FLORES (PE)";"PE";"FLORES";121;42;14;177
2016;"FLORESTA (PE)";"PE";"FLORESTA";498;26;24;548
2016;"FREI MIGUELINHO (PE)";"PE";"FREI MIGUELINHO";214;138;22;374
2016;"GAMELEIRA (PE)";"PE";"GAMELEIRA";95;16;58;169
2016;"GARANHUNS (PE)";"PE";"GARANHUNS";1733;314;162;2209
2016;"GLORIA DO GOITA (PE)";"PE";"GLORIA DO GOITA";203;61;45;309
2016;"GOIANA (PE)";"PE";"GOIANA";790;212;137;1139
2016;"GRANITO (PE)";"PE";"GRANITO";33;0;13;46
2016;"GRAVATA (PE)";"PE";"GRAVATA";997;142;93;1232
2016;"IATI (PE)";"PE";"IATI";92;39;28;159
2016;"IBIMIRIM (PE)";"PE";"IBIMIRIM";223;51;18;292
2016;"IBIRAJUBA (PE)";"PE";"IBIRAJUBA";56;13;7;76
2016;"IGARASSU (PE)";"PE";"IGARASSU";937;119;682;1738
2016;"IGUARACI (PE)";"PE";"IGUARACI";136;29;30;195
2016;"ILHA DE ITAMARACA (PE)";"PE";"ILHA DE ITAMARACA";91;16;16;123
2016;"INAJA (PE)";"PE";"INAJA";69;14;11;94
2016;"INGAZEIRA (PE)";"PE";"INGAZEIRA";37;13;6;56
2016;"IPOJUCA (PE)";"PE";"IPOJUCA";716;321;300;1337
2016;"IPUBI (PE)";"PE";"IPUBI";264;17;35;316
2016;"ITACURUBA (PE)";"PE";"ITACURUBA";32;2;7;41
2016;"ITAIBA (PE)";"PE";"ITAIBA";153;39;20;212
2016;"ITAMBE (PE)";"PE";"ITAMBE";425;41;141;607
2016;"ITAPETIM (PE)";"PE";"ITAPETIM";88;5;10;103
2016;"ITAPISSUMA (PE)";"PE";"ITAPISSUMA";117;35;32;184
2016;"ITAQUITINGA (PE)";"PE";"ITAQUITINGA";43;11;43;97
2016;"JABOATAO DOS GUARARAPES (PE)";"PE";"JABOATAO DOS GUARARAPES";5609;793;2177;8579
2016;"JAQUEIRA (PE)";"PE";"JAQUEIRA";60;7;29;96
2016;"JATAUBA (PE)";"PE";"JATAUBA";158;217;16;391
2016;"JATOBA (PE)";"PE";"JATOBA";54;25;14;93
2016;"JOAO ALFREDO (PE)";"PE";"JOAO ALFREDO";229;641;19;889
2016;"JOAQUIM NABUCO (PE)";"PE";"JOAQUIM NABUCO";81;19;52;152
2016;"JUCATI (PE)";"PE";"JUCATI";143;29;26;198
2016;"JUPI (PE)";"PE";"JUPI";229;43;41;313
2016;"JUREMA (PE)";"PE";"JUREMA";79;41;16;136
2016;"LAGOA DO CARRO (PE)";"PE";"LAGOA DO CARRO";108;15;15;138
2016;"LAGOA DO ITAENGA (PE)";"PE";"LAGOA DO ITAENGA";424;43;66;533
2016;"LAGOA DO OURO (PE)";"PE";"LAGOA DO OURO";49;32;16;97
2016;"LAGOA DOS GATOS (PE)";"PE";"LAGOA DOS GATOS";105;36;8;149
2016;"LAGOA GRANDE (PE)";"PE";"LAGOA GRANDE";163;9;17;189
2016;"LAJEDO (PE)";"PE";"LAJEDO";600;109;58;767
2016;"LIMOEIRO (PE)";"PE";"LIMOEIRO";543;143;74;760
2016;"MACAPARANA (PE)";"PE";"MACAPARANA";194;16;62;272
2016;"MACHADOS (PE)";"PE";"MACHADOS";169;39;19;227
2016;"MANARI (PE)";"PE";"MANARI";65;19;11;95
2016;"MARAIAL (PE)";"PE";"MARAIAL";128;18;25;171
2016;"MIRANDIBA (PE)";"PE";"MIRANDIBA";130;7;7;144
2016;"MOREILANDIA (PE)";"PE";"MOREILANDIA";77;5;10;92
2016;"MORENO (PE)";"PE";"MORENO";694;154;155;1003
2016;"NAZARE DA MATA (PE)";"PE";"NAZARE DA MATA";244;29;57;330
2016;"OLINDA (PE)";"PE";"OLINDA";3126;448;1372;4946
2016;"OROBO (PE)";"PE";"OROBO";208;227;79;514
2016;"OROCO (PE)";"PE";"OROCO";92;2;14;108
2016;"OURICURI (PE)";"PE";"OURICURI";703;41;108;852
2016;"PALMARES (PE)";"PE";"PALMARES";506;109;212;827
2016;"PALMEIRINA (PE)";"PE";"PALMEIRINA";25;18;7;50
2016;"PANELAS (PE)";"PE";"PANELAS";98;66;21;185
2016;"PARANATAMA (PE)";"PE";"PARANATAMA";119;35;22;176
2016;"PARNAMIRIM (PE)";"PE";"PARNAMIRIM";246;5;21;272
2016;"PASSIRA (PE)";"PE";"PASSIRA";266;132;29;427
2016;"PAUDALHO (PE)";"PE";"PAUDALHO";602;44;78;724
2016;"PAULISTA (PE)";"PE";"PAULISTA";1611;349;329;2289
2016;"PEDRA (PE)";"PE";"PEDRA";173;57;21;251
2016;"PESQUEIRA (PE)";"PE";"PESQUEIRA";810;124;141;1075
2016;"PETROLANDIA (PE)";"PE";"PETROLANDIA";331;14;68;413
2016;"PETROLINA (PE)";"PE";"PETROLINA";4291;293;544;5128
2016;"POCAO (PE)";"PE";"POCAO";63;36;13;112
2016;"POMBOS (PE)";"PE";"POMBOS";545;52;51;648
2016;"PRIMAVERA (PE)";"PE";"PRIMAVERA";84;14;37;135
2016;"QUIPAPA (PE)";"PE";"QUIPAPA";103;34;44;181
2016;"QUIXABA (PE)";"PE";"QUIXABA";50;31;11;92
2016;"RECIFE (PE)";"PE";"RECIFE";20044;2560;3991;26595
2016;"RIACHO DAS ALMAS (PE)";"PE";"RIACHO DAS ALMAS";352;97;28;477
2016;"RIBEIRAO (PE)";"PE";"RIBEIRAO";252;48;105;405
2016;"RIO FORMOSO (PE)";"PE";"RIO FORMOSO";117;38;81;236
2016;"SAIRE (PE)";"PE";"SAIRE";104;12;20;136
2016;"SALGADINHO (PE)";"PE";"SALGADINHO";20;56;5;81
2016;"SALGUEIRO (PE)";"PE";"SALGUEIRO";557;54;67;678
2016;"SALOA (PE)";"PE";"SALOA";68;42;13;123
2016;"SANHARO (PE)";"PE";"SANHARO";154;31;38;223
2016;"SANTA CRUZ (PE)";"PE";"SANTA CRUZ";190;9;29;228
2016;"SANTA CRUZ DA BAIXA VERDE (PE)";"PE";"SANTA CRUZ DA BAIXA VERDE";223;11;11;245
2016;"SANTA CRUZ DO CAPIBARIBE (PE)";"PE";"SANTA CRUZ DO CAPIBARIBE";988;413;66;1467
2016;"SANTA FILOMENA (PE)";"PE";"SANTA FILOMENA";116;2;28;146
2016;"SANTA MARIA DA BOA VISTA (PE)";"PE";"SANTA MARIA DA BOA VISTA";272;16;71;359
2016;"SANTA MARIA DO CAMBUCA (PE)";"PE";"SANTA MARIA DO CAMBUCA";210;120;29;359
2016;"SANTA TEREZINHA (PE)";"PE";"SANTA TEREZINHA";81;16;8;105
2016;"SAO BENEDITO DO SUL (PE)";"PE";"SAO BENEDITO DO SUL";29;16;17;62
2016;"SAO BENTO DO UNA (PE)";"PE";"SAO BENTO DO UNA";1003;92;103;1198
2016;"SAO CAITANO (PE)";"PE";"SAO CAITANO";377;242;38;657
2016;"SAO JOAO (PE)";"PE";"SAO JOAO";120;53;23;196
2016;"SAO JOAQUIM DO MONTE (PE)";"PE";"SAO JOAQUIM DO MONTE";87;53;23;163
2016;"SAO JOSE DA COROA GRANDE (PE)";"PE";"SAO JOSE DA COROA GRANDE";69;15;35;119
2016;"SAO JOSE DO BELMONTE (PE)";"PE";"SAO JOSE DO BELMONTE";327;40;35;402
2016;"SAO JOSE DO EGITO (PE)";"PE";"SAO JOSE DO EGITO";538;60;76;674
2016;"SAO LOURENCO DA MATA (PE)";"PE";"SAO LOURENCO DA MATA";449;93;458;1000
2016;"SAO VICENTE FERRER (PE)";"PE";"SAO VICENTE FERRER";186;12;20;218
2016;"SERRA TALHADA (PE)";"PE";"SERRA TALHADA";1595;117;86;1798
2016;"SERRITA (PE)";"PE";"SERRITA";118;6;17;141
2016;"SERTANIA (PE)";"PE";"SERTANIA";488;76;60;624
2016;"SIRINHAEM (PE)";"PE";"SIRINHAEM";213;31;92;336
2016;"SOLIDAO (PE)";"PE";"SOLIDAO";27;7;7;41
2016;"SURUBIM (PE)";"PE";"SURUBIM";861;738;93;1692
2016;"TABIRA (PE)";"PE";"TABIRA";295;50;46;391
2016;"TACAIMBO (PE)";"PE";"TACAIMBO";104;42;20;166
2016;"TACARATU (PE)";"PE";"TACARATU";68;44;12;124
2016;"TAMANDARE (PE)";"PE";"TAMANDARE";78;32;23;133
2016;"TAQUARITINGA DO NORTE (PE)";"PE";"TAQUARITINGA DO NORTE";326;95;43;464
2016;"TEREZINHA (PE)";"PE";"TEREZINHA";26;9;8;43
2016;"TERRA NOVA (PE)";"PE";"TERRA NOVA";78;2;13;93
2016;"TIMBAUBA (PE)";"PE";"TIMBAUBA";685;36;115;836
2016;"TORITAMA (PE)";"PE";"TORITAMA";304;83;26;413
2016;"TRACUNHAEM (PE)";"PE";"TRACUNHAEM";50;25;17;92
2016;"TRINDADE (PE)";"PE";"TRINDADE";386;42;20;448
2016;"TRIUNFO (PE)";"PE";"TRIUNFO";248;24;14;286
2016;"TUPANATINGA (PE)";"PE";"TUPANATINGA";148;51;25;224
2016;"TUPARETAMA (PE)";"PE";"TUPARETAMA";132;40;17;189
2016;"VENTUROSA (PE)";"PE";"VENTUROSA";199;42;16;257
2016;"VERDEJANTE (PE)";"PE";"VERDEJANTE";73;9;15;97
2016;"VERTENTE DO LERIO (PE)";"PE";"VERTENTE DO LERIO";87;119;17;223
2016;"VERTENTES (PE)";"PE";"VERTENTES";214;97;25;336
2016;"VICENCIA (PE)";"PE";"VICENCIA";289;15;84;388
2016;"VITORIA DE SANTO ANTAO (PE)";"PE";"VITORIA DE SANTO ANTAO";2341;170;355;2866
2016;"XEXEU (PE)";"PE";"XEXEU";76;10;41;127
2016;"ACAUA (PI)";"PI";"ACAUA";93;12;19;124
2016;"AGRICOLANDIA (PI)";"PI";"AGRICOLANDIA";18;3;8;29
2016;"AGUA BRANCA (PI)";"PI";"AGUA BRANCA";199;21;22;242
2016;"ALAGOINHA DO PIAUI (PI)";"PI";"ALAGOINHA DO PIAUI";68;4;5;77
2016;"ALEGRETE DO PIAUI (PI)";"PI";"ALEGRETE DO PIAUI";59;5;4;68
2016;"ALTO LONGA (PI)";"PI";"ALTO LONGA";51;12;23;86
2016;"ALTOS (PI)";"PI";"ALTOS";299;11;50;360
2016;"ALVORADA DO GURGUEIA (PI)";"PI";"ALVORADA DO GURGUEIA";23;3;9;35
2016;"AMARANTE (PI)";"PI";"AMARANTE";89;15;23;127
2016;"ANGICAL DO PIAUI (PI)";"PI";"ANGICAL DO PIAUI";26;4;6;36
2016;"ANISIO DE ABREU (PI)";"PI";"ANISIO DE ABREU";54;11;13;78
2016;"ANTONIO ALMEIDA (PI)";"PI";"ANTONIO ALMEIDA";30;3;6;39
2016;"AROAZES (PI)";"PI";"AROAZES";21;5;10;36
2016;"AROEIRAS DO ITAIM (PI)";"PI";"AROEIRAS DO ITAIM";14;0;12;26
2016;"ARRAIAL (PI)";"PI";"ARRAIAL";14;2;4;20
2016;"ASSUNCAO DO PIAUI (PI)";"PI";"ASSUNCAO DO PIAUI";13;0;3;16
2016;"AVELINO LOPES (PI)";"PI";"AVELINO LOPES";24;6;5;35
2016;"BAIXA GRANDE DO RIBEIRO (PI)";"PI";"BAIXA GRANDE DO RIBEIRO";102;2;18;122
2016;"BARRA D ALCANTARA (PI)";"PI";"BARRA D ALCANTARA";19;2;4;25
2016;"BARRAS (PI)";"PI";"BARRAS";159;13;78;250
2016;"BARREIRAS DO PIAUI (PI)";"PI";"BARREIRAS DO PIAUI";5;1;2;8
2016;"BARRO DURO (PI)";"PI";"BARRO DURO";48;6;6;60
2016;"BATALHA (PI)";"PI";"BATALHA";97;5;20;122
2016;"BELA VISTA DO PIAUI (PI)";"PI";"BELA VISTA DO PIAUI";14;1;6;21
2016;"BELEM DO PIAUI (PI)";"PI";"BELEM DO PIAUI";32;2;3;37
2016;"BENEDITINOS (PI)";"PI";"BENEDITINOS";39;3;15;57
2016;"BERTOLINIA (PI)";"PI";"BERTOLINIA";25;11;13;49
2016;"BETANIA DO PIAUI (PI)";"PI";"BETANIA DO PIAUI";60;9;4;73
2016;"BOA HORA (PI)";"PI";"BOA HORA";22;2;10;34
2016;"BOCAINA (PI)";"PI";"BOCAINA";12;9;4;25
2016;"BOM JESUS (PI)";"PI";"BOM JESUS";304;12;24;340
2016;"BOM PRINCIPIO DO PIAUI (PI)";"PI";"BOM PRINCIPIO DO PIAUI";10;4;10;24
2016;"BONFIM DO PIAUI (PI)";"PI";"BONFIM DO PIAUI";46;4;10;60
2016;"BOQUEIRAO DO PIAUI (PI)";"PI";"BOQUEIRAO DO PIAUI";16;1;4;21
2016;"BRASILEIRA (PI)";"PI";"BRASILEIRA";27;4;12;43
2016;"BREJO DO PIAUI (PI)";"PI";"BREJO DO PIAUI";10;5;3;18
2016;"BURITI DOS LOPES (PI)";"PI";"BURITI DOS LOPES";49;10;22;81
2016;"BURITI DOS MONTES (PI)";"PI";"BURITI DOS MONTES";17;8;5;30
2016;"CABECEIRAS DO PIAUI (PI)";"PI";"CABECEIRAS DO PIAUI";29;2;26;57
2016;"CAJAZEIRAS DO PIAUI (PI)";"PI";"CAJAZEIRAS DO PIAUI";6;0;3;9
2016;"CAJUEIRO DA PRAIA (PI)";"PI";"CAJUEIRO DA PRAIA";16;2;11;29
2016;"CALDEIRAO GRANDE DO PIAUI (PI)";"PI";"CALDEIRAO GRANDE DO PIAUI";33;12;9;54
2016;"CAMPINAS DO PIAUI (PI)";"PI";"CAMPINAS DO PIAUI";6;3;2;11
2016;"CAMPO ALEGRE DO FIDALGO (PI)";"PI";"CAMPO ALEGRE DO FIDALGO";38;5;2;45
2016;"CAMPO GRANDE DO PIAUI (PI)";"PI";"CAMPO GRANDE DO PIAUI";56;10;4;70
2016;"CAMPO LARGO DO PIAUI (PI)";"PI";"CAMPO LARGO DO PIAUI";10;1;4;15
2016;"CAMPO MAIOR (PI)";"PI";"CAMPO MAIOR";463;37;85;585
2016;"CANAVIEIRA (PI)";"PI";"CANAVIEIRA";2;1;1;4
2016;"CANTO DO BURITI (PI)";"PI";"CANTO DO BURITI";127;41;22;190
2016;"CAPITAO DE CAMPOS (PI)";"PI";"CAPITAO DE CAMPOS";41;5;14;60
2016;"CAPITAO GERVASIO OLIVEIRA (PI)";"PI";"CAPITAO GERVASIO OLIVEIRA";26;0;8;34
2016;"CARACOL (PI)";"PI";"CARACOL";74;4;6;84
2016;"CARAUBAS DO PIAUI (PI)";"PI";"CARAUBAS DO PIAUI";23;3;7;33
2016;"CARIDADE DO PIAUI (PI)";"PI";"CARIDADE DO PIAUI";20;2;7;29
2016;"CASTELO DO PIAUI (PI)";"PI";"CASTELO DO PIAUI";81;15;20;116
2016;"CAXINGO (PI)";"PI";"CAXINGO";13;2;7;22
2016;"COCAL (PI)";"PI";"COCAL";144;14;22;180
2016;"COCAL DE TELHA (PI)";"PI";"COCAL DE TELHA";13;4;4;21
2016;"COCAL DOS ALVES (PI)";"PI";"COCAL DOS ALVES";7;5;4;16
2016;"COIVARAS (PI)";"PI";"COIVARAS";13;1;8;22
2016;"COLONIA DO GURGUEIA (PI)";"PI";"COLONIA DO GURGUEIA";17;13;3;33
2016;"COLONIA DO PIAUI (PI)";"PI";"COLONIA DO PIAUI";15;7;8;30
2016;"CONCEICAO DO CANINDE (PI)";"PI";"CONCEICAO DO CANINDE";15;2;5;22
2016;"CORONEL JOSE DIAS (PI)";"PI";"CORONEL JOSE DIAS";18;7;6;31
2016;"CORRENTE (PI)";"PI";"CORRENTE";277;17;38;332
2016;"CRISTALANDIA DO PIAUI (PI)";"PI";"CRISTALANDIA DO PIAUI";15;5;4;24
2016;"CRISTINO CASTRO (PI)";"PI";"CRISTINO CASTRO";43;5;11;59
2016;"CURIMATA (PI)";"PI";"CURIMATA";51;3;7;61
2016;"CURRAIS (PI)";"PI";"CURRAIS";3;2;2;7
2016;"CURRAL NOVO DO PIAUI (PI)";"PI";"CURRAL NOVO DO PIAUI";17;4;3;24
2016;"CURRALINHOS (PI)";"PI";"CURRALINHOS";6;0;2;8
2016;"DEMERVAL LOBAO (PI)";"PI";"DEMERVAL LOBAO";78;2;33;113
2016;"DIRCEU ARCOVERDE (PI)";"PI";"DIRCEU ARCOVERDE";88;11;4;103
2016;"DOM EXPEDITO LOPES (PI)";"PI";"DOM EXPEDITO LOPES";72;8;6;86
2016;"DOM INOCENCIO (PI)";"PI";"DOM INOCENCIO";84;14;10;108
2016;"DOMINGOS MOURAO (PI)";"PI";"DOMINGOS MOURAO";4;0;5;9
2016;"ELESBAO VELOSO (PI)";"PI";"ELESBAO VELOSO";71;8;11;90
2016;"ELISEU MARTINS (PI)";"PI";"ELISEU MARTINS";16;3;3;22
2016;"ESPERANTINA (PI)";"PI";"ESPERANTINA";230;21;62;313
2016;"FARTURA DO PIAUI (PI)";"PI";"FARTURA DO PIAUI";18;10;5;33
2016;"FLORES DO PIAUI (PI)";"PI";"FLORES DO PIAUI";16;5;3;24
2016;"FLORESTA DO PIAUI (PI)";"PI";"FLORESTA DO PIAUI";10;5;5;20
2016;"FLORIANO (PI)";"PI";"FLORIANO";1168;107;79;1354
2016;"FRANCINOPOLIS (PI)";"PI";"FRANCINOPOLIS";19;8;2;29
2016;"FRANCISCO AYRES (PI)";"PI";"FRANCISCO AYRES";9;11;6;26
2016;"FRANCISCO MACEDO (PI)";"PI";"FRANCISCO MACEDO";40;12;7;59
2016;"FRANCISCO SANTOS (PI)";"PI";"FRANCISCO SANTOS";74;11;9;94
2016;"FRONTEIRAS (PI)";"PI";"FRONTEIRAS";114;22;10;146
2016;"GEMINIANO (PI)";"PI";"GEMINIANO";39;13;11;63
2016;"GILBUES (PI)";"PI";"GILBUES";11;4;10;25
2016;"GUADALUPE (PI)";"PI";"GUADALUPE";98;14;9;121
2016;"GUARIBAS (PI)";"PI";"GUARIBAS";10;0;5;15
2016;"HUGO NAPOLEAO (PI)";"PI";"HUGO NAPOLEAO";9;0;2;11
2016;"ILHA GRANDE (PI)";"PI";"ILHA GRANDE";15;7;9;31
2016;"INHUMA (PI)";"PI";"INHUMA";111;8;18;137
2016;"IPIRANGA DO PIAUI (PI)";"PI";"IPIRANGA DO PIAUI";67;12;10;89
2016;"ISAIAS COELHO (PI)";"PI";"ISAIAS COELHO";19;1;6;26
2016;"ITAINOPOLIS (PI)";"PI";"ITAINOPOLIS";60;27;21;108
2016;"ITAUEIRA (PI)";"PI";"ITAUEIRA";74;11;5;90
2016;"JACOBINA DO PIAUI (PI)";"PI";"JACOBINA DO PIAUI";75;6;1;82
2016;"JAICOS (PI)";"PI";"JAICOS";137;11;12;160
2016;"JARDIM DO MULATO (PI)";"PI";"JARDIM DO MULATO";11;1;3;15
2016;"JATOBA DO PIAUI (PI)";"PI";"JATOBA DO PIAUI";34;1;12;47
2016;"JERUMENHA (PI)";"PI";"JERUMENHA";21;1;1;23
2016;"JOAO COSTA (PI)";"PI";"JOAO COSTA";6;0;3;9
2016;"JOAQUIM PIRES (PI)";"PI";"JOAQUIM PIRES";42;3;11;56
2016;"JOCA MARQUES (PI)";"PI";"JOCA MARQUES";7;0;5;12
2016;"JOSE DE FREITAS (PI)";"PI";"JOSE DE FREITAS";134;13;55;202
2016;"JUAZEIRO DO PIAUI (PI)";"PI";"JUAZEIRO DO PIAUI";23;1;5;29
2016;"JULIO BORGES (PI)";"PI";"JULIO BORGES";9;4;5;18
2016;"JUREMA (PI)";"PI";"JUREMA";23;4;11;38
2016;"LAGOA ALEGRE (PI)";"PI";"LAGOA ALEGRE";13;3;22;38
2016;"LAGOA DE SAO FRANCISCO (PI)";"PI";"LAGOA DE SAO FRANCISCO";13;3;4;20
2016;"LAGOA DO BARRO DO PIAUI (PI)";"PI";"LAGOA DO BARRO DO PIAUI";33;6;10;49
2016;"LAGOA DO PIAUI (PI)";"PI";"LAGOA DO PIAUI";15;1;3;19
2016;"LAGOA DO SITIO (PI)";"PI";"LAGOA DO SITIO";15;1;4;20
2016;"LAGOINHA DO PIAUI (PI)";"PI";"LAGOINHA DO PIAUI";6;0;4;10
2016;"LANDRI SALES (PI)";"PI";"LANDRI SALES";20;5;1;26
2016;"LUIS CORREIA (PI)";"PI";"LUIS CORREIA";75;14;49;138
2016;"LUZILANDIA (PI)";"PI";"LUZILANDIA";100;12;30;142
2016;"MADEIRO (PI)";"PI";"MADEIRO";11;3;3;17
2016;"MANOEL EMIDIO (PI)";"PI";"MANOEL EMIDIO";16;3;6;25
2016;"MARCOLANDIA (PI)";"PI";"MARCOLANDIA";539;57;16;612
2016;"MARCOS PARENTE (PI)";"PI";"MARCOS PARENTE";12;2;2;16
2016;"MASSAPE DO PIAUI (PI)";"PI";"MASSAPE DO PIAUI";24;1;4;29
2016;"MATIAS OLIMPIO (PI)";"PI";"MATIAS OLIMPIO";37;7;8;52
2016;"MIGUEL ALVES (PI)";"PI";"MIGUEL ALVES";55;6;31;92
2016;"MIGUEL LEAO (PI)";"PI";"MIGUEL LEAO";4;0;1;5
2016;"MILTON BRANDAO (PI)";"PI";"MILTON BRANDAO";14;1;6;21
2016;"MONSENHOR GIL (PI)";"PI";"MONSENHOR GIL";36;4;7;47
2016;"MONSENHOR HIPOLITO (PI)";"PI";"MONSENHOR HIPOLITO";50;11;7;68
2016;"MONTE ALEGRE DO PIAUI (PI)";"PI";"MONTE ALEGRE DO PIAUI";22;2;4;28
2016;"MORRO CABECA NO TEMPO (PI)";"PI";"MORRO CABECA NO TEMPO";6;0;4;10
2016;"MORRO DO CHAPEU DO PIAUI (PI)";"PI";"MORRO DO CHAPEU DO PIAUI";6;1;12;19
2016;"MURICI DOS PORTELAS (PI)";"PI";"MURICI DOS PORTELAS";13;0;8;21
2016;"NAZARE DO PIAUI (PI)";"PI";"NAZARE DO PIAUI";23;17;4;44
2016;"NAZARIA (PI)";"PI";"NAZARIA";22;0;11;33
2016;"NOSSA SENHORA DE NAZARE (PI)";"PI";"NOSSA SENHORA DE NAZARE";17;5;13;35
2016;"NOSSA SENHORA DOS REMEDIOS (PI)";"PI";"NOSSA SENHORA DOS REMEDIOS";12;4;5;21
2016;"NOVA SANTA RITA (PI)";"PI";"NOVA SANTA RITA";3;7;4;14
2016;"NOVO ORIENTE DO PIAUI (PI)";"PI";"NOVO ORIENTE DO PIAUI";18;4;12;34
2016;"NOVO SANTO ANTONIO (PI)";"PI";"NOVO SANTO ANTONIO";15;1;5;21
2016;"OEIRAS (PI)";"PI";"OEIRAS";365;67;47;479
2016;"OLHO D AGUA DO PIAUI (PI)";"PI";"OLHO D AGUA DO PIAUI";7;1;3;11
2016;"PADRE MARCOS (PI)";"PI";"PADRE MARCOS";107;9;7;123
2016;"PAES LANDIM (PI)";"PI";"PAES LANDIM";9;6;2;17
2016;"PAJEU DO PIAUI (PI)";"PI";"PAJEU DO PIAUI";13;6;4;23
2016;"PALMEIRA DO PIAUI (PI)";"PI";"PALMEIRA DO PIAUI";41;3;6;50
2016;"PALMEIRAIS (PI)";"PI";"PALMEIRAIS";21;3;10;34
2016;"PAQUETA (PI)";"PI";"PAQUETA";21;6;7;34
2016;"PARNAGUA (PI)";"PI";"PARNAGUA";21;5;5;31
2016;"PARNAIBA (PI)";"PI";"PARNAIBA";1288;113;301;1702
2016;"PASSAGEM FRANCA DO PIAUI (PI)";"PI";"PASSAGEM FRANCA DO PIAUI";13;2;5;20
2016;"PATOS DO PIAUI (PI)";"PI";"PATOS DO PIAUI";24;3;9;36
2016;"PAU D ARCO DO PIAUI (PI)";"PI";"PAU D ARCO DO PIAUI";9;0;7;16
2016;"PAULISTANA (PI)";"PI";"PAULISTANA";359;46;67;472
2016;"PAVUSSU (PI)";"PI";"PAVUSSU";13;5;2;20
2016;"PEDRO II (PI)";"PI";"PEDRO II";142;42;26;210
2016;"PEDRO LAURENTINO (PI)";"PI";"PEDRO LAURENTINO";5;0;2;7
2016;"PICOS (PI)";"PI";"PICOS";1820;150;103;2073
2016;"PIMENTEIRAS (PI)";"PI";"PIMENTEIRAS";51;9;7;67
2016;"PIO IX (PI)";"PI";"PIO IX";108;14;18;140
2016;"PIRACURUCA (PI)";"PI";"PIRACURUCA";288;24;53;365
2016;"PIRIPIRI (PI)";"PI";"PIRIPIRI";411;63;166;640
2016;"PORTO (PI)";"PI";"PORTO";12;4;5;21
2016;"PORTO ALEGRE DO PIAUI (PI)";"PI";"PORTO ALEGRE DO PIAUI";12;4;2;18
2016;"PRATA DO PIAUI (PI)";"PI";"PRATA DO PIAUI";13;1;2;16
2016;"QUEIMADA NOVA (PI)";"PI";"QUEIMADA NOVA";103;7;32;142
2016;"REDENCAO DO GURGUEIA (PI)";"PI";"REDENCAO DO GURGUEIA";18;2;16;36
2016;"REGENERACAO (PI)";"PI";"REGENERACAO";91;10;16;117
2016;"RIACHO FRIO (PI)";"PI";"RIACHO FRIO";7;3;5;15
2016;"RIBEIRA DO PIAUI (PI)";"PI";"RIBEIRA DO PIAUI";9;3;2;14
2016;"RIBEIRO GONCALVES (PI)";"PI";"RIBEIRO GONCALVES";27;1;4;32
2016;"RIO GRANDE DO PIAUI (PI)";"PI";"RIO GRANDE DO PIAUI";27;8;6;41
2016;"SANTA CRUZ DO PIAUI (PI)";"PI";"SANTA CRUZ DO PIAUI";29;20;5;54
2016;"SANTA CRUZ DOS MILAGRES (PI)";"PI";"SANTA CRUZ DOS MILAGRES";7;1;3;11
2016;"SANTA FILOMENA (PI)";"PI";"SANTA FILOMENA";29;0;4;33
2016;"SANTA LUZ (PI)";"PI";"SANTA LUZ";11;1;4;16
2016;"SANTA ROSA DO PIAUI (PI)";"PI";"SANTA ROSA DO PIAUI";16;8;11;35
2016;"SANTANA DO PIAUI (PI)";"PI";"SANTANA DO PIAUI";30;14;14;58
2016;"SANTO ANTONIO DE LISBOA (PI)";"PI";"SANTO ANTONIO DE LISBOA";52;14;6;72
2016;"SANTO ANTONIO DOS MILAGRES (PI)";"PI";"SANTO ANTONIO DOS MILAGRES";3;3;2;8
2016;"SANTO INACIO DO PIAUI (PI)";"PI";"SANTO INACIO DO PIAUI";14;5;2;21
2016;"SAO BRAZ DO PIAUI (PI)";"PI";"SAO BRAZ DO PIAUI";35;3;5;43
2016;"SAO FELIX DO PIAUI (PI)";"PI";"SAO FELIX DO PIAUI";7;2;3;12
2016;"SAO FRANCISCO DE ASSIS DO PIAU (PI)";"PI";"SAO FRANCISCO DE ASSIS DO PIAU";25;8;4;37
2016;"SAO FRANCISCO DO PIAUI (PI)";"PI";"SAO FRANCISCO DO PIAUI";12;12;8;32
2016;"SAO GONCALO DO GURGUEIA (PI)";"PI";"SAO GONCALO DO GURGUEIA";4;1;1;6
2016;"SAO GONCALO DO PIAUI (PI)";"PI";"SAO GONCALO DO PIAUI";17;3;4;24
2016;"SAO JOAO DA CANABRAVA (PI)";"PI";"SAO JOAO DA CANABRAVA";23;13;5;41
2016;"SAO JOAO DA FRONTEIRA (PI)";"PI";"SAO JOAO DA FRONTEIRA";6;2;7;15
2016;"SAO JOAO DA SERRA (PI)";"PI";"SAO JOAO DA SERRA";22;0;1;23
2016;"SAO JOAO DA VARJOTA (PI)";"PI";"SAO JOAO DA VARJOTA";5;8;5;18
2016;"SAO JOAO DO ARRAIAL (PI)";"PI";"SAO JOAO DO ARRAIAL";13;4;7;24
2016;"SAO JOAO DO PIAUI (PI)";"PI";"SAO JOAO DO PIAUI";124;29;21;174
2016;"SAO JOSE DO DIVINO (PI)";"PI";"SAO JOSE DO DIVINO";27;5;4;36
2016;"SAO JOSE DO PEIXE (PI)";"PI";"SAO JOSE DO PEIXE";8;0;4;12
2016;"SAO JOSE DO PIAUI (PI)";"PI";"SAO JOSE DO PIAUI";38;10;9;57
2016;"SAO JULIAO (PI)";"PI";"SAO JULIAO";39;11;5;55
2016;"SAO LOURENCO DO PIAUI (PI)";"PI";"SAO LOURENCO DO PIAUI";10;6;7;23
2016;"SAO LUIS DO PIAUI (PI)";"PI";"SAO LUIS DO PIAUI";12;5;2;19
2016;"SAO MIGUEL DA BAIXA GRANDE (PI)";"PI";"SAO MIGUEL DA BAIXA GRANDE";11;3;4;18
2016;"SAO MIGUEL DO FIDALGO (PI)";"PI";"SAO MIGUEL DO FIDALGO";6;2;3;11
2016;"SAO MIGUEL DO TAPUIO (PI)";"PI";"SAO MIGUEL DO TAPUIO";41;5;22;68
2016;"SAO PEDRO DO PIAUI (PI)";"PI";"SAO PEDRO DO PIAUI";55;5;9;69
2016;"SAO RAIMUNDO NONATO (PI)";"PI";"SAO RAIMUNDO NONATO";545;110;77;732
2016;"SEBASTIAO BARROS (PI)";"PI";"SEBASTIAO BARROS";7;2;2;11
2016;"SEBASTIAO LEAL (PI)";"PI";"SEBASTIAO LEAL";36;2;3;41
2016;"SIGEFREDO PACHECO (PI)";"PI";"SIGEFREDO PACHECO";43;7;9;59
2016;"SIMOES (PI)";"PI";"SIMOES";109;13;13;135
2016;"SIMPLICIO MENDES (PI)";"PI";"SIMPLICIO MENDES";79;16;11;106
2016;"SOCORRO DO PIAUI (PI)";"PI";"SOCORRO DO PIAUI";8;4;3;15
2016;"SUSSUAPARA (PI)";"PI";"SUSSUAPARA";56;19;6;81
2016;"TAMBORIL DO PIAUI (PI)";"PI";"TAMBORIL DO PIAUI";6;3;1;10
2016;"TANQUE DO PIAUI (PI)";"PI";"TANQUE DO PIAUI";15;4;4;23
2016;"TERESINA (PI)";"PI";"TERESINA";11357;1182;3389;15928
2016;"UNIAO (PI)";"PI";"UNIAO";171;50;66;287
2016;"URUCUI (PI)";"PI";"URUCUI";187;12;26;225
2016;"VALENCA DO PIAUI (PI)";"PI";"VALENCA DO PIAUI";181;39;36;256
2016;"VARZEA BRANCA (PI)";"PI";"VARZEA BRANCA";39;5;14;58
2016;"VARZEA GRANDE (PI)";"PI";"VARZEA GRANDE";13;4;3;20
2016;"VERA MENDES (PI)";"PI";"VERA MENDES";19;6;4;29
2016;"VILA NOVA DO PIAUI (PI)";"PI";"VILA NOVA DO PIAUI";21;8;5;34
2016;"WALL FERRAZ (PI)";"PI";"WALL FERRAZ";15;14;8;37
2016;"ABATIA (PR)";"PR";"ABATIA";157;6;50;213
2016;"ADRIANOPOLIS (PR)";"PR";"ADRIANOPOLIS";128;11;23;162
2016;"AGUDOS DO SUL (PR)";"PR";"AGUDOS DO SUL";433;13;31;477
2016;"ALMIRANTE TAMANDARE (PR)";"PR";"ALMIRANTE TAMANDARE";1635;107;244;1986
2016;"ALTAMIRA DO PARANA (PR)";"PR";"ALTAMIRA DO PARANA";53;4;16;73
2016;"ALTO PARAISO (PR)";"PR";"ALTO PARAISO";68;11;14;93
2016;"ALTO PARANA (PR)";"PR";"ALTO PARANA";316;18;99;433
2016;"ALTO PIQUIRI (PR)";"PR";"ALTO PIQUIRI";208;11;48;267
2016;"ALTONIA (PR)";"PR";"ALTONIA";494;32;57;583
2016;"ALVORADA DO SUL (PR)";"PR";"ALVORADA DO SUL";338;11;62;411
2016;"AMAPORA (PR)";"PR";"AMAPORA";73;5;52;130
2016;"AMPERE (PR)";"PR";"AMPERE";528;20;44;592
2016;"ANAHY (PR)";"PR";"ANAHY";102;2;7;111
2016;"ANDIRA (PR)";"PR";"ANDIRA";619;18;88;725
2016;"ANGULO (PR)";"PR";"ANGULO";85;3;13;101
2016;"ANTONINA (PR)";"PR";"ANTONINA";116;17;48;181
2016;"ANTONIO OLINTO (PR)";"PR";"ANTONIO OLINTO";222;8;37;267
2016;"APUCARANA (PR)";"PR";"APUCARANA";2636;392;329;3357
2016;"ARAPONGAS (PR)";"PR";"ARAPONGAS";3435;278;185;3898
2016;"ARAPOTI (PR)";"PR";"ARAPOTI";688;39;83;810
2016;"ARAPUA (PR)";"PR";"ARAPUA";120;6;29;155
2016;"ARARUNA (PR)";"PR";"ARARUNA";443;25;34;502
2016;"ARAUCARIA (PR)";"PR";"ARAUCARIA";2953;369;642;3964
2016;"ARIRANHA DO IVAI (PR)";"PR";"ARIRANHA DO IVAI";70;3;19;92
2016;"ASSAI (PR)";"PR";"ASSAI";503;31;53;587
2016;"ASSIS CHATEAUBRIAND (PR)";"PR";"ASSIS CHATEAUBRIAND";1311;61;80;1452
2016;"ASTORGA (PR)";"PR";"ASTORGA";760;47;108;915
2016;"ATALAIA (PR)";"PR";"ATALAIA";122;11;33;166
2016;"BALSA NOVA (PR)";"PR";"BALSA NOVA";437;26;134;597
2016;"BANDEIRANTES (PR)";"PR";"BANDEIRANTES";890;64;115;1069
2016;"BARBOSA FERRAZ (PR)";"PR";"BARBOSA FERRAZ";237;7;42;286
2016;"BARRA DO JACARE (PR)";"PR";"BARRA DO JACARE";60;8;11;79
2016;"BARRACAO (PR)";"PR";"BARRACAO";272;25;45;342
2016;"BELA VISTA DO CAROBA (PR)";"PR";"BELA VISTA DO CAROBA";73;4;21;98
2016;"BELA VISTA DO PARAISO (PR)";"PR";"BELA VISTA DO PARAISO";453;29;62;544
2016;"BITURUNA (PR)";"PR";"BITURUNA";504;31;190;725
2016;"BOA ESPERANCA (PR)";"PR";"BOA ESPERANCA";213;8;16;237
2016;"BOA ESPERANCA DO IGUACU (PR)";"PR";"BOA ESPERANCA DO IGUACU";80;5;17;102
2016;"BOA VENTURA DE SAO ROQUE (PR)";"PR";"BOA VENTURA DE SAO ROQUE";221;15;45;281
2016;"BOA VISTA DA APARECIDA (PR)";"PR";"BOA VISTA DA APARECIDA";183;18;27;228
2016;"BOCAIUVA DO SUL (PR)";"PR";"BOCAIUVA DO SUL";344;17;27;388
2016;"BOM JESUS DO SUL (PR)";"PR";"BOM JESUS DO SUL";47;8;15;70
2016;"BOM SUCESSO (PR)";"PR";"BOM SUCESSO";138;15;67;220
2016;"BOM SUCESSO DO SUL (PR)";"PR";"BOM SUCESSO DO SUL";134;7;12;153
2016;"BORRAZOPOLIS (PR)";"PR";"BORRAZOPOLIS";316;7;16;339
2016;"BRAGANEY (PR)";"PR";"BRAGANEY";208;6;27;241
2016;"BRASILANDIA DO SUL (PR)";"PR";"BRASILANDIA DO SUL";94;5;11;110
2016;"CAFEARA (PR)";"PR";"CAFEARA";53;7;18;78
2016;"CAFELANDIA (PR)";"PR";"CAFELANDIA";707;62;86;855
2016;"CAFEZAL DO SUL (PR)";"PR";"CAFEZAL DO SUL";99;5;29;133
2016;"CALIFORNIA (PR)";"PR";"CALIFORNIA";297;12;25;334
2016;"CAMBARA (PR)";"PR";"CAMBARA";847;47;104;998
2016;"CAMBE (PR)";"PR";"CAMBE";2115;302;155;2572
2016;"CAMBIRA (PR)";"PR";"CAMBIRA";308;8;25;341
2016;"CAMPINA DA LAGOA (PR)";"PR";"CAMPINA DA LAGOA";489;28;49;566
2016;"CAMPINA DO SIMAO (PR)";"PR";"CAMPINA DO SIMAO";120;4;32;156
2016;"CAMPINA GRANDE DO SUL (PR)";"PR";"CAMPINA GRANDE DO SUL";923;92;82;1097
2016;"CAMPO BONITO (PR)";"PR";"CAMPO BONITO";123;10;19;152
2016;"CAMPO DO TENENTE (PR)";"PR";"CAMPO DO TENENTE";171;14;48;233
2016;"CAMPO LARGO (PR)";"PR";"CAMPO LARGO";2519;332;471;3322
2016;"CAMPO MAGRO (PR)";"PR";"CAMPO MAGRO";592;93;39;724
2016;"CAMPO MOURAO (PR)";"PR";"CAMPO MOURAO";2560;135;623;3318
2016;"CANDIDO DE ABREU (PR)";"PR";"CANDIDO DE ABREU";299;13;58;370
2016;"CANDOI (PR)";"PR";"CANDOI";472;13;125;610
2016;"CANTAGALO (PR)";"PR";"CANTAGALO";287;9;53;349
2016;"CAPANEMA (PR)";"PR";"CAPANEMA";524;15;74;613
2016;"CAPITAO LEONIDAS MARQUES (PR)";"PR";"CAPITAO LEONIDAS MARQUES";640;26;64;730
2016;"CARAMBEI (PR)";"PR";"CARAMBEI";694;76;70;840
2016;"CARLOPOLIS (PR)";"PR";"CARLOPOLIS";328;27;74;429
2016;"CASCAVEL (PR)";"PR";"CASCAVEL";8327;465;1042;9834
2016;"CASTRO (PR)";"PR";"CASTRO";2116;258;358;2732
2016;"CATANDUVAS (PR)";"PR";"CATANDUVAS";240;14;42;296
2016;"CENTENARIO DO SUL (PR)";"PR";"CENTENARIO DO SUL";155;33;80;268
2016;"CERRO AZUL (PR)";"PR";"CERRO AZUL";540;22;73;635
2016;"CEU AZUL (PR)";"PR";"CEU AZUL";374;14;53;441
2016;"CHOPINZINHO (PR)";"PR";"CHOPINZINHO";679;35;98;812
2016;"CIANORTE (PR)";"PR";"CIANORTE";1751;98;264;2113
2016;"CIDADE GAUCHA (PR)";"PR";"CIDADE GAUCHA";309;21;87;417
2016;"CLEVELANDIA (PR)";"PR";"CLEVELANDIA";616;45;56;717
2016;"COLOMBO (PR)";"PR";"COLOMBO";4440;361;582;5383
2016;"COLORADO (PR)";"PR";"COLORADO";617;53;189;859
2016;"CONGONHINHAS (PR)";"PR";"CONGONHINHAS";150;8;42;200
2016;"CONSELHEIRO MAIRINCK (PR)";"PR";"CONSELHEIRO MAIRINCK";58;3;10;71
2016;"CONTENDA (PR)";"PR";"CONTENDA";827;24;58;909
2016;"CORBELIA (PR)";"PR";"CORBELIA";823;26;73;922
2016;"CORNELIO PROCOPIO (PR)";"PR";"CORNELIO PROCOPIO";1131;122;154;1407
2016;"CORONEL DOMINGOS SOARES (PR)";"PR";"CORONEL DOMINGOS SOARES";191;10;33;234
2016;"CORONEL VIVIDA (PR)";"PR";"CORONEL VIVIDA";774;40;120;934
2016;"CORUMBATAI DO SUL (PR)";"PR";"CORUMBATAI DO SUL";77;4;29;110
2016;"CRUZ MACHADO (PR)";"PR";"CRUZ MACHADO";684;16;109;809
2016;"CRUZEIRO DO IGUACU (PR)";"PR";"CRUZEIRO DO IGUACU";95;6;24;125
2016;"CRUZEIRO DO OESTE (PR)";"PR";"CRUZEIRO DO OESTE";536;21;84;641
2016;"CRUZEIRO DO SUL (PR)";"PR";"CRUZEIRO DO SUL";101;8;25;134
2016;"CRUZMALTINA (PR)";"PR";"CRUZMALTINA";95;4;11;110
2016;"CURITIBA (PR)";"PR";"CURITIBA";39453;4274;6986;50713
2016;"CURIUVA (PR)";"PR";"CURIUVA";296;20;87;403
2016;"DIAMANTE D OESTE (PR)";"PR";"DIAMANTE D OESTE";91;9;37;137
2016;"DIAMANTE DO NORTE (PR)";"PR";"DIAMANTE DO NORTE";79;7;31;117
2016;"DIAMANTE DO SUL (PR)";"PR";"DIAMANTE DO SUL";43;5;14;62
2016;"DOIS VIZINHOS (PR)";"PR";"DOIS VIZINHOS";1252;119;126;1497
2016;"DOURADINA (PR)";"PR";"DOURADINA";421;17;23;461
2016;"DOUTOR CAMARGO (PR)";"PR";"DOUTOR CAMARGO";193;5;64;262
2016;"DOUTOR ULYSSES (PR)";"PR";"DOUTOR ULYSSES";71;5;27;103
2016;"ENEAS MARQUES (PR)";"PR";"ENEAS MARQUES";208;8;30;246
2016;"ENGENHEIRO BELTRAO (PR)";"PR";"ENGENHEIRO BELTRAO";533;16;102;651
2016;"ENTRE RIOS DO OESTE (PR)";"PR";"ENTRE RIOS DO OESTE";160;7;14;181
2016;"ESPERANCA NOVA (PR)";"PR";"ESPERANCA NOVA";36;5;7;48
2016;"ESPIGAO ALTO DO IGUACU (PR)";"PR";"ESPIGAO ALTO DO IGUACU";87;9;12;108
2016;"FAROL (PR)";"PR";"FAROL";103;1;15;119
2016;"FAXINAL (PR)";"PR";"FAXINAL";489;20;43;552
2016;"FAZENDA RIO GRANDE (PR)";"PR";"FAZENDA RIO GRANDE";1376;83;262;1721
2016;"FENIX (PR)";"PR";"FENIX";136;4;19;159
2016;"FERNANDES PINHEIRO (PR)";"PR";"FERNANDES PINHEIRO";124;9;29;162
2016;"FIGUEIRA (PR)";"PR";"FIGUEIRA";151;14;38;203
2016;"FLOR DA SERRA DO SUL (PR)";"PR";"FLOR DA SERRA DO SUL";110;4;30;144
2016;"FLORAI (PR)";"PR";"FLORAI";169;8;26;203
2016;"FLORESTA (PR)";"PR";"FLORESTA";283;20;37;340
2016;"FLORESTOPOLIS (PR)";"PR";"FLORESTOPOLIS";204;37;118;359
2016;"FLORIDA (PR)";"PR";"FLORIDA";81;6;25;112
2016;"FORMOSA DO OESTE (PR)";"PR";"FORMOSA DO OESTE";288;12;28;328
2016;"FOZ DO IGUACU (PR)";"PR";"FOZ DO IGUACU";3723;1200;1377;6300
2016;"FOZ DO JORDAO (PR)";"PR";"FOZ DO JORDAO";86;8;21;115
2016;"FRANCISCO ALVES (PR)";"PR";"FRANCISCO ALVES";197;5;28;230
2016;"FRANCISCO BELTRAO (PR)";"PR";"FRANCISCO BELTRAO";2285;185;271;2741
2016;"GENERAL CARNEIRO (PR)";"PR";"GENERAL CARNEIRO";464;29;86;579
2016;"GODOY MOREIRA (PR)";"PR";"GODOY MOREIRA";61;3;12;76
2016;"GOIOERE (PR)";"PR";"GOIOERE";660;48;55;763
2016;"GOIOXIM (PR)";"PR";"GOIOXIM";134;13;38;185
2016;"GRANDES RIOS (PR)";"PR";"GRANDES RIOS";122;11;19;152
2016;"GUAIRA (PR)";"PR";"GUAIRA";1164;43;516;1723
2016;"GUAIRACA (PR)";"PR";"GUAIRACA";145;12;39;196
2016;"GUAMIRANGA (PR)";"PR";"GUAMIRANGA";195;16;39;250
2016;"GUAPIRAMA (PR)";"PR";"GUAPIRAMA";126;7;22;155
2016;"GUAPOREMA (PR)";"PR";"GUAPOREMA";50;3;11;64
2016;"GUARACI (PR)";"PR";"GUARACI";123;6;40;169
2016;"GUARANIACU (PR)";"PR";"GUARANIACU";471;43;55;569
2016;"GUARAPUAVA (PR)";"PR";"GUARAPUAVA";4949;576;514;6039
2016;"GUARAQUECABA (PR)";"PR";"GUARAQUECABA";39;3;14;56
2016;"GUARATUBA (PR)";"PR";"GUARATUBA";469;39;62;570
2016;"HONORIO SERPA (PR)";"PR";"HONORIO SERPA";128;5;40;173
2016;"IBAITI (PR)";"PR";"IBAITI";615;53;171;839
2016;"IBEMA (PR)";"PR";"IBEMA";165;16;18;199
2016;"IBIPORA (PR)";"PR";"IBIPORA";1181;88;177;1446
2016;"ICARAIMA (PR)";"PR";"ICARAIMA";184;16;45;245
2016;"IGUARACU (PR)";"PR";"IGUARACU";105;9;13;127
2016;"IGUATU (PR)";"PR";"IGUATU";59;2;7;68
2016;"IMBAU (PR)";"PR";"IMBAU";246;24;36;306
2016;"IMBITUVA (PR)";"PR";"IMBITUVA";871;45;73;989
2016;"INACIO MARTINS (PR)";"PR";"INACIO MARTINS";281;31;52;364
2016;"INAJA (PR)";"PR";"INAJA";32;5;17;54
2016;"INDIANOPOLIS (PR)";"PR";"INDIANOPOLIS";199;6;14;219
2016;"IPIRANGA (PR)";"PR";"IPIRANGA";369;29;79;477
2016;"IPORA (PR)";"PR";"IPORA";414;14;46;474
2016;"IRACEMA DO OESTE (PR)";"PR";"IRACEMA DO OESTE";82;5;9;96
2016;"IRATI (PR)";"PR";"IRATI";1732;118;154;2004
2016;"IRETAMA (PR)";"PR";"IRETAMA";240;5;44;289
2016;"ITAGUAJE (PR)";"PR";"ITAGUAJE";76;8;31;115
2016;"ITAIPULANDIA (PR)";"PR";"ITAIPULANDIA";250;35;43;328
2016;"ITAMBARACA (PR)";"PR";"ITAMBARACA";186;12;35;233
2016;"ITAMBE (PR)";"PR";"ITAMBE";194;7;35;236
2016;"ITAPEJARA D OESTE (PR)";"PR";"ITAPEJARA D OESTE";373;16;47;436
2016;"ITAPERUCU (PR)";"PR";"ITAPERUCU";623;85;102;810
2016;"ITAUNA DO SUL (PR)";"PR";"ITAUNA DO SUL";57;5;12;74
2016;"IVAI (PR)";"PR";"IVAI";380;14;43;437
2016;"IVAIPORA (PR)";"PR";"IVAIPORA";974;40;103;1117
2016;"IVATE (PR)";"PR";"IVATE";223;11;69;303
2016;"IVATUBA (PR)";"PR";"IVATUBA";64;4;8;76
2016;"JABOTI (PR)";"PR";"JABOTI";83;8;24;115
2016;"JACAREZINHO (PR)";"PR";"JACAREZINHO";623;131;159;913
2016;"JAGUAPITA (PR)";"PR";"JAGUAPITA";396;36;86;518
2016;"JAGUARIAIVA (PR)";"PR";"JAGUARIAIVA";840;73;133;1046
2016;"JANDAIA DO SUL (PR)";"PR";"JANDAIA DO SUL";686;50;76;812
2016;"JANIOPOLIS (PR)";"PR";"JANIOPOLIS";168;8;29;205
2016;"JAPIRA (PR)";"PR";"JAPIRA";67;3;23;93
2016;"JAPURA (PR)";"PR";"JAPURA";323;12;28;363
2016;"JARDIM ALEGRE (PR)";"PR";"JARDIM ALEGRE";279;9;41;329
2016;"JARDIM OLINDA (PR)";"PR";"JARDIM OLINDA";38;3;9;50
2016;"JATAIZINHO (PR)";"PR";"JATAIZINHO";393;29;29;451
2016;"JESUITAS (PR)";"PR";"JESUITAS";332;22;36;390
2016;"JOAQUIM TAVORA (PR)";"PR";"JOAQUIM TAVORA";294;20;39;353
2016;"JUNDIAI DO SUL (PR)";"PR";"JUNDIAI DO SUL";37;4;26;67
2016;"JURANDA (PR)";"PR";"JURANDA";336;6;14;356
2016;"JUSSARA (PR)";"PR";"JUSSARA";191;7;43;241
2016;"KALORE (PR)";"PR";"KALORE";177;16;24;217
2016;"LAPA (PR)";"PR";"LAPA";1349;141;206;1696
2016;"LARANJAL (PR)";"PR";"LARANJAL";78;6;24;108
2016;"LARANJEIRAS DO SUL (PR)";"PR";"LARANJEIRAS DO SUL";856;49;100;1005
2016;"LEOPOLIS (PR)";"PR";"LEOPOLIS";97;6;9;112
2016;"LIDIANOPOLIS (PR)";"PR";"LIDIANOPOLIS";117;7;25;149
2016;"LINDOESTE (PR)";"PR";"LINDOESTE";118;10;31;159
2016;"LOANDA (PR)";"PR";"LOANDA";451;22;65;538
2016;"LOBATO (PR)";"PR";"LOBATO";159;8;33;200
2016;"LONDRINA (PR)";"PR";"LONDRINA";9475;843;2112;12430
2016;"LUIZIANA (PR)";"PR";"LUIZIANA";201;8;24;233
2016;"LUNARDELLI (PR)";"PR";"LUNARDELLI";113;10;12;135
2016;"LUPIONOPOLIS (PR)";"PR";"LUPIONOPOLIS";115;22;75;212
2016;"MALLET (PR)";"PR";"MALLET";449;17;66;532
2016;"MAMBORE (PR)";"PR";"MAMBORE";646;9;49;704
2016;"MANDAGUACU (PR)";"PR";"MANDAGUACU";519;27;55;601
2016;"MANDAGUARI (PR)";"PR";"MANDAGUARI";866;53;89;1008
2016;"MANDIRITUBA (PR)";"PR";"MANDIRITUBA";1160;51;87;1298
2016;"MANFRINOPOLIS (PR)";"PR";"MANFRINOPOLIS";45;5;24;74
2016;"MANGUEIRINHA (PR)";"PR";"MANGUEIRINHA";561;32;79;672
2016;"MANOEL RIBAS (PR)";"PR";"MANOEL RIBAS";417;19;38;474
2016;"MARECHAL CANDIDO RONDON (PR)";"PR";"MARECHAL CANDIDO RONDON";1646;102;201;1949
2016;"MARIA HELENA (PR)";"PR";"MARIA HELENA";133;10;31;174
2016;"MARIALVA (PR)";"PR";"MARIALVA";988;60;104;1152
2016;"MARILANDIA DO SUL (PR)";"PR";"MARILANDIA DO SUL";274;15;33;322
2016;"MARILENA (PR)";"PR";"MARILENA";120;7;35;162
2016;"MARILUZ (PR)";"PR";"MARILUZ";211;14;79;304
2016;"MARINGA (PR)";"PR";"MARINGA";10148;568;944;11660
2016;"MARIOPOLIS (PR)";"PR";"MARIOPOLIS";264;20;39;323
2016;"MARIPA (PR)";"PR";"MARIPA";362;13;13;388
2016;"MARMELEIRO (PR)";"PR";"MARMELEIRO";416;33;64;513
2016;"MARQUINHO (PR)";"PR";"MARQUINHO";75;5;21;101
2016;"MARUMBI (PR)";"PR";"MARUMBI";111;9;24;144
2016;"MATELANDIA (PR)";"PR";"MATELANDIA";676;17;79;772
2016;"MATINHOS (PR)";"PR";"MATINHOS";392;46;58;496
2016;"MATO RICO (PR)";"PR";"MATO RICO";82;4;10;96
2016;"MAUA DA SERRA (PR)";"PR";"MAUA DA SERRA";260;12;29;301
2016;"MEDIANEIRA (PR)";"PR";"MEDIANEIRA";1407;80;134;1621
2016;"MERCEDES (PR)";"PR";"MERCEDES";259;6;30;295
2016;"MIRADOR (PR)";"PR";"MIRADOR";19;2;10;31
2016;"MIRASELVA (PR)";"PR";"MIRASELVA";41;7;33;81
2016;"MISSAL (PR)";"PR";"MISSAL";407;28;41;476
2016;"MOREIRA SALES (PR)";"PR";"MOREIRA SALES";329;17;103;449
2016;"MORRETES (PR)";"PR";"MORRETES";243;26;45;314
2016;"MUNHOZ DE MELLO (PR)";"PR";"MUNHOZ DE MELLO";81;7;10;98
2016;"NOSSA SENHORA DAS GRACAS (PR)";"PR";"NOSSA SENHORA DAS GRACAS";43;11;37;91
2016;"NOVA ALIANCA DO IVAI (PR)";"PR";"NOVA ALIANCA DO IVAI";29;5;8;42
2016;"NOVA AMERICA DA COLINA (PR)";"PR";"NOVA AMERICA DA COLINA";113;7;29;149
2016;"NOVA AURORA (PR)";"PR";"NOVA AURORA";484;12;52;548
2016;"NOVA CANTU (PR)";"PR";"NOVA CANTU";157;2;29;188
2016;"NOVA ESPERANCA (PR)";"PR";"NOVA ESPERANCA";853;48;86;987
2016;"NOVA ESPERANCA DO SUDOESTE (PR)";"PR";"NOVA ESPERANCA DO SUDOESTE";169;16;29;214
2016;"NOVA FATIMA (PR)";"PR";"NOVA FATIMA";316;5;48;369
2016;"NOVA LARANJEIRAS (PR)";"PR";"NOVA LARANJEIRAS";194;10;34;238
2016;"NOVA LONDRINA (PR)";"PR";"NOVA LONDRINA";388;20;60;468
2016;"NOVA OLIMPIA (PR)";"PR";"NOVA OLIMPIA";133;13;26;172
2016;"NOVA PRATA DO IGUACU (PR)";"PR";"NOVA PRATA DO IGUACU";357;15;35;407
2016;"NOVA SANTA BARBARA (PR)";"PR";"NOVA SANTA BARBARA";140;12;9;161
2016;"NOVA SANTA ROSA (PR)";"PR";"NOVA SANTA ROSA";443;15;18;476
2016;"NOVA TEBAS (PR)";"PR";"NOVA TEBAS";153;10;30;193
2016;"NOVO ITACOLOMI (PR)";"PR";"NOVO ITACOLOMI";103;3;10;116
2016;"ORTIGUEIRA (PR)";"PR";"ORTIGUEIRA";495;44;102;641
2016;"OURIZONA (PR)";"PR";"OURIZONA";101;4;20;125
2016;"OURO VERDE DO OESTE (PR)";"PR";"OURO VERDE DO OESTE";178;9;16;203
2016;"PAICANDU (PR)";"PR";"PAICANDU";588;42;62;692
2016;"PALMAS (PR)";"PR";"PALMAS";1048;84;118;1250
2016;"PALMEIRA (PR)";"PR";"PALMEIRA";1067;64;98;1229
2016;"PALMITAL (PR)";"PR";"PALMITAL";321;18;62;401
2016;"PALOTINA (PR)";"PR";"PALOTINA";1371;63;178;1612
2016;"PARAISO DO NORTE (PR)";"PR";"PARAISO DO NORTE";285;18;71;374
2016;"PARANACITY (PR)";"PR";"PARANACITY";298;24;58;380
2016;"PARANAGUA (PR)";"PR";"PARANAGUA";2003;174;199;2376
2016;"PARANAPOEMA (PR)";"PR";"PARANAPOEMA";71;9;19;99
2016;"PARANAVAI (PR)";"PR";"PARANAVAI";2186;154;260;2600
2016;"PATO BRAGADO (PR)";"PR";"PATO BRAGADO";184;7;19;210
2016;"PATO BRANCO (PR)";"PR";"PATO BRANCO";2382;172;445;2999
2016;"PAULA FREITAS (PR)";"PR";"PAULA FREITAS";174;8;30;212
2016;"PAULO FRONTIN (PR)";"PR";"PAULO FRONTIN";284;6;26;316
2016;"PEABIRU (PR)";"PR";"PEABIRU";367;19;31;417
2016;"PEROBAL (PR)";"PR";"PEROBAL";121;9;34;164
2016;"PEROLA (PR)";"PR";"PEROLA";237;16;21;274
2016;"PEROLA D OESTE (PR)";"PR";"PEROLA D OESTE";230;8;28;266
2016;"PIEN (PR)";"PR";"PIEN";450;26;31;507
2016;"PINHAIS (PR)";"PR";"PINHAIS";2392;253;468;3113
2016;"PINHAL DO SAO BENTO (PR)";"PR";"PINHAL DO SAO BENTO";50;4;22;76
2016;"PINHALAO (PR)";"PR";"PINHALAO";132;11;22;165
2016;"PINHAO (PR)";"PR";"PINHAO";635;63;124;822
2016;"PIRAI DO SUL (PR)";"PR";"PIRAI DO SUL";520;56;118;694
2016;"PIRAQUARA (PR)";"PR";"PIRAQUARA";703;109;225;1037
2016;"PITANGA (PR)";"PR";"PITANGA";1015;39;135;1189
2016;"PITANGUEIRAS (PR)";"PR";"PITANGUEIRAS";60;6;33;99
2016;"PLANALTINA DO PARANA (PR)";"PR";"PLANALTINA DO PARANA";115;6;26;147
2016;"PLANALTO (PR)";"PR";"PLANALTO";403;16;46;465
2016;"PONTA GROSSA (PR)";"PR";"PONTA GROSSA";6541;754;1223;8518
2016;"PONTAL DO PARANA (PR)";"PR";"PONTAL DO PARANA";327;34;53;414
2016;"PORECATU (PR)";"PR";"PORECATU";299;38;169;506
2016;"PORTO AMAZONAS (PR)";"PR";"PORTO AMAZONAS";87;13;15;115
2016;"PORTO BARREIRO (PR)";"PR";"PORTO BARREIRO";98;9;31;138
2016;"PORTO RICO (PR)";"PR";"PORTO RICO";33;3;10;46
2016;"PORTO VITORIA (PR)";"PR";"PORTO VITORIA";182;4;14;200
2016;"PRADO FERREIRA (PR)";"PR";"PRADO FERREIRA";111;4;16;131
2016;"PRANCHITA (PR)";"PR";"PRANCHITA";287;11;21;319
2016;"PRESIDENTE CASTELO BRANCO (PR)";"PR";"PRESIDENTE CASTELO BRANCO";131;10;29;170
2016;"PRIMEIRO DE MAIO (PR)";"PR";"PRIMEIRO DE MAIO";346;17;34;397
2016;"PRUDENTOPOLIS (PR)";"PR";"PRUDENTOPOLIS";1476;72;158;1706
2016;"QUARTO CENTENARIO (PR)";"PR";"QUARTO CENTENARIO";142;5;10;157
2016;"QUATIGUA (PR)";"PR";"QUATIGUA";368;18;21;407
2016;"QUATRO BARRAS (PR)";"PR";"QUATRO BARRAS";702;49;124;875
2016;"QUATRO PONTES (PR)";"PR";"QUATRO PONTES";192;6;8;206
2016;"QUEDAS DO IGUACU (PR)";"PR";"QUEDAS DO IGUACU";811;43;176;1030
2016;"QUERENCIA DO NORTE (PR)";"PR";"QUERENCIA DO NORTE";254;7;38;299
2016;"QUINTA DO SOL (PR)";"PR";"QUINTA DO SOL";138;5;23;166
2016;"QUITANDINHA (PR)";"PR";"QUITANDINHA";545;13;87;645
2016;"RAMILANDIA (PR)";"PR";"RAMILANDIA";56;4;17;77
2016;"RANCHO ALEGRE (PR)";"PR";"RANCHO ALEGRE";117;7;19;143
2016;"RANCHO ALEGRE D OESTE (PR)";"PR";"RANCHO ALEGRE D OESTE";91;3;15;109
2016;"REALEZA (PR)";"PR";"REALEZA";686;28;47;761
2016;"REBOUCAS (PR)";"PR";"REBOUCAS";306;24;58;388
2016;"RENASCENCA (PR)";"PR";"RENASCENCA";291;13;41;345
2016;"RESERVA (PR)";"PR";"RESERVA";697;40;108;845
2016;"RESERVA DO IGUACU (PR)";"PR";"RESERVA DO IGUACU";92;11;19;122
2016;"RIBEIRAO CLARO (PR)";"PR";"RIBEIRAO CLARO";220;40;38;298
2016;"RIBEIRAO DO PINHAL (PR)";"PR";"RIBEIRAO DO PINHAL";226;37;65;328
2016;"RIO AZUL (PR)";"PR";"RIO AZUL";344;14;46;404
2016;"RIO BOM (PR)";"PR";"RIO BOM";102;6;13;121
2016;"RIO BONITO DO IGUACU (PR)";"PR";"RIO BONITO DO IGUACU";323;12;89;424
2016;"RIO BRANCO DO IVAI (PR)";"PR";"RIO BRANCO DO IVAI";48;5;13;66
2016;"RIO BRANCO DO SUL (PR)";"PR";"RIO BRANCO DO SUL";763;129;170;1062
2016;"RIO NEGRO (PR)";"PR";"RIO NEGRO";1107;98;86;1291
2016;"ROLANDIA (PR)";"PR";"ROLANDIA";1753;138;133;2024
2016;"RONCADOR (PR)";"PR";"RONCADOR";407;4;43;454
2016;"RONDON (PR)";"PR";"RONDON";290;13;75;378
2016;"ROSARIO DO IVAI (PR)";"PR";"ROSARIO DO IVAI";107;12;26;145
2016;"SABAUDIA (PR)";"PR";"SABAUDIA";236;13;25;274
2016;"SALGADO FILHO (PR)";"PR";"SALGADO FILHO";98;6;32;136
2016;"SALTO DO ITARARE (PR)";"PR";"SALTO DO ITARARE";119;7;20;146
2016;"SALTO DO LONTRA (PR)";"PR";"SALTO DO LONTRA";337;12;41;390
2016;"SANTA AMELIA (PR)";"PR";"SANTA AMELIA";79;8;22;109
2016;"SANTA CECILIA DO PAVAO (PR)";"PR";"SANTA CECILIA DO PAVAO";97;8;14;119
2016;"SANTA CRUZ DO MONTE CASTELO (PR)";"PR";"SANTA CRUZ DO MONTE CASTELO";235;15;51;301
2016;"SANTA FE (PR)";"PR";"SANTA FE";290;17;37;344
2016;"SANTA HELENA (PR)";"PR";"SANTA HELENA";700;66;134;900
2016;"SANTA INES (PR)";"PR";"SANTA INES";21;10;10;41
2016;"SANTA ISABEL DO IVAI (PR)";"PR";"SANTA ISABEL DO IVAI";219;21;38;278
2016;"SANTA IZABEL DO OESTE (PR)";"PR";"SANTA IZABEL DO OESTE";257;28;40;325
2016;"SANTA LUCIA (PR)";"PR";"SANTA LUCIA";133;4;11;148
2016;"SANTA MARIA DO OESTE (PR)";"PR";"SANTA MARIA DO OESTE";266;17;25;308
2016;"SANTA MARIANA (PR)";"PR";"SANTA MARIANA";328;26;54;408
2016;"SANTA MONICA (PR)";"PR";"SANTA MONICA";54;5;16;75
2016;"SANTA TEREZA DO OESTE (PR)";"PR";"SANTA TEREZA DO OESTE";275;13;25;313
2016;"SANTA TEREZINHA DE ITAIPU (PR)";"PR";"SANTA TEREZINHA DE ITAIPU";525;58;63;646
2016;"SANTANA DO ITARARE (PR)";"PR";"SANTANA DO ITARARE";111;8;25;144
2016;"SANTO ANTONIO DA PLATINA (PR)";"PR";"SANTO ANTONIO DA PLATINA";785;81;254;1120
2016;"SANTO ANTONIO DO CAIUA (PR)";"PR";"SANTO ANTONIO DO CAIUA";21;4;13;38
2016;"SANTO ANTONIO DO PARAISO (PR)";"PR";"SANTO ANTONIO DO PARAISO";79;7;16;102
2016;"SANTO ANTONIO DO SUDOESTE (PR)";"PR";"SANTO ANTONIO DO SUDOESTE";455;19;45;519
2016;"SANTO INACIO (PR)";"PR";"SANTO INACIO";139;9;23;171
2016;"SAO CARLOS DO IVAI (PR)";"PR";"SAO CARLOS DO IVAI";244;9;32;285
2016;"SAO JERONIMO DA SERRA (PR)";"PR";"SAO JERONIMO DA SERRA";191;11;29;231
2016;"SAO JOAO (PR)";"PR";"SAO JOAO";421;17;51;489
2016;"SAO JOAO DO CAIUA (PR)";"PR";"SAO JOAO DO CAIUA";84;8;38;130
2016;"SAO JOAO DO IVAI (PR)";"PR";"SAO JOAO DO IVAI";367;10;38;415
2016;"SAO JOAO DO TRIUNFO (PR)";"PR";"SAO JOAO DO TRIUNFO";284;13;48;345
2016;"SAO JORGE D OESTE (PR)";"PR";"SAO JORGE D OESTE";254;16;54;324
2016;"SAO JORGE DO IVAI (PR)";"PR";"SAO JORGE DO IVAI";280;10;22;312
2016;"SAO JORGE DO PATROCINIO (PR)";"PR";"SAO JORGE DO PATROCINIO";142;8;24;174
2016;"SAO JOSE DA BOA VISTA (PR)";"PR";"SAO JOSE DA BOA VISTA";130;6;27;163
2016;"SAO JOSE DAS PALMEIRAS (PR)";"PR";"SAO JOSE DAS PALMEIRAS";97;12;33;142
2016;"SAO JOSE DOS PINHAIS (PR)";"PR";"SAO JOSE DOS PINHAIS";8056;700;871;9627
2016;"SAO MANOEL DO PARANA (PR)";"PR";"SAO MANOEL DO PARANA";56;1;10;67
2016;"SAO MATEUS DO SUL (PR)";"PR";"SAO MATEUS DO SUL";1114;106;167;1387
2016;"SAO MIGUEL DO IGUACU (PR)";"PR";"SAO MIGUEL DO IGUACU";962;59;75;1096
2016;"SAO PEDRO DO IGUACU (PR)";"PR";"SAO PEDRO DO IGUACU";199;7;42;248
2016;"SAO PEDRO DO IVAI (PR)";"PR";"SAO PEDRO DO IVAI";363;15;50;428
2016;"SAO PEDRO DO PARANA (PR)";"PR";"SAO PEDRO DO PARANA";47;6;6;59
2016;"SAO SEBASTIAO DA AMOREIRA (PR)";"PR";"SAO SEBASTIAO DA AMOREIRA";205;7;53;265
2016;"SAO TOME (PR)";"PR";"SAO TOME";165;10;39;214
2016;"SAPOPEMA (PR)";"PR";"SAPOPEMA";138;5;21;164
2016;"SARANDI (PR)";"PR";"SARANDI";1182;114;198;1494
2016;"SAUDADE DO IGUACU (PR)";"PR";"SAUDADE DO IGUACU";95;21;28;144
2016;"SENGES (PR)";"PR";"SENGES";576;37;69;682
2016;"SERRANOPOLIS DO IGUACU (PR)";"PR";"SERRANOPOLIS DO IGUACU";160;14;15;189
2016;"SERTANEJA (PR)";"PR";"SERTANEJA";202;13;35;250
2016;"SERTANOPOLIS (PR)";"PR";"SERTANOPOLIS";657;28;74;759
2016;"SIQUEIRA CAMPOS (PR)";"PR";"SIQUEIRA CAMPOS";450;23;74;547
2016;"SULINA (PR)";"PR";"SULINA";95;4;14;113
2016;"TAMARANA (PR)";"PR";"TAMARANA";341;18;54;413
2016;"TAMBOARA (PR)";"PR";"TAMBOARA";105;10;15;130
2016;"TAPEJARA (PR)";"PR";"TAPEJARA";453;12;106;571
2016;"TAPIRA (PR)";"PR";"TAPIRA";176;7;36;219
2016;"TEIXEIRA SOARES (PR)";"PR";"TEIXEIRA SOARES";221;16;98;335
2016;"TELEMACO BORBA (PR)";"PR";"TELEMACO BORBA";1148;250;239;1637
2016;"TERRA BOA (PR)";"PR";"TERRA BOA";382;24;111;517
2016;"TERRA RICA (PR)";"PR";"TERRA RICA";427;21;93;541
2016;"TERRA ROXA (PR)";"PR";"TERRA ROXA";600;20;66;686
2016;"TIBAGI (PR)";"PR";"TIBAGI";386;55;66;507
2016;"TIJUCAS DO SUL (PR)";"PR";"TIJUCAS DO SUL";508;21;51;580
2016;"TOLEDO (PR)";"PR";"TOLEDO";3479;255;251;3985
2016;"TOMAZINA (PR)";"PR";"TOMAZINA";125;13;25;163
2016;"TRES BARRAS DO PARANA (PR)";"PR";"TRES BARRAS DO PARANA";382;8;37;427
2016;"TUNAS DO PARANA (PR)";"PR";"TUNAS DO PARANA";127;14;50;191
2016;"TUNEIRAS DO OESTE (PR)";"PR";"TUNEIRAS DO OESTE";168;12;63;243
2016;"TUPASSI (PR)";"PR";"TUPASSI";388;14;41;443
2016;"TURVO (PR)";"PR";"TURVO";451;31;81;563
2016;"UBIRATA (PR)";"PR";"UBIRATA";787;38;79;904
2016;"UMUARAMA (PR)";"PR";"UMUARAMA";2910;99;311;3320
2016;"UNIAO DA VITORIA (PR)";"PR";"UNIAO DA VITORIA";1547;70;94;1711
2016;"UNIFLOR (PR)";"PR";"UNIFLOR";56;6;17;79
2016;"URAI (PR)";"PR";"URAI";364;24;24;412
2016;"VENTANIA (PR)";"PR";"VENTANIA";180;20;36;236
2016;"VERA CRUZ DO OESTE (PR)";"PR";"VERA CRUZ DO OESTE";315;13;22;350
2016;"VERE (PR)";"PR";"VERE";254;6;26;286
2016;"VIRMOND (PR)";"PR";"VIRMOND";134;2;24;160
2016;"VITORINO (PR)";"PR";"VITORINO";283;11;34;328
2016;"WENCESLAU BRAZ (PR)";"PR";"WENCESLAU BRAZ";512;30;86;628
2016;"XAMBRE (PR)";"PR";"XAMBRE";168;11;16;195
2016;"ANGRA DOS REIS (RJ)";"RJ";"ANGRA DOS REIS";1248;221;385;1854
2016;"APERIBE (RJ)";"RJ";"APERIBE";145;19;14;178
2016;"ARARUAMA (RJ)";"RJ";"ARARUAMA";1908;307;175;2390
2016;"AREAL (RJ)";"RJ";"AREAL";179;37;44;260
2016;"ARMACAO DE BUZIOS (RJ)";"RJ";"ARMACAO DE BUZIOS";358;326;64;748
2016;"ARRAIAL DO CABO (RJ)";"RJ";"ARRAIAL DO CABO";169;66;16;251
2016;"BARRA DO PIRAI (RJ)";"RJ";"BARRA DO PIRAI";1441;230;288;1959
2016;"BARRA MANSA (RJ)";"RJ";"BARRA MANSA";2012;267;672;2951
2016;"BELFORD ROXO (RJ)";"RJ";"BELFORD ROXO";1999;498;927;3424
2016;"BOM JARDIM (RJ)";"RJ";"BOM JARDIM";672;60;54;786
2016;"BOM JESUS DO ITABAPOANA (RJ)";"RJ";"BOM JESUS DO ITABAPOANA";301;57;63;421
2016;"CABO FRIO (RJ)";"RJ";"CABO FRIO";3120;376;483;3979
2016;"CACHOEIRAS DE MACACU (RJ)";"RJ";"CACHOEIRAS DE MACACU";927;179;46;1152
2016;"CAMBUCI (RJ)";"RJ";"CAMBUCI";131;28;27;186
2016;"CAMPOS DOS GOYTACAZES (RJ)";"RJ";"CAMPOS DOS GOYTACAZES";7002;1141;1483;9626
2016;"CANTAGALO (RJ)";"RJ";"CANTAGALO";212;48;47;307
2016;"CARAPEBUS (RJ)";"RJ";"CARAPEBUS";132;30;16;178
2016;"CARDOSO MOREIRA (RJ)";"RJ";"CARDOSO MOREIRA";181;33;51;265
2016;"CARMO (RJ)";"RJ";"CARMO";143;33;23;199
2016;"CASIMIRO DE ABREU (RJ)";"RJ";"CASIMIRO DE ABREU";615;97;27;739
2016;"COMENDADOR LEVY GASPARIAN (RJ)";"RJ";"COMENDADOR LEVY GASPARIAN";192;34;18;244
2016;"CONCEICAO DE MACABU (RJ)";"RJ";"CONCEICAO DE MACABU";183;41;60;284
2016;"CORDEIRO (RJ)";"RJ";"CORDEIRO";282;52;61;395
2016;"DUAS BARRAS (RJ)";"RJ";"DUAS BARRAS";158;42;10;210
2016;"DUQUE DE CAXIAS (RJ)";"RJ";"DUQUE DE CAXIAS";9516;1081;3915;14512
2016;"ENGENHEIRO PAULO DE FRONTIN (RJ)";"RJ";"ENGENHEIRO PAULO DE FRONTIN";132;29;17;178
2016;"GUAPIMIRIM (RJ)";"RJ";"GUAPIMIRIM";432;76;56;564
2016;"IGUABA GRANDE (RJ)";"RJ";"IGUABA GRANDE";192;84;28;304
2016;"ITABORAI (RJ)";"RJ";"ITABORAI";3205;752;558;4515
2016;"ITAGUAI (RJ)";"RJ";"ITAGUAI";1741;311;334;2386
2016;"ITALVA (RJ)";"RJ";"ITALVA";206;32;36;274
2016;"ITAOCARA (RJ)";"RJ";"ITAOCARA";376;49;40;465
2016;"ITAPERUNA (RJ)";"RJ";"ITAPERUNA";1137;143;116;1396
2016;"ITATIAIA (RJ)";"RJ";"ITATIAIA";153;81;46;280
2016;"JAPERI (RJ)";"RJ";"JAPERI";560;73;42;675
2016;"LAJE DO MURIAE (RJ)";"RJ";"LAJE DO MURIAE";42;7;15;64
2016;"MACAE (RJ)";"RJ";"MACAE";3192;1033;1002;5227
2016;"MACUCO (RJ)";"RJ";"MACUCO";187;14;11;212
2016;"MAGE (RJ)";"RJ";"MAGE";1921;448;181;2550
2016;"MANGARATIBA (RJ)";"RJ";"MANGARATIBA";203;149;174;526
2016;"MARICA (RJ)";"RJ";"MARICA";1199;390;420;2009
2016;"MENDES (RJ)";"RJ";"MENDES";223;57;52;332
2016;"MESQUITA (RJ)";"RJ";"MESQUITA";880;125;701;1706
2016;"MIGUEL PEREIRA (RJ)";"RJ";"MIGUEL PEREIRA";377;82;46;505
2016;"MIRACEMA (RJ)";"RJ";"MIRACEMA";277;37;35;349
2016;"NATIVIDADE (RJ)";"RJ";"NATIVIDADE";92;20;46;158
2016;"NILOPOLIS (RJ)";"RJ";"NILOPOLIS";664;161;360;1185
2016;"NITEROI (RJ)";"RJ";"NITEROI";2734;1281;2817;6832
2016;"NOVA FRIBURGO (RJ)";"RJ";"NOVA FRIBURGO";3724;304;362;4390
2016;"NOVA IGUACU (RJ)";"RJ";"NOVA IGUACU";6614;1562;1794;9970
2016;"PARACAMBI (RJ)";"RJ";"PARACAMBI";693;109;111;913
2016;"PARAIBA DO SUL (RJ)";"RJ";"PARAIBA DO SUL";611;131;107;849
2016;"PARATI (RJ)";"RJ";"PARATI";224;88;57;369
2016;"PATY DO ALFERES (RJ)";"RJ";"PATY DO ALFERES";511;55;59;625
2016;"PETROPOLIS (RJ)";"RJ";"PETROPOLIS";3133;715;998;4846
2016;"PINHEIRAL (RJ)";"RJ";"PINHEIRAL";210;61;129;400
2016;"PIRAI (RJ)";"RJ";"PIRAI";422;79;74;575
2016;"PORCIUNCULA (RJ)";"RJ";"PORCIUNCULA";74;24;26;124
2016;"PORTO REAL (RJ)";"RJ";"PORTO REAL";256;52;20;328
2016;"QUATIS (RJ)";"RJ";"QUATIS";161;73;34;268
2016;"QUEIMADOS (RJ)";"RJ";"QUEIMADOS";688;234;309;1231
2016;"QUISSAMA (RJ)";"RJ";"QUISSAMA";230;39;121;390
2016;"RESENDE (RJ)";"RJ";"RESENDE";1459;307;716;2482
2016;"RIO BONITO (RJ)";"RJ";"RIO BONITO";3432;350;155;3937
2016;"RIO CLARO (RJ)";"RJ";"RIO CLARO";126;22;25;173
2016;"RIO DAS FLORES (RJ)";"RJ";"RIO DAS FLORES";53;33;18;104
2016;"RIO DAS OSTRAS (RJ)";"RJ";"RIO DAS OSTRAS";1125;840;172;2137
2016;"RIO DE JANEIRO (RJ)";"RJ";"RIO DE JANEIRO";43154;18031;18578;79763
2016;"SANTA MARIA MADALENA (RJ)";"RJ";"SANTA MARIA MADALENA";83;35;23;141
2016;"SANTO ANTONIO DE PADUA (RJ)";"RJ";"SANTO ANTONIO DE PADUA";613;110;36;759
2016;"SAO FIDELIS (RJ)";"RJ";"SAO FIDELIS";441;54;72;567
2016;"SAO FRANCISCO DE ITABAPOANA (RJ)";"RJ";"SAO FRANCISCO DE ITABAPOANA";443;125;107;675
2016;"SAO GONCALO (RJ)";"RJ";"SAO GONCALO";5170;1959;3340;10469
2016;"SAO JOAO DA BARRA (RJ)";"RJ";"SAO JOAO DA BARRA";679;95;69;843
2016;"SAO JOAO DE MERITI (RJ)";"RJ";"SAO JOAO DE MERITI";3687;574;1370;5631
2016;"SAO JOSE DE UBA (RJ)";"RJ";"SAO JOSE DE UBA";51;11;10;72
2016;"SAO JOSE DO VALE DO RIO PRETO (RJ)";"RJ";"SAO JOSE DO VALE DO RIO PRETO";714;41;42;797
2016;"SAO PEDRO DA ALDEIA (RJ)";"RJ";"SAO PEDRO DA ALDEIA";952;117;89;1158
2016;"SAO SEBASTIAO DO ALTO (RJ)";"RJ";"SAO SEBASTIAO DO ALTO";121;30;8;159
2016;"SAPUCAIA (RJ)";"RJ";"SAPUCAIA";128;16;8;152
2016;"SAQUAREMA (RJ)";"RJ";"SAQUAREMA";844;150;156;1150
2016;"SEROPEDICA (RJ)";"RJ";"SEROPEDICA";1353;83;286;1722
2016;"SILVA JARDIM (RJ)";"RJ";"SILVA JARDIM";319;59;45;423
2016;"SUMIDOURO (RJ)";"RJ";"SUMIDOURO";360;20;22;402
2016;"TANGUA (RJ)";"RJ";"TANGUA";350;60;72;482
2016;"TERESOPOLIS (RJ)";"RJ";"TERESOPOLIS";2392;334;288;3014
2016;"TRAJANO DE MORAIS (RJ)";"RJ";"TRAJANO DE MORAIS";114;29;18;161
2016;"TRES RIOS (RJ)";"RJ";"TRES RIOS";1051;125;224;1400
2016;"VALENCA (RJ)";"RJ";"VALENCA";394;134;100;628
2016;"VARRE SAI (RJ)";"RJ";"VARRE SAI";75;16;7;98
2016;"VASSOURAS (RJ)";"RJ";"VASSOURAS";575;89;99;763
2016;"VOLTA REDONDA (RJ)";"RJ";"VOLTA REDONDA";2349;438;619;3406
2016;"ACARI (RN)";"RN";"ACARI";113;10;13;136
2016;"AFONSO BEZERRA (RN)";"RN";"AFONSO BEZERRA";32;6;15;53
2016;"AGUA NOVA (RN)";"RN";"AGUA NOVA";8;13;2;23
2016;"ALEXANDRIA (RN)";"RN";"ALEXANDRIA";95;32;15;142
2016;"ALMINO AFONSO (RN)";"RN";"ALMINO AFONSO";26;9;1;36
2016;"ALTO DO RODRIGUES (RN)";"RN";"ALTO DO RODRIGUES";182;18;26;226
2016;"ANGICOS (RN)";"RN";"ANGICOS";122;19;12;153
2016;"ANTONIO MARTINS (RN)";"RN";"ANTONIO MARTINS";35;8;3;46
2016;"APODI (RN)";"RN";"APODI";339;36;48;423
2016;"AREIA BRANCA (RN)";"RN";"AREIA BRANCA";139;48;73;260
2016;"ARES (RN)";"RN";"ARES";58;7;41;106
2016;"ASSU (RN)";"RN";"ASSU";697;65;96;858
2016;"BAIA FORMOSA (RN)";"RN";"BAIA FORMOSA";53;3;24;80
2016;"BARAUNA (RN)";"RN";"BARAUNA";652;31;40;723
2016;"BARCELONA (RN)";"RN";"BARCELONA";25;3;4;32
2016;"BENTO FERNANDES (RN)";"RN";"BENTO FERNANDES";14;5;12;31
2016;"BOA SAUDE (RN)";"RN";"BOA SAUDE";85;5;12;102
2016;"BODO (RN)";"RN";"BODO";7;6;3;16
2016;"BOM JESUS (RN)";"RN";"BOM JESUS";62;5;9;76
2016;"BREJINHO (RN)";"RN";"BREJINHO";119;12;19;150
2016;"CAICARA DO NORTE (RN)";"RN";"CAICARA DO NORTE";16;2;6;24
2016;"CAICARA DO RIO DO VENTO (RN)";"RN";"CAICARA DO RIO DO VENTO";24;4;3;31
2016;"CAICO (RN)";"RN";"CAICO";2049;133;66;2248
2016;"CAMPO GRANDE (RN)";"RN";"CAMPO GRANDE";52;12;9;73
2016;"CAMPO REDONDO (RN)";"RN";"CAMPO REDONDO";67;10;13;90
2016;"CANGUARETAMA (RN)";"RN";"CANGUARETAMA";187;31;79;297
2016;"CARAUBAS (RN)";"RN";"CARAUBAS";188;42;18;248
2016;"CARNAUBA DOS DANTAS (RN)";"RN";"CARNAUBA DOS DANTAS";236;10;9;255
2016;"CARNAUBAIS (RN)";"RN";"CARNAUBAIS";49;18;14;81
2016;"CEARA MIRIM (RN)";"RN";"CEARA MIRIM";371;55;136;562
2016;"CERRO CORA (RN)";"RN";"CERRO CORA";112;14;15;141
2016;"CORONEL EZEQUIEL (RN)";"RN";"CORONEL EZEQUIEL";69;7;4;80
2016;"CORONEL JOAO PESSOA (RN)";"RN";"CORONEL JOAO PESSOA";14;3;4;21
2016;"CRUZETA (RN)";"RN";"CRUZETA";87;17;11;115
2016;"CURRAIS NOVOS (RN)";"RN";"CURRAIS NOVOS";764;62;64;890
2016;"DOUTOR SEVERIANO (RN)";"RN";"DOUTOR SEVERIANO";35;5;10;50
2016;"ENCANTO (RN)";"RN";"ENCANTO";16;9;9;34
2016;"EQUADOR (RN)";"RN";"EQUADOR";136;7;3;146
2016;"ESPIRITO SANTO (RN)";"RN";"ESPIRITO SANTO";29;2;16;47
2016;"EXTREMOZ (RN)";"RN";"EXTREMOZ";90;24;45;159
2016;"FELIPE GUERRA (RN)";"RN";"FELIPE GUERRA";26;11;11;48
2016;"FERNANDO PEDROZA (RN)";"RN";"FERNANDO PEDROZA";30;4;2;36
2016;"FLORANIA (RN)";"RN";"FLORANIA";77;13;8;98
2016;"FRANCISCO DANTAS (RN)";"RN";"FRANCISCO DANTAS";21;4;3;28
2016;"FRUTUOSO GOMES (RN)";"RN";"FRUTUOSO GOMES";31;15;2;48
2016;"GALINHOS (RN)";"RN";"GALINHOS";16;4;4;24
2016;"GOIANINHA (RN)";"RN";"GOIANINHA";186;63;106;355
2016;"GOVERNADOR DIX SEPT ROSADO (RN)";"RN";"GOVERNADOR DIX SEPT ROSADO";175;25;17;217
2016;"GROSSOS (RN)";"RN";"GROSSOS";55;4;18;77
2016;"GUAMARE (RN)";"RN";"GUAMARE";133;22;43;198
2016;"IELMO MARINHO (RN)";"RN";"IELMO MARINHO";58;3;24;85
2016;"IPANGUACU (RN)";"RN";"IPANGUACU";109;31;51;191
2016;"IPUEIRA (RN)";"RN";"IPUEIRA";16;7;6;29
2016;"ITAJA (RN)";"RN";"ITAJA";105;3;7;115
2016;"ITAU (RN)";"RN";"ITAU";36;11;1;48
2016;"JACANA (RN)";"RN";"JACANA";330;63;26;419
2016;"JANDAIRA (RN)";"RN";"JANDAIRA";50;1;12;63
2016;"JANDUIS (RN)";"RN";"JANDUIS";22;5;3;30
2016;"JAPI (RN)";"RN";"JAPI";59;11;10;80
2016;"JARDIM DE ANGICOS (RN)";"RN";"JARDIM DE ANGICOS";13;1;4;18
2016;"JARDIM DE PIRANHAS (RN)";"RN";"JARDIM DE PIRANHAS";99;32;10;141
2016;"JARDIM DO SERIDO (RN)";"RN";"JARDIM DO SERIDO";147;21;51;219
2016;"JOAO CAMARA (RN)";"RN";"JOAO CAMARA";385;26;46;457
2016;"JOAO DIAS (RN)";"RN";"JOAO DIAS";11;1;1;13
2016;"JOSE DA PENHA (RN)";"RN";"JOSE DA PENHA";33;15;3;51
2016;"JUCURUTU (RN)";"RN";"JUCURUTU";157;43;12;212
2016;"JUNDIA (RN)";"RN";"JUNDIA";15;5;9;29
2016;"LAGOA DANTA (RN)";"RN";"LAGOA DANTA";56;11;19;86
2016;"LAGOA DE PEDRAS (RN)";"RN";"LAGOA DE PEDRAS";35;5;16;56
2016;"LAGOA DE VELHOS (RN)";"RN";"LAGOA DE VELHOS";23;2;2;27
2016;"LAGOA NOVA (RN)";"RN";"LAGOA NOVA";111;17;15;143
2016;"LAGOA SALGADA (RN)";"RN";"LAGOA SALGADA";117;5;10;132
2016;"LAJES (RN)";"RN";"LAJES";82;7;12;101
2016;"LAJES PINTADAS (RN)";"RN";"LAJES PINTADAS";24;14;5;43
2016;"LUCRECIA (RN)";"RN";"LUCRECIA";29;8;4;41
2016;"LUIS GOMES (RN)";"RN";"LUIS GOMES";55;37;8;100
2016;"MACAIBA (RN)";"RN";"MACAIBA";864;134;81;1079
2016;"MACAU (RN)";"RN";"MACAU";210;35;66;311
2016;"MAJOR SALES (RN)";"RN";"MAJOR SALES";17;12;2;31
2016;"MARCELINO VIEIRA (RN)";"RN";"MARCELINO VIEIRA";24;17;4;45
2016;"MARTINS (RN)";"RN";"MARTINS";51;14;8;73
2016;"MAXARANGUAPE (RN)";"RN";"MAXARANGUAPE";26;9;9;44
2016;"MESSIAS TARGINO (RN)";"RN";"MESSIAS TARGINO";45;10;4;59
2016;"MONTANHAS (RN)";"RN";"MONTANHAS";55;9;19;83
2016;"MONTE ALEGRE (RN)";"RN";"MONTE ALEGRE";116;21;38;175
2016;"MONTE DAS GAMELEIRAS (RN)";"RN";"MONTE DAS GAMELEIRAS";15;2;8;25
2016;"MOSSORO (RN)";"RN";"MOSSORO";3956;313;347;4616
2016;"NATAL (RN)";"RN";"NATAL";7039;1322;2622;10983
2016;"NISIA FLORESTA (RN)";"RN";"NISIA FLORESTA";90;44;55;189
2016;"NOVA CRUZ (RN)";"RN";"NOVA CRUZ";455;54;79;588
2016;"OLHO D AGUA DO BORGES (RN)";"RN";"OLHO D AGUA DO BORGES";29;4;1;34
2016;"OURO BRANCO (RN)";"RN";"OURO BRANCO";43;14;5;62
2016;"PARANA (RN)";"RN";"PARANA";21;12;4;37
2016;"PARAU (RN)";"RN";"PARAU";16;12;2;30
2016;"PARAZINHO (RN)";"RN";"PARAZINHO";32;4;15;51
2016;"PARELHAS (RN)";"RN";"PARELHAS";454;38;45;537
2016;"PARNAMIRIM (RN)";"RN";"PARNAMIRIM";2080;401;456;2937
2016;"PASSA E FICA (RN)";"RN";"PASSA E FICA";171;59;44;274
2016;"PASSAGEM (RN)";"RN";"PASSAGEM";17;9;2;28
2016;"PATU (RN)";"RN";"PATU";127;25;6;158
2016;"PAU DOS FERROS (RN)";"RN";"PAU DOS FERROS";592;58;33;683
2016;"PEDRA GRANDE (RN)";"RN";"PEDRA GRANDE";12;2;7;21
2016;"PEDRA PRETA (RN)";"RN";"PEDRA PRETA";36;3;11;50
2016;"PEDRO AVELINO (RN)";"RN";"PEDRO AVELINO";32;3;6;41
2016;"PEDRO VELHO (RN)";"RN";"PEDRO VELHO";49;7;16;72
2016;"PENDENCIAS (RN)";"RN";"PENDENCIAS";69;15;16;100
2016;"PILOES (RN)";"RN";"PILOES";21;6;2;29
2016;"POCO BRANCO (RN)";"RN";"POCO BRANCO";34;7;13;54
2016;"PORTALEGRE (RN)";"RN";"PORTALEGRE";47;14;6;67
2016;"PORTO DO MANGUE (RN)";"RN";"PORTO DO MANGUE";26;18;8;52
2016;"PUREZA (RN)";"RN";"PUREZA";86;7;22;115
2016;"RAFAEL FERNANDES (RN)";"RN";"RAFAEL FERNANDES";32;6;1;39
2016;"RAFAEL GODEIRO (RN)";"RN";"RAFAEL GODEIRO";9;1;2;12
2016;"RIACHO DA CRUZ (RN)";"RN";"RIACHO DA CRUZ";11;4;1;16
2016;"RIACHO DE SANTANA (RN)";"RN";"RIACHO DE SANTANA";9;8;4;21
2016;"RIACHUELO (RN)";"RN";"RIACHUELO";34;4;8;46
2016;"RIO DO FOGO (RN)";"RN";"RIO DO FOGO";38;6;8;52
2016;"RODOLFO FERNANDES (RN)";"RN";"RODOLFO FERNANDES";40;5;4;49
2016;"RUY BARBOSA (RN)";"RN";"RUY BARBOSA";19;1;5;25
2016;"SANTA CRUZ (RN)";"RN";"SANTA CRUZ";561;36;48;645
2016;"SANTA MARIA (RN)";"RN";"SANTA MARIA";65;4;6;75
2016;"SANTANA DO MATOS (RN)";"RN";"SANTANA DO MATOS";82;12;13;107
2016;"SANTANA DO SERIDO (RN)";"RN";"SANTANA DO SERIDO";25;3;2;30
2016;"SANTO ANTONIO (RN)";"RN";"SANTO ANTONIO";142;56;38;236
2016;"SAO BENTO DO NORTE (RN)";"RN";"SAO BENTO DO NORTE";9;0;9;18
2016;"SAO BENTO DO TRAIRI (RN)";"RN";"SAO BENTO DO TRAIRI";15;1;6;22
2016;"SAO FERNANDO (RN)";"RN";"SAO FERNANDO";20;10;5;35
2016;"SAO FRANCISCO DO OESTE (RN)";"RN";"SAO FRANCISCO DO OESTE";34;4;3;41
2016;"SAO GONCALO DO AMARANTE (RN)";"RN";"SAO GONCALO DO AMARANTE";494;185;261;940
2016;"SAO JOAO DO SABUGI (RN)";"RN";"SAO JOAO DO SABUGI";52;22;4;78
2016;"SAO JOSE DE MIPIBU (RN)";"RN";"SAO JOSE DE MIPIBU";365;49;64;478
2016;"SAO JOSE DO CAMPESTRE (RN)";"RN";"SAO JOSE DO CAMPESTRE";85;5;21;111
2016;"SAO JOSE DO SERIDO (RN)";"RN";"SAO JOSE DO SERIDO";35;12;2;49
2016;"SAO MIGUEL (RN)";"RN";"SAO MIGUEL";251;54;29;334
2016;"SAO MIGUEL DO GOSTOSO (RN)";"RN";"SAO MIGUEL DO GOSTOSO";35;10;18;63
2016;"SAO PAULO DO POTENGI (RN)";"RN";"SAO PAULO DO POTENGI";129;11;25;165
2016;"SAO PEDRO (RN)";"RN";"SAO PEDRO";35;5;9;49
2016;"SAO RAFAEL (RN)";"RN";"SAO RAFAEL";40;16;5;61
2016;"SAO TOME (RN)";"RN";"SAO TOME";71;4;25;100
2016;"SAO VICENTE (RN)";"RN";"SAO VICENTE";53;4;7;64
2016;"SENADOR ELOI DE SOUZA (RN)";"RN";"SENADOR ELOI DE SOUZA";24;4;13;41
2016;"SENADOR GEORGINO AVELINO (RN)";"RN";"SENADOR GEORGINO AVELINO";13;1;2;16
2016;"SERRA CAIADA (RN)";"RN";"SERRA CAIADA";56;8;16;80
2016;"SERRA DE SAO BENTO (RN)";"RN";"SERRA DE SAO BENTO";45;7;5;57
2016;"SERRA DO MEL (RN)";"RN";"SERRA DO MEL";107;12;16;135
2016;"SERRA NEGRA DO NORTE (RN)";"RN";"SERRA NEGRA DO NORTE";71;22;10;103
2016;"SERRINHA (RN)";"RN";"SERRINHA";33;14;9;56
2016;"SERRINHA DOS PINTOS (RN)";"RN";"SERRINHA DOS PINTOS";39;4;2;45
2016;"SEVERIANO MELO (RN)";"RN";"SEVERIANO MELO";37;9;6;52
2016;"SITIO NOVO (RN)";"RN";"SITIO NOVO";17;6;5;28
2016;"TABOLEIRO GRANDE (RN)";"RN";"TABOLEIRO GRANDE";7;6;3;16
2016;"TAIPU (RN)";"RN";"TAIPU";59;5;20;84
2016;"TANGARA (RN)";"RN";"TANGARA";157;10;39;206
2016;"TENENTE ANANIAS (RN)";"RN";"TENENTE ANANIAS";73;20;4;97
2016;"TENENTE LAURENTINO CRUZ (RN)";"RN";"TENENTE LAURENTINO CRUZ";55;11;6;72
2016;"TIBAU (RN)";"RN";"TIBAU";33;9;20;62
2016;"TIBAU DO SUL (RN)";"RN";"TIBAU DO SUL";51;49;17;117
2016;"TIMBAUBA DOS BATISTAS (RN)";"RN";"TIMBAUBA DOS BATISTAS";15;5;3;23
2016;"TOUROS (RN)";"RN";"TOUROS";179;32;49;260
2016;"TRIUNFO POTIGUAR (RN)";"RN";"TRIUNFO POTIGUAR";16;6;3;25
2016;"UMARIZAL (RN)";"RN";"UMARIZAL";76;31;5;112
2016;"UPANEMA (RN)";"RN";"UPANEMA";89;12;15;116
2016;"VARZEA (RN)";"RN";"VARZEA";17;4;8;29
2016;"VENHA VER (RN)";"RN";"VENHA VER";19;10;5;34
2016;"VERA CRUZ (RN)";"RN";"VERA CRUZ";166;10;22;198
2016;"VICOSA (RN)";"RN";"VICOSA";8;2;1;11
2016;"VILA FLOR (RN)";"RN";"VILA FLOR";12;2;3;17
2016;"ALTA FLORESTA D OESTE (RO)";"RO";"ALTA FLORESTA D OESTE";556;16;80;652
2016;"ALTO ALEGRE DOS PARECIS (RO)";"RO";"ALTO ALEGRE DOS PARECIS";167;15;36;218
2016;"ALTO PARAISO (RO)";"RO";"ALTO PARAISO";323;10;76;409
2016;"ALVORADA D OESTE (RO)";"RO";"ALVORADA D OESTE";278;7;66;351
2016;"ARIQUEMES (RO)";"RO";"ARIQUEMES";2101;34;220;2355
2016;"BURITIS (RO)";"RO";"BURITIS";527;8;39;574
2016;"CABIXI (RO)";"RO";"CABIXI";103;4;25;132
2016;"CACAULANDIA (RO)";"RO";"CACAULANDIA";82;4;27;113
2016;"CACOAL (RO)";"RO";"CACOAL";1877;75;297;2249
2016;"CAMPO NOVO DE RONDONIA (RO)";"RO";"CAMPO NOVO DE RONDONIA";85;7;45;137
2016;"CANDEIAS DO JAMARI (RO)";"RO";"CANDEIAS DO JAMARI";226;8;35;269
2016;"CASTANHEIRAS (RO)";"RO";"CASTANHEIRAS";41;2;17;60
2016;"CEREJEIRAS (RO)";"RO";"CEREJEIRAS";390;4;59;453
2016;"CHUPINGUAIA (RO)";"RO";"CHUPINGUAIA";144;6;64;214
2016;"COLORADO DO OESTE (RO)";"RO";"COLORADO DO OESTE";411;14;57;482
2016;"CORUMBIARA (RO)";"RO";"CORUMBIARA";103;8;19;130
2016;"COSTA MARQUES (RO)";"RO";"COSTA MARQUES";149;7;28;184
2016;"CUJUBIM (RO)";"RO";"CUJUBIM";281;7;23;311
2016;"ESPIGAO D OESTE (RO)";"RO";"ESPIGAO D OESTE";678;5;135;818
2016;"GOVERNADOR JORGE TEIXEIRA (RO)";"RO";"GOVERNADOR JORGE TEIXEIRA";69;3;22;94
2016;"GUAJARA MIRIM (RO)";"RO";"GUAJARA MIRIM";859;13;39;911
2016;"ITAPUA DO OESTE (RO)";"RO";"ITAPUA DO OESTE";171;5;59;235
2016;"JARU (RO)";"RO";"JARU";990;27;209;1226
2016;"JI PARANA (RO)";"RO";"JI PARANA";3139;90;700;3929
2016;"MACHADINHO D OESTE (RO)";"RO";"MACHADINHO D OESTE";417;15;78;510
2016;"MINISTRO ANDREAZZA (RO)";"RO";"MINISTRO ANDREAZZA";247;4;20;271
2016;"MIRANTE DA SERRA (RO)";"RO";"MIRANTE DA SERRA";196;7;34;237
2016;"MONTE NEGRO (RO)";"RO";"MONTE NEGRO";312;18;87;417
2016;"NOVA BRASILANDIA D OESTE (RO)";"RO";"NOVA BRASILANDIA D OESTE";258;9;78;345
2016;"NOVA DO MAMORE (RO)";"RO";"NOVA DO MAMORE";350;3;29;382
2016;"NOVA UNIAO (RO)";"RO";"NOVA UNIAO";87;1;35;123
2016;"NOVO HORIZONTE DO OESTE (RO)";"RO";"NOVO HORIZONTE DO OESTE";122;1;20;143
2016;"OURO PRETO DO OESTE (RO)";"RO";"OURO PRETO DO OESTE";797;28;126;951
2016;"PARECIS (RO)";"RO";"PARECIS";64;3;24;91
2016;"PIMENTA BUENO (RO)";"RO";"PIMENTA BUENO";1126;40;91;1257
2016;"PIMENTEIRAS DO OESTE (RO)";"RO";"PIMENTEIRAS DO OESTE";34;1;16;51
2016;"PORTO VELHO (RO)";"RO";"PORTO VELHO";7180;521;1814;9515
2016;"PRESIDENTE MEDICI (RO)";"RO";"PRESIDENTE MEDICI";346;10;66;422
2016;"PRIMAVERA DE RONDONIA (RO)";"RO";"PRIMAVERA DE RONDONIA";47;3;15;65
2016;"RIO CRESPO (RO)";"RO";"RIO CRESPO";63;2;20;85
2016;"ROLIM DE MOURA (RO)";"RO";"ROLIM DE MOURA";1218;38;137;1393
2016;"SANTA LUZIA D OESTE (RO)";"RO";"SANTA LUZIA D OESTE";210;3;51;264
2016;"SAO FELIPE D OESTE (RO)";"RO";"SAO FELIPE D OESTE";90;4;28;122
2016;"SAO FRANCISCO DO GUAPORE (RO)";"RO";"SAO FRANCISCO DO GUAPORE";343;7;78;428
2016;"SAO MIGUEL DO GUAPORE (RO)";"RO";"SAO MIGUEL DO GUAPORE";294;12;71;377
2016;"SERINGUEIRAS (RO)";"RO";"SERINGUEIRAS";224;3;50;277
2016;"TEIXEIROPOLIS (RO)";"RO";"TEIXEIROPOLIS";55;1;14;70
2016;"THEOBROMA (RO)";"RO";"THEOBROMA";136;1;22;159
2016;"URUPA (RO)";"RO";"URUPA";119;4;99;222
2016;"VALE DO ANARI (RO)";"RO";"VALE DO ANARI";108;8;28;144
2016;"VALE DO PARAISO (RO)";"RO";"VALE DO PARAISO";98;1;23;122
2016;"VILHENA (RO)";"RO";"VILHENA";1691;77;177;1945
2016;"ALTO ALEGRE (RR)";"RR";"ALTO ALEGRE";67;12;15;94
2016;"AMAJARI (RR)";"RR";"AMAJARI";28;6;4;38
2016;"BOA VISTA (RR)";"RR";"BOA VISTA";3655;498;836;4989
2016;"BONFIM (RR)";"RR";"BONFIM";14;1;10;25
2016;"CANTA (RR)";"RR";"CANTA";61;10;13;84
2016;"CARACARAI (RR)";"RR";"CARACARAI";128;11;13;152
2016;"CAROEBE (RR)";"RR";"CAROEBE";55;8;31;94
2016;"IRACEMA (RR)";"RR";"IRACEMA";29;16;1;46
2016;"MUCAJAI (RR)";"RR";"MUCAJAI";123;44;46;213
2016;"NORMANDIA (RR)";"RR";"NORMANDIA";11;0;2;13
2016;"PACARAIMA (RR)";"RR";"PACARAIMA";183;5;9;197
2016;"RORAINOPOLIS (RR)";"RR";"RORAINOPOLIS";197;26;28;251
2016;"SAO JOAO DA BALIZA (RR)";"RR";"SAO JOAO DA BALIZA";50;6;7;63
2016;"SAO LUIZ (RR)";"RR";"SAO LUIZ";43;4;5;52
2016;"UIRAMUTA (RR)";"RR";"UIRAMUTA";2;0;0;2
2016;"ACEGUA (RS)";"RS";"ACEGUA";82;18;21;121
2016;"AGUA SANTA (RS)";"RS";"AGUA SANTA";199;14;21;234
2016;"AGUDO (RS)";"RS";"AGUDO";321;16;60;397
2016;"AJURICABA (RS)";"RS";"AJURICABA";448;22;27;497
2016;"ALECRIM (RS)";"RS";"ALECRIM";94;7;36;137
2016;"ALEGRETE (RS)";"RS";"ALEGRETE";1037;51;255;1343
2016;"ALEGRIA (RS)";"RS";"ALEGRIA";107;6;28;141
2016;"ALMIRANTE TAMANDARE DO SUL (RS)";"RS";"ALMIRANTE TAMANDARE DO SUL";110;12;4;126
2016;"ALPESTRE (RS)";"RS";"ALPESTRE";163;22;54;239
2016;"ALTO ALEGRE (RS)";"RS";"ALTO ALEGRE";114;6;9;129
2016;"ALTO FELIZ (RS)";"RS";"ALTO FELIZ";120;11;16;147
2016;"ALVORADA (RS)";"RS";"ALVORADA";1805;224;605;2634
2016;"AMARAL FERRADOR (RS)";"RS";"AMARAL FERRADOR";138;15;26;179
2016;"AMETISTA DO SUL (RS)";"RS";"AMETISTA DO SUL";87;6;56;149
2016;"ANDRE DA ROCHA (RS)";"RS";"ANDRE DA ROCHA";60;10;9;79
2016;"ANTA GORDA (RS)";"RS";"ANTA GORDA";272;24;24;320
2016;"ANTONIO PRADO (RS)";"RS";"ANTONIO PRADO";705;19;43;767
2016;"ARAMBARE (RS)";"RS";"ARAMBARE";92;6;16;114
2016;"ARARICA (RS)";"RS";"ARARICA";117;9;15;141
2016;"ARATIBA (RS)";"RS";"ARATIBA";195;36;37;268
2016;"ARROIO DO MEIO (RS)";"RS";"ARROIO DO MEIO";605;45;56;706
2016;"ARROIO DO PADRE (RS)";"RS";"ARROIO DO PADRE";117;3;16;136
2016;"ARROIO DO SAL (RS)";"RS";"ARROIO DO SAL";130;12;14;156
2016;"ARROIO DO TIGRE (RS)";"RS";"ARROIO DO TIGRE";317;26;45;388
2016;"ARROIO DOS RATOS (RS)";"RS";"ARROIO DOS RATOS";266;21;83;370
2016;"ARROIO GRANDE (RS)";"RS";"ARROIO GRANDE";297;23;72;392
2016;"ARVOREZINHA (RS)";"RS";"ARVOREZINHA";530;41;53;624
2016;"AUGUSTO PESTANA (RS)";"RS";"AUGUSTO PESTANA";504;15;39;558
2016;"AUREA (RS)";"RS";"AUREA";184;4;9;197
2016;"BAGE (RS)";"RS";"BAGE";1378;235;354;1967
2016;"BALNEARIO PINHAL (RS)";"RS";"BALNEARIO PINHAL";132;10;25;167
2016;"BARAO (RS)";"RS";"BARAO";202;26;52;280
2016;"BARAO DE COTEGIPE (RS)";"RS";"BARAO DE COTEGIPE";283;11;19;313
2016;"BARAO DO TRIUNFO (RS)";"RS";"BARAO DO TRIUNFO";135;17;57;209
2016;"BARRA DO GUARITA (RS)";"RS";"BARRA DO GUARITA";37;4;8;49
2016;"BARRA DO QUARAI (RS)";"RS";"BARRA DO QUARAI";35;4;15;54
2016;"BARRA DO RIBEIRO (RS)";"RS";"BARRA DO RIBEIRO";236;21;60;317
2016;"BARRA DO RIO AZUL (RS)";"RS";"BARRA DO RIO AZUL";37;11;13;61
2016;"BARRA FUNDA (RS)";"RS";"BARRA FUNDA";191;4;24;219
2016;"BARRACAO (RS)";"RS";"BARRACAO";172;8;22;202
2016;"BARROS CASSAL (RS)";"RS";"BARROS CASSAL";186;26;60;272
2016;"BENJAMIN CONSTANT DO SUL (RS)";"RS";"BENJAMIN CONSTANT DO SUL";29;5;19;53
2016;"BENTO GONCALVES (RS)";"RS";"BENTO GONCALVES";3367;289;376;4032
2016;"BOA VISTA DAS MISSOES (RS)";"RS";"BOA VISTA DAS MISSOES";110;4;13;127
2016;"BOA VISTA DO BURICA (RS)";"RS";"BOA VISTA DO BURICA";238;14;29;281
2016;"BOA VISTA DO CADEADO (RS)";"RS";"BOA VISTA DO CADEADO";140;2;20;162
2016;"BOA VISTA DO INCRA (RS)";"RS";"BOA VISTA DO INCRA";84;2;12;98
2016;"BOA VISTA DO SUL (RS)";"RS";"BOA VISTA DO SUL";343;9;15;367
2016;"BOM JESUS (RS)";"RS";"BOM JESUS";301;47;68;416
2016;"BOM PRINCIPIO (RS)";"RS";"BOM PRINCIPIO";506;35;39;580
2016;"BOM PROGRESSO (RS)";"RS";"BOM PROGRESSO";56;9;8;73
2016;"BOM RETIRO DO SUL (RS)";"RS";"BOM RETIRO DO SUL";211;13;54;278
2016;"BOQUEIRAO DO LEAO (RS)";"RS";"BOQUEIRAO DO LEAO";189;13;19;221
2016;"BOSSOROCA (RS)";"RS";"BOSSOROCA";222;6;23;251
2016;"BOZANO (RS)";"RS";"BOZANO";169;4;7;180
2016;"BRAGA (RS)";"RS";"BRAGA";92;5;21;118
2016;"BROCHIER (RS)";"RS";"BROCHIER";310;11;29;350
2016;"BUTIA (RS)";"RS";"BUTIA";476;47;158;681
2016;"CACAPAVA DO SUL (RS)";"RS";"CACAPAVA DO SUL";754;73;150;977
2016;"CACEQUI (RS)";"RS";"CACEQUI";164;20;25;209
2016;"CACHOEIRA DO SUL (RS)";"RS";"CACHOEIRA DO SUL";1384;131;247;1762
2016;"CACHOEIRINHA (RS)";"RS";"CACHOEIRINHA";2402;230;540;3172
2016;"CACIQUE DOBLE (RS)";"RS";"CACIQUE DOBLE";137;4;14;155
2016;"CAIBATE (RS)";"RS";"CAIBATE";155;8;7;170
2016;"CAICARA (RS)";"RS";"CAICARA";94;10;22;126
2016;"CAMAQUA (RS)";"RS";"CAMAQUA";1443;70;281;1794
2016;"CAMARGO (RS)";"RS";"CAMARGO";256;5;19;280
2016;"CAMBARA DO SUL (RS)";"RS";"CAMBARA DO SUL";260;16;41;317
2016;"CAMPESTRE DA SERRA (RS)";"RS";"CAMPESTRE DA SERRA";179;3;15;197
2016;"CAMPINA DAS MISSOES (RS)";"RS";"CAMPINA DAS MISSOES";176;9;35;220
2016;"CAMPINAS DO SUL (RS)";"RS";"CAMPINAS DO SUL";220;13;26;259
2016;"CAMPO BOM (RS)";"RS";"CAMPO BOM";861;106;95;1062
2016;"CAMPO NOVO (RS)";"RS";"CAMPO NOVO";188;17;34;239
2016;"CAMPOS BORGES (RS)";"RS";"CAMPOS BORGES";173;15;20;208
2016;"CANDELARIA (RS)";"RS";"CANDELARIA";483;31;115;629
2016;"CANDIDO GODOI (RS)";"RS";"CANDIDO GODOI";280;15;20;315
2016;"CANDIOTA (RS)";"RS";"CANDIOTA";163;39;59;261
2016;"CANELA (RS)";"RS";"CANELA";616;109;121;846
2016;"CANGUCU (RS)";"RS";"CANGUCU";1269;129;222;1620
2016;"CANOAS (RS)";"RS";"CANOAS";4769;541;1043;6353
2016;"CANUDOS DO VALE (RS)";"RS";"CANUDOS DO VALE";24;19;5;48
2016;"CAPAO BONITO DO SUL (RS)";"RS";"CAPAO BONITO DO SUL";57;3;5;65
2016;"CAPAO DA CANOA (RS)";"RS";"CAPAO DA CANOA";563;73;121;757
2016;"CAPAO DO CIPO (RS)";"RS";"CAPAO DO CIPO";130;5;12;147
2016;"CAPAO DO LEAO (RS)";"RS";"CAPAO DO LEAO";510;29;35;574
2016;"CAPELA DE SANTANA (RS)";"RS";"CAPELA DE SANTANA";225;13;25;263
2016;"CAPITAO (RS)";"RS";"CAPITAO";78;5;11;94
2016;"CAPIVARI DO SUL (RS)";"RS";"CAPIVARI DO SUL";169;12;10;191
2016;"CARAA (RS)";"RS";"CARAA";114;9;27;150
2016;"CARAZINHO (RS)";"RS";"CARAZINHO";1420;90;214;1724
2016;"CARLOS BARBOSA (RS)";"RS";"CARLOS BARBOSA";900;52;139;1091
2016;"CARLOS GOMES (RS)";"RS";"CARLOS GOMES";39;4;10;53
2016;"CASCA (RS)";"RS";"CASCA";428;21;43;492
2016;"CASEIROS (RS)";"RS";"CASEIROS";186;8;18;212
2016;"CATUIPE (RS)";"RS";"CATUIPE";414;9;38;461
2016;"CAXIAS DO SUL (RS)";"RS";"CAXIAS DO SUL";9360;1530;1785;12675
2016;"CENTENARIO (RS)";"RS";"CENTENARIO";121;7;12;140
2016;"CERRITO (RS)";"RS";"CERRITO";246;16;14;276
2016;"CERRO BRANCO (RS)";"RS";"CERRO BRANCO";73;9;21;103
2016;"CERRO GRANDE (RS)";"RS";"CERRO GRANDE";54;1;14;69
2016;"CERRO GRANDE DO SUL (RS)";"RS";"CERRO GRANDE DO SUL";310;19;27;356
2016;"CERRO LARGO (RS)";"RS";"CERRO LARGO";381;12;42;435
2016;"CHAPADA (RS)";"RS";"CHAPADA";415;43;33;491
2016;"CHARQUEADAS (RS)";"RS";"CHARQUEADAS";409;85;126;620
2016;"CHARRUA (RS)";"RS";"CHARRUA";105;5;10;120
2016;"CHIAPETTA (RS)";"RS";"CHIAPETTA";166;9;15;190
2016;"CHUI (RS)";"RS";"CHUI";127;13;8;148
2016;"CHUVISCA (RS)";"RS";"CHUVISCA";147;7;39;193
2016;"CIDREIRA (RS)";"RS";"CIDREIRA";105;16;40;161
2016;"CIRIACO (RS)";"RS";"CIRIACO";175;15;21;211
2016;"COLINAS (RS)";"RS";"COLINAS";69;10;9;88
2016;"COLORADO (RS)";"RS";"COLORADO";252;15;13;280
2016;"CONDOR (RS)";"RS";"CONDOR";297;16;34;347
2016;"CONSTANTINA (RS)";"RS";"CONSTANTINA";426;20;89;535
2016;"COQUEIRO BAIXO (RS)";"RS";"COQUEIRO BAIXO";20;4;5;29
2016;"COQUEIROS DO SUL (RS)";"RS";"COQUEIROS DO SUL";148;5;10;163
2016;"CORONEL BARROS (RS)";"RS";"CORONEL BARROS";129;0;9;138
2016;"CORONEL BICACO (RS)";"RS";"CORONEL BICACO";251;15;26;292
2016;"CORONEL PILAR (RS)";"RS";"CORONEL PILAR";218;11;7;236
2016;"COTIPORA (RS)";"RS";"COTIPORA";268;8;16;292
2016;"COXILHA (RS)";"RS";"COXILHA";135;5;15;155
2016;"CRISSIUMAL (RS)";"RS";"CRISSIUMAL";356;18;51;425
2016;"CRISTAL (RS)";"RS";"CRISTAL";258;12;59;329
2016;"CRISTAL DO SUL (RS)";"RS";"CRISTAL DO SUL";53;10;21;84
2016;"CRUZ ALTA (RS)";"RS";"CRUZ ALTA";1264;105;146;1515
2016;"CRUZALTENSE (RS)";"RS";"CRUZALTENSE";74;7;10;91
2016;"CRUZEIRO DO SUL (RS)";"RS";"CRUZEIRO DO SUL";482;14;21;517
2016;"DAVID CANABARRO (RS)";"RS";"DAVID CANABARRO";183;10;26;219
2016;"DERRUBADAS (RS)";"RS";"DERRUBADAS";116;8;15;139
2016;"DEZESSEIS DE NOVEMBRO (RS)";"RS";"DEZESSEIS DE NOVEMBRO";63;5;9;77
2016;"DILERMANDO DE AGUIAR (RS)";"RS";"DILERMANDO DE AGUIAR";50;2;29;81
2016;"DOIS IRMAOS (RS)";"RS";"DOIS IRMAOS";499;25;113;637
2016;"DOIS IRMAOS DAS MISSOES (RS)";"RS";"DOIS IRMAOS DAS MISSOES";75;7;7;89
2016;"DOIS LAJEADOS (RS)";"RS";"DOIS LAJEADOS";155;5;18;178
2016;"DOM FELICIANO (RS)";"RS";"DOM FELICIANO";257;17;89;363
2016;"DOM PEDRITO (RS)";"RS";"DOM PEDRITO";657;42;52;751
2016;"DOM PEDRO DE ALCANTARA (RS)";"RS";"DOM PEDRO DE ALCANTARA";120;4;6;130
2016;"DONA FRANCISCA (RS)";"RS";"DONA FRANCISCA";54;3;9;66
2016;"DOUTOR MAURICIO CARDOSO (RS)";"RS";"DOUTOR MAURICIO CARDOSO";226;17;20;263
2016;"DOUTOR RICARDO (RS)";"RS";"DOUTOR RICARDO";74;7;7;88
2016;"ELDORADO DO SUL (RS)";"RS";"ELDORADO DO SUL";805;46;63;914
2016;"ENCANTADO (RS)";"RS";"ENCANTADO";762;57;120;939
2016;"ENCRUZILHADA DO SUL (RS)";"RS";"ENCRUZILHADA DO SUL";452;30;208;690
2016;"ENGENHO VELHO (RS)";"RS";"ENGENHO VELHO";38;2;14;54
2016;"ENTRE IJUIS (RS)";"RS";"ENTRE IJUIS";412;11;28;451
2016;"ENTRE RIOS DO SUL (RS)";"RS";"ENTRE RIOS DO SUL";71;14;19;104
2016;"EREBANGO (RS)";"RS";"EREBANGO";131;3;4;138
2016;"ERECHIM (RS)";"RS";"ERECHIM";2206;341;530;3077
2016;"ERNESTINA (RS)";"RS";"ERNESTINA";180;21;18;219
2016;"ERVAL GRANDE (RS)";"RS";"ERVAL GRANDE";140;24;27;191
2016;"ERVAL SECO (RS)";"RS";"ERVAL SECO";170;6;40;216
2016;"ESMERALDA (RS)";"RS";"ESMERALDA";100;3;17;120
2016;"ESPERANCA DO SUL (RS)";"RS";"ESPERANCA DO SUL";67;3;16;86
2016;"ESPUMOSO (RS)";"RS";"ESPUMOSO";813;42;86;941
2016;"ESTACAO (RS)";"RS";"ESTACAO";243;12;23;278
2016;"ESTANCIA VELHA (RS)";"RS";"ESTANCIA VELHA";901;79;120;1100
2016;"ESTEIO (RS)";"RS";"ESTEIO";1095;137;300;1532
2016;"ESTRELA (RS)";"RS";"ESTRELA";1124;46;74;1244
2016;"ESTRELA VELHA (RS)";"RS";"ESTRELA VELHA";145;7;21;173
2016;"EUGENIO DE CASTRO (RS)";"RS";"EUGENIO DE CASTRO";110;10;13;133
2016;"FAGUNDES VARELA (RS)";"RS";"FAGUNDES VARELA";126;4;23;153
2016;"FARROUPILHA (RS)";"RS";"FARROUPILHA";2309;262;223;2794
2016;"FAXINAL DO SOTURNO (RS)";"RS";"FAXINAL DO SOTURNO";166;4;19;189
2016;"FAXINALZINHO (RS)";"RS";"FAXINALZINHO";61;7;13;81
2016;"FAZENDA VILANOVA (RS)";"RS";"FAZENDA VILANOVA";153;10;22;185
2016;"FELIZ (RS)";"RS";"FELIZ";470;34;93;597
2016;"FLORES DA CUNHA (RS)";"RS";"FLORES DA CUNHA";1602;78;139;1819
2016;"FLORIANO PEIXOTO (RS)";"RS";"FLORIANO PEIXOTO";76;10;20;106
2016;"FONTOURA XAVIER (RS)";"RS";"FONTOURA XAVIER";243;25;51;319
2016;"FORMIGUEIRO (RS)";"RS";"FORMIGUEIRO";194;2;26;222
2016;"FORQUETINHA (RS)";"RS";"FORQUETINHA";76;6;4;86
2016;"FORTALEZA DOS VALOS (RS)";"RS";"FORTALEZA DOS VALOS";284;5;21;310
2016;"FREDERICO WESTPHALEN (RS)";"RS";"FREDERICO WESTPHALEN";845;41;100;986
2016;"GARIBALDI (RS)";"RS";"GARIBALDI";1458;93;145;1696
2016;"GARRUCHOS (RS)";"RS";"GARRUCHOS";52;9;17;78
2016;"GAURAMA (RS)";"RS";"GAURAMA";243;26;23;292
2016;"GENERAL CAMARA (RS)";"RS";"GENERAL CAMARA";113;13;40;166
2016;"GENTIL (RS)";"RS";"GENTIL";111;8;17;136
2016;"GETULIO VARGAS (RS)";"RS";"GETULIO VARGAS";518;43;45;606
2016;"GIRUA (RS)";"RS";"GIRUA";609;49;51;709
2016;"GLORINHA (RS)";"RS";"GLORINHA";214;26;16;256
2016;"GRAMADO (RS)";"RS";"GRAMADO";742;164;157;1063
2016;"GRAMADO DOS LOUREIROS (RS)";"RS";"GRAMADO DOS LOUREIROS";46;5;13;64
2016;"GRAMADO XAVIER (RS)";"RS";"GRAMADO XAVIER";61;5;9;75
2016;"GRAVATAI (RS)";"RS";"GRAVATAI";3655;546;672;4873
2016;"GUABIJU (RS)";"RS";"GUABIJU";51;7;8;66
2016;"GUAIBA (RS)";"RS";"GUAIBA";1140;232;459;1831
2016;"GUAPORE (RS)";"RS";"GUAPORE";511;43;84;638
2016;"GUARANI DAS MISSOES (RS)";"RS";"GUARANI DAS MISSOES";284;7;32;323
2016;"HARMONIA (RS)";"RS";"HARMONIA";252;9;11;272
2016;"HERVAL (RS)";"RS";"HERVAL";130;16;15;161
2016;"HERVEIRAS (RS)";"RS";"HERVEIRAS";65;3;3;71
2016;"HORIZONTINA (RS)";"RS";"HORIZONTINA";415;36;64;515
2016;"HULHA NEGRA (RS)";"RS";"HULHA NEGRA";101;7;28;136
2016;"HUMAITA (RS)";"RS";"HUMAITA";172;10;10;192
2016;"IBARAMA (RS)";"RS";"IBARAMA";98;7;19;124
2016;"IBIACA (RS)";"RS";"IBIACA";306;12;30;348
2016;"IBIRAIARAS (RS)";"RS";"IBIRAIARAS";522;11;29;562
2016;"IBIRAPUITA (RS)";"RS";"IBIRAPUITA";155;13;52;220
2016;"IBIRUBA (RS)";"RS";"IBIRUBA";1048;58;100;1206
2016;"IGREJINHA (RS)";"RS";"IGREJINHA";500;39;93;632
2016;"IJUI (RS)";"RS";"IJUI";2017;158;140;2315
2016;"ILOPOLIS (RS)";"RS";"ILOPOLIS";239;12;15;266
2016;"IMBE (RS)";"RS";"IMBE";312;24;66;402
2016;"IMIGRANTE (RS)";"RS";"IMIGRANTE";108;17;19;144
2016;"INDEPENDENCIA (RS)";"RS";"INDEPENDENCIA";278;14;51;343
2016;"INHACORA (RS)";"RS";"INHACORA";74;6;8;88
2016;"IPE (RS)";"RS";"IPE";318;33;30;381
2016;"IPIRANGA DO SUL (RS)";"RS";"IPIRANGA DO SUL";139;8;16;163
2016;"IRAI (RS)";"RS";"IRAI";153;7;26;186
2016;"ITAARA (RS)";"RS";"ITAARA";134;7;22;163
2016;"ITACURUBI (RS)";"RS";"ITACURUBI";54;9;13;76
2016;"ITAPUCA (RS)";"RS";"ITAPUCA";66;4;10;80
2016;"ITAQUI (RS)";"RS";"ITAQUI";710;28;96;834
2016;"ITATI (RS)";"RS";"ITATI";79;4;10;93
2016;"ITATIBA DO SUL (RS)";"RS";"ITATIBA DO SUL";87;14;12;113
2016;"IVORA (RS)";"RS";"IVORA";84;5;7;96
2016;"IVOTI (RS)";"RS";"IVOTI";567;50;114;731
2016;"JABOTICABA (RS)";"RS";"JABOTICABA";99;5;27;131
2016;"JACUIZINHO (RS)";"RS";"JACUIZINHO";76;3;18;97
2016;"JACUTINGA (RS)";"RS";"JACUTINGA";131;13;10;154
2016;"JAGUARAO (RS)";"RS";"JAGUARAO";341;23;56;420
2016;"JAGUARI (RS)";"RS";"JAGUARI";326;26;64;416
2016;"JAQUIRANA (RS)";"RS";"JAQUIRANA";157;8;16;181
2016;"JARI (RS)";"RS";"JARI";99;6;15;120
2016;"JOIA (RS)";"RS";"JOIA";369;18;48;435
2016;"JULIO DE CASTILHOS (RS)";"RS";"JULIO DE CASTILHOS";701;27;72;800
2016;"LAGOA BONITA DO SUL (RS)";"RS";"LAGOA BONITA DO SUL";61;7;16;84
2016;"LAGOA DOS TRES CANTOS (RS)";"RS";"LAGOA DOS TRES CANTOS";113;7;5;125
2016;"LAGOA VERMELHA (RS)";"RS";"LAGOA VERMELHA";731;73;89;893
2016;"LAGOAO (RS)";"RS";"LAGOAO";103;9;43;155
2016;"LAJEADO (RS)";"RS";"LAJEADO";2284;172;284;2740
2016;"LAJEADO DO BUGRE (RS)";"RS";"LAJEADO DO BUGRE";33;4;14;51
2016;"LAVRAS DO SUL (RS)";"RS";"LAVRAS DO SUL";107;10;28;145
2016;"LIBERATO SALZANO (RS)";"RS";"LIBERATO SALZANO";149;6;32;187
2016;"LINDOLFO COLLOR (RS)";"RS";"LINDOLFO COLLOR";140;13;18;171
2016;"LINHA NOVA (RS)";"RS";"LINHA NOVA";84;10;5;99
2016;"MACAMBARA (RS)";"RS";"MACAMBARA";46;3;37;86
2016;"MACHADINHO (RS)";"RS";"MACHADINHO";146;11;29;186
2016;"MAMPITUBA (RS)";"RS";"MAMPITUBA";31;2;13;46
2016;"MANOEL VIANA (RS)";"RS";"MANOEL VIANA";186;8;17;211
2016;"MAQUINE (RS)";"RS";"MAQUINE";264;15;22;301
2016;"MARATA (RS)";"RS";"MARATA";133;11;24;168
2016;"MARAU (RS)";"RS";"MARAU";1217;104;202;1523
2016;"MARCELINO RAMOS (RS)";"RS";"MARCELINO RAMOS";129;22;30;181
2016;"MARIANA PIMENTEL (RS)";"RS";"MARIANA PIMENTEL";156;13;32;201
2016;"MARIANO MORO (RS)";"RS";"MARIANO MORO";79;15;11;105
2016;"MARQUES DE SOUZA (RS)";"RS";"MARQUES DE SOUZA";144;13;26;183
2016;"MATA (RS)";"RS";"MATA";118;8;23;149
2016;"MATO CASTELHANO (RS)";"RS";"MATO CASTELHANO";152;16;20;188
2016;"MATO LEITAO (RS)";"RS";"MATO LEITAO";150;11;11;172
2016;"MATO QUEIMADO (RS)";"RS";"MATO QUEIMADO";100;8;7;115
2016;"MAXIMILIANO DE ALMEIDA (RS)";"RS";"MAXIMILIANO DE ALMEIDA";152;17;73;242
2016;"MINAS DO LEAO (RS)";"RS";"MINAS DO LEAO";117;13;36;166
2016;"MIRAGUAI (RS)";"RS";"MIRAGUAI";120;4;30;154
2016;"MONTAURI (RS)";"RS";"MONTAURI";70;4;5;79
2016;"MONTE ALEGRE DOS CAMPOS (RS)";"RS";"MONTE ALEGRE DOS CAMPOS";98;4;27;129
2016;"MONTE BELO DO SUL (RS)";"RS";"MONTE BELO DO SUL";263;5;21;289
2016;"MONTENEGRO (RS)";"RS";"MONTENEGRO";1454;167;199;1820
2016;"MORMACO (RS)";"RS";"MORMACO";104;6;12;122
2016;"MORRINHOS DO SUL (RS)";"RS";"MORRINHOS DO SUL";161;2;8;171
2016;"MORRO REDONDO (RS)";"RS";"MORRO REDONDO";255;6;21;282
2016;"MORRO REUTER (RS)";"RS";"MORRO REUTER";202;12;22;236
2016;"MOSTARDAS (RS)";"RS";"MOSTARDAS";347;17;62;426
2016;"MUCUM (RS)";"RS";"MUCUM";93;12;19;124
2016;"MUITOS CAPOES (RS)";"RS";"MUITOS CAPOES";92;5;6;103
2016;"MULITERNO (RS)";"RS";"MULITERNO";113;4;11;128
2016;"NAO ME TOQUE (RS)";"RS";"NAO ME TOQUE";635;47;69;751
2016;"NICOLAU VERGUEIRO (RS)";"RS";"NICOLAU VERGUEIRO";113;6;17;136
2016;"NONOAI (RS)";"RS";"NONOAI";262;19;54;335
2016;"NOVA ALVORADA (RS)";"RS";"NOVA ALVORADA";198;7;18;223
2016;"NOVA ARACA (RS)";"RS";"NOVA ARACA";167;16;45;228
2016;"NOVA BASSANO (RS)";"RS";"NOVA BASSANO";547;36;73;656
2016;"NOVA BOA VISTA (RS)";"RS";"NOVA BOA VISTA";91;9;12;112
2016;"NOVA BRESCIA (RS)";"RS";"NOVA BRESCIA";142;11;12;165
2016;"NOVA CANDELARIA (RS)";"RS";"NOVA CANDELARIA";87;6;8;101
2016;"NOVA ESPERANCA DO SUL (RS)";"RS";"NOVA ESPERANCA DO SUL";99;13;34;146
2016;"NOVA HARTZ (RS)";"RS";"NOVA HARTZ";202;27;110;339
2016;"NOVA PADUA (RS)";"RS";"NOVA PADUA";348;3;5;356
2016;"NOVA PALMA (RS)";"RS";"NOVA PALMA";310;16;39;365
2016;"NOVA PETROPOLIS (RS)";"RS";"NOVA PETROPOLIS";578;40;73;691
2016;"NOVA PRATA (RS)";"RS";"NOVA PRATA";694;25;81;800
2016;"NOVA RAMADA (RS)";"RS";"NOVA RAMADA";135;10;11;156
2016;"NOVA ROMA DO SUL (RS)";"RS";"NOVA ROMA DO SUL";333;6;28;367
2016;"NOVA SANTA RITA (RS)";"RS";"NOVA SANTA RITA";1051;55;58;1164
2016;"NOVO BARREIRO (RS)";"RS";"NOVO BARREIRO";163;7;14;184
2016;"NOVO CABRAIS (RS)";"RS";"NOVO CABRAIS";112;4;9;125
2016;"NOVO HAMBURGO (RS)";"RS";"NOVO HAMBURGO";3295;340;523;4158
2016;"NOVO MACHADO (RS)";"RS";"NOVO MACHADO";201;20;15;236
2016;"NOVO TIRADENTES (RS)";"RS";"NOVO TIRADENTES";49;3;8;60
2016;"NOVO XINGU (RS)";"RS";"NOVO XINGU";52;10;10;72
2016;"OSORIO (RS)";"RS";"OSORIO";1004;68;119;1191
2016;"PAIM FILHO (RS)";"RS";"PAIM FILHO";143;5;27;175
2016;"PALMARES DO SUL (RS)";"RS";"PALMARES DO SUL";207;20;50;277
2016;"PALMEIRA DAS MISSOES (RS)";"RS";"PALMEIRA DAS MISSOES";1060;35;108;1203
2016;"PALMITINHO (RS)";"RS";"PALMITINHO";218;18;64;300
2016;"PANAMBI (RS)";"RS";"PANAMBI";1113;68;130;1311
2016;"PANTANO GRANDE (RS)";"RS";"PANTANO GRANDE";350;11;34;395
2016;"PARAI (RS)";"RS";"PARAI";577;11;19;607
2016;"PARAISO DO SUL (RS)";"RS";"PARAISO DO SUL";109;8;21;138
2016;"PARECI NOVO (RS)";"RS";"PARECI NOVO";445;9;18;472
2016;"PAROBE (RS)";"RS";"PAROBE";635;84;186;905
2016;"PASSA SETE (RS)";"RS";"PASSA SETE";103;5;36;144
2016;"PASSO DO SOBRADO (RS)";"RS";"PASSO DO SOBRADO";149;7;49;205
2016;"PASSO FUNDO (RS)";"RS";"PASSO FUNDO";3787;264;413;4464
2016;"PAULO BENTO (RS)";"RS";"PAULO BENTO";91;17;11;119
2016;"PAVERAMA (RS)";"RS";"PAVERAMA";217;44;48;309
2016;"PEDRAS ALTAS (RS)";"RS";"PEDRAS ALTAS";23;14;8;45
2016;"PEDRO OSORIO (RS)";"RS";"PEDRO OSORIO";124;12;34;170
2016;"PEJUCARA (RS)";"RS";"PEJUCARA";248;4;18;270
2016;"PELOTAS (RS)";"RS";"PELOTAS";5812;455;1293;7560
2016;"PICADA CAFE (RS)";"RS";"PICADA CAFE";116;24;59;199
2016;"PINHAL (RS)";"RS";"PINHAL";109;2;10;121
2016;"PINHAL DA SERRA (RS)";"RS";"PINHAL DA SERRA";63;10;21;94
2016;"PINHAL GRANDE (RS)";"RS";"PINHAL GRANDE";141;12;27;180
2016;"PINHEIRINHO DO VALE (RS)";"RS";"PINHEIRINHO DO VALE";61;4;23;88
2016;"PINHEIRO MACHADO (RS)";"RS";"PINHEIRO MACHADO";161;15;57;233
2016;"PINTO BANDEIRA (RS)";"RS";"PINTO BANDEIRA";101;11;5;117
2016;"PIRAPO (RS)";"RS";"PIRAPO";44;7;13;64
2016;"PIRATINI (RS)";"RS";"PIRATINI";305;50;140;495
2016;"PLANALTO (RS)";"RS";"PLANALTO";251;10;39;300
2016;"POCO DAS ANTAS (RS)";"RS";"POCO DAS ANTAS";114;10;17;141
2016;"PONTAO (RS)";"RS";"PONTAO";161;4;22;187
2016;"PONTE PRETA (RS)";"RS";"PONTE PRETA";80;7;13;100
2016;"PORTAO (RS)";"RS";"PORTAO";1630;115;128;1873
2016;"PORTO ALEGRE (RS)";"RS";"PORTO ALEGRE";16397;2397;5425;24219
2016;"PORTO LUCENA (RS)";"RS";"PORTO LUCENA";105;15;17;137
2016;"PORTO MAUA (RS)";"RS";"PORTO MAUA";66;5;7;78
2016;"PORTO VERA CRUZ (RS)";"RS";"PORTO VERA CRUZ";16;4;10;30
2016;"PORTO XAVIER (RS)";"RS";"PORTO XAVIER";199;25;47;271
2016;"POUSO NOVO (RS)";"RS";"POUSO NOVO";49;7;9;65
2016;"PRESIDENTE LUCENA (RS)";"RS";"PRESIDENTE LUCENA";184;7;16;207
2016;"PROGRESSO (RS)";"RS";"PROGRESSO";133;14;32;179
2016;"PROTASIO ALVES (RS)";"RS";"PROTASIO ALVES";50;6;8;64
2016;"PUTINGA (RS)";"RS";"PUTINGA";131;10;11;152
2016;"QUARAI (RS)";"RS";"QUARAI";227;29;60;316
2016;"QUATRO IRMAOS (RS)";"RS";"QUATRO IRMAOS";62;13;7;82
2016;"QUEVEDOS (RS)";"RS";"QUEVEDOS";54;9;10;73
2016;"QUINZE DE NOVEMBRO (RS)";"RS";"QUINZE DE NOVEMBRO";228;25;30;283
2016;"REDENTORA (RS)";"RS";"REDENTORA";123;19;20;162
2016;"RELVADO (RS)";"RS";"RELVADO";53;10;4;67
2016;"RESTINGA SECA (RS)";"RS";"RESTINGA SECA";362;15;58;435
2016;"RIO DOS INDIOS (RS)";"RS";"RIO DOS INDIOS";92;6;28;126
2016;"RIO GRANDE (RS)";"RS";"RIO GRANDE";2464;264;815;3543
2016;"RIO PARDO (RS)";"RS";"RIO PARDO";547;66;107;720
2016;"RIOZINHO (RS)";"RS";"RIOZINHO";56;14;28;98
2016;"ROCA SALES (RS)";"RS";"ROCA SALES";176;22;42;240
2016;"RODEIO BONITO (RS)";"RS";"RODEIO BONITO";183;8;32;223
2016;"ROLADOR (RS)";"RS";"ROLADOR";71;4;6;81
2016;"ROLANTE (RS)";"RS";"ROLANTE";302;33;104;439
2016;"RONDA ALTA (RS)";"RS";"RONDA ALTA";337;15;43;395
2016;"RONDINHA (RS)";"RS";"RONDINHA";200;11;22;233
2016;"ROQUE GONZALES (RS)";"RS";"ROQUE GONZALES";160;7;28;195
2016;"ROSARIO DO SUL (RS)";"RS";"ROSARIO DO SUL";567;58;105;730
2016;"SAGRADA FAMILIA (RS)";"RS";"SAGRADA FAMILIA";46;4;7;57
2016;"SALDANHA MARINHO (RS)";"RS";"SALDANHA MARINHO";176;10;7;193
2016;"SALTO DO JACUI (RS)";"RS";"SALTO DO JACUI";246;23;36;305
2016;"SALVADOR DAS MISSOES (RS)";"RS";"SALVADOR DAS MISSOES";129;4;7;140
2016;"SALVADOR DO SUL (RS)";"RS";"SALVADOR DO SUL";315;21;31;367
2016;"SANANDUVA (RS)";"RS";"SANANDUVA";743;35;82;860
2016;"SANTA BARBARA DO SUL (RS)";"RS";"SANTA BARBARA DO SUL";399;16;35;450
2016;"SANTA CECILIA DO SUL (RS)";"RS";"SANTA CECILIA DO SUL";82;4;16;102
2016;"SANTA CLARA DO SUL (RS)";"RS";"SANTA CLARA DO SUL";138;28;15;181
2016;"SANTA CRUZ DO SUL (RS)";"RS";"SANTA CRUZ DO SUL";2307;182;629;3118
2016;"SANTA MARGARIDA DO SUL (RS)";"RS";"SANTA MARGARIDA DO SUL";64;4;11;79
2016;"SANTA MARIA (RS)";"RS";"SANTA MARIA";3776;420;1084;5280
2016;"SANTA MARIA DO HERVAL (RS)";"RS";"SANTA MARIA DO HERVAL";258;29;55;342
2016;"SANTA ROSA (RS)";"RS";"SANTA ROSA";1756;102;218;2076
2016;"SANTA TEREZA (RS)";"RS";"SANTA TEREZA";102;6;5;113
2016;"SANTA VITORIA DO PALMAR (RS)";"RS";"SANTA VITORIA DO PALMAR";665;22;71;758
2016;"SANTANA DA BOA VISTA (RS)";"RS";"SANTANA DA BOA VISTA";94;19;48;161
2016;"SANTANA DO LIVRAMENTO (RS)";"RS";"SANTANA DO LIVRAMENTO";892;114;240;1246
2016;"SANTIAGO (RS)";"RS";"SANTIAGO";982;119;106;1207
2016;"SANTO ANGELO (RS)";"RS";"SANTO ANGELO";1430;99;129;1658
2016;"SANTO ANTONIO DA PATRULHA (RS)";"RS";"SANTO ANTONIO DA PATRULHA";1036;63;197;1296
2016;"SANTO ANTONIO DAS MISSOES (RS)";"RS";"SANTO ANTONIO DAS MISSOES";268;56;54;378
2016;"SANTO ANTONIO DO PALMA (RS)";"RS";"SANTO ANTONIO DO PALMA";71;4;13;88
2016;"SANTO ANTONIO DO PLANALTO (RS)";"RS";"SANTO ANTONIO DO PLANALTO";106;4;9;119
2016;"SANTO AUGUSTO (RS)";"RS";"SANTO AUGUSTO";586;47;33;666
2016;"SANTO CRISTO (RS)";"RS";"SANTO CRISTO";562;25;55;642
2016;"SANTO EXPEDITO DO SUL (RS)";"RS";"SANTO EXPEDITO DO SUL";117;2;13;132
2016;"SAO BORJA (RS)";"RS";"SAO BORJA";1178;69;120;1367
2016;"SAO DOMINGOS DO SUL (RS)";"RS";"SAO DOMINGOS DO SUL";120;9;16;145
2016;"SAO FRANCISCO DE ASSIS (RS)";"RS";"SAO FRANCISCO DE ASSIS";374;42;128;544
2016;"SAO FRANCISCO DE PAULA (RS)";"RS";"SAO FRANCISCO DE PAULA";600;46;84;730
2016;"SAO GABRIEL (RS)";"RS";"SAO GABRIEL";972;47;135;1154
2016;"SAO JERONIMO (RS)";"RS";"SAO JERONIMO";346;34;117;497
2016;"SAO JOAO DA URTIGA (RS)";"RS";"SAO JOAO DA URTIGA";176;7;22;205
2016;"SAO JOAO DO POLESINE (RS)";"RS";"SAO JOAO DO POLESINE";93;1;7;101
2016;"SAO JORGE (RS)";"RS";"SAO JORGE";155;8;19;182
2016;"SAO JOSE DAS MISSOES (RS)";"RS";"SAO JOSE DAS MISSOES";47;5;10;62
2016;"SAO JOSE DO HERVAL (RS)";"RS";"SAO JOSE DO HERVAL";87;3;13;103
2016;"SAO JOSE DO HORTENCIO (RS)";"RS";"SAO JOSE DO HORTENCIO";207;11;33;251
2016;"SAO JOSE DO INHACORA (RS)";"RS";"SAO JOSE DO INHACORA";56;5;8;69
2016;"SAO JOSE DO NORTE (RS)";"RS";"SAO JOSE DO NORTE";434;16;122;572
2016;"SAO JOSE DO OURO (RS)";"RS";"SAO JOSE DO OURO";366;7;44;417
2016;"SAO JOSE DO SUL (RS)";"RS";"SAO JOSE DO SUL";152;7;14;173
2016;"SAO JOSE DOS AUSENTES (RS)";"RS";"SAO JOSE DOS AUSENTES";133;8;22;163
2016;"SAO LEOPOLDO (RS)";"RS";"SAO LEOPOLDO";2322;296;391;3009
2016;"SAO LOURENCO DO SUL (RS)";"RS";"SAO LOURENCO DO SUL";1058;56;153;1267
2016;"SAO LUIZ GONZAGA (RS)";"RS";"SAO LUIZ GONZAGA";709;76;97;882
2016;"SAO MARCOS (RS)";"RS";"SAO MARCOS";805;30;131;966
2016;"SAO MARTINHO (RS)";"RS";"SAO MARTINHO";256;12;22;290
2016;"SAO MARTINHO DA SERRA (RS)";"RS";"SAO MARTINHO DA SERRA";62;5;7;74
2016;"SAO MIGUEL DAS MISSOES (RS)";"RS";"SAO MIGUEL DAS MISSOES";284;27;41;352
2016;"SAO NICOLAU (RS)";"RS";"SAO NICOLAU";87;11;15;113
2016;"SAO PAULO DAS MISSOES (RS)";"RS";"SAO PAULO DAS MISSOES";123;7;32;162
2016;"SAO PEDRO DA SERRA (RS)";"RS";"SAO PEDRO DA SERRA";114;11;18;143
2016;"SAO PEDRO DAS MISSOES (RS)";"RS";"SAO PEDRO DAS MISSOES";46;7;7;60
2016;"SAO PEDRO DO BUTIA (RS)";"RS";"SAO PEDRO DO BUTIA";144;2;17;163
2016;"SAO PEDRO DO SUL (RS)";"RS";"SAO PEDRO DO SUL";331;52;49;432
2016;"SAO SEBASTIAO DO CAI (RS)";"RS";"SAO SEBASTIAO DO CAI";810;35;67;912
2016;"SAO SEPE (RS)";"RS";"SAO SEPE";513;53;121;687
2016;"SAO VALENTIM (RS)";"RS";"SAO VALENTIM";73;14;14;101
2016;"SAO VALENTIM DO SUL (RS)";"RS";"SAO VALENTIM DO SUL";84;7;10;101
2016;"SAO VALERIO DO SUL (RS)";"RS";"SAO VALERIO DO SUL";45;3;8;56
2016;"SAO VENDELINO (RS)";"RS";"SAO VENDELINO";88;13;12;113
2016;"SAO VICENTE DO SUL (RS)";"RS";"SAO VICENTE DO SUL";157;9;55;221
2016;"SAPIRANGA (RS)";"RS";"SAPIRANGA";957;104;185;1246
2016;"SAPUCAIA DO SUL (RS)";"RS";"SAPUCAIA DO SUL";1786;149;141;2076
2016;"SARANDI (RS)";"RS";"SARANDI";650;36;71;757
2016;"SEBERI (RS)";"RS";"SEBERI";359;13;54;426
2016;"SEDE NOVA (RS)";"RS";"SEDE NOVA";113;11;15;139
2016;"SEGREDO (RS)";"RS";"SEGREDO";208;6;50;264
2016;"SELBACH (RS)";"RS";"SELBACH";357;15;23;395
2016;"SENADOR SALGADO FILHO (RS)";"RS";"SENADOR SALGADO FILHO";153;10;13;176
2016;"SENTINELA DO SUL (RS)";"RS";"SENTINELA DO SUL";178;2;17;197
2016;"SERAFINA CORREA (RS)";"RS";"SERAFINA CORREA";394;47;74;515
2016;"SERIO (RS)";"RS";"SERIO";62;4;6;72
2016;"SERTAO (RS)";"RS";"SERTAO";289;19;45;353
2016;"SERTAO SANTANA (RS)";"RS";"SERTAO SANTANA";172;4;29;205
2016;"SETE DE SETEMBRO (RS)";"RS";"SETE DE SETEMBRO";86;5;12;103
2016;"SEVERIANO DE ALMEIDA (RS)";"RS";"SEVERIANO DE ALMEIDA";118;15;13;146
2016;"SILVEIRA MARTINS (RS)";"RS";"SILVEIRA MARTINS";138;2;10;150
2016;"SINIMBU (RS)";"RS";"SINIMBU";144;4;8;156
2016;"SOBRADINHO (RS)";"RS";"SOBRADINHO";343;15;54;412
2016;"SOLEDADE (RS)";"RS";"SOLEDADE";683;48;141;872
2016;"TABAI (RS)";"RS";"TABAI";217;17;16;250
2016;"TAPEJARA (RS)";"RS";"TAPEJARA";857;37;122;1016
2016;"TAPERA (RS)";"RS";"TAPERA";441;32;33;506
2016;"TAPES (RS)";"RS";"TAPES";303;22;35;360
2016;"TAQUARA (RS)";"RS";"TAQUARA";873;61;277;1211
2016;"TAQUARI (RS)";"RS";"TAQUARI";478;44;170;692
2016;"TAQUARUCU DO SUL (RS)";"RS";"TAQUARUCU DO SUL";79;3;13;95
2016;"TAVARES (RS)";"RS";"TAVARES";156;17;23;196
2016;"TENENTE PORTELA (RS)";"RS";"TENENTE PORTELA";332;18;58;408
2016;"TERRA DE AREIA (RS)";"RS";"TERRA DE AREIA";346;14;33;393
2016;"TEUTONIA (RS)";"RS";"TEUTONIA";772;35;109;916
2016;"TIO HUGO (RS)";"RS";"TIO HUGO";143;6;15;164
2016;"TIRADENTES DO SUL (RS)";"RS";"TIRADENTES DO SUL";133;5;13;151
2016;"TOROPI (RS)";"RS";"TOROPI";66;10;20;96
2016;"TORRES (RS)";"RS";"TORRES";494;29;97;620
2016;"TRAMANDAI (RS)";"RS";"TRAMANDAI";718;90;150;958
2016;"TRAVESSEIRO (RS)";"RS";"TRAVESSEIRO";45;11;12;68
2016;"TRES ARROIOS (RS)";"RS";"TRES ARROIOS";120;11;5;136
2016;"TRES CACHOEIRAS (RS)";"RS";"TRES CACHOEIRAS";638;15;29;682
2016;"TRES COROAS (RS)";"RS";"TRES COROAS";297;40;81;418
2016;"TRES DE MAIO (RS)";"RS";"TRES DE MAIO";786;45;88;919
2016;"TRES FORQUILHAS (RS)";"RS";"TRES FORQUILHAS";100;2;7;109
2016;"TRES PALMEIRAS (RS)";"RS";"TRES PALMEIRAS";92;5;35;132
2016;"TRES PASSOS (RS)";"RS";"TRES PASSOS";532;32;137;701
2016;"TRINDADE DO SUL (RS)";"RS";"TRINDADE DO SUL";144;21;22;187
2016;"TRIUNFO (RS)";"RS";"TRIUNFO";609;136;285;1030
2016;"TUCUNDUVA (RS)";"RS";"TUCUNDUVA";277;14;15;306
2016;"TUNAS (RS)";"RS";"TUNAS";60;6;20;86
2016;"TUPANCI DO SUL (RS)";"RS";"TUPANCI DO SUL";66;3;16;85
2016;"TUPANCIRETA (RS)";"RS";"TUPANCIRETA";670;83;69;822
2016;"TUPANDI (RS)";"RS";"TUPANDI";113;38;42;193
2016;"TUPARENDI (RS)";"RS";"TUPARENDI";326;15;32;373
2016;"TURUCU (RS)";"RS";"TURUCU";119;8;12;139
2016;"UBIRETAMA (RS)";"RS";"UBIRETAMA";102;11;5;118
2016;"UNIAO DA SERRA (RS)";"RS";"UNIAO DA SERRA";59;5;9;73
2016;"UNISTALDA (RS)";"RS";"UNISTALDA";54;12;20;86
2016;"URUGUAIANA (RS)";"RS";"URUGUAIANA";1931;106;191;2228
2016;"VACARIA (RS)";"RS";"VACARIA";1828;191;557;2576
2016;"VALE DO SOL (RS)";"RS";"VALE DO SOL";209;11;52;272
2016;"VALE REAL (RS)";"RS";"VALE REAL";227;13;11;251
2016;"VALE VERDE (RS)";"RS";"VALE VERDE";67;5;10;82
2016;"VANINI (RS)";"RS";"VANINI";107;10;14;131
2016;"VENANCIO AIRES (RS)";"RS";"VENANCIO AIRES";1245;118;203;1566
2016;"VERA CRUZ (RS)";"RS";"VERA CRUZ";471;44;141;656
2016;"VERANOPOLIS (RS)";"RS";"VERANOPOLIS";963;44;72;1079
2016;"VESPASIANO CORREA (RS)";"RS";"VESPASIANO CORREA";116;11;11;138
2016;"VIADUTOS (RS)";"RS";"VIADUTOS";160;12;24;196
2016;"VIAMAO (RS)";"RS";"VIAMAO";2399;386;673;3458
2016;"VICENTE DUTRA (RS)";"RS";"VICENTE DUTRA";67;2;18;87
2016;"VICTOR GRAEFF (RS)";"RS";"VICTOR GRAEFF";181;16;8;205
2016;"VILA FLORES (RS)";"RS";"VILA FLORES";199;17;17;233
2016;"VILA LANGARO (RS)";"RS";"VILA LANGARO";121;6;15;142
2016;"VILA MARIA (RS)";"RS";"VILA MARIA";297;8;42;347
2016;"VILA NOVA DO SUL (RS)";"RS";"VILA NOVA DO SUL";114;11;15;140
2016;"VISTA ALEGRE (RS)";"RS";"VISTA ALEGRE";85;6;10;101
2016;"VISTA ALEGRE DO PRATA (RS)";"RS";"VISTA ALEGRE DO PRATA";47;10;4;61
2016;"VISTA GAUCHA (RS)";"RS";"VISTA GAUCHA";70;1;13;84
2016;"VITORIA DAS MISSOES (RS)";"RS";"VITORIA DAS MISSOES";136;2;18;156
2016;"WESTFALIA (RS)";"RS";"WESTFALIA";157;15;16;188
2016;"XANGRI LA (RS)";"RS";"XANGRI LA";227;14;19;260
2016;"ABDON BATISTA (SC)";"SC";"ABDON BATISTA";83;6;12;101
2016;"ABELARDO LUZ (SC)";"SC";"ABELARDO LUZ";448;25;112;585
2016;"AGROLANDIA (SC)";"SC";"AGROLANDIA";255;18;19;292
2016;"AGRONOMICA (SC)";"SC";"AGRONOMICA";162;6;12;180
2016;"AGUA DOCE (SC)";"SC";"AGUA DOCE";235;30;28;293
2016;"AGUAS DE CHAPECO (SC)";"SC";"AGUAS DE CHAPECO";86;9;35;130
2016;"AGUAS FRIAS (SC)";"SC";"AGUAS FRIAS";63;5;6;74
2016;"AGUAS MORNAS (SC)";"SC";"AGUAS MORNAS";312;5;18;335
2016;"ALFREDO WAGNER (SC)";"SC";"ALFREDO WAGNER";322;22;18;362
2016;"ALTO BELA VISTA (SC)";"SC";"ALTO BELA VISTA";64;11;8;83
2016;"ANCHIETA (SC)";"SC";"ANCHIETA";230;14;25;269
2016;"ANGELINA (SC)";"SC";"ANGELINA";252;19;17;288
2016;"ANITA GARIBALDI (SC)";"SC";"ANITA GARIBALDI";145;14;33;192
2016;"ANITAPOLIS (SC)";"SC";"ANITAPOLIS";135;6;14;155
2016;"ANTONIO CARLOS (SC)";"SC";"ANTONIO CARLOS";686;5;12;703
2016;"APIUNA (SC)";"SC";"APIUNA";204;29;21;254
2016;"ARABUTA (SC)";"SC";"ARABUTA";140;11;35;186
2016;"ARAQUARI (SC)";"SC";"ARAQUARI";819;68;63;950
2016;"ARARANGUA (SC)";"SC";"ARARANGUA";1411;74;174;1659
2016;"ARMAZEM (SC)";"SC";"ARMAZEM";284;16;19;319
2016;"ARROIO TRINTA (SC)";"SC";"ARROIO TRINTA";186;12;22;220
2016;"ARVOREDO (SC)";"SC";"ARVOREDO";51;20;5;76
2016;"ASCURRA (SC)";"SC";"ASCURRA";256;21;38;315
2016;"ATALANTA (SC)";"SC";"ATALANTA";99;1;7;107
2016;"AURORA (SC)";"SC";"AURORA";206;5;20;231
2016;"BALNEARIO ARROIO DO SILVA (SC)";"SC";"BALNEARIO ARROIO DO SILVA";144;8;16;168
2016;"BALNEARIO BARRA DO SUL (SC)";"SC";"BALNEARIO BARRA DO SUL";169;14;8;191
2016;"BALNEARIO CAMBORIU (SC)";"SC";"BALNEARIO CAMBORIU";969;284;317;1570
2016;"BALNEARIO DE PICARRAS (SC)";"SC";"BALNEARIO DE PICARRAS";331;47;56;434
2016;"BALNEARIO GAIVOTA (SC)";"SC";"BALNEARIO GAIVOTA";208;12;25;245
2016;"BALNEARIO RINCAO (SC)";"SC";"BALNEARIO RINCAO";101;11;6;118
2016;"BANDEIRANTE (SC)";"SC";"BANDEIRANTE";54;6;16;76
2016;"BARRA BONITA (SC)";"SC";"BARRA BONITA";39;6;10;55
2016;"BARRA VELHA (SC)";"SC";"BARRA VELHA";520;44;48;612
2016;"BELA VISTA DO TOLDO (SC)";"SC";"BELA VISTA DO TOLDO";105;7;41;153
2016;"BELMONTE (SC)";"SC";"BELMONTE";79;9;6;94
2016;"BENEDITO NOVO (SC)";"SC";"BENEDITO NOVO";310;46;30;386
2016;"BIGUACU (SC)";"SC";"BIGUACU";1402;90;138;1630
2016;"BLUMENAU (SC)";"SC";"BLUMENAU";5496;469;764;6729
2016;"BOCAINA DO SUL (SC)";"SC";"BOCAINA DO SUL";60;3;15;78
2016;"BOM JARDIM DA SERRA (SC)";"SC";"BOM JARDIM DA SERRA";164;13;27;204
2016;"BOM JESUS (SC)";"SC";"BOM JESUS";75;3;7;85
2016;"BOM JESUS DO OESTE (SC)";"SC";"BOM JESUS DO OESTE";69;5;10;84
2016;"BOM RETIRO (SC)";"SC";"BOM RETIRO";221;16;40;277
2016;"BOMBINHAS (SC)";"SC";"BOMBINHAS";194;59;28;281
2016;"BOTUVERA (SC)";"SC";"BOTUVERA";221;7;14;242
2016;"BRACO DO NORTE (SC)";"SC";"BRACO DO NORTE";1239;63;74;1376
2016;"BRACO DO TROMBUDO (SC)";"SC";"BRACO DO TROMBUDO";143;7;9;159
2016;"BRUNOPOLIS (SC)";"SC";"BRUNOPOLIS";109;6;12;127
2016;"BRUSQUE (SC)";"SC";"BRUSQUE";2559;170;178;2907
2016;"CACADOR (SC)";"SC";"CACADOR";2186;133;787;3106
2016;"CAIBI (SC)";"SC";"CAIBI";180;9;26;215
2016;"CALMON (SC)";"SC";"CALMON";41;13;27;81
2016;"CAMBORIU (SC)";"SC";"CAMBORIU";1184;62;39;1285
2016;"CAMPO ALEGRE (SC)";"SC";"CAMPO ALEGRE";446;18;16;480
2016;"CAMPO BELO DO SUL (SC)";"SC";"CAMPO BELO DO SUL";216;16;47;279
2016;"CAMPO ERE (SC)";"SC";"CAMPO ERE";327;13;34;374
2016;"CAMPOS NOVOS (SC)";"SC";"CAMPOS NOVOS";1104;108;117;1329
2016;"CANELINHA (SC)";"SC";"CANELINHA";522;17;11;550
2016;"CANOINHAS (SC)";"SC";"CANOINHAS";1376;79;157;1612
2016;"CAPAO ALTO (SC)";"SC";"CAPAO ALTO";74;10;17;101
2016;"CAPINZAL (SC)";"SC";"CAPINZAL";499;50;61;610
2016;"CAPIVARI DE BAIXO (SC)";"SC";"CAPIVARI DE BAIXO";367;19;28;414
2016;"CATANDUVAS (SC)";"SC";"CATANDUVAS";399;27;40;466
2016;"CAXAMBU DO SUL (SC)";"SC";"CAXAMBU DO SUL";121;2;20;143
2016;"CELSO RAMOS (SC)";"SC";"CELSO RAMOS";84;9;6;99
2016;"CERRO NEGRO (SC)";"SC";"CERRO NEGRO";79;8;19;106
2016;"CHAPADAO DO LAGEADO (SC)";"SC";"CHAPADAO DO LAGEADO";49;5;11;65
2016;"CHAPECO (SC)";"SC";"CHAPECO";4546;340;445;5331
2016;"COCAL DO SUL (SC)";"SC";"COCAL DO SUL";329;21;24;374
2016;"CONCORDIA (SC)";"SC";"CONCORDIA";2687;149;270;3106
2016;"CORDILHEIRA ALTA (SC)";"SC";"CORDILHEIRA ALTA";328;24;17;369
2016;"CORONEL FREITAS (SC)";"SC";"CORONEL FREITAS";290;13;25;328
2016;"CORONEL MARTINS (SC)";"SC";"CORONEL MARTINS";59;9;19;87
2016;"CORREIA PINTO (SC)";"SC";"CORREIA PINTO";422;50;71;543
2016;"CORUPA (SC)";"SC";"CORUPA";442;6;38;486
2016;"CRICIUMA (SC)";"SC";"CRICIUMA";3562;348;438;4348
2016;"CUNHA PORA (SC)";"SC";"CUNHA PORA";436;17;62;515
2016;"CUNHATAI (SC)";"SC";"CUNHATAI";46;3;9;58
2016;"CURITIBANOS (SC)";"SC";"CURITIBANOS";1028;92;143;1263
2016;"DESCANSO (SC)";"SC";"DESCANSO";237;17;29;283
2016;"DIONISIO CERQUEIRA (SC)";"SC";"DIONISIO CERQUEIRA";199;25;20;244
2016;"DONA EMMA (SC)";"SC";"DONA EMMA";133;17;10;160
2016;"DOUTOR PEDRINHO (SC)";"SC";"DOUTOR PEDRINHO";132;6;4;142
2016;"ENTRE RIOS (SC)";"SC";"ENTRE RIOS";37;3;31;71
2016;"ERMO (SC)";"SC";"ERMO";89;3;8;100
2016;"ERVAL VELHO (SC)";"SC";"ERVAL VELHO";124;6;24;154
2016;"FAXINAL DOS GUEDES (SC)";"SC";"FAXINAL DOS GUEDES";422;23;39;484
2016;"FLOR DO SERTAO (SC)";"SC";"FLOR DO SERTAO";31;9;17;57
2016;"FLORIANOPOLIS (SC)";"SC";"FLORIANOPOLIS";3814;982;2004;6800
2016;"FORMOSA DO SUL (SC)";"SC";"FORMOSA DO SUL";65;6;16;87
2016;"FORQUILHINHA (SC)";"SC";"FORQUILHINHA";604;25;43;672
2016;"FRAIBURGO (SC)";"SC";"FRAIBURGO";910;52;220;1182
2016;"FREI ROGERIO (SC)";"SC";"FREI ROGERIO";90;11;18;119
2016;"GALVAO (SC)";"SC";"GALVAO";104;6;15;125
2016;"GAROPABA (SC)";"SC";"GAROPABA";295;34;41;370
2016;"GARUVA (SC)";"SC";"GARUVA";586;34;48;668
2016;"GASPAR (SC)";"SC";"GASPAR";1381;72;80;1533
2016;"GOVERNADOR CELSO RAMOS (SC)";"SC";"GOVERNADOR CELSO RAMOS";173;24;15;212
2016;"GRAO PARA (SC)";"SC";"GRAO PARA";270;7;12;289
2016;"GRAVATAL (SC)";"SC";"GRAVATAL";313;21;19;353
2016;"GUABIRUBA (SC)";"SC";"GUABIRUBA";326;20;22;368
2016;"GUARACIABA (SC)";"SC";"GUARACIABA";259;15;43;317
2016;"GUARAMIRIM (SC)";"SC";"GUARAMIRIM";1072;34;31;1137
2016;"GUARUJA DO SUL (SC)";"SC";"GUARUJA DO SUL";166;11;22;199
2016;"GUATAMBU (SC)";"SC";"GUATAMBU";126;14;23;163
2016;"HERVAL D OESTE (SC)";"SC";"HERVAL D OESTE";367;39;70;476
2016;"IBIAM (SC)";"SC";"IBIAM";74;6;14;94
2016;"IBICARE (SC)";"SC";"IBICARE";152;11;10;173
2016;"IBIRAMA (SC)";"SC";"IBIRAMA";538;67;84;689
2016;"ICARA (SC)";"SC";"ICARA";1887;101;143;2131
2016;"ILHOTA (SC)";"SC";"ILHOTA";381;26;24;431
2016;"IMARUI (SC)";"SC";"IMARUI";174;27;32;233
2016;"IMBITUBA (SC)";"SC";"IMBITUBA";689;80;104;873
2016;"IMBUIA (SC)";"SC";"IMBUIA";190;9;23;222
2016;"INDAIAL (SC)";"SC";"INDAIAL";1582;93;136;1811
2016;"IOMERE (SC)";"SC";"IOMERE";159;5;10;174
2016;"IPIRA (SC)";"SC";"IPIRA";142;8;23;173
2016;"IPORA DO OESTE (SC)";"SC";"IPORA DO OESTE";265;24;53;342
2016;"IPUACU (SC)";"SC";"IPUACU";116;11;36;163
2016;"IPUMIRIM (SC)";"SC";"IPUMIRIM";289;43;31;363
2016;"IRACEMINHA (SC)";"SC";"IRACEMINHA";112;6;25;143
2016;"IRANI (SC)";"SC";"IRANI";367;28;59;454
2016;"IRATI (SC)";"SC";"IRATI";33;4;8;45
2016;"IRINEOPOLIS (SC)";"SC";"IRINEOPOLIS";294;16;17;327
2016;"ITA (SC)";"SC";"ITA";113;16;41;170
2016;"ITAIOPOLIS (SC)";"SC";"ITAIOPOLIS";667;31;98;796
2016;"ITAJAI (SC)";"SC";"ITAJAI";4522;302;415;5239
2016;"ITAPEMA (SC)";"SC";"ITAPEMA";633;67;51;751
2016;"ITAPIRANGA (SC)";"SC";"ITAPIRANGA";347;25;73;445
2016;"ITAPOA (SC)";"SC";"ITAPOA";257;21;18;296
2016;"ITUPORANGA (SC)";"SC";"ITUPORANGA";699;39;67;805
2016;"JABORA (SC)";"SC";"JABORA";143;16;27;186
2016;"JACINTO MACHADO (SC)";"SC";"JACINTO MACHADO";450;16;39;505
2016;"JAGUARUNA (SC)";"SC";"JAGUARUNA";492;28;62;582
2016;"JARAGUA DO SUL (SC)";"SC";"JARAGUA DO SUL";2633;244;414;3291
2016;"JARDINOPOLIS (SC)";"SC";"JARDINOPOLIS";21;5;6;32
2016;"JOACABA (SC)";"SC";"JOACABA";883;64;48;995
2016;"JOINVILLE (SC)";"SC";"JOINVILLE";8418;761;865;10044
2016;"JOSE BOITEUX (SC)";"SC";"JOSE BOITEUX";125;24;9;158
2016;"JUPIA (SC)";"SC";"JUPIA";54;3;8;65
2016;"LACERDOPOLIS (SC)";"SC";"LACERDOPOLIS";117;5;6;128
2016;"LAGEADO GRANDE (SC)";"SC";"LAGEADO GRANDE";38;1;5;44
2016;"LAGES (SC)";"SC";"LAGES";3475;290;401;4166
2016;"LAGUNA (SC)";"SC";"LAGUNA";586;123;104;813
2016;"LAURENTINO (SC)";"SC";"LAURENTINO";325;6;9;340
2016;"LAURO MULLER (SC)";"SC";"LAURO MULLER";480;27;53;560
2016;"LEBON REGIS (SC)";"SC";"LEBON REGIS";271;28;54;353
2016;"LEOBERTO LEAL (SC)";"SC";"LEOBERTO LEAL";114;12;5;131
2016;"LINDOIA DO SUL (SC)";"SC";"LINDOIA DO SUL";155;12;44;211
2016;"LONTRAS (SC)";"SC";"LONTRAS";354;23;42;419
2016;"LUIZ ALVES (SC)";"SC";"LUIZ ALVES";484;10;26;520
2016;"LUZERNA (SC)";"SC";"LUZERNA";155;12;25;192
2016;"MACIEIRA (SC)";"SC";"MACIEIRA";89;6;16;111
2016;"MAFRA (SC)";"SC";"MAFRA";1504;104;149;1757
2016;"MAJOR GERCINO (SC)";"SC";"MAJOR GERCINO";141;6;12;159
2016;"MAJOR VIEIRA (SC)";"SC";"MAJOR VIEIRA";221;5;16;242
2016;"MARACAJA (SC)";"SC";"MARACAJA";243;3;15;261
2016;"MARAVILHA (SC)";"SC";"MARAVILHA";851;40;73;964
2016;"MAREMA (SC)";"SC";"MAREMA";71;6;8;85
2016;"MASSARANDUBA (SC)";"SC";"MASSARANDUBA";552;28;43;623
2016;"MATOS COSTA (SC)";"SC";"MATOS COSTA";50;7;16;73
2016;"MELEIRO (SC)";"SC";"MELEIRO";290;8;23;321
2016;"MIRIM DOCE (SC)";"SC";"MIRIM DOCE";65;3;10;78
2016;"MODELO (SC)";"SC";"MODELO";130;8;11;149
2016;"MONDAI (SC)";"SC";"MONDAI";192;15;60;267
2016;"MONTE CARLO (SC)";"SC";"MONTE CARLO";167;20;104;291
2016;"MONTE CASTELO (SC)";"SC";"MONTE CASTELO";195;16;23;234
2016;"MORRO DA FUMACA (SC)";"SC";"MORRO DA FUMACA";869;32;35;936
2016;"MORRO GRANDE (SC)";"SC";"MORRO GRANDE";148;4;10;162
2016;"NAVEGANTES (SC)";"SC";"NAVEGANTES";907;112;76;1095
2016;"NOVA ERECHIM (SC)";"SC";"NOVA ERECHIM";136;6;10;152
2016;"NOVA ITABERABA (SC)";"SC";"NOVA ITABERABA";132;5;18;155
2016;"NOVA TRENTO (SC)";"SC";"NOVA TRENTO";294;45;39;378
2016;"NOVA VENEZA (SC)";"SC";"NOVA VENEZA";467;31;47;545
2016;"NOVO HORIZONTE (SC)";"SC";"NOVO HORIZONTE";63;11;19;93
2016;"ORLEANS (SC)";"SC";"ORLEANS";891;32;47;970
2016;"OTACILIO COSTA (SC)";"SC";"OTACILIO COSTA";488;47;67;602
2016;"OURO (SC)";"SC";"OURO";262;32;34;328
2016;"OURO VERDE (SC)";"SC";"OURO VERDE";95;2;9;106
2016;"PAIAL (SC)";"SC";"PAIAL";21;2;15;38
2016;"PAINEL (SC)";"SC";"PAINEL";45;5;11;61
2016;"PALHOCA (SC)";"SC";"PALHOCA";2503;175;390;3068
2016;"PALMA SOLA (SC)";"SC";"PALMA SOLA";209;7;33;249
2016;"PALMEIRA (SC)";"SC";"PALMEIRA";108;9;5;122
2016;"PALMITOS (SC)";"SC";"PALMITOS";421;47;53;521
2016;"PAPANDUVA (SC)";"SC";"PAPANDUVA";569;18;91;678
2016;"PARAISO (SC)";"SC";"PARAISO";99;6;10;115
2016;"PASSO DE TORRES (SC)";"SC";"PASSO DE TORRES";163;7;20;190
2016;"PASSOS MAIA (SC)";"SC";"PASSOS MAIA";132;3;31;166
2016;"PAULO LOPES (SC)";"SC";"PAULO LOPES";264;17;46;327
2016;"PEDRAS GRANDES (SC)";"SC";"PEDRAS GRANDES";246;21;15;282
2016;"PENHA (SC)";"SC";"PENHA";407;48;57;512
2016;"PERITIBA (SC)";"SC";"PERITIBA";95;7;16;118
2016;"PESCARIA BRAVA (SC)";"SC";"PESCARIA BRAVA";85;7;5;97
2016;"PETROLANDIA (SC)";"SC";"PETROLANDIA";179;13;24;216
2016;"PINHALZINHO (SC)";"SC";"PINHALZINHO";547;25;59;631
2016;"PINHEIRO PRETO (SC)";"SC";"PINHEIRO PRETO";276;8;17;301
2016;"PIRATUBA (SC)";"SC";"PIRATUBA";124;11;34;169
2016;"PLANALTO ALEGRE (SC)";"SC";"PLANALTO ALEGRE";80;8;5;93
2016;"POMERODE (SC)";"SC";"POMERODE";700;35;90;825
2016;"PONTE ALTA (SC)";"SC";"PONTE ALTA";146;9;15;170
2016;"PONTE ALTA DO NORTE (SC)";"SC";"PONTE ALTA DO NORTE";92;5;11;108
2016;"PONTE SERRADA (SC)";"SC";"PONTE SERRADA";369;50;124;543
2016;"PORTO BELO (SC)";"SC";"PORTO BELO";290;32;31;353
2016;"PORTO UNIAO (SC)";"SC";"PORTO UNIAO";682;36;41;759
2016;"POUSO REDONDO (SC)";"SC";"POUSO REDONDO";521;25;41;587
2016;"PRAIA GRANDE (SC)";"SC";"PRAIA GRANDE";258;8;27;293
2016;"PRESIDENTE CASTELO BRANCO (SC)";"SC";"PRESIDENTE CASTELO BRANCO";75;7;9;91
2016;"PRESIDENTE GETULIO (SC)";"SC";"PRESIDENTE GETULIO";389;51;71;511
2016;"PRESIDENTE NEREU (SC)";"SC";"PRESIDENTE NEREU";43;10;8;61
2016;"PRINCESA (SC)";"SC";"PRINCESA";64;3;12;79
2016;"QUILOMBO (SC)";"SC";"QUILOMBO";233;33;47;313
2016;"RANCHO QUEIMADO (SC)";"SC";"RANCHO QUEIMADO";158;5;8;171
2016;"RIO DAS ANTAS (SC)";"SC";"RIO DAS ANTAS";211;7;29;247
2016;"RIO DO CAMPO (SC)";"SC";"RIO DO CAMPO";195;12;18;225
2016;"RIO DO OESTE (SC)";"SC";"RIO DO OESTE";221;18;19;258
2016;"RIO DO SUL (SC)";"SC";"RIO DO SUL";1483;84;111;1678
2016;"RIO DOS CEDROS (SC)";"SC";"RIO DOS CEDROS";268;35;30;333
2016;"RIO FORTUNA (SC)";"SC";"RIO FORTUNA";291;5;18;314
2016;"RIO NEGRINHO (SC)";"SC";"RIO NEGRINHO";1134;65;124;1323
2016;"RIO RUFINO (SC)";"SC";"RIO RUFINO";59;7;22;88
2016;"RIQUEZA (SC)";"SC";"RIQUEZA";144;6;25;175
2016;"RODEIO (SC)";"SC";"RODEIO";274;17;25;316
2016;"ROMELANDIA (SC)";"SC";"ROMELANDIA";93;6;34;133
2016;"SALETE (SC)";"SC";"SALETE";196;13;27;236
2016;"SALTINHO (SC)";"SC";"SALTINHO";61;7;23;91
2016;"SALTO VELOSO (SC)";"SC";"SALTO VELOSO";165;5;11;181
2016;"SANGAO (SC)";"SC";"SANGAO";483;15;17;515
2016;"SANTA CECILIA (SC)";"SC";"SANTA CECILIA";494;41;65;600
2016;"SANTA HELENA (SC)";"SC";"SANTA HELENA";65;13;16;94
2016;"SANTA ROSA DE LIMA (SC)";"SC";"SANTA ROSA DE LIMA";122;5;10;137
2016;"SANTA ROSA DO SUL (SC)";"SC";"SANTA ROSA DO SUL";290;14;22;326
2016;"SANTA TEREZINHA (SC)";"SC";"SANTA TEREZINHA";195;14;29;238
2016;"SANTA TEREZINHA DO PROGRESSO (SC)";"SC";"SANTA TEREZINHA DO PROGRESSO";56;8;13;77
2016;"SANTIAGO DO SUL (SC)";"SC";"SANTIAGO DO SUL";69;8;4;81
2016;"SANTO AMARO DA IMPERATRIZ (SC)";"SC";"SANTO AMARO DA IMPERATRIZ";673;30;71;774
2016;"SAO BENTO DO SUL (SC)";"SC";"SAO BENTO DO SUL";1716;160;182;2058
2016;"SAO BERNARDINO (SC)";"SC";"SAO BERNARDINO";53;8;19;80
2016;"SAO BONIFACIO (SC)";"SC";"SAO BONIFACIO";138;9;11;158
2016;"SAO CARLOS (SC)";"SC";"SAO CARLOS";219;19;49;287
2016;"SAO CRISTOVAO DO SUL (SC)";"SC";"SAO CRISTOVAO DO SUL";336;6;13;355
2016;"SAO DOMINGOS (SC)";"SC";"SAO DOMINGOS";348;25;50;423
2016;"SAO FRANCISCO DO SUL (SC)";"SC";"SAO FRANCISCO DO SUL";722;74;83;879
2016;"SAO JOAO BATISTA (SC)";"SC";"SAO JOAO BATISTA";614;36;55;705
2016;"SAO JOAO DO ITAPERIU (SC)";"SC";"SAO JOAO DO ITAPERIU";240;6;13;259
2016;"SAO JOAO DO OESTE (SC)";"SC";"SAO JOAO DO OESTE";192;13;19;224
2016;"SAO JOAO DO SUL (SC)";"SC";"SAO JOAO DO SUL";227;4;17;248
2016;"SAO JOAQUIM (SC)";"SC";"SAO JOAQUIM";1076;103;219;1398
2016;"SAO JOSE (SC)";"SC";"SAO JOSE";3630;281;242;4153
2016;"SAO JOSE DO CEDRO (SC)";"SC";"SAO JOSE DO CEDRO";421;21;71;513
2016;"SAO JOSE DO CERRITO (SC)";"SC";"SAO JOSE DO CERRITO";224;15;57;296
2016;"SAO LOURENCO D OESTE (SC)";"SC";"SAO LOURENCO D OESTE";837;50;85;972
2016;"SAO LUDGERO (SC)";"SC";"SAO LUDGERO";605;12;31;648
2016;"SAO MARTINHO (SC)";"SC";"SAO MARTINHO";159;8;5;172
2016;"SAO MIGUEL D OESTE (SC)";"SC";"SAO MIGUEL D OESTE";1129;71;122;1322
2016;"SAO MIGUEL DA BOA VISTA (SC)";"SC";"SAO MIGUEL DA BOA VISTA";33;2;13;48
2016;"SAO PEDRO DE ALCANTARA (SC)";"SC";"SAO PEDRO DE ALCANTARA";156;7;5;168
2016;"SAUDADES (SC)";"SC";"SAUDADES";248;11;37;296
2016;"SCHROEDER (SC)";"SC";"SCHROEDER";243;9;21;273
2016;"SEARA (SC)";"SC";"SEARA";399;70;84;553
2016;"SERRA ALTA (SC)";"SC";"SERRA ALTA";69;10;16;95
2016;"SIDEROPOLIS (SC)";"SC";"SIDEROPOLIS";446;28;72;546
2016;"SOMBRIO (SC)";"SC";"SOMBRIO";745;61;81;887
2016;"SUL BRASIL (SC)";"SC";"SUL BRASIL";61;4;16;81
2016;"TAIO (SC)";"SC";"TAIO";614;22;59;695
2016;"TANGARA (SC)";"SC";"TANGARA";452;16;48;516
2016;"TIGRINHOS (SC)";"SC";"TIGRINHOS";35;4;11;50
2016;"TIJUCAS (SC)";"SC";"TIJUCAS";1040;56;52;1148
2016;"TIMBE DO SUL (SC)";"SC";"TIMBE DO SUL";158;13;16;187
2016;"TIMBO (SC)";"SC";"TIMBO";725;61;52;838
2016;"TIMBO GRANDE (SC)";"SC";"TIMBO GRANDE";202;9;26;237
2016;"TRES BARRAS (SC)";"SC";"TRES BARRAS";320;33;65;418
2016;"TREVISO (SC)";"SC";"TREVISO";124;9;8;141
2016;"TREZE DE MAIO (SC)";"SC";"TREZE DE MAIO";416;14;24;454
2016;"TREZE TILIAS (SC)";"SC";"TREZE TILIAS";331;21;43;395
2016;"TROMBUDO CENTRAL (SC)";"SC";"TROMBUDO CENTRAL";238;18;26;282
2016;"TUBARAO (SC)";"SC";"TUBARAO";2359;112;310;2781
2016;"TUNAPOLIS (SC)";"SC";"TUNAPOLIS";102;14;21;137
2016;"TURVO (SC)";"SC";"TURVO";512;19;50;581
2016;"UNIAO DO OESTE (SC)";"SC";"UNIAO DO OESTE";51;3;20;74
2016;"URUBICI (SC)";"SC";"URUBICI";300;23;55;378
2016;"URUPEMA (SC)";"SC";"URUPEMA";85;15;11;111
2016;"URUSSANGA (SC)";"SC";"URUSSANGA";509;45;95;649
2016;"VARGEAO (SC)";"SC";"VARGEAO";149;5;12;166
2016;"VARGEM (SC)";"SC";"VARGEM";76;0;14;90
2016;"VARGEM BONITA (SC)";"SC";"VARGEM BONITA";172;13;22;207
2016;"VIDAL RAMOS (SC)";"SC";"VIDAL RAMOS";178;17;19;214
2016;"VIDEIRA (SC)";"SC";"VIDEIRA";1701;133;165;1999
2016;"VITOR MEIRELES (SC)";"SC";"VITOR MEIRELES";98;20;19;137
2016;"WITMARSUM (SC)";"SC";"WITMARSUM";122;8;17;147
2016;"XANXERE (SC)";"SC";"XANXERE";1365;131;130;1626
2016;"XAVANTINA (SC)";"SC";"XAVANTINA";121;19;6;146
2016;"XAXIM (SC)";"SC";"XAXIM";745;61;146;952
2016;"ZORTEA (SC)";"SC";"ZORTEA";45;10;4;59
2016;"AMPARO DE SAO FRANCISCO (SE)";"SE";"AMPARO DE SAO FRANCISCO";9;12;3;24
2016;"AQUIDABA (SE)";"SE";"AQUIDABA";123;19;53;195
2016;"ARACAJU (SE)";"SE";"ARACAJU";5941;1054;2524;9519
2016;"ARAUA (SE)";"SE";"ARAUA";53;21;18;92
2016;"AREIA BRANCA (SE)";"SE";"AREIA BRANCA";163;23;20;206
2016;"BARRA DOS COQUEIROS (SE)";"SE";"BARRA DOS COQUEIROS";91;43;33;167
2016;"BOQUIM (SE)";"SE";"BOQUIM";216;26;38;280
2016;"BREJO GRANDE (SE)";"SE";"BREJO GRANDE";8;5;9;22
2016;"CAMPO DO BRITO (SE)";"SE";"CAMPO DO BRITO";421;17;67;505
2016;"CANHOBA (SE)";"SE";"CANHOBA";7;3;6;16
2016;"CANINDE DE SAO FRANCISCO (SE)";"SE";"CANINDE DE SAO FRANCISCO";213;75;25;313
2016;"CAPELA (SE)";"SE";"CAPELA";135;36;76;247
2016;"CARIRA (SE)";"SE";"CARIRA";291;32;98;421
2016;"CARMOPOLIS (SE)";"SE";"CARMOPOLIS";91;39;48;178
2016;"CEDRO DE SAO JOAO (SE)";"SE";"CEDRO DE SAO JOAO";24;7;5;36
2016;"CRISTINAPOLIS (SE)";"SE";"CRISTINAPOLIS";87;22;39;148
2016;"CUMBE (SE)";"SE";"CUMBE";32;8;17;57
2016;"DIVINA PASTORA (SE)";"SE";"DIVINA PASTORA";9;8;8;25
2016;"ESTANCIA (SE)";"SE";"ESTANCIA";562;196;267;1025
2016;"FEIRA NOVA (SE)";"SE";"FEIRA NOVA";20;10;7;37
2016;"FREI PAULO (SE)";"SE";"FREI PAULO";143;24;43;210
2016;"GARARU (SE)";"SE";"GARARU";54;15;30;99
2016;"GENERAL MAYNARD (SE)";"SE";"GENERAL MAYNARD";12;11;12;35
2016;"GRACCHO CARDOSO (SE)";"SE";"GRACCHO CARDOSO";23;10;9;42
2016;"ILHA DAS FLORES (SE)";"SE";"ILHA DAS FLORES";16;9;11;36
2016;"INDIAROBA (SE)";"SE";"INDIAROBA";43;18;18;79
2016;"ITABAIANA (SE)";"SE";"ITABAIANA";3293;140;200;3633
2016;"ITABAIANINHA (SE)";"SE";"ITABAIANINHA";584;67;69;720
2016;"ITABI (SE)";"SE";"ITABI";23;4;8;35
2016;"ITAPORANGA D AJUDA (SE)";"SE";"ITAPORANGA D AJUDA";315;43;78;436
2016;"JAPARATUBA (SE)";"SE";"JAPARATUBA";50;29;70;149
2016;"JAPOATA (SE)";"SE";"JAPOATA";56;12;39;107
2016;"LAGARTO (SE)";"SE";"LAGARTO";1101;155;220;1476
2016;"LARANJEIRAS (SE)";"SE";"LARANJEIRAS";132;67;45;244
2016;"MACAMBIRA (SE)";"SE";"MACAMBIRA";50;6;21;77
2016;"MALHADA DOS BOIS (SE)";"SE";"MALHADA DOS BOIS";14;5;11;30
2016;"MALHADOR (SE)";"SE";"MALHADOR";213;25;57;295
2016;"MARUIM (SE)";"SE";"MARUIM";50;34;35;119
2016;"MOITA BONITA (SE)";"SE";"MOITA BONITA";479;17;20;516
2016;"MONTE ALEGRE DE SERGIPE (SE)";"SE";"MONTE ALEGRE DE SERGIPE";166;35;36;237
2016;"MURIBECA (SE)";"SE";"MURIBECA";71;8;38;117
2016;"NEOPOLIS (SE)";"SE";"NEOPOLIS";56;18;31;105
2016;"NOSSA SENHORA APARECIDA (SE)";"SE";"NOSSA SENHORA APARECIDA";134;19;16;169
2016;"NOSSA SENHORA DA GLORIA (SE)";"SE";"NOSSA SENHORA DA GLORIA";491;66;150;707
2016;"NOSSA SENHORA DAS DORES (SE)";"SE";"NOSSA SENHORA DAS DORES";259;27;91;377
2016;"NOSSA SENHORA DE LOURDES (SE)";"SE";"NOSSA SENHORA DE LOURDES";30;5;9;44
2016;"NOSSA SENHORA DO SOCORRO (SE)";"SE";"NOSSA SENHORA DO SOCORRO";948;131;216;1295
2016;"PACATUBA (SE)";"SE";"PACATUBA";422;12;60;494
2016;"PEDRA MOLE (SE)";"SE";"PEDRA MOLE";7;4;5;16
2016;"PEDRINHAS (SE)";"SE";"PEDRINHAS";65;5;10;80
2016;"PINHAO (SE)";"SE";"PINHAO";25;15;9;49
2016;"PIRAMBU (SE)";"SE";"PIRAMBU";29;8;22;59
2016;"POCO REDONDO (SE)";"SE";"POCO REDONDO";178;64;74;316
2016;"POCO VERDE (SE)";"SE";"POCO VERDE";151;70;165;386
2016;"PORTO DA FOLHA (SE)";"SE";"PORTO DA FOLHA";137;38;36;211
2016;"PROPRIA (SE)";"SE";"PROPRIA";243;28;59;330
2016;"RIACHAO DO DANTAS (SE)";"SE";"RIACHAO DO DANTAS";40;7;20;67
2016;"RIACHUELO (SE)";"SE";"RIACHUELO";40;14;11;65
2016;"RIBEIROPOLIS (SE)";"SE";"RIBEIROPOLIS";269;42;75;386
2016;"ROSARIO DO CATETE (SE)";"SE";"ROSARIO DO CATETE";36;22;17;75
2016;"SALGADO (SE)";"SE";"SALGADO";142;19;139;300
2016;"SANTA LUZIA DO ITANHY (SE)";"SE";"SANTA LUZIA DO ITANHY";25;15;28;68
2016;"SANTA ROSA DE LIMA (SE)";"SE";"SANTA ROSA DE LIMA";28;5;8;41
2016;"SANTANA DO SAO FRANCISCO (SE)";"SE";"SANTANA DO SAO FRANCISCO";15;5;8;28
2016;"SANTO AMARO DAS BROTAS (SE)";"SE";"SANTO AMARO DAS BROTAS";17;8;20;45
2016;"SAO CRISTOVAO (SE)";"SE";"SAO CRISTOVAO";421;110;234;765
2016;"SAO DOMINGOS (SE)";"SE";"SAO DOMINGOS";132;11;33;176
2016;"SAO FRANCISCO (SE)";"SE";"SAO FRANCISCO";18;3;26;47
2016;"SAO MIGUEL DO ALEIXO (SE)";"SE";"SAO MIGUEL DO ALEIXO";49;3;5;57
2016;"SIMAO DIAS (SE)";"SE";"SIMAO DIAS";250;54;287;591
2016;"SIRIRI (SE)";"SE";"SIRIRI";39;11;39;89
2016;"TELHA (SE)";"SE";"TELHA";18;12;5;35
2016;"TOBIAS BARRETO (SE)";"SE";"TOBIAS BARRETO";350;94;220;664
2016;"TOMAR DO GERU (SE)";"SE";"TOMAR DO GERU";60;7;24;91
2016;"UMBAUBA (SE)";"SE";"UMBAUBA";325;43;40;408
2016;"ADAMANTINA (SP)";"SP";"ADAMANTINA";728;66;73;867
2016;"ADOLFO (SP)";"SP";"ADOLFO";74;2;27;103
2016;"AGUAI (SP)";"SP";"AGUAI";891;79;189;1159
2016;"AGUAS DA PRATA (SP)";"SP";"AGUAS DA PRATA";126;17;13;156
2016;"AGUAS DE LINDOIA (SP)";"SP";"AGUAS DE LINDOIA";202;83;78;363
2016;"AGUAS DE SANTA BARBARA (SP)";"SP";"AGUAS DE SANTA BARBARA";112;32;35;179
2016;"AGUAS DE SAO PEDRO (SP)";"SP";"AGUAS DE SAO PEDRO";38;9;6;53
2016;"AGUDOS (SP)";"SP";"AGUDOS";584;119;104;807
2016;"ALAMBARI (SP)";"SP";"ALAMBARI";90;17;8;115
2016;"ALFREDO MARCONDES (SP)";"SP";"ALFREDO MARCONDES";72;11;8;91
2016;"ALTAIR (SP)";"SP";"ALTAIR";73;6;37;116
2016;"ALTINOPOLIS (SP)";"SP";"ALTINOPOLIS";385;58;128;571
2016;"ALTO ALEGRE (SP)";"SP";"ALTO ALEGRE";103;3;46;152
2016;"ALUMINIO (SP)";"SP";"ALUMINIO";248;41;41;330
2016;"ALVARES FLORENCE (SP)";"SP";"ALVARES FLORENCE";62;3;17;82
2016;"ALVARES MACHADO (SP)";"SP";"ALVARES MACHADO";460;37;33;530
2016;"ALVARO DE CARVALHO (SP)";"SP";"ALVARO DE CARVALHO";30;6;28;64
2016;"ALVINLANDIA (SP)";"SP";"ALVINLANDIA";55;7;18;80
2016;"AMERICANA (SP)";"SP";"AMERICANA";3612;557;580;4749
2016;"AMERICO BRASILIENSE (SP)";"SP";"AMERICO BRASILIENSE";705;71;221;997
2016;"AMERICO DE CAMPOS (SP)";"SP";"AMERICO DE CAMPOS";123;11;30;164
2016;"AMPARO (SP)";"SP";"AMPARO";1429;243;142;1814
2016;"ANALANDIA (SP)";"SP";"ANALANDIA";97;14;17;128
2016;"ANDRADINA (SP)";"SP";"ANDRADINA";1373;100;149;1622
2016;"ANGATUBA (SP)";"SP";"ANGATUBA";401;58;119;578
2016;"ANHEMBI (SP)";"SP";"ANHEMBI";98;22;25;145
2016;"ANHUMAS (SP)";"SP";"ANHUMAS";88;9;9;106
2016;"APARECIDA (SP)";"SP";"APARECIDA";895;81;522;1498
2016;"APARECIDA D OESTE (SP)";"SP";"APARECIDA D OESTE";103;15;26;144
2016;"APIAI (SP)";"SP";"APIAI";396;57;90;543
2016;"ARACARIGUAMA (SP)";"SP";"ARACARIGUAMA";631;82;53;766
2016;"ARACATUBA (SP)";"SP";"ARACATUBA";3693;324;788;4805
2016;"ARACOIABA DA SERRA (SP)";"SP";"ARACOIABA DA SERRA";568;102;29;699
2016;"ARAMINA (SP)";"SP";"ARAMINA";65;12;25;102
2016;"ARANDU (SP)";"SP";"ARANDU";65;9;23;97
2016;"ARAPEI (SP)";"SP";"ARAPEI";39;11;12;62
2016;"ARARAQUARA (SP)";"SP";"ARARAQUARA";3791;479;1213;5483
2016;"ARARAS (SP)";"SP";"ARARAS";2379;311;367;3057
2016;"ARCO IRIS (SP)";"SP";"ARCO IRIS";75;4;7;86
2016;"AREALVA (SP)";"SP";"AREALVA";191;6;28;225
2016;"AREIAS (SP)";"SP";"AREIAS";61;4;8;73
2016;"AREIOPOLIS (SP)";"SP";"AREIOPOLIS";143;33;120;296
2016;"ARIRANHA (SP)";"SP";"ARIRANHA";288;24;190;502
2016;"ARTUR NOGUEIRA (SP)";"SP";"ARTUR NOGUEIRA";1108;108;166;1382
2016;"ARUJA (SP)";"SP";"ARUJA";3141;373;474;3988
2016;"ASPASIA (SP)";"SP";"ASPASIA";30;7;5;42
2016;"ASSIS (SP)";"SP";"ASSIS";1938;195;382;2515
2016;"ATIBAIA (SP)";"SP";"ATIBAIA";2588;406;347;3341
2016;"AURIFLAMA (SP)";"SP";"AURIFLAMA";350;36;51;437
2016;"AVAI (SP)";"SP";"AVAI";80;13;22;115
2016;"AVANHANDAVA (SP)";"SP";"AVANHANDAVA";176;13;59;248
2016;"AVARE (SP)";"SP";"AVARE";1392;157;307;1856
2016;"BADY BASSITT (SP)";"SP";"BADY BASSITT";412;48;77;537
2016;"BALBINOS (SP)";"SP";"BALBINOS";26;2;8;36
2016;"BALSAMO (SP)";"SP";"BALSAMO";211;8;23;242
2016;"BANANAL (SP)";"SP";"BANANAL";167;20;38;225
2016;"BARAO DE ANTONINA (SP)";"SP";"BARAO DE ANTONINA";34;4;14;52
2016;"BARBOSA (SP)";"SP";"BARBOSA";124;7;44;175
2016;"BARIRI (SP)";"SP";"BARIRI";855;64;98;1017
2016;"BARRA BONITA (SP)";"SP";"BARRA BONITA";1078;93;262;1433
2016;"BARRA DO CHAPEU (SP)";"SP";"BARRA DO CHAPEU";63;6;18;87
2016;"BARRA DO TURVO (SP)";"SP";"BARRA DO TURVO";76;21;48;145
2016;"BARRETOS (SP)";"SP";"BARRETOS";2156;254;525;2935
2016;"BARRINHA (SP)";"SP";"BARRINHA";486;55;200;741
2016;"BARUERI (SP)";"SP";"BARUERI";6179;837;1218;8234
2016;"BASTOS (SP)";"SP";"BASTOS";866;31;98;995
2016;"BATATAIS (SP)";"SP";"BATATAIS";1208;142;176;1526
2016;"BAURU (SP)";"SP";"BAURU";5907;498;1279;7684
2016;"BEBEDOURO (SP)";"SP";"BEBEDOURO";1708;164;319;2191
2016;"BENTO DE ABREU (SP)";"SP";"BENTO DE ABREU";65;11;13;89
2016;"BERNARDINO DE CAMPOS (SP)";"SP";"BERNARDINO DE CAMPOS";348;43;38;429
2016;"BERTIOGA (SP)";"SP";"BERTIOGA";556;73;105;734
2016;"BILAC (SP)";"SP";"BILAC";168;10;21;199
2016;"BIRIGUI (SP)";"SP";"BIRIGUI";1841;122;189;2152
2016;"BIRITIBA MIRIM (SP)";"SP";"BIRITIBA MIRIM";449;56;55;560
2016;"BOA ESPERANCA DO SUL (SP)";"SP";"BOA ESPERANCA DO SUL";338;47;104;489
2016;"BOCAINA (SP)";"SP";"BOCAINA";208;48;36;292
2016;"BOFETE (SP)";"SP";"BOFETE";230;55;54;339
2016;"BOITUVA (SP)";"SP";"BOITUVA";1466;192;159;1817
2016;"BOM JESUS DOS PERDOES (SP)";"SP";"BOM JESUS DOS PERDOES";574;82;75;731
2016;"BOM SUCESSO DE ITARARE (SP)";"SP";"BOM SUCESSO DE ITARARE";76;8;14;98
2016;"BORA (SP)";"SP";"BORA";44;1;7;52
2016;"BORACEIA (SP)";"SP";"BORACEIA";197;12;21;230
2016;"BORBOREMA (SP)";"SP";"BORBOREMA";378;35;82;495
2016;"BOREBI (SP)";"SP";"BOREBI";55;9;5;69
2016;"BOTUCATU (SP)";"SP";"BOTUCATU";1819;359;524;2702
2016;"BRAGANCA PAULISTA (SP)";"SP";"BRAGANCA PAULISTA";2917;410;388;3715
2016;"BRAUNA (SP)";"SP";"BRAUNA";82;9;85;176
2016;"BREJO ALEGRE (SP)";"SP";"BREJO ALEGRE";149;1;19;169
2016;"BRODOWSKI (SP)";"SP";"BRODOWSKI";653;40;46;739
2016;"BROTAS (SP)";"SP";"BROTAS";529;69;192;790
2016;"BURI (SP)";"SP";"BURI";473;48;96;617
2016;"BURITAMA (SP)";"SP";"BURITAMA";351;33;73;457
2016;"BURITIZAL (SP)";"SP";"BURITIZAL";120;17;33;170
2016;"CABRALIA PAULISTA (SP)";"SP";"CABRALIA PAULISTA";138;9;20;167
2016;"CABREUVA (SP)";"SP";"CABREUVA";1017;146;65;1228
2016;"CACAPAVA (SP)";"SP";"CACAPAVA";1201;329;208;1738
2016;"CACHOEIRA PAULISTA (SP)";"SP";"CACHOEIRA PAULISTA";425;125;23;573
2016;"CACONDE (SP)";"SP";"CACONDE";269;62;85;416
2016;"CAFELANDIA (SP)";"SP";"CAFELANDIA";300;27;82;409
2016;"CAIABU (SP)";"SP";"CAIABU";44;9;42;95
2016;"CAIEIRAS (SP)";"SP";"CAIEIRAS";1182;286;493;1961
2016;"CAIUA (SP)";"SP";"CAIUA";58;13;24;95
2016;"CAJAMAR (SP)";"SP";"CAJAMAR";1666;260;336;2262
2016;"CAJATI (SP)";"SP";"CAJATI";641;85;87;813
2016;"CAJOBI (SP)";"SP";"CAJOBI";249;10;91;350
2016;"CAJURU (SP)";"SP";"CAJURU";523;32;104;659
2016;"CAMPINA DO MONTE ALEGRE (SP)";"SP";"CAMPINA DO MONTE ALEGRE";84;20;28;132
2016;"CAMPINAS (SP)";"SP";"CAMPINAS";20377;3832;5398;29607
2016;"CAMPO LIMPO PAULISTA (SP)";"SP";"CAMPO LIMPO PAULISTA";687;119;40;846
2016;"CAMPOS DO JORDAO (SP)";"SP";"CAMPOS DO JORDAO";636;161;63;860
2016;"CAMPOS NOVOS PAULISTA (SP)";"SP";"CAMPOS NOVOS PAULISTA";105;8;29;142
2016;"CANANEIA (SP)";"SP";"CANANEIA";108;13;14;135
2016;"CANAS (SP)";"SP";"CANAS";143;9;12;164
2016;"CANDIDO MOTA (SP)";"SP";"CANDIDO MOTA";974;67;70;1111
2016;"CANDIDO RODRIGUES (SP)";"SP";"CANDIDO RODRIGUES";109;10;10;129
2016;"CANITAR (SP)";"SP";"CANITAR";56;19;22;97
2016;"CAPAO BONITO (SP)";"SP";"CAPAO BONITO";991;150;194;1335
2016;"CAPELA DO ALTO (SP)";"SP";"CAPELA DO ALTO";565;65;38;668
2016;"CAPIVARI (SP)";"SP";"CAPIVARI";1173;108;236;1517
2016;"CARAGUATATUBA (SP)";"SP";"CARAGUATATUBA";1686;177;131;1994
2016;"CARAPICUIBA (SP)";"SP";"CARAPICUIBA";3908;879;939;5726
2016;"CARDOSO (SP)";"SP";"CARDOSO";183;19;53;255
2016;"CASA BRANCA (SP)";"SP";"CASA BRANCA";583;71;98;752
2016;"CASSIA DOS COQUEIROS (SP)";"SP";"CASSIA DOS COQUEIROS";23;6;16;45
2016;"CASTILHO (SP)";"SP";"CASTILHO";252;40;120;412
2016;"CATANDUVA (SP)";"SP";"CATANDUVA";2970;266;489;3725
2016;"CATIGUA (SP)";"SP";"CATIGUA";98;11;33;142
2016;"CEDRAL (SP)";"SP";"CEDRAL";238;21;20;279
2016;"CERQUEIRA CESAR (SP)";"SP";"CERQUEIRA CESAR";399;44;137;580
2016;"CERQUILHO (SP)";"SP";"CERQUILHO";899;141;112;1152
2016;"CESARIO LANGE (SP)";"SP";"CESARIO LANGE";368;59;53;480
2016;"CHARQUEADA (SP)";"SP";"CHARQUEADA";447;41;100;588
2016;"CHAVANTES (SP)";"SP";"CHAVANTES";144;42;52;238
2016;"CLEMENTINA (SP)";"SP";"CLEMENTINA";299;11;68;378
2016;"COLINA (SP)";"SP";"COLINA";383;34;89;506
2016;"COLOMBIA (SP)";"SP";"COLOMBIA";136;37;69;242
2016;"CONCHAL (SP)";"SP";"CONCHAL";829;75;278;1182
2016;"CONCHAS (SP)";"SP";"CONCHAS";363;50;41;454
2016;"CORDEIROPOLIS (SP)";"SP";"CORDEIROPOLIS";777;81;50;908
2016;"COROADOS (SP)";"SP";"COROADOS";99;7;22;128
2016;"CORONEL MACEDO (SP)";"SP";"CORONEL MACEDO";60;15;22;97
2016;"CORUMBATAI (SP)";"SP";"CORUMBATAI";162;13;9;184
2016;"COSMOPOLIS (SP)";"SP";"COSMOPOLIS";884;288;269;1441
2016;"COSMORAMA (SP)";"SP";"COSMORAMA";229;15;51;295
2016;"COTIA (SP)";"SP";"COTIA";3336;899;920;5155
2016;"CRAVINHOS (SP)";"SP";"CRAVINHOS";997;53;166;1216
2016;"CRISTAIS PAULISTA (SP)";"SP";"CRISTAIS PAULISTA";129;10;27;166
2016;"CRUZALIA (SP)";"SP";"CRUZALIA";86;7;5;98
2016;"CRUZEIRO (SP)";"SP";"CRUZEIRO";758;174;48;980
2016;"CUBATAO (SP)";"SP";"CUBATAO";2842;418;453;3713
2016;"CUNHA (SP)";"SP";"CUNHA";332;63;51;446
2016;"DESCALVADO (SP)";"SP";"DESCALVADO";1049;112;182;1343
2016;"DIADEMA (SP)";"SP";"DIADEMA";4362;719;680;5761
2016;"DIRCE REIS (SP)";"SP";"DIRCE REIS";67;5;7;79
2016;"DIVINOLANDIA (SP)";"SP";"DIVINOLANDIA";474;29;59;562
2016;"DOBRADA (SP)";"SP";"DOBRADA";66;18;84;168
2016;"DOIS CORREGOS (SP)";"SP";"DOIS CORREGOS";676;90;151;917
2016;"DOLCINOPOLIS (SP)";"SP";"DOLCINOPOLIS";34;5;6;45
2016;"DOURADO (SP)";"SP";"DOURADO";196;32;59;287
2016;"DRACENA (SP)";"SP";"DRACENA";1121;67;133;1321
2016;"DUARTINA (SP)";"SP";"DUARTINA";271;27;76;374
2016;"DUMONT (SP)";"SP";"DUMONT";342;9;54;405
2016;"ECHAPORA (SP)";"SP";"ECHAPORA";154;4;27;185
2016;"ELDORADO (SP)";"SP";"ELDORADO";278;30;62;370
2016;"ELIAS FAUSTO (SP)";"SP";"ELIAS FAUSTO";358;19;94;471
2016;"ELISIARIO (SP)";"SP";"ELISIARIO";52;10;10;72
2016;"EMBAUBA (SP)";"SP";"EMBAUBA";73;4;27;104
2016;"EMBU (SP)";"SP";"EMBU";2704;749;784;4237
2016;"EMBU GUACU (SP)";"SP";"EMBU GUACU";2526;290;308;3124
2016;"EMILIANOPOLIS (SP)";"SP";"EMILIANOPOLIS";52;4;12;68
2016;"ENGENHEIRO COELHO (SP)";"SP";"ENGENHEIRO COELHO";386;64;176;626
2016;"ESPIRITO SANTO DO PINHAL (SP)";"SP";"ESPIRITO SANTO DO PINHAL";671;133;72;876
2016;"ESPIRITO SANTO DO TURVO (SP)";"SP";"ESPIRITO SANTO DO TURVO";159;24;37;220
2016;"ESTIVA GERBI (SP)";"SP";"ESTIVA GERBI";275;17;29;321
2016;"ESTRELA D OESTE (SP)";"SP";"ESTRELA D OESTE";274;8;36;318
2016;"ESTRELA DO NORTE (SP)";"SP";"ESTRELA DO NORTE";27;1;8;36
2016;"EUCLIDES DA CUNHA PAULISTA (SP)";"SP";"EUCLIDES DA CUNHA PAULISTA";107;7;51;165
2016;"FARTURA (SP)";"SP";"FARTURA";319;38;47;404
2016;"FERNANDO PRESTES (SP)";"SP";"FERNANDO PRESTES";247;9;20;276
2016;"FERNANDOPOLIS (SP)";"SP";"FERNANDOPOLIS";1580;100;216;1896
2016;"FERNAO (SP)";"SP";"FERNAO";36;6;9;51
2016;"FERRAZ DE VASCONCELOS (SP)";"SP";"FERRAZ DE VASCONCELOS";2111;318;365;2794
2016;"FLORA RICA (SP)";"SP";"FLORA RICA";25;2;9;36
2016;"FLOREAL (SP)";"SP";"FLOREAL";65;9;7;81
2016;"FLORIDA PAULISTA (SP)";"SP";"FLORIDA PAULISTA";345;24;123;492
2016;"FLORINEA (SP)";"SP";"FLORINEA";51;7;9;67
2016;"FRANCA (SP)";"SP";"FRANCA";3684;444;687;4815
2016;"FRANCISCO MORATO (SP)";"SP";"FRANCISCO MORATO";593;255;222;1070
2016;"FRANCO DA ROCHA (SP)";"SP";"FRANCO DA ROCHA";960;243;200;1403
2016;"GABRIEL MONTEIRO (SP)";"SP";"GABRIEL MONTEIRO";62;2;14;78
2016;"GALIA (SP)";"SP";"GALIA";154;18;45;217
2016;"GARCA (SP)";"SP";"GARCA";781;95;121;997
2016;"GASTAO VIDIGAL (SP)";"SP";"GASTAO VIDIGAL";61;7;67;135
2016;"GAVIAO PEIXOTO (SP)";"SP";"GAVIAO PEIXOTO";69;15;24;108
2016;"GENERAL SALGADO (SP)";"SP";"GENERAL SALGADO";269;21;103;393
2016;"GETULINA (SP)";"SP";"GETULINA";133;8;72;213
2016;"GLICERIO (SP)";"SP";"GLICERIO";136;11;29;176
2016;"GUAICARA (SP)";"SP";"GUAICARA";123;12;32;167
2016;"GUAIMBE (SP)";"SP";"GUAIMBE";139;4;32;175
2016;"GUAIRA (SP)";"SP";"GUAIRA";1311;102;212;1625
2016;"GUAPIACU (SP)";"SP";"GUAPIACU";460;25;69;554
2016;"GUAPIARA (SP)";"SP";"GUAPIARA";387;46;55;488
2016;"GUARA (SP)";"SP";"GUARA";248;45;188;481
2016;"GUARACAI (SP)";"SP";"GUARACAI";299;25;36;360
2016;"GUARACI (SP)";"SP";"GUARACI";196;17;75;288
2016;"GUARANI D OESTE (SP)";"SP";"GUARANI D OESTE";32;4;6;42
2016;"GUARANTA (SP)";"SP";"GUARANTA";95;7;44;146
2016;"GUARARAPES (SP)";"SP";"GUARARAPES";695;65;156;916
2016;"GUARAREMA (SP)";"SP";"GUARAREMA";558;96;69;723
2016;"GUARATINGUETA (SP)";"SP";"GUARATINGUETA";1333;396;214;1943
2016;"GUAREI (SP)";"SP";"GUAREI";308;30;83;421
2016;"GUARIBA (SP)";"SP";"GUARIBA";867;71;295;1233
2016;"GUARUJA (SP)";"SP";"GUARUJA";2164;431;458;3053
2016;"GUARULHOS (SP)";"SP";"GUARULHOS";21244;4063;4091;29398
2016;"GUATAPARA (SP)";"SP";"GUATAPARA";204;17;59;280
2016;"GUZOLANDIA (SP)";"SP";"GUZOLANDIA";76;5;32;113
2016;"HERCULANDIA (SP)";"SP";"HERCULANDIA";515;6;23;544
2016;"HOLAMBRA (SP)";"SP";"HOLAMBRA";396;53;103;552
2016;"HORTOLANDIA (SP)";"SP";"HORTOLANDIA";2255;521;567;3343
2016;"IACANGA (SP)";"SP";"IACANGA";257;35;42;334
2016;"IACRI (SP)";"SP";"IACRI";147;6;21;174
2016;"IARAS (SP)";"SP";"IARAS";68;19;33;120
2016;"IBATE (SP)";"SP";"IBATE";606;138;221;965
2016;"IBIRA (SP)";"SP";"IBIRA";179;20;52;251
2016;"IBIRAREMA (SP)";"SP";"IBIRAREMA";215;17;29;261
2016;"IBITINGA (SP)";"SP";"IBITINGA";881;102;183;1166
2016;"IBIUNA (SP)";"SP";"IBIUNA";2223;258;107;2588
2016;"ICEM (SP)";"SP";"ICEM";219;9;74;302
2016;"IEPE (SP)";"SP";"IEPE";194;15;32;241
2016;"IGARACU DO TIETE (SP)";"SP";"IGARACU DO TIETE";369;42;100;511
2016;"IGARAPAVA (SP)";"SP";"IGARAPAVA";473;53;122;648
2016;"IGARATA (SP)";"SP";"IGARATA";157;25;17;199
2016;"IGUAPE (SP)";"SP";"IGUAPE";260;52;109;421
2016;"ILHA COMPRIDA (SP)";"SP";"ILHA COMPRIDA";187;32;78;297
2016;"ILHA SOLTEIRA (SP)";"SP";"ILHA SOLTEIRA";265;34;90;389
2016;"ILHABELA (SP)";"SP";"ILHABELA";356;75;70;501
2016;"INDAIATUBA (SP)";"SP";"INDAIATUBA";3507;642;427;4576
2016;"INDIANA (SP)";"SP";"INDIANA";125;13;12;150
2016;"INDIAPORA (SP)";"SP";"INDIAPORA";72;5;18;95
2016;"INUBIA PAULISTA (SP)";"SP";"INUBIA PAULISTA";54;8;11;73
2016;"IPAUSSU (SP)";"SP";"IPAUSSU";203;26;59;288
2016;"IPERO (SP)";"SP";"IPERO";287;55;37;379
2016;"IPEUNA (SP)";"SP";"IPEUNA";193;32;42;267
2016;"IPIGUA (SP)";"SP";"IPIGUA";44;5;11;60
2016;"IPORANGA (SP)";"SP";"IPORANGA";31;21;9;61
2016;"IPUA (SP)";"SP";"IPUA";273;26;87;386
2016;"IRACEMAPOLIS (SP)";"SP";"IRACEMAPOLIS";555;71;108;734
2016;"IRAPUA (SP)";"SP";"IRAPUA";138;7;85;230
2016;"IRAPURU (SP)";"SP";"IRAPURU";107;11;29;147
2016;"ITABERA (SP)";"SP";"ITABERA";283;56;54;393
2016;"ITAI (SP)";"SP";"ITAI";561;81;194;836
2016;"ITAJOBI (SP)";"SP";"ITAJOBI";539;23;55;617
2016;"ITAJU (SP)";"SP";"ITAJU";77;2;20;99
2016;"ITANHAEM (SP)";"SP";"ITANHAEM";940;243;129;1312
2016;"ITAOCA (SP)";"SP";"ITAOCA";32;10;9;51
2016;"ITAPECERICA DA SERRA (SP)";"SP";"ITAPECERICA DA SERRA";2597;689;825;4111
2016;"ITAPETININGA (SP)";"SP";"ITAPETININGA";2983;497;514;3994
2016;"ITAPEVA (SP)";"SP";"ITAPEVA";2057;355;418;2830
2016;"ITAPEVI (SP)";"SP";"ITAPEVI";2131;432;216;2779
2016;"ITAPIRA (SP)";"SP";"ITAPIRA";1797;145;235;2177
2016;"ITAPIRAPUA PAULISTA (SP)";"SP";"ITAPIRAPUA PAULISTA";54;19;15;88
2016;"ITAPOLIS (SP)";"SP";"ITAPOLIS";1292;113;217;1622
2016;"ITAPORANGA (SP)";"SP";"ITAPORANGA";259;26;85;370
2016;"ITAPUI (SP)";"SP";"ITAPUI";402;48;68;518
2016;"ITAPURA (SP)";"SP";"ITAPURA";30;9;19;58
2016;"ITAQUAQUECETUBA (SP)";"SP";"ITAQUAQUECETUBA";3616;496;515;4627
2016;"ITARARE (SP)";"SP";"ITARARE";980;90;271;1341
2016;"ITARIRI (SP)";"SP";"ITARIRI";380;38;22;440
2016;"ITATIBA (SP)";"SP";"ITATIBA";2573;278;319;3170
2016;"ITATINGA (SP)";"SP";"ITATINGA";250;56;115;421
2016;"ITIRAPINA (SP)";"SP";"ITIRAPINA";324;48;61;433
2016;"ITIRAPUA (SP)";"SP";"ITIRAPUA";95;6;21;122
2016;"ITOBI (SP)";"SP";"ITOBI";168;39;86;293
2016;"ITU (SP)";"SP";"ITU";3242;513;688;4443
2016;"ITUPEVA (SP)";"SP";"ITUPEVA";1544;136;117;1797
2016;"ITUVERAVA (SP)";"SP";"ITUVERAVA";637;63;122;822
2016;"JABORANDI (SP)";"SP";"JABORANDI";179;10;42;231
2016;"JABOTICABAL (SP)";"SP";"JABOTICABAL";2031;117;215;2363
2016;"JACAREI (SP)";"SP";"JACAREI";2763;642;335;3740
2016;"JACI (SP)";"SP";"JACI";214;8;15;237
2016;"JACUPIRANGA (SP)";"SP";"JACUPIRANGA";420;65;468;953
2016;"JAGUARIUNA (SP)";"SP";"JAGUARIUNA";1191;99;175;1465
2016;"JALES (SP)";"SP";"JALES";1256;56;88;1400
2016;"JAMBEIRO (SP)";"SP";"JAMBEIRO";121;33;16;170
2016;"JANDIRA (SP)";"SP";"JANDIRA";1185;333;202;1720
2016;"JARDINOPOLIS (SP)";"SP";"JARDINOPOLIS";1041;119;164;1324
2016;"JARINU (SP)";"SP";"JARINU";652;72;64;788
2016;"JAU (SP)";"SP";"JAU";2491;340;478;3309
2016;"JERIQUARA (SP)";"SP";"JERIQUARA";67;7;25;99
2016;"JOANOPOLIS (SP)";"SP";"JOANOPOLIS";421;29;18;468
2016;"JOAO RAMALHO (SP)";"SP";"JOAO RAMALHO";38;9;21;68
2016;"JOSE BONIFACIO (SP)";"SP";"JOSE BONIFACIO";928;69;146;1143
2016;"JULIO MESQUITA (SP)";"SP";"JULIO MESQUITA";43;9;32;84
2016;"JUMIRIM (SP)";"SP";"JUMIRIM";100;13;6;119
2016;"JUNDIAI (SP)";"SP";"JUNDIAI";8208;875;1163;10246
2016;"JUNQUEIROPOLIS (SP)";"SP";"JUNQUEIROPOLIS";508;34;228;770
2016;"JUQUIA (SP)";"SP";"JUQUIA";437;33;24;494
2016;"JUQUITIBA (SP)";"SP";"JUQUITIBA";667;132;110;909
2016;"LAGOINHA (SP)";"SP";"LAGOINHA";163;27;24;214
2016;"LARANJAL PAULISTA (SP)";"SP";"LARANJAL PAULISTA";750;65;213;1028
2016;"LAVINIA (SP)";"SP";"LAVINIA";86;5;19;110
2016;"LAVRINHAS (SP)";"SP";"LAVRINHAS";92;20;13;125
2016;"LEME (SP)";"SP";"LEME";2544;209;563;3316
2016;"LENCOIS PAULISTA (SP)";"SP";"LENCOIS PAULISTA";1499;244;378;2121
2016;"LIMEIRA (SP)";"SP";"LIMEIRA";4941;983;714;6638
2016;"LINDOIA (SP)";"SP";"LINDOIA";204;28;32;264
2016;"LINS (SP)";"SP";"LINS";1339;139;199;1677
2016;"LORENA (SP)";"SP";"LORENA";982;215;35;1232
2016;"LOURDES (SP)";"SP";"LOURDES";23;2;20;45
2016;"LOUVEIRA (SP)";"SP";"LOUVEIRA";965;164;65;1194
2016;"LUCELIA (SP)";"SP";"LUCELIA";377;27;202;606
2016;"LUCIANOPOLIS (SP)";"SP";"LUCIANOPOLIS";52;9;18;79
2016;"LUIS ANTONIO (SP)";"SP";"LUIS ANTONIO";267;31;189;487
2016;"LUIZIANIA (SP)";"SP";"LUIZIANIA";74;3;29;106
2016;"LUPERCIO (SP)";"SP";"LUPERCIO";51;5;33;89
2016;"LUTECIA (SP)";"SP";"LUTECIA";46;7;12;65
2016;"MACATUBA (SP)";"SP";"MACATUBA";478;33;93;604
2016;"MACAUBAL (SP)";"SP";"MACAUBAL";150;16;24;190
2016;"MACEDONIA (SP)";"SP";"MACEDONIA";47;4;13;64
2016;"MAGDA (SP)";"SP";"MAGDA";116;14;12;142
2016;"MAIRINQUE (SP)";"SP";"MAIRINQUE";638;135;108;881
2016;"MAIRIPORA (SP)";"SP";"MAIRIPORA";2133;311;173;2617
2016;"MANDURI (SP)";"SP";"MANDURI";265;51;91;407
2016;"MARABA PAULISTA (SP)";"SP";"MARABA PAULISTA";40;8;19;67
2016;"MARACAI (SP)";"SP";"MARACAI";318;67;51;436
2016;"MARAPOAMA (SP)";"SP";"MARAPOAMA";152;8;12;172
2016;"MARIAPOLIS (SP)";"SP";"MARIAPOLIS";52;5;37;94
2016;"MARILIA (SP)";"SP";"MARILIA";3388;349;574;4311
2016;"MARINOPOLIS (SP)";"SP";"MARINOPOLIS";88;5;9;102
2016;"MARTINOPOLIS (SP)";"SP";"MARTINOPOLIS";482;48;124;654
2016;"MATAO (SP)";"SP";"MATAO";1617;119;435;2171
2016;"MAUA (SP)";"SP";"MAUA";4045;1106;1449;6600
2016;"MENDONCA (SP)";"SP";"MENDONCA";111;7;27;145
2016;"MERIDIANO (SP)";"SP";"MERIDIANO";178;12;21;211
2016;"MESOPOLIS (SP)";"SP";"MESOPOLIS";18;3;12;33
2016;"MIGUELOPOLIS (SP)";"SP";"MIGUELOPOLIS";293;15;93;401
2016;"MINEIROS DO TIETE (SP)";"SP";"MINEIROS DO TIETE";253;19;62;334
2016;"MIRA ESTRELA (SP)";"SP";"MIRA ESTRELA";46;9;27;82
2016;"MIRACATU (SP)";"SP";"MIRACATU";710;77;30;817
2016;"MIRANDOPOLIS (SP)";"SP";"MIRANDOPOLIS";543;47;191;781
2016;"MIRANTE DO PARANAPANEMA (SP)";"SP";"MIRANTE DO PARANAPANEMA";299;60;97;456
2016;"MIRASSOL (SP)";"SP";"MIRASSOL";1343;65;93;1501
2016;"MIRASSOLANDIA (SP)";"SP";"MIRASSOLANDIA";53;11;11;75
2016;"MOCOCA (SP)";"SP";"MOCOCA";1241;146;354;1741
2016;"MOGI DAS CRUZES (SP)";"SP";"MOGI DAS CRUZES";6471;945;1565;8981
2016;"MOGI GUACU (SP)";"SP";"MOGI GUACU";2587;523;618;3728
2016;"MOGI MIRIM (SP)";"SP";"MOGI MIRIM";2035;223;368;2626
2016;"MOMBUCA (SP)";"SP";"MOMBUCA";114;7;19;140
2016;"MONCOES (SP)";"SP";"MONCOES";79;14;16;109
2016;"MONGAGUA (SP)";"SP";"MONGAGUA";573;112;78;763
2016;"MONTE ALEGRE DO SUL (SP)";"SP";"MONTE ALEGRE DO SUL";233;52;50;335
2016;"MONTE ALTO (SP)";"SP";"MONTE ALTO";1550;90;107;1747
2016;"MONTE APRAZIVEL (SP)";"SP";"MONTE APRAZIVEL";628;57;237;922
2016;"MONTE AZUL PAULISTA (SP)";"SP";"MONTE AZUL PAULISTA";521;50;171;742
2016;"MONTE CASTELO (SP)";"SP";"MONTE CASTELO";88;6;12;106
2016;"MONTE MOR (SP)";"SP";"MONTE MOR";779;117;134;1030
2016;"MONTEIRO LOBATO (SP)";"SP";"MONTEIRO LOBATO";188;39;17;244
2016;"MORRO AGUDO (SP)";"SP";"MORRO AGUDO";733;51;181;965
2016;"MORUNGABA (SP)";"SP";"MORUNGABA";408;63;31;502
2016;"MOTUCA (SP)";"SP";"MOTUCA";149;9;28;186
2016;"MUNICIPIO NAO INFORMADO (SP)";"SP";"MUNICIPIO NAO INFORMADO";0;0;0;0
2016;"MURUTINGA DO SUL (SP)";"SP";"MURUTINGA DO SUL";87;9;20;116
2016;"NANTES (SP)";"SP";"NANTES";23;11;16;50
2016;"NARANDIBA (SP)";"SP";"NARANDIBA";92;9;21;122
2016;"NATIVIDADE DA SERRA (SP)";"SP";"NATIVIDADE DA SERRA";104;51;9;164
2016;"NAZARE PAULISTA (SP)";"SP";"NAZARE PAULISTA";734;24;37;795
2016;"NEVES PAULISTA (SP)";"SP";"NEVES PAULISTA";192;11;32;235
2016;"NHANDEARA (SP)";"SP";"NHANDEARA";207;19;54;280
2016;"NIPOA (SP)";"SP";"NIPOA";129;11;33;173
2016;"NOVA ALIANCA (SP)";"SP";"NOVA ALIANCA";160;12;20;192
2016;"NOVA CAMPINA (SP)";"SP";"NOVA CAMPINA";89;16;24;129
2016;"NOVA CANAA PAULISTA (SP)";"SP";"NOVA CANAA PAULISTA";38;5;7;50
2016;"NOVA CASTILHO (SP)";"SP";"NOVA CASTILHO";21;3;4;28
2016;"NOVA EUROPA (SP)";"SP";"NOVA EUROPA";167;16;147;330
2016;"NOVA GRANADA (SP)";"SP";"NOVA GRANADA";370;56;113;539
2016;"NOVA GUATAPORANGA (SP)";"SP";"NOVA GUATAPORANGA";36;6;16;58
2016;"NOVA INDEPENDENCIA (SP)";"SP";"NOVA INDEPENDENCIA";57;9;14;80
2016;"NOVA LUZITANIA (SP)";"SP";"NOVA LUZITANIA";36;4;30;70
2016;"NOVA ODESSA (SP)";"SP";"NOVA ODESSA";950;147;139;1236
2016;"NOVAIS (SP)";"SP";"NOVAIS";104;7;35;146
2016;"NOVO HORIZONTE (SP)";"SP";"NOVO HORIZONTE";1220;51;319;1590
2016;"NUPORANGA (SP)";"SP";"NUPORANGA";237;21;55;313
2016;"OCAUCU (SP)";"SP";"OCAUCU";126;11;26;163
2016;"OLEO (SP)";"SP";"OLEO";40;17;8;65
2016;"OLIMPIA (SP)";"SP";"OLIMPIA";980;123;234;1337
2016;"ONDA VERDE (SP)";"SP";"ONDA VERDE";101;11;24;136
2016;"ORIENTE (SP)";"SP";"ORIENTE";102;17;20;139
2016;"ORINDIUVA (SP)";"SP";"ORINDIUVA";236;14;69;319
2016;"ORLANDIA (SP)";"SP";"ORLANDIA";948;64;300;1312
2016;"OSASCO (SP)";"SP";"OSASCO";10316;2234;2776;15326
2016;"OSCAR BRESSANE (SP)";"SP";"OSCAR BRESSANE";58;9;5;72
2016;"OSVALDO CRUZ (SP)";"SP";"OSVALDO CRUZ";545;39;122;706
2016;"OURINHOS (SP)";"SP";"OURINHOS";2218;154;636;3008
2016;"OURO VERDE (SP)";"SP";"OURO VERDE";130;5;64;199
2016;"OUROESTE (SP)";"SP";"OUROESTE";197;11;39;247
2016;"PACAEMBU (SP)";"SP";"PACAEMBU";201;25;42;268
2016;"PALESTINA (SP)";"SP";"PALESTINA";194;17;51;262
2016;"PALMARES PAULISTA (SP)";"SP";"PALMARES PAULISTA";85;22;116;223
2016;"PALMEIRA D OESTE (SP)";"SP";"PALMEIRA D OESTE";274;10;34;318
2016;"PALMITAL (SP)";"SP";"PALMITAL";677;41;58;776
2016;"PANORAMA (SP)";"SP";"PANORAMA";336;12;22;370
2016;"PARAGUACU PAULISTA (SP)";"SP";"PARAGUACU PAULISTA";934;171;126;1231
2016;"PARAIBUNA (SP)";"SP";"PARAIBUNA";261;79;72;412
2016;"PARAISO (SP)";"SP";"PARAISO";194;15;103;312
2016;"PARANAPANEMA (SP)";"SP";"PARANAPANEMA";616;52;83;751
2016;"PARANAPUA (SP)";"SP";"PARANAPUA";99;15;16;130
2016;"PARAPUA (SP)";"SP";"PARAPUA";329;11;59;399
2016;"PARDINHO (SP)";"SP";"PARDINHO";156;28;33;217
2016;"PARIQUERA ACU (SP)";"SP";"PARIQUERA ACU";431;39;19;489
2016;"PARISI (SP)";"SP";"PARISI";36;5;12;53
2016;"PATROCINIO PAULISTA (SP)";"SP";"PATROCINIO PAULISTA";287;19;58;364
2016;"PAULICEIA (SP)";"SP";"PAULICEIA";335;9;29;373
2016;"PAULINIA (SP)";"SP";"PAULINIA";2209;213;369;2791
2016;"PAULISTANIA (SP)";"SP";"PAULISTANIA";25;14;11;50
2016;"PAULO DE FARIA (SP)";"SP";"PAULO DE FARIA";104;16;46;166
2016;"PEDERNEIRAS (SP)";"SP";"PEDERNEIRAS";1130;115;227;1472
2016;"PEDRA BELA (SP)";"SP";"PEDRA BELA";235;13;14;262
2016;"PEDRANOPOLIS (SP)";"SP";"PEDRANOPOLIS";53;3;15;71
2016;"PEDREGULHO (SP)";"SP";"PEDREGULHO";320;41;138;499
2016;"PEDREIRA (SP)";"SP";"PEDREIRA";812;137;78;1027
2016;"PEDRINHAS PAULISTA (SP)";"SP";"PEDRINHAS PAULISTA";164;7;12;183
2016;"PEDRO DE TOLEDO (SP)";"SP";"PEDRO DE TOLEDO";180;51;18;249
2016;"PENAPOLIS (SP)";"SP";"PENAPOLIS";1399;106;303;1808
2016;"PEREIRA BARRETO (SP)";"SP";"PEREIRA BARRETO";412;52;113;577
2016;"PEREIRAS (SP)";"SP";"PEREIRAS";263;17;29;309
2016;"PERUIBE (SP)";"SP";"PERUIBE";709;230;102;1041
2016;"PIACATU (SP)";"SP";"PIACATU";94;4;21;119
2016;"PIEDADE (SP)";"SP";"PIEDADE";1568;167;110;1845
2016;"PILAR DO SUL (SP)";"SP";"PILAR DO SUL";1123;85;97;1305
2016;"PINDAMONHANGABA (SP)";"SP";"PINDAMONHANGABA";2056;454;176;2686
2016;"PINDORAMA (SP)";"SP";"PINDORAMA";327;36;58;421
2016;"PINHALZINHO (SP)";"SP";"PINHALZINHO";448;57;17;522
2016;"PIQUEROBI (SP)";"SP";"PIQUEROBI";49;5;11;65
2016;"PIQUETE (SP)";"SP";"PIQUETE";204;55;18;277
2016;"PIRACAIA (SP)";"SP";"PIRACAIA";544;97;68;709
2016;"PIRACICABA (SP)";"SP";"PIRACICABA";8009;990;1502;10501
2016;"PIRAJU (SP)";"SP";"PIRAJU";501;81;82;664
2016;"PIRAJUI (SP)";"SP";"PIRAJUI";331;24;94;449
2016;"PIRANGI (SP)";"SP";"PIRANGI";392;17;79;488
2016;"PIRAPORA DO BOM JESUS (SP)";"SP";"PIRAPORA DO BOM JESUS";282;58;100;440
2016;"PIRAPOZINHO (SP)";"SP";"PIRAPOZINHO";479;42;97;618
2016;"PIRASSUNUNGA (SP)";"SP";"PIRASSUNUNGA";1126;174;247;1547
2016;"PIRATININGA (SP)";"SP";"PIRATININGA";275;26;46;347
2016;"PITANGUEIRAS (SP)";"SP";"PITANGUEIRAS";976;58;311;1345
2016;"PLANALTO (SP)";"SP";"PLANALTO";155;11;62;228
2016;"PLATINA (SP)";"SP";"PLATINA";62;20;12;94
2016;"POA (SP)";"SP";"POA";1036;237;179;1452
2016;"POLONI (SP)";"SP";"POLONI";177;4;52;233
2016;"POMPEIA (SP)";"SP";"POMPEIA";293;18;53;364
2016;"PONGAI (SP)";"SP";"PONGAI";70;6;20;96
2016;"PONTAL (SP)";"SP";"PONTAL";1056;37;558;1651
2016;"PONTALINDA (SP)";"SP";"PONTALINDA";37;13;30;80
2016;"PONTES GESTAL (SP)";"SP";"PONTES GESTAL";112;5;31;148
2016;"POPULINA (SP)";"SP";"POPULINA";58;7;17;82
2016;"PORANGABA (SP)";"SP";"PORANGABA";166;14;17;197
2016;"PORTO FELIZ (SP)";"SP";"PORTO FELIZ";1403;122;202;1727
2016;"PORTO FERREIRA (SP)";"SP";"PORTO FERREIRA";1232;124;150;1506
2016;"POTIM (SP)";"SP";"POTIM";80;51;20;151
2016;"POTIRENDABA (SP)";"SP";"POTIRENDABA";559;18;83;660
2016;"PRACINHA (SP)";"SP";"PRACINHA";13;2;13;28
2016;"PRADOPOLIS (SP)";"SP";"PRADOPOLIS";418;26;264;708
2016;"PRAIA GRANDE (SP)";"SP";"PRAIA GRANDE";2564;424;309;3297
2016;"PRATANIA (SP)";"SP";"PRATANIA";130;22;61;213
2016;"PRESIDENTE ALVES (SP)";"SP";"PRESIDENTE ALVES";65;7;48;120
2016;"PRESIDENTE BERNARDES (SP)";"SP";"PRESIDENTE BERNARDES";263;38;54;355
2016;"PRESIDENTE EPITACIO (SP)";"SP";"PRESIDENTE EPITACIO";587;76;168;831
2016;"PRESIDENTE PRUDENTE (SP)";"SP";"PRESIDENTE PRUDENTE";4084;409;889;5382
2016;"PRESIDENTE VENCESLAU (SP)";"SP";"PRESIDENTE VENCESLAU";731;61;81;873
2016;"PROMISSAO (SP)";"SP";"PROMISSAO";766;146;186;1098
2016;"QUADRA (SP)";"SP";"QUADRA";68;12;20;100
2016;"QUATA (SP)";"SP";"QUATA";241;31;73;345
2016;"QUEIROZ (SP)";"SP";"QUEIROZ";29;9;11;49
2016;"QUELUZ (SP)";"SP";"QUELUZ";127;43;11;181
2016;"QUINTANA (SP)";"SP";"QUINTANA";192;18;25;235
2016;"RAFARD (SP)";"SP";"RAFARD";280;28;27;335
2016;"RANCHARIA (SP)";"SP";"RANCHARIA";629;80;105;814
2016;"REDENCAO DA SERRA (SP)";"SP";"REDENCAO DA SERRA";101;32;41;174
2016;"REGENTE FEIJO (SP)";"SP";"REGENTE FEIJO";416;45;37;498
2016;"REGINOPOLIS (SP)";"SP";"REGINOPOLIS";86;9;21;116
2016;"REGISTRO (SP)";"SP";"REGISTRO";1345;139;297;1781
2016;"RESTINGA (SP)";"SP";"RESTINGA";126;10;33;169
2016;"RIBEIRA (SP)";"SP";"RIBEIRA";31;12;13;56
2016;"RIBEIRAO BONITO (SP)";"SP";"RIBEIRAO BONITO";294;55;104;453
2016;"RIBEIRAO BRANCO (SP)";"SP";"RIBEIRAO BRANCO";213;42;62;317
2016;"RIBEIRAO CORRENTE (SP)";"SP";"RIBEIRAO CORRENTE";96;7;47;150
2016;"RIBEIRAO DO SUL (SP)";"SP";"RIBEIRAO DO SUL";147;13;18;178
2016;"RIBEIRAO DOS INDIOS (SP)";"SP";"RIBEIRAO DOS INDIOS";30;4;8;42
2016;"RIBEIRAO GRANDE (SP)";"SP";"RIBEIRAO GRANDE";81;31;16;128
2016;"RIBEIRAO PIRES (SP)";"SP";"RIBEIRAO PIRES";3065;539;467;4071
2016;"RIBEIRAO PRETO (SP)";"SP";"RIBEIRAO PRETO";10956;1084;1784;13824
2016;"RIFAINA (SP)";"SP";"RIFAINA";49;13;11;73
2016;"RINCAO (SP)";"SP";"RINCAO";275;20;50;345
2016;"RINOPOLIS (SP)";"SP";"RINOPOLIS";195;8;52;255
2016;"RIO CLARO (SP)";"SP";"RIO CLARO";3437;446;441;4324
2016;"RIO DAS PEDRAS (SP)";"SP";"RIO DAS PEDRAS";683;109;188;980
2016;"RIO GRANDE DA SERRA (SP)";"SP";"RIO GRANDE DA SERRA";544;240;102;886
2016;"RIOLANDIA (SP)";"SP";"RIOLANDIA";90;15;53;158
2016;"RIVERSUL (SP)";"SP";"RIVERSUL";85;32;32;149
2016;"ROSANA (SP)";"SP";"ROSANA";183;37;76;296
2016;"ROSEIRA (SP)";"SP";"ROSEIRA";139;93;22;254
2016;"RUBIACEA (SP)";"SP";"RUBIACEA";33;3;12;48
2016;"RUBINEIA (SP)";"SP";"RUBINEIA";31;11;11;53
2016;"SABINO (SP)";"SP";"SABINO";64;7;17;88
2016;"SAGRES (SP)";"SP";"SAGRES";22;3;6;31
2016;"SALES (SP)";"SP";"SALES";91;6;37;134
2016;"SALES OLIVEIRA (SP)";"SP";"SALES OLIVEIRA";295;16;61;372
2016;"SALESOPOLIS (SP)";"SP";"SALESOPOLIS";880;85;106;1071
2016;"SALMOURAO (SP)";"SP";"SALMOURAO";34;4;35;73
2016;"SALTINHO (SP)";"SP";"SALTINHO";378;13;12;403
2016;"SALTO (SP)";"SP";"SALTO";2440;306;181;2927
2016;"SALTO DE PIRAPORA (SP)";"SP";"SALTO DE PIRAPORA";751;97;82;930
2016;"SALTO GRANDE (SP)";"SP";"SALTO GRANDE";160;16;31;207
2016;"SANDOVALINA (SP)";"SP";"SANDOVALINA";67;7;20;94
2016;"SANTA ADELIA (SP)";"SP";"SANTA ADELIA";609;33;86;728
2016;"SANTA ALBERTINA (SP)";"SP";"SANTA ALBERTINA";142;8;28;178
2016;"SANTA BARBARA D OESTE (SP)";"SP";"SANTA BARBARA D OESTE";2516;488;376;3380
2016;"SANTA BRANCA (SP)";"SP";"SANTA BRANCA";145;46;39;230
2016;"SANTA CLARA D OESTE (SP)";"SP";"SANTA CLARA D OESTE";34;5;6;45
2016;"SANTA CRUZ DA CONCEICAO (SP)";"SP";"SANTA CRUZ DA CONCEICAO";156;19;16;191
2016;"SANTA CRUZ DA ESPERANCA (SP)";"SP";"SANTA CRUZ DA ESPERANCA";48;2;3;53
2016;"SANTA CRUZ DAS PALMEIRAS (SP)";"SP";"SANTA CRUZ DAS PALMEIRAS";603;54;220;877
2016;"SANTA CRUZ DO RIO PARDO (SP)";"SP";"SANTA CRUZ DO RIO PARDO";1512;112;118;1742
2016;"SANTA ERNESTINA (SP)";"SP";"SANTA ERNESTINA";79;27;84;190
2016;"SANTA FE DO SUL (SP)";"SP";"SANTA FE DO SUL";671;34;48;753
2016;"SANTA GERTRUDES (SP)";"SP";"SANTA GERTRUDES";629;58;37;724
2016;"SANTA ISABEL (SP)";"SP";"SANTA ISABEL";1276;115;128;1519
2016;"SANTA LUCIA (SP)";"SP";"SANTA LUCIA";123;27;45;195
2016;"SANTA MARIA DA SERRA (SP)";"SP";"SANTA MARIA DA SERRA";273;31;32;336
2016;"SANTA MERCEDES (SP)";"SP";"SANTA MERCEDES";58;8;9;75
2016;"SANTA RITA D OESTE (SP)";"SP";"SANTA RITA D OESTE";39;2;6;47
2016;"SANTA RITA DO PASSA QUATRO (SP)";"SP";"SANTA RITA DO PASSA QUATRO";560;81;53;694
2016;"SANTA ROSA DE VITERBO (SP)";"SP";"SANTA ROSA DE VITERBO";468;42;106;616
2016;"SANTA SALETE (SP)";"SP";"SANTA SALETE";45;3;7;55
2016;"SANTANA DA PONTE PENSA (SP)";"SP";"SANTANA DA PONTE PENSA";24;4;6;34
2016;"SANTANA DE PARNAIBA (SP)";"SP";"SANTANA DE PARNAIBA";2009;351;208;2568
2016;"SANTO ANASTACIO (SP)";"SP";"SANTO ANASTACIO";514;40;64;618
2016;"SANTO ANDRE (SP)";"SP";"SANTO ANDRE";9192;1703;1742;12637
2016;"SANTO ANTONIO DA ALEGRIA (SP)";"SP";"SANTO ANTONIO DA ALEGRIA";124;10;29;163
2016;"SANTO ANTONIO DE POSSE (SP)";"SP";"SANTO ANTONIO DE POSSE";883;77;163;1123
2016;"SANTO ANTONIO DO ARACANGUA (SP)";"SP";"SANTO ANTONIO DO ARACANGUA";195;33;91;319
2016;"SANTO ANTONIO DO JARDIM (SP)";"SP";"SANTO ANTONIO DO JARDIM";229;13;16;258
2016;"SANTO ANTONIO DO PINHAL (SP)";"SP";"SANTO ANTONIO DO PINHAL";172;26;14;212
2016;"SANTO EXPEDITO (SP)";"SP";"SANTO EXPEDITO";27;4;15;46
2016;"SANTOPOLIS DO AGUAPEI (SP)";"SP";"SANTOPOLIS DO AGUAPEI";71;4;32;107
2016;"SANTOS (SP)";"SP";"SANTOS";5632;992;748;7372
2016;"SAO BENTO DO SAPUCAI (SP)";"SP";"SAO BENTO DO SAPUCAI";191;54;17;262
2016;"SAO BERNARDO DO CAMPO (SP)";"SP";"SAO BERNARDO DO CAMPO";12088;2615;4224;18927
2016;"SAO CAETANO DO SUL (SP)";"SP";"SAO CAETANO DO SUL";2890;512;626;4028
2016;"SAO CARLOS (SP)";"SP";"SAO CARLOS";4080;453;444;4977
2016;"SAO FRANCISCO (SP)";"SP";"SAO FRANCISCO";47;6;19;72
2016;"SAO JOAO DA BOA VISTA (SP)";"SP";"SAO JOAO DA BOA VISTA";2062;292;113;2467
2016;"SAO JOAO DAS DUAS PONTES (SP)";"SP";"SAO JOAO DAS DUAS PONTES";24;8;4;36
2016;"SAO JOAO DE IRACEMA (SP)";"SP";"SAO JOAO DE IRACEMA";31;6;8;45
2016;"SAO JOAO DO PAU D ALHO (SP)";"SP";"SAO JOAO DO PAU D ALHO";39;6;7;52
2016;"SAO JOAQUIM DA BARRA (SP)";"SP";"SAO JOAQUIM DA BARRA";822;95;224;1141
2016;"SAO JOSE DA BELA VISTA (SP)";"SP";"SAO JOSE DA BELA VISTA";75;17;46;138
2016;"SAO JOSE DO BARREIRO (SP)";"SP";"SAO JOSE DO BARREIRO";48;16;4;68
2016;"SAO JOSE DO RIO PARDO (SP)";"SP";"SAO JOSE DO RIO PARDO";1252;113;165;1530
2016;"SAO JOSE DO RIO PRETO (SP)";"SP";"SAO JOSE DO RIO PRETO";8770;679;1625;11074
2016;"SAO JOSE DOS CAMPOS (SP)";"SP";"SAO JOSE DOS CAMPOS";7143;1964;1798;10905
2016;"SAO LOURENCO DA SERRA (SP)";"SP";"SAO LOURENCO DA SERRA";376;37;32;445
2016;"SAO LUIZ DO PARAITINGA (SP)";"SP";"SAO LUIZ DO PARAITINGA";200;36;31;267
2016;"SAO MANUEL (SP)";"SP";"SAO MANUEL";787;131;242;1160
2016;"SAO MIGUEL ARCANJO (SP)";"SP";"SAO MIGUEL ARCANJO";756;125;89;970
2016;"SAO PAULO (SP)";"SP";"SAO PAULO";127327;37853;44242;209422
2016;"SAO PEDRO (SP)";"SP";"SAO PEDRO";650;117;99;866
2016;"SAO PEDRO DO TURVO (SP)";"SP";"SAO PEDRO DO TURVO";187;23;46;256
2016;"SAO ROQUE (SP)";"SP";"SAO ROQUE";1235;251;222;1708
2016;"SAO SEBASTIAO (SP)";"SP";"SAO SEBASTIAO";956;151;176;1283
2016;"SAO SEBASTIAO DA GRAMA (SP)";"SP";"SAO SEBASTIAO DA GRAMA";263;35;38;336
2016;"SAO SIMAO (SP)";"SP";"SAO SIMAO";375;26;51;452
2016;"SAO VICENTE (SP)";"SP";"SAO VICENTE";2079;566;1160;3805
2016;"SARAPUI (SP)";"SP";"SARAPUI";178;27;19;224
2016;"SARUTAIA (SP)";"SP";"SARUTAIA";60;11;33;104
2016;"SEBASTIANOPOLIS DO SUL (SP)";"SP";"SEBASTIANOPOLIS DO SUL";272;5;16;293
2016;"SERRA AZUL (SP)";"SP";"SERRA AZUL";174;17;114;305
2016;"SERRA NEGRA (SP)";"SP";"SERRA NEGRA";477;70;33;580
2016;"SERRANA (SP)";"SP";"SERRANA";653;117;256;1026
2016;"SERTAOZINHO (SP)";"SP";"SERTAOZINHO";2727;186;680;3593
2016;"SETE BARRAS (SP)";"SP";"SETE BARRAS";245;20;33;298
2016;"SEVERINIA (SP)";"SP";"SEVERINIA";304;20;243;567
2016;"SILVEIRAS (SP)";"SP";"SILVEIRAS";91;29;7;127
2016;"SOCORRO (SP)";"SP";"SOCORRO";991;149;56;1196
2016;"SOROCABA (SP)";"SP";"SOROCABA";8145;1535;1687;11367
2016;"SUD MENNUCCI (SP)";"SP";"SUD MENNUCCI";145;17;56;218
2016;"SUMARE (SP)";"SP";"SUMARE";2900;693;646;4239
2016;"SUZANAPOLIS (SP)";"SP";"SUZANAPOLIS";89;10;18;117
2016;"SUZANO (SP)";"SP";"SUZANO";3537;968;919;5424
2016;"TABAPUA (SP)";"SP";"TABAPUA";172;15;58;245
2016;"TABATINGA (SP)";"SP";"TABATINGA";350;25;192;567
2016;"TABOAO DA SERRA (SP)";"SP";"TABOAO DA SERRA";2784;1000;583;4367
2016;"TACIBA (SP)";"SP";"TACIBA";92;13;24;129
2016;"TAGUAI (SP)";"SP";"TAGUAI";179;16;35;230
2016;"TAIACU (SP)";"SP";"TAIACU";157;8;26;191
2016;"TAIUVA (SP)";"SP";"TAIUVA";159;9;28;196
2016;"TAMBAU (SP)";"SP";"TAMBAU";584;53;73;710
2016;"TANABI (SP)";"SP";"TANABI";507;60;119;686
2016;"TAPIRAI (SP)";"SP";"TAPIRAI";220;20;13;253
2016;"TAPIRATIBA (SP)";"SP";"TAPIRATIBA";375;32;79;486
2016;"TAQUARAL (SP)";"SP";"TAQUARAL";67;7;22;96
2016;"TAQUARITINGA (SP)";"SP";"TAQUARITINGA";1607;115;351;2073
2016;"TAQUARITUBA (SP)";"SP";"TAQUARITUBA";785;72;107;964
2016;"TAQUARIVAI (SP)";"SP";"TAQUARIVAI";107;11;19;137
2016;"TARABAI (SP)";"SP";"TARABAI";131;5;28;164
2016;"TARUMA (SP)";"SP";"TARUMA";359;36;173;568
2016;"TATUI (SP)";"SP";"TATUI";2365;198;737;3300
2016;"TAUBATE (SP)";"SP";"TAUBATE";3306;894;679;4879
2016;"TEJUPA (SP)";"SP";"TEJUPA";62;24;11;97
2016;"TEODORO SAMPAIO (SP)";"SP";"TEODORO SAMPAIO";340;45;319;704
2016;"TERRA ROXA (SP)";"SP";"TERRA ROXA";176;18;73;267
2016;"TIETE (SP)";"SP";"TIETE";1298;67;207;1572
2016;"TIMBURI (SP)";"SP";"TIMBURI";33;5;5;43
2016;"TORRE DE PEDRA (SP)";"SP";"TORRE DE PEDRA";52;10;9;71
2016;"TORRINHA (SP)";"SP";"TORRINHA";455;25;48;528
2016;"TRABIJU (SP)";"SP";"TRABIJU";47;10;9;66
2016;"TREMEMBE (SP)";"SP";"TREMEMBE";504;79;18;601
2016;"TRES FRONTEIRAS (SP)";"SP";"TRES FRONTEIRAS";75;25;14;114
2016;"TUIUTI (SP)";"SP";"TUIUTI";121;30;19;170
2016;"TUPA (SP)";"SP";"TUPA";1593;74;255;1922
2016;"TUPI PAULISTA (SP)";"SP";"TUPI PAULISTA";348;21;33;402
2016;"TURIUBA (SP)";"SP";"TURIUBA";26;3;12;41
2016;"TURMALINA (SP)";"SP";"TURMALINA";30;2;12;44
2016;"UBARANA (SP)";"SP";"UBARANA";137;3;40;180
2016;"UBATUBA (SP)";"SP";"UBATUBA";775;140;104;1019
2016;"UBIRAJARA (SP)";"SP";"UBIRAJARA";112;7;33;152
2016;"UCHOA (SP)";"SP";"UCHOA";175;17;49;241
2016;"UNIAO PAULISTA (SP)";"SP";"UNIAO PAULISTA";58;5;11;74
2016;"URANIA (SP)";"SP";"URANIA";157;20;34;211
2016;"URU (SP)";"SP";"URU";13;10;9;32
2016;"URUPES (SP)";"SP";"URUPES";391;21;51;463
2016;"VALENTIM GENTIL (SP)";"SP";"VALENTIM GENTIL";319;19;32;370
2016;"VALINHOS (SP)";"SP";"VALINHOS";2170;586;2012;4768
2016;"VALPARAISO (SP)";"SP";"VALPARAISO";459;34;168;661
2016;"VARGEM (SP)";"SP";"VARGEM";346;23;25;394
2016;"VARGEM GRANDE DO SUL (SP)";"SP";"VARGEM GRANDE DO SUL";1252;116;244;1612
2016;"VARGEM GRANDE PAULISTA (SP)";"SP";"VARGEM GRANDE PAULISTA";1027;124;83;1234
2016;"VARZEA PAULISTA (SP)";"SP";"VARZEA PAULISTA";1263;428;380;2071
2016;"VERA CRUZ (SP)";"SP";"VERA CRUZ";173;27;36;236
2016;"VINHEDO (SP)";"SP";"VINHEDO";1539;155;165;1859
2016;"VIRADOURO (SP)";"SP";"VIRADOURO";377;25;93;495
2016;"VISTA ALEGRE DO ALTO (SP)";"SP";"VISTA ALEGRE DO ALTO";440;40;144;624
2016;"VITORIA BRASIL (SP)";"SP";"VITORIA BRASIL";29;4;8;41
2016;"VOTORANTIM (SP)";"SP";"VOTORANTIM";1319;301;260;1880
2016;"VOTUPORANGA (SP)";"SP";"VOTUPORANGA";2126;153;268;2547
2016;"ZACARIAS (SP)";"SP";"ZACARIAS";60;5;25;90
2016;"ABREULANDIA (TO)";"TO";"ABREULANDIA";20;1;2;23
2016;"AGUIARNOPOLIS (TO)";"TO";"AGUIARNOPOLIS";64;4;15;83
2016;"ALIANCA DO TOCANTINS (TO)";"TO";"ALIANCA DO TOCANTINS";83;9;12;104
2016;"ALMAS (TO)";"TO";"ALMAS";72;0;10;82
2016;"ALVORADA (TO)";"TO";"ALVORADA";206;2;15;223
2016;"ANANAS (TO)";"TO";"ANANAS";89;1;28;118
2016;"ANGICO (TO)";"TO";"ANGICO";18;5;8;31
2016;"APARECIDA DO RIO NEGRO (TO)";"TO";"APARECIDA DO RIO NEGRO";65;13;5;83
2016;"ARAGOMINAS (TO)";"TO";"ARAGOMINAS";59;2;14;75
2016;"ARAGUACEMA (TO)";"TO";"ARAGUACEMA";33;4;9;46
2016;"ARAGUACU (TO)";"TO";"ARAGUACU";115;12;13;140
2016;"ARAGUAINA (TO)";"TO";"ARAGUAINA";3816;177;744;4737
2016;"ARAGUANA (TO)";"TO";"ARAGUANA";94;3;24;121
2016;"ARAGUATINS (TO)";"TO";"ARAGUATINS";326;52;78;456
2016;"ARAPOEMA (TO)";"TO";"ARAPOEMA";55;5;15;75
2016;"ARRAIAS (TO)";"TO";"ARRAIAS";48;1;8;57
2016;"AUGUSTINOPOLIS (TO)";"TO";"AUGUSTINOPOLIS";204;36;43;283
2016;"AURORA DO TOCANTINS (TO)";"TO";"AURORA DO TOCANTINS";10;0;5;15
2016;"AXIXA DO TOCANTINS (TO)";"TO";"AXIXA DO TOCANTINS";51;19;9;79
2016;"BABACULANDIA (TO)";"TO";"BABACULANDIA";235;14;21;270
2016;"BANDEIRANTES DO TOCANTINS (TO)";"TO";"BANDEIRANTES DO TOCANTINS";28;4;4;36
2016;"BARRA DO OURO (TO)";"TO";"BARRA DO OURO";16;0;3;19
2016;"BARROLANDIA (TO)";"TO";"BARROLANDIA";61;3;7;71
2016;"BERNARDO SAYAO (TO)";"TO";"BERNARDO SAYAO";35;1;7;43
2016;"BOM JESUS DO TOCANTINS (TO)";"TO";"BOM JESUS DO TOCANTINS";11;1;3;15
2016;"BRASILANDIA DO TOCANTINS (TO)";"TO";"BRASILANDIA DO TOCANTINS";18;2;2;22
2016;"BREJINHO DE NAZARE (TO)";"TO";"BREJINHO DE NAZARE";53;1;19;73
2016;"BURITI DO TOCANTINS (TO)";"TO";"BURITI DO TOCANTINS";51;13;6;70
2016;"CACHOEIRINHA (TO)";"TO";"CACHOEIRINHA";7;0;1;8
2016;"CAMPOS LINDOS (TO)";"TO";"CAMPOS LINDOS";72;0;7;79
2016;"CARIRI DO TOCANTINS (TO)";"TO";"CARIRI DO TOCANTINS";47;7;12;66
2016;"CARMOLANDIA (TO)";"TO";"CARMOLANDIA";218;16;99;333
2016;"CARRASCO BONITO (TO)";"TO";"CARRASCO BONITO";9;8;3;20
2016;"CASEARA (TO)";"TO";"CASEARA";33;4;7;44
2016;"CENTENARIO (TO)";"TO";"CENTENARIO";4;0;3;7
2016;"CHAPADA DA NATIVIDADE (TO)";"TO";"CHAPADA DA NATIVIDADE";25;1;9;35
2016;"CHAPADA DE AREIA (TO)";"TO";"CHAPADA DE AREIA";7;2;2;11
2016;"COLINAS DO TOCANTINS (TO)";"TO";"COLINAS DO TOCANTINS";605;14;77;696
2016;"COLMEIA (TO)";"TO";"COLMEIA";132;8;18;158
2016;"COMBINADO (TO)";"TO";"COMBINADO";19;1;11;31
2016;"CONCEICAO DO TOCANTINS (TO)";"TO";"CONCEICAO DO TOCANTINS";22;1;3;26
2016;"COUTO DE MAGALHAES (TO)";"TO";"COUTO DE MAGALHAES";29;6;11;46
2016;"CRISTALANDIA (TO)";"TO";"CRISTALANDIA";105;1;7;113
2016;"CRIXAS DO TOCANTINS (TO)";"TO";"CRIXAS DO TOCANTINS";17;1;3;21
2016;"DARCINOPOLIS (TO)";"TO";"DARCINOPOLIS";91;8;13;112
2016;"DIANOPOLIS (TO)";"TO";"DIANOPOLIS";246;23;68;337
2016;"DIVINOPOLIS DO TOCANTINS (TO)";"TO";"DIVINOPOLIS DO TOCANTINS";98;2;7;107
2016;"DOIS IRMAOS DO TOCANTINS (TO)";"TO";"DOIS IRMAOS DO TOCANTINS";41;6;14;61
2016;"DUERE (TO)";"TO";"DUERE";50;2;4;56
2016;"ESPERANTINA (TO)";"TO";"ESPERANTINA";27;9;11;47
2016;"FATIMA (TO)";"TO";"FATIMA";57;2;9;68
2016;"FIGUEIROPOLIS (TO)";"TO";"FIGUEIROPOLIS";90;5;9;104
2016;"FILADELFIA (TO)";"TO";"FILADELFIA";53;8;9;70
2016;"FORMOSO DO ARAGUAIA (TO)";"TO";"FORMOSO DO ARAGUAIA";270;11;37;318
2016;"FORTALEZA DO TABOCAO (TO)";"TO";"FORTALEZA DO TABOCAO";34;4;4;42
2016;"GOIANORTE (TO)";"TO";"GOIANORTE";45;2;12;59
2016;"GOIATINS (TO)";"TO";"GOIATINS";61;6;10;77
2016;"GUARAI (TO)";"TO";"GUARAI";446;21;40;507
2016;"GURUPI (TO)";"TO";"GURUPI";1687;47;255;1989
2016;"IPUEIRAS (TO)";"TO";"IPUEIRAS";10;0;2;12
2016;"ITACAJA (TO)";"TO";"ITACAJA";50;2;4;56
2016;"ITAGUATINS (TO)";"TO";"ITAGUATINS";35;4;14;53
2016;"ITAPIRATINS (TO)";"TO";"ITAPIRATINS";25;2;8;35
2016;"ITAPORA DO TOCANTINS (TO)";"TO";"ITAPORA DO TOCANTINS";21;3;6;30
2016;"JAU DO TOCANTINS (TO)";"TO";"JAU DO TOCANTINS";22;1;8;31
2016;"JUARINA (TO)";"TO";"JUARINA";9;3;6;18
2016;"LAGOA DA CONFUSAO (TO)";"TO";"LAGOA DA CONFUSAO";183;3;19;205
2016;"LAGOA DO TOCANTINS (TO)";"TO";"LAGOA DO TOCANTINS";9;0;4;13
2016;"LAJEADO (TO)";"TO";"LAJEADO";36;2;9;47
2016;"LAVANDEIRA (TO)";"TO";"LAVANDEIRA";4;0;2;6
2016;"LIZARDA (TO)";"TO";"LIZARDA";20;0;1;21
2016;"LUZINOPOLIS (TO)";"TO";"LUZINOPOLIS";16;2;2;20
2016;"MARIANOPOLIS DO TOCANTINS (TO)";"TO";"MARIANOPOLIS DO TOCANTINS";44;2;8;54
2016;"MATEIROS (TO)";"TO";"MATEIROS";25;0;5;30
2016;"MAURILANDIA DO TOCANTINS (TO)";"TO";"MAURILANDIA DO TOCANTINS";14;7;5;26
2016;"MIRACEMA DO TOCANTINS (TO)";"TO";"MIRACEMA DO TOCANTINS";195;18;36;249
2016;"MIRANORTE (TO)";"TO";"MIRANORTE";252;12;23;287
2016;"MONTE DO CARMO (TO)";"TO";"MONTE DO CARMO";29;4;5;38
2016;"MONTE SANTO DO TOCANTINS (TO)";"TO";"MONTE SANTO DO TOCANTINS";19;3;4;26
2016;"MURICILANDIA (TO)";"TO";"MURICILANDIA";15;2;5;22
2016;"NATIVIDADE (TO)";"TO";"NATIVIDADE";101;4;8;113
2016;"NAZARE (TO)";"TO";"NAZARE";26;2;5;33
2016;"NOVA OLINDA (TO)";"TO";"NOVA OLINDA";108;2;32;142
2016;"NOVA ROSALANDIA (TO)";"TO";"NOVA ROSALANDIA";29;1;2;32
2016;"NOVO ACORDO (TO)";"TO";"NOVO ACORDO";28;1;8;37
2016;"NOVO ALEGRE (TO)";"TO";"NOVO ALEGRE";13;1;4;18
2016;"NOVO JARDIM (TO)";"TO";"NOVO JARDIM";17;0;4;21
2016;"OLIVEIRA DE FATIMA (TO)";"TO";"OLIVEIRA DE FATIMA";10;1;4;15
2016;"PALMAS (TO)";"TO";"PALMAS";4830;326;1812;6968
2016;"PALMEIRANTE (TO)";"TO";"PALMEIRANTE";23;4;6;33
2016;"PALMEIRAS DO TOCANTINS (TO)";"TO";"PALMEIRAS DO TOCANTINS";41;8;10;59
2016;"PALMEIROPOLIS (TO)";"TO";"PALMEIROPOLIS";123;2;18;143
2016;"PARAISO DO TOCANTINS (TO)";"TO";"PARAISO DO TOCANTINS";1310;40;137;1487
2016;"PARANA (TO)";"TO";"PARANA";40;3;2;45
2016;"PAU D ARCO (TO)";"TO";"PAU D ARCO";30;1;9;40
2016;"PEDRO AFONSO (TO)";"TO";"PEDRO AFONSO";232;14;59;305
2016;"PEIXE (TO)";"TO";"PEIXE";84;12;45;141
2016;"PEQUIZEIRO (TO)";"TO";"PEQUIZEIRO";43;2;11;56
2016;"PINDORAMA DO TOCANTINS (TO)";"TO";"PINDORAMA DO TOCANTINS";22;1;8;31
2016;"PIRAQUE (TO)";"TO";"PIRAQUE";11;0;7;18
2016;"PIUM (TO)";"TO";"PIUM";54;4;11;69
2016;"PONTE ALTA DO BOM JESUS (TO)";"TO";"PONTE ALTA DO BOM JESUS";16;3;3;22
2016;"PONTE ALTA DO TOCANTINS (TO)";"TO";"PONTE ALTA DO TOCANTINS";25;2;6;33
2016;"PORTO ALEGRE DO TOCANTINS (TO)";"TO";"PORTO ALEGRE DO TOCANTINS";13;1;5;19
2016;"PORTO NACIONAL (TO)";"TO";"PORTO NACIONAL";804;73;165;1042
2016;"PRAIA NORTE (TO)";"TO";"PRAIA NORTE";11;4;5;20
2016;"PRESIDENTE KENNEDY (TO)";"TO";"PRESIDENTE KENNEDY";35;0;2;37
2016;"PUGMIL (TO)";"TO";"PUGMIL";25;2;1;28
2016;"RECURSOLANDIA (TO)";"TO";"RECURSOLANDIA";12;0;2;14
2016;"RIACHINHO (TO)";"TO";"RIACHINHO";124;13;82;219
2016;"RIO DA CONCEICAO (TO)";"TO";"RIO DA CONCEICAO";9;1;2;12
2016;"RIO DOS BOIS (TO)";"TO";"RIO DOS BOIS";16;3;4;23
2016;"RIO SONO (TO)";"TO";"RIO SONO";24;1;6;31
2016;"SAMPAIO (TO)";"TO";"SAMPAIO";61;2;4;67
2016;"SANDOLANDIA (TO)";"TO";"SANDOLANDIA";24;9;1;34
2016;"SANTA FE DO ARAGUAIA (TO)";"TO";"SANTA FE DO ARAGUAIA";71;9;19;99
2016;"SANTA MARIA DO TOCANTINS (TO)";"TO";"SANTA MARIA DO TOCANTINS";13;3;3;19
2016;"SANTA RITA DO TOCANTINS (TO)";"TO";"SANTA RITA DO TOCANTINS";16;1;4;21
2016;"SANTA ROSA DO TOCANTINS (TO)";"TO";"SANTA ROSA DO TOCANTINS";43;1;4;48
2016;"SANTA TEREZA DO TOCANTINS (TO)";"TO";"SANTA TEREZA DO TOCANTINS";22;1;4;27
2016;"SANTA TEREZINHA DO TOCANTINS (TO)";"TO";"SANTA TEREZINHA DO TOCANTINS";19;3;4;26
2016;"SAO BENTO DO TOCANTINS (TO)";"TO";"SAO BENTO DO TOCANTINS";27;4;13;44
2016;"SAO FELIX DO TOCANTINS (TO)";"TO";"SAO FELIX DO TOCANTINS";7;0;0;7
2016;"SAO MIGUEL DO TOCANTINS (TO)";"TO";"SAO MIGUEL DO TOCANTINS";117;13;43;173
2016;"SAO SALVADOR DO TOCANTINS (TO)";"TO";"SAO SALVADOR DO TOCANTINS";24;4;4;32
2016;"SAO SEBASTIAO DO TOCANTINS (TO)";"TO";"SAO SEBASTIAO DO TOCANTINS";19;2;2;23
2016;"SAO VALERIO DA NATIVIDADE (TO)";"TO";"SAO VALERIO DA NATIVIDADE";55;1;7;63
2016;"SILVANOPOLIS (TO)";"TO";"SILVANOPOLIS";51;1;5;57
2016;"SITIO NOVO DO TOCANTINS (TO)";"TO";"SITIO NOVO DO TOCANTINS";51;9;15;75
2016;"SUCUPIRA (TO)";"TO";"SUCUPIRA";16;0;7;23
2016;"TAGUATINGA (TO)";"TO";"TAGUATINGA";129;11;27;167
2016;"TAIPAS DO TOCANTINS (TO)";"TO";"TAIPAS DO TOCANTINS";6;0;2;8
2016;"TALISMA (TO)";"TO";"TALISMA";23;6;2;31
2016;"TOCANTINIA (TO)";"TO";"TOCANTINIA";27;1;8;36
2016;"TOCANTINOPOLIS (TO)";"TO";"TOCANTINOPOLIS";1250;291;422;1963
2016;"TUPIRAMA (TO)";"TO";"TUPIRAMA";23;4;4;31
2016;"TUPIRATINS (TO)";"TO";"TUPIRATINS";12;1;7;20
2016;"WANDERLANDIA (TO)";"TO";"WANDERLANDIA";72;4;9;85
2016;"XAMBIOA (TO)";"TO";"XAMBIOA";132;7;21;160
